2,155,155,16,7,9,2,1
1,162,162,6,6,0,1,0
0,500,500,34,34,0,1,0

0,348,348,6,2,4,2,1
1,377,377,1,1,0,1,0
3,393,393,17,17,0,1,0
2,448,448,17,17,0,1,0
4,483,483,49,49,0,1,0

1,111,111,10,10,0,1,0
0,367,367,5,5,0,1,0
2,392,392,40,14,26,4,3

0,154,154,16,16,0,1,0
1,168,168,17,17,0,1,0

0,162,162,11,3,8,2,1
2,237,237,24,24,0,1,0
1,458,458,15,3,12,2,1

1,368,368,14,8,6,3,2
0,460,460,29,29,0,1,0
2,462,462,47,27,20,2,1

0,366,366,2,2,0,1,0
1,375,375,34,28,6,2,1
3,472,472,48,40,8,3,2
2,474,474,2,2,0,1,0

1,239,239,24,24,0,1,0
0,258,258,26,11,15,2,1

2,117,117,12,2,10,2,1
0,168,168,6,2,4,2,1
1,343,343,23,16,7,2,1

0,452,452,46,40,6,2,1
1,469,469,47,47,0,1,0

1,260,260,15,15,0,1,0
3,273,273,28,11,17,2,1
2,295,295,12,12,0,1,0
0,367,367,1,1,0,1,0

0,157,157,16,6,10,2,1
1,245,245,25,25,0,1,0

1,137,137,8,8,0,1,0
0,151,151,7,7,0,1,0
2,229,229,23,7,16,2,1

0,237,237,2,2,0,1,0
1,399,399,24,24,0,1,0
2,422,422,14,14,0,1,0
3,424,424,43,43,0,1,0

0,125,125,13,13,0,1,0
1,346,346,35,17,18,4,3

3,112,112,12,12,0,1,0
0,186,186,1,1,0,1,0
2,247,247,7,1,6,2,1
1,281,281,19,19,0,1,0

1,120,120,12,2,10,3,2
0,431,431,44,39,5,2,1

0,293,293,30,30,0,1,0
1,438,438,44,44,0,1,0

0,268,268,5,5,0,1,0
3,281,281,29,2,27,4,3
2,320,320,18,10,8,2,1
1,427,427,12,5,7,2,1

2,358,358,36,12,24,4,3
1,366,366,2,2,0,1,0
0,434,434,42,42,0,1,0

1,202,202,21,21,0,1,0
0,448,448,45,45,0,1,0

0,102,102,5,5,0,1,0
2,434,434,44,30,14,3,2
1,482,482,25,4,21,2,1

2,110,110,11,11,0,1,0
1,269,269,12,1,11,2,1
0,375,375,22,10,12,3,2

3,168,168,17,17,0,1,0
2,259,259,3,3,0,1,0
1,264,264,20,8,12,4,3
0,376,376,5,5,0,1,0

1,155,155,1,1,0,1,0
0,156,156,15,5,10,3,2
2,388,388,39,39,0,1,0

1,221,221,23,23,0,1,0
0,494,494,50,11,39,4,3

0,121,121,7,7,0,1,0
1,234,234,5,5,0,1,0
2,315,315,7,7,0,1,0
3,475,475,48,27,21,2,1

0,114,114,2,2,0,1,0
2,211,211,22,22,0,1,0
1,286,286,24,24,0,1,0

2,102,102,2,2,0,1,0
1,234,234,1,1,0,1,0
3,259,259,26,17,9,4,3
0,343,343,29,29,0,1,0

1,146,146,15,7,8,2,1
0,439,439,44,8,36,2,1

1,154,154,16,1,15,4,3
0,301,301,31,7,24,4,3

3,135,135,3,3,0,1,0
4,236,236,24,11,13,2,1
0,240,240,12,4,8,2,1
2,245,245,4,4,0,1,0
1,408,408,5,5,0,1,0

0,145,145,15,3,12,4,3
1,439,439,44,20,24,4,3

0,130,130,13,13,0,1,0
1,451,451,46,4,42,4,3

1,115,115,12,12,0,1,0
0,216,216,22,13,9,2,1

0,205,205,21,21,0,1,0
1,315,315,32,16,16,3,2

0,154,154,14,14,0,1,0
2,217,217,22,22,0,1,0
1,229,229,3,3,0,1,0

0,172,172,12,12,0,1,0
2,201,201,21,15,6,3,2
1,371,371,12,3,9,2,1

2,115,115,2,2,0,1,0
0,145,145,5,5,0,1,0
1,170,170,9,9,0,1,0
3,343,343,35,35,0,1,0

0,259,259,26,26,0,1,0
1,487,487,49,1,48,3,2

1,192,192,2,2,0,1,0
2,263,263,27,4,23,2,1
0,274,274,25,25,0,1,0

0,133,133,9,9,0,1,0
1,173,173,6,6,0,1,0
2,446,446,45,18,27,2,1

1,491,491,50,1,49,4,3
0,492,492,50,50,0,1,0

1,142,142,5,5,0,1,0
4,163,163,9,9,0,1,0
5,235,235,24,24,0,1,0
0,253,253,1,1,0,1,0
3,306,306,2,2,0,1,0
2,398,398,2,2,0,1,0

1,200,200,20,20,0,1,0
0,350,350,36,20,16,3,2

0,115,115,3,3,0,1,0
1,389,389,29,6,23,2,1
2,456,456,46,33,13,2,1

0,134,134,14,2,12,2,1
1,199,199,20,20,0,1,0

2,143,143,2,2,0,1,0
4,143,143,2,2,0,1,0
0,256,256,3,3,0,1,0
5,404,404,41,41,0,1,0
3,416,416,24,24,0,1,0
1,464,464,4,4,0,1,0

0,114,114,3,3,0,1,0
4,170,170,17,6,11,2,1
1,269,269,8,5,3,2,1
3,441,441,19,3,16,3,2
2,499,499,1,1,0,1,0

1,436,436,44,22,22,2,1
0,453,453,46,46,0,1,0

2,165,165,6,6,0,1,0
3,182,182,4,4,0,1,0
1,288,288,12,12,0,1,0
0,337,337,1,1,0,1,0
4,374,374,38,2,36,3,2

2,127,127,13,1,12,2,1
1,280,280,5,5,0,1,0
0,282,282,24,24,0,1,0

1,173,173,15,9,6,3,2
4,184,184,19,19,0,1,0
0,240,240,1,1,0,1,0
3,305,305,3,3,0,1,0
2,439,439,1,1,0,1,0

0,226,226,15,6,9,4,3
2,318,318,1,1,0,1,0
3,420,420,42,42,0,1,0
1,454,454,15,12,3,2,1

0,261,261,27,27,0,1,0
1,327,327,33,33,0,1,0

3,143,143,15,15,0,1,0
2,339,339,16,4,12,3,2
1,425,425,6,6,0,1,0
0,497,497,20,20,0,1,0

0,369,369,37,20,17,2,1
1,410,410,41,17,24,3,2

1,169,169,17,11,6,2,1
0,290,290,1,1,0,1,0
2,327,327,33,33,0,1,0

1,246,246,25,25,0,1,0
0,364,364,37,37,0,1,0

0,188,188,4,1,3,2,1
1,211,211,17,14,3,2,1
2,365,365,37,37,0,1,0

0,176,176,18,12,6,3,2
1,216,216,22,22,0,1,0

1,161,161,17,11,6,2,1
0,387,387,39,39,0,1,0

0,251,251,17,1,16,4,3
2,313,313,32,32,0,1,0
1,390,390,13,6,7,2,1

1,150,150,15,15,0,1,0
0,202,202,21,21,0,1,0

2,149,149,15,6,9,4,3
0,200,200,19,10,9,4,3
1,416,416,3,3,0,1,0

1,357,357,36,36,0,1,0
0,393,393,40,31,9,4,3

0,373,373,38,29,9,4,3
1,381,381,39,3,36,4,3

1,112,112,2,2,0,1,0
2,207,207,1,1,0,1,0
4,296,296,30,30,0,1,0
0,436,436,16,1,15,4,3
3,468,468,20,2,18,3,2

1,212,212,22,3,19,2,1
0,347,347,35,35,0,1,0

0,251,251,26,26,0,1,0
1,280,280,28,4,24,4,3

1,286,286,1,1,0,1,0
2,310,310,9,9,0,1,0
3,420,420,42,10,32,2,1
0,441,441,30,24,6,2,1

2,240,240,24,15,9,2,1
0,317,317,8,8,0,1,0
1,396,396,30,30,0,1,0

2,358,358,36,14,22,4,3
1,445,445,24,2,22,3,2
0,458,458,22,19,3,2,1

0,110,110,9,1,8,3,2
2,135,135,14,5,9,2,1
1,448,448,9,3,6,2,1

0,243,243,25,25,0,1,0
1,382,382,39,39,0,1,0

0,104,104,11,11,0,1,0
1,105,105,11,3,8,3,2

0,148,148,11,2,9,4,3
1,294,294,8,1,7,2,1
2,484,484,49,17,32,3,2

0,210,210,4,4,0,1,0
2,398,398,40,14,26,3,2
1,479,479,39,39,0,1,0

0,140,140,14,10,4,2,1
1,339,339,34,28,6,3,2

1,361,361,37,25,12,3,2
0,480,480,48,27,21,2,1

0,236,236,10,10,0,1,0
2,437,437,44,44,0,1,0
1,495,495,29,29,0,1,0

1,176,176,18,13,5,2,1
0,210,210,22,22,0,1,0

0,113,113,5,5,0,1,0
1,202,202,12,2,10,2,1
2,211,211,22,1,21,2,1

0,349,349,35,21,14,2,1
1,449,449,45,45,0,1,0

4,115,115,12,8,4,2,1
2,284,284,19,3,16,2,1
3,373,373,11,11,0,1,0
0,400,400,1,1,0,1,0
1,459,459,1,1,0,1,0

0,209,209,21,21,0,1,0
1,355,355,36,18,18,4,3

0,174,174,8,8,0,1,0
1,215,215,12,12,0,1,0
2,488,488,49,18,31,4,3

2,153,153,8,5,3,2,1
1,265,265,12,8,4,2,1
3,376,376,38,6,32,3,2
0,447,447,3,3,0,1,0

0,181,181,10,10,0,1,0
1,192,192,9,5,4,2,1
2,415,415,42,10,32,3,2

0,259,259,26,26,0,1,0
1,318,318,32,2,30,3,2

2,129,129,13,5,8,2,1
0,374,374,11,11,0,1,0
1,488,488,35,10,25,2,1

1,177,177,8,8,0,1,0
2,184,184,19,19,0,1,0
0,339,339,19,19,0,1,0

1,357,357,36,36,0,1,0
0,495,495,50,18,32,3,2

0,275,275,28,7,21,2,1
1,351,351,36,9,27,2,1

0,147,147,15,15,0,1,0
1,165,165,17,7,10,2,1

0,178,178,18,18,0,1,0
1,489,489,49,2,47,3,2

0,106,106,11,11,0,1,0
1,321,321,33,33,0,1,0

1,112,112,12,12,0,1,0
0,348,348,35,20,15,4,3

2,251,251,26,26,0,1,0
0,434,434,23,23,0,1,0
1,467,467,22,22,0,1,0

2,140,140,14,4,10,3,2
1,290,290,26,26,0,1,0
0,404,404,5,5,0,1,0

2,109,109,11,11,0,1,0
0,300,300,20,11,9,2,1
1,438,438,15,15,0,1,0

0,314,314,32,6,26,3,2
1,360,360,36,5,31,2,1

0,106,106,2,2,0,1,0
1,209,209,17,17,0,1,0
2,379,379,38,38,0,1,0

1,104,104,10,10,0,1,0
0,258,258,1,1,0,1,0
2,424,424,43,43,0,1,0

1,222,222,23,23,0,1,0
0,418,418,42,12,30,4,3

1,444,444,45,45,0,1,0
0,498,498,50,21,29,2,1

2,126,126,1,1,0,1,0
4,217,217,22,11,11,2,1
1,404,404,20,20,0,1,0
3,465,465,19,10,9,2,1
0,488,488,1,1,0,1,0

1,151,151,16,16,0,1,0
0,167,167,17,11,6,2,1

1,140,140,2,2,0,1,0
3,422,422,43,19,24,2,1
0,441,441,12,8,4,2,1
2,458,458,27,15,12,3,2

1,106,106,7,7,0,1,0
2,156,156,16,16,0,1,0
0,220,220,9,9,0,1,0

0,146,146,15,6,9,4,3
1,229,229,23,23,0,1,0

0,211,211,4,4,0,1,0
2,261,261,27,27,0,1,0
1,379,379,31,31,0,1,0

3,112,112,12,12,0,1,0
1,267,267,10,10,0,1,0
2,338,338,1,1,0,1,0
0,446,446,27,27,0,1,0

1,120,120,12,1,11,3,2
0,244,244,25,14,11,2,1

2,173,173,7,7,0,1,0
0,284,284,3,3,0,1,0
3,437,437,44,44,0,1,0
1,459,459,24,24,0,1,0

0,132,132,14,9,5,2,1
1,344,344,35,13,22,3,2

0,259,259,10,2,8,3,2
2,296,296,30,30,0,1,0
1,465,465,29,29,0,1,0

0,137,137,1,1,0,1,0
2,173,173,6,6,0,1,0
3,198,198,20,20,0,1,0
1,259,259,16,16,0,1,0

0,325,325,16,16,0,1,0
1,398,398,21,21,0,1,0
2,496,496,50,23,27,2,1

0,464,464,47,16,31,4,3
1,466,466,47,37,10,2,1

2,267,267,27,9,18,3,2
0,377,377,22,22,0,1,0
1,399,399,17,17,0,1,0

1,446,446,45,2,43,2,1
0,461,461,47,11,36,4,3

1,133,133,8,8,0,1,0
0,279,279,12,6,6,3,2
2,286,286,29,17,12,2,1

0,290,290,29,29,0,1,0
1,295,295,30,18,12,4,3

1,170,170,5,2,3,2,1
2,178,178,18,18,0,1,0
0,276,276,21,21,0,1,0

1,264,264,27,27,0,1,0
0,407,407,41,4,37,2,1

3,192,192,20,20,0,1,0
2,201,201,5,5,0,1,0
1,304,304,6,6,0,1,0
0,335,335,20,1,19,2,1

2,243,243,25,7,18,2,1
0,268,268,23,23,0,1,0
1,459,459,7,7,0,1,0

0,331,331,34,34,0,1,0
1,375,375,38,38,0,1,0

2,128,128,13,13,0,1,0
0,150,150,1,1,0,1,0
1,207,207,20,20,0,1,0

2,130,130,13,5,8,3,2
1,190,190,10,7,3,2,1
0,210,210,10,10,0,1,0

0,378,378,38,38,0,1,0
1,475,475,48,48,0,1,0

0,192,192,13,13,0,1,0
2,287,287,29,29,0,1,0
1,309,309,10,10,0,1,0

1,174,174,10,10,0,1,0
0,360,360,17,17,0,1,0
2,454,454,46,46,0,1,0

0,327,327,33,33,0,1,0
1,341,341,35,11,24,4,3

3,109,109,11,1,10,2,1
1,225,225,10,4,6,2,1
2,407,407,8,8,0,1,0
0,462,462,17,11,6,3,2

0,137,137,3,3,0,1,0
4,199,199,20,20,0,1,0
2,277,277,3,3,0,1,0
1,361,361,6,6,0,1,0
3,422,422,22,22,0,1,0

2,208,208,13,13,0,1,0
0,335,335,8,8,0,1,0
1,383,383,7,7,0,1,0
3,416,416,42,42,0,1,0

1,129,129,6,6,0,1,0
0,244,244,7,3,4,2,1
3,263,263,27,5,22,2,1
2,410,410,11,11,0,1,0

0,156,156,15,15,0,1,0
2,352,352,36,29,7,2,1
1,481,481,2,2,0,1,0

0,119,119,12,12,0,1,0
1,246,246,25,15,10,3,2

1,105,105,11,5,6,3,2
0,487,487,49,27,22,2,1

1,136,136,3,3,0,1,0
2,318,318,32,32,0,1,0
0,477,477,40,40,0,1,0

1,274,274,25,1,24,2,1
2,415,415,42,32,10,3,2
0,498,498,6,6,0,1,0

4,105,105,11,1,10,2,1
3,117,117,1,1,0,1,0
1,240,240,5,5,0,1,0
2,246,246,16,4,12,4,3
0,375,375,4,4,0,1,0

2,157,157,4,4,0,1,0
0,249,249,3,3,0,1,0
1,333,333,22,22,0,1,0
3,493,493,50,17,33,2,1

0,164,164,1,1,0,1,0
3,240,240,24,24,0,1,0
2,337,337,28,28,0,1,0
1,405,405,5,5,0,1,0

2,179,179,18,12,6,3,2
1,238,238,23,23,0,1,0
0,270,270,1,1,0,1,0

0,179,179,18,6,12,4,3
1,282,282,29,1,28,3,2

2,319,319,32,26,6,2,1
1,366,366,26,26,0,1,0
0,391,391,12,12,0,1,0

3,186,186,19,19,0,1,0
0,257,257,10,3,7,2,1
1,318,318,13,13,0,1,0
2,349,349,8,8,0,1,0

4,222,222,23,23,0,1,0
1,290,290,5,5,0,1,0
2,350,350,20,15,5,2,1
0,393,393,9,3,6,2,1
3,489,489,2,2,0,1,0

3,298,298,30,30,0,1,0
1,311,311,9,9,0,1,0
2,340,340,2,2,0,1,0
0,486,486,33,33,0,1,0

5,135,135,14,1,13,3,2
1,196,196,1,1,0,1,0
4,212,212,8,8,0,1,0
2,217,217,1,1,0,1,0
0,396,396,19,3,16,2,1
3,424,424,2,2,0,1,0

2,139,139,5,5,0,1,0
1,247,247,14,2,12,3,2
3,319,319,1,1,0,1,0
5,325,325,33,13,20,2,1
0,348,348,1,1,0,1,0
4,489,489,1,1,0,1,0

2,284,284,29,29,0,1,0
0,287,287,15,15,0,1,0
1,370,370,18,18,0,1,0

0,237,237,12,12,0,1,0
2,337,337,34,34,0,1,0
1,387,387,20,20,0,1,0

1,204,204,21,21,0,1,0
0,479,479,48,18,30,2,1

1,114,114,2,2,0,1,0
3,216,216,22,22,0,1,0
2,236,236,3,3,0,1,0
0,300,300,21,21,0,1,0

2,108,108,10,5,5,2,1
0,129,129,1,1,0,1,0
1,272,272,1,1,0,1,0
3,409,409,41,41,0,1,0

2,195,195,1,1,0,1,0
0,284,284,19,1,18,3,2
4,312,312,32,26,6,3,2
3,318,318,3,3,0,1,0
1,349,349,7,7,0,1,0

0,128,128,1,1,0,1,0
1,211,211,2,2,0,1,0
4,249,249,25,13,12,4,3
3,310,310,25,25,0,1,0
2,405,405,1,1,0,1,0

0,335,335,34,34,0,1,0
1,418,418,42,25,17,2,1

2,132,132,14,14,0,1,0
1,148,148,7,7,0,1,0
0,178,178,10,10,0,1,0

1,137,137,12,12,0,1,0
2,165,165,17,17,0,1,0
0,277,277,5,5,0,1,0

0,126,126,6,6,0,1,0
3,156,156,1,1,0,1,0
4,272,272,28,28,0,1,0
2,310,310,7,7,0,1,0
1,438,438,13,13,0,1,0

1,144,144,9,9,0,1,0
0,238,238,1,1,0,1,0
4,307,307,31,22,9,2,1
2,357,357,5,5,0,1,0
3,469,469,10,10,0,1,0

0,210,210,22,13,9,4,3
1,302,302,31,13,18,3,2

0,307,307,31,1,30,2,1
1,498,498,50,8,42,3,2

2,101,101,5,5,0,1,0
4,120,120,12,12,0,1,0
3,229,229,3,3,0,1,0
0,245,245,1,1,0,1,0
1,417,417,15,5,10,2,1

3,116,116,12,12,0,1,0
0,323,323,12,12,0,1,0
1,423,423,24,3,21,4,3
2,497,497,4,4,0,1,0

3,264,264,27,27,0,1,0
2,269,269,16,3,13,2,1
0,366,366,5,5,0,1,0
1,427,427,13,13,0,1,0

1,220,220,22,22,0,1,0
0,391,391,40,40,0,1,0

1,314,314,13,3,10,3,2
0,331,331,11,11,0,1,0
2,359,359,10,10,0,1,0
3,468,468,47,14,33,4,3

0,107,107,3,3,0,1,0
1,121,121,2,2,0,1,0
4,265,265,4,4,0,1,0
3,340,340,11,3,8,2,1
5,383,383,39,6,33,4,3
2,393,393,4,4,0,1,0

3,267,267,27,13,14,3,2
0,306,306,13,4,9,2,1
1,368,368,10,10,0,1,0
2,486,486,15,15,0,1,0

0,181,181,2,2,0,1,0
2,209,209,8,8,0,1,0
4,318,318,32,12,20,4,3
1,321,321,13,2,11,2,1
3,334,334,4,4,0,1,0

1,147,147,8,8,0,1,0
2,175,175,18,18,0,1,0
0,277,277,14,14,0,1,0

2,396,396,40,40,0,1,0
1,427,427,6,6,0,1,0
0,442,442,38,38,0,1,0

1,237,237,10,10,0,1,0
3,269,269,4,4,0,1,0
0,371,371,12,12,0,1,0
4,475,475,48,48,0,1,0
2,495,495,7,2,5,2,1

1,251,251,26,26,0,1,0
0,257,257,26,26,0,1,0

4,204,204,21,21,0,1,0
3,214,214,1,1,0,1,0
1,400,400,4,4,0,1,0
2,443,443,19,10,9,4,3
0,469,469,22,22,0,1,0

0,175,175,18,6,12,3,2
1,439,439,44,44,0,1,0

0,156,156,16,3,13,4,3
1,464,464,47,47,0,1,0

1,172,172,4,4,0,1,0
2,253,253,26,8,18,3,2
0,305,305,25,25,0,1,0

2,339,339,34,34,0,1,0
1,392,392,29,29,0,1,0
0,469,469,13,10,3,2,1

1,439,439,4,4,0,1,0
2,454,454,46,46,0,1,0
0,471,471,43,43,0,1,0

1,254,254,20,4,16,2,1
2,357,357,36,36,0,1,0
0,473,473,11,3,8,3,2

1,298,298,3,3,0,1,0
2,316,316,32,32,0,1,0
0,485,485,44,44,0,1,0

0,107,107,5,5,0,1,0
1,265,265,15,15,0,1,0
2,280,280,28,5,23,2,1

0,162,162,17,7,10,3,2
1,216,216,22,22,0,1,0

2,234,234,24,24,0,1,0
1,323,323,9,2,7,3,2
0,442,442,32,26,6,2,1

0,314,314,32,3,29,2,1
1,445,445,45,45,0,1,0

4,105,105,11,11,0,1,0
3,135,135,1,1,0,1,0
2,260,260,8,1,7,2,1
0,392,392,22,12,10,3,2
1,429,429,4,1,3,2,1

2,252,252,26,14,12,2,1
1,307,307,30,2,28,2,1
0,434,434,1,1,0,1,0

2,155,155,16,16,0,1,0
0,314,314,21,21,0,1,0
1,325,325,11,11,0,1,0

0,165,165,8,2,6,2,1
2,435,435,44,35,9,2,1
1,445,445,23,23,0,1,0

3,174,174,18,6,12,4,3
0,283,283,1,1,0,1,0
2,342,342,16,16,0,1,0
1,402,402,20,20,0,1,0

0,147,147,5,5,0,1,0
1,158,158,7,7,0,1,0
2,185,185,5,5,0,1,0
3,496,496,50,11,39,2,1

0,300,300,23,23,0,1,0
2,341,341,35,11,24,4,3
1,493,493,12,12,0,1,0

3,176,176,1,1,0,1,0
1,310,310,1,1,0,1,0
0,317,317,27,1,26,3,2
2,365,365,3,3,0,1,0
4,376,376,38,38,0,1,0

1,175,175,8,4,4,2,1
2,277,277,28,28,0,1,0
0,478,478,26,26,0,1,0

4,129,129,2,2,0,1,0
5,294,294,30,30,0,1,0
1,423,423,18,13,5,2,1
3,465,465,12,12,0,1,0
2,472,472,2,2,0,1,0
0,491,491,6,2,4,2,1

2,219,219,22,8,14,3,2
1,319,319,21,21,0,1,0
0,380,380,13,13,0,1,0

1,103,103,10,10,0,1,0
0,234,234,1,1,0,1,0
2,338,338,34,19,15,4,3

2,190,190,9,9,0,1,0
3,202,202,21,6,15,2,1
0,448,448,20,20,0,1,0
1,496,496,6,6,0,1,0

1,429,429,43,43,0,1,0
0,447,447,45,11,34,3,2

2,175,175,18,1,17,4,3
1,192,192,16,11,5,2,1
0,197,197,4,4,0,1,0

3,194,194,20,8,12,2,1
0,228,228,12,12,0,1,0
2,228,228,2,2,0,1,0
1,370,370,15,2,13,2,1

3,210,210,21,6,15,4,3
1,214,214,1,1,0,1,0
2,384,384,6,6,0,1,0
0,486,486,40,31,9,4,3

0,108,108,11,11,0,1,0
1,110,110,11,11,0,1,0

2,212,212,22,4,18,2,1
1,269,269,12,12,0,1,0
0,393,393,23,8,15,4,3

1,172,172,18,18,0,1,0
0,368,368,37,19,18,4,3

0,407,407,1,1,0,1,0
2,460,460,46,46,0,1,0
1,479,479,47,7,40,3,2

2,167,167,17,4,13,4,3
0,317,317,6,3,3,2,1
1,382,382,31,31,0,1,0

3,340,340,34,2,32,3,2
1,356,356,2,2,0,1,0
0,387,387,17,5,12,3,2
2,487,487,25,10,15,4,3

1,236,236,3,3,0,1,0
2,435,435,44,35,9,2,1
0,484,484,43,27,16,4,3

1,128,128,13,13,0,1,0
0,437,437,44,8,36,2,1

0,281,281,29,29,0,1,0
1,283,283,29,29,0,1,0

3,181,181,19,9,10,2,1
1,221,221,1,1,0,1,0
2,292,292,22,22,0,1,0
0,415,415,9,3,6,3,2

2,193,193,20,17,3,2,1
0,206,206,12,12,0,1,0
1,307,307,13,5,8,3,2

0,122,122,13,13,0,1,0
1,391,391,40,22,18,4,3

1,137,137,10,1,9,4,3
2,163,163,17,12,5,2,1
0,274,274,8,2,6,3,2

2,215,215,22,22,0,1,0
0,264,264,4,4,0,1,0
1,349,349,30,30,0,1,0

0,119,119,12,12,0,1,0
1,490,490,49,49,0,1,0

0,151,151,16,16,0,1,0
1,253,253,26,20,6,2,1

1,316,316,32,32,0,1,0
0,401,401,41,41,0,1,0

0,229,229,23,23,0,1,0
1,321,321,33,33,0,1,0

2,227,227,23,3,20,3,2
1,231,231,13,13,0,1,0
0,259,259,12,12,0,1,0

0,170,170,3,3,0,1,0
3,185,185,1,1,0,1,0
1,235,235,16,16,0,1,0
2,251,251,3,3,0,1,0
4,500,500,50,50,0,1,0

2,152,152,2,2,0,1,0
3,188,188,1,1,0,1,0
0,292,292,18,18,0,1,0
4,295,295,30,30,0,1,0
1,387,387,9,9,0,1,0

1,356,356,36,36,0,1,0
0,383,383,39,29,10,3,2

1,305,305,7,1,6,3,2
0,327,327,26,26,0,1,0
2,481,481,49,13,36,3,2

3,106,106,11,11,0,1,0
2,117,117,5,5,0,1,0
0,228,228,5,5,0,1,0
1,461,461,20,20,0,1,0

3,126,126,3,3,0,1,0
0,194,194,2,2,0,1,0
2,200,200,4,1,3,2,1
1,246,246,7,7,0,1,0
5,257,257,26,7,19,2,1
4,296,296,6,6,0,1,0

0,485,485,49,11,38,4,3
1,491,491,50,26,24,2,1

1,116,116,12,4,8,3,2
0,451,451,46,15,31,4,3

1,414,414,42,6,36,4,3
0,460,460,46,19,27,4,3

0,147,147,1,1,0,1,0
2,147,147,11,11,0,1,0
1,287,287,6,6,0,1,0
3,346,346,35,35,0,1,0

1,131,131,14,14,0,1,0
0,193,193,20,20,0,1,0

1,174,174,16,1,15,4,3
0,239,239,2,2,0,1,0
2,457,457,46,36,10,2,1

3,122,122,1,1,0,1,0
4,125,125,13,7,6,3,2
0,396,396,20,20,0,1,0
2,415,415,13,13,0,1,0
1,477,477,6,6,0,1,0

0,343,343,35,1,34,2,1
1,396,396,40,40,0,1,0

3,148,148,6,6,0,1,0
4,288,288,29,11,18,2,1
2,303,303,4,4,0,1,0
0,378,378,2,2,0,1,0
1,451,451,21,12,9,2,1

0,211,211,22,22,0,1,0
1,352,352,36,36,0,1,0

0,257,257,9,1,8,3,2
2,345,345,35,2,33,3,2
1,411,411,27,12,15,2,1

0,207,207,20,12,8,2,1
2,265,265,27,27,0,1,0
1,487,487,2,2,0,1,0

0,107,107,11,11,0,1,0
1,111,111,12,12,0,1,0

0,156,156,16,1,15,4,3
1,325,325,33,1,32,2,1

4,159,159,16,3,13,3,2
1,312,312,3,3,0,1,0
3,316,316,25,2,23,3,2
0,452,452,2,2,0,1,0
2,486,486,4,4,0,1,0

1,114,114,3,3,0,1,0
3,342,342,8,2,6,3,2
4,390,390,39,3,36,3,2
0,414,414,17,17,0,1,0
2,414,414,5,5,0,1,0

2,110,110,1,1,0,1,0
5,113,113,12,3,9,4,3
3,152,152,1,1,0,1,0
0,197,197,4,4,0,1,0
1,427,427,3,3,0,1,0
4,488,488,28,28,0,1,0

3,129,129,13,13,0,1,0
0,298,298,7,4,3,2,1
2,307,307,23,23,0,1,0
1,368,368,1,1,0,1,0

1,176,176,18,18,0,1,0
0,305,305,31,31,0,1,0

0,169,169,17,8,9,4,3
1,212,212,22,7,15,2,1

0,195,195,1,1,0,1,0
2,299,299,5,5,0,1,0
3,382,382,3,3,0,1,0
4,441,441,45,3,42,4,3
1,486,486,35,8,27,3,2

1,191,191,20,8,12,2,1
0,240,240,24,13,11,2,1

1,399,399,40,22,18,4,3
0,453,453,46,22,24,2,1

1,145,145,5,5,0,1,0
2,149,149,10,10,0,1,0
0,337,337,1,1,0,1,0
3,499,499,50,50,0,1,0

3,159,159,16,6,10,2,1
1,258,258,1,1,0,1,0
0,271,271,7,2,5,2,1
2,285,285,21,21,0,1,0

1,147,147,15,15,0,1,0
0,212,212,22,18,4,2,1

2,277,277,28,9,19,2,1
0,460,460,33,33,0,1,0
1,475,475,14,5,9,2,1

2,299,299,30,30,0,1,0
1,353,353,34,13,21,2,1
0,359,359,2,2,0,1,0

0,315,315,32,32,0,1,0
1,343,343,35,6,29,4,3

0,102,102,11,7,4,2,1
1,323,323,33,19,14,4,3

0,147,147,3,3,0,1,0
2,263,263,13,6,7,2,1
3,335,335,34,34,0,1,0
1,435,435,14,14,0,1,0

2,207,207,7,7,0,1,0
0,268,268,9,9,0,1,0
1,348,348,12,2,10,2,1
3,348,348,35,22,13,2,1

0,257,257,13,13,0,1,0
1,275,275,10,10,0,1,0
2,342,342,5,5,0,1,0
3,490,490,49,15,34,2,1

0,126,126,13,13,0,1,0
1,365,365,37,1,36,4,3

2,250,250,25,9,16,4,3
0,253,253,5,5,0,1,0
1,414,414,34,1,33,4,3

3,190,190,19,19,0,1,0
2,296,296,14,2,12,4,3
1,318,318,13,13,0,1,0
0,321,321,4,4,0,1,0

0,162,162,9,3,6,2,1
2,163,163,17,4,13,2,1
1,307,307,14,14,0,1,0

1,121,121,3,3,0,1,0
0,152,152,11,7,4,2,1
2,225,225,1,1,0,1,0
3,248,248,25,19,6,2,1

0,133,133,14,10,4,2,1
1,403,403,41,36,5,2,1

0,373,373,38,38,0,1,0
1,442,442,45,29,16,3,2

1,277,277,6,3,3,2,1
0,361,361,23,8,15,2,1
3,411,411,42,42,0,1,0
2,497,497,8,8,0,1,0

2,297,297,30,11,19,2,1
1,333,333,7,7,0,1,0
0,351,351,28,28,0,1,0

0,101,101,7,7,0,1,0
2,266,266,27,19,8,3,2
1,328,328,11,3,8,3,2

3,206,206,21,21,0,1,0
0,267,267,15,15,0,1,0
1,303,303,11,11,0,1,0
2,428,428,4,4,0,1,0

1,154,154,15,1,14,2,1
2,341,341,35,35,0,1,0
0,458,458,3,3,0,1,0

0,156,156,10,1,9,4,3
2,211,211,22,22,0,1,0
1,315,315,12,4,8,2,1

1,329,329,33,12,21,2,1
0,445,445,45,45,0,1,0

0,143,143,1,1,0,1,0
3,194,194,20,3,17,2,1
2,303,303,20,7,13,3,2
1,356,356,10,10,0,1,0

0,296,296,30,3,27,4,3
1,349,349,35,35,0,1,0

0,298,298,30,30,0,1,0
1,498,498,50,31,19,3,2

0,177,177,3,3,0,1,0
2,348,348,29,29,0,1,0
3,363,363,37,37,0,1,0
1,498,498,1,1,0,1,0

0,115,115,12,12,0,1,0
1,296,296,30,2,28,2,1

3,130,130,13,1,12,4,3
2,143,143,13,13,0,1,0
0,181,181,2,2,0,1,0
1,393,393,1,1,0,1,0

1,114,114,12,12,0,1,0
0,260,260,26,15,11,2,1

0,412,412,42,24,18,3,2
1,419,419,42,9,33,4,3

0,217,217,1,1,0,1,0
2,225,225,6,6,0,1,0
1,267,267,19,9,10,2,1
3,466,466,47,3,44,2,1

0,194,194,8,8,0,1,0
2,310,310,31,31,0,1,0
1,454,454,27,6,21,3,2

1,106,106,11,11,0,1,0
0,334,334,34,5,29,3,2

0,133,133,6,1,5,2,1
2,134,134,4,4,0,1,0
3,230,230,23,23,0,1,0
1,463,463,14,14,0,1,0

1,184,184,19,5,14,3,2
0,339,339,34,10,24,2,1

1,190,190,6,6,0,1,0
0,306,306,22,22,0,1,0
2,315,315,32,17,15,2,1

0,255,255,5,1,4,2,1
2,277,277,28,28,0,1,0
1,359,359,29,8,21,4,3

1,206,206,21,21,0,1,0
0,360,360,37,37,0,1,0

0,129,129,13,7,6,2,1
1,262,262,27,27,0,1,0

2,163,163,17,2,15,4,3
1,205,205,9,9,0,1,0
0,301,301,18,6,12,3,2

2,182,182,10,10,0,1,0
0,244,244,11,11,0,1,0
1,414,414,2,2,0,1,0
3,450,450,45,45,0,1,0

1,126,126,1,1,0,1,0
0,186,186,7,1,6,2,1
3,247,247,25,3,22,2,1
2,293,293,16,16,0,1,0

1,241,241,24,10,14,2,1
0,439,439,2,2,0,1,0
2,479,479,48,48,0,1,0

0,137,137,3,3,0,1,0
2,223,223,23,6,17,2,1
1,350,350,28,28,0,1,0

0,229,229,23,2,21,3,2
1,320,320,32,29,3,2,1

0,174,174,8,8,0,1,0
3,197,197,20,20,0,1,0
1,316,316,2,2,0,1,0
2,333,333,16,16,0,1,0

3,196,196,2,2,0,1,0
1,325,325,12,9,3,2,1
4,359,359,36,14,22,3,2
2,417,417,14,14,0,1,0
0,459,459,11,11,0,1,0

2,243,243,25,25,0,1,0
0,454,454,43,43,0,1,0
1,479,479,3,3,0,1,0

3,187,187,19,7,12,4,3
1,195,195,5,1,4,2,1
0,213,213,13,13,0,1,0
2,415,415,6,6,0,1,0

2,247,247,25,25,0,1,0
1,303,303,8,1,7,2,1
0,393,393,29,9,20,3,2

1,118,118,4,4,0,1,0
0,196,196,13,10,3,2,1
2,220,220,22,22,0,1,0

1,264,264,27,14,13,3,2
0,398,398,40,40,0,1,0

0,245,245,25,19,6,2,1
1,292,292,30,19,11,2,1

0,379,379,24,24,0,1,0
1,432,432,4,4,0,1,0
3,440,440,44,44,0,1,0
2,474,474,13,4,9,2,1

0,302,302,31,14,17,3,2
1,348,348,35,35,0,1,0

4,339,339,34,8,26,3,2
0,359,359,8,3,5,2,1
1,368,368,1,1,0,1,0
2,378,378,27,4,23,4,3
3,476,476,2,2,0,1,0

0,272,272,28,28,0,1,0
1,284,284,29,29,0,1,0

0,383,383,12,8,4,2,1
2,404,404,41,3,38,2,1
1,412,412,29,6,23,2,1

0,285,285,29,29,0,1,0
1,360,360,36,20,16,2,1

2,206,206,21,21,0,1,0
1,263,263,17,17,0,1,0
0,481,481,18,7,11,2,1

1,176,176,8,8,0,1,0
2,242,242,25,4,21,4,3
0,288,288,16,16,0,1,0

0,257,257,26,11,15,4,3
1,259,259,26,26,0,1,0

0,140,140,14,14,0,1,0
1,456,456,46,39,7,2,1

0,149,149,7,2,5,2,1
2,315,315,32,6,26,3,2
1,477,477,26,26,0,1,0

1,273,273,28,28,0,1,0
0,459,459,46,46,0,1,0

0,168,168,17,17,0,1,0
1,299,299,30,30,0,1,0

0,148,148,8,8,0,1,0
4,273,273,28,2,26,2,1
2,352,352,1,1,0,1,0
3,432,432,2,2,0,1,0
1,490,490,19,19,0,1,0

0,366,366,37,27,10,2,1
1,436,436,44,39,5,2,1

2,341,341,35,5,30,3,2
1,354,354,34,14,20,2,1
0,482,482,2,2,0,1,0

1,137,137,4,1,3,2,1
2,292,292,16,16,0,1,0
3,346,346,35,5,30,4,3
0,423,423,7,7,0,1,0

2,290,290,29,5,24,4,3
0,344,344,4,4,0,1,0
1,420,420,38,38,0,1,0

3,105,105,11,11,0,1,0
0,107,107,1,1,0,1,0
2,109,109,2,2,0,1,0
1,385,385,31,31,0,1,0

0,167,167,16,16,0,1,0
1,483,483,3,3,0,1,0
2,487,487,49,41,8,2,1

0,185,185,2,2,0,1,0
1,302,302,27,9,18,4,3
2,495,495,50,50,0,1,0

0,229,229,14,9,5,2,1
2,408,408,41,41,0,1,0
1,421,421,17,2,15,4,3

0,200,200,21,21,0,1,0
1,289,289,29,29,0,1,0

1,284,284,29,2,27,4,3
0,399,399,40,25,15,2,1

2,287,287,3,3,0,1,0
1,347,347,28,6,22,3,2
3,462,462,47,47,0,1,0
0,481,481,5,5,0,1,0

1,141,141,15,3,12,3,2
0,155,155,16,16,0,1,0

0,114,114,12,12,0,1,0
1,313,313,32,16,16,2,1

1,220,220,19,19,0,1,0
0,320,320,5,5,0,1,0
2,382,382,39,39,0,1,0

2,233,233,7,7,0,1,0
4,272,272,5,5,0,1,0
1,370,370,4,4,0,1,0
5,423,423,43,1,42,4,3
0,455,455,4,4,0,1,0
3,463,463,16,10,6,3,2

1,137,137,14,14,0,1,0
0,407,407,41,32,9,4,3

1,229,229,12,12,0,1,0
0,252,252,10,10,0,1,0
2,396,396,4,1,3,2,1
3,411,411,42,15,27,4,3

2,139,139,14,2,12,2,1
1,468,468,46,46,0,1,0
0,472,472,1,1,0,1,0

0,108,108,11,8,3,2,1
1,228,228,23,23,0,1,0

4,134,134,14,1,13,4,3
3,141,141,3,3,0,1,0
0,303,303,21,21,0,1,0
1,363,363,1,1,0,1,0
2,422,422,3,3,0,1,0

2,119,119,1,1,0,1,0
3,160,160,16,10,6,3,2
1,363,363,22,22,0,1,0
0,381,381,15,5,10,3,2

1,219,219,22,8,14,3,2
0,455,455,46,7,39,4,3

1,112,112,1,1,0,1,0
0,194,194,18,18,0,1,0
2,225,225,23,5,18,4,3

0,122,122,13,13,0,1,0
1,287,287,29,17,12,4,3

1,223,223,21,21,0,1,0
2,313,313,32,32,0,1,0
0,406,406,4,4,0,1,0

1,108,108,11,11,0,1,0
0,122,122,13,13,0,1,0

2,195,195,20,20,0,1,0
0,202,202,10,4,6,3,2
1,320,320,17,8,9,2,1

3,198,198,20,6,14,2,1
2,204,204,3,3,0,1,0
1,382,382,1,1,0,1,0
0,439,439,38,22,16,3,2

1,112,112,2,2,0,1,0
2,146,146,6,6,0,1,0
3,169,169,17,17,0,1,0
0,272,272,13,13,0,1,0

3,142,142,1,1,0,1,0
1,238,238,17,17,0,1,0
0,306,306,7,7,0,1,0
4,365,365,37,37,0,1,0
2,426,426,2,2,0,1,0

1,125,125,9,1,8,3,2
0,307,307,10,10,0,1,0
2,319,319,32,32,0,1,0

1,316,316,32,4,28,3,2
0,497,497,50,13,37,2,1

0,171,171,18,4,14,2,1
1,193,193,20,2,18,4,3

2,159,159,16,16,0,1,0
1,337,337,23,8,15,4,3
0,377,377,13,13,0,1,0

1,223,223,6,2,4,2,1
3,348,348,35,35,0,1,0
2,351,351,8,8,0,1,0
0,454,454,23,15,8,2,1

0,192,192,20,20,0,1,0
1,458,458,46,2,44,3,2

2,148,148,15,15,0,1,0
0,411,411,25,8,17,2,1
1,472,472,19,19,0,1,0

0,140,140,14,14,0,1,0
1,396,396,40,19,21,2,1

0,150,150,15,9,6,2,1
1,237,237,24,14,10,3,2

1,196,196,16,16,0,1,0
0,252,252,5,5,0,1,0
2,436,436,44,44,0,1,0

1,446,446,45,45,0,1,0
0,477,477,48,32,16,3,2

2,109,109,6,3,3,2,1
1,138,138,1,1,0,1,0
3,463,463,47,47,0,1,0
0,476,476,18,18,0,1,0

0,125,125,1,1,0,1,0
2,201,201,3,3,0,1,0
1,303,303,24,24,0,1,0
3,405,405,41,29,12,3,2

0,183,183,11,11,0,1,0
1,347,347,14,14,0,1,0
2,385,385,39,39,0,1,0

2,125,125,13,7,6,3,2
1,336,336,12,12,0,1,0
0,406,406,27,27,0,1,0

0,274,274,28,16,12,3,2
1,469,469,47,7,40,3,2

2,100,100,3,3,0,1,0
0,168,168,12,3,9,4,3
1,460,460,1,1,0,1,0
3,487,487,49,1,48,2,1

0,182,182,19,19,0,1,0
1,393,393,40,5,35,2,1

0,176,176,16,12,4,2,1
2,277,277,28,28,0,1,0
1,446,446,5,5,0,1,0

1,145,145,13,13,0,1,0
0,153,153,2,2,0,1,0
2,467,467,47,47,0,1,0

2,195,195,20,10,10,2,1
1,233,233,20,20,0,1,0
0,365,365,6,6,0,1,0

1,129,129,4,4,0,1,0
2,293,293,30,7,23,3,2
0,431,431,31,31,0,1,0

1,201,201,14,7,7,2,1
2,247,247,25,9,16,3,2
0,387,387,13,5,8,3,2

1,150,150,15,15,0,1,0
0,478,478,48,34,14,2,1

0,331,331,18,18,0,1,0
1,468,468,22,22,0,1,0
2,473,473,48,14,34,2,1

1,303,303,30,22,8,2,1
0,372,372,1,1,0,1,0
2,397,397,40,4,36,2,1

2,100,100,10,10,0,1,0
1,118,118,6,6,0,1,0
0,432,432,24,24,0,1,0

0,124,124,13,3,10,2,1
1,147,147,15,2,13,2,1

0,249,249,25,25,0,1,0
1,464,464,47,47,0,1,0

5,151,151,16,16,0,1,0
2,169,169,4,4,0,1,0
4,293,293,3,3,0,1,0
3,397,397,20,20,0,1,0
1,422,422,6,2,4,2,1
0,479,479,1,1,0,1,0

4,133,133,14,9,5,2,1
0,141,141,9,9,0,1,0
2,332,332,8,4,4,2,1
1,453,453,5,1,4,2,1
3,496,496,1,1,0,1,0

0,137,137,2,2,0,1,0
2,166,166,7,7,0,1,0
1,273,273,12,3,9,4,3
3,275,275,28,28,0,1,0

0,121,121,7,7,0,1,0
2,210,210,9,3,6,3,2
1,360,360,1,1,0,1,0
3,409,409,41,23,18,4,3

2,174,174,7,1,6,2,1
3,174,174,18,4,14,4,3
1,277,277,15,15,0,1,0
0,440,440,4,1,3,2,1

0,193,193,20,20,0,1,0
1,407,407,41,41,0,1,0

0,260,260,26,6,20,3,2
1,401,401,41,8,33,4,3

0,316,316,32,22,10,2,1
1,368,368,37,37,0,1,0

0,175,175,18,18,0,1,0
1,248,248,25,25,0,1,0

0,200,200,18,18,0,1,0
2,333,333,34,14,20,2,1
1,450,450,5,5,0,1,0

1,136,136,14,7,7,2,1
0,167,167,17,2,15,4,3

1,215,215,22,4,18,4,3
0,234,234,24,24,0,1,0

0,109,109,1,1,0,1,0
2,132,132,14,2,12,4,3
1,334,334,31,8,23,2,1

2,140,140,14,5,9,2,1
0,355,355,33,8,25,2,1
1,466,466,4,4,0,1,0

0,182,182,19,7,12,4,3
1,353,353,36,5,31,2,1

2,238,238,4,4,0,1,0
3,371,371,38,38,0,1,0
1,390,390,31,22,9,4,3
0,443,443,3,3,0,1,0

0,192,192,20,20,0,1,0
1,425,425,43,9,34,3,2

0,217,217,22,22,0,1,0
1,312,312,32,32,0,1,0

2,192,192,5,2,3,2,1
3,210,210,21,4,17,3,2
1,305,305,17,8,9,2,1
0,307,307,7,3,4,2,1

3,174,174,18,9,9,2,1
2,353,353,27,22,5,2,1
0,405,405,4,4,0,1,0
1,478,478,7,1,6,3,2

2,103,103,5,5,0,1,0
0,121,121,4,4,0,1,0
3,390,390,39,39,0,1,0
1,420,420,8,8,0,1,0

2,103,103,11,3,8,3,2
1,279,279,26,26,0,1,0
0,431,431,3,3,0,1,0

1,104,104,10,10,0,1,0
2,145,145,15,11,4,2,1
0,414,414,2,2,0,1,0

0,258,258,26,26,0,1,0
1,463,463,47,47,0,1,0

2,147,147,15,1,14,3,2
1,313,313,25,25,0,1,0
0,429,429,10,5,5,2,1

1,190,190,19,10,9,4,3
0,218,218,22,11,11,2,1

1,208,208,21,9,12,2,1
0,245,245,25,25,0,1,0

1,290,290,23,2,21,4,3
3,304,304,31,31,0,1,0
0,456,456,6,3,3,2,1
2,498,498,4,4,0,1,0

0,275,275,28,7,21,2,1
1,417,417,42,6,36,4,3

1,219,219,18,18,0,1,0
0,230,230,5,5,0,1,0
2,429,429,43,17,26,3,2

2,207,207,10,10,0,1,0
0,405,405,20,20,0,1,0
1,473,473,3,3,0,1,0
3,491,491,50,32,18,2,1

0,160,160,17,11,6,2,1
1,389,389,39,17,22,3,2

1,291,291,14,3,11,2,1
2,334,334,34,9,25,2,1
0,367,367,20,20,0,1,0

1,139,139,14,3,11,2,1
0,448,448,45,11,34,2,1

1,141,141,15,15,0,1,0
0,261,261,27,21,6,2,1

1,301,301,23,23,0,1,0
0,415,415,11,11,0,1,0
2,467,467,47,47,0,1,0

2,163,163,17,9,8,2,1
0,201,201,15,5,10,3,2
1,489,489,13,1,12,4,3

1,160,160,16,16,0,1,0
0,274,274,28,9,19,2,1

1,237,237,23,23,0,1,0
2,437,437,44,2,42,4,3
0,460,460,2,2,0,1,0

1,108,108,11,11,0,1,0
0,390,390,40,40,0,1,0

0,276,276,28,28,0,1,0
1,355,355,36,23,13,2,1

4,177,177,18,18,0,1,0
0,200,200,1,1,0,1,0
1,201,201,8,8,0,1,0
2,315,315,13,13,0,1,0
3,427,427,6,6,0,1,0

0,106,106,1,1,0,1,0
2,424,424,43,25,18,4,3
1,494,494,45,21,24,3,2

4,147,147,15,15,0,1,0
2,277,277,10,10,0,1,0
1,295,295,2,2,0,1,0
0,341,341,1,1,0,1,0
3,494,494,27,27,0,1,0

1,131,131,5,5,0,1,0
0,402,402,20,3,17,2,1
3,430,430,43,1,42,3,2
2,432,432,6,6,0,1,0

1,190,190,1,1,0,1,0
0,218,218,21,1,20,3,2
2,309,309,31,8,23,2,1

1,152,152,4,4,0,1,0
3,229,229,23,8,15,4,3
0,336,336,15,15,0,1,0
2,387,387,12,12,0,1,0

0,221,221,11,5,6,3,2
2,346,346,35,35,0,1,0
1,369,369,19,4,15,4,3

0,139,139,14,8,6,3,2
1,404,404,41,41,0,1,0

0,164,164,17,17,0,1,0
1,384,384,39,39,0,1,0

0,213,213,22,13,9,4,3
1,388,388,39,13,26,3,2

0,157,157,8,8,0,1,0
1,224,224,11,2,9,4,3
2,314,314,32,23,9,2,1

0,195,195,20,20,0,1,0
1,479,479,48,27,21,4,3

2,154,154,10,10,0,1,0
1,273,273,5,5,0,1,0
3,288,288,29,29,0,1,0
0,443,443,8,5,3,2,1

1,462,462,47,29,18,4,3
0,499,499,50,50,0,1,0

1,125,125,13,7,6,2,1
0,133,133,14,14,0,1,0

0,372,372,38,38,0,1,0
1,393,393,40,9,31,2,1

1,149,149,7,7,0,1,0
3,163,163,17,17,0,1,0
0,433,433,6,6,0,1,0
2,466,466,19,10,9,4,3

1,119,119,12,12,0,1,0
0,416,416,42,42,0,1,0

2,383,383,29,9,20,2,1
1,385,385,5,5,0,1,0
3,444,444,45,15,30,4,3
0,448,448,6,6,0,1,0

2,345,345,35,35,0,1,0
1,356,356,29,29,0,1,0
0,453,453,9,9,0,1,0

0,376,376,38,11,27,3,2
1,484,484,49,39,10,2,1

0,239,239,24,24,0,1,0
1,362,362,37,1,36,4,3

0,131,131,4,4,0,1,0
1,201,201,14,14,0,1,0
2,443,443,45,10,35,2,1

0,103,103,7,4,3,2,1
2,283,283,8,8,0,1,0
1,290,290,2,2,0,1,0
3,415,415,42,2,40,2,1

2,282,282,29,24,5,2,1
0,329,329,10,4,6,3,2
1,495,495,35,35,0,1,0

0,271,271,28,12,16,3,2
1,330,330,33,33,0,1,0

2,400,400,40,40,0,1,0
0,440,440,43,43,0,1,0
1,495,495,2,2,0,1,0

2,161,161,1,1,0,1,0
1,194,194,2,2,0,1,0
0,244,244,1,1,0,1,0
4,301,301,31,31,0,1,0
3,432,432,35,35,0,1,0

1,420,420,42,42,0,1,0
0,453,453,46,46,0,1,0

1,384,384,39,1,38,2,1
0,482,482,49,39,10,2,1

1,250,250,23,23,0,1,0
0,253,253,3,3,0,1,0
2,264,264,27,12,15,4,3

1,188,188,1,1,0,1,0
2,239,239,24,24,0,1,0
0,305,305,30,30,0,1,0

1,243,243,25,25,0,1,0
0,413,413,42,18,24,4,3

1,197,197,20,20,0,1,0
0,487,487,49,31,18,4,3

2,112,112,12,1,11,2,1
1,307,307,4,4,0,1,0
0,500,500,44,44,0,1,0

0,175,175,18,5,13,2,1
1,446,446,45,45,0,1,0

2,100,100,10,10,0,1,0
0,150,150,2,2,0,1,0
1,410,410,36,30,6,2,1

1,219,219,18,18,0,1,0
0,407,407,9,9,0,1,0
2,472,472,48,45,3,2,1

1,100,100,8,8,0,1,0
3,217,217,22,22,0,1,0
2,394,394,4,1,3,2,1
0,499,499,5,5,0,1,0

0,452,452,46,46,0,1,0
1,499,499,50,50,0,1,0

0,163,163,17,4,13,2,1
1,214,214,22,2,20,2,1

2,257,257,26,26,0,1,0
1,408,408,14,14,0,1,0
0,478,478,32,32,0,1,0

0,189,189,19,19,0,1,0
1,302,302,31,31,0,1,0

0,364,364,37,9,28,3,2
1,373,373,38,38,0,1,0

0,107,107,10,10,0,1,0
2,440,440,44,24,20,3,2
1,478,478,4,1,3,2,1

1,325,325,19,5,14,3,2
0,432,432,18,6,12,2,1
2,468,468,47,18,29,4,3

1,202,202,21,21,0,1,0
0,268,268,27,27,0,1,0

0,383,383,1,1,0,1,0
1,430,430,42,42,0,1,0
2,478,478,48,18,30,2,1

0,256,256,24,10,14,3,2
1,406,406,3,3,0,1,0
2,454,454,46,46,0,1,0

0,154,154,5,5,0,1,0
2,221,221,23,23,0,1,0
1,263,263,18,3,15,4,3

2,296,296,22,22,0,1,0
1,359,359,8,5,3,2,1
3,440,440,44,44,0,1,0
0,464,464,2,2,0,1,0

0,190,190,2,2,0,1,0
1,226,226,21,2,19,3,2
2,307,307,31,1,30,3,2

0,153,153,1,1,0,1,0
1,208,208,5,5,0,1,0
2,353,353,25,8,17,2,1
3,491,491,50,10,40,3,2

1,323,323,33,19,14,2,1
0,396,396,40,22,18,3,2

2,193,193,20,20,0,1,0
1,221,221,20,20,0,1,0
0,354,354,4,4,0,1,0

2,231,231,24,18,6,2,1
0,327,327,26,11,15,4,3
1,482,482,10,10,0,1,0

1,193,193,8,8,0,1,0
0,338,338,20,12,8,2,1
2,425,425,43,3,40,3,2

1,120,120,4,4,0,1,0
0,140,140,10,1,9,4,3
2,219,219,22,6,16,2,1

2,223,223,23,23,0,1,0
1,262,262,18,9,9,4,3
0,303,303,10,10,0,1,0

2,228,228,12,12,0,1,0
0,311,311,1,1,0,1,0
3,336,336,34,34,0,1,0
1,451,451,20,20,0,1,0

1,315,315,4,4,0,1,0
0,418,418,37,9,28,3,2
2,480,480,48,48,0,1,0

1,279,279,4,1,3,2,1
2,308,308,31,31,0,1,0
0,408,408,35,18,17,2,1

2,102,102,4,4,0,1,0
1,135,135,7,7,0,1,0
0,296,296,5,1,4,2,1
3,336,336,34,6,28,3,2

3,112,112,12,3,9,2,1
1,226,226,1,1,0,1,0
2,357,357,15,15,0,1,0
0,384,384,21,21,0,1,0

3,122,122,1,1,0,1,0
5,180,180,18,12,6,3,2
2,274,274,3,3,0,1,0
4,309,309,5,5,0,1,0
0,320,320,20,20,0,1,0
1,412,412,1,1,0,1,0

0,204,204,2,2,0,1,0
1,311,311,29,17,12,4,3
2,369,369,37,19,18,3,2

0,369,369,9,3,6,3,2
1,407,407,31,5,26,3,2
2,498,498,50,29,21,4,3

0,261,261,11,1,10,3,2
1,263,263,16,5,11,2,1
2,347,347,35,26,9,2,1

2,254,254,24,24,0,1,0
3,358,358,36,12,24,2,1
1,416,416,3,3,0,1,0
0,458,458,1,1,0,1,0

1,292,292,22,13,9,2,1
2,354,354,36,36,0,1,0
0,358,358,9,2,7,2,1

1,318,318,31,1,30,3,2
0,443,443,2,2,0,1,0
2,452,452,46,46,0,1,0

1,338,338,34,26,8,3,2
0,440,440,44,27,17,2,1

0,108,108,11,2,9,4,3
1,477,477,48,48,0,1,0

1,138,138,14,10,4,2,1
0,270,270,27,13,14,3,2

0,102,102,11,11,0,1,0
1,121,121,13,3,10,2,1

1,132,132,4,1,3,2,1
2,169,169,5,2,3,2,1
3,392,392,40,40,0,1,0
0,441,441,18,18,0,1,0

0,189,189,19,19,0,1,0
1,300,300,30,4,26,2,1

0,121,121,13,13,0,1,0
1,169,169,17,7,10,3,2

0,124,124,13,8,5,2,1
1,432,432,44,44,0,1,0

0,195,195,20,11,9,4,3
1,208,208,21,13,8,2,1

2,106,106,5,5,0,1,0
1,134,134,4,4,0,1,0
0,230,230,6,2,4,2,1
3,340,340,34,18,16,2,1

1,204,204,21,21,0,1,0
0,470,470,47,47,0,1,0

2,125,125,13,13,0,1,0
0,128,128,10,10,0,1,0
1,330,330,8,8,0,1,0

1,207,207,21,14,7,2,1
0,322,322,33,33,0,1,0

0,307,307,21,1,20,4,3
1,435,435,14,14,0,1,0
2,449,449,45,33,12,3,2

0,243,243,14,14,0,1,0
1,268,268,12,6,6,2,1
2,415,415,42,42,0,1,0

2,193,193,6,6,0,1,0
0,253,253,3,3,0,1,0
3,336,336,13,13,0,1,0
1,367,367,7,3,4,2,1
4,500,500,50,50,0,1,0

1,180,180,18,15,3,2,1
0,205,205,21,21,0,1,0

2,106,106,2,2,0,1,0
1,310,310,18,6,12,4,3
0,338,338,10,10,0,1,0
3,370,370,37,7,30,2,1

0,119,119,4,4,0,1,0
1,154,154,2,2,0,1,0
2,341,341,1,1,0,1,0
3,350,350,10,10,0,1,0
4,489,489,11,1,10,2,1
5,497,497,50,50,0,1,0

0,235,235,2,2,0,1,0
2,494,494,50,41,9,4,3
1,500,500,46,8,38,4,3

1,234,234,4,4,0,1,0
2,400,400,9,1,8,2,1
0,435,435,27,27,0,1,0
3,452,452,46,30,16,4,3

0,148,148,6,2,4,2,1
1,233,233,14,14,0,1,0
2,488,488,49,49,0,1,0

3,131,131,1,1,0,1,0
0,149,149,8,8,0,1,0
1,151,151,2,2,0,1,0
5,164,164,1,1,0,1,0
6,201,201,21,6,15,2,1
4,402,402,7,7,0,1,0
2,438,438,3,3,0,1,0

0,305,305,29,5,24,3,2
1,314,314,1,1,0,1,0
2,365,365,1,1,0,1,0
3,489,489,49,49,0,1,0

2,203,203,3,3,0,1,0
1,214,214,12,12,0,1,0
0,303,303,10,2,8,3,2
3,452,452,46,5,41,4,3

2,101,101,11,5,6,3,2
0,445,445,7,3,4,2,1
1,469,469,40,31,9,4,3

1,254,254,26,26,0,1,0
0,468,468,47,47,0,1,0

0,278,278,17,17,0,1,0
1,338,338,14,14,0,1,0
2,447,447,45,9,36,3,2

0,110,110,1,1,0,1,0
3,191,191,20,12,8,3,2
1,294,294,4,4,0,1,0
2,461,461,36,27,9,2,1

0,145,145,5,5,0,1,0
2,218,218,10,6,4,2,1
4,389,389,39,39,0,1,0
1,424,424,8,8,0,1,0
3,434,434,1,1,0,1,0

3,103,103,11,5,6,2,1
2,376,376,16,16,0,1,0
0,423,423,13,8,5,2,1
1,433,433,12,12,0,1,0

1,176,176,18,15,3,2,1
0,498,498,50,9,41,2,1

0,359,359,36,36,0,1,0
1,414,414,42,11,31,4,3

0,121,121,13,13,0,1,0
1,383,383,39,12,27,2,1

1,380,380,36,36,0,1,0
0,417,417,3,3,0,1,0
2,473,473,48,30,18,2,1

0,164,164,5,2,3,2,1
1,187,187,13,7,6,2,1
2,359,359,36,4,32,3,2

3,114,114,3,3,0,1,0
2,130,130,1,1,0,1,0
0,131,131,8,8,0,1,0
4,378,378,38,22,16,3,2
1,473,473,3,3,0,1,0

1,165,165,5,2,3,2,1
3,176,176,18,18,0,1,0
0,335,335,9,9,0,1,0
2,490,490,21,9,12,3,2

0,269,269,10,10,0,1,0
1,292,292,19,19,0,1,0
2,313,313,32,32,0,1,0

0,229,229,13,13,0,1,0
1,322,322,14,14,0,1,0
2,453,453,46,30,16,3,2

0,256,256,4,4,0,1,0
1,311,311,25,18,7,2,1
2,339,339,2,2,0,1,0
3,370,370,37,23,14,3,2

0,114,114,12,4,8,2,1
1,210,210,21,5,16,3,2

1,140,140,1,1,0,1,0
0,276,276,7,7,0,1,0
3,286,286,29,8,21,2,1
2,370,370,25,14,11,2,1

0,159,159,16,5,11,2,1
1,288,288,29,29,0,1,0

3,238,238,9,9,0,1,0
0,380,380,1,1,0,1,0
2,446,446,19,4,15,2,1
4,483,483,49,49,0,1,0
1,488,488,9,9,0,1,0

0,117,117,4,4,0,1,0
3,257,257,5,5,0,1,0
2,324,324,10,10,0,1,0
4,465,465,47,10,37,2,1
1,481,481,9,9,0,1,0

1,243,243,25,25,0,1,0
0,256,256,26,6,20,2,1

0,149,149,15,12,3,2,1
1,224,224,23,9,14,2,1

2,157,157,16,16,0,1,0
0,159,159,4,4,0,1,0
1,195,195,15,4,11,2,1

0,120,120,12,12,0,1,0
1,422,422,43,43,0,1,0

0,230,230,23,9,14,3,2
1,458,458,46,46,0,1,0

0,388,388,23,23,0,1,0
2,465,465,47,47,0,1,0
1,493,493,21,21,0,1,0

1,298,298,9,9,0,1,0
0,322,322,23,23,0,1,0
2,366,366,37,37,0,1,0

1,269,269,27,1,26,3,2
0,309,309,31,9,22,2,1

2,239,239,24,7,17,3,2
0,320,320,8,5,3,2,1
1,333,333,25,25,0,1,0

0,167,167,17,17,0,1,0
1,173,173,18,4,14,2,1

1,426,426,43,8,35,2,1
0,437,437,44,4,40,2,1

0,210,210,22,22,0,1,0
1,212,212,22,22,0,1,0

0,296,296,30,22,8,2,1
1,331,331,34,10,24,3,2

1,219,219,22,22,0,1,0
0,425,425,43,43,0,1,0

0,282,282,1,1,0,1,0
5,291,291,30,30,0,1,0
2,401,401,9,9,0,1,0
1,471,471,18,6,12,2,1
4,490,490,11,11,0,1,0
3,493,493,7,7,0,1,0

0,134,134,8,8,0,1,0
1,295,295,12,12,0,1,0
2,430,430,43,43,0,1,0

1,270,270,12,12,0,1,0
4,380,380,38,2,36,4,3
0,404,404,13,8,5,2,1
2,460,460,6,3,3,2,1
3,483,483,5,5,0,1,0

1,289,289,29,23,6,3,2
0,446,446,45,23,22,2,1

0,120,120,2,2,0,1,0
3,179,179,3,3,0,1,0
2,181,181,5,1,4,2,1
1,438,438,19,19,0,1,0
4,472,472,48,22,26,3,2

2,143,143,15,15,0,1,0
1,205,205,4,4,0,1,0
0,458,458,39,39,0,1,0

2,366,366,14,14,0,1,0
0,383,383,17,11,6,3,2
1,386,386,7,7,0,1,0
3,389,389,39,13,26,3,2

2,171,171,4,4,0,1,0
3,205,205,21,21,0,1,0
1,455,455,7,4,3,2,1
0,478,478,31,31,0,1,0

0,212,212,21,21,0,1,0
1,271,271,1,1,0,1,0
2,392,392,40,40,0,1,0

1,144,144,15,9,6,3,2
0,422,422,43,43,0,1,0

1,141,141,6,6,0,1,0
3,200,200,20,2,18,2,1
2,345,345,20,6,14,2,1
0,493,493,1,1,0,1,0

0,180,180,19,19,0,1,0
1,422,422,43,43,0,1,0

0,151,151,16,16,0,1,0
1,418,418,42,42,0,1,0

3,140,140,14,7,7,2,1
1,351,351,2,2,0,1,0
2,392,392,33,5,28,2,1
0,447,447,5,5,0,1,0

0,182,182,4,4,0,1,0
1,262,262,21,21,0,1,0
2,441,441,45,45,0,1,0

1,268,268,27,27,0,1,0
0,301,301,31,3,28,4,3

2,347,347,29,11,18,2,1
3,386,386,39,39,0,1,0
1,392,392,2,2,0,1,0
0,419,419,5,5,0,1,0

0,146,146,13,13,0,1,0
1,345,345,4,1,3,2,1
2,366,366,37,37,0,1,0

0,346,346,35,16,19,2,1
1,457,457,46,46,0,1,0

1,356,356,17,17,0,1,0
0,390,390,21,3,18,3,2
2,437,437,44,44,0,1,0

0,301,301,31,4,27,4,3
1,352,352,36,36,0,1,0

0,103,103,2,2,0,1,0
3,164,164,17,17,0,1,0
1,211,211,7,7,0,1,0
2,243,243,12,12,0,1,0

0,203,203,8,5,3,2,1
3,282,282,29,3,26,4,3
2,448,448,2,2,0,1,0
1,470,470,27,27,0,1,0

1,155,155,16,6,10,2,1
0,204,204,21,4,17,3,2

1,172,172,13,1,12,2,1
2,193,193,20,20,0,1,0
0,246,246,7,1,6,3,2

2,215,215,22,8,14,2,1
0,394,394,35,26,9,4,3
1,476,476,6,6,0,1,0

1,201,201,5,5,0,1,0
2,270,270,11,7,4,2,1
3,282,282,29,29,0,1,0
0,413,413,15,15,0,1,0

0,439,439,44,26,18,4,3
1,498,498,50,50,0,1,0

0,238,238,24,9,15,2,1
1,425,425,43,11,32,2,1

2,105,105,11,4,7,2,1
1,246,246,15,15,0,1,0
0,387,387,16,3,13,2,1

1,213,213,22,22,0,1,0
0,325,325,33,3,30,2,1

1,309,309,12,12,0,1,0
2,373,373,38,38,0,1,0
0,393,393,25,20,5,2,1

0,148,148,11,11,0,1,0
2,186,186,19,19,0,1,0
1,218,218,6,6,0,1,0

2,181,181,19,19,0,1,0
0,362,362,21,21,0,1,0
1,390,390,17,1,16,3,2

1,174,174,1,1,0,1,0
2,182,182,5,1,4,2,1
4,185,185,19,10,9,4,3
0,189,189,2,2,0,1,0
3,466,466,27,27,0,1,0

1,299,299,30,30,0,1,0
0,309,309,31,31,0,1,0

4,101,101,11,11,0,1,0
3,202,202,6,6,0,1,0
2,261,261,8,8,0,1,0
1,303,303,7,7,0,1,0
0,485,485,10,1,9,4,3

3,107,107,11,6,5,2,1
2,224,224,16,16,0,1,0
0,372,372,10,10,0,1,0
1,439,439,1,1,0,1,0

0,306,306,31,5,26,4,3
1,368,368,37,30,7,2,1

2,117,117,12,12,0,1,0
1,159,159,6,1,5,2,1
0,458,458,29,29,0,1,0

1,249,249,23,15,8,3,2
2,322,322,33,5,28,3,2
0,451,451,4,4,0,1,0

2,146,146,15,15,0,1,0
0,373,373,24,3,21,2,1
1,435,435,16,16,0,1,0

2,122,122,1,1,0,1,0
4,172,172,7,7,0,1,0
0,192,192,4,4,0,1,0
6,237,237,24,24,0,1,0
1,296,296,3,3,0,1,0
5,372,372,3,3,0,1,0
3,432,432,6,6,0,1,0

1,469,469,47,47,0,1,0
0,476,476,48,16,32,2,1

1,150,150,10,10,0,1,0
0,163,163,4,4,0,1,0
2,205,205,2,2,0,1,0
3,429,429,43,28,15,4,3

2,280,280,28,10,18,2,1
0,496,496,24,24,0,1,0
1,496,496,26,26,0,1,0

2,125,125,13,13,0,1,0
0,158,158,2,2,0,1,0
1,318,318,28,28,0,1,0

1,130,130,2,2,0,1,0
0,140,140,6,6,0,1,0
2,413,413,17,3,14,3,2
3,435,435,1,1,0,1,0
4,475,475,48,48,0,1,0

4,107,107,1,1,0,1,0
5,127,127,13,13,0,1,0
0,222,222,6,2,4,2,1
1,406,406,6,3,3,2,1
3,418,418,21,21,0,1,0
2,493,493,1,1,0,1,0

0,113,113,12,5,7,2,1
1,286,286,29,8,21,2,1

0,180,180,14,8,6,3,2
2,246,246,3,3,0,1,0
1,291,291,3,3,0,1,0
3,406,406,41,29,12,2,1

5,181,181,19,4,15,3,2
0,230,230,1,1,0,1,0
2,409,409,10,2,8,2,1
4,425,425,26,11,15,2,1
1,426,426,4,4,0,1,0
3,482,482,1,1,0,1,0

0,273,273,28,7,21,2,1
1,276,276,28,28,0,1,0

1,247,247,16,16,0,1,0
2,354,354,36,3,33,4,3
0,361,361,13,13,0,1,0

0,140,140,14,1,13,2,1
1,421,421,43,23,20,2,1

1,186,186,19,19,0,1,0
0,310,310,31,17,14,3,2

2,105,105,4,4,0,1,0
0,166,166,10,10,0,1,0
3,171,171,18,8,10,3,2
1,417,417,2,2,0,1,0

1,116,116,4,1,3,2,1
2,153,153,1,1,0,1,0
5,178,178,18,18,0,1,0
4,227,227,11,2,9,2,1
3,293,293,2,2,0,1,0
0,299,299,2,2,0,1,0

0,102,102,1,1,0,1,0
1,104,104,1,1,0,1,0
4,120,120,12,1,11,2,1
2,417,417,25,2,23,4,3
3,471,471,10,5,5,2,1

0,239,239,7,7,0,1,0
2,308,308,31,31,0,1,0
1,457,457,33,5,28,2,1

2,113,113,12,6,6,2,1
0,346,346,13,10,3,2,1
1,497,497,32,32,0,1,0

1,182,182,19,19,0,1,0
0,202,202,21,21,0,1,0

2,129,129,13,3,10,2,1
0,162,162,15,15,0,1,0
1,207,207,2,2,0,1,0

1,191,191,20,6,14,3,2
0,495,495,50,50,0,1,0

0,100,100,2,2,0,1,0
1,145,145,1,1,0,1,0
4,204,204,3,3,0,1,0
6,269,269,27,13,14,2,1
3,351,351,1,1,0,1,0
2,426,426,6,6,0,1,0
5,463,463,20,20,0,1,0

1,118,118,12,4,8,2,1
0,498,498,50,50,0,1,0

0,130,130,2,2,0,1,0
1,218,218,19,7,12,3,2
2,330,330,33,3,30,4,3

1,138,138,14,14,0,1,0
0,420,420,43,27,16,3,2

1,122,122,8,8,0,1,0
2,333,333,2,2,0,1,0
0,354,354,11,11,0,1,0
3,397,397,40,7,33,2,1

0,117,117,12,6,6,3,2
1,401,401,41,41,0,1,0

2,206,206,21,11,10,2,1
1,224,224,22,7,15,4,3
0,281,281,1,1,0,1,0

2,218,218,22,22,0,1,0
1,315,315,24,9,15,4,3
0,342,342,9,6,3,2,1

1,107,107,7,1,6,3,2
2,374,374,38,16,22,2,1
0,448,448,17,2,15,4,3

2,140,140,6,6,0,1,0
0,152,152,4,4,0,1,0
3,178,178,18,5,13,2,1
1,317,317,10,10,0,1,0

2,301,301,31,4,27,2,1
0,332,332,32,2,30,2,1
1,390,390,2,2,0,1,0

0,301,301,28,18,10,2,1
1,307,307,3,3,0,1,0
2,374,374,38,38,0,1,0

0,123,123,1,1,0,1,0
2,406,406,41,41,0,1,0
1,456,456,42,33,9,4,3

2,139,139,1,1,0,1,0
4,159,159,16,16,0,1,0
3,228,228,1,1,0,1,0
1,410,410,5,5,0,1,0
0,445,445,35,35,0,1,0

1,125,125,13,13,0,1,0
0,401,401,41,41,0,1,0

0,298,298,30,30,0,1,0
1,308,308,31,27,4,2,1

1,287,287,28,12,16,3,2
2,293,293,30,30,0,1,0
0,375,375,1,1,0,1,0

0,146,146,15,15,0,1,0
1,279,279,28,14,14,2,1

1,153,153,16,16,0,1,0
0,380,380,39,12,27,4,3

2,282,282,29,29,0,1,0
1,408,408,12,12,0,1,0
0,420,420,30,26,4,2,1

1,133,133,5,2,3,2,1
0,175,175,11,8,3,2,1
2,222,222,23,23,0,1,0

1,301,301,31,31,0,1,0
0,490,490,49,10,39,4,3

1,113,113,12,12,0,1,0
2,202,202,21,21,0,1,0
0,470,470,1,1,0,1,0

1,152,152,1,1,0,1,0
0,296,296,28,28,0,1,0
2,463,463,47,47,0,1,0

2,364,364,37,22,15,2,1
1,427,427,35,28,7,2,1
0,460,460,9,9,0,1,0

0,297,297,30,30,0,1,0
1,421,421,43,3,40,2,1

0,188,188,19,19,0,1,0
1,244,244,25,25,0,1,0

0,230,230,23,14,9,4,3
1,322,322,33,2,31,2,1

1,185,185,2,2,0,1,0
0,345,345,32,32,0,1,0
2,474,474,48,33,15,2,1

1,162,162,17,17,0,1,0
0,209,209,21,7,14,3,2

1,400,400,9,9,0,1,0
2,467,467,47,11,36,3,2
0,487,487,38,38,0,1,0

1,209,209,21,17,4,2,1
0,275,275,1,1,0,1,0
2,388,388,39,39,0,1,0

0,209,209,21,21,0,1,0
1,339,339,34,1,33,4,3

0,122,122,13,7,6,2,1
1,499,499,50,40,10,2,1

0,204,204,21,21,0,1,0
1,461,461,47,10,37,3,2

0,129,129,5,5,0,1,0
2,218,218,22,3,19,3,2
1,246,246,16,2,14,2,1

2,190,190,19,7,12,3,2
1,262,262,14,14,0,1,0
0,397,397,20,20,0,1,0

2,204,204,21,21,0,1,0
1,417,417,19,1,18,2,1
0,427,427,24,24,0,1,0

3,220,220,5,5,0,1,0
1,287,287,1,1,0,1,0
4,310,310,31,31,0,1,0
2,318,318,11,11,0,1,0
0,370,370,16,16,0,1,0

0,229,229,23,13,10,2,1
1,376,376,38,38,0,1,0

4,123,123,2,2,0,1,0
0,232,232,3,3,0,1,0
5,294,294,30,30,0,1,0
3,313,313,4,4,0,1,0
2,391,391,7,1,6,2,1
1,490,490,23,23,0,1,0

0,184,184,14,14,0,1,0
2,244,244,25,19,6,2,1
1,273,273,7,7,0,1,0

1,107,107,10,2,8,2,1
0,110,110,1,1,0,1,0
2,196,196,20,20,0,1,0

2,318,318,32,2,30,4,3
1,401,401,28,13,15,2,1
0,439,439,14,14,0,1,0

2,372,372,38,9,29,4,3
0,484,484,30,30,0,1,0
1,485,485,19,19,0,1,0

1,253,253,26,26,0,1,0
0,451,451,46,46,0,1,0

0,103,103,6,2,4,2,1
1,252,252,11,11,0,1,0
2,481,481,49,1,48,2,1

0,224,224,1,1,0,1,0
1,254,254,25,9,16,3,2
2,294,294,30,30,0,1,0

2,205,205,21,21,0,1,0
1,257,257,8,2,6,3,2
0,377,377,26,26,0,1,0

0,254,254,26,20,6,2,1
1,484,484,49,49,0,1,0

2,141,141,15,15,0,1,0
0,254,254,18,1,17,3,2
1,457,457,14,14,0,1,0

0,110,110,11,2,9,2,1
1,497,497,50,20,30,4,3

0,450,450,45,17,28,4,3
1,458,458,46,6,40,2,1

1,255,255,5,2,3,2,1
0,355,355,29,29,0,1,0
2,476,476,48,48,0,1,0

0,302,302,31,31,0,1,0
1,477,477,48,48,0,1,0

1,204,204,21,21,0,1,0
0,320,320,33,33,0,1,0

0,119,119,3,3,0,1,0
2,279,279,28,6,22,2,1
1,467,467,35,25,10,2,1

0,235,235,24,24,0,1,0
1,384,384,39,39,0,1,0

1,109,109,10,10,0,1,0
2,156,156,16,16,0,1,0
0,189,189,3,3,0,1,0

1,373,373,38,38,0,1,0
0,472,472,48,24,24,4,3

4,144,144,15,15,0,1,0
1,195,195,5,5,0,1,0
3,258,258,4,4,0,1,0
2,394,394,17,17,0,1,0
0,434,434,8,8,0,1,0

2,188,188,19,2,17,2,1
1,272,272,2,2,0,1,0
0,338,338,32,32,0,1,0

2,275,275,28,28,0,1,0
1,475,475,23,5,18,2,1
0,500,500,26,26,0,1,0

2,118,118,12,12,0,1,0
0,311,311,12,4,8,2,1
1,406,406,25,25,0,1,0

2,199,199,20,20,0,1,0
0,275,275,21,21,0,1,0
1,471,471,12,12,0,1,0

0,261,261,5,5,0,1,0
3,303,303,31,3,28,2,1
2,318,318,11,11,0,1,0
1,388,388,18,18,0,1,0

2,145,145,2,2,0,1,0
3,183,183,19,19,0,1,0
0,192,192,8,8,0,1,0
1,259,259,13,13,0,1,0

0,126,126,9,2,7,2,1
1,226,226,7,7,0,1,0
2,393,393,40,40,0,1,0

0,143,143,1,1,0,1,0
2,292,292,30,3,27,4,3
1,487,487,46,46,0,1,0

0,105,105,1,1,0,1,0
3,181,181,19,6,13,2,1
2,287,287,26,4,22,2,1
1,315,315,1,1,0,1,0

1,160,160,6,3,3,2,1
0,177,177,7,4,3,2,1
3,437,437,44,23,21,4,3
2,453,453,11,11,0,1,0

1,230,230,20,15,5,2,1
2,328,328,33,15,18,3,2
0,430,430,6,6,0,1,0

1,160,160,1,1,0,1,0
0,208,208,20,2,18,2,1
2,425,425,43,43,0,1,0

1,206,206,21,8,13,2,1
0,271,271,28,12,16,2,1

0,356,356,36,36,0,1,0
1,386,386,39,39,0,1,0

0,129,129,3,3,0,1,0
6,192,192,1,1,0,1,0
7,335,335,34,34,0,1,0
2,391,391,8,8,0,1,0
1,431,431,1,1,0,1,0
3,477,477,18,18,0,1,0
5,493,493,4,4,0,1,0
4,500,500,4,4,0,1,0

0,313,313,32,32,0,1,0
1,482,482,49,49,0,1,0

1,399,399,20,5,15,4,3
0,470,470,24,24,0,1,0
2,482,482,49,44,5,2,1

1,199,199,6,6,0,1,0
2,298,298,30,16,14,3,2
0,313,313,23,20,3,2,1

3,117,117,12,12,0,1,0
2,259,259,14,8,6,2,1
1,280,280,4,4,0,1,0
0,331,331,11,2,9,4,3

1,103,103,11,2,9,4,3
0,168,168,17,2,15,4,3

0,148,148,11,4,7,2,1
2,238,238,24,3,21,2,1
1,248,248,7,2,5,2,1

2,286,286,29,29,0,1,0
0,384,384,32,32,0,1,0
1,462,462,8,3,5,2,1

0,152,152,1,1,0,1,0
2,165,165,17,17,0,1,0
1,242,242,23,2,21,4,3

1,214,214,7,7,0,1,0
2,326,326,33,6,27,4,3
0,487,487,35,12,23,2,1

2,366,366,37,37,0,1,0
0,389,389,21,2,19,2,1
1,443,443,21,6,15,4,3

2,203,203,9,2,7,2,1
0,267,267,10,2,8,2,1
3,308,308,31,17,14,2,1
1,438,438,8,8,0,1,0

1,109,109,4,4,0,1,0
2,158,158,6,6,0,1,0
3,186,186,19,19,0,1,0
0,273,273,8,4,4,2,1

0,104,104,11,5,6,3,2
1,339,339,34,19,15,2,1

1,305,305,31,16,15,4,3
0,375,375,38,30,8,2,1

1,327,327,3,3,0,1,0
4,376,376,38,38,0,1,0
0,403,403,5,5,0,1,0
3,413,413,28,16,12,4,3
2,466,466,5,5,0,1,0

1,145,145,14,4,10,3,2
0,356,356,3,3,0,1,0
2,454,454,46,3,43,2,1

1,170,170,17,4,13,2,1
0,212,212,22,22,0,1,0

1,339,339,11,5,6,3,2
2,407,407,41,23,18,2,1
0,430,430,30,20,10,3,2

1,189,189,8,8,0,1,0
0,207,207,1,1,0,1,0
3,403,403,41,3,38,4,3
2,435,435,23,23,0,1,0

0,136,136,1,1,0,1,0
2,270,270,7,7,0,1,0
1,329,329,22,22,0,1,0
3,340,340,34,34,0,1,0

0,226,226,23,23,0,1,0
1,239,239,24,18,6,2,1

1,139,139,6,6,0,1,0
3,266,266,27,9,18,3,2
0,421,421,2,2,0,1,0
2,496,496,26,18,8,3,2

0,218,218,18,4,14,3,2
1,318,318,6,6,0,1,0
2,370,370,37,37,0,1,0

1,136,136,14,14,0,1,0
0,418,418,42,9,33,4,3

1,171,171,18,1,17,2,1
0,396,396,40,40,0,1,0

0,142,142,15,15,0,1,0
1,465,465,47,47,0,1,0

2,167,167,17,17,0,1,0
0,256,256,4,4,0,1,0
1,287,287,25,25,0,1,0

1,122,122,12,12,0,1,0
2,166,166,17,5,12,2,1
0,398,398,2,2,0,1,0

0,335,335,34,8,26,2,1
1,369,369,37,37,0,1,0

1,136,136,2,2,0,1,0
2,181,181,19,7,12,2,1
0,326,326,29,29,0,1,0

0,290,290,29,29,0,1,0
1,462,462,47,38,9,2,1

1,296,296,30,2,28,4,3
0,311,311,32,32,0,1,0

0,110,110,2,2,0,1,0
2,184,184,19,19,0,1,0
1,423,423,35,17,18,4,3

1,202,202,21,21,0,1,0
0,402,402,41,41,0,1,0

2,201,201,21,21,0,1,0
0,365,365,9,6,3,2,1
1,446,446,34,22,12,3,2

1,135,135,13,13,0,1,0
2,382,382,39,7,32,3,2
0,387,387,2,2,0,1,0

0,117,117,8,8,0,1,0
1,422,422,14,14,0,1,0
2,429,429,43,43,0,1,0

1,187,187,19,19,0,1,0
0,308,308,31,31,0,1,0

0,193,193,20,11,9,2,1
1,444,444,45,45,0,1,0

0,278,278,21,21,0,1,0
3,399,399,40,40,0,1,0
2,430,430,2,2,0,1,0
1,475,475,10,2,8,3,2

1,220,220,22,2,20,2,1
0,377,377,38,38,0,1,0

2,135,135,14,14,0,1,0
0,148,148,8,8,0,1,0
1,271,271,13,13,0,1,0

0,125,125,1,1,0,1,0
1,243,243,1,1,0,1,0
4,312,312,32,32,0,1,0
3,463,463,9,1,8,3,2
2,497,497,35,2,33,3,2

0,151,151,16,6,10,3,2
1,326,326,33,1,32,3,2

2,229,229,23,9,14,3,2
0,405,405,27,18,9,4,3
1,426,426,15,6,9,4,3

1,242,242,25,25,0,1,0
0,460,460,46,46,0,1,0

0,186,186,19,1,18,4,3
1,469,469,47,47,0,1,0

1,107,107,11,11,0,1,0
0,389,389,39,4,35,4,3

2,100,100,1,1,0,1,0
0,111,111,3,3,0,1,0
3,276,276,8,2,6,2,1
4,376,376,38,38,0,1,0
1,461,461,17,17,0,1,0

2,102,102,11,5,6,2,1
0,278,278,17,6,11,4,3
1,294,294,12,8,4,2,1

2,155,155,4,4,0,1,0
3,161,161,17,9,8,3,2
1,272,272,4,4,0,1,0
0,339,339,22,22,0,1,0

1,132,132,1,1,0,1,0
2,274,274,28,28,0,1,0
0,465,465,43,43,0,1,0

0,248,248,18,18,0,1,0
1,297,297,9,3,6,2,1
2,395,395,40,40,0,1,0

1,352,352,16,5,11,2,1
2,381,381,39,21,18,4,3
0,441,441,25,25,0,1,0

2,324,324,1,1,0,1,0
1,341,341,6,6,0,1,0
4,429,429,9,1,8,2,1
5,436,436,44,4,40,2,1
0,444,444,10,10,0,1,0
3,479,479,18,3,15,4,3

3,158,158,16,4,12,3,2
2,160,160,3,3,0,1,0
1,305,305,17,17,0,1,0
0,320,320,10,10,0,1,0

0,245,245,25,1,24,2,1
1,344,344,35,2,33,2,1

0,306,306,31,31,0,1,0
1,446,446,45,18,27,2,1

0,311,311,10,10,0,1,0
1,374,374,21,21,0,1,0
3,422,422,43,25,18,2,1
2,472,472,6,3,3,2,1

0,457,457,46,31,15,4,3
1,461,461,47,15,32,2,1

2,326,326,15,15,0,1,0
0,349,349,19,19,0,1,0
1,403,403,1,1,0,1,0
3,442,442,45,15,30,4,3

2,141,141,15,15,0,1,0
0,171,171,1,1,0,1,0
1,264,264,25,25,0,1,0

1,124,124,12,12,0,1,0
0,179,179,1,1,0,1,0
2,196,196,20,14,6,3,2

0,455,455,46,20,26,4,3
1,496,496,50,2,48,4,3

0,123,123,13,13,0,1,0
1,314,314,32,11,21,2,1

0,148,148,15,5,10,3,2
1,307,307,31,12,19,2,1

1,269,269,27,27,0,1,0
0,463,463,47,47,0,1,0

0,283,283,10,7,3,2,1
3,313,313,32,32,0,1,0
1,366,366,5,5,0,1,0
2,373,373,20,12,8,3,2

1,273,273,10,10,0,1,0
2,307,307,31,7,24,2,1
0,345,345,23,5,18,4,3

1,219,219,4,4,0,1,0
2,364,364,11,11,0,1,0
3,369,369,37,37,0,1,0
0,440,440,23,3,20,2,1

1,245,245,12,12,0,1,0
0,266,266,14,14,0,1,0
2,299,299,30,30,0,1,0

0,396,396,40,22,18,3,2
1,490,490,49,49,0,1,0

0,250,250,8,8,0,1,0
2,301,301,1,1,0,1,0
3,358,358,22,10,12,2,1
1,380,380,2,2,0,1,0
4,393,393,40,13,27,2,1

2,137,137,2,2,0,1,0
1,226,226,1,1,0,1,0
5,246,246,25,3,22,3,2
4,327,327,20,20,0,1,0
0,441,441,7,1,6,3,2
3,478,478,2,2,0,1,0

1,290,290,29,29,0,1,0
0,373,373,38,38,0,1,0

2,107,107,10,4,6,3,2
0,369,369,1,1,0,1,0
3,382,382,39,39,0,1,0
1,444,444,2,2,0,1,0

1,126,126,13,13,0,1,0
0,415,415,42,42,0,1,0

0,233,233,24,24,0,1,0
1,467,467,47,24,23,2,1

0,450,450,45,45,0,1,0
1,462,462,47,23,24,2,1

0,285,285,8,2,6,2,1
1,330,330,24,24,0,1,0
2,382,382,39,39,0,1,0

1,208,208,21,21,0,1,0
0,418,418,42,42,0,1,0

2,258,258,26,7,19,2,1
1,266,266,7,7,0,1,0
0,311,311,23,23,0,1,0

0,307,307,31,31,0,1,0
1,327,327,33,6,27,2,1

2,105,105,3,3,0,1,0
0,205,205,5,5,0,1,0
1,279,279,15,15,0,1,0
3,459,459,46,46,0,1,0

1,139,139,14,14,0,1,0
0,235,235,24,3,21,2,1

1,119,119,1,1,0,1,0
2,230,230,16,10,6,2,1
3,346,346,35,15,20,3,2
0,381,381,10,10,0,1,0

1,263,263,8,3,5,2,1
2,286,286,10,2,8,2,1
4,346,346,35,17,18,4,3
3,436,436,8,4,4,2,1
0,481,481,8,1,7,3,2

1,204,204,21,13,8,3,2
0,255,255,26,26,0,1,0

1,128,128,13,3,10,2,1
0,387,387,39,9,30,2,1

0,204,204,20,20,0,1,0
1,372,372,1,1,0,1,0
2,473,473,48,8,40,3,2

1,130,130,4,4,0,1,0
0,286,286,21,1,20,2,1
2,414,414,42,42,0,1,0

3,174,174,1,1,0,1,0
2,180,180,16,16,0,1,0
0,373,373,1,1,0,1,0
4,436,436,44,44,0,1,0
1,496,496,4,4,0,1,0

0,206,206,4,1,3,2,1
1,208,208,6,2,4,2,1
2,423,423,22,10,12,4,3
3,487,487,49,21,28,3,2

0,272,272,28,28,0,1,0
1,405,405,41,16,25,4,3

1,201,201,21,21,0,1,0
0,356,356,36,31,5,2,1

0,226,226,23,5,18,4,3
1,363,363,37,37,0,1,0

2,138,138,14,14,0,1,0
0,184,184,12,12,0,1,0
1,310,310,11,2,9,2,1

1,133,133,12,12,0,1,0
3,183,183,19,6,13,2,1
0,193,193,1,1,0,1,0
2,209,209,1,1,0,1,0

3,182,182,19,19,0,1,0
2,217,217,15,15,0,1,0
1,308,308,7,7,0,1,0
0,343,343,4,1,3,2,1

1,285,285,29,29,0,1,0
0,308,308,31,31,0,1,0

0,129,129,13,13,0,1,0
1,359,359,36,36,0,1,0

1,329,329,33,33,0,1,0
0,376,376,38,22,16,3,2

1,110,110,11,5,6,3,2
0,192,192,20,20,0,1,0

1,306,306,28,12,16,3,2
2,447,447,45,30,15,4,3
0,495,495,5,5,0,1,0

2,219,219,22,6,16,3,2
0,336,336,1,1,0,1,0
1,337,337,33,33,0,1,0

0,113,113,1,1,0,1,0
3,145,145,4,4,0,1,0
2,198,198,1,1,0,1,0
1,238,238,15,1,14,2,1
4,399,399,40,4,36,4,3

1,349,349,35,11,24,2,1
0,455,455,46,46,0,1,0

0,167,167,17,17,0,1,0
1,259,259,26,14,12,2,1

2,184,184,19,19,0,1,0
1,420,420,2,2,0,1,0
0,425,425,41,8,33,2,1

0,227,227,15,15,0,1,0
2,233,233,24,6,18,3,2
1,248,248,9,2,7,2,1

0,395,395,40,40,0,1,0
1,489,489,49,1,48,2,1

1,479,479,48,23,25,4,3
0,488,488,49,4,45,4,3

2,186,186,19,10,9,4,3
0,226,226,8,8,0,1,0
1,337,337,22,22,0,1,0

1,104,104,11,11,0,1,0
0,115,115,12,5,7,2,1

0,138,138,14,14,0,1,0
1,227,227,23,23,0,1,0

0,264,264,27,27,0,1,0
1,290,290,29,10,19,2,1

2,106,106,11,2,9,2,1
0,181,181,1,1,0,1,0
1,392,392,38,38,0,1,0

1,128,128,13,13,0,1,0
0,194,194,20,10,10,3,2

0,166,166,17,2,15,2,1
1,254,254,26,12,14,2,1

0,185,185,1,1,0,1,0
2,272,272,28,28,0,1,0
1,397,397,38,38,0,1,0

0,299,299,3,3,0,1,0
1,374,374,34,34,0,1,0
2,482,482,49,24,25,2,1

1,372,372,38,26,12,3,2
0,468,468,47,18,29,4,3

0,459,459,46,12,34,3,2
1,500,500,50,50,0,1,0

0,103,103,4,4,0,1,0
2,167,167,17,17,0,1,0
1,352,352,22,7,15,2,1

1,239,239,19,19,0,1,0
0,370,370,9,9,0,1,0
2,436,436,44,4,40,2,1

0,330,330,34,34,0,1,0
1,335,335,34,34,0,1,0

1,110,110,8,8,0,1,0
2,110,110,11,11,0,1,0
0,177,177,5,5,0,1,0

0,311,311,32,13,19,2,1
1,459,459,46,46,0,1,0

1,223,223,23,13,10,2,1
0,496,496,50,17,33,3,2

1,189,189,3,3,0,1,0
2,279,279,28,6,22,2,1
0,460,460,40,2,38,3,2

0,144,144,3,3,0,1,0
1,202,202,2,2,0,1,0
4,206,206,21,9,12,2,1
3,289,289,8,8,0,1,0
2,313,313,14,14,0,1,0

3,111,111,1,1,0,1,0
4,204,204,21,21,0,1,0
1,206,206,1,1,0,1,0
0,257,257,18,18,0,1,0
2,297,297,7,7,0,1,0

0,147,147,12,12,0,1,0
1,225,225,1,1,0,1,0
3,277,277,28,22,6,2,1
2,480,480,7,7,0,1,0

0,339,339,34,9,25,2,1
1,499,499,50,26,24,2,1

0,170,170,18,18,0,1,0
1,287,287,29,29,0,1,0

2,115,115,12,12,0,1,0
1,301,301,18,12,6,3,2
0,308,308,13,13,0,1,0

1,413,413,42,20,22,3,2
0,497,497,50,50,0,1,0

0,317,317,32,32,0,1,0
1,394,394,40,22,18,2,1

0,147,147,15,3,12,3,2
1,319,319,32,32,0,1,0

2,269,269,27,27,0,1,0
1,282,282,14,14,0,1,0
0,496,496,25,25,0,1,0

2,284,284,29,8,21,2,1
0,425,425,3,3,0,1,0
1,465,465,44,44,0,1,0

2,232,232,6,2,4,2,1
3,296,296,30,4,26,3,2
1,316,316,6,6,0,1,0
0,414,414,23,5,18,3,2

1,130,130,1,1,0,1,0
3,280,280,28,1,27,2,1
2,286,286,19,3,16,3,2
0,500,500,13,13,0,1,0

2,102,102,1,1,0,1,0
1,190,190,16,7,9,2,1
3,230,230,23,23,0,1,0
0,336,336,5,5,0,1,0

0,181,181,19,19,0,1,0
1,471,471,48,48,0,1,0

0,282,282,14,14,0,1,0
1,364,364,19,19,0,1,0
2,411,411,42,42,0,1,0

0,203,203,19,2,17,2,1
2,220,220,22,3,19,2,1
1,426,426,3,3,0,1,0

1,202,202,2,2,0,1,0
2,394,394,40,40,0,1,0
0,418,418,38,2,36,4,3

0,237,237,24,24,0,1,0
1,382,382,39,3,36,3,2

1,137,137,14,14,0,1,0
0,289,289,29,5,24,4,3

4,210,210,21,6,15,4,3
0,267,267,1,1,0,1,0
1,278,278,3,3,0,1,0
2,482,482,31,31,0,1,0
3,497,497,11,3,8,2,1

0,218,218,12,12,0,1,0
1,330,330,1,1,0,1,0
3,386,386,39,11,28,3,2
2,406,406,18,18,0,1,0

1,259,259,26,26,0,1,0
0,333,333,34,12,22,3,2

1,129,129,13,13,0,1,0
0,337,337,1,1,0,1,0
2,498,498,50,50,0,1,0

1,165,165,17,17,0,1,0
0,457,457,46,17,29,2,1

2,175,175,6,6,0,1,0
0,204,204,1,1,0,1,0
1,208,208,13,2,11,2,1
3,330,330,33,22,11,2,1

2,367,367,25,25,0,1,0
0,370,370,11,11,0,1,0
3,437,437,44,2,42,4,3
1,462,462,2,2,0,1,0

0,270,270,27,27,0,1,0
1,439,439,44,44,0,1,0

1,123,123,6,6,0,1,0
3,286,286,29,29,0,1,0
0,328,328,11,1,10,2,1
2,359,359,7,7,0,1,0

0,329,329,33,33,0,1,0
1,500,500,50,26,24,3,2

0,264,264,10,10,0,1,0
3,287,287,29,29,0,1,0
2,355,355,13,4,9,2,1
1,481,481,13,3,10,3,2

0,444,444,2,2,0,1,0
1,446,446,43,43,0,1,0
2,492,492,50,50,0,1,0

0,207,207,21,21,0,1,0
1,248,248,25,25,0,1,0

0,275,275,1,1,0,1,0
2,289,289,17,5,12,4,3
3,355,355,36,36,0,1,0
1,446,446,18,8,10,2,1

3,198,198,1,1,0,1,0
1,238,238,7,2,5,2,1
5,422,422,43,43,0,1,0
0,432,432,7,7,0,1,0
4,433,433,14,14,0,1,0
2,470,470,8,8,0,1,0

0,179,179,1,1,0,1,0
1,371,371,36,36,0,1,0
2,434,434,44,44,0,1,0

0,130,130,12,12,0,1,0
1,384,384,3,3,0,1,0
2,499,499,50,42,8,2,1

1,366,366,37,37,0,1,0
0,420,420,43,43,0,1,0

1,175,175,6,6,0,1,0
2,175,175,18,10,8,3,2
0,200,200,14,10,4,2,1

2,117,117,12,4,8,2,1
1,210,210,6,6,0,1,0
0,375,375,27,27,0,1,0

2,364,364,37,29,8,2,1
0,412,412,7,7,0,1,0
1,461,461,39,39,0,1,0

1,127,127,13,13,0,1,0
0,284,284,29,29,0,1,0

1,219,219,22,22,0,1,0
2,363,363,37,37,0,1,0
0,412,412,1,1,0,1,0

2,154,154,16,16,0,1,0
0,208,208,5,1,4,2,1
1,293,293,23,23,0,1,0

0,108,108,11,11,0,1,0
1,469,469,47,47,0,1,0

1,108,108,5,5,0,1,0
0,180,180,11,11,0,1,0
2,214,214,22,5,17,2,1

3,187,187,19,9,10,3,2
1,199,199,14,14,0,1,0
0,413,413,7,7,0,1,0
2,453,453,6,6,0,1,0

0,115,115,4,4,0,1,0
1,229,229,15,15,0,1,0
2,440,440,44,13,31,4,3

3,260,260,26,26,0,1,0
1,295,295,13,13,0,1,0
0,299,299,3,3,0,1,0
2,399,399,19,19,0,1,0

3,103,103,11,11,0,1,0
0,262,262,14,14,0,1,0
1,304,304,7,7,0,1,0
2,320,320,8,4,4,2,1

1,180,180,18,18,0,1,0
0,454,454,46,46,0,1,0

1,104,104,11,11,0,1,0
0,239,239,24,15,9,2,1

0,278,278,28,28,0,1,0
1,397,397,40,1,39,4,3

2,153,153,16,16,0,1,0
1,173,173,1,1,0,1,0
0,347,347,33,8,25,2,1

1,206,206,21,21,0,1,0
0,227,227,23,23,0,1,0

1,145,145,15,15,0,1,0
0,387,387,39,3,36,3,2

0,217,217,22,16,6,3,2
1,232,232,24,6,18,2,1

3,222,222,23,23,0,1,0
0,261,261,2,2,0,1,0
1,365,365,24,4,20,2,1
2,474,474,13,5,8,2,1

0,155,155,2,2,0,1,0
1,284,284,25,16,9,2,1
2,302,302,31,31,0,1,0

0,445,445,45,25,20,2,1
1,458,458,46,30,16,2,1

0,104,104,3,3,0,1,0
1,193,193,14,14,0,1,0
2,256,256,26,26,0,1,0

0,289,289,20,20,0,1,0
2,320,320,32,12,20,3,2
1,420,420,13,13,0,1,0

0,238,238,24,9,15,4,3
1,469,469,47,47,0,1,0

1,274,274,6,6,0,1,0
2,298,298,15,1,14,2,1
0,311,311,9,9,0,1,0
3,460,460,46,46,0,1,0

2,173,173,18,18,0,1,0
0,388,388,15,15,0,1,0
1,472,472,29,29,0,1,0

0,168,168,17,14,3,2,1
1,238,238,24,15,9,2,1

0,126,126,9,9,0,1,0
2,126,126,13,13,0,1,0
1,325,325,10,1,9,2,1

2,101,101,11,11,0,1,0
1,381,381,2,2,0,1,0
0,462,462,44,44,0,1,0

0,242,242,12,8,4,2,1
1,465,465,24,6,18,3,2
2,481,481,49,49,0,1,0

0,192,192,20,11,9,4,3
1,316,316,32,20,12,4,3

0,288,288,29,29,0,1,0
1,417,417,42,15,27,2,1

1,115,115,12,12,0,1,0
0,415,415,42,8,34,3,2

1,128,128,8,2,6,2,1
2,254,254,26,2,24,3,2
0,381,381,15,1,14,3,2

2,198,198,3,3,0,1,0
0,388,388,12,3,9,2,1
3,407,407,41,41,0,1,0
1,420,420,23,23,0,1,0

0,418,418,34,34,0,1,0
2,433,433,44,27,17,2,1
1,459,459,9,3,6,3,2

2,208,208,4,4,0,1,0
0,308,308,10,4,6,3,2
3,415,415,42,36,6,2,1
1,447,447,22,1,21,2,1

0,170,170,1,1,0,1,0
2,428,428,17,17,0,1,0
1,444,444,25,21,4,2,1
3,472,472,48,14,34,2,1

3,118,118,12,12,0,1,0
2,161,161,5,5,0,1,0
1,197,197,6,3,3,2,1
0,482,482,21,2,19,4,3

2,234,234,1,1,0,1,0
4,238,238,10,2,8,3,2
3,248,248,3,3,0,1,0
1,249,249,8,4,4,2,1
5,319,319,1,1,0,1,0
6,373,373,38,10,28,2,1
0,381,381,3,3,0,1,0

2,108,108,11,11,0,1,0
0,158,158,1,1,0,1,0
1,338,338,32,32,0,1,0

1,213,213,6,6,0,1,0
4,214,214,2,2,0,1,0
0,311,311,8,3,5,2,1
5,384,384,39,39,0,1,0
2,448,448,2,2,0,1,0
3,500,500,17,11,6,2,1

2,135,135,14,14,0,1,0
0,202,202,17,9,8,2,1
1,487,487,8,8,0,1,0

0,188,188,6,3,3,2,1
1,243,243,17,17,0,1,0
2,401,401,41,41,0,1,0

1,116,116,7,4,3,2,1
0,256,256,8,8,0,1,0
2,274,274,3,3,0,1,0
3,408,408,41,6,35,2,1

0,396,396,40,40,0,1,0
1,444,444,45,45,0,1,0

0,306,306,13,5,8,2,1
2,456,456,46,46,0,1,0
1,477,477,28,11,17,3,2

0,231,231,3,3,0,1,0
3,234,234,7,7,0,1,0
5,276,276,28,24,4,2,1
2,284,284,6,6,0,1,0
1,408,408,13,13,0,1,0
4,422,422,2,2,0,1,0

1,153,153,12,12,0,1,0
0,382,382,9,1,8,3,2
2,420,420,42,42,0,1,0

0,144,144,13,5,8,2,1
2,144,144,15,15,0,1,0
1,348,348,4,4,0,1,0

1,288,288,24,24,0,1,0
0,300,300,5,5,0,1,0
2,343,343,35,35,0,1,0

0,222,222,23,23,0,1,0
1,292,292,30,30,0,1,0

0,117,117,10,2,8,3,2
2,216,216,22,22,0,1,0
1,355,355,6,6,0,1,0

1,380,380,37,37,0,1,0
2,387,387,39,14,25,2,1
0,395,395,2,2,0,1,0

0,204,204,21,21,0,1,0
1,405,405,41,1,40,2,1

4,133,133,1,1,0,1,0
2,139,139,8,8,0,1,0
5,186,186,19,19,0,1,0
0,276,276,2,2,0,1,0
3,332,332,4,4,0,1,0
1,340,340,6,6,0,1,0

1,122,122,4,4,0,1,0
4,123,123,2,2,0,1,0
2,234,234,2,2,0,1,0
0,367,367,14,14,0,1,0
3,436,436,2,2,0,1,0
5,476,476,48,48,0,1,0

3,128,128,1,1,0,1,0
2,173,173,2,2,0,1,0
4,300,300,30,12,18,4,3
0,372,372,18,18,0,1,0
1,407,407,16,16,0,1,0

0,394,394,40,40,0,1,0
1,472,472,48,48,0,1,0

0,117,117,12,3,9,4,3
1,411,411,42,9,33,4,3

0,183,183,19,19,0,1,0
1,356,356,36,8,28,2,1

2,246,246,25,25,0,1,0
0,301,301,2,2,0,1,0
1,450,450,43,15,28,2,1

1,430,430,43,43,0,1,0
0,471,471,48,48,0,1,0

0,282,282,29,19,10,3,2
1,432,432,44,20,24,3,2

2,213,213,14,14,0,1,0
0,293,293,9,9,0,1,0
3,310,310,31,31,0,1,0
1,499,499,4,1,3,2,1

2,157,157,16,16,0,1,0
0,224,224,6,2,4,2,1
1,242,242,18,8,10,3,2

2,161,161,10,10,0,1,0
1,211,211,8,5,3,2,1
3,262,262,27,5,22,3,2
0,413,413,1,1,0,1,0

1,356,356,5,5,0,1,0
2,372,372,38,38,0,1,0
0,450,450,39,18,21,4,3

0,220,220,22,8,14,3,2
1,443,443,45,41,4,2,1

1,155,155,1,1,0,1,0
2,194,194,20,15,5,2,1
0,222,222,22,22,0,1,0

0,111,111,1,1,0,1,0
2,170,170,6,6,0,1,0
1,302,302,17,17,0,1,0
3,429,429,43,21,22,2,1

2,321,321,33,15,18,3,2
0,500,500,44,44,0,1,0
1,500,500,6,6,0,1,0

2,168,168,17,17,0,1,0
1,274,274,3,3,0,1,0
0,469,469,42,42,0,1,0

2,115,115,12,12,0,1,0
0,161,161,12,2,10,2,1
1,491,491,13,4,9,2,1

1,145,145,6,6,0,1,0
4,276,276,28,12,16,2,1
0,286,286,9,5,4,2,1
3,289,289,5,5,0,1,0
2,351,351,4,4,0,1,0

3,200,200,20,20,0,1,0
0,286,286,13,13,0,1,0
2,335,335,16,10,6,3,2
1,496,496,4,4,0,1,0

2,131,131,14,14,0,1,0
1,265,265,20,8,12,4,3
0,385,385,10,10,0,1,0

1,130,130,13,13,0,1,0
0,421,421,43,43,0,1,0

0,344,344,35,35,0,1,0
1,475,475,48,33,15,4,3

1,231,231,8,8,0,1,0
0,258,258,17,17,0,1,0
2,293,293,30,24,6,2,1

1,141,141,9,9,0,1,0
0,259,259,11,6,5,2,1
2,397,397,40,35,5,2,1

0,102,102,2,2,0,1,0
4,152,152,16,10,6,3,2
1,177,177,6,2,4,2,1
3,223,223,5,5,0,1,0
2,226,226,6,6,0,1,0

2,193,193,6,6,0,1,0
3,278,278,28,28,0,1,0
1,321,321,20,17,3,2,1
0,329,329,3,3,0,1,0

2,133,133,14,14,0,1,0
1,289,289,12,12,0,1,0
0,402,402,24,7,17,2,1

1,297,297,30,30,0,1,0
0,495,495,50,50,0,1,0

1,229,229,23,2,21,4,3
0,407,407,41,2,39,2,1

1,326,326,6,6,0,1,0
2,438,438,44,44,0,1,0
0,457,457,38,38,0,1,0

2,175,175,8,8,0,1,0
3,445,445,1,1,0,1,0
1,450,450,19,4,15,2,1
4,499,499,50,50,0,1,0
0,500,500,5,2,3,2,1

1,216,216,20,20,0,1,0
2,262,262,27,27,0,1,0
0,443,443,4,4,0,1,0

2,336,336,34,17,17,2,1
1,407,407,32,24,8,3,2
0,456,456,10,10,0,1,0

2,324,324,1,1,0,1,0
3,334,334,34,2,32,3,2
0,419,419,40,40,0,1,0
1,479,479,1,1,0,1,0

2,238,238,24,24,0,1,0
0,391,391,21,21,0,1,0
1,460,460,22,22,0,1,0

0,124,124,13,13,0,1,0
1,372,372,38,6,32,2,1

2,339,339,34,34,0,1,0
1,346,346,20,20,0,1,0
0,371,371,16,16,0,1,0

2,179,179,18,18,0,1,0
1,375,375,30,16,14,3,2
0,490,490,10,2,8,2,1

1,192,192,16,16,0,1,0
2,197,197,20,5,15,2,1
0,243,243,5,5,0,1,0

1,116,116,12,12,0,1,0
0,187,187,19,1,18,2,1

2,215,215,22,22,0,1,0
0,223,223,21,17,4,2,1
1,496,496,3,3,0,1,0

0,133,133,7,7,0,1,0
2,284,284,29,29,0,1,0
1,443,443,21,21,0,1,0

2,169,169,17,3,14,2,1
1,242,242,23,23,0,1,0
0,256,256,2,2,0,1,0

0,185,185,19,11,8,3,2
1,473,473,48,4,44,2,1

1,162,162,3,3,0,1,0
0,177,177,15,15,0,1,0
2,358,358,36,36,0,1,0

1,272,272,19,19,0,1,0
2,298,298,30,17,13,2,1
0,426,426,13,5,8,2,1

1,189,189,19,19,0,1,0
0,248,248,25,14,11,2,1

0,146,146,15,15,0,1,0
1,180,180,18,9,9,4,3

0,270,270,27,27,0,1,0
1,487,487,49,49,0,1,0

1,194,194,20,12,8,3,2
0,483,483,49,49,0,1,0

2,103,103,11,11,0,1,0
0,235,235,19,7,12,4,3
1,405,405,8,3,5,2,1

0,223,223,23,23,0,1,0
1,271,271,28,22,6,3,2

3,158,158,16,16,0,1,0
2,189,189,8,2,6,2,1
1,368,368,13,3,10,2,1
0,490,490,13,13,0,1,0

1,167,167,6,6,0,1,0
2,191,191,3,3,0,1,0
0,319,319,17,5,12,4,3
3,469,469,47,23,24,4,3

0,181,181,6,6,0,1,0
2,322,322,33,33,0,1,0
1,410,410,28,28,0,1,0

2,401,401,41,41,0,1,0
0,433,433,29,10,19,2,1
1,440,440,15,15,0,1,0

0,107,107,3,3,0,1,0
2,119,119,12,4,8,3,2
1,186,186,14,14,0,1,0

1,125,125,1,1,0,1,0
2,220,220,19,19,0,1,0
0,240,240,2,2,0,1,0
3,283,283,29,15,14,2,1

0,115,115,12,4,8,2,1
1,201,201,21,11,10,2,1

1,372,372,4,4,0,1,0
2,447,447,45,45,0,1,0
0,476,476,43,43,0,1,0

2,467,467,15,6,9,2,1
1,473,473,21,9,12,3,2
3,477,477,48,6,42,4,3
0,492,492,12,7,5,2,1

2,139,139,6,2,4,2,1
3,216,216,22,10,12,4,3
1,239,239,1,1,0,1,0
0,459,459,25,10,15,2,1

0,307,307,1,1,0,1,0
2,396,396,40,7,33,4,3
1,493,493,48,22,26,3,2

1,116,116,1,1,0,1,0
0,207,207,2,2,0,1,0
3,374,374,38,38,0,1,0
2,430,430,36,36,0,1,0

0,109,109,3,3,0,1,0
1,177,177,8,8,0,1,0
2,250,250,7,1,6,2,1
3,425,425,43,43,0,1,0

0,241,241,20,20,0,1,0
1,245,245,5,5,0,1,0
2,389,389,39,35,4,2,1

1,166,166,7,7,0,1,0
0,199,199,6,6,0,1,0
3,282,282,3,3,0,1,0
4,354,354,36,11,25,4,3
2,437,437,8,1,7,2,1

1,178,178,18,18,0,1,0
0,467,467,47,12,35,2,1

1,110,110,3,3,0,1,0
5,124,124,13,13,0,1,0
4,335,335,9,5,4,2,1
3,392,392,1,1,0,1,0
2,427,427,16,13,3,2,1
0,459,459,4,4,0,1,0

1,135,135,14,4,10,3,2
0,142,142,15,15,0,1,0

2,134,134,14,9,5,2,1
0,185,185,2,2,0,1,0
1,436,436,39,39,0,1,0

0,253,253,26,26,0,1,0
1,483,483,49,11,38,3,2

0,280,280,28,12,16,2,1
1,356,356,36,24,12,4,3

0,163,163,17,1,16,2,1
1,396,396,40,2,38,2,1

0,163,163,17,8,9,2,1
1,263,263,27,27,0,1,0

0,104,104,2,2,0,1,0
2,174,174,18,4,14,3,2
1,175,175,15,3,12,2,1

0,366,366,37,37,0,1,0
1,443,443,45,45,0,1,0

1,382,382,39,19,20,2,1
0,450,450,45,28,17,2,1

0,254,254,26,21,5,2,1
1,329,329,33,26,7,2,1

0,140,140,7,7,0,1,0
2,371,371,38,20,18,4,3
1,389,389,20,7,13,2,1

2,107,107,11,8,3,2,1
1,177,177,12,7,5,2,1
0,431,431,16,1,15,2,1

0,148,148,1,1,0,1,0
1,178,178,13,4,9,2,1
2,319,319,7,7,0,1,0
3,427,427,43,31,12,2,1

2,264,264,27,27,0,1,0
1,316,316,6,6,0,1,0
0,355,355,29,29,0,1,0

0,271,271,28,4,24,2,1
1,278,278,28,28,0,1,0

2,281,281,29,29,0,1,0
0,287,287,14,14,0,1,0
1,365,365,19,11,8,2,1

2,309,309,31,4,27,3,2
0,383,383,6,6,0,1,0
1,445,445,38,2,36,3,2

0,154,154,16,2,14,2,1
1,365,365,37,37,0,1,0

0,132,132,11,11,0,1,0
1,364,364,7,7,0,1,0
2,483,483,49,49,0,1,0

0,365,365,37,30,7,2,1
1,453,453,46,4,42,2,1

0,355,355,25,9,16,3,2
2,358,358,36,4,32,2,1
1,400,400,12,12,0,1,0

1,102,102,11,11,0,1,0
0,279,279,28,2,26,2,1

2,130,130,13,13,0,1,0
1,164,164,12,12,0,1,0
0,448,448,14,14,0,1,0

0,132,132,13,10,3,2,1
2,169,169,17,17,0,1,0
1,239,239,1,1,0,1,0

0,165,165,17,5,12,4,3
1,216,216,22,5,17,3,2

0,433,433,44,16,28,2,1
1,485,485,49,5,44,3,2

1,104,104,1,1,0,1,0
2,312,312,32,21,11,2,1
0,402,402,40,2,38,2,1

1,250,250,23,11,12,3,2
0,270,270,3,3,0,1,0
2,331,331,34,34,0,1,0

0,202,202,17,8,9,4,3
1,230,230,4,4,0,1,0
2,473,473,48,18,30,2,1

1,117,117,12,1,11,2,1
0,219,219,22,22,0,1,0

1,209,209,8,4,4,2,1
2,291,291,16,1,15,2,1
3,395,395,40,40,0,1,0
0,435,435,4,1,3,2,1

0,368,368,37,33,4,2,1
1,372,372,38,38,0,1,0

0,166,166,2,2,0,1,0
1,166,166,1,1,0,1,0
2,280,280,23,10,13,4,3
3,421,421,43,22,21,2,1

1,141,141,1,1,0,1,0
0,298,298,23,23,0,1,0
3,420,420,42,42,0,1,0
2,434,434,7,7,0,1,0

0,220,220,19,19,0,1,0
1,226,226,1,1,0,1,0
3,376,376,38,28,10,3,2
2,450,450,5,5,0,1,0

0,155,155,16,16,0,1,0
1,237,237,24,24,0,1,0

2,125,125,13,3,10,2,1
1,144,144,7,7,0,1,0
0,283,283,16,16,0,1,0

0,133,133,3,3,0,1,0
2,191,191,20,7,13,2,1
1,391,391,31,15,16,2,1

0,130,130,3,3,0,1,0
1,283,283,22,1,21,2,1
2,417,417,42,3,39,3,2

0,215,215,16,4,12,3,2
1,321,321,9,9,0,1,0
2,398,398,40,3,37,2,1

1,170,170,15,15,0,1,0
0,207,207,3,3,0,1,0
2,375,375,38,38,0,1,0

1,100,100,2,2,0,1,0
2,143,143,15,9,6,2,1
0,415,415,37,6,31,2,1

3,135,135,5,5,0,1,0
4,150,150,15,15,0,1,0
0,202,202,7,7,0,1,0
1,285,285,3,3,0,1,0
2,476,476,11,5,6,3,2

1,153,153,16,13,3,2,1
0,203,203,21,21,0,1,0

0,106,106,1,1,0,1,0
1,163,163,11,5,6,3,2
3,393,393,40,16,24,4,3
2,418,418,10,10,0,1,0

2,137,137,14,14,0,1,0
0,376,376,4,1,3,2,1
1,427,427,39,21,18,2,1

0,285,285,29,25,4,2,1
1,479,479,48,24,24,2,1

2,123,123,13,3,10,4,3
0,264,264,23,23,0,1,0
1,320,320,5,1,4,2,1

1,172,172,6,6,0,1,0
0,175,175,11,4,7,2,1
3,202,202,21,5,16,2,1
2,337,337,1,1,0,1,0

0,365,365,12,12,0,1,0
2,377,377,38,11,27,4,3
1,488,488,33,27,6,3,2

0,273,273,13,13,0,1,0
1,406,406,22,13,9,2,1
2,483,483,49,49,0,1,0

0,156,156,3,3,0,1,0
1,164,164,5,5,0,1,0
3,339,339,34,21,13,2,1
2,497,497,25,5,20,3,2

1,122,122,5,5,0,1,0
0,201,201,13,7,6,2,1
2,364,364,37,11,26,2,1

0,312,312,32,32,0,1,0
1,454,454,46,25,21,2,1

1,314,314,32,21,11,2,1
0,443,443,45,45,0,1,0

0,135,135,6,6,0,1,0
2,169,169,17,1,16,3,2
1,336,336,19,9,10,2,1

0,132,132,14,4,10,3,2
1,376,376,38,26,12,2,1

2,259,259,26,8,18,2,1
0,345,345,22,22,0,1,0
1,452,452,17,17,0,1,0

0,112,112,12,8,4,2,1
1,340,340,34,34,0,1,0

0,167,167,11,2,9,2,1
2,315,315,32,32,0,1,0
1,317,317,11,3,8,3,2

2,204,204,21,1,20,2,1
0,480,480,22,22,0,1,0
1,499,499,28,28,0,1,0

1,230,230,23,23,0,1,0
0,469,469,47,47,0,1,0

1,123,123,13,1,12,2,1
0,144,144,15,15,0,1,0

0,228,228,2,2,0,1,0
2,258,258,1,1,0,1,0
3,360,360,36,36,0,1,0
1,392,392,35,35,0,1,0

1,109,109,11,11,0,1,0
0,152,152,16,4,12,3,2

0,193,193,16,16,0,1,0
2,220,220,22,8,14,2,1
1,258,258,5,5,0,1,0

0,224,224,11,3,8,3,2
1,229,229,12,12,0,1,0
2,351,351,36,23,13,2,1

0,339,339,34,22,12,2,1
1,422,422,43,3,40,3,2

1,245,245,4,4,0,1,0
0,408,408,35,35,0,1,0
2,426,426,43,4,39,2,1

2,141,141,15,15,0,1,0
1,327,327,7,7,0,1,0
0,476,476,38,21,17,3,2

2,220,220,22,22,0,1,0
0,452,452,34,4,30,3,2
1,473,473,12,2,10,3,2

0,356,356,11,11,0,1,0
1,395,395,28,28,0,1,0
2,470,470,47,23,24,3,2

0,290,290,29,29,0,1,0
1,385,385,39,39,0,1,0

0,330,330,34,4,30,2,1
1,457,457,46,9,37,4,3

1,183,183,15,15,0,1,0
0,267,267,5,5,0,1,0
2,462,462,47,47,0,1,0

0,240,240,24,24,0,1,0
1,269,269,27,3,24,4,3

1,139,139,14,9,5,2,1
0,429,429,43,43,0,1,0

1,224,224,23,16,7,2,1
0,399,399,40,40,0,1,0

0,229,229,23,4,19,2,1
1,258,258,26,26,0,1,0

1,153,153,9,9,0,1,0
2,258,258,26,26,0,1,0
0,431,431,18,4,14,3,2

2,230,230,23,11,12,4,3
0,288,288,1,1,0,1,0
1,418,418,41,41,0,1,0

0,127,127,13,1,12,3,2
1,422,422,43,43,0,1,0

1,402,402,41,41,0,1,0
0,419,419,42,42,0,1,0

1,182,182,13,13,0,1,0
2,189,189,19,19,0,1,0
0,443,443,13,4,9,4,3

1,138,138,2,2,0,1,0
0,164,164,15,15,0,1,0
2,464,464,47,47,0,1,0

0,125,125,13,1,12,2,1
1,153,153,16,16,0,1,0

0,253,253,26,26,0,1,0
1,430,430,43,22,21,4,3

0,192,192,20,14,6,2,1
1,448,448,45,33,12,2,1

0,232,232,24,24,0,1,0
1,328,328,33,1,32,3,2

2,264,264,27,1,26,3,2
0,378,378,15,8,7,2,1
1,482,482,30,8,22,4,3

2,173,173,18,18,0,1,0
0,179,179,14,14,0,1,0
1,207,207,5,5,0,1,0

0,150,150,4,4,0,1,0
1,229,229,17,7,10,2,1
2,403,403,41,41,0,1,0

0,193,193,2,2,0,1,0
2,242,242,25,5,20,2,1
1,323,323,29,29,0,1,0

1,290,290,29,29,0,1,0
0,476,476,48,10,38,3,2

0,208,208,21,10,11,2,1
1,451,451,46,30,16,2,1

0,109,109,11,11,0,1,0
1,426,426,43,5,38,2,1

3,213,213,22,22,0,1,0
0,295,295,18,18,0,1,0
2,381,381,6,1,5,2,1
1,437,437,11,11,0,1,0

2,198,198,8,8,0,1,0
1,338,338,1,1,0,1,0
0,352,352,20,6,14,3,2
3,464,464,47,47,0,1,0

2,190,190,19,3,16,3,2
0,495,495,23,1,22,2,1
1,500,500,27,1,26,3,2

2,113,113,1,1,0,1,0
0,121,121,5,5,0,1,0
1,289,289,6,6,0,1,0
3,328,328,5,5,0,1,0
4,418,418,6,6,0,1,0
5,486,486,49,49,0,1,0

1,209,209,21,3,18,4,3
0,250,250,25,3,22,3,2

2,161,161,17,5,12,3,2
1,179,179,13,5,8,3,2
0,182,182,5,2,3,2,1

1,349,349,35,35,0,1,0
0,399,399,40,40,0,1,0

3,232,232,24,24,0,1,0
1,240,240,1,1,0,1,0
2,263,263,13,1,12,3,2
0,298,298,14,9,5,2,1

0,376,376,38,12,26,3,2
1,408,408,41,13,28,3,2

2,104,104,11,11,0,1,0
0,172,172,3,3,0,1,0
1,194,194,17,7,10,3,2

0,273,273,28,28,0,1,0
1,370,370,37,37,0,1,0

0,222,222,1,1,0,1,0
1,260,260,25,7,18,2,1
2,416,416,42,42,0,1,0

0,228,228,23,13,10,2,1
1,399,399,40,20,20,2,1

1,142,142,10,10,0,1,0
2,147,147,3,3,0,1,0
3,245,245,25,25,0,1,0
0,325,325,5,1,4,2,1

0,382,382,17,17,0,1,0
1,443,443,25,18,7,2,1
2,446,446,45,8,37,2,1

1,170,170,17,17,0,1,0
0,445,445,45,27,18,4,3

1,213,213,22,22,0,1,0
0,282,282,29,29,0,1,0

0,273,273,28,4,24,3,2
1,356,356,36,36,0,1,0

1,175,175,18,6,12,3,2
0,290,290,29,12,17,2,1

3,288,288,29,15,14,3,2
2,300,300,25,3,22,3,2
1,415,415,1,1,0,1,0
0,479,479,7,7,0,1,0

0,271,271,16,16,0,1,0
2,338,338,34,26,8,3,2
1,449,449,19,9,10,3,2

0,192,192,20,20,0,1,0
1,247,247,25,22,3,2,1

0,252,252,8,3,5,2,1
2,258,258,26,4,22,3,2
1,305,305,21,15,6,3,2

2,313,313,32,32,0,1,0
1,363,363,18,7,11,2,1
0,495,495,26,26,0,1,0

0,187,187,19,19,0,1,0
1,260,260,26,14,12,3,2

0,281,281,21,21,0,1,0
2,307,307,31,31,0,1,0
1,476,476,13,13,0,1,0

1,113,113,4,1,3,2,1
0,449,449,30,7,23,2,1
2,471,471,48,8,40,3,2

1,281,281,1,1,0,1,0
0,377,377,9,9,0,1,0
4,399,399,40,28,12,4,3
2,422,422,22,8,14,2,1
3,426,426,9,3,6,2,1

1,360,360,18,9,9,2,1
0,399,399,21,21,0,1,0
2,421,421,43,30,13,3,2

2,239,239,21,3,18,2,1
3,277,277,28,22,6,3,2
0,457,457,1,1,0,1,0
1,486,486,5,5,0,1,0

0,103,103,10,10,0,1,0
1,116,116,1,1,0,1,0
2,371,371,38,38,0,1,0

1,169,169,10,10,0,1,0
0,250,250,11,8,3,2,1
2,355,355,36,36,0,1,0

0,274,274,28,10,18,2,1
1,324,324,33,4,29,2,1

2,134,134,4,4,0,1,0
0,140,140,1,1,0,1,0
3,205,205,7,7,0,1,0
1,269,269,9,9,0,1,0
4,443,443,45,3,42,3,2

0,322,322,33,33,0,1,0
1,476,476,48,48,0,1,0

3,270,270,27,27,0,1,0
0,288,288,3,3,0,1,0
2,324,324,2,2,0,1,0
1,450,450,38,19,19,2,1

0,287,287,22,14,8,3,2
1,467,467,11,11,0,1,0
2,497,497,50,50,0,1,0

0,196,196,20,20,0,1,0
1,341,341,35,35,0,1,0

0,147,147,10,10,0,1,0
1,159,159,4,4,0,1,0
2,364,364,3,3,0,1,0
3,419,419,42,23,19,2,1

0,253,253,13,13,0,1,0
1,282,282,14,14,0,1,0
2,323,323,33,1,32,3,2

6,189,189,19,12,7,2,1
2,211,211,12,12,0,1,0
3,219,219,1,1,0,1,0
5,325,325,2,2,0,1,0
0,399,399,1,1,0,1,0
4,457,457,4,1,3,2,1
1,494,494,11,2,9,4,3

1,185,185,19,19,0,1,0
0,476,476,48,48,0,1,0

1,184,184,19,13,6,2,1
0,193,193,20,7,13,4,3

3,168,168,17,7,10,3,2
1,195,195,3,3,0,1,0
0,361,361,16,7,9,4,3
2,453,453,19,19,0,1,0

3,157,157,16,3,13,4,3
0,279,279,10,3,7,2,1
1,300,300,1,1,0,1,0
2,332,332,21,21,0,1,0

2,219,219,22,11,11,2,1
0,439,439,20,20,0,1,0
1,472,472,26,17,9,2,1

0,151,151,12,12,0,1,0
2,353,353,3,3,0,1,0
3,469,469,47,47,0,1,0
1,470,470,6,6,0,1,0

0,135,135,14,14,0,1,0
1,369,369,37,23,14,4,3

1,167,167,17,8,9,2,1
0,202,202,21,15,6,3,2

1,139,139,14,14,0,1,0
0,276,276,28,28,0,1,0

0,174,174,3,3,0,1,0
2,296,296,24,24,0,1,0
3,338,338,34,34,0,1,0
1,399,399,1,1,0,1,0

0,358,358,36,25,11,2,1
1,481,481,49,49,0,1,0

3,216,216,22,22,0,1,0
0,355,355,4,4,0,1,0
2,449,449,39,39,0,1,0
1,495,495,2,2,0,1,0

0,122,122,5,5,0,1,0
1,234,234,10,3,7,2,1
3,332,332,34,25,9,2,1
2,496,496,9,9,0,1,0

1,136,136,4,1,3,2,1
3,209,209,6,6,0,1,0
2,296,296,11,5,6,3,2
0,367,367,3,3,0,1,0
4,404,404,41,41,0,1,0

0,144,144,3,3,0,1,0
2,411,411,42,10,32,3,2
1,465,465,37,6,31,4,3

1,434,434,44,44,0,1,0
0,497,497,50,50,0,1,0

2,302,302,31,27,4,2,1
0,321,321,25,25,0,1,0
1,489,489,11,11,0,1,0

0,198,198,15,15,0,1,0
2,380,380,6,6,0,1,0
1,390,390,4,4,0,1,0
3,401,401,41,14,27,2,1

1,189,189,19,19,0,1,0
0,360,360,37,37,0,1,0

1,226,226,1,1,0,1,0
2,410,410,41,30,11,2,1
0,452,452,45,19,26,3,2

0,203,203,21,5,16,2,1
1,382,382,39,5,34,3,2

2,180,180,18,18,0,1,0
1,231,231,7,7,0,1,0
0,277,277,20,4,16,4,3

0,187,187,1,1,0,1,0
2,300,300,14,14,0,1,0
3,439,439,44,44,0,1,0
1,453,453,22,22,0,1,0

1,240,240,24,2,22,4,3
0,405,405,41,10,31,4,3

0,214,214,22,22,0,1,0
1,216,216,22,22,0,1,0

1,311,311,32,32,0,1,0
0,492,492,50,38,12,3,2

1,154,154,7,1,6,2,1
3,158,158,16,7,9,4,3
0,346,346,10,10,0,1,0
2,469,469,13,13,0,1,0

2,276,276,28,2,26,3,2
1,346,346,22,22,0,1,0
0,487,487,18,18,0,1,0

1,319,319,6,6,0,1,0
2,351,351,36,1,35,4,3
0,489,489,41,12,29,4,3

1,139,139,14,5,9,2,1
0,192,192,20,20,0,1,0

1,449,449,45,7,38,3,2
0,477,477,48,28,20,3,2

1,139,139,14,5,9,3,2
0,271,271,28,28,0,1,0

2,172,172,18,18,0,1,0
1,254,254,20,20,0,1,0
0,320,320,8,2,6,3,2

4,159,159,16,4,12,3,2
2,191,191,5,5,0,1,0
0,367,367,13,13,0,1,0
3,403,403,6,1,5,2,1
1,464,464,11,11,0,1,0

0,282,282,18,15,3,2,1
2,293,293,30,12,18,4,3
1,435,435,16,8,8,2,1

1,181,181,2,2,0,1,0
3,211,211,22,10,12,2,1
2,408,408,34,22,12,3,2
0,434,434,3,3,0,1,0

1,114,114,5,5,0,1,0
2,145,145,15,1,14,3,2
0,483,483,28,28,0,1,0

0,143,143,15,1,14,2,1
1,321,321,33,33,0,1,0

2,101,101,9,3,6,3,2
3,218,218,22,22,0,1,0
0,237,237,1,1,0,1,0
1,427,427,4,4,0,1,0

1,135,135,3,3,0,1,0
2,151,151,16,1,15,4,3
0,390,390,33,17,16,3,2

1,228,228,23,20,3,2,1
0,377,377,38,38,0,1,0

0,301,301,30,30,0,1,0
1,366,366,1,1,0,1,0
2,438,438,44,44,0,1,0

2,225,225,23,23,0,1,0
0,248,248,18,18,0,1,0
1,268,268,8,8,0,1,0

0,263,263,24,24,0,1,0
1,376,376,4,4,0,1,0
2,476,476,48,4,44,2,1

1,131,131,12,3,9,2,1
2,352,352,36,30,6,2,1
0,431,431,5,5,0,1,0

1,180,180,18,2,16,4,3
0,342,342,35,24,11,2,1

1,116,116,3,3,0,1,0
2,119,119,12,12,0,1,0
0,403,403,32,32,0,1,0

0,201,201,21,12,9,4,3
1,478,478,48,48,0,1,0

0,175,175,18,18,0,1,0
1,309,309,31,31,0,1,0

4,292,292,12,12,0,1,0
3,312,312,5,5,0,1,0
5,317,317,32,29,3,2,1
1,354,354,1,1,0,1,0
2,362,362,6,2,4,2,1
0,435,435,11,3,8,2,1

2,200,200,2,2,0,1,0
0,276,276,7,7,0,1,0
1,472,472,32,12,20,3,2
3,492,492,50,23,27,4,3

1,106,106,7,7,0,1,0
0,278,278,2,2,0,1,0
2,460,460,13,5,8,2,1
3,475,475,48,7,41,2,1

1,260,260,26,26,0,1,0
0,402,402,41,8,33,2,1

0,116,116,3,3,0,1,0
1,219,219,17,17,0,1,0
2,391,391,40,14,26,4,3

3,100,100,1,1,0,1,0
5,123,123,1,1,0,1,0
4,221,221,9,3,6,3,2
6,306,306,31,31,0,1,0
1,319,319,8,8,0,1,0
0,362,362,6,6,0,1,0
2,388,388,1,1,0,1,0

1,114,114,5,5,0,1,0
3,155,155,16,5,11,2,1
0,409,409,21,7,14,2,1
2,456,456,3,3,0,1,0

3,154,154,16,16,0,1,0
2,232,232,20,20,0,1,0
0,317,317,2,2,0,1,0
1,486,486,4,4,0,1,0

2,104,104,7,1,6,2,1
1,247,247,6,6,0,1,0
0,325,325,2,2,0,1,0
4,338,338,34,34,0,1,0
3,413,413,1,1,0,1,0

0,126,126,9,9,0,1,0
2,450,450,45,45,0,1,0
1,459,459,14,4,10,2,1

1,116,116,12,12,0,1,0
0,294,294,30,21,9,4,3

1,138,138,4,4,0,1,0
4,138,138,14,14,0,1,0
3,158,158,6,2,4,2,1
0,248,248,6,3,3,2,1
2,452,452,4,4,0,1,0

1,167,167,17,17,0,1,0
0,323,323,33,24,9,2,1

0,334,334,34,16,18,2,1
1,424,424,43,17,26,3,2

0,142,142,3,3,0,1,0
3,161,161,10,2,8,3,2
1,198,198,1,1,0,1,0
5,265,265,27,3,24,4,3
4,291,291,2,2,0,1,0
2,416,416,3,3,0,1,0

0,174,174,14,4,10,2,1
2,324,324,1,1,0,1,0
1,364,364,7,7,0,1,0
3,489,489,49,3,46,3,2

1,113,113,2,2,0,1,0
2,121,121,13,13,0,1,0
0,431,431,37,37,0,1,0

1,182,182,1,1,0,1,0
2,256,256,2,2,0,1,0
3,278,278,11,11,0,1,0
4,404,404,41,23,18,3,2
0,427,427,21,21,0,1,0

2,157,157,16,2,14,3,2
0,287,287,23,23,0,1,0
1,429,429,9,2,7,2,1

1,411,411,42,42,0,1,0
0,481,481,49,20,29,4,3

0,112,112,2,2,0,1,0
1,299,299,25,13,12,4,3
2,340,340,34,9,25,2,1

0,137,137,14,14,0,1,0
1,298,298,30,8,22,2,1

1,402,402,14,2,12,4,3
2,434,434,44,14,30,2,1
0,445,445,30,30,0,1,0

3,187,187,19,5,14,3,2
2,232,232,5,5,0,1,0
0,265,265,17,3,14,2,1
1,433,433,8,8,0,1,0

0,212,212,11,3,8,3,2
1,271,271,3,3,0,1,0
2,276,276,11,11,0,1,0
3,391,391,40,40,0,1,0

1,238,238,24,4,20,2,1
0,453,453,46,46,0,1,0

3,258,258,26,4,22,2,1
2,314,314,16,5,11,2,1
0,401,401,18,15,3,2,1
1,427,427,3,3,0,1,0

2,299,299,6,2,4,2,1
1,345,345,26,26,0,1,0
0,346,346,2,2,0,1,0
3,437,437,44,4,40,2,1

2,116,116,1,1,0,1,0
4,225,225,23,23,0,1,0
3,274,274,4,1,3,2,1
1,386,386,12,12,0,1,0
0,387,387,18,18,0,1,0

2,195,195,10,4,6,3,2
1,247,247,1,1,0,1,0
0,273,273,13,13,0,1,0
3,342,342,35,35,0,1,0

0,130,130,1,1,0,1,0
2,181,181,19,19,0,1,0
1,471,471,44,44,0,1,0

0,164,164,17,6,11,2,1
1,241,241,25,5,20,4,3

3,140,140,14,1,13,2,1
2,145,145,11,11,0,1,0
0,188,188,1,1,0,1,0
1,380,380,8,2,6,3,2

0,297,297,30,4,26,3,2
1,487,487,49,49,0,1,0

4,168,168,17,17,0,1,0
3,335,335,2,2,0,1,0
0,357,357,15,15,0,1,0
2,357,357,6,2,4,2,1
1,393,393,15,1,14,3,2

0,178,178,17,17,0,1,0
2,442,442,45,12,33,3,2
1,488,488,3,3,0,1,0

2,126,126,1,1,0,1,0
3,289,289,29,24,5,2,1
1,322,322,27,4,23,2,1
0,455,455,7,7,0,1,0

0,157,157,12,12,0,1,0
2,237,237,24,9,15,4,3
1,449,449,11,11,0,1,0

2,125,125,13,1,12,4,3
1,376,376,22,10,12,4,3
0,467,467,20,20,0,1,0

1,103,103,1,1,0,1,0
0,170,170,3,3,0,1,0
2,246,246,18,18,0,1,0
3,337,337,34,34,0,1,0

1,136,136,14,5,9,4,3
0,371,371,38,38,0,1,0

0,266,266,27,27,0,1,0
1,345,345,35,23,12,2,1

0,289,289,29,29,0,1,0
1,309,309,31,27,4,2,1

1,135,135,14,1,13,2,1
0,400,400,41,41,0,1,0

2,176,176,18,1,17,2,1
0,193,193,2,2,0,1,0
1,317,317,29,6,23,2,1

1,301,301,17,7,10,3,2
0,351,351,16,8,8,3,2
2,466,466,47,47,0,1,0

2,239,239,24,24,0,1,0
1,315,315,25,25,0,1,0
0,322,322,7,7,0,1,0

1,161,161,7,1,6,2,1
2,401,401,41,4,37,4,3
0,461,461,28,28,0,1,0

3,111,111,12,8,4,2,1
1,151,151,10,10,0,1,0
0,431,431,3,3,0,1,0
2,454,454,13,13,0,1,0

3,111,111,12,12,0,1,0
0,306,306,17,17,0,1,0
2,372,372,14,14,0,1,0
1,476,476,4,4,0,1,0

2,116,116,12,12,0,1,0
0,373,373,30,10,20,2,1
1,441,441,9,9,0,1,0

0,215,215,22,22,0,1,0
1,385,385,39,22,17,2,1

1,325,325,32,11,21,2,1
0,450,450,1,1,0,1,0
2,468,468,47,23,24,2,1

1,212,212,22,13,9,4,3
0,355,355,36,36,0,1,0

1,180,180,12,12,0,1,0
2,259,259,26,17,9,2,1
0,300,300,11,3,8,3,2

0,138,138,1,1,0,1,0
1,212,212,20,17,3,2,1
2,434,434,44,44,0,1,0

1,144,144,15,9,6,2,1
0,484,484,49,49,0,1,0

0,326,326,22,22,0,1,0
2,475,475,48,48,0,1,0
1,490,490,16,16,0,1,0

1,187,187,18,5,13,2,1
0,195,195,1,1,0,1,0
2,333,333,34,34,0,1,0

2,179,179,18,18,0,1,0
0,257,257,4,4,0,1,0
1,310,310,27,27,0,1,0

1,205,205,21,5,16,3,2
0,451,451,46,27,19,2,1

3,269,269,27,27,0,1,0
2,312,312,6,6,0,1,0
1,403,403,1,1,0,1,0
0,433,433,35,11,24,3,2

1,135,135,8,8,0,1,0
2,214,214,22,22,0,1,0
0,448,448,21,21,0,1,0

1,124,124,2,2,0,1,0
0,261,261,23,17,6,3,2
2,370,370,37,2,35,2,1

1,136,136,14,4,10,2,1
0,325,325,1,1,0,1,0
2,437,437,44,29,15,2,1

0,340,340,16,8,8,2,1
2,440,440,44,28,16,2,1
1,477,477,26,26,0,1,0

0,176,176,18,3,15,4,3
1,183,183,19,19,0,1,0

0,263,263,27,1,26,3,2
1,292,292,30,30,0,1,0

1,301,301,31,31,0,1,0
0,404,404,41,23,18,4,3

1,158,158,4,4,0,1,0
3,306,306,31,17,14,2,1
0,425,425,18,8,10,2,1
2,500,500,17,17,0,1,0

0,105,105,10,10,0,1,0
1,162,162,1,1,0,1,0
2,207,207,21,7,14,2,1

1,347,347,35,32,3,2,1
0,393,393,40,1,39,2,1

0,200,200,12,12,0,1,0
1,404,404,17,8,9,2,1
2,418,418,42,42,0,1,0

0,235,235,3,3,0,1,0
4,305,305,31,14,17,2,1
2,407,407,1,1,0,1,0
1,438,438,37,2,35,2,1
3,460,460,1,1,0,1,0

0,341,341,21,21,0,1,0
2,392,392,40,18,22,2,1
1,465,465,18,11,7,2,1

1,142,142,9,9,0,1,0
3,203,203,21,21,0,1,0
0,260,260,2,2,0,1,0
2,358,358,11,6,5,2,1

0,218,218,22,11,11,3,2
1,274,274,28,28,0,1,0

0,121,121,13,13,0,1,0
1,285,285,29,29,0,1,0

0,176,176,18,18,0,1,0
1,427,427,43,21,22,2,1

1,149,149,6,1,5,2,1
3,343,343,35,35,0,1,0
2,351,351,21,21,0,1,0
0,412,412,1,1,0,1,0

0,146,146,6,6,0,1,0
2,372,372,38,17,21,4,3
1,486,486,29,9,20,2,1

3,166,166,17,17,0,1,0
1,220,220,6,3,3,2,1
2,340,340,22,13,9,2,1
0,392,392,4,1,3,2,1

1,164,164,16,16,0,1,0
2,324,324,33,33,0,1,0
0,361,361,1,1,0,1,0

1,215,215,5,2,3,2,1
2,334,334,4,4,0,1,0
0,414,414,27,18,9,2,1
3,414,414,42,22,20,3,2

2,146,146,15,15,0,1,0
1,337,337,31,31,0,1,0
0,486,486,5,5,0,1,0

1,296,296,30,25,5,2,1
0,358,358,36,36,0,1,0

3,214,214,18,18,0,1,0
2,224,224,1,1,0,1,0
4,263,263,27,23,4,2,1
1,390,390,1,1,0,1,0
0,444,444,4,4,0,1,0

1,153,153,2,2,0,1,0
0,366,366,33,18,15,4,3
2,478,478,48,48,0,1,0

1,196,196,20,20,0,1,0
0,428,428,43,28,15,3,2

1,187,187,19,19,0,1,0
0,306,306,31,31,0,1,0

2,155,155,5,5,0,1,0
3,408,408,41,8,33,2,1
1,431,431,22,10,12,2,1
0,459,459,9,9,0,1,0

1,151,151,2,2,0,1,0
2,271,271,28,28,0,1,0
0,449,449,39,10,29,2,1

3,115,115,12,12,0,1,0
0,201,201,1,1,0,1,0
2,204,204,9,9,0,1,0
1,452,452,24,5,19,2,1

0,324,324,33,17,16,2,1
1,404,404,41,25,16,3,2

0,155,155,8,8,0,1,0
1,295,295,15,15,0,1,0
2,349,349,35,4,31,2,1

0,314,314,32,32,0,1,0
1,378,378,38,23,15,2,1

1,157,157,16,1,15,4,3
0,279,279,28,19,9,4,3

0,361,361,33,33,0,1,0
2,371,371,38,9,29,2,1
1,487,487,5,5,0,1,0

0,128,128,1,1,0,1,0
2,206,206,21,17,4,2,1
1,365,365,34,34,0,1,0

4,146,146,15,15,0,1,0
2,199,199,3,3,0,1,0
3,210,210,5,5,0,1,0
1,448,448,17,8,9,4,3
0,491,491,13,13,0,1,0

1,113,113,2,2,0,1,0
3,140,140,14,14,0,1,0
0,207,207,3,3,0,1,0
2,283,283,20,20,0,1,0

2,180,180,18,18,0,1,0
1,340,340,19,4,15,3,2
0,418,418,19,19,0,1,0

0,167,167,1,1,0,1,0
3,201,201,3,3,0,1,0
4,315,315,32,23,9,4,3
2,412,412,2,2,0,1,0
1,474,474,37,37,0,1,0

1,169,169,13,13,0,1,0
0,242,242,6,6,0,1,0
2,307,307,31,31,0,1,0

2,122,122,2,2,0,1,0
0,155,155,10,10,0,1,0
3,186,186,19,19,0,1,0
1,433,433,11,11,0,1,0

0,232,232,20,20,0,1,0
2,334,334,34,34,0,1,0
1,364,364,6,6,0,1,0

1,187,187,10,1,9,4,3
0,223,223,11,11,0,1,0
2,469,469,47,13,34,3,2

0,153,153,16,16,0,1,0
1,295,295,30,30,0,1,0

1,144,144,9,9,0,1,0
2,347,347,35,3,32,3,2
0,465,465,20,20,0,1,0

2,103,103,11,11,0,1,0
1,414,414,12,12,0,1,0
0,444,444,32,32,0,1,0

1,209,209,21,21,0,1,0
0,427,427,43,43,0,1,0

0,251,251,1,1,0,1,0
3,344,344,25,8,17,3,2
2,350,350,7,2,5,2,1
1,422,422,2,2,0,1,0
4,466,466,47,32,15,2,1

0,242,242,5,5,0,1,0
2,259,259,26,1,25,3,2
1,364,364,29,29,0,1,0

0,151,151,1,1,0,1,0
2,200,200,12,12,0,1,0
1,221,221,8,5,3,2,1
3,226,226,23,10,13,2,1

0,325,325,33,33,0,1,0
1,452,452,46,46,0,1,0

1,202,202,4,4,0,1,0
0,298,298,24,12,12,2,1
2,392,392,40,12,28,3,2

4,213,213,22,6,16,2,1
0,262,262,9,9,0,1,0
2,296,296,8,8,0,1,0
3,360,360,2,2,0,1,0
1,435,435,15,15,0,1,0

2,175,175,18,9,9,2,1
0,272,272,13,8,5,2,1
1,356,356,19,4,15,4,3

2,113,113,12,1,11,2,1
0,279,279,3,3,0,1,0
1,490,490,44,39,5,2,1

2,155,155,6,6,0,1,0
1,178,178,4,1,3,2,1
3,225,225,2,2,0,1,0
4,295,295,30,9,21,2,1
0,476,476,15,10,5,2,1

1,164,164,17,10,7,2,1
0,365,365,37,37,0,1,0

1,267,267,27,27,0,1,0
0,461,461,47,23,24,2,1

1,389,389,39,39,0,1,0
0,490,490,49,16,33,4,3

0,115,115,12,8,4,2,1
1,139,139,14,14,0,1,0

1,188,188,9,4,5,2,1
2,268,268,27,27,0,1,0
0,302,302,16,16,0,1,0

1,466,466,47,35,12,3,2
0,492,492,50,50,0,1,0

0,181,181,1,1,0,1,0
1,186,186,15,2,13,2,1
2,268,268,4,1,3,2,1
3,391,391,40,40,0,1,0

0,151,151,3,3,0,1,0
1,259,259,16,2,14,2,1
3,356,356,36,27,9,4,3
2,406,406,8,8,0,1,0

0,263,263,13,4,9,4,3
3,293,293,12,12,0,1,0
1,295,295,2,2,0,1,0
4,316,316,32,32,0,1,0
2,392,392,2,2,0,1,0

0,449,449,45,41,4,2,1
1,490,490,49,49,0,1,0

0,323,323,33,33,0,1,0
1,340,340,34,34,0,1,0

0,249,249,16,16,0,1,0
2,456,456,46,16,30,3,2
1,474,474,17,17,0,1,0

1,237,237,1,1,0,1,0
2,301,301,15,9,6,2,1
3,400,400,40,30,10,2,1
0,489,489,23,18,5,2,1

0,224,224,23,1,22,3,2
1,471,471,48,10,38,2,1

2,279,279,21,1,20,2,1
1,288,288,1,1,0,1,0
3,309,309,2,2,0,1,0
4,316,316,32,5,27,4,3
0,343,343,6,2,4,2,1

0,166,166,17,17,0,1,0
1,370,370,37,37,0,1,0

0,218,218,22,22,0,1,0
1,239,239,24,24,0,1,0

2,304,304,1,1,0,1,0
1,314,314,1,1,0,1,0
3,403,403,15,4,11,2,1
4,446,446,45,45,0,1,0
0,463,463,27,27,0,1,0

1,151,151,16,2,14,3,2
0,467,467,47,47,0,1,0

1,145,145,15,15,0,1,0
0,245,245,25,1,24,3,2

0,171,171,8,8,0,1,0
1,174,174,10,10,0,1,0
2,245,245,25,5,20,4,3

1,261,261,27,27,0,1,0
0,313,313,32,32,0,1,0

0,343,343,35,7,28,3,2
1,414,414,42,13,29,2,1

0,145,145,2,2,0,1,0
2,158,158,5,5,0,1,0
1,227,227,10,10,0,1,0
4,290,290,29,23,6,3,2
3,363,363,4,4,0,1,0

1,125,125,10,10,0,1,0
0,224,224,5,5,0,1,0
2,254,254,26,1,25,4,3

1,238,238,24,24,0,1,0
0,350,350,36,20,16,3,2

1,246,246,25,25,0,1,0
0,487,487,49,49,0,1,0

0,298,298,30,30,0,1,0
1,496,496,50,50,0,1,0

1,119,119,7,3,4,2,1
0,274,274,5,5,0,1,0
2,282,282,7,7,0,1,0
3,348,348,35,35,0,1,0

0,196,196,20,20,0,1,0
1,315,315,32,32,0,1,0

1,132,132,13,2,11,4,3
2,188,188,19,19,0,1,0
0,405,405,3,3,0,1,0

2,118,118,12,12,0,1,0
1,305,305,19,19,0,1,0
0,450,450,17,17,0,1,0

0,313,313,32,11,21,2,1
1,355,355,36,36,0,1,0

1,206,206,21,18,3,2,1
0,483,483,49,49,0,1,0

1,163,163,17,9,8,3,2
0,265,265,27,27,0,1,0

0,124,124,13,2,11,2,1
1,485,485,49,22,27,4,3

1,251,251,8,8,0,1,0
2,438,438,44,44,0,1,0
0,454,454,32,2,30,2,1

1,185,185,19,19,0,1,0
0,461,461,47,33,14,2,1

4,131,131,2,2,0,1,0
0,176,176,4,4,0,1,0
2,361,361,1,1,0,1,0
5,374,374,38,38,0,1,0
3,387,387,20,20,0,1,0
1,428,428,4,4,0,1,0

3,135,135,14,6,8,3,2
0,191,191,2,2,0,1,0
1,205,205,17,17,0,1,0
2,256,256,2,2,0,1,0

0,159,159,9,9,0,1,0
2,201,201,21,21,0,1,0
1,282,282,13,4,9,2,1

2,104,104,4,4,0,1,0
3,163,163,17,9,8,3,2
1,394,394,3,3,0,1,0
0,420,420,26,14,12,3,2

1,211,211,4,4,0,1,0
0,420,420,35,13,22,3,2
2,467,467,47,47,0,1,0

2,186,186,12,4,8,2,1
3,342,342,35,8,27,4,3
0,421,421,2,2,0,1,0
1,434,434,14,4,10,3,2

2,186,186,19,19,0,1,0
0,328,328,28,28,0,1,0
1,413,413,7,7,0,1,0

0,108,108,10,2,8,2,1
1,183,183,2,2,0,1,0
2,286,286,29,21,8,2,1

1,101,101,6,6,0,1,0
2,200,200,20,4,16,4,3
0,487,487,20,20,0,1,0

2,199,199,7,1,6,3,2
1,383,383,16,16,0,1,0
0,405,405,10,1,9,2,1
3,471,471,48,40,8,3,2

0,131,131,14,14,0,1,0
1,362,362,37,22,15,4,3

1,101,101,7,7,0,1,0
0,252,252,8,8,0,1,0
2,312,312,32,32,0,1,0

2,176,176,1,1,0,1,0
3,210,210,4,4,0,1,0
0,218,218,7,7,0,1,0
1,461,461,21,1,20,3,2
4,490,490,49,49,0,1,0

1,133,133,14,6,8,3,2
0,336,336,34,34,0,1,0

2,113,113,12,1,11,2,1
0,260,260,14,14,0,1,0
1,463,463,22,16,6,3,2

1,225,225,22,4,18,2,1
0,267,267,1,1,0,1,0
2,333,333,34,34,0,1,0

2,229,229,23,23,0,1,0
0,248,248,3,3,0,1,0
1,383,383,34,34,0,1,0

2,282,282,4,4,0,1,0
3,321,321,33,14,19,2,1
1,350,350,26,14,12,3,2
0,482,482,6,6,0,1,0

1,443,443,18,11,7,2,1
0,444,444,27,13,14,3,2
2,495,495,50,8,42,2,1

1,143,143,5,5,0,1,0
2,373,373,38,38,0,1,0
0,422,422,30,30,0,1,0

2,160,160,16,7,9,4,3
1,200,200,12,5,7,2,1
0,395,395,16,16,0,1,0

1,167,167,17,5,12,2,1
0,309,309,31,31,0,1,0

0,119,119,4,4,0,1,0
2,208,208,21,21,0,1,0
1,254,254,17,17,0,1,0

2,144,144,15,15,0,1,0
0,208,208,7,7,0,1,0
1,258,258,18,2,16,3,2

1,224,224,22,22,0,1,0
2,272,272,28,21,7,2,1
0,350,350,2,2,0,1,0

0,120,120,1,1,0,1,0
2,162,162,17,5,12,3,2
1,177,177,17,5,12,4,3

2,141,141,10,4,6,3,2
3,400,400,40,20,20,2,1
0,447,447,7,1,6,3,2
1,447,447,7,7,0,1,0

2,133,133,14,14,0,1,0
0,341,341,19,19,0,1,0
1,470,470,21,21,0,1,0

1,121,121,4,1,3,2,1
2,133,133,3,3,0,1,0
3,166,166,1,1,0,1,0
4,325,325,33,3,30,3,2
0,402,402,16,16,0,1,0

1,211,211,16,16,0,1,0
2,340,340,34,34,0,1,0
0,416,416,12,7,5,2,1

1,103,103,1,1,0,1,0
0,190,190,18,4,14,3,2
2,342,342,35,9,26,2,1

1,126,126,3,3,0,1,0
3,295,295,30,30,0,1,0
0,364,364,22,2,20,2,1
2,445,445,8,3,5,2,1

0,283,283,29,29,0,1,0
1,407,407,41,41,0,1,0

1,199,199,13,2,11,2,1
0,261,261,10,10,0,1,0
2,351,351,36,10,26,3,2

0,337,337,34,34,0,1,0
1,476,476,48,22,26,4,3

2,325,325,33,33,0,1,0
1,396,396,10,10,0,1,0
0,494,494,38,38,0,1,0

0,274,274,28,28,0,1,0
1,285,285,29,29,0,1,0

3,307,307,31,23,8,3,2
1,341,341,1,1,0,1,0
2,355,355,26,9,17,2,1
0,420,420,11,8,3,2,1

0,258,258,25,25,0,1,0
1,403,403,2,2,0,1,0
2,412,412,42,42,0,1,0

2,127,127,13,13,0,1,0
0,453,453,33,33,0,1,0
1,463,463,13,13,0,1,0

1,113,113,2,2,0,1,0
2,153,153,16,4,12,4,3
0,410,410,34,34,0,1,0

0,191,191,5,1,4,2,1
1,316,316,9,6,3,2,1
3,400,400,40,40,0,1,0
2,432,432,20,5,15,2,1

2,236,236,24,24,0,1,0
0,372,372,24,2,22,3,2
1,479,479,17,17,0,1,0

0,209,209,7,2,5,2,1
2,294,294,14,5,9,4,3
3,390,390,39,3,36,4,3
1,409,409,9,9,0,1,0

0,109,109,11,1,10,3,2
1,451,451,46,35,11,2,1

2,155,155,16,6,10,2,1
0,300,300,1,1,0,1,0
1,303,303,30,30,0,1,0

2,401,401,41,12,29,2,1
1,419,419,19,19,0,1,0
0,492,492,27,27,0,1,0

2,109,109,11,1,10,3,2
1,176,176,15,1,14,3,2
0,472,472,8,8,0,1,0

0,297,297,30,9,21,3,2
1,413,413,42,12,30,4,3

5,280,280,28,28,0,1,0
2,301,301,12,4,8,3,2
1,309,309,6,1,5,2,1
4,392,392,9,9,0,1,0
0,406,406,4,4,0,1,0
3,490,490,4,4,0,1,0

2,110,110,11,3,8,3,2
1,238,238,21,21,0,1,0
0,395,395,5,2,3,2,1

2,261,261,27,6,21,2,1
1,289,289,23,23,0,1,0
0,290,290,6,6,0,1,0

2,114,114,4,1,3,2,1
1,203,203,1,1,0,1,0
3,208,208,3,3,0,1,0
5,243,243,25,2,23,2,1
0,382,382,12,12,0,1,0
4,477,477,7,4,3,2,1

1,219,219,10,4,6,2,1
2,463,463,47,47,0,1,0
0,465,465,27,9,18,2,1

1,269,269,27,27,0,1,0
0,421,421,43,10,33,4,3

1,197,197,1,1,0,1,0
3,280,280,11,7,4,2,1
4,289,289,29,16,13,2,1
2,419,419,20,11,9,3,2
0,423,423,4,4,0,1,0

1,183,183,6,3,3,2,1
2,306,306,31,31,0,1,0
0,337,337,23,23,0,1,0

1,279,279,28,2,26,2,1
0,398,398,40,31,9,2,1

1,210,210,6,6,0,1,0
2,307,307,31,31,0,1,0
0,382,382,28,28,0,1,0

1,185,185,15,15,0,1,0
2,461,461,47,27,20,2,1
0,476,476,10,10,0,1,0

1,272,272,28,28,0,1,0
0,443,443,45,24,21,4,3

1,249,249,1,1,0,1,0
0,317,317,1,1,0,1,0
2,334,334,32,32,0,1,0
3,419,419,42,21,21,2,1

2,151,151,16,16,0,1,0
1,222,222,7,7,0,1,0
0,399,399,28,16,12,2,1

0,123,123,3,3,0,1,0
3,179,179,3,3,0,1,0
4,278,278,28,10,18,2,1
1,348,348,20,17,3,2,1
2,424,424,1,1,0,1,0

1,435,435,40,13,27,4,3
2,446,446,45,45,0,1,0
0,459,459,4,4,0,1,0

0,143,143,5,5,0,1,0
2,207,207,21,21,0,1,0
1,401,401,27,1,26,3,2

2,125,125,8,4,4,2,1
0,186,186,3,3,0,1,0
1,446,446,10,2,8,3,2
3,497,497,50,42,8,2,1

1,260,260,26,4,22,2,1
0,438,438,44,44,0,1,0

1,131,131,6,1,5,2,1
0,230,230,11,5,6,2,1
3,371,371,38,38,0,1,0
2,388,388,3,3,0,1,0

0,106,106,2,2,0,1,0
1,122,122,7,7,0,1,0
3,228,228,23,3,20,3,2
2,241,241,6,6,0,1,0

0,234,234,24,24,0,1,0
1,245,245,25,13,12,4,3

1,196,196,14,2,12,3,2
0,263,263,8,2,6,3,2
2,441,441,45,29,16,3,2

2,145,145,1,1,0,1,0
1,161,161,1,1,0,1,0
4,219,219,22,6,16,3,2
3,362,362,29,5,24,2,1
0,466,466,4,4,0,1,0

0,369,369,19,19,0,1,0
2,393,393,11,11,0,1,0
1,394,394,9,3,6,3,2
3,437,437,44,28,16,4,3

0,155,155,3,3,0,1,0
1,275,275,14,8,6,3,2
3,397,397,40,3,37,4,3
2,467,467,14,3,11,4,3

0,379,379,38,22,16,3,2
1,449,449,45,33,12,3,2

0,290,290,29,21,8,3,2
1,433,433,44,44,0,1,0

3,146,146,15,5,10,2,1
0,149,149,1,1,0,1,0
2,168,168,4,4,0,1,0
1,217,217,16,1,15,4,3

0,190,190,17,17,0,1,0
1,294,294,4,4,0,1,0
2,440,440,44,18,26,3,2

1,277,277,28,28,0,1,0
0,439,439,44,23,21,2,1

1,166,166,12,12,0,1,0
0,442,442,13,1,12,2,1
2,473,473,48,48,0,1,0

1,212,212,3,3,0,1,0
4,278,278,3,3,0,1,0
5,296,296,30,30,0,1,0
2,348,348,5,1,4,2,1
0,427,427,14,5,9,4,3
3,489,489,14,14,0,1,0

0,222,222,23,5,18,4,3
1,246,246,25,25,0,1,0

1,127,127,3,3,0,1,0
0,157,157,13,3,10,3,2
2,464,464,47,47,0,1,0

0,233,233,3,3,0,1,0
2,255,255,26,26,0,1,0
1,259,259,23,11,12,4,3

0,290,290,29,29,0,1,0
1,460,460,46,46,0,1,0

0,206,206,9,4,5,2,1
2,223,223,23,1,22,3,2
1,378,378,22,22,0,1,0

1,145,145,9,9,0,1,0
0,200,200,8,3,5,2,1
2,427,427,43,43,0,1,0

1,235,235,24,2,22,3,2
0,311,311,32,32,0,1,0

1,306,306,7,7,0,1,0
2,413,413,42,2,40,2,1
0,449,449,36,36,0,1,0

0,234,234,11,11,0,1,0
1,286,286,16,4,12,4,3
2,324,324,33,12,21,4,3

2,130,130,13,10,3,2,1
1,315,315,7,7,0,1,0
0,360,360,28,28,0,1,0

1,210,210,21,6,15,2,1
0,219,219,22,18,4,2,1

2,177,177,18,18,0,1,0
0,179,179,7,7,0,1,0
1,323,323,20,20,0,1,0

2,201,201,21,21,0,1,0
1,270,270,4,4,0,1,0
0,287,287,25,7,18,3,2

2,210,210,11,11,0,1,0
3,250,250,25,15,10,3,2
1,291,291,8,8,0,1,0
0,486,486,12,2,10,2,1

1,106,106,11,11,0,1,0
0,165,165,17,17,0,1,0

1,136,136,6,6,0,1,0
2,320,320,32,32,0,1,0
0,324,324,20,2,18,4,3

2,120,120,12,5,7,2,1
0,158,158,12,4,8,3,2
1,263,263,7,7,0,1,0

0,106,106,1,1,0,1,0
1,122,122,3,3,0,1,0
4,124,124,13,7,6,2,1
3,135,135,5,5,0,1,0
2,277,277,9,9,0,1,0

0,134,134,10,10,0,1,0
1,138,138,1,1,0,1,0
2,299,299,6,6,0,1,0
3,464,464,47,47,0,1,0

0,164,164,5,5,0,1,0
2,263,263,13,4,9,2,1
1,284,284,1,1,0,1,0
4,325,325,33,20,13,2,1
3,454,454,8,8,0,1,0

1,101,101,3,3,0,1,0
2,178,178,18,15,3,2,1
0,213,213,15,11,4,2,1

0,112,112,1,1,0,1,0
1,172,172,13,5,8,3,2
2,243,243,4,4,0,1,0
3,406,406,41,15,26,4,3

0,107,107,1,1,0,1,0
2,176,176,18,6,12,3,2
1,323,323,30,30,0,1,0

1,121,121,1,1,0,1,0
0,128,128,1,1,0,1,0
4,214,214,1,1,0,1,0
5,216,216,1,1,0,1,0
2,338,338,10,7,3,2,1
6,368,368,2,2,0,1,0
3,428,428,18,2,16,2,1
7,451,451,46,5,41,3,2

0,341,341,35,2,33,2,1
1,368,368,37,8,29,3,2

1,109,109,7,7,0,1,0
2,269,269,27,27,0,1,0
0,373,373,15,9,6,3,2

0,220,220,22,22,0,1,0
1,321,321,33,33,0,1,0

0,117,117,6,3,3,2,1
2,120,120,12,12,0,1,0
1,295,295,15,15,0,1,0

0,215,215,22,5,17,2,1
1,490,490,49,39,10,3,2

1,273,273,10,10,0,1,0
0,431,431,28,4,24,3,2
2,471,471,48,10,38,3,2

0,226,226,23,23,0,1,0
1,360,360,36,24,12,4,3

1,416,416,23,23,0,1,0
3,427,427,43,11,32,4,3
2,435,435,11,11,0,1,0
0,469,469,10,10,0,1,0

2,129,129,13,13,0,1,0
0,173,173,8,1,7,2,1
1,320,320,18,18,0,1,0

0,202,202,21,21,0,1,0
1,462,462,47,47,0,1,0

1,155,155,16,9,7,2,1
0,226,226,23,5,18,4,3

3,144,144,2,2,0,1,0
4,219,219,22,5,17,3,2
1,269,269,3,3,0,1,0
2,363,363,3,3,0,1,0
0,424,424,30,7,23,2,1

0,163,163,5,5,0,1,0
2,178,178,6,6,0,1,0
4,273,273,28,21,7,2,1
1,287,287,3,3,0,1,0
3,410,410,11,1,10,2,1

3,251,251,26,26,0,1,0
2,302,302,23,3,20,3,2
0,458,458,11,3,8,3,2
1,485,485,1,1,0,1,0

0,237,237,9,9,0,1,0
1,445,445,28,28,0,1,0
2,477,477,48,1,47,2,1

1,148,148,10,10,0,1,0
0,292,292,10,10,0,1,0
2,416,416,42,21,21,2,1

2,201,201,3,3,0,1,0
3,238,238,24,24,0,1,0
0,356,356,1,1,0,1,0
1,395,395,34,34,0,1,0

0,275,275,28,20,8,2,1
1,276,276,28,21,7,2,1

0,213,213,21,15,6,2,1
2,422,422,43,11,32,4,3
1,464,464,1,1,0,1,0

0,194,194,13,5,8,2,1
2,230,230,23,23,0,1,0
1,282,282,10,10,0,1,0

0,104,104,11,11,0,1,0
1,239,239,24,16,8,3,2

0,258,258,26,13,13,4,3
1,402,402,41,41,0,1,0

1,109,109,11,3,8,3,2
0,224,224,23,23,0,1,0

1,111,111,11,11,0,1,0
2,117,117,12,1,11,2,1
0,468,468,4,4,0,1,0

2,202,202,21,21,0,1,0
1,366,366,9,9,0,1,0
0,496,496,38,38,0,1,0

1,117,117,12,12,0,1,0
0,261,261,27,27,0,1,0

0,113,113,6,1,5,2,1
1,180,180,2,2,0,1,0
2,298,298,11,6,5,2,1
3,405,405,41,41,0,1,0

0,189,189,19,19,0,1,0
1,422,422,43,3,40,2,1

0,243,243,25,25,0,1,0
1,496,496,50,50,0,1,0

1,122,122,4,4,0,1,0
2,317,317,32,24,8,2,1
0,500,500,34,34,0,1,0

0,264,264,27,3,24,3,2
1,472,472,48,2,46,3,2

2,130,130,13,2,11,2,1
0,239,239,1,1,0,1,0
1,375,375,36,12,24,3,2

1,100,100,10,4,6,2,1
0,300,300,30,12,18,4,3

2,157,157,7,7,0,1,0
3,211,211,22,22,0,1,0
1,236,236,1,1,0,1,0
0,263,263,14,10,4,2,1

2,126,126,13,8,5,2,1
0,291,291,15,7,8,3,2
1,304,304,15,9,6,3,2

1,205,205,6,6,0,1,0
0,279,279,20,20,0,1,0
2,310,310,31,7,24,4,3

2,264,264,27,27,0,1,0
1,355,355,9,5,4,2,1
0,391,391,30,19,11,2,1

1,122,122,13,13,0,1,0
0,167,167,17,17,0,1,0

0,318,318,32,32,0,1,0
1,402,402,41,41,0,1,0

0,218,218,22,22,0,1,0
1,373,373,38,38,0,1,0

0,146,146,1,1,0,1,0
5,226,226,23,16,7,2,1
3,400,400,4,4,0,1,0
4,436,436,4,4,0,1,0
2,473,473,6,6,0,1,0
1,498,498,31,31,0,1,0

2,391,391,23,23,0,1,0
1,413,413,1,1,0,1,0
0,415,415,1,1,0,1,0
3,434,434,16,16,0,1,0
4,492,492,50,31,19,2,1

0,382,382,39,9,30,4,3
1,410,410,41,20,21,4,3

2,274,274,28,28,0,1,0
1,327,327,32,14,18,4,3
0,331,331,1,1,0,1,0

1,150,150,1,1,0,1,0
0,228,228,17,17,0,1,0
2,356,356,7,7,0,1,0
3,389,389,39,39,0,1,0

1,195,195,2,2,0,1,0
0,355,355,29,17,12,3,2
3,384,384,2,2,0,1,0
4,401,401,41,10,31,2,1
2,406,406,2,2,0,1,0

1,117,117,12,12,0,1,0
0,166,166,17,8,9,2,1

2,220,220,1,1,0,1,0
0,288,288,2,2,0,1,0
3,323,323,8,8,0,1,0
1,336,336,22,19,3,2,1
4,461,461,47,47,0,1,0

0,194,194,1,1,0,1,0
3,403,403,41,5,36,3,2
2,407,407,4,4,0,1,0
1,486,486,42,42,0,1,0

0,444,444,45,45,0,1,0
1,494,494,50,50,0,1,0

0,115,115,6,6,0,1,0
1,175,175,9,6,3,2,1
2,250,250,25,1,24,2,1

2,132,132,14,5,9,2,1
0,231,231,1,1,0,1,0
1,394,394,38,38,0,1,0

1,158,158,4,4,0,1,0
0,254,254,19,19,0,1,0
2,434,434,44,16,28,2,1

0,112,112,8,1,7,2,1
1,222,222,7,4,3,2,1
2,428,428,43,3,40,3,2

1,109,109,11,7,4,2,1
0,387,387,39,39,0,1,0

0,349,349,35,30,5,2,1
1,460,460,46,46,0,1,0

1,108,108,11,11,0,1,0
0,399,399,40,8,32,4,3

