1,201,201,15,15,0,1,0
0,386,386,11,11,0,1,0
3,427,427,86,86,0,1,0
2,467,467,46,46,0,1,0

0,278,278,5,5,0,1,0
3,296,296,4,4,0,1,0
1,336,336,25,25,0,1,0
4,424,424,85,75,10,2,1
2,497,497,47,47,0,1,0

1,165,165,4,4,0,1,0
3,255,255,14,6,8,3,2
4,351,351,71,68,3,2,1
2,462,462,27,27,0,1,0
0,488,488,31,9,22,3,2

1,276,276,27,27,0,1,0
0,289,289,30,30,0,1,0
2,344,344,69,35,34,2,1

0,280,280,36,36,0,1,0
1,365,365,27,27,0,1,0
2,408,408,82,35,47,2,1

3,276,276,56,49,7,2,1
1,286,286,27,12,15,2,1
2,381,381,11,6,5,2,1
0,407,407,32,8,24,2,1

3,321,321,65,65,0,1,0
2,444,444,6,6,0,1,0
1,467,467,67,67,0,1,0
0,478,478,21,21,0,1,0

3,117,117,2,2,0,1,0
2,169,169,1,1,0,1,0
0,236,236,29,11,18,4,3
1,288,288,18,2,16,3,2
4,435,435,87,83,4,2,1

2,443,443,89,35,54,3,2
1,488,488,47,13,34,2,1
0,496,496,52,42,10,3,2

1,292,292,33,33,0,1,0
2,394,394,3,3,0,1,0
0,398,398,32,15,17,2,1
3,493,493,99,44,55,4,3

2,186,186,18,2,16,3,2
0,257,257,5,5,0,1,0
4,334,334,13,13,0,1,0
5,348,348,70,39,31,3,2
3,451,451,11,1,10,2,1
1,476,476,11,6,5,2,1

0,149,149,1,1,0,1,0
1,335,335,5,5,0,1,0
4,433,433,87,42,45,4,3
3,437,437,11,11,0,1,0
2,465,465,72,72,0,1,0

4,113,113,23,7,16,2,1
3,121,121,3,3,0,1,0
0,210,210,13,13,0,1,0
2,258,258,24,6,18,3,2
1,343,343,8,4,4,2,1

2,153,153,4,4,0,1,0
3,256,256,52,2,50,4,3
1,275,275,47,28,19,4,3
0,488,488,4,4,0,1,0

3,197,197,40,40,0,1,0
1,223,223,27,12,15,2,1
0,380,380,14,4,10,3,2
2,386,386,17,17,0,1,0

2,133,133,27,27,0,1,0
0,263,263,32,14,18,4,3
1,405,405,32,32,0,1,0

2,233,233,5,5,0,1,0
3,243,243,1,1,0,1,0
0,257,257,16,16,0,1,0
5,315,315,63,63,0,1,0
1,411,411,30,21,9,4,3
4,440,440,18,10,8,2,1

1,105,105,1,1,0,1,0
0,292,292,56,19,37,2,1
2,498,498,100,18,82,3,2

3,107,107,22,22,0,1,0
0,151,151,1,1,0,1,0
1,372,372,67,25,42,2,1
2,452,452,6,6,0,1,0

3,110,110,2,2,0,1,0
4,222,222,45,45,0,1,0
0,384,384,1,1,0,1,0
1,400,400,56,56,0,1,0
2,416,416,19,19,0,1,0

1,100,100,20,20,0,1,0
0,130,130,26,16,10,3,2

3,121,121,2,2,0,1,0
2,138,138,3,3,0,1,0
6,207,207,42,42,0,1,0
0,211,211,1,1,0,1,0
4,260,260,6,6,0,1,0
5,370,370,20,8,12,4,3
1,454,454,37,37,0,1,0

6,131,131,4,4,0,1,0
7,152,152,31,31,0,1,0
5,155,155,1,1,0,1,0
4,160,160,6,1,5,2,1
1,211,211,2,2,0,1,0
2,260,260,10,10,0,1,0
3,313,313,6,6,0,1,0
0,482,482,29,29,0,1,0

0,236,236,39,39,0,1,0
2,310,310,3,3,0,1,0
3,464,464,93,28,65,4,3
1,485,485,13,9,4,2,1

1,100,100,2,2,0,1,0
2,267,267,54,2,52,3,2
0,285,285,54,54,0,1,0

2,363,363,73,18,55,4,3
1,445,445,82,34,48,3,2
0,481,481,8,8,0,1,0

4,209,209,5,5,0,1,0
1,348,348,4,4,0,1,0
0,368,368,15,1,14,2,1
5,429,429,86,41,45,3,2
2,469,469,58,58,0,1,0
3,475,475,2,2,0,1,0

5,180,180,7,7,0,1,0
0,189,189,2,2,0,1,0
1,205,205,5,5,0,1,0
3,313,313,10,1,9,4,3
2,423,423,40,40,0,1,0
6,464,464,93,52,41,2,1
4,479,479,2,2,0,1,0

2,193,193,5,5,0,1,0
1,199,199,12,12,0,1,0
3,291,291,59,35,24,4,3
0,348,348,40,22,18,2,1

0,219,219,44,8,36,3,2
1,430,430,86,86,0,1,0

1,151,151,15,2,13,4,3
2,180,180,36,36,0,1,0
0,469,469,50,50,0,1,0

2,151,151,4,4,0,1,0
1,184,184,6,3,3,2,1
3,206,206,18,18,0,1,0
0,472,472,27,1,26,4,3
4,480,480,96,68,28,3,2

2,287,287,58,14,44,4,3
0,345,345,68,68,0,1,0
1,471,471,2,2,0,1,0

2,182,182,23,3,20,2,1
4,205,205,41,32,9,2,1
0,297,297,1,1,0,1,0
1,326,326,2,2,0,1,0
3,458,458,30,30,0,1,0

6,135,135,27,5,22,2,1
3,149,149,2,2,0,1,0
5,160,160,6,6,0,1,0
2,164,164,1,1,0,1,0
0,256,256,1,1,0,1,0
4,288,288,18,10,8,3,2
1,289,289,23,8,15,2,1

3,238,238,16,2,14,4,3
4,246,246,1,1,0,1,0
7,301,301,61,50,11,2,1
2,386,386,1,1,0,1,0
5,399,399,34,34,0,1,0
1,411,411,11,5,6,2,1
6,424,424,1,1,0,1,0
0,432,432,6,3,3,2,1

3,165,165,33,7,26,3,2
0,216,216,15,4,11,3,2
2,229,229,29,2,27,4,3
1,464,464,2,2,0,1,0

4,105,105,7,7,0,1,0
5,142,142,29,29,0,1,0
0,169,169,5,5,0,1,0
1,249,249,1,1,0,1,0
2,255,255,21,21,0,1,0
3,474,474,11,11,0,1,0

2,102,102,8,8,0,1,0
1,271,271,5,5,0,1,0
3,276,276,56,8,48,2,1
0,284,284,30,30,0,1,0

1,104,104,21,11,10,3,2
0,323,323,65,65,0,1,0

2,154,154,12,3,9,2,1
1,198,198,13,13,0,1,0
4,242,242,49,49,0,1,0
0,264,264,8,8,0,1,0
3,273,273,8,1,7,2,1

1,161,161,1,1,0,1,0
0,163,163,2,2,0,1,0
5,196,196,5,5,0,1,0
3,263,263,16,16,0,1,0
2,330,330,24,24,0,1,0
4,418,418,11,11,0,1,0
6,480,480,96,96,0,1,0

3,176,176,36,36,0,1,0
0,335,335,6,6,0,1,0
2,337,337,38,17,21,4,3
1,424,424,30,22,8,3,2

1,314,314,23,23,0,1,0
0,415,415,53,53,0,1,0
2,485,485,97,97,0,1,0

1,100,100,2,2,0,1,0
3,140,140,28,10,18,2,1
0,157,157,28,28,0,1,0
2,415,415,1,1,0,1,0

0,185,185,8,2,6,3,2
1,210,210,14,14,0,1,0
2,294,294,27,21,6,3,2
3,467,467,94,94,0,1,0

0,117,117,4,1,3,2,1
5,118,118,24,24,0,1,0
4,136,136,3,3,0,1,0
2,282,282,18,18,0,1,0
3,296,296,1,1,0,1,0
1,362,362,28,28,0,1,0

0,135,135,15,15,0,1,0
4,186,186,38,38,0,1,0
1,245,245,3,3,0,1,0
3,325,325,12,5,7,2,1
2,357,357,15,1,14,3,2

1,129,129,13,13,0,1,0
3,146,146,30,23,7,2,1
2,263,263,7,7,0,1,0
0,280,280,21,21,0,1,0

0,253,253,48,48,0,1,0
2,422,422,85,40,45,2,1
1,458,458,5,2,3,2,1

2,174,174,35,35,0,1,0
1,227,227,45,45,0,1,0
0,243,243,1,1,0,1,0

2,187,187,38,8,30,3,2
1,290,290,6,6,0,1,0
0,438,438,79,79,0,1,0

0,105,105,1,1,0,1,0
6,109,109,22,14,8,2,1
3,149,149,2,2,0,1,0
5,176,176,15,15,0,1,0
4,266,266,13,4,9,2,1
2,368,368,8,3,5,2,1
1,412,412,9,4,5,2,1

1,410,410,24,24,0,1,0
0,412,412,34,7,27,2,1
3,458,458,92,47,45,2,1
2,459,459,28,7,21,4,3

0,169,169,5,5,0,1,0
2,192,192,1,1,0,1,0
3,211,211,28,28,0,1,0
1,334,334,12,1,11,3,2
4,470,470,94,94,0,1,0

3,140,140,3,3,0,1,0
4,189,189,38,19,19,4,3
2,233,233,4,4,0,1,0
1,436,436,46,16,30,2,1
0,485,485,29,29,0,1,0

1,156,156,9,9,0,1,0
3,165,165,2,2,0,1,0
4,212,212,43,13,30,4,3
0,276,276,1,1,0,1,0
2,430,430,57,31,26,3,2

3,142,142,29,20,9,2,1
1,218,218,5,1,4,2,1
0,220,220,15,12,3,2,1
2,499,499,55,24,31,3,2

0,221,221,45,45,0,1,0
1,429,429,86,86,0,1,0

5,159,159,32,6,26,2,1
2,202,202,9,9,0,1,0
1,286,286,5,5,0,1,0
4,314,314,20,16,4,2,1
3,332,332,13,13,0,1,0
0,460,460,17,17,0,1,0

1,203,203,4,4,0,1,0
2,287,287,58,58,0,1,0
0,328,328,60,60,0,1,0

1,375,375,36,36,0,1,0
0,389,389,41,23,18,4,3
2,432,432,87,87,0,1,0

3,248,248,50,50,0,1,0
2,442,442,12,12,0,1,0
0,454,454,74,74,0,1,0
1,495,495,5,5,0,1,0

2,122,122,16,4,12,3,2
1,288,288,5,1,4,2,1
3,437,437,88,88,0,1,0
0,479,479,25,25,0,1,0

3,130,130,26,26,0,1,0
1,159,159,25,1,24,3,2
2,218,218,6,6,0,1,0
0,425,425,7,7,0,1,0

1,255,255,12,4,8,2,1
2,280,280,39,31,8,3,2
0,411,411,7,7,0,1,0
3,481,481,97,36,61,4,3

0,306,306,62,14,48,2,1
1,452,452,91,65,26,3,2

1,129,129,5,5,0,1,0
3,156,156,32,32,0,1,0
2,364,364,49,27,22,3,2
0,444,444,12,12,0,1,0

2,210,210,42,42,0,1,0
0,252,252,18,18,0,1,0
1,256,256,33,33,0,1,0

3,212,212,43,14,29,2,1
2,217,217,16,5,11,2,1
0,286,286,27,27,0,1,0
1,349,349,12,12,0,1,0

2,186,186,38,4,34,3,2
0,495,495,55,55,0,1,0
1,497,497,45,45,0,1,0

3,208,208,8,5,3,2,1
4,226,226,46,46,0,1,0
0,393,393,18,18,0,1,0
2,473,473,48,48,0,1,0
1,485,485,8,8,0,1,0

1,262,262,34,34,0,1,0
2,297,297,60,17,43,2,1
0,379,379,27,27,0,1,0

3,166,166,34,13,21,2,1
2,216,216,2,2,0,1,0
1,262,262,49,34,15,2,1
0,268,268,1,1,0,1,0

0,173,173,3,3,0,1,0
2,263,263,20,20,0,1,0
3,308,308,62,62,0,1,0
1,403,403,44,12,32,3,2

2,181,181,37,15,22,2,1
1,377,377,74,74,0,1,0
0,452,452,2,2,0,1,0

1,230,230,42,16,26,3,2
2,321,321,65,41,24,4,3
0,439,439,9,9,0,1,0

0,140,140,9,9,0,1,0
1,195,195,27,27,0,1,0
2,240,240,48,48,0,1,0

3,181,181,37,4,33,2,1
0,404,404,47,47,0,1,0
2,439,439,22,10,12,4,3
1,474,474,16,16,0,1,0

0,136,136,3,3,0,1,0
2,195,195,9,9,0,1,0
1,197,197,14,5,9,2,1
4,230,230,13,13,0,1,0
5,273,273,55,55,0,1,0
3,493,493,3,3,0,1,0

1,149,149,4,4,0,1,0
6,187,187,38,14,24,2,1
2,210,210,1,1,0,1,0
3,219,219,6,6,0,1,0
5,230,230,9,9,0,1,0
4,294,294,3,3,0,1,0
0,446,446,42,12,30,2,1

2,220,220,44,26,18,4,3
1,246,246,30,3,27,4,3
0,307,307,24,24,0,1,0

2,120,120,17,17,0,1,0
1,387,387,9,9,0,1,0
3,408,408,82,82,0,1,0
0,422,422,18,18,0,1,0

3,139,139,2,2,0,1,0
2,142,142,13,13,0,1,0
4,389,389,78,66,12,4,3
0,391,391,20,20,0,1,0
1,431,431,19,19,0,1,0

0,137,137,1,1,0,1,0
5,220,220,44,3,41,2,1
3,255,255,23,5,18,2,1
2,279,279,7,7,0,1,0
4,297,297,17,2,15,2,1
1,394,394,8,8,0,1,0

1,168,168,34,34,0,1,0
0,178,178,36,22,14,3,2

1,236,236,3,3,0,1,0
2,391,391,79,64,15,4,3
0,493,493,93,93,0,1,0

3,129,129,26,7,19,2,1
2,177,177,8,5,3,2,1
1,197,197,5,5,0,1,0
0,211,211,28,2,26,3,2

0,158,158,1,1,0,1,0
4,219,219,4,4,0,1,0
6,356,356,2,2,0,1,0
2,360,360,16,5,11,2,1
3,361,361,28,9,19,2,1
1,370,370,3,3,0,1,0
7,386,386,78,37,41,4,3
5,463,463,19,2,17,2,1

2,161,161,5,5,0,1,0
3,245,245,11,11,0,1,0
1,406,406,16,1,15,2,1
4,474,474,95,10,85,4,3
0,489,489,42,42,0,1,0

0,100,100,1,1,0,1,0
2,188,188,2,2,0,1,0
3,269,269,54,54,0,1,0
1,282,282,51,1,50,2,1

0,215,215,31,13,18,4,3
1,273,273,16,16,0,1,0
2,356,356,72,72,0,1,0

2,108,108,22,22,0,1,0
1,124,124,14,14,0,1,0
0,288,288,26,26,0,1,0

2,220,220,44,23,21,4,3
1,319,319,46,7,39,2,1
0,421,421,24,24,0,1,0

0,158,158,32,15,17,2,1
1,429,429,86,48,38,2,1

1,125,125,8,8,0,1,0
3,182,182,24,11,13,2,1
4,324,324,65,18,47,4,3
2,416,416,1,1,0,1,0
0,498,498,2,2,0,1,0

1,123,123,20,10,10,3,2
0,129,129,5,5,0,1,0
2,133,133,27,27,0,1,0

2,300,300,60,46,14,3,2
1,421,421,3,3,0,1,0
0,489,489,95,17,78,3,2

1,110,110,7,7,0,1,0
2,174,174,10,10,0,1,0
0,206,206,7,7,0,1,0
3,215,215,10,4,6,3,2
4,323,323,65,2,63,4,3

4,103,103,21,3,18,2,1
3,259,259,7,7,0,1,0
2,330,330,25,25,0,1,0
1,386,386,28,19,9,4,3
0,398,398,11,11,0,1,0

2,108,108,11,11,0,1,0
1,157,157,1,1,0,1,0
3,168,168,15,15,0,1,0
0,276,276,1,1,0,1,0
4,418,418,84,81,3,2,1

3,247,247,34,15,19,4,3
2,383,383,15,15,0,1,0
0,384,384,2,2,0,1,0
4,402,402,81,21,60,4,3
1,500,500,10,10,0,1,0

2,197,197,40,40,0,1,0
0,250,250,13,13,0,1,0
1,427,427,64,28,36,2,1

1,259,259,52,52,0,1,0
0,460,460,92,92,0,1,0

0,386,386,78,72,6,3,2
1,445,445,89,80,9,2,1

3,187,187,21,21,0,1,0
0,249,249,1,1,0,1,0
1,265,265,11,7,4,2,1
2,286,286,13,13,0,1,0
4,296,296,60,31,29,2,1

2,321,321,65,62,3,2,1
0,427,427,33,33,0,1,0
1,434,434,54,30,24,4,3

5,145,145,29,29,0,1,0
1,160,160,6,6,0,1,0
0,176,176,3,3,0,1,0
2,177,177,8,8,0,1,0
4,186,186,10,10,0,1,0
3,470,470,24,24,0,1,0

1,160,160,24,12,12,2,1
2,255,255,51,51,0,1,0
0,476,476,25,25,0,1,0

2,102,102,5,5,0,1,0
3,218,218,44,44,0,1,0
1,293,293,25,25,0,1,0
0,479,479,36,36,0,1,0

2,211,211,43,43,0,1,0
0,214,214,17,14,3,2,1
1,342,342,42,42,0,1,0

0,146,146,12,12,0,1,0
2,252,252,51,39,12,3,2
1,385,385,46,46,0,1,0

0,152,152,26,14,12,3,2
1,271,271,8,8,0,1,0
2,476,476,96,96,0,1,0

1,206,206,11,11,0,1,0
0,229,229,34,34,0,1,0
2,372,372,75,75,0,1,0

1,152,152,6,6,0,1,0
2,284,284,57,57,0,1,0
0,395,395,64,64,0,1,0

0,165,165,2,2,0,1,0
2,202,202,14,14,0,1,0
3,202,202,41,41,0,1,0
1,243,243,30,30,0,1,0

1,117,117,5,2,3,2,1
4,125,125,13,3,10,3,2
2,132,132,2,2,0,1,0
3,288,288,2,2,0,1,0
0,462,462,17,2,15,2,1
5,488,488,98,26,72,3,2

0,296,296,60,12,48,3,2
1,320,320,64,20,44,2,1

0,206,206,4,4,0,1,0
2,305,305,24,12,12,4,3
4,305,305,1,1,0,1,0
3,333,333,3,3,0,1,0
6,371,371,75,42,33,4,3
1,427,427,26,26,0,1,0
5,499,499,15,8,7,2,1

5,159,159,4,4,0,1,0
9,162,162,3,3,0,1,0
7,194,194,1,1,0,1,0
8,222,222,1,1,0,1,0
6,319,319,19,19,0,1,0
11,320,320,64,13,51,3,2
3,346,346,18,3,15,3,2
10,385,385,3,3,0,1,0
1,411,411,1,1,0,1,0
4,424,424,4,4,0,1,0
2,450,450,5,2,3,2,1
0,465,465,3,3,0,1,0

2,120,120,1,1,0,1,0
3,146,146,13,4,9,2,1
1,163,163,4,1,3,2,1
0,225,225,5,5,0,1,0
5,245,245,49,49,0,1,0
4,322,322,18,18,0,1,0

1,141,141,1,1,0,1,0
2,158,158,26,2,24,4,3
3,296,296,60,60,0,1,0
0,391,391,13,13,0,1,0

2,129,129,9,4,5,2,1
1,131,131,1,1,0,1,0
3,216,216,14,14,0,1,0
4,386,386,78,32,46,3,2
0,487,487,29,1,28,2,1

1,273,273,43,27,16,2,1
0,321,321,14,14,0,1,0
2,424,424,85,85,0,1,0

1,179,179,14,8,6,2,1
0,190,190,24,1,23,4,3
2,324,324,65,65,0,1,0

0,209,209,42,1,41,2,1
1,409,409,82,82,0,1,0

4,224,224,45,5,40,2,1
2,310,310,26,16,10,2,1
0,432,432,25,25,0,1,0
3,465,465,6,6,0,1,0
1,474,474,22,14,8,3,2

3,125,125,25,25,0,1,0
1,146,146,3,3,0,1,0
0,179,179,13,13,0,1,0
2,279,279,30,30,0,1,0

0,103,103,8,8,0,1,0
2,105,105,21,21,0,1,0
1,181,181,23,11,12,2,1

2,153,153,31,31,0,1,0
1,273,273,53,53,0,1,0
0,383,383,3,3,0,1,0

3,162,162,33,33,0,1,0
0,227,227,20,6,14,2,1
1,308,308,21,21,0,1,0
2,417,417,19,19,0,1,0

1,162,162,29,5,24,3,2
0,210,210,5,5,0,1,0
2,452,452,91,91,0,1,0

2,125,125,22,11,11,2,1
0,232,232,1,1,0,1,0
1,354,354,7,2,5,2,1
3,489,489,98,59,39,4,3

1,104,104,6,6,0,1,0
4,265,265,1,1,0,1,0
3,289,289,3,3,0,1,0
2,311,311,29,29,0,1,0
0,353,353,8,8,0,1,0
5,378,378,5,5,0,1,0
6,396,396,80,2,78,3,2

3,231,231,47,47,0,1,0
0,273,273,10,10,0,1,0
1,369,369,43,21,22,3,2
2,453,453,22,22,0,1,0

6,150,150,6,6,0,1,0
0,163,163,1,1,0,1,0
3,253,253,2,2,0,1,0
2,262,262,5,5,0,1,0
5,315,315,14,14,0,1,0
4,354,354,13,10,3,2,1
7,357,357,72,60,12,2,1
1,360,360,18,18,0,1,0

2,129,129,3,3,0,1,0
0,217,217,17,17,0,1,0
1,266,266,28,4,24,4,3
3,465,465,93,39,54,3,2

2,259,259,52,52,0,1,0
1,363,363,8,8,0,1,0
0,404,404,73,58,15,2,1

3,159,159,32,32,0,1,0
0,439,439,54,54,0,1,0
1,454,454,17,7,10,3,2
2,460,460,19,19,0,1,0

1,294,294,55,25,30,4,3
0,426,426,6,2,4,2,1
2,465,465,93,93,0,1,0

0,159,159,9,4,5,2,1
4,290,290,58,58,0,1,0
1,311,311,25,7,18,4,3
2,329,329,1,1,0,1,0
3,366,366,22,10,12,2,1

2,136,136,1,1,0,1,0
1,299,299,9,9,0,1,0
0,302,302,51,37,14,2,1
3,436,436,88,22,66,3,2

2,120,120,5,5,0,1,0
3,307,307,3,3,0,1,0
0,342,342,10,1,9,2,1
4,379,379,76,76,0,1,0
1,492,492,59,43,16,2,1

3,107,107,5,5,0,1,0
4,204,204,41,41,0,1,0
1,277,277,18,18,0,1,0
2,344,344,20,7,13,2,1
0,498,498,18,18,0,1,0

0,216,216,12,12,0,1,0
2,288,288,6,6,0,1,0
1,303,303,38,38,0,1,0
3,431,431,87,63,24,3,2

4,205,205,1,1,0,1,0
3,235,235,1,1,0,1,0
1,301,301,33,33,0,1,0
0,380,380,8,8,0,1,0
2,433,433,27,14,13,2,1
5,452,452,91,71,20,3,2

2,299,299,29,29,0,1,0
1,320,320,6,3,3,2,1
3,339,339,68,47,21,4,3
0,362,362,31,31,0,1,0

5,135,135,4,4,0,1,0
3,199,199,2,2,0,1,0
0,234,234,5,5,0,1,0
7,344,344,69,61,8,3,2
4,380,380,9,9,0,1,0
1,459,459,23,11,12,3,2
6,464,464,7,7,0,1,0
2,487,487,25,25,0,1,0

0,139,139,6,6,0,1,0
4,164,164,33,22,11,2,1
1,318,318,26,14,12,3,2
2,330,330,11,4,7,2,1
3,389,389,17,13,4,2,1

0,165,165,16,1,15,4,3
2,342,342,23,23,0,1,0
3,392,392,79,72,7,2,1
1,475,475,18,4,14,3,2

1,260,260,6,6,0,1,0
2,310,310,31,23,8,2,1
3,375,375,75,50,25,3,2
0,479,479,38,38,0,1,0

3,168,168,34,34,0,1,0
1,231,231,28,28,0,1,0
0,303,303,13,13,0,1,0
2,462,462,17,17,0,1,0

0,138,138,14,5,9,2,1
1,209,209,21,12,9,4,3
2,496,496,100,80,20,3,2

1,117,117,18,18,0,1,0
0,241,241,12,12,0,1,0
2,475,475,95,49,46,4,3

3,193,193,39,39,0,1,0
0,216,216,26,2,24,2,1
1,454,454,9,9,0,1,0
2,472,472,29,23,6,3,2

2,184,184,22,22,0,1,0
0,193,193,5,2,3,2,1
1,203,203,2,2,0,1,0
5,343,343,69,69,0,1,0
4,436,436,12,12,0,1,0
3,473,473,9,4,5,2,1

1,116,116,23,23,0,1,0
2,128,128,26,26,0,1,0
0,191,191,1,1,0,1,0

3,253,253,51,23,28,3,2
0,255,255,25,25,0,1,0
1,267,267,21,21,0,1,0
2,340,340,8,8,0,1,0

0,196,196,7,1,6,3,2
2,265,265,2,2,0,1,0
6,296,296,60,10,50,2,1
3,306,306,15,4,11,2,1
4,412,412,9,6,3,2,1
1,455,455,4,4,0,1,0
5,483,483,38,38,0,1,0

1,282,282,57,57,0,1,0
0,299,299,60,50,10,3,2

4,191,191,1,1,0,1,0
1,198,198,14,14,0,1,0
0,318,318,2,2,0,1,0
3,330,330,37,3,34,3,2
5,399,399,80,80,0,1,0
2,441,441,4,1,3,2,1

3,103,103,2,2,0,1,0
0,248,248,29,14,15,2,1
1,316,316,5,5,0,1,0
2,435,435,11,4,7,2,1
5,477,477,96,96,0,1,0
4,492,492,12,12,0,1,0

1,184,184,15,15,0,1,0
0,246,246,26,26,0,1,0
3,411,411,83,83,0,1,0
2,451,451,6,6,0,1,0

0,160,160,33,15,18,3,2
1,306,306,62,62,0,1,0

2,147,147,1,1,0,1,0
3,245,245,12,4,8,2,1
5,303,303,61,61,0,1,0
4,378,378,36,6,30,3,2
1,447,447,15,6,9,2,1
0,452,452,7,7,0,1,0

1,302,302,39,26,13,2,1
2,392,392,79,79,0,1,0
0,480,480,35,35,0,1,0

0,102,102,10,4,6,3,2
1,115,115,2,2,0,1,0
4,317,317,64,23,41,4,3
2,322,322,13,4,9,4,3
3,459,459,21,21,0,1,0

2,274,274,55,55,0,1,0
1,412,412,59,20,39,4,3
0,451,451,26,26,0,1,0

3,114,114,1,1,0,1,0
4,190,190,11,3,8,2,1
6,240,240,14,14,0,1,0
0,287,287,1,1,0,1,0
1,337,337,6,6,0,1,0
2,349,349,7,7,0,1,0
5,378,378,13,7,6,3,2
7,431,431,87,27,60,3,2

0,131,131,22,22,0,1,0
2,297,297,60,45,15,4,3
1,465,465,15,1,14,2,1

0,329,329,66,54,12,4,3
1,439,439,88,80,8,3,2

0,282,282,57,17,40,3,2
1,423,423,85,74,11,2,1

1,106,106,22,2,20,3,2
0,231,231,47,47,0,1,0

0,203,203,33,27,6,2,1
2,325,325,65,65,0,1,0
1,331,331,13,13,0,1,0

0,214,214,13,5,8,2,1
2,418,418,84,84,0,1,0
1,465,465,65,28,37,4,3

0,172,172,8,3,5,2,1
2,274,274,18,18,0,1,0
3,282,282,57,22,35,2,1
1,465,465,42,42,0,1,0

6,132,132,1,1,0,1,0
1,295,295,22,1,21,4,3
5,298,298,12,3,9,2,1
3,350,350,2,2,0,1,0
2,418,418,4,4,0,1,0
0,475,475,21,15,6,3,2
7,476,476,96,70,26,4,3
4,487,487,10,10,0,1,0

2,233,233,47,44,3,2,1
1,387,387,62,16,46,2,1
0,434,434,18,18,0,1,0

0,114,114,10,1,9,2,1
2,218,218,1,1,0,1,0
3,440,440,88,52,36,4,3
1,452,452,50,50,0,1,0

1,114,114,11,2,9,4,3
3,301,301,61,52,9,2,1
2,309,309,17,2,15,4,3
0,413,413,21,21,0,1,0

3,164,164,3,3,0,1,0
2,221,221,23,23,0,1,0
0,343,343,18,6,12,3,2
5,407,407,82,82,0,1,0
4,467,467,11,11,0,1,0
1,469,469,1,1,0,1,0

1,218,218,12,12,0,1,0
0,290,290,43,43,0,1,0
2,364,364,73,66,7,2,1

0,213,213,13,3,10,2,1
1,256,256,11,11,0,1,0
3,394,394,11,2,9,2,1
4,439,439,88,88,0,1,0
2,446,446,31,19,12,4,3

0,194,194,38,38,0,1,0
1,250,250,2,2,0,1,0
2,266,266,54,54,0,1,0

0,173,173,35,35,0,1,0
1,297,297,60,60,0,1,0

3,187,187,2,2,0,1,0
0,194,194,15,15,0,1,0
4,383,383,77,77,0,1,0
2,460,460,50,50,0,1,0
1,469,469,3,3,0,1,0

2,100,100,10,10,0,1,0
3,204,204,41,9,32,2,1
1,240,240,21,21,0,1,0
0,475,475,9,9,0,1,0

0,263,263,53,23,30,2,1
1,432,432,87,7,80,4,3

1,207,207,13,13,0,1,0
5,220,220,3,3,0,1,0
4,322,322,1,1,0,1,0
2,330,330,1,1,0,1,0
6,402,402,81,64,17,3,2
3,475,475,23,23,0,1,0
0,497,497,35,1,34,2,1

1,366,366,11,2,9,4,3
2,441,441,89,82,7,2,1
0,481,481,83,17,66,4,3

0,138,138,8,8,0,1,0
1,159,159,23,23,0,1,0
2,236,236,48,48,0,1,0

0,274,274,40,13,27,4,3
2,303,303,61,2,59,3,2
1,351,351,19,7,12,4,3

1,287,287,21,21,0,1,0
2,478,478,96,9,87,4,3
0,486,486,62,47,15,2,1

2,194,194,6,6,0,1,0
3,217,217,44,37,7,2,1
1,218,218,7,1,6,3,2
0,314,314,44,18,26,3,2

0,132,132,9,9,0,1,0
1,198,198,3,3,0,1,0
3,274,274,10,4,6,3,2
5,376,376,76,69,7,2,1
2,462,462,10,10,0,1,0
4,498,498,30,2,28,3,2

0,362,362,48,11,37,4,3
1,441,441,30,16,14,2,1
2,474,474,95,55,40,3,2

1,116,116,2,2,0,1,0
2,274,274,28,19,9,2,1
0,385,385,32,32,0,1,0
3,422,422,85,41,44,4,3

2,150,150,30,30,0,1,0
1,191,191,25,25,0,1,0
0,192,192,14,14,0,1,0

6,190,190,38,38,0,1,0
4,196,196,14,14,0,1,0
1,256,256,10,1,9,2,1
2,287,287,4,4,0,1,0
0,339,339,7,7,0,1,0
5,377,377,4,1,3,2,1
3,384,384,18,18,0,1,0

0,204,204,41,41,0,1,0
1,390,390,78,78,0,1,0

3,110,110,22,22,0,1,0
0,144,144,12,12,0,1,0
2,252,252,18,18,0,1,0
1,306,306,14,14,0,1,0

5,103,103,9,6,3,2,1
6,199,199,4,4,0,1,0
1,213,213,5,5,0,1,0
2,232,232,3,3,0,1,0
3,390,390,1,1,0,1,0
4,402,402,1,1,0,1,0
0,436,436,23,23,0,1,0
7,442,442,89,89,0,1,0

0,348,348,70,54,16,2,1
1,478,478,96,96,0,1,0

2,161,161,8,5,3,2,1
3,196,196,2,2,0,1,0
1,267,267,29,29,0,1,0
0,294,294,1,1,0,1,0
5,333,333,67,19,48,4,3
4,459,459,13,6,7,2,1

3,170,170,5,5,0,1,0
1,198,198,14,14,0,1,0
0,266,266,18,10,8,2,1
2,278,278,8,8,0,1,0
4,350,350,2,2,0,1,0
5,383,383,77,18,59,4,3

2,130,130,26,26,0,1,0
1,317,317,52,24,28,3,2
0,363,363,14,1,13,3,2

3,238,238,48,8,40,3,2
2,370,370,23,23,0,1,0
0,432,432,18,3,15,4,3
1,467,467,46,10,36,4,3

0,153,153,4,4,0,1,0
4,310,310,34,34,0,1,0
5,310,310,62,62,0,1,0
3,332,332,13,13,0,1,0
2,461,461,1,1,0,1,0
1,481,481,11,5,6,3,2

3,101,101,21,1,20,3,2
0,247,247,24,24,0,1,0
2,309,309,10,7,3,2,1
1,463,463,34,15,19,4,3

4,264,264,53,5,48,2,1
2,280,280,3,3,0,1,0
3,429,429,11,11,0,1,0
1,475,475,76,76,0,1,0
0,476,476,2,2,0,1,0

2,120,120,2,2,0,1,0
1,128,128,1,1,0,1,0
3,212,212,5,5,0,1,0
5,222,222,45,45,0,1,0
0,256,256,36,3,33,4,3
4,325,325,4,4,0,1,0

3,137,137,8,8,0,1,0
1,142,142,7,7,0,1,0
2,234,234,7,7,0,1,0
4,256,256,52,52,0,1,0
0,454,454,29,15,14,3,2

2,105,105,10,10,0,1,0
0,315,315,9,9,0,1,0
3,349,349,70,38,32,4,3
1,400,400,32,16,16,3,2

1,193,193,2,2,0,1,0
2,247,247,1,1,0,1,0
4,296,296,60,4,56,4,3
0,325,325,50,6,44,3,2
3,355,355,12,12,0,1,0

1,180,180,11,1,10,2,1
3,210,210,4,4,0,1,0
2,237,237,15,7,8,2,1
4,242,242,49,19,30,3,2
0,423,423,25,20,5,2,1

1,311,311,51,51,0,1,0
0,358,358,13,13,0,1,0
2,399,399,80,5,75,4,3

1,244,244,49,49,0,1,0
0,292,292,59,29,30,4,3

0,233,233,1,1,0,1,0
2,345,345,69,69,0,1,0
1,348,348,69,5,64,3,2

2,379,379,18,4,14,3,2
3,389,389,13,13,0,1,0
4,431,431,87,87,0,1,0
1,437,437,42,5,37,2,1
0,492,492,12,12,0,1,0

5,132,132,9,9,0,1,0
2,257,257,3,3,0,1,0
6,335,335,67,32,35,2,1
3,343,343,3,3,0,1,0
4,376,376,5,5,0,1,0
0,422,422,15,15,0,1,0
1,471,471,31,31,0,1,0

1,205,205,12,12,0,1,0
0,220,220,1,1,0,1,0
2,270,270,37,19,18,4,3
3,291,291,59,10,49,4,3

1,219,219,43,5,38,4,3
0,423,423,3,3,0,1,0
2,474,474,95,65,30,2,1

1,149,149,30,4,26,2,1
0,400,400,81,69,12,2,1

2,211,211,43,14,29,2,1
1,259,259,28,28,0,1,0
0,342,342,32,32,0,1,0

2,350,350,70,23,47,2,1
1,423,423,6,6,0,1,0
0,493,493,92,19,73,4,3

1,128,128,26,7,19,2,1
0,192,192,39,18,21,4,3

1,125,125,8,8,0,1,0
2,177,177,1,1,0,1,0
3,179,179,5,5,0,1,0
0,318,318,6,6,0,1,0
4,359,359,30,30,0,1,0
5,429,429,86,68,18,3,2

2,165,165,33,33,0,1,0
1,236,236,47,7,40,3,2
0,314,314,1,1,0,1,0

2,100,100,20,5,15,4,3
1,412,412,13,4,9,2,1
0,440,440,75,75,0,1,0

0,364,364,73,73,0,1,0
1,418,418,84,36,48,2,1

4,230,230,9,4,5,2,1
3,241,241,18,18,0,1,0
2,346,346,8,3,5,2,1
1,353,353,5,1,4,2,1
6,418,418,84,55,29,2,1
5,432,432,5,5,0,1,0
0,486,486,19,19,0,1,0

4,114,114,23,1,22,3,2
1,247,247,3,3,0,1,0
0,301,301,4,4,0,1,0
2,429,429,59,59,0,1,0
3,483,483,18,18,0,1,0

3,185,185,17,9,8,2,1
2,256,256,18,3,15,4,3
0,321,321,2,2,0,1,0
1,329,329,12,4,8,2,1
4,386,386,78,70,8,2,1

0,214,214,16,16,0,1,0
2,337,337,12,12,0,1,0
3,425,425,2,2,0,1,0
4,434,434,87,87,0,1,0
1,475,475,41,41,0,1,0

0,230,230,46,30,16,2,1
1,335,335,67,67,0,1,0

2,351,351,71,71,0,1,0
0,361,361,6,1,5,2,1
1,451,451,83,83,0,1,0

4,106,106,22,22,0,1,0
3,206,206,8,8,0,1,0
1,271,271,27,14,13,2,1
2,346,346,1,1,0,1,0
0,393,393,24,24,0,1,0

0,325,325,66,45,21,4,3
1,357,357,72,66,6,3,2

1,106,106,17,3,14,3,2
2,313,313,2,2,0,1,0
0,353,353,12,9,3,2,1
3,385,385,77,17,60,4,3

0,126,126,26,26,0,1,0
1,279,279,56,56,0,1,0

4,182,182,37,26,11,2,1
1,204,204,12,3,9,2,1
0,354,354,1,1,0,1,0
2,362,362,9,6,3,2,1
3,363,363,42,42,0,1,0

3,165,165,33,33,0,1,0
2,181,181,5,5,0,1,0
0,198,198,23,23,0,1,0
1,326,326,19,19,0,1,0

3,189,189,14,4,10,3,2
0,310,310,4,4,0,1,0
2,358,358,24,6,18,2,1
1,433,433,20,20,0,1,0
4,456,456,92,68,24,4,3

0,169,169,34,34,0,1,0
1,300,300,60,60,0,1,0

2,219,219,5,5,0,1,0
3,267,267,54,23,31,2,1
1,427,427,3,3,0,1,0
0,451,451,77,69,8,2,1

1,139,139,28,18,10,3,2
0,189,189,38,38,0,1,0

1,119,119,24,13,11,2,1
0,442,442,89,54,35,4,3

1,142,142,20,12,8,3,2
2,201,201,2,2,0,1,0
3,262,262,53,53,0,1,0
0,346,346,18,13,5,2,1

1,358,358,66,66,0,1,0
2,359,359,72,6,66,4,3
0,448,448,8,5,3,2,1

2,261,261,5,5,0,1,0
0,333,333,24,24,0,1,0
3,355,355,71,35,36,4,3
1,374,374,41,2,39,4,3

4,132,132,2,2,0,1,0
0,197,197,6,3,3,2,1
6,199,199,40,40,0,1,0
1,220,220,18,18,0,1,0
2,373,373,14,14,0,1,0
3,469,469,6,6,0,1,0
5,494,494,11,11,0,1,0

4,169,169,34,34,0,1,0
2,245,245,26,26,0,1,0
0,249,249,8,3,5,2,1
3,261,261,1,1,0,1,0
1,330,330,20,20,0,1,0

3,139,139,1,1,0,1,0
1,164,164,22,22,0,1,0
4,179,179,1,1,0,1,0
2,183,183,1,1,0,1,0
6,193,193,39,39,0,1,0
0,415,415,1,1,0,1,0
5,422,422,20,8,12,2,1

0,189,189,13,5,8,2,1
2,206,206,18,3,15,2,1
1,336,336,16,10,6,2,1
3,359,359,72,21,51,4,3

0,120,120,4,4,0,1,0
3,201,201,1,1,0,1,0
6,250,250,50,50,0,1,0
2,342,342,1,1,0,1,0
4,441,441,1,1,0,1,0
5,458,458,56,56,0,1,0
1,479,479,17,6,11,4,3

2,183,183,37,10,27,4,3
1,370,370,5,5,0,1,0
0,414,414,78,25,53,4,3

2,244,244,49,49,0,1,0
0,253,253,14,14,0,1,0
1,420,420,61,12,49,2,1

1,466,466,4,4,0,1,0
0,469,469,90,25,65,4,3
2,482,482,97,18,79,4,3

3,178,178,12,9,3,2,1
0,191,191,4,4,0,1,0
2,271,271,29,3,26,2,1
4,332,332,67,1,66,3,2
1,478,478,4,4,0,1,0

1,196,196,1,1,0,1,0
4,234,234,47,12,35,2,1
2,288,288,31,31,0,1,0
0,456,456,3,3,0,1,0
3,456,456,37,37,0,1,0

3,173,173,35,35,0,1,0
1,215,215,7,1,6,2,1
0,220,220,2,2,0,1,0
2,407,407,65,65,0,1,0

5,185,185,37,8,29,2,1
4,205,205,10,10,0,1,0
1,213,213,3,3,0,1,0
2,234,234,6,6,0,1,0
3,391,391,22,1,21,4,3
0,461,461,27,27,0,1,0

3,108,108,22,13,9,2,1
2,132,132,10,1,9,4,3
1,171,171,21,21,0,1,0
0,305,305,1,1,0,1,0

2,144,144,9,9,0,1,0
1,173,173,5,1,4,2,1
0,243,243,27,27,0,1,0
3,412,412,83,44,39,4,3

0,148,148,17,13,4,2,1
3,241,241,49,5,44,3,2
1,293,293,3,3,0,1,0
2,310,310,24,16,8,2,1

2,143,143,1,1,0,1,0
5,229,229,46,30,16,3,2
3,255,255,3,3,0,1,0
0,315,315,8,8,0,1,0
1,389,389,8,1,7,2,1
4,426,426,58,58,0,1,0

0,112,112,1,1,0,1,0
4,132,132,2,2,0,1,0
7,194,194,8,3,5,2,1
2,261,261,8,3,5,2,1
3,288,288,7,7,0,1,0
8,295,295,59,45,14,2,1
1,296,296,1,1,0,1,0
5,384,384,7,7,0,1,0
6,418,418,26,26,0,1,0

1,156,156,26,3,23,3,2
2,290,290,9,1,8,3,2
0,419,419,1,1,0,1,0
3,498,498,100,100,0,1,0

1,134,134,8,8,0,1,0
2,207,207,6,6,0,1,0
4,209,209,42,37,5,2,1
0,453,453,37,16,21,4,3
3,480,480,15,15,0,1,0

0,279,279,40,18,22,3,2
2,304,304,61,57,4,2,1
1,376,376,22,22,0,1,0

3,112,112,5,5,0,1,0
5,154,154,31,1,30,2,1
4,164,164,7,7,0,1,0
1,251,251,7,7,0,1,0
0,344,344,28,5,23,2,1
2,452,452,4,4,0,1,0

2,186,186,12,12,0,1,0
0,276,276,26,17,9,2,1
1,305,305,13,13,0,1,0
3,447,447,90,77,13,2,1

1,101,101,4,1,3,2,1
3,125,125,25,25,0,1,0
2,219,219,32,12,20,2,1
0,242,242,4,4,0,1,0

3,117,117,3,3,0,1,0
2,167,167,3,3,0,1,0
4,177,177,36,36,0,1,0
1,254,254,35,35,0,1,0
0,456,456,10,10,0,1,0

2,106,106,7,2,5,2,1
0,121,121,1,1,0,1,0
1,253,253,32,32,0,1,0
3,418,418,84,5,79,4,3

0,371,371,75,46,29,2,1
1,466,466,94,16,78,3,2

1,239,239,17,17,0,1,0
3,303,303,61,25,36,4,3
0,372,372,19,10,9,3,2
2,496,496,39,24,15,2,1

0,361,361,73,73,0,1,0
1,468,468,94,50,44,3,2

0,153,153,17,2,15,2,1
1,245,245,18,18,0,1,0
3,276,276,56,23,33,2,1
2,358,358,6,6,0,1,0

3,108,108,5,5,0,1,0
1,145,145,13,13,0,1,0
4,164,164,33,11,22,2,1
0,205,205,1,1,0,1,0
2,325,325,21,21,0,1,0

1,195,195,39,39,0,1,0
0,216,216,44,44,0,1,0

1,138,138,12,12,0,1,0
0,167,167,13,7,6,3,2
2,296,296,8,8,0,1,0
3,353,353,3,3,0,1,0
4,452,452,91,21,70,4,3

4,134,134,10,5,5,2,1
5,157,157,1,1,0,1,0
0,167,167,3,3,0,1,0
2,317,317,1,1,0,1,0
3,441,441,8,5,3,2,1
1,445,445,36,36,0,1,0
6,458,458,92,92,0,1,0

1,316,316,47,4,43,2,1
2,332,332,67,51,16,3,2
0,448,448,24,9,15,2,1

0,221,221,1,1,0,1,0
1,445,445,87,12,75,4,3
2,484,484,97,49,48,2,1

0,149,149,30,13,17,3,2
1,452,452,91,91,0,1,0

0,143,143,29,29,0,1,0
1,400,400,80,80,0,1,0

1,246,246,41,15,26,2,1
2,341,341,69,58,11,2,1
0,452,452,16,16,0,1,0

0,142,142,12,4,8,3,2
1,173,173,2,2,0,1,0
2,215,215,21,6,15,4,3
4,334,334,67,25,42,4,3
3,432,432,3,3,0,1,0

2,124,124,1,1,0,1,0
3,132,132,27,27,0,1,0
1,133,133,1,1,0,1,0
0,489,489,91,19,72,3,2

2,106,106,18,4,14,2,1
1,162,162,5,5,0,1,0
3,196,196,40,12,28,3,2
0,409,409,1,1,0,1,0

1,197,197,25,3,22,3,2
2,227,227,46,46,0,1,0
0,231,231,17,7,10,3,2

0,118,118,20,11,9,4,3
2,212,212,43,24,19,2,1
1,232,232,8,8,0,1,0

1,313,313,63,63,0,1,0
0,495,495,99,32,67,4,3

4,177,177,3,3,0,1,0
5,258,258,10,3,7,3,2
0,372,372,2,2,0,1,0
6,443,443,89,11,78,4,3
2,449,449,8,8,0,1,0
3,452,452,37,4,33,2,1
1,463,463,19,2,17,4,3

0,108,108,1,1,0,1,0
8,216,216,44,7,37,2,1
7,298,298,13,1,12,4,3
2,332,332,11,11,0,1,0
4,332,332,14,14,0,1,0
3,337,337,15,15,0,1,0
6,350,350,2,2,0,1,0
5,408,408,2,2,0,1,0
1,440,440,8,8,0,1,0

2,396,396,53,5,48,3,2
0,400,400,18,13,5,2,1
3,412,412,83,32,51,4,3
1,468,468,10,5,5,2,1

3,158,158,32,10,22,2,1
0,307,307,17,17,0,1,0
1,393,393,38,20,18,2,1
2,407,407,20,20,0,1,0

2,159,159,32,32,0,1,0
0,286,286,16,6,10,2,1
1,294,294,43,36,7,2,1

4,156,156,7,7,0,1,0
5,262,262,53,53,0,1,0
1,292,292,2,2,0,1,0
2,398,398,21,21,0,1,0
0,426,426,6,6,0,1,0
3,440,440,38,15,23,3,2

0,134,134,26,26,0,1,0
1,161,161,1,1,0,1,0
2,269,269,54,54,0,1,0

1,183,183,25,25,0,1,0
0,305,305,20,20,0,1,0
2,318,318,64,64,0,1,0

1,254,254,51,12,39,4,3
0,414,414,83,53,30,4,3

1,142,142,1,1,0,1,0
2,237,237,38,38,0,1,0
0,391,391,13,13,0,1,0
3,492,492,99,93,6,3,2

2,369,369,29,29,0,1,0
3,377,377,76,7,69,4,3
0,398,398,21,21,0,1,0
1,470,470,33,33,0,1,0

0,204,204,11,3,8,2,1
2,249,249,50,41,9,2,1
1,476,476,70,34,36,2,1

1,136,136,2,2,0,1,0
2,192,192,5,2,3,2,1
3,220,220,16,7,9,2,1
0,224,224,9,9,0,1,0
6,242,242,49,11,38,3,2
5,401,401,5,5,0,1,0
4,483,483,17,3,14,3,2

2,105,105,9,2,7,2,1
1,232,232,5,5,0,1,0
0,343,343,34,34,0,1,0
3,413,413,83,33,50,4,3

0,238,238,25,13,12,2,1
3,326,326,66,66,0,1,0
2,338,338,5,5,0,1,0
1,345,345,28,28,0,1,0

1,217,217,4,4,0,1,0
4,232,232,47,18,29,2,1
2,253,253,5,5,0,1,0
0,413,413,28,28,0,1,0
3,418,418,40,40,0,1,0

4,109,109,2,2,0,1,0
5,141,141,29,29,0,1,0
0,207,207,9,6,3,2,1
3,240,240,4,4,0,1,0
1,408,408,20,10,10,3,2
2,425,425,32,23,9,2,1

1,134,134,27,9,18,2,1
0,378,378,76,76,0,1,0

1,268,268,54,54,0,1,0
0,310,310,62,62,0,1,0

4,170,170,34,34,0,1,0
1,175,175,4,4,0,1,0
2,183,183,23,23,0,1,0
0,382,382,1,1,0,1,0
3,494,494,25,25,0,1,0

0,117,117,19,13,6,3,2
6,144,144,29,2,27,2,1
5,157,157,1,1,0,1,0
4,257,257,3,3,0,1,0
2,347,347,3,3,0,1,0
3,411,411,5,5,0,1,0
1,478,478,1,1,0,1,0

1,155,155,31,31,0,1,0
0,206,206,42,42,0,1,0

1,168,168,1,1,0,1,0
3,330,330,66,66,0,1,0
2,477,477,19,19,0,1,0
0,498,498,77,39,38,4,3

2,136,136,1,1,0,1,0
0,195,195,11,1,10,3,2
1,198,198,4,1,3,2,1
6,310,310,62,62,0,1,0
5,311,311,4,4,0,1,0
3,414,414,28,1,27,2,1
4,481,481,18,3,15,2,1

1,289,289,18,5,13,2,1
2,300,300,60,17,43,2,1
0,340,340,47,27,20,2,1

3,233,233,47,47,0,1,0
0,287,287,18,18,0,1,0
2,324,324,41,22,19,2,1
1,377,377,5,1,4,2,1

0,171,171,35,11,24,3,2
1,353,353,71,24,47,4,3

0,245,245,36,20,16,2,1
2,277,277,56,15,41,4,3
1,470,470,25,7,18,4,3

0,103,103,17,17,0,1,0
2,185,185,2,2,0,1,0
3,445,445,89,89,0,1,0
1,452,452,12,4,8,2,1

0,220,220,44,44,0,1,0
1,307,307,62,62,0,1,0

3,161,161,3,3,0,1,0
5,167,167,34,16,18,3,2
1,208,208,16,7,9,4,3
4,305,305,22,7,15,4,3
2,419,419,13,13,0,1,0
0,444,444,2,2,0,1,0

3,109,109,1,1,0,1,0
5,336,336,18,18,0,1,0
4,342,342,1,1,0,1,0
1,345,345,7,7,0,1,0
2,370,370,16,8,8,3,2
0,423,423,17,3,14,3,2
6,441,441,14,14,0,1,0
7,491,491,99,18,81,4,3

0,145,145,22,22,0,1,0
1,374,374,19,19,0,1,0
2,381,381,77,40,37,2,1

2,322,322,65,41,24,2,1
0,422,422,71,36,35,2,1
1,467,467,15,7,8,2,1

2,190,190,4,4,0,1,0
1,192,192,7,7,0,1,0
4,326,326,19,19,0,1,0
5,426,426,28,4,24,2,1
6,475,475,95,22,73,4,3
0,490,490,5,5,0,1,0
3,498,498,5,5,0,1,0

2,192,192,12,12,0,1,0
1,202,202,7,7,0,1,0
3,411,411,4,4,0,1,0
0,451,451,43,25,18,3,2
4,458,458,92,92,0,1,0

2,112,112,10,10,0,1,0
0,135,135,4,4,0,1,0
4,135,135,27,5,22,3,2
3,169,169,4,4,0,1,0
1,301,301,18,8,10,2,1

0,259,259,17,17,0,1,0
2,268,268,54,54,0,1,0
1,462,462,63,63,0,1,0

1,320,320,64,64,0,1,0
0,336,336,68,68,0,1,0

1,160,160,7,2,5,2,1
2,263,263,29,8,21,2,1
4,305,305,61,51,10,2,1
0,359,359,1,1,0,1,0
3,425,425,19,19,0,1,0

1,370,370,28,28,0,1,0
2,409,409,25,25,0,1,0
3,425,425,85,19,66,4,3
0,452,452,29,26,3,2,1

0,132,132,5,5,0,1,0
1,174,174,29,4,25,4,3
2,328,328,66,7,59,3,2

4,178,178,13,13,0,1,0
0,289,289,20,2,18,4,3
1,317,317,16,13,3,2,1
3,328,328,2,2,0,1,0
5,351,351,71,71,0,1,0
2,481,481,3,3,0,1,0

0,142,142,29,16,13,2,1
1,435,435,87,87,0,1,0

2,113,113,6,2,4,2,1
3,121,121,5,5,0,1,0
4,147,147,9,5,4,2,1
5,317,317,64,14,50,3,2
0,374,374,1,1,0,1,0
1,468,468,22,22,0,1,0

2,229,229,46,46,0,1,0
0,267,267,2,2,0,1,0
1,437,437,85,85,0,1,0

0,158,158,22,1,21,4,3
1,295,295,18,8,10,2,1
2,319,319,64,59,5,2,1

1,101,101,12,12,0,1,0
0,364,364,30,12,18,2,1
2,378,378,76,76,0,1,0

1,237,237,22,7,15,2,1
0,419,419,45,25,20,2,1
2,487,487,98,80,18,4,3

4,114,114,23,23,0,1,0
0,179,179,14,14,0,1,0
1,222,222,16,16,0,1,0
2,248,248,1,1,0,1,0
3,451,451,21,3,18,4,3

2,185,185,37,37,0,1,0
1,359,359,58,58,0,1,0
0,471,471,19,1,18,3,2

2,156,156,32,11,21,4,3
1,190,190,26,26,0,1,0
0,469,469,31,7,24,4,3

1,198,198,15,15,0,1,0
3,198,198,40,1,39,3,2
0,258,258,11,1,10,2,1
2,405,405,34,34,0,1,0

0,286,286,32,32,0,1,0
2,354,354,71,23,48,4,3
1,389,389,35,6,29,2,1

2,111,111,3,3,0,1,0
3,182,182,37,37,0,1,0
0,233,233,5,5,0,1,0
1,249,249,39,20,19,2,1

0,195,195,2,2,0,1,0
1,201,201,19,19,0,1,0
2,262,262,25,1,24,3,2
3,466,466,94,66,28,3,2

2,114,114,23,18,5,2,1
1,295,295,46,31,15,2,1
0,351,351,16,16,0,1,0

1,209,209,10,4,6,3,2
2,274,274,55,37,18,3,2
0,394,394,61,1,60,4,3

4,141,141,29,8,21,4,3
3,143,143,1,1,0,1,0
0,198,198,1,1,0,1,0
1,309,309,42,30,12,2,1
2,460,460,26,16,10,3,2

3,206,206,16,16,0,1,0
4,209,209,42,24,18,4,3
2,318,318,9,4,5,2,1
0,321,321,7,7,0,1,0
1,378,378,29,5,24,4,3

0,198,198,33,33,0,1,0
1,285,285,10,5,5,2,1
2,439,439,88,77,11,2,1

3,106,106,6,6,0,1,0
1,211,211,7,1,6,3,2
4,309,309,62,44,18,4,3
0,317,317,16,6,10,3,2
2,417,417,26,26,0,1,0

2,105,105,19,19,0,1,0
3,181,181,37,37,0,1,0
1,379,379,5,5,0,1,0
0,485,485,3,3,0,1,0

1,333,333,67,67,0,1,0
0,471,471,95,95,0,1,0

0,115,115,6,6,0,1,0
3,168,168,12,6,6,3,2
4,182,182,37,37,0,1,0
1,389,389,1,1,0,1,0
2,413,413,31,31,0,1,0

0,373,373,75,75,0,1,0
1,399,399,80,80,0,1,0

1,126,126,22,22,0,1,0
2,361,361,73,37,36,3,2
0,376,376,12,12,0,1,0

0,118,118,2,2,0,1,0
2,174,174,11,11,0,1,0
1,261,261,32,19,13,2,1
3,262,262,53,19,34,2,1

2,151,151,31,31,0,1,0
0,173,173,3,3,0,1,0
1,471,471,87,87,0,1,0

0,346,346,35,35,0,1,0
1,361,361,36,36,0,1,0
2,446,446,90,42,48,4,3

0,461,461,93,93,0,1,0
1,470,470,94,70,24,3,2

1,194,194,8,2,6,3,2
4,265,265,2,2,0,1,0
6,290,290,58,58,0,1,0
0,314,314,5,5,0,1,0
2,413,413,19,9,10,3,2
3,437,437,3,3,0,1,0
5,485,485,40,17,23,2,1

1,312,312,63,1,62,3,2
0,479,479,96,96,0,1,0

0,480,480,87,55,32,2,1
1,491,491,10,10,0,1,0
2,491,491,99,99,0,1,0

1,249,249,50,11,39,2,1
0,352,352,71,14,57,3,2

1,291,291,59,59,0,1,0
0,363,363,73,73,0,1,0

4,239,239,3,3,0,1,0
5,242,242,11,11,0,1,0
2,284,284,5,5,0,1,0
1,313,313,8,8,0,1,0
7,319,319,64,64,0,1,0
6,356,356,4,4,0,1,0
3,360,360,2,2,0,1,0
0,438,438,36,16,20,2,1

3,142,142,29,29,0,1,0
0,175,175,5,1,4,2,1
1,452,452,18,18,0,1,0
2,454,454,60,4,56,4,3

0,158,158,32,32,0,1,0
1,244,244,49,31,18,4,3

3,177,177,3,3,0,1,0
1,180,180,9,9,0,1,0
2,315,315,14,14,0,1,0
0,356,356,4,4,0,1,0
5,367,367,24,24,0,1,0
6,473,473,95,72,23,2,1
4,490,490,6,6,0,1,0

3,129,129,3,3,0,1,0
0,180,180,1,1,0,1,0
6,220,220,14,5,9,4,3
5,243,243,6,3,3,2,1
2,321,321,7,7,0,1,0
7,322,322,65,65,0,1,0
4,359,359,1,1,0,1,0
1,474,474,29,2,27,4,3

0,164,164,8,8,0,1,0
1,211,211,16,11,5,2,1
3,252,252,14,14,0,1,0
2,318,318,7,1,6,2,1
4,339,339,68,62,6,2,1

2,178,178,8,8,0,1,0
0,237,237,16,4,12,2,1
1,298,298,21,21,0,1,0
4,305,305,61,32,29,2,1
3,324,324,6,3,3,2,1

2,150,150,30,30,0,1,0
1,327,327,38,30,8,2,1
0,462,462,39,39,0,1,0

4,110,110,8,8,0,1,0
0,207,207,1,1,0,1,0
3,317,317,5,5,0,1,0
6,344,344,69,25,44,2,1
5,376,376,14,14,0,1,0
2,495,495,6,6,0,1,0
1,496,496,29,29,0,1,0

0,181,181,34,34,0,1,0
1,364,364,5,5,0,1,0
2,446,446,90,51,39,4,3

4,100,100,20,20,0,1,0
1,133,133,1,1,0,1,0
3,207,207,5,5,0,1,0
2,242,242,32,32,0,1,0
0,285,285,11,11,0,1,0

5,101,101,2,2,0,1,0
4,197,197,12,12,0,1,0
2,214,214,5,5,0,1,0
1,307,307,14,14,0,1,0
3,334,334,9,9,0,1,0
0,337,337,8,2,6,3,2
6,369,369,74,36,38,3,2

3,118,118,3,3,0,1,0
1,168,168,8,8,0,1,0
0,203,203,25,6,19,2,1
4,376,376,76,76,0,1,0
2,411,411,3,3,0,1,0

2,244,244,49,29,20,3,2
1,473,473,40,40,0,1,0
0,493,493,57,51,6,2,1

1,129,129,4,4,0,1,0
0,240,240,1,1,0,1,0
4,415,415,83,4,79,4,3
2,456,456,73,43,30,3,2
3,483,483,3,3,0,1,0

0,202,202,41,41,0,1,0
1,482,482,97,97,0,1,0

0,132,132,18,18,0,1,0
2,335,335,67,67,0,1,0
1,356,356,23,7,16,3,2

0,169,169,1,1,0,1,0
4,183,183,1,1,0,1,0
6,265,265,53,16,37,2,1
2,318,318,28,4,24,3,2
1,447,447,21,21,0,1,0
5,450,450,18,18,0,1,0
3,457,457,7,1,6,2,1

2,138,138,11,3,8,3,2
0,145,145,3,3,0,1,0
5,207,207,42,42,0,1,0
1,211,211,1,1,0,1,0
3,430,430,10,10,0,1,0
4,466,466,34,19,15,4,3

3,108,108,22,22,0,1,0
2,171,171,3,3,0,1,0
0,229,229,10,10,0,1,0
1,463,463,65,2,63,4,3

2,194,194,39,39,0,1,0
0,297,297,1,1,0,1,0
1,382,382,76,35,41,3,2

0,165,165,14,14,0,1,0
4,221,221,45,18,27,4,3
2,352,352,1,1,0,1,0
1,389,389,3,3,0,1,0
3,428,428,45,45,0,1,0

0,279,279,56,16,40,3,2
1,457,457,92,92,0,1,0

1,133,133,6,6,0,1,0
2,181,181,27,22,5,2,1
3,216,216,44,44,0,1,0
0,434,434,4,4,0,1,0

3,220,220,1,1,0,1,0
1,281,281,13,2,11,2,1
0,372,372,22,22,0,1,0
4,398,398,80,80,0,1,0
2,474,474,43,43,0,1,0

0,102,102,15,3,12,4,3
2,175,175,3,3,0,1,0
3,401,401,81,81,0,1,0
1,467,467,19,5,14,3,2

0,164,164,33,9,24,3,2
1,226,226,46,46,0,1,0

0,147,147,15,6,9,2,1
1,182,182,16,16,0,1,0
2,229,229,3,3,0,1,0
3,323,323,65,46,19,2,1

2,230,230,46,46,0,1,0
0,313,313,23,23,0,1,0
1,314,314,40,1,39,4,3

3,101,101,21,21,0,1,0
2,137,137,7,1,6,3,2
0,173,173,12,12,0,1,0
1,321,321,27,27,0,1,0

1,137,137,11,6,5,2,1
0,233,233,1,1,0,1,0
4,329,329,2,2,0,1,0
3,346,346,29,7,22,3,2
2,444,444,12,1,11,2,1
5,495,495,99,65,34,2,1

2,200,200,14,14,0,1,0
3,248,248,50,8,42,4,3
0,396,396,50,50,0,1,0
1,470,470,4,4,0,1,0

5,127,127,26,26,0,1,0
0,171,171,1,1,0,1,0
3,338,338,1,1,0,1,0
4,411,411,40,40,0,1,0
1,453,453,34,34,0,1,0
2,460,460,9,9,0,1,0

2,119,119,24,4,20,2,1
1,364,364,4,4,0,1,0
0,366,366,70,70,0,1,0

3,114,114,9,9,0,1,0
5,162,162,33,3,30,3,2
4,269,269,6,2,4,2,1
0,385,385,13,13,0,1,0
1,427,427,2,2,0,1,0
2,443,443,28,28,0,1,0

0,261,261,10,3,7,2,1
2,262,262,7,7,0,1,0
3,303,303,61,22,39,4,3
1,467,467,64,7,57,4,3

1,280,280,56,16,40,3,2
0,472,472,95,70,25,2,1

3,272,272,5,1,4,2,1
4,294,294,59,14,45,4,3
2,337,337,3,3,0,1,0
0,385,385,16,16,0,1,0
1,403,403,54,29,25,2,1

1,129,129,9,9,0,1,0
0,326,326,43,43,0,1,0
2,355,355,71,71,0,1,0

1,123,123,1,1,0,1,0
5,155,155,31,22,9,4,3
0,279,279,38,38,0,1,0
3,393,393,13,13,0,1,0
4,479,479,10,1,9,4,3
2,492,492,1,1,0,1,0

2,195,195,15,4,11,2,1
0,201,201,1,1,0,1,0
3,225,225,5,5,0,1,0
4,313,313,63,36,27,2,1
1,492,492,48,16,32,2,1

0,149,149,10,4,6,2,1
1,213,213,10,2,8,2,1
2,214,214,19,13,6,2,1
3,394,394,79,29,50,3,2

5,112,112,3,3,0,1,0
4,130,130,5,5,0,1,0
3,220,220,6,6,0,1,0
0,368,368,8,8,0,1,0
6,368,368,74,74,0,1,0
2,394,394,22,8,14,2,1
1,417,417,16,16,0,1,0

4,204,204,2,2,0,1,0
3,302,302,3,3,0,1,0
5,316,316,4,4,0,1,0
6,356,356,72,57,15,2,1
0,386,386,3,3,0,1,0
1,438,438,32,32,0,1,0
2,487,487,43,43,0,1,0

3,123,123,25,16,9,4,3
0,175,175,3,3,0,1,0
2,317,317,9,9,0,1,0
1,460,460,72,20,52,3,2

0,180,180,37,37,0,1,0
1,317,317,64,64,0,1,0

0,179,179,3,3,0,1,0
3,259,259,20,20,0,1,0
2,270,270,1,1,0,1,0
4,394,394,79,79,0,1,0
1,496,496,51,43,8,2,1

2,202,202,41,34,7,2,1
1,272,272,36,36,0,1,0
0,306,306,21,6,15,4,3

1,402,402,81,17,64,3,2
0,474,474,95,29,66,3,2

2,171,171,35,35,0,1,0
0,380,380,39,39,0,1,0
1,499,499,49,49,0,1,0

4,163,163,33,24,9,2,1
2,241,241,1,1,0,1,0
0,392,392,8,8,0,1,0
3,398,398,7,1,6,2,1
1,480,480,76,26,50,2,1

0,121,121,2,2,0,1,0
2,121,121,25,25,0,1,0
1,130,130,24,12,12,4,3

3,105,105,4,4,0,1,0
2,159,159,2,2,0,1,0
4,196,196,10,2,8,2,1
1,204,204,3,3,0,1,0
0,259,259,1,1,0,1,0
5,380,380,31,1,30,4,3
6,389,389,78,75,3,2,1

0,330,330,53,53,0,1,0
1,486,486,20,20,0,1,0
2,494,494,99,79,20,3,2

3,210,210,42,35,7,2,1
2,312,312,17,12,5,2,1
1,408,408,52,52,0,1,0
0,430,430,9,3,6,2,1

3,116,116,24,24,0,1,0
2,150,150,1,1,0,1,0
0,265,265,46,46,0,1,0
1,465,465,12,12,0,1,0

3,138,138,3,3,0,1,0
0,164,164,7,1,6,3,2
1,322,322,41,41,0,1,0
2,323,323,4,4,0,1,0
4,469,469,94,94,0,1,0

1,322,322,65,43,22,3,2
0,446,446,90,90,0,1,0

3,123,123,25,20,5,2,1
1,226,226,16,16,0,1,0
0,272,272,7,7,0,1,0
2,326,326,34,4,30,2,1

1,223,223,42,42,0,1,0
0,338,338,5,5,0,1,0
2,386,386,78,58,20,3,2

2,147,147,10,4,6,3,2
5,153,153,5,5,0,1,0
0,164,164,7,3,4,2,1
3,192,192,8,8,0,1,0
4,371,371,5,5,0,1,0
6,422,422,85,59,26,3,2
1,456,456,1,1,0,1,0

3,204,204,41,11,30,2,1
0,216,216,27,27,0,1,0
1,223,223,5,1,4,2,1
2,348,348,19,19,0,1,0

0,142,142,3,3,0,1,0
3,356,356,72,8,64,3,2
2,375,375,56,7,49,2,1
1,420,420,13,13,0,1,0

4,119,119,24,24,0,1,0
2,163,163,1,1,0,1,0
1,307,307,14,6,8,2,1
3,444,444,9,9,0,1,0
0,457,457,59,40,19,2,1

3,211,211,4,4,0,1,0
1,232,232,20,20,0,1,0
0,288,288,10,10,0,1,0
2,395,395,24,16,8,3,2
4,493,493,99,99,0,1,0

2,192,192,11,11,0,1,0
0,225,225,3,3,0,1,0
1,247,247,19,13,6,3,2
4,298,298,60,60,0,1,0
3,449,449,24,12,12,3,2

1,176,176,4,4,0,1,0
4,176,176,2,2,0,1,0
5,231,231,47,25,22,3,2
0,297,297,16,2,14,2,1
2,317,317,1,1,0,1,0
3,428,428,48,48,0,1,0

6,137,137,28,20,8,3,2
2,192,192,11,11,0,1,0
5,229,229,3,3,0,1,0
0,264,264,1,1,0,1,0
3,264,264,26,16,10,2,1
1,350,350,10,10,0,1,0
4,472,472,1,1,0,1,0

0,135,135,4,4,0,1,0
3,244,244,6,6,0,1,0
4,244,244,13,13,0,1,0
1,314,314,23,23,0,1,0
2,473,473,11,6,5,2,1
5,478,478,96,96,0,1,0

2,303,303,61,61,0,1,0
1,430,430,12,6,6,2,1
0,500,500,87,87,0,1,0

0,116,116,24,6,18,3,2
1,448,448,90,90,0,1,0

1,138,138,4,4,0,1,0
2,150,150,10,10,0,1,0
4,265,265,9,1,8,2,1
5,284,284,57,12,45,4,3
3,288,288,3,3,0,1,0
0,394,394,24,24,0,1,0

0,139,139,9,1,8,2,1
1,221,221,4,4,0,1,0
4,295,295,59,59,0,1,0
2,405,405,2,2,0,1,0
3,434,434,49,42,7,2,1

1,105,105,1,1,0,1,0
0,114,114,1,1,0,1,0
5,186,186,38,26,12,4,3
4,217,217,2,2,0,1,0
3,467,467,73,28,45,4,3
2,485,485,9,1,8,3,2

0,216,216,30,18,12,4,3
2,239,239,11,4,7,2,1
4,382,382,77,57,20,4,3
1,444,444,3,3,0,1,0
3,486,486,5,5,0,1,0

1,243,243,33,33,0,1,0
0,350,350,23,10,13,2,1
2,396,396,80,62,18,3,2

2,126,126,1,1,0,1,0
7,197,197,40,2,38,2,1
3,224,224,1,1,0,1,0
6,328,328,25,25,0,1,0
1,335,335,1,1,0,1,0
4,369,369,34,3,31,4,3
0,438,438,2,2,0,1,0
5,486,486,7,7,0,1,0

2,163,163,26,26,0,1,0
1,314,314,1,1,0,1,0
4,341,341,69,69,0,1,0
3,344,344,10,10,0,1,0
0,455,455,5,5,0,1,0

0,236,236,9,9,0,1,0
1,256,256,42,12,30,2,1
2,384,384,77,5,72,3,2

3,154,154,31,13,18,4,3
1,291,291,1,1,0,1,0
2,411,411,18,18,0,1,0
0,440,440,68,19,49,4,3

1,183,183,30,30,0,1,0
2,402,402,81,45,36,3,2
0,497,497,19,5,14,2,1

1,146,146,2,2,0,1,0
3,169,169,34,21,13,4,3
2,294,294,34,15,19,2,1
0,353,353,25,11,14,3,2

3,142,142,29,29,0,1,0
2,148,148,3,3,0,1,0
0,187,187,28,28,0,1,0
1,498,498,16,16,0,1,0

1,138,138,2,2,0,1,0
2,293,293,27,3,24,4,3
5,306,306,1,1,0,1,0
3,410,410,20,5,15,4,3
4,448,448,17,8,9,2,1
0,455,455,3,3,0,1,0
6,468,468,94,94,0,1,0

1,243,243,1,1,0,1,0
3,255,255,51,1,50,3,2
2,319,319,43,5,38,2,1
0,407,407,25,14,11,2,1

7,187,187,7,7,0,1,0
8,190,190,38,1,37,3,2
5,220,220,1,1,0,1,0
6,260,260,4,4,0,1,0
4,319,319,9,9,0,1,0
2,339,339,4,4,0,1,0
0,378,378,29,25,4,2,1
1,479,479,8,2,6,3,2
3,485,485,6,6,0,1,0

0,197,197,40,40,0,1,0
1,472,472,95,25,70,4,3

2,132,132,5,1,4,2,1
1,176,176,20,5,15,2,1
4,341,341,69,31,38,4,3
3,355,355,10,10,0,1,0
0,392,392,9,9,0,1,0

0,122,122,25,19,6,3,2
1,187,187,38,1,37,2,1

0,221,221,24,3,21,2,1
2,291,291,20,20,0,1,0
4,369,369,74,71,3,2,1
3,472,472,7,3,4,2,1
1,477,477,4,4,0,1,0

4,149,149,5,5,0,1,0
3,154,154,12,5,7,2,1
1,159,159,8,8,0,1,0
0,162,162,1,1,0,1,0
5,304,304,61,40,21,2,1
2,427,427,16,6,10,4,3

1,148,148,4,4,0,1,0
2,307,307,62,15,47,2,1
0,425,425,75,72,3,2,1

1,236,236,6,6,0,1,0
2,257,257,5,5,0,1,0
0,314,314,24,4,20,2,1
3,410,410,33,27,6,3,2
4,461,461,93,29,64,3,2

0,169,169,10,2,8,2,1
2,195,195,11,11,0,1,0
3,283,283,20,8,12,2,1
1,345,345,5,2,3,2,1
4,362,362,73,73,0,1,0

4,112,112,23,23,0,1,0
3,252,252,28,28,0,1,0
0,284,284,9,3,6,3,2
2,453,453,5,5,0,1,0
1,468,468,22,3,19,2,1

2,119,119,24,12,12,4,3
0,347,347,56,14,42,4,3
1,426,426,17,17,0,1,0

0,261,261,26,1,25,4,3
2,304,304,61,61,0,1,0
1,439,439,45,9,36,3,2

0,175,175,1,1,0,1,0
2,189,189,15,15,0,1,0
4,235,235,10,10,0,1,0
3,292,292,6,6,0,1,0
5,327,327,66,66,0,1,0
1,428,428,24,24,0,1,0

0,210,210,1,1,0,1,0
2,433,433,87,72,15,2,1
1,491,491,96,42,54,4,3

2,164,164,11,3,8,3,2
1,238,238,9,9,0,1,0
0,252,252,24,14,10,3,2
3,427,427,86,80,6,2,1

2,158,158,6,6,0,1,0
0,418,418,29,9,20,2,1
1,423,423,41,1,40,3,2
3,475,475,95,95,0,1,0

0,258,258,52,29,23,2,1
1,447,447,90,16,74,3,2

1,123,123,8,8,0,1,0
0,158,158,4,1,3,2,1
2,308,308,34,11,23,2,1
3,309,309,62,15,47,2,1

1,233,233,6,1,5,2,1
2,243,243,16,2,14,2,1
0,305,305,12,12,0,1,0
3,368,368,26,26,0,1,0
4,419,419,84,84,0,1,0

2,163,163,33,15,18,2,1
1,211,211,35,35,0,1,0
0,292,292,11,3,8,2,1

0,239,239,11,11,0,1,0
1,311,311,48,12,36,3,2
2,339,339,68,68,0,1,0

2,133,133,6,6,0,1,0
3,195,195,39,27,12,2,1
0,350,350,17,17,0,1,0
1,394,394,44,44,0,1,0

1,173,173,12,12,0,1,0
2,216,216,8,5,3,2,1
0,274,274,26,8,18,4,3
3,415,415,83,36,47,4,3

3,174,174,1,1,0,1,0
0,192,192,9,1,8,3,2
2,281,281,1,1,0,1,0
7,316,316,64,52,12,4,3
6,364,364,15,15,0,1,0
1,402,402,32,32,0,1,0
5,473,473,8,4,4,2,1
4,491,491,4,1,3,2,1

1,226,226,34,26,8,3,2
2,327,327,66,27,39,4,3
0,430,430,22,22,0,1,0

3,148,148,11,11,0,1,0
4,235,235,47,11,36,2,1
0,358,358,27,27,0,1,0
1,371,371,6,6,0,1,0
2,496,496,18,18,0,1,0

1,215,215,1,1,0,1,0
3,293,293,46,13,33,4,3
2,332,332,5,5,0,1,0
4,405,405,81,81,0,1,0
0,488,488,13,13,0,1,0

2,223,223,45,39,6,3,2
1,260,260,31,18,13,2,1
0,366,366,30,15,15,2,1

0,268,268,54,41,13,2,1
1,359,359,72,41,31,2,1

2,117,117,24,24,0,1,0
1,134,134,15,12,3,2,1
0,397,397,37,3,34,2,1

0,282,282,30,21,9,2,1
2,342,342,69,69,0,1,0
1,392,392,37,37,0,1,0

2,229,229,11,2,9,4,3
3,268,268,36,12,24,3,2
4,335,335,67,67,0,1,0
0,369,369,1,1,0,1,0
1,376,376,6,3,3,2,1

2,132,132,17,3,14,3,2
3,158,158,32,32,0,1,0
0,242,242,1,1,0,1,0
1,390,390,27,27,0,1,0

1,213,213,29,13,16,3,2
2,234,234,47,8,39,4,3
0,360,360,23,23,0,1,0

1,107,107,1,1,0,1,0
0,158,158,17,8,9,4,3
4,315,315,63,51,12,3,2
3,345,345,8,3,5,2,1
2,419,419,26,1,25,2,1

3,114,114,1,1,0,1,0
1,170,170,16,7,9,4,3
2,341,341,10,7,3,2,1
0,360,360,26,26,0,1,0
4,367,367,74,6,68,3,2

1,121,121,24,6,18,3,2
0,230,230,1,1,0,1,0
2,438,438,88,1,87,4,3

0,299,299,6,6,0,1,0
2,301,301,36,18,18,2,1
1,305,305,19,10,9,4,3
3,361,361,73,41,32,2,1

2,102,102,3,3,0,1,0
0,138,138,2,2,0,1,0
4,187,187,16,16,0,1,0
5,204,204,41,3,38,2,1
3,260,260,7,7,0,1,0
1,488,488,23,23,0,1,0

3,255,255,51,27,24,3,2
1,285,285,14,14,0,1,0
2,290,290,40,40,0,1,0
0,353,353,5,1,4,2,1

1,203,203,6,2,4,2,1
5,300,300,60,60,0,1,0
2,389,389,8,2,6,2,1
4,389,389,4,4,0,1,0
3,443,443,1,1,0,1,0
0,462,462,64,64,0,1,0

0,252,252,14,14,0,1,0
2,292,292,12,12,0,1,0
4,384,384,77,44,33,4,3
1,399,399,13,13,0,1,0
3,411,411,30,25,5,2,1

0,400,400,81,75,6,3,2
1,469,469,94,94,0,1,0

3,122,122,25,25,0,1,0
2,155,155,5,5,0,1,0
0,280,280,9,9,0,1,0
1,436,436,60,11,49,2,1

0,129,129,1,1,0,1,0
2,195,195,14,2,12,4,3
3,395,395,79,39,40,3,2
1,473,473,59,59,0,1,0

1,144,144,20,20,0,1,0
3,171,171,7,7,0,1,0
0,322,322,7,7,0,1,0
4,418,418,84,29,55,3,2
2,476,476,1,1,0,1,0

1,151,151,24,24,0,1,0
2,190,190,1,1,0,1,0
0,395,395,15,3,12,4,3
3,408,408,82,82,0,1,0

0,118,118,2,2,0,1,0
1,119,119,1,1,0,1,0
2,319,319,56,56,0,1,0
3,465,465,93,93,0,1,0

0,116,116,10,1,9,4,3
1,120,120,14,14,0,1,0
2,139,139,28,28,0,1,0

1,151,151,13,13,0,1,0
2,221,221,45,45,0,1,0
0,260,260,31,31,0,1,0

0,181,181,32,32,0,1,0
1,418,418,10,10,0,1,0
2,498,498,100,67,33,4,3

1,230,230,24,9,15,4,3
0,305,305,30,20,10,2,1
2,438,438,88,31,57,4,3

0,115,115,21,21,0,1,0
1,462,462,9,2,7,2,1
2,479,479,96,51,45,4,3

0,233,233,1,1,0,1,0
1,362,362,71,36,35,2,1
2,386,386,78,72,6,2,1

0,144,144,10,10,0,1,0
1,224,224,30,6,24,4,3
2,444,444,89,26,63,3,2

3,289,289,58,31,27,2,1
2,408,408,14,4,10,3,2
0,410,410,20,11,9,4,3
1,461,461,54,22,32,3,2

1,452,452,3,3,0,1,0
0,469,469,91,48,43,4,3
2,500,500,100,100,0,1,0

1,173,173,4,4,0,1,0
0,228,228,21,6,15,2,1
2,273,273,24,11,13,2,1
3,453,453,91,91,0,1,0

1,160,160,20,12,8,3,2
0,226,226,10,10,0,1,0
3,347,347,70,43,27,2,1
2,447,447,14,1,13,2,1

2,183,183,37,37,0,1,0
1,406,406,18,8,10,3,2
0,463,463,73,73,0,1,0

1,130,130,1,1,0,1,0
2,447,447,90,58,32,3,2
0,472,472,93,6,87,4,3

0,236,236,48,48,0,1,0
1,351,351,71,71,0,1,0

2,148,148,2,2,0,1,0
3,276,276,4,4,0,1,0
0,352,352,1,1,0,1,0
1,385,385,8,8,0,1,0
6,392,392,79,60,19,2,1
4,393,393,50,50,0,1,0
5,466,466,10,10,0,1,0

0,300,300,5,5,0,1,0
2,355,355,71,71,0,1,0
1,384,384,71,71,0,1,0

1,194,194,1,1,0,1,0
6,206,206,8,8,0,1,0
4,257,257,3,3,0,1,0
2,275,275,6,6,0,1,0
0,297,297,1,1,0,1,0
8,342,342,69,69,0,1,0
3,408,408,38,38,0,1,0
7,465,465,12,12,0,1,0
5,484,484,1,1,0,1,0

2,115,115,4,4,0,1,0
1,136,136,1,1,0,1,0
0,397,397,66,38,28,4,3
3,444,444,89,32,57,4,3

1,169,169,27,3,24,3,2
2,392,392,79,79,0,1,0
0,438,438,19,19,0,1,0

3,203,203,41,41,0,1,0
0,232,232,5,5,0,1,0
1,370,370,16,16,0,1,0
2,419,419,57,26,31,3,2

2,106,106,8,8,0,1,0
0,233,233,3,3,0,1,0
1,335,335,38,25,13,2,1
3,377,377,76,76,0,1,0

2,204,204,1,1,0,1,0
3,221,221,35,23,12,2,1
4,390,390,78,40,38,3,2
1,467,467,1,1,0,1,0
0,468,468,17,17,0,1,0

1,325,325,65,7,58,3,2
0,445,445,89,38,51,4,3

1,196,196,40,16,24,2,1
0,349,349,70,31,39,3,2

6,174,174,35,23,12,2,1
1,207,207,1,1,0,1,0
5,355,355,14,3,11,4,3
3,377,377,12,12,0,1,0
4,405,405,2,2,0,1,0
2,462,462,38,38,0,1,0
0,465,465,18,9,9,3,2

3,183,183,2,2,0,1,0
0,236,236,42,14,28,3,2
4,236,236,48,7,41,2,1
1,363,363,5,1,4,2,1
2,427,427,1,1,0,1,0

7,155,155,31,31,0,1,0
4,174,174,6,1,5,2,1
1,228,228,1,1,0,1,0
5,241,241,13,1,12,4,3
6,288,288,14,14,0,1,0
2,364,364,1,1,0,1,0
3,389,389,12,3,9,2,1
0,485,485,13,4,9,2,1

2,218,218,44,44,0,1,0
1,253,253,45,45,0,1,0
0,397,397,10,10,0,1,0

2,239,239,10,10,0,1,0
1,248,248,29,3,26,3,2
0,289,289,12,12,0,1,0
3,295,295,59,59,0,1,0

1,230,230,32,32,0,1,0
2,279,279,14,2,12,4,3
0,294,294,4,4,0,1,0
3,308,308,62,34,28,3,2

0,112,112,1,1,0,1,0
1,274,274,53,53,0,1,0
2,329,329,66,66,0,1,0

0,127,127,12,12,0,1,0
6,209,209,42,3,39,2,1
3,260,260,10,10,0,1,0
4,276,276,5,5,0,1,0
2,337,337,8,2,6,3,2
5,340,340,8,5,3,2,1
1,341,341,1,1,0,1,0

3,232,232,47,47,0,1,0
0,254,254,4,4,0,1,0
2,432,432,21,17,4,2,1
1,472,472,65,65,0,1,0

6,156,156,3,3,0,1,0
9,161,161,33,14,19,2,1
3,203,203,1,1,0,1,0
8,205,205,12,12,0,1,0
2,212,212,2,2,0,1,0
0,296,296,9,2,7,2,1
4,370,370,18,18,0,1,0
1,371,371,7,7,0,1,0
5,457,457,3,3,0,1,0
7,469,469,3,3,0,1,0

1,177,177,6,1,5,2,1
3,238,238,48,48,0,1,0
0,388,388,5,5,0,1,0
2,485,485,75,75,0,1,0

3,296,296,60,60,0,1,0
2,298,298,36,36,0,1,0
1,400,400,15,15,0,1,0
0,413,413,18,18,0,1,0

0,107,107,1,1,0,1,0
2,195,195,5,5,0,1,0
1,313,313,53,37,16,3,2
3,321,321,65,65,0,1,0

0,174,174,16,16,0,1,0
3,231,231,10,10,0,1,0
2,241,241,5,5,0,1,0
4,257,257,52,8,44,3,2
1,476,476,22,2,20,2,1

0,191,191,15,15,0,1,0
1,277,277,34,7,27,2,1
2,436,436,88,88,0,1,0

1,148,148,6,6,0,1,0
0,261,261,16,2,14,2,1
3,369,369,28,1,27,2,1
4,388,388,78,6,72,4,3
2,423,423,10,3,7,2,1

1,156,156,2,2,0,1,0
0,271,271,52,10,42,2,1
2,302,302,61,61,0,1,0

1,117,117,24,24,0,1,0
0,426,426,86,23,63,4,3

1,144,144,1,1,0,1,0
2,163,163,28,28,0,1,0
3,257,257,52,52,0,1,0
0,310,310,8,1,7,2,1

0,222,222,27,27,0,1,0
1,296,296,24,18,6,2,1
2,411,411,83,60,23,2,1

2,155,155,11,11,0,1,0
3,233,233,47,47,0,1,0
0,358,358,28,7,21,4,3
1,465,465,24,8,16,4,3

2,146,146,30,25,5,2,1
0,210,210,41,21,20,2,1
1,457,457,3,3,0,1,0

1,127,127,21,15,6,2,1
4,262,262,53,53,0,1,0
2,284,284,1,1,0,1,0
0,311,311,1,1,0,1,0
3,359,359,11,11,0,1,0

1,101,101,11,1,10,2,1
2,228,228,46,46,0,1,0
0,275,275,27,27,0,1,0

1,241,241,14,14,0,1,0
2,373,373,44,44,0,1,0
3,454,454,91,26,65,4,3
0,482,482,12,6,6,3,2

6,119,119,24,6,18,3,2
2,136,136,5,5,0,1,0
4,184,184,1,1,0,1,0
1,269,269,7,3,4,2,1
5,294,294,29,29,0,1,0
0,458,458,3,3,0,1,0
3,481,481,14,1,13,2,1

2,130,130,4,4,0,1,0
3,162,162,9,1,8,3,2
5,251,251,51,51,0,1,0
1,425,425,34,34,0,1,0
4,431,431,12,12,0,1,0
0,483,483,3,3,0,1,0

0,220,220,4,4,0,1,0
2,260,260,52,2,50,3,2
1,490,490,90,90,0,1,0

3,189,189,12,12,0,1,0
2,246,246,8,2,6,2,1
1,401,401,26,4,22,2,1
4,481,481,97,21,76,4,3
0,495,495,21,12,9,4,3

1,197,197,9,6,3,2,1
2,267,267,28,28,0,1,0
0,281,281,14,14,0,1,0
3,454,454,91,91,0,1,0

4,132,132,27,19,8,3,2
1,249,249,8,3,5,2,1
2,387,387,14,14,0,1,0
0,399,399,5,5,0,1,0
3,448,448,54,5,49,4,3

4,185,185,15,15,0,1,0
1,205,205,3,3,0,1,0
5,294,294,59,59,0,1,0
3,350,350,8,8,0,1,0
0,428,428,21,21,0,1,0
2,480,480,17,8,9,4,3

2,323,323,8,2,6,2,1
4,344,344,69,57,12,3,2
3,439,439,8,3,5,2,1
1,445,445,64,28,36,4,3
0,500,500,7,2,5,2,1

3,265,265,53,53,0,1,0
0,319,319,11,11,0,1,0
1,382,382,17,2,15,4,3
2,425,425,52,52,0,1,0

1,186,186,16,7,9,4,3
2,299,299,60,60,0,1,0
0,447,447,51,27,24,2,1

3,109,109,3,3,0,1,0
4,223,223,45,45,0,1,0
0,257,257,12,12,0,1,0
1,456,456,3,3,0,1,0
2,486,486,58,53,5,2,1

0,280,280,56,56,0,1,0
1,397,397,80,47,33,4,3

0,206,206,42,42,0,1,0
1,377,377,76,67,9,2,1

4,103,103,6,6,0,1,0
0,177,177,1,1,0,1,0
1,184,184,2,2,0,1,0
6,230,230,46,1,45,2,1
3,394,394,28,12,16,2,1
5,467,467,14,14,0,1,0
2,493,493,12,8,4,2,1

2,119,119,24,15,9,2,1
1,167,167,17,1,16,3,2
0,300,300,31,16,15,2,1

1,155,155,1,1,0,1,0
3,162,162,33,12,21,3,2
2,190,190,37,37,0,1,0
0,325,325,1,1,0,1,0

2,198,198,4,4,0,1,0
1,213,213,29,29,0,1,0
0,390,390,18,18,0,1,0
3,486,486,98,26,72,4,3

4,207,207,42,16,26,2,1
1,323,323,17,1,16,2,1
3,349,349,40,40,0,1,0
2,464,464,1,1,0,1,0
0,486,486,15,6,9,3,2

2,119,119,24,12,12,3,2
1,235,235,16,4,12,2,1
0,480,480,64,64,0,1,0

1,217,217,40,5,35,2,1
0,355,355,6,6,0,1,0
2,480,480,96,90,6,3,2

2,142,142,7,7,0,1,0
0,207,207,1,1,0,1,0
3,335,335,67,53,14,3,2
1,424,424,64,51,13,2,1

1,222,222,45,24,21,4,3
0,468,468,94,22,72,3,2

0,324,324,51,51,0,1,0
1,327,327,5,5,0,1,0
3,353,353,71,71,0,1,0
2,461,461,13,13,0,1,0

0,349,349,70,70,0,1,0
1,417,417,84,74,10,2,1

1,209,209,18,18,0,1,0
3,223,223,20,2,18,4,3
2,241,241,5,1,4,2,1
0,282,282,2,2,0,1,0
4,324,324,65,39,26,3,2

5,103,103,9,9,0,1,0
6,138,138,28,24,4,2,1
0,141,141,4,4,0,1,0
2,168,168,2,2,0,1,0
1,338,338,3,3,0,1,0
3,491,491,28,28,0,1,0
4,492,492,6,6,0,1,0

2,131,131,27,11,16,3,2
0,211,211,16,16,0,1,0
1,314,314,39,39,0,1,0

4,219,219,44,44,0,1,0
1,222,222,6,6,0,1,0
3,400,400,5,5,0,1,0
0,456,456,42,26,16,3,2
2,466,466,32,23,9,2,1

1,414,414,25,8,17,2,1
2,436,436,88,49,39,4,3
0,491,491,69,69,0,1,0

0,100,100,3,3,0,1,0
1,154,154,6,2,4,2,1
3,300,300,25,25,0,1,0
4,302,302,61,46,15,4,3
2,418,418,20,17,3,2,1

1,186,186,2,2,0,1,0
2,225,225,17,3,14,2,1
4,311,311,63,48,15,2,1
0,465,465,27,27,0,1,0
3,483,483,27,27,0,1,0

0,379,379,67,25,42,3,2
1,417,417,10,10,0,1,0
2,498,498,100,28,72,4,3

0,192,192,11,11,0,1,0
1,209,209,30,11,19,4,3
2,322,322,65,31,34,2,1

1,140,140,11,11,0,1,0
2,151,151,1,1,0,1,0
0,238,238,28,28,0,1,0
3,268,268,54,54,0,1,0

0,198,198,9,3,6,2,1
2,353,353,71,71,0,1,0
1,402,402,63,42,21,2,1

0,192,192,39,27,12,4,3
1,491,491,99,67,32,3,2

3,283,283,57,49,8,2,1
0,413,413,1,1,0,1,0
1,466,466,55,55,0,1,0
2,468,468,38,38,0,1,0

2,167,167,34,8,26,3,2
1,195,195,20,20,0,1,0
0,213,213,21,13,8,2,1

1,186,186,34,34,0,1,0
0,305,305,6,6,0,1,0
2,385,385,77,77,0,1,0

0,160,160,33,33,0,1,0
1,474,474,95,17,78,4,3

1,285,285,29,29,0,1,0
0,357,357,36,8,28,3,2
2,436,436,88,4,84,4,3

3,105,105,21,8,13,2,1
0,245,245,16,1,15,4,3
1,259,259,30,9,21,4,3
2,329,329,7,7,0,1,0

2,148,148,5,2,3,2,1
1,164,164,5,5,0,1,0
0,218,218,3,3,0,1,0
6,418,418,84,50,34,2,1
4,459,459,14,14,0,1,0
3,473,473,6,6,0,1,0
5,489,489,39,39,0,1,0

3,174,174,11,2,9,4,3
4,242,242,12,7,5,2,1
0,310,310,15,9,6,3,2
1,340,340,12,12,0,1,0
5,364,364,73,61,12,2,1
2,480,480,2,2,0,1,0

0,249,249,10,10,0,1,0
1,343,343,55,19,36,3,2
2,388,388,78,46,32,2,1

0,186,186,3,3,0,1,0
1,399,399,74,74,0,1,0
2,437,437,88,88,0,1,0

1,122,122,1,1,0,1,0
2,171,171,35,11,24,2,1
0,209,209,41,31,10,2,1

1,108,108,7,7,0,1,0
0,300,300,6,6,0,1,0
2,437,437,51,3,48,4,3
3,492,492,99,80,19,3,2

2,242,242,49,13,36,3,2
0,382,382,13,7,6,2,1
1,473,473,79,46,33,4,3

0,248,248,26,12,14,3,2
1,274,274,27,27,0,1,0
2,385,385,77,77,0,1,0

2,106,106,16,4,12,2,1
1,139,139,6,6,0,1,0
0,208,208,3,3,0,1,0
3,295,295,59,59,0,1,0

0,212,212,35,32,3,2,1
3,403,403,81,32,49,2,1
2,426,426,13,13,0,1,0
1,469,469,3,3,0,1,0

1,174,174,1,1,0,1,0
3,255,255,9,9,0,1,0
5,311,311,63,33,30,3,2
0,391,391,15,15,0,1,0
4,439,439,49,22,27,3,2
2,494,494,5,5,0,1,0

3,192,192,39,11,28,4,3
1,246,246,15,3,12,2,1
2,294,294,30,6,24,4,3
0,482,482,19,13,6,3,2

1,140,140,28,15,13,2,1
0,241,241,49,32,17,2,1

2,128,128,9,9,0,1,0
3,200,200,20,14,6,3,2
1,218,218,4,1,3,2,1
4,353,353,71,31,40,3,2
0,413,413,5,5,0,1,0

1,163,163,7,2,5,2,1
2,233,233,3,3,0,1,0
0,319,319,36,21,15,2,1
4,354,354,71,29,42,4,3
3,464,464,15,7,8,3,2

1,110,110,19,19,0,1,0
2,196,196,40,9,31,2,1
0,249,249,8,8,0,1,0

2,153,153,18,18,0,1,0
0,415,415,27,27,0,1,0
3,469,469,94,79,15,3,2
1,496,496,10,10,0,1,0

4,155,155,6,6,0,1,0
5,208,208,42,42,0,1,0
1,337,337,3,3,0,1,0
3,337,337,3,3,0,1,0
2,348,348,1,1,0,1,0
0,440,440,63,41,22,3,2

1,261,261,9,9,0,1,0
0,347,347,17,7,10,2,1
2,401,401,47,6,41,2,1
3,428,428,86,86,0,1,0

3,203,203,41,41,0,1,0
1,217,217,1,1,0,1,0
2,378,378,52,52,0,1,0
0,411,411,24,10,14,2,1

3,208,208,42,42,0,1,0
2,307,307,27,27,0,1,0
0,326,326,20,20,0,1,0
1,483,483,26,26,0,1,0

0,353,353,40,4,36,4,3
1,373,373,17,17,0,1,0
4,383,383,77,56,21,2,1
2,420,420,4,4,0,1,0
3,446,446,15,15,0,1,0

0,256,256,14,3,11,2,1
1,294,294,15,15,0,1,0
3,317,317,3,3,0,1,0
2,349,349,30,2,28,2,1
4,405,405,81,42,39,4,3

0,162,162,33,33,0,1,0
1,180,180,36,36,0,1,0

0,280,280,33,12,21,2,1
2,437,437,88,74,14,3,2
1,489,489,41,6,35,2,1

1,245,245,39,39,0,1,0
0,423,423,18,12,6,2,1
2,423,423,85,75,10,3,2

1,193,193,33,19,14,2,1
0,281,281,9,9,0,1,0
2,339,339,68,59,9,2,1

0,190,190,27,27,0,1,0
3,219,219,44,44,0,1,0
2,225,225,13,4,9,4,3
1,384,384,1,1,0,1,0

1,275,275,1,1,0,1,0
3,277,277,56,40,16,2,1
0,293,293,54,54,0,1,0
2,392,392,5,5,0,1,0

1,165,165,12,1,11,2,1
0,328,328,24,11,13,2,1
2,369,369,20,14,6,3,2
3,434,434,87,65,22,2,1

1,221,221,34,34,0,1,0
2,389,389,78,36,42,2,1
0,410,410,20,20,0,1,0

2,252,252,22,5,17,2,1
0,291,291,22,2,20,3,2
3,318,318,64,38,26,3,2
1,417,417,16,16,0,1,0

2,163,163,20,20,0,1,0
3,214,214,43,43,0,1,0
0,415,415,10,10,0,1,0
1,432,432,24,11,13,2,1

0,255,255,28,20,8,2,1
2,389,389,3,3,0,1,0
1,433,433,36,10,26,3,2
3,488,488,98,57,41,2,1

1,161,161,2,2,0,1,0
2,349,349,70,28,42,4,3
0,457,457,86,11,75,4,3

2,249,249,18,2,16,3,2
3,259,259,13,13,0,1,0
4,267,267,12,12,0,1,0
1,390,390,6,6,0,1,0
0,395,395,8,8,0,1,0
5,466,466,94,41,53,3,2

3,107,107,22,3,19,2,1
2,211,211,4,1,3,2,1
1,268,268,46,46,0,1,0
0,363,363,4,4,0,1,0

0,252,252,6,6,0,1,0
1,298,298,53,29,24,4,3
2,332,332,67,19,48,4,3

1,101,101,15,15,0,1,0
0,105,105,6,3,3,2,1
2,398,398,80,59,21,4,3

2,107,107,22,5,17,2,1
1,151,151,13,13,0,1,0
0,324,324,37,13,24,4,3

4,191,191,39,39,0,1,0
3,203,203,2,2,0,1,0
1,282,282,5,5,0,1,0
0,473,473,6,3,3,2,1
2,499,499,81,44,37,4,3

3,201,201,41,16,25,2,1
0,232,232,25,13,12,3,2
1,293,293,8,8,0,1,0
2,485,485,32,2,30,2,1

1,198,198,32,4,28,2,1
0,225,225,9,3,6,2,1
2,272,272,55,50,5,2,1

1,407,407,82,22,60,3,2
0,409,409,82,2,80,3,2

1,139,139,23,23,0,1,0
0,218,218,9,9,0,1,0
2,218,218,44,2,42,3,2

1,166,166,6,2,4,2,1
2,315,315,13,13,0,1,0
3,451,451,91,71,20,2,1
0,478,478,60,60,0,1,0

2,211,211,43,1,42,3,2
1,214,214,11,11,0,1,0
0,368,368,55,55,0,1,0

0,141,141,3,3,0,1,0
2,191,191,39,39,0,1,0
1,226,226,41,41,0,1,0

2,358,358,72,72,0,1,0
1,364,364,54,36,18,2,1
0,459,459,24,24,0,1,0

0,120,120,24,10,14,2,1
1,457,457,92,26,66,4,3

3,118,118,24,24,0,1,0
0,195,195,26,26,0,1,0
1,322,322,20,20,0,1,0
2,449,449,3,3,0,1,0

2,269,269,54,33,21,2,1
0,315,315,19,3,16,2,1
1,400,400,56,56,0,1,0

2,170,170,3,3,0,1,0
4,215,215,43,9,34,2,1
1,280,280,8,4,4,2,1
3,294,294,5,5,0,1,0
0,407,407,56,56,0,1,0

2,269,269,54,7,47,2,1
0,430,430,78,61,17,2,1
1,478,478,9,9,0,1,0

0,266,266,5,1,4,2,1
2,280,280,31,17,14,3,2
3,418,418,84,14,70,4,3
1,424,424,30,30,0,1,0

0,104,104,1,1,0,1,0
2,279,279,53,53,0,1,0
3,352,352,71,64,7,2,1
1,413,413,1,1,0,1,0

3,200,200,40,6,34,3,2
2,255,255,50,50,0,1,0
0,305,305,1,1,0,1,0
1,476,476,1,1,0,1,0

2,155,155,2,2,0,1,0
3,194,194,11,11,0,1,0
0,198,198,21,21,0,1,0
4,322,322,65,4,61,3,2
1,381,381,11,11,0,1,0

2,143,143,29,29,0,1,0
0,247,247,24,24,0,1,0
1,496,496,52,20,32,3,2

1,112,112,23,2,21,4,3
0,277,277,56,56,0,1,0

1,318,318,26,5,21,4,3
0,339,339,12,2,10,3,2
2,374,374,31,3,28,3,2
3,453,453,91,91,0,1,0

3,135,135,27,9,18,3,2
2,136,136,16,9,7,2,1
0,325,325,13,7,6,3,2
1,331,331,16,6,10,3,2

2,131,131,27,21,6,3,2
1,350,350,70,26,44,4,3
0,474,474,1,1,0,1,0

0,204,204,41,29,12,2,1
1,314,314,63,13,50,2,1

3,157,157,17,17,0,1,0
4,232,232,47,42,5,2,1
2,316,316,8,8,0,1,0
0,351,351,18,18,0,1,0
1,367,367,7,1,6,2,1

1,362,362,51,13,38,4,3
2,414,414,14,14,0,1,0
3,476,476,96,96,0,1,0
0,478,478,13,7,6,3,2

5,111,111,1,1,0,1,0
6,205,205,7,3,4,2,1
0,290,290,1,1,0,1,0
1,328,328,3,3,0,1,0
2,336,336,11,3,8,2,1
7,336,336,68,68,0,1,0
3,396,396,25,13,12,4,3
4,445,445,23,3,20,3,2

0,216,216,41,35,6,2,1
2,248,248,2,2,0,1,0
1,296,296,1,1,0,1,0
3,339,339,68,68,0,1,0

0,205,205,9,5,4,2,1
2,398,398,80,59,21,4,3
1,406,406,64,43,21,4,3

0,197,197,18,6,12,2,1
1,227,227,11,11,0,1,0
4,228,228,46,8,38,3,2
3,378,378,8,5,3,2,1
2,401,401,16,16,0,1,0

0,255,255,26,18,8,3,2
1,291,291,1,1,0,1,0
4,389,389,78,64,14,3,2
3,415,415,6,6,0,1,0
2,456,456,37,37,0,1,0

2,104,104,11,11,0,1,0
1,249,249,3,3,0,1,0
0,355,355,4,1,3,2,1
3,459,459,33,33,0,1,0
4,490,490,98,21,77,4,3

0,249,249,1,1,0,1,0
1,275,275,3,3,0,1,0
5,370,370,74,53,21,4,3
4,383,383,69,38,31,2,1
3,412,412,2,2,0,1,0
2,428,428,1,1,0,1,0

0,342,342,69,54,15,4,3
1,440,440,88,16,72,3,2

0,226,226,15,5,10,2,1
4,341,341,69,43,26,4,3
3,354,354,25,15,10,3,2
1,415,415,14,14,0,1,0
2,472,472,14,9,5,2,1

1,162,162,7,3,4,2,1
0,211,211,34,11,23,2,1
2,422,422,85,24,61,4,3

0,117,117,4,4,0,1,0
3,168,168,1,1,0,1,0
2,170,170,4,4,0,1,0
5,188,188,18,2,16,3,2
1,290,290,1,1,0,1,0
6,350,350,70,70,0,1,0
4,390,390,15,15,0,1,0

1,262,262,53,3,50,2,1
0,339,339,68,68,0,1,0

1,104,104,1,1,0,1,0
2,189,189,1,1,0,1,0
3,189,189,3,3,0,1,0
5,452,452,91,49,42,2,1
4,484,484,7,1,6,2,1
0,500,500,78,75,3,2,1

0,209,209,23,8,15,2,1
1,352,352,32,7,25,2,1
2,438,438,88,58,30,3,2

1,233,233,25,13,12,2,1
0,316,316,30,30,0,1,0
2,365,365,73,73,0,1,0

0,269,269,36,11,25,2,1
2,299,299,60,22,38,2,1
1,343,343,23,23,0,1,0

0,117,117,12,12,0,1,0
2,155,155,31,31,0,1,0
1,386,386,38,34,4,2,1

1,229,229,46,46,0,1,0
0,250,250,50,17,33,4,3

2,134,134,27,27,0,1,0
0,198,198,36,19,17,2,1
1,330,330,6,6,0,1,0

1,107,107,10,7,3,2,1
0,129,129,14,11,3,2,1
2,488,488,98,17,81,4,3

2,341,341,69,69,0,1,0
1,451,451,63,11,52,3,2
0,472,472,29,29,0,1,0

3,133,133,27,27,0,1,0
1,180,180,10,2,8,2,1
2,222,222,23,23,0,1,0
0,360,360,15,15,0,1,0

1,384,384,55,35,20,3,2
0,405,405,23,23,0,1,0
2,418,418,84,81,3,2,1

0,256,256,44,44,0,1,0
2,260,260,52,52,0,1,0
1,394,394,12,6,6,2,1

0,286,286,58,32,26,3,2
1,341,341,69,29,40,3,2

1,343,343,43,43,0,1,0
2,471,471,95,95,0,1,0
0,472,472,36,36,0,1,0

1,148,148,10,4,6,3,2
0,266,266,10,4,6,3,2
2,355,355,19,1,18,3,2
4,368,368,74,25,49,3,2
3,478,478,20,20,0,1,0

0,115,115,11,1,10,3,2
2,255,255,51,30,21,2,1
1,357,357,38,35,3,2,1

0,191,191,38,30,8,3,2
2,239,239,48,27,21,2,1
1,340,340,1,1,0,1,0

3,134,134,14,14,0,1,0
1,209,209,1,1,0,1,0
6,330,330,66,66,0,1,0
2,346,346,1,1,0,1,0
0,429,429,3,3,0,1,0
4,439,439,4,4,0,1,0
5,453,453,33,33,0,1,0

3,123,123,1,1,0,1,0
2,168,168,6,6,0,1,0
4,225,225,45,17,28,2,1
0,337,337,5,5,0,1,0
1,365,365,54,54,0,1,0

0,143,143,21,10,11,2,1
2,302,302,61,61,0,1,0
1,497,497,27,15,12,3,2

0,165,165,2,2,0,1,0
2,284,284,12,12,0,1,0
3,352,352,71,26,45,4,3
1,428,428,63,63,0,1,0

0,169,169,15,11,4,2,1
1,207,207,24,16,8,3,2
2,465,465,93,33,60,3,2

4,121,121,25,13,12,2,1
2,125,125,1,1,0,1,0
0,256,256,34,4,30,2,1
1,334,334,13,7,6,3,2
3,487,487,10,10,0,1,0

1,179,179,21,21,0,1,0
2,388,388,78,47,31,2,1
0,467,467,41,41,0,1,0

1,193,193,11,3,8,3,2
2,209,209,42,39,3,2,1
0,236,236,34,34,0,1,0

2,328,328,66,30,36,3,2
0,364,364,33,17,16,2,1
1,411,411,45,15,30,4,3

4,152,152,31,31,0,1,0
2,264,264,19,19,0,1,0
1,292,292,6,2,4,2,1
0,335,335,20,15,5,2,1
3,347,347,17,17,0,1,0

0,344,344,69,69,0,1,0
1,470,470,94,80,14,2,1

3,202,202,4,4,0,1,0
4,225,225,45,45,0,1,0
1,227,227,7,7,0,1,0
0,291,291,34,34,0,1,0
2,419,419,15,3,12,3,2

2,142,142,7,7,0,1,0
0,167,167,7,7,0,1,0
4,274,274,55,40,15,4,3
1,326,326,13,13,0,1,0
3,373,373,26,26,0,1,0

3,177,177,36,36,0,1,0
2,305,305,8,8,0,1,0
0,406,406,43,16,27,4,3
1,467,467,33,21,12,4,3

1,208,208,1,1,0,1,0
3,226,226,46,2,44,3,2
2,392,392,26,8,18,4,3
0,473,473,61,61,0,1,0

2,112,112,23,2,21,4,3
1,222,222,8,8,0,1,0
0,408,408,67,67,0,1,0

4,201,201,2,2,0,1,0
2,268,268,1,1,0,1,0
6,275,275,55,12,43,4,3
3,417,417,9,9,0,1,0
5,463,463,14,14,0,1,0
0,471,471,26,20,6,3,2
1,484,484,39,39,0,1,0

1,131,131,18,18,0,1,0
3,432,432,87,69,18,4,3
2,437,437,11,11,0,1,0
0,440,440,17,17,0,1,0

3,156,156,32,32,0,1,0
2,259,259,12,12,0,1,0
0,279,279,4,4,0,1,0
1,444,444,62,62,0,1,0

1,360,360,72,72,0,1,0
0,426,426,86,29,57,4,3

0,116,116,14,14,0,1,0
2,231,231,47,19,28,2,1
1,272,272,22,22,0,1,0

0,145,145,23,2,21,2,1
2,185,185,37,7,30,4,3
1,350,350,15,3,12,4,3

1,147,147,1,1,0,1,0
3,158,158,32,32,0,1,0
0,213,213,30,17,13,4,3
2,258,258,14,14,0,1,0

3,134,134,1,1,0,1,0
0,194,194,4,4,0,1,0
2,270,270,6,1,5,2,1
4,273,273,28,28,0,1,0
5,315,315,63,11,52,3,2
1,336,336,16,16,0,1,0

1,189,189,38,26,12,4,3
0,492,492,99,66,33,4,3

6,127,127,26,26,0,1,0
4,172,172,4,4,0,1,0
2,276,276,2,2,0,1,0
0,277,277,7,1,6,3,2
3,355,355,27,27,0,1,0
5,431,431,7,7,0,1,0
1,488,488,26,23,3,2,1

0,289,289,58,11,47,2,1
1,471,471,95,85,10,2,1

0,122,122,2,2,0,1,0
1,141,141,8,8,0,1,0
2,273,273,9,3,6,2,1
3,377,377,36,36,0,1,0
4,397,397,80,66,14,4,3

0,119,119,2,2,0,1,0
2,131,131,6,6,0,1,0
3,299,299,8,3,5,2,1
1,354,354,1,1,0,1,0
4,361,361,39,39,0,1,0
5,408,408,82,82,0,1,0

4,175,175,1,1,0,1,0
2,240,240,8,8,0,1,0
5,302,302,61,37,24,4,3
0,304,304,4,1,3,2,1
1,351,351,52,52,0,1,0
3,388,388,2,2,0,1,0

1,154,154,4,4,0,1,0
0,160,160,22,22,0,1,0
3,226,226,46,46,0,1,0
2,428,428,16,16,0,1,0

4,262,262,53,53,0,1,0
1,306,306,21,21,0,1,0
2,427,427,7,1,6,3,2
0,440,440,18,18,0,1,0
3,450,450,34,28,6,2,1

2,159,159,26,26,0,1,0
0,183,183,1,1,0,1,0
3,216,216,7,7,0,1,0
1,361,361,1,1,0,1,0
4,494,494,99,11,88,4,3

1,134,134,23,23,0,1,0
2,337,337,68,68,0,1,0
0,415,415,12,1,11,2,1

1,115,115,1,1,0,1,0
3,184,184,37,17,20,4,3
0,223,223,7,2,5,2,1
2,370,370,60,18,42,2,1

0,114,114,23,9,14,2,1
1,383,383,77,54,23,3,2

2,170,170,34,34,0,1,0
1,323,323,61,61,0,1,0
0,481,481,6,6,0,1,0

1,169,169,34,34,0,1,0
0,251,251,51,19,32,2,1

0,171,171,21,11,10,3,2
2,173,173,35,14,21,2,1
1,288,288,23,6,17,4,3

1,112,112,11,11,0,1,0
3,278,278,56,32,24,4,3
0,380,380,27,27,0,1,0
2,395,395,13,7,6,2,1

1,177,177,11,8,3,2,1
3,179,179,36,18,18,3,2
2,206,206,14,14,0,1,0
0,387,387,28,28,0,1,0

1,166,166,10,4,6,3,2
4,179,179,18,10,8,3,2
2,263,263,1,1,0,1,0
3,286,286,6,6,0,1,0
5,292,292,59,41,18,2,1
0,454,454,7,7,0,1,0

1,141,141,12,12,0,1,0
2,314,314,31,23,8,3,2
0,430,430,7,1,6,3,2
3,441,441,89,89,0,1,0

0,161,161,13,13,0,1,0
3,227,227,46,34,12,3,2
2,251,251,26,8,18,2,1
1,459,459,8,8,0,1,0

1,246,246,44,44,0,1,0
3,256,256,52,16,36,4,3
0,351,351,5,5,0,1,0
2,495,495,4,4,0,1,0

2,163,163,33,25,8,2,1
1,386,386,23,23,0,1,0
0,416,416,59,59,0,1,0

2,166,166,34,34,0,1,0
0,315,315,41,41,0,1,0
1,318,318,23,23,0,1,0

0,242,242,49,1,48,4,3
1,248,248,50,41,9,4,3

1,269,269,8,8,0,1,0
0,313,313,54,54,0,1,0
2,339,339,68,49,19,2,1

2,266,266,54,43,11,3,2
0,340,340,49,49,0,1,0
1,460,460,26,9,17,2,1

6,104,104,21,21,0,1,0
5,208,208,4,4,0,1,0
1,232,232,6,6,0,1,0
0,259,259,4,4,0,1,0
4,343,343,7,1,6,3,2
3,380,380,23,2,21,4,3
2,397,397,24,24,0,1,0

1,185,185,14,7,7,2,1
3,188,188,20,6,14,3,2
0,216,216,2,2,0,1,0
5,227,227,46,46,0,1,0
2,407,407,1,1,0,1,0
4,464,464,3,3,0,1,0

2,113,113,2,2,0,1,0
5,153,153,31,31,0,1,0
1,159,159,5,5,0,1,0
4,218,218,8,2,6,2,1
0,243,243,7,1,6,3,2
3,488,488,43,43,0,1,0

0,117,117,1,1,0,1,0
2,365,365,73,73,0,1,0
1,465,465,90,51,39,4,3

0,127,127,6,3,3,2,1
1,137,137,13,13,0,1,0
3,172,172,2,2,0,1,0
2,336,336,17,2,15,4,3
4,489,489,98,98,0,1,0

4,125,125,25,3,22,3,2
2,147,147,2,2,0,1,0
0,179,179,21,21,0,1,0
1,260,260,11,1,10,2,1
3,387,387,11,11,0,1,0

4,105,105,21,21,0,1,0
1,123,123,10,10,0,1,0
0,146,146,5,5,0,1,0
3,146,146,8,8,0,1,0
2,445,445,15,15,0,1,0

4,149,149,30,30,0,1,0
1,268,268,4,4,0,1,0
3,300,300,28,28,0,1,0
2,344,344,27,5,22,2,1
0,384,384,6,3,3,2,1

1,246,246,1,1,0,1,0
2,344,344,8,2,6,2,1
0,350,350,36,10,26,3,2
3,395,395,28,28,0,1,0
4,418,418,84,44,40,3,2

2,178,178,36,36,0,1,0
0,334,334,28,28,0,1,0
1,363,363,43,33,10,2,1

1,210,210,42,42,0,1,0
0,426,426,86,35,51,4,3

1,171,171,1,1,0,1,0
0,210,210,9,9,0,1,0
2,258,258,26,1,25,4,3
4,273,273,55,12,43,2,1
3,373,373,19,19,0,1,0

1,132,132,19,1,18,3,2
0,149,149,9,9,0,1,0
2,343,343,69,15,54,4,3

1,101,101,4,4,0,1,0
3,171,171,1,1,0,1,0
2,349,349,45,20,25,2,1
4,401,401,81,45,36,3,2
0,463,463,14,5,9,4,3

3,104,104,21,9,12,3,2
2,114,114,14,14,0,1,0
0,246,246,15,15,0,1,0
1,249,249,5,5,0,1,0

1,171,171,35,17,18,3,2
0,173,173,35,10,25,2,1

2,133,133,27,1,26,2,1
1,224,224,32,32,0,1,0
0,463,463,27,27,0,1,0

0,128,128,26,26,0,1,0
1,196,196,40,40,0,1,0

1,206,206,42,42,0,1,0
0,280,280,56,2,54,4,3

4,123,123,25,7,18,4,3
2,304,304,26,5,21,2,1
1,339,339,15,15,0,1,0
3,424,424,15,15,0,1,0
0,441,441,16,16,0,1,0

1,160,160,5,2,3,2,1
3,183,183,37,37,0,1,0
2,330,330,9,9,0,1,0
0,413,413,59,59,0,1,0

1,211,211,33,23,10,3,2
0,331,331,5,5,0,1,0
3,399,399,11,1,10,3,2
2,407,407,1,1,0,1,0
4,475,475,95,48,47,2,1

1,141,141,1,1,0,1,0
2,153,153,4,4,0,1,0
3,297,297,37,11,26,3,2
4,342,342,11,11,0,1,0
5,412,412,83,23,60,4,3
0,424,424,5,5,0,1,0

4,124,124,5,5,0,1,0
3,160,160,12,12,0,1,0
1,304,304,4,4,0,1,0
2,361,361,22,22,0,1,0
5,379,379,76,17,59,4,3
0,395,395,7,7,0,1,0

0,130,130,26,26,0,1,0
1,323,323,65,16,49,2,1

0,194,194,9,9,0,1,0
1,286,286,44,14,30,3,2
2,399,399,80,80,0,1,0

2,234,234,47,6,41,2,1
1,353,353,37,1,36,4,3
0,476,476,46,7,39,4,3

1,386,386,78,78,0,1,0
0,410,410,83,83,0,1,0

0,228,228,44,26,18,2,1
2,298,298,60,60,0,1,0
1,388,388,3,3,0,1,0

1,126,126,2,2,0,1,0
2,390,390,53,17,36,4,3
0,414,414,21,21,0,1,0
3,479,479,96,49,47,3,2

1,100,100,19,19,0,1,0
2,191,191,39,39,0,1,0
0,284,284,5,2,3,2,1

3,267,267,10,10,0,1,0
2,269,269,41,41,0,1,0
1,273,273,1,1,0,1,0
4,465,465,93,81,12,4,3
0,479,479,4,4,0,1,0

2,163,163,33,2,31,4,3
1,233,233,5,1,4,2,1
0,447,447,81,2,79,4,3

0,125,125,13,13,0,1,0
1,329,329,32,32,0,1,0
2,469,469,94,94,0,1,0

3,383,383,77,19,58,3,2
0,413,413,1,1,0,1,0
1,422,422,80,80,0,1,0
2,498,498,4,4,0,1,0

0,176,176,36,36,0,1,0
1,231,231,47,22,25,2,1

0,140,140,1,1,0,1,0
2,167,167,23,23,0,1,0
4,207,207,42,13,29,4,3
1,269,269,4,4,0,1,0
3,448,448,19,3,16,3,2

0,457,457,92,8,84,4,3
1,493,493,99,58,41,2,1

1,232,232,8,4,4,2,1
3,318,318,15,15,0,1,0
2,355,355,6,6,0,1,0
5,362,362,73,35,38,2,1
4,372,372,27,23,4,2,1
0,490,490,15,15,0,1,0

0,119,119,6,6,0,1,0
3,196,196,40,16,24,3,2
1,421,421,61,53,8,3,2
2,432,432,3,3,0,1,0

2,283,283,12,12,0,1,0
1,348,348,28,2,26,3,2
3,366,366,74,29,45,4,3
0,463,463,37,3,34,3,2

0,170,170,6,6,0,1,0
2,329,329,66,66,0,1,0
1,361,361,60,60,0,1,0

0,118,118,13,13,0,1,0
1,385,385,35,35,0,1,0
2,408,408,82,82,0,1,0

4,105,105,3,3,0,1,0
3,194,194,6,6,0,1,0
2,231,231,8,8,0,1,0
0,246,246,9,9,0,1,0
1,390,390,30,5,25,2,1
5,449,449,90,41,49,4,3

2,131,131,27,13,14,2,1
1,286,286,39,8,31,2,1
0,422,422,27,12,15,2,1

1,220,220,44,44,0,1,0
0,225,225,45,45,0,1,0

0,137,137,28,13,15,2,1
1,285,285,57,22,35,2,1

4,143,143,3,3,0,1,0
0,149,149,8,1,7,2,1
2,311,311,1,1,0,1,0
3,408,408,30,4,26,2,1
5,425,425,85,37,48,3,2
1,493,493,25,25,0,1,0

1,317,317,64,64,0,1,0
0,400,400,81,51,30,2,1

0,199,199,2,2,0,1,0
1,339,339,36,36,0,1,0
2,423,423,36,1,35,2,1
3,438,438,88,88,0,1,0

3,149,149,30,30,0,1,0
1,211,211,22,19,3,2,1
2,246,246,23,23,0,1,0
0,363,363,2,2,0,1,0

1,177,177,36,36,0,1,0
0,352,352,71,71,0,1,0

0,145,145,5,5,0,1,0
1,280,280,47,19,28,3,2
2,476,476,96,40,56,3,2

0,103,103,8,4,4,2,1
5,145,145,2,2,0,1,0
2,251,251,15,15,0,1,0
3,336,336,6,1,5,2,1
1,352,352,1,1,0,1,0
6,377,377,76,73,3,2,1
4,488,488,16,4,12,3,2

3,159,159,32,1,31,3,2
0,229,229,17,17,0,1,0
1,267,267,27,8,19,2,1
2,367,367,10,4,6,2,1

1,117,117,1,1,0,1,0
0,269,269,12,5,7,2,1
3,345,345,38,38,0,1,0
2,363,363,14,11,3,2,1
4,372,372,75,15,60,3,2

0,262,262,29,21,8,2,1
3,451,451,91,91,0,1,0
1,464,464,7,7,0,1,0
2,474,474,36,8,28,3,2

4,111,111,4,4,0,1,0
1,112,112,5,5,0,1,0
5,117,117,9,9,0,1,0
3,130,130,3,3,0,1,0
6,147,147,30,2,28,3,2
0,211,211,2,2,0,1,0
2,331,331,5,5,0,1,0

1,152,152,5,5,0,1,0
2,215,215,2,2,0,1,0
7,234,234,47,20,27,2,1
0,246,246,5,5,0,1,0
5,269,269,4,4,0,1,0
4,428,428,3,3,0,1,0
6,462,462,2,2,0,1,0
3,499,499,56,47,9,4,3

2,268,268,54,54,0,1,0
0,347,347,40,11,29,2,1
1,403,403,35,3,32,2,1

2,166,166,34,7,27,2,1
0,470,470,39,30,9,4,3
1,470,470,55,55,0,1,0

5,124,124,1,1,0,1,0
2,168,168,3,3,0,1,0
6,181,181,9,9,0,1,0
0,207,207,8,3,5,2,1
7,259,259,52,24,28,2,1
3,291,291,20,8,12,4,3
1,386,386,3,3,0,1,0
4,423,423,5,5,0,1,0

1,127,127,7,3,4,2,1
2,233,233,33,3,30,4,3
0,240,240,1,1,0,1,0
3,305,305,61,46,15,2,1

1,310,310,19,1,18,3,2
0,417,417,58,26,32,3,2
2,490,490,98,92,6,3,2

1,140,140,9,9,0,1,0
2,207,207,18,18,0,1,0
3,284,284,57,18,39,4,3
0,299,299,15,12,3,2,1

1,359,359,72,66,6,2,1
0,399,399,80,20,60,3,2

0,141,141,29,29,0,1,0
1,333,333,67,3,64,3,2

0,244,244,4,4,0,1,0
1,415,415,77,77,0,1,0
2,490,490,98,20,78,4,3

0,208,208,42,30,12,4,3
1,496,496,100,100,0,1,0

1,135,135,11,11,0,1,0
3,210,210,42,21,21,4,3
2,238,238,28,8,20,3,2
0,286,286,1,1,0,1,0

2,108,108,6,6,0,1,0
4,179,179,5,5,0,1,0
3,299,299,17,4,13,2,1
0,301,301,18,18,0,1,0
5,303,303,61,14,47,2,1
1,361,361,1,1,0,1,0

2,142,142,17,10,7,2,1
1,189,189,2,2,0,1,0
0,193,193,14,4,10,2,1
3,442,442,89,64,25,2,1

3,160,160,32,32,0,1,0
1,184,184,1,1,0,1,0
0,323,323,1,1,0,1,0
2,333,333,64,64,0,1,0

0,138,138,12,12,0,1,0
4,149,149,30,30,0,1,0
2,205,205,7,7,0,1,0
1,328,328,11,11,0,1,0
3,410,410,19,19,0,1,0

3,181,181,6,3,3,2,1
0,205,205,1,1,0,1,0
2,250,250,19,3,16,2,1
4,337,337,16,16,0,1,0
1,363,363,14,11,3,2,1
5,365,365,73,31,42,4,3

0,132,132,3,3,0,1,0
5,142,142,12,2,10,3,2
4,399,399,8,1,7,2,1
1,418,418,16,7,9,2,1
2,466,466,6,6,0,1,0
3,484,484,12,12,0,1,0
6,487,487,98,98,0,1,0

3,139,139,6,6,0,1,0
0,255,255,10,10,0,1,0
4,320,320,64,50,14,2,1
1,356,356,22,22,0,1,0
2,430,430,27,4,23,4,3

0,165,165,34,16,18,4,3
1,438,438,88,55,33,4,3

2,175,175,35,27,8,2,1
1,216,216,28,3,25,2,1
0,472,472,34,34,0,1,0

2,244,244,30,30,0,1,0
3,277,277,56,56,0,1,0
1,348,348,25,25,0,1,0
0,484,484,4,4,0,1,0

0,197,197,7,7,0,1,0
2,303,303,1,1,0,1,0
3,337,337,29,15,14,4,3
4,380,380,11,11,0,1,0
1,396,396,19,1,18,3,2
5,409,409,82,79,3,2,1

3,105,105,11,5,6,3,2
2,117,117,3,3,0,1,0
0,141,141,1,1,0,1,0
4,161,161,5,5,0,1,0
1,169,169,3,3,0,1,0
5,265,265,4,1,3,2,1
6,394,394,79,19,60,4,3

3,341,341,69,16,53,3,2
2,455,455,63,32,31,2,1
0,460,460,4,4,0,1,0
1,484,484,26,26,0,1,0

1,174,174,10,10,0,1,0
0,205,205,30,9,21,2,1
2,481,481,97,97,0,1,0

0,135,135,27,18,9,4,3
1,286,286,58,12,46,3,2

1,134,134,10,6,4,2,1
3,158,158,9,4,5,2,1
2,203,203,2,2,0,1,0
4,250,250,6,6,0,1,0
5,314,314,63,63,0,1,0
0,439,439,16,16,0,1,0

2,168,168,19,4,15,2,1
1,215,215,14,10,4,2,1
0,221,221,6,6,0,1,0
3,458,458,92,78,14,3,2

3,121,121,25,25,0,1,0
1,167,167,6,2,4,2,1
2,187,187,23,23,0,1,0
0,297,297,13,1,12,4,3

4,222,222,45,45,0,1,0
0,363,363,41,41,0,1,0
1,404,404,18,18,0,1,0
2,421,421,3,3,0,1,0
3,497,497,18,8,10,2,1

0,281,281,10,1,9,4,3
1,293,293,49,3,46,2,1
2,485,485,97,22,75,4,3

4,132,132,27,1,26,3,2
2,260,260,1,1,0,1,0
3,295,295,11,11,0,1,0
1,387,387,16,16,0,1,0
0,470,470,56,47,9,2,1

2,123,123,1,1,0,1,0
3,148,148,10,2,8,2,1
4,200,200,40,40,0,1,0
0,483,483,19,8,11,2,1
1,499,499,43,1,42,3,2

1,185,185,37,37,0,1,0
0,446,446,90,30,60,3,2

0,249,249,11,2,9,4,3
3,299,299,60,60,0,1,0
1,306,306,1,1,0,1,0
2,454,454,70,1,69,4,3

2,332,332,67,39,28,2,1
0,418,418,24,24,0,1,0
1,452,452,65,65,0,1,0

0,272,272,1,1,0,1,0
1,445,445,22,2,20,3,2
2,463,463,69,48,21,2,1
3,483,483,97,61,36,3,2

3,169,169,10,10,0,1,0
4,320,320,64,28,36,4,3
0,337,337,8,8,0,1,0
1,440,440,35,35,0,1,0
2,445,445,19,4,15,2,1

4,126,126,26,17,9,4,3
1,213,213,6,1,5,2,1
0,231,231,10,10,0,1,0
3,357,357,25,3,22,3,2
2,497,497,30,30,0,1,0

4,180,180,36,36,0,1,0
0,226,226,12,12,0,1,0
1,288,288,18,5,13,2,1
3,477,477,23,3,20,3,2
2,479,479,18,18,0,1,0

1,249,249,9,9,0,1,0
2,298,298,47,47,0,1,0
3,361,361,73,69,4,2,1
0,409,409,3,3,0,1,0

3,135,135,27,27,0,1,0
2,238,238,31,31,0,1,0
1,333,333,19,19,0,1,0
0,488,488,7,7,0,1,0

1,278,278,30,24,6,3,2
2,416,416,84,84,0,1,0
0,431,431,40,40,0,1,0

0,104,104,6,6,0,1,0
3,307,307,18,18,0,1,0
2,392,392,32,20,12,3,2
4,450,450,90,86,4,2,1
1,483,483,1,1,0,1,0

1,132,132,1,1,0,1,0
2,204,204,27,4,23,2,1
4,291,291,59,59,0,1,0
3,293,293,6,6,0,1,0
0,400,400,17,17,0,1,0

0,163,163,1,1,0,1,0
3,217,217,44,12,32,2,1
1,277,277,1,1,0,1,0
2,453,453,87,87,0,1,0

0,130,130,18,18,0,1,0
2,223,223,45,5,40,2,1
1,331,331,21,21,0,1,0

0,291,291,59,39,20,3,2
1,451,451,91,45,46,3,2

1,303,303,50,4,46,2,1
0,378,378,14,14,0,1,0
2,482,482,97,43,54,3,2

1,179,179,3,3,0,1,0
3,272,272,55,55,0,1,0
0,310,310,38,7,31,2,1
2,358,358,22,12,10,2,1

3,126,126,26,20,6,2,1
1,171,171,22,22,0,1,0
0,355,355,23,23,0,1,0
2,451,451,3,3,0,1,0

0,129,129,6,6,0,1,0
4,137,137,2,2,0,1,0
3,187,187,1,1,0,1,0
6,250,250,1,1,0,1,0
2,288,288,12,3,9,4,3
7,308,308,62,62,0,1,0
5,418,418,28,28,0,1,0
1,424,424,10,10,0,1,0

2,364,364,73,31,42,4,3
1,472,472,91,91,0,1,0
0,488,488,4,1,3,2,1

2,113,113,15,15,0,1,0
1,265,265,14,5,9,2,1
3,326,326,66,66,0,1,0
0,489,489,8,8,0,1,0

2,184,184,37,12,25,2,1
0,377,377,21,21,0,1,0
1,492,492,71,24,47,3,2

0,268,268,38,5,33,2,1
2,319,319,64,36,28,2,1
1,431,431,26,8,18,4,3

3,385,385,77,25,52,3,2
2,403,403,15,15,0,1,0
1,413,413,48,41,7,2,1
0,435,435,21,12,9,4,3

0,245,245,4,4,0,1,0
1,370,370,68,45,23,3,2
2,436,436,88,41,47,4,3

2,406,406,82,74,8,2,1
0,450,450,19,7,12,2,1
1,455,455,72,72,0,1,0

0,119,119,1,1,0,1,0
2,158,158,13,13,0,1,0
6,231,231,47,47,0,1,0
3,343,343,11,11,0,1,0
1,391,391,5,1,4,2,1
4,427,427,8,1,7,2,1
5,474,474,22,22,0,1,0

2,172,172,1,1,0,1,0
5,200,200,40,40,0,1,0
4,290,290,3,3,0,1,0
0,328,328,28,3,25,2,1
1,387,387,13,5,8,2,1
3,425,425,28,28,0,1,0

1,182,182,1,1,0,1,0
2,254,254,51,30,21,4,3
0,490,490,97,77,20,3,2

1,146,146,5,5,0,1,0
2,231,231,33,9,24,2,1
3,296,296,60,60,0,1,0
0,302,302,8,8,0,1,0

0,276,276,56,44,12,2,1
1,456,456,92,92,0,1,0

5,122,122,1,1,0,1,0
2,123,123,2,2,0,1,0
7,196,196,1,1,0,1,0
6,206,206,2,2,0,1,0
3,210,210,5,5,0,1,0
4,268,268,8,2,6,3,2
0,272,272,11,11,0,1,0
8,384,384,77,77,0,1,0
1,468,468,33,33,0,1,0

3,199,199,20,20,0,1,0
2,202,202,9,9,0,1,0
1,255,255,6,1,5,2,1
4,262,262,53,47,6,3,2
0,278,278,9,3,6,2,1

2,290,290,58,21,37,2,1
1,374,374,33,22,11,2,1
0,494,494,56,18,38,3,2

0,109,109,6,6,0,1,0
4,115,115,1,1,0,1,0
6,153,153,31,16,15,4,3
1,189,189,3,3,0,1,0
5,282,282,9,2,7,3,2
3,291,291,8,8,0,1,0
2,467,467,29,14,15,4,3

0,179,179,36,30,6,2,1
1,458,458,92,21,71,4,3

1,239,239,11,11,0,1,0
0,376,376,52,4,48,2,1
2,481,481,8,2,6,2,1
3,493,493,99,78,21,2,1

1,178,178,14,14,0,1,0
2,258,258,52,40,12,3,2
0,374,374,47,47,0,1,0

3,216,216,7,7,0,1,0
2,260,260,26,21,5,2,1
0,366,366,17,8,9,2,1
4,444,444,89,73,16,2,1
1,462,462,10,3,7,2,1

0,123,123,25,19,6,2,1
1,412,412,83,83,0,1,0

0,151,151,13,13,0,1,0
2,435,435,87,87,0,1,0
1,484,484,56,56,0,1,0

0,118,118,6,2,4,2,1
2,171,171,35,4,31,2,1
1,299,299,45,27,18,2,1

3,127,127,4,4,0,1,0
4,171,171,35,35,0,1,0
2,235,235,23,23,0,1,0
0,320,320,22,7,15,4,3
1,361,361,1,1,0,1,0

0,181,181,13,1,12,3,2
5,184,184,37,3,34,3,2
2,275,275,10,10,0,1,0
3,345,345,2,2,0,1,0
1,406,406,12,3,9,4,3
4,481,481,28,4,24,3,2

0,178,178,3,3,0,1,0
3,212,212,17,17,0,1,0
4,234,234,18,18,0,1,0
1,239,239,5,5,0,1,0
5,300,300,60,10,50,2,1
2,450,450,3,3,0,1,0

2,160,160,8,8,0,1,0
1,194,194,23,23,0,1,0
3,209,209,42,17,25,2,1
0,464,464,16,3,13,2,1

1,157,157,14,7,7,2,1
2,231,231,14,5,9,4,3
0,274,274,14,14,0,1,0
3,397,397,80,22,58,4,3

0,105,105,7,3,4,2,1
2,179,179,9,1,8,3,2
1,328,328,28,28,0,1,0
3,487,487,98,98,0,1,0

1,176,176,27,27,0,1,0
2,190,190,38,38,0,1,0
0,236,236,12,12,0,1,0

0,209,209,42,3,39,2,1
1,436,436,88,50,38,3,2

1,393,393,79,34,45,4,3
0,412,412,83,38,45,4,3

1,252,252,29,2,27,4,3
2,293,293,59,21,38,3,2
0,441,441,39,6,33,4,3

1,285,285,57,39,18,2,1
0,303,303,61,61,0,1,0

2,304,304,27,15,12,2,1
0,340,340,2,2,0,1,0
3,409,409,82,57,25,2,1
1,426,426,45,45,0,1,0

1,248,248,1,1,0,1,0
0,366,366,72,23,49,2,1
2,367,367,74,10,64,3,2

3,157,157,1,1,0,1,0
5,195,195,3,3,0,1,0
2,222,222,7,7,0,1,0
6,317,317,64,48,16,2,1
0,337,337,7,7,0,1,0
1,402,402,51,51,0,1,0
4,432,432,1,1,0,1,0

2,275,275,55,27,28,3,2
0,288,288,36,36,0,1,0
1,454,454,35,35,0,1,0

3,110,110,15,15,0,1,0
1,261,261,5,5,0,1,0
4,319,319,64,64,0,1,0
0,330,330,2,2,0,1,0
2,461,461,20,20,0,1,0

5,158,158,3,3,0,1,0
7,187,187,38,38,0,1,0
1,287,287,7,1,6,2,1
2,325,325,2,2,0,1,0
4,369,369,4,4,0,1,0
0,392,392,41,41,0,1,0
6,419,419,9,9,0,1,0
3,488,488,7,7,0,1,0

4,120,120,9,9,0,1,0
3,169,169,4,4,0,1,0
2,192,192,1,1,0,1,0
5,246,246,50,5,45,4,3
0,288,288,16,16,0,1,0
1,440,440,20,2,18,4,3

1,130,130,12,12,0,1,0
2,209,209,42,7,35,4,3
0,436,436,48,48,0,1,0

3,276,276,56,56,0,1,0
0,303,303,31,1,30,4,3
2,406,406,38,38,0,1,0
1,412,412,2,2,0,1,0

2,100,100,1,1,0,1,0
3,300,300,30,30,0,1,0
0,448,448,21,4,17,2,1
1,465,465,21,21,0,1,0
4,495,495,99,18,81,4,3

5,110,110,2,2,0,1,0
2,198,198,4,1,3,2,1
0,225,225,4,4,0,1,0
7,275,275,9,3,6,2,1
6,285,285,15,15,0,1,0
3,288,288,3,3,0,1,0
4,319,319,8,2,6,2,1
8,430,430,86,35,51,4,3
1,484,484,12,1,11,4,3

3,107,107,1,1,0,1,0
0,181,181,7,1,6,2,1
4,262,262,53,24,29,2,1
1,371,371,41,41,0,1,0
2,476,476,21,3,18,2,1

2,134,134,1,1,0,1,0
3,150,150,10,1,9,2,1
4,234,234,47,8,39,4,3
1,274,274,10,10,0,1,0
0,381,381,35,3,32,2,1

1,137,137,28,28,0,1,0
0,415,415,84,52,32,2,1

1,151,151,31,31,0,1,0
0,206,206,42,22,20,2,1

2,105,105,8,8,0,1,0
3,274,274,3,3,0,1,0
1,358,358,5,5,0,1,0
4,377,377,76,56,20,2,1
0,411,411,42,42,0,1,0

1,182,182,1,1,0,1,0
6,212,212,43,43,0,1,0
0,214,214,19,19,0,1,0
5,240,240,1,1,0,1,0
4,365,365,28,28,0,1,0
3,409,409,4,4,0,1,0
2,497,497,8,8,0,1,0

0,205,205,42,2,40,3,2
1,232,232,47,47,0,1,0

0,143,143,3,3,0,1,0
4,190,190,38,30,8,2,1
1,212,212,8,8,0,1,0
3,219,219,25,4,21,4,3
2,234,234,7,7,0,1,0

0,229,229,1,1,0,1,0
5,280,280,21,3,18,4,3
4,328,328,22,8,14,2,1
3,362,362,8,4,4,2,1
1,423,423,1,1,0,1,0
2,463,463,15,15,0,1,0
6,495,495,99,99,0,1,0

2,120,120,6,6,0,1,0
5,177,177,36,36,0,1,0
3,190,190,8,1,7,2,1
0,195,195,16,16,0,1,0
1,255,255,5,1,4,2,1
4,328,328,3,3,0,1,0

5,113,113,23,9,14,3,2
2,193,193,2,2,0,1,0
1,201,201,1,1,0,1,0
3,208,208,16,16,0,1,0
4,395,395,5,5,0,1,0
0,500,500,48,48,0,1,0

1,165,165,3,3,0,1,0
3,250,250,7,7,0,1,0
4,408,408,82,4,78,3,2
0,419,419,10,3,7,2,1
2,454,454,60,32,28,3,2

4,107,107,22,22,0,1,0
1,132,132,3,3,0,1,0
3,187,187,1,1,0,1,0
0,188,188,24,24,0,1,0
2,492,492,22,22,0,1,0

3,210,210,42,24,18,3,2
0,252,252,34,22,12,3,2
1,327,327,3,3,0,1,0
2,412,412,24,10,14,2,1

0,158,158,7,7,0,1,0
3,177,177,8,8,0,1,0
1,258,258,4,4,0,1,0
4,326,326,66,26,40,2,1
2,344,344,34,34,0,1,0

1,182,182,19,19,0,1,0
2,217,217,44,44,0,1,0
0,409,409,40,1,39,4,3

1,267,267,7,7,0,1,0
2,335,335,67,29,38,2,1
0,356,356,62,53,9,2,1

1,130,130,13,13,0,1,0
2,342,342,69,69,0,1,0
0,463,463,48,48,0,1,0

3,163,163,15,15,0,1,0
2,204,204,1,1,0,1,0
4,226,226,46,11,35,2,1
0,478,478,7,7,0,1,0
1,481,481,45,17,28,2,1

2,264,264,53,53,0,1,0
1,344,344,11,11,0,1,0
0,363,363,62,2,60,3,2

1,231,231,5,5,0,1,0
2,345,345,20,5,15,4,3
0,397,397,48,6,42,2,1
3,410,410,82,61,21,2,1

2,168,168,2,2,0,1,0
4,229,229,46,46,0,1,0
3,273,273,28,6,22,3,2
1,331,331,10,10,0,1,0
0,458,458,27,27,0,1,0

2,164,164,24,24,0,1,0
3,214,214,43,43,0,1,0
1,270,270,10,10,0,1,0
0,340,340,6,6,0,1,0

1,141,141,14,14,0,1,0
0,241,241,24,12,12,3,2
2,368,368,1,1,0,1,0
3,384,384,77,43,34,2,1

0,156,156,2,2,0,1,0
3,304,304,61,19,42,2,1
2,362,362,12,2,10,3,2
1,465,465,72,29,43,4,3

2,104,104,1,1,0,1,0
3,240,240,4,4,0,1,0
4,279,279,12,4,8,3,2
5,324,324,65,20,45,2,1
0,386,386,10,10,0,1,0
1,463,463,49,49,0,1,0

0,144,144,1,1,0,1,0
2,239,239,11,3,8,3,2
4,338,338,14,3,11,2,1
1,347,347,27,27,0,1,0
5,450,450,90,90,0,1,0
3,480,480,14,14,0,1,0

2,117,117,8,8,0,1,0
3,178,178,2,2,0,1,0
5,207,207,7,7,0,1,0
0,239,239,1,1,0,1,0
6,335,335,1,1,0,1,0
4,364,364,2,2,0,1,0
7,456,456,92,92,0,1,0
1,496,496,38,16,22,3,2

2,119,119,24,17,7,2,1
0,268,268,24,6,18,3,2
1,430,430,48,36,12,3,2

0,146,146,16,16,0,1,0
3,333,333,67,27,40,3,2
1,384,384,18,9,9,4,3
2,402,402,18,3,15,3,2

0,121,121,16,4,12,4,3
3,207,207,42,28,14,2,1
1,288,288,5,5,0,1,0
2,489,489,25,3,22,3,2

3,126,126,26,26,0,1,0
2,148,148,8,8,0,1,0
1,279,279,4,4,0,1,0
0,392,392,53,53,0,1,0

0,211,211,43,43,0,1,0
1,479,479,96,34,62,3,2

1,344,344,69,39,30,4,3
0,479,479,96,73,23,2,1

0,264,264,6,6,0,1,0
2,273,273,55,43,12,4,3
1,381,381,68,44,24,4,3

2,256,256,10,3,7,2,1
3,375,375,75,75,0,1,0
0,421,421,22,2,20,2,1
1,444,444,49,49,0,1,0

0,324,324,65,17,48,4,3
1,397,397,80,47,33,2,1

1,399,399,28,28,0,1,0
2,431,431,87,46,41,2,1
0,483,483,63,42,21,4,3

5,136,136,28,1,27,3,2
1,240,240,3,3,0,1,0
0,275,275,8,8,0,1,0
4,363,363,10,10,0,1,0
3,407,407,41,41,0,1,0
2,438,438,14,4,10,2,1

2,144,144,5,5,0,1,0
0,156,156,14,14,0,1,0
1,278,278,22,10,12,4,3
3,282,282,57,15,42,2,1

2,161,161,15,15,0,1,0
3,166,166,34,4,30,3,2
1,258,258,18,18,0,1,0
0,293,293,11,5,6,2,1

0,139,139,22,22,0,1,0
1,429,429,16,6,10,2,1
3,489,489,98,16,82,3,2
2,499,499,3,3,0,1,0

1,304,304,61,61,0,1,0
0,311,311,63,63,0,1,0

0,106,106,3,3,0,1,0
3,181,181,37,37,0,1,0
1,365,365,50,50,0,1,0
2,433,433,16,16,0,1,0

0,140,140,6,6,0,1,0
3,253,253,23,23,0,1,0
1,426,426,25,25,0,1,0
4,476,476,96,77,19,2,1
2,483,483,4,4,0,1,0

2,169,169,1,1,0,1,0
1,182,182,3,3,0,1,0
4,211,211,12,12,0,1,0
3,308,308,5,5,0,1,0
5,398,398,41,22,19,2,1
6,442,442,89,11,78,3,2
0,464,464,1,1,0,1,0

2,136,136,6,6,0,1,0
5,227,227,46,11,35,2,1
1,261,261,18,4,14,2,1
4,307,307,17,9,8,2,1
3,371,371,1,1,0,1,0
0,409,409,12,12,0,1,0

2,185,185,1,1,0,1,0
4,246,246,50,30,20,3,2
3,249,249,2,2,0,1,0
1,276,276,27,27,0,1,0
0,423,423,38,38,0,1,0

4,106,106,1,1,0,1,0
2,171,171,2,2,0,1,0
0,176,176,1,1,0,1,0
1,225,225,3,3,0,1,0
5,282,282,6,6,0,1,0
6,313,313,63,33,30,4,3
3,442,442,62,40,22,2,1

0,210,210,20,20,0,1,0
2,218,218,10,10,0,1,0
1,372,372,23,23,0,1,0
3,392,392,79,79,0,1,0

2,106,106,22,16,6,3,2
0,332,332,1,1,0,1,0
1,393,393,78,78,0,1,0

0,115,115,4,1,3,2,1
3,132,132,27,6,21,4,3
1,253,253,13,13,0,1,0
2,373,373,43,8,35,4,3

0,270,270,26,26,0,1,0
1,419,419,18,18,0,1,0
3,476,476,96,96,0,1,0
2,495,495,31,15,16,2,1

0,118,118,15,8,7,2,1
2,214,214,43,16,27,4,3
1,280,280,21,21,0,1,0

0,191,191,1,1,0,1,0
1,203,203,12,12,0,1,0
2,273,273,38,38,0,1,0
3,407,407,82,55,27,4,3

1,120,120,8,8,0,1,0
2,302,302,33,12,21,4,3
0,344,344,1,1,0,1,0
3,459,459,10,3,7,2,1
4,483,483,97,39,58,3,2

2,336,336,68,68,0,1,0
1,362,362,25,25,0,1,0
0,467,467,62,36,26,3,2

2,151,151,31,3,28,3,2
0,243,243,10,10,0,1,0
1,450,450,72,46,26,2,1

5,152,152,31,31,0,1,0
1,231,231,2,2,0,1,0
3,431,431,12,12,0,1,0
0,440,440,59,1,58,4,3
4,458,458,2,2,0,1,0
2,491,491,13,2,11,3,2

1,221,221,45,31,14,2,1
0,368,368,74,35,39,2,1

2,124,124,25,10,15,2,1
0,153,153,7,3,4,2,1
1,488,488,76,49,27,2,1

2,161,161,4,4,0,1,0
0,201,201,1,1,0,1,0
3,227,227,46,26,20,2,1
1,275,275,48,48,0,1,0

0,234,234,14,14,0,1,0
1,234,234,10,10,0,1,0
3,289,289,58,58,0,1,0
2,422,422,42,28,14,2,1

0,386,386,78,78,0,1,0
1,417,417,84,84,0,1,0

1,143,143,29,29,0,1,0
0,207,207,42,18,24,3,2

1,118,118,2,2,0,1,0
5,346,346,70,42,28,2,1
4,407,407,20,1,19,2,1
3,448,448,47,47,0,1,0
0,466,466,11,8,3,2,1
2,481,481,3,3,0,1,0

3,236,236,3,3,0,1,0
4,322,322,22,22,0,1,0
0,372,372,33,19,14,3,2
5,411,411,83,41,42,4,3
1,416,416,1,1,0,1,0
2,456,456,13,13,0,1,0

5,100,100,20,20,0,1,0
1,150,150,1,1,0,1,0
0,216,216,6,6,0,1,0
2,321,321,48,19,29,2,1
4,365,365,3,3,0,1,0
3,482,482,4,4,0,1,0

0,374,374,75,75,0,1,0
1,424,424,85,33,52,3,2

2,164,164,33,26,7,2,1
1,438,438,71,71,0,1,0
0,448,448,17,17,0,1,0

1,189,189,7,7,0,1,0
5,228,228,4,1,3,2,1
2,229,229,11,11,0,1,0
3,258,258,4,4,0,1,0
4,309,309,13,7,6,3,2
0,359,359,15,15,0,1,0
6,497,497,100,16,84,3,2

1,157,157,5,5,0,1,0
0,267,267,26,26,0,1,0
3,270,270,54,54,0,1,0
2,327,327,24,24,0,1,0

0,108,108,13,10,3,2,1
2,279,279,5,5,0,1,0
1,295,295,19,19,0,1,0
3,369,369,74,74,0,1,0

2,242,242,49,9,40,3,2
0,268,268,39,13,26,2,1
1,468,468,26,26,0,1,0

2,214,214,43,43,0,1,0
1,255,255,44,34,10,2,1
0,428,428,12,12,0,1,0

2,201,201,41,41,0,1,0
1,391,391,52,28,24,3,2
0,432,432,29,14,15,4,3

3,142,142,29,3,26,2,1
1,207,207,9,9,0,1,0
2,284,284,11,11,0,1,0
0,292,292,35,9,26,3,2

0,125,125,1,1,0,1,0
3,249,249,1,1,0,1,0
4,285,285,57,57,0,1,0
2,317,317,21,4,17,2,1
1,422,422,53,28,25,2,1

2,112,112,1,1,0,1,0
0,193,193,28,28,0,1,0
1,300,300,8,8,0,1,0
3,383,383,8,3,5,2,1
4,387,387,78,72,6,3,2

0,138,138,2,2,0,1,0
2,232,232,5,5,0,1,0
3,242,242,49,49,0,1,0
1,248,248,41,41,0,1,0

0,124,124,2,2,0,1,0
1,259,259,48,48,0,1,0
2,480,480,96,40,56,3,2

1,209,209,17,1,16,3,2
2,224,224,5,2,3,2,1
5,326,326,66,43,23,2,1
4,384,384,2,2,0,1,0
3,448,448,36,6,30,4,3
0,457,457,6,6,0,1,0

0,176,176,13,1,12,3,2
3,187,187,10,7,3,2,1
5,206,206,42,12,30,2,1
1,213,213,9,9,0,1,0
4,215,215,1,1,0,1,0
2,309,309,8,8,0,1,0

1,189,189,19,19,0,1,0
5,205,205,41,3,38,4,3
0,209,209,5,5,0,1,0
4,257,257,10,10,0,1,0
3,400,400,12,12,0,1,0
2,413,413,4,4,0,1,0

1,317,317,46,46,0,1,0
2,377,377,76,30,46,3,2
0,484,484,28,28,0,1,0

0,142,142,6,6,0,1,0
3,285,285,57,57,0,1,0
2,414,414,42,16,26,2,1
1,450,450,26,1,25,2,1

8,103,103,3,3,0,1,0
9,181,181,1,1,0,1,0
1,262,262,4,1,3,2,1
7,262,262,2,2,0,1,0
5,269,269,2,2,0,1,0
0,285,285,4,4,0,1,0
3,292,292,1,1,0,1,0
4,310,310,1,1,0,1,0
11,346,346,70,30,40,2,1
2,403,403,18,15,3,2,1
6,442,442,15,10,5,2,1
10,461,461,17,17,0,1,0

3,128,128,26,26,0,1,0
1,167,167,26,26,0,1,0
2,196,196,9,2,7,2,1
0,296,296,1,1,0,1,0

1,154,154,16,16,0,1,0
0,237,237,19,19,0,1,0
2,255,255,5,1,4,2,1
3,417,417,84,84,0,1,0

1,201,201,14,14,0,1,0
0,477,477,63,21,42,4,3
2,499,499,100,86,14,4,3

2,208,208,34,34,0,1,0
1,299,299,8,8,0,1,0
0,350,350,4,4,0,1,0
3,403,403,81,81,0,1,0

0,222,222,43,1,42,3,2
1,397,397,3,3,0,1,0
2,406,406,82,82,0,1,0

4,196,196,40,12,28,4,3
2,229,229,18,8,10,2,1
0,429,429,6,6,0,1,0
3,432,432,28,28,0,1,0
1,470,470,21,6,15,4,3

1,305,305,61,4,57,4,3
0,443,443,89,50,39,2,1

4,121,121,25,25,0,1,0
3,226,226,7,7,0,1,0
2,300,300,10,10,0,1,0
0,439,439,47,11,36,2,1
1,498,498,15,15,0,1,0

0,139,139,9,1,8,2,1
5,197,197,40,40,0,1,0
2,239,239,5,5,0,1,0
4,287,287,18,7,11,2,1
3,360,360,13,10,3,2,1
1,433,433,8,8,0,1,0

0,187,187,1,1,0,1,0
4,223,223,45,17,28,3,2
1,294,294,38,5,33,4,3
3,360,360,16,2,14,3,2
2,464,464,11,11,0,1,0

1,288,288,38,18,20,3,2
0,379,379,27,22,5,2,1
2,429,429,86,44,42,4,3

0,192,192,29,29,0,1,0
1,260,260,13,3,10,2,1
2,405,405,81,81,0,1,0

3,175,175,14,14,0,1,0
2,252,252,12,12,0,1,0
1,304,304,9,9,0,1,0
0,409,409,19,7,12,4,3
4,440,440,88,88,0,1,0

2,216,216,36,36,0,1,0
0,221,221,1,1,0,1,0
1,412,412,13,13,0,1,0
3,449,449,90,9,81,4,3

6,155,155,31,22,9,4,3
5,293,293,11,6,5,2,1
1,295,295,4,4,0,1,0
4,390,390,24,24,0,1,0
3,434,434,4,4,0,1,0
2,435,435,8,8,0,1,0
0,481,481,30,25,5,2,1

2,128,128,26,26,0,1,0
0,162,162,15,1,14,3,2
1,167,167,18,2,16,3,2

4,148,148,30,6,24,2,1
0,171,171,5,5,0,1,0
3,302,302,4,4,0,1,0
2,320,320,45,45,0,1,0
1,461,461,8,8,0,1,0

1,295,295,59,59,0,1,0
0,438,438,88,54,34,3,2

1,187,187,33,19,14,4,3
2,253,253,51,51,0,1,0
0,457,457,12,6,6,2,1

0,156,156,1,1,0,1,0
1,174,174,19,8,11,2,1
2,270,270,23,1,22,2,1
3,332,332,67,25,42,4,3

2,201,201,41,41,0,1,0
0,265,265,10,1,9,4,3
1,341,341,56,2,54,4,3

3,138,138,4,1,3,2,1
0,241,241,26,26,0,1,0
1,266,266,15,7,8,3,2
2,319,319,4,4,0,1,0
4,360,360,72,72,0,1,0

4,184,184,2,2,0,1,0
1,218,218,5,1,4,2,1
5,298,298,60,60,0,1,0
2,407,407,4,4,0,1,0
0,447,447,51,51,0,1,0
3,462,462,20,3,17,2,1

1,429,429,86,44,42,3,2
0,461,461,93,1,92,4,3

0,124,124,3,3,0,1,0
2,187,187,38,12,26,2,1
1,495,495,88,41,47,2,1

1,195,195,5,5,0,1,0
0,381,381,68,8,60,4,3
2,449,449,90,90,0,1,0

1,185,185,20,20,0,1,0
0,280,280,27,27,0,1,0
2,423,423,85,49,36,4,3

0,126,126,1,1,0,1,0
3,167,167,20,20,0,1,0
2,213,213,1,1,0,1,0
4,359,359,6,1,5,2,1
5,458,458,92,92,0,1,0
1,459,459,24,24,0,1,0

4,182,182,37,37,0,1,0
1,205,205,26,26,0,1,0
0,291,291,6,6,0,1,0
3,341,341,5,1,4,2,1
2,468,468,18,18,0,1,0

2,112,112,1,1,0,1,0
6,113,113,23,17,6,2,1
4,154,154,17,17,0,1,0
1,341,341,6,1,5,2,1
5,415,415,4,4,0,1,0
0,432,432,12,1,11,2,1
3,481,481,13,13,0,1,0

2,109,109,22,1,21,2,1
1,339,339,8,8,0,1,0
0,392,392,70,70,0,1,0

1,188,188,22,22,0,1,0
3,205,205,41,25,16,3,2
2,380,380,3,3,0,1,0
0,407,407,31,31,0,1,0

3,316,316,64,37,27,2,1
2,318,318,18,4,14,3,2
0,331,331,40,4,36,2,1
1,348,348,8,8,0,1,0

1,151,151,11,7,4,2,1
0,234,234,23,23,0,1,0
2,284,284,9,4,5,2,1
3,350,350,70,70,0,1,0

0,169,169,1,1,0,1,0
5,277,277,56,14,42,2,1
2,302,302,9,6,3,2,1
1,309,309,2,2,0,1,0
3,425,425,18,4,14,2,1
4,440,440,51,51,0,1,0

1,479,479,96,81,15,2,1
0,494,494,99,99,0,1,0

2,132,132,17,17,0,1,0
3,172,172,1,1,0,1,0
0,236,236,3,3,0,1,0
4,445,445,89,86,3,2,1
1,480,480,26,18,8,3,2

0,455,455,91,85,6,3,2
1,462,462,93,39,54,4,3

4,174,174,35,2,33,2,1
2,251,251,15,15,0,1,0
1,264,264,6,6,0,1,0
3,320,320,34,34,0,1,0
0,457,457,6,6,0,1,0

3,107,107,1,1,0,1,0
0,253,253,20,15,5,2,1
1,361,361,12,2,10,3,2
2,407,407,5,1,4,2,1
4,447,447,30,9,21,4,3
5,463,463,93,93,0,1,0

2,159,159,31,31,0,1,0
1,180,180,1,1,0,1,0
3,241,241,49,21,28,4,3
0,500,500,2,2,0,1,0

0,355,355,72,61,11,2,1
1,405,405,81,81,0,1,0

2,154,154,31,31,0,1,0
0,336,336,37,20,17,2,1
1,377,377,34,34,0,1,0

1,362,362,57,57,0,1,0
2,421,421,85,58,27,4,3
0,498,498,22,10,12,4,3

1,171,171,1,1,0,1,0
3,182,182,37,37,0,1,0
2,448,448,87,9,78,3,2
0,470,470,1,1,0,1,0

1,126,126,2,2,0,1,0
2,135,135,7,2,5,2,1
0,427,427,59,18,41,2,1
3,455,455,91,91,0,1,0

2,159,159,4,4,0,1,0
0,254,254,41,41,0,1,0
3,485,485,97,97,0,1,0
1,490,490,7,7,0,1,0

1,107,107,12,12,0,1,0
3,385,385,77,17,60,4,3
2,418,418,15,5,10,3,2
0,498,498,26,8,18,3,2

2,182,182,18,2,16,3,2
3,197,197,40,40,0,1,0
1,407,407,10,1,9,2,1
0,454,454,37,2,35,2,1

2,139,139,28,28,0,1,0
1,282,282,31,31,0,1,0
0,363,363,33,33,0,1,0

1,118,118,1,1,0,1,0
0,219,219,14,14,0,1,0
2,240,240,1,1,0,1,0
6,359,359,72,72,0,1,0
3,389,389,32,16,16,2,1
5,400,400,13,2,11,2,1
4,439,439,4,4,0,1,0

2,156,156,32,18,14,3,2
0,358,358,7,3,4,2,1
1,398,398,72,72,0,1,0

2,132,132,27,17,10,3,2
0,345,345,48,11,37,4,3
1,378,378,24,6,18,4,3

4,139,139,28,28,0,1,0
3,157,157,11,3,8,3,2
2,174,174,1,1,0,1,0
1,438,438,11,11,0,1,0
0,447,447,45,45,0,1,0

3,152,152,9,3,6,2,1
4,199,199,40,1,39,4,3
0,372,372,44,12,32,2,1
1,411,411,1,1,0,1,0
2,494,494,12,12,0,1,0

3,110,110,1,1,0,1,0
2,150,150,20,20,0,1,0
1,173,173,2,2,0,1,0
0,256,256,14,7,7,2,1
4,394,394,79,31,48,3,2

2,173,173,35,35,0,1,0
1,216,216,2,2,0,1,0
0,352,352,68,27,41,2,1

4,103,103,21,21,0,1,0
2,396,396,57,57,0,1,0
1,441,441,9,5,4,2,1
3,477,477,10,10,0,1,0
0,494,494,8,1,7,2,1

0,166,166,11,11,0,1,0
2,233,233,7,7,0,1,0
3,305,305,61,61,0,1,0
1,379,379,40,40,0,1,0

3,149,149,10,6,4,2,1
0,166,166,16,2,14,3,2
4,172,172,35,24,11,2,1
2,339,339,13,2,11,2,1
1,436,436,2,2,0,1,0

3,196,196,40,40,0,1,0
0,257,257,10,10,0,1,0
1,292,292,29,5,24,4,3
2,356,356,22,13,9,2,1

0,228,228,20,20,0,1,0
2,306,306,62,62,0,1,0
1,421,421,48,48,0,1,0

2,107,107,22,8,14,3,2
1,191,191,2,2,0,1,0
0,434,434,83,83,0,1,0

0,109,109,1,1,0,1,0
3,162,162,33,33,0,1,0
2,277,277,15,15,0,1,0
1,483,483,67,67,0,1,0

2,158,158,32,32,0,1,0
0,247,247,10,10,0,1,0
1,419,419,67,28,39,3,2

0,156,156,11,7,4,2,1
3,255,255,51,3,48,3,2
2,309,309,12,12,0,1,0
1,498,498,46,46,0,1,0

1,287,287,3,3,0,1,0
2,291,291,59,59,0,1,0
0,407,407,78,20,58,3,2

4,106,106,22,22,0,1,0
1,147,147,22,22,0,1,0
3,158,158,2,2,0,1,0
0,263,263,8,1,7,2,1
2,470,470,4,4,0,1,0

2,222,222,32,6,26,3,2
1,454,454,11,11,0,1,0
3,471,471,95,8,87,4,3
0,499,499,17,8,9,3,2

1,146,146,30,30,0,1,0
0,372,372,75,56,19,2,1

1,121,121,10,2,8,2,1
3,182,182,7,7,0,1,0
4,305,305,61,17,44,3,2
2,316,316,20,8,12,3,2
0,466,466,8,4,4,2,1

1,227,227,46,46,0,1,0
0,316,316,64,64,0,1,0

3,138,138,28,28,0,1,0
1,387,387,34,8,26,3,2
0,394,394,40,15,25,3,2
2,428,428,5,5,0,1,0

4,124,124,25,25,0,1,0
2,313,313,12,4,8,2,1
0,418,418,3,3,0,1,0
1,439,439,54,15,39,4,3
3,460,460,15,15,0,1,0

1,391,391,79,45,34,3,2
0,470,470,94,26,68,3,2

3,133,133,2,2,0,1,0
4,280,280,56,56,0,1,0
0,375,375,1,1,0,1,0
1,447,447,27,3,24,2,1
2,478,478,60,54,6,3,2

2,112,112,1,1,0,1,0
5,219,219,5,5,0,1,0
1,233,233,4,4,0,1,0
3,313,313,1,1,0,1,0
8,316,316,64,14,50,3,2
7,336,336,2,2,0,1,0
0,360,360,23,8,15,4,3
6,415,415,31,20,11,2,1
4,446,446,2,2,0,1,0

0,166,166,4,4,0,1,0
1,380,380,67,19,48,2,1
2,419,419,84,1,83,4,3

0,341,341,53,53,0,1,0
2,365,365,73,73,0,1,0
1,422,422,19,5,14,3,2

0,215,215,3,3,0,1,0
2,284,284,57,17,40,2,1
1,435,435,81,11,70,3,2

0,161,161,7,1,6,3,2
3,250,250,38,11,27,4,3
2,252,252,1,1,0,1,0
4,276,276,56,56,0,1,0
1,402,402,1,1,0,1,0

0,238,238,48,2,46,2,1
1,427,427,86,86,0,1,0

2,179,179,9,9,0,1,0
0,218,218,29,29,0,1,0
3,470,470,94,85,9,4,3
1,500,500,11,11,0,1,0

1,191,191,3,3,0,1,0
0,289,289,14,9,5,2,1
3,367,367,74,74,0,1,0
2,379,379,52,4,48,3,2

3,210,210,42,38,4,2,1
2,340,340,20,20,0,1,0
1,462,462,45,45,0,1,0
0,497,497,23,3,20,3,2

1,170,170,18,18,0,1,0
0,192,192,6,6,0,1,0
2,201,201,12,12,0,1,0
3,248,248,1,1,0,1,0
4,485,485,97,39,58,4,3

2,179,179,36,36,0,1,0
0,194,194,18,6,12,4,3
1,491,491,53,46,7,2,1

1,197,197,35,3,32,3,2
2,197,197,2,2,0,1,0
0,408,408,6,6,0,1,0
3,444,444,89,89,0,1,0

0,208,208,37,7,30,4,3
2,402,402,81,81,0,1,0
1,481,481,11,2,9,2,1

1,199,199,40,18,22,3,2
0,421,421,85,85,0,1,0

2,111,111,23,2,21,4,3
0,115,115,9,9,0,1,0
1,125,125,16,16,0,1,0

0,201,201,31,16,15,4,3
2,270,270,54,21,33,4,3
1,433,433,20,20,0,1,0

0,283,283,4,4,0,1,0
2,433,433,87,87,0,1,0
1,443,443,83,54,29,2,1

2,152,152,9,9,0,1,0
3,186,186,38,8,30,2,1
0,243,243,15,3,12,3,2
1,453,453,38,14,24,3,2

1,304,304,61,39,22,4,3
0,462,462,93,93,0,1,0

2,169,169,34,34,0,1,0
0,243,243,13,13,0,1,0
1,474,474,70,53,17,2,1

3,121,121,2,2,0,1,0
1,180,180,10,10,0,1,0
0,184,184,11,11,0,1,0
2,235,235,14,14,0,1,0
4,286,286,3,3,0,1,0
5,322,322,65,65,0,1,0

1,225,225,5,5,0,1,0
3,316,316,24,16,8,2,1
2,335,335,28,13,15,2,1
4,339,339,68,68,0,1,0
0,345,345,7,7,0,1,0

0,234,234,21,15,6,3,2
2,334,334,67,22,45,2,1
1,500,500,56,32,24,4,3

2,436,436,88,48,40,2,1
0,440,440,26,26,0,1,0
1,478,478,68,2,66,3,2

1,105,105,5,5,0,1,0
3,134,134,5,5,0,1,0
0,240,240,2,2,0,1,0
4,315,315,24,24,0,1,0
2,342,342,11,11,0,1,0
5,498,498,100,8,92,3,2

2,177,177,36,12,24,3,2
0,296,296,19,19,0,1,0
1,336,336,46,6,40,4,3

5,186,186,38,38,0,1,0
2,385,385,12,12,0,1,0
0,412,412,19,1,18,4,3
1,437,437,26,21,5,2,1
3,440,440,11,11,0,1,0
4,489,489,19,5,14,2,1

1,123,123,4,4,0,1,0
5,244,244,49,22,27,4,3
3,267,267,23,23,0,1,0
0,334,334,19,19,0,1,0
2,384,384,6,6,0,1,0
4,437,437,4,4,0,1,0

0,113,113,23,12,11,2,1
1,235,235,47,4,43,4,3

0,100,100,6,1,5,2,1
1,383,383,44,20,24,3,2
2,468,468,12,8,4,2,1
3,486,486,98,98,0,1,0

3,150,150,7,1,6,2,1
2,211,211,22,15,7,2,1
0,231,231,5,5,0,1,0
4,275,275,55,55,0,1,0
1,465,465,14,14,0,1,0

0,180,180,32,32,0,1,0
1,289,289,7,7,0,1,0
2,301,301,61,51,10,3,2

0,148,148,20,12,8,3,2
1,271,271,18,18,0,1,0
2,473,473,95,70,25,2,1

2,218,218,3,3,0,1,0
3,351,351,42,13,29,2,1
4,352,352,71,71,0,1,0
0,366,366,1,1,0,1,0
1,497,497,32,32,0,1,0

1,152,152,30,30,0,1,0
2,439,439,88,6,82,3,2
0,454,454,4,1,3,2,1

0,145,145,14,2,12,4,3
1,218,218,23,23,0,1,0
2,313,313,63,28,35,2,1

2,139,139,27,18,9,4,3
1,142,142,1,1,0,1,0
0,178,178,1,1,0,1,0
3,439,439,88,18,70,3,2

0,180,180,25,13,12,2,1
2,208,208,42,42,0,1,0
1,222,222,14,2,12,2,1

2,139,139,5,5,0,1,0
4,159,159,32,11,21,4,3
1,214,214,12,12,0,1,0
3,407,407,26,20,6,3,2
0,461,461,21,6,15,4,3

0,157,157,2,2,0,1,0
2,166,166,7,7,0,1,0
4,226,226,16,1,15,4,3
1,229,229,12,12,0,1,0
3,312,312,8,4,4,2,1
5,477,477,96,47,49,2,1

3,101,101,3,3,0,1,0
1,137,137,5,5,0,1,0
2,180,180,22,22,0,1,0
4,239,239,2,2,0,1,0
0,282,282,2,2,0,1,0
5,359,359,72,72,0,1,0

0,235,235,11,8,3,2,1
1,327,327,51,21,30,4,3
2,463,463,93,47,46,4,3

1,110,110,8,1,7,2,1
0,142,142,11,11,0,1,0
2,259,259,13,13,0,1,0
3,265,265,53,50,3,2,1

0,135,135,12,7,5,2,1
2,137,137,28,10,18,2,1
1,491,491,55,55,0,1,0

0,197,197,40,40,0,1,0
1,314,314,63,33,30,3,2

1,162,162,33,1,32,4,3
0,266,266,54,24,30,4,3

4,158,158,32,32,0,1,0
1,346,346,7,1,6,3,2
2,399,399,64,10,54,4,3
0,470,470,4,1,3,2,1
3,481,481,6,6,0,1,0

3,123,123,1,1,0,1,0
0,178,178,2,2,0,1,0
4,306,306,62,62,0,1,0
2,355,355,7,4,3,2,1
1,494,494,82,82,0,1,0

0,258,258,4,4,0,1,0
2,309,309,62,14,48,3,2
1,337,337,63,42,21,4,3

0,187,187,7,7,0,1,0
2,419,419,84,84,0,1,0
1,482,482,79,19,60,4,3

2,158,158,22,22,0,1,0
1,205,205,12,12,0,1,0
3,216,216,44,44,0,1,0
0,410,410,2,2,0,1,0

2,112,112,17,3,14,3,2
3,129,129,26,16,10,3,2
0,132,132,1,1,0,1,0
1,408,408,18,18,0,1,0

4,161,161,33,23,10,3,2
1,215,215,4,4,0,1,0
0,331,331,50,50,0,1,0
3,340,340,7,7,0,1,0
2,403,403,5,1,4,2,1

1,191,191,10,10,0,1,0
0,273,273,41,13,28,4,3
2,355,355,71,43,28,2,1

0,100,100,16,6,10,2,1
1,191,191,8,8,0,1,0
2,239,239,48,48,0,1,0

1,148,148,13,13,0,1,0
3,214,214,43,43,0,1,0
0,306,306,13,13,0,1,0
2,359,359,26,2,24,3,2

2,339,339,68,64,4,2,1
1,357,357,36,33,3,2,1
0,360,360,36,2,34,3,2

2,201,201,11,11,0,1,0
0,320,320,15,6,9,4,3
3,366,366,74,2,72,4,3
1,375,375,38,18,20,2,1

1,245,245,25,25,0,1,0
0,326,326,32,20,12,4,3
2,367,367,74,11,63,4,3

2,131,131,2,2,0,1,0
5,189,189,38,21,17,2,1
0,348,348,30,6,24,4,3
3,409,409,34,34,0,1,0
1,418,418,5,5,0,1,0
4,441,441,2,2,0,1,0

0,140,140,10,5,5,2,1
3,174,174,2,2,0,1,0
2,243,243,27,27,0,1,0
1,332,332,3,3,0,1,0
4,349,349,70,70,0,1,0

0,158,158,16,4,12,4,3
2,228,228,46,13,33,3,2
1,311,311,31,31,0,1,0

0,239,239,7,7,0,1,0
3,352,352,71,65,6,3,2
1,400,400,58,8,50,2,1
2,419,419,11,1,10,3,2

1,409,409,5,5,0,1,0
0,434,434,82,40,42,3,2
2,467,467,94,64,30,3,2

3,123,123,25,20,5,2,1
2,234,234,25,25,0,1,0
0,290,290,1,1,0,1,0
1,407,407,37,37,0,1,0

0,191,191,12,12,0,1,0
1,354,354,49,14,35,4,3
2,378,378,76,10,66,4,3

1,110,110,4,1,3,2,1
2,136,136,12,9,3,2,1
4,150,150,30,30,0,1,0
3,244,244,16,8,8,3,2
0,457,457,6,6,0,1,0

0,139,139,10,1,9,3,2
3,170,170,34,34,0,1,0
1,206,206,15,15,0,1,0
2,438,438,25,25,0,1,0

0,150,150,13,13,0,1,0
1,172,172,20,2,18,4,3
2,327,327,66,66,0,1,0

0,251,251,28,28,0,1,0
1,290,290,26,26,0,1,0
2,325,325,65,65,0,1,0

4,142,142,1,1,0,1,0
3,185,185,11,11,0,1,0
2,340,340,15,15,0,1,0
1,353,353,16,16,0,1,0
0,362,362,17,2,15,4,3
5,366,366,74,35,39,4,3

2,180,180,6,3,3,2,1
1,214,214,1,1,0,1,0
4,236,236,18,18,0,1,0
0,310,310,1,1,0,1,0
5,443,443,89,55,34,4,3
3,496,496,43,17,26,2,1

1,113,113,7,7,0,1,0
2,162,162,33,33,0,1,0
0,454,454,63,63,0,1,0

4,180,180,36,27,9,2,1
3,306,306,2,2,0,1,0
1,311,311,2,2,0,1,0
0,364,364,48,26,22,2,1
2,429,429,25,25,0,1,0

2,123,123,1,1,0,1,0
5,163,163,3,3,0,1,0
0,188,188,17,17,0,1,0
6,221,221,45,17,28,4,3
1,284,284,16,1,15,4,3
4,466,466,3,3,0,1,0
3,476,476,12,2,10,3,2

3,288,288,9,5,4,2,1
6,289,289,58,26,32,3,2
4,300,300,3,3,0,1,0
5,367,367,8,8,0,1,0
0,407,407,20,3,17,2,1
2,431,431,22,22,0,1,0
1,470,470,18,3,15,4,3

2,105,105,2,2,0,1,0
0,157,157,8,1,7,2,1
4,234,234,23,23,0,1,0
3,265,265,6,1,5,2,1
1,284,284,3,3,0,1,0
5,311,311,63,63,0,1,0

0,109,109,1,1,0,1,0
1,175,175,34,34,0,1,0
2,232,232,47,3,44,3,2

3,313,313,63,57,6,3,2
0,379,379,19,8,11,2,1
2,389,389,22,22,0,1,0
1,419,419,40,10,30,3,2

1,297,297,45,45,0,1,0
0,395,395,20,20,0,1,0
2,466,466,94,32,62,4,3

2,159,159,12,12,0,1,0
0,272,272,1,1,0,1,0
4,424,424,85,45,40,3,2
3,455,455,55,20,35,2,1
1,472,472,1,1,0,1,0

1,184,184,29,29,0,1,0
2,241,241,2,2,0,1,0
0,257,257,9,9,0,1,0
3,454,454,91,61,30,4,3

2,106,106,2,2,0,1,0
4,162,162,2,2,0,1,0
0,214,214,6,6,0,1,0
6,244,244,49,17,32,2,1
3,283,283,14,14,0,1,0
5,328,328,16,16,0,1,0
1,496,496,22,22,0,1,0

4,267,267,2,2,0,1,0
2,323,323,9,9,0,1,0
0,332,332,24,24,0,1,0
1,388,388,20,20,0,1,0
3,402,402,17,17,0,1,0
5,455,455,91,49,42,4,3

4,202,202,41,13,28,2,1
2,203,203,12,6,6,2,1
1,334,334,7,1,6,2,1
3,364,364,39,39,0,1,0
0,437,437,6,6,0,1,0

2,252,252,10,10,0,1,0
0,310,310,25,10,15,4,3
3,365,365,16,16,0,1,0
4,407,407,82,54,28,3,2
1,453,453,17,17,0,1,0

1,280,280,56,56,0,1,0
0,348,348,70,70,0,1,0

1,144,144,8,5,3,2,1
2,149,149,2,2,0,1,0
4,196,196,40,40,0,1,0
3,384,384,19,2,17,4,3
0,490,490,41,11,30,3,2

2,254,254,1,1,0,1,0
4,317,317,6,6,0,1,0
0,364,364,4,4,0,1,0
3,393,393,19,19,0,1,0
5,428,428,86,86,0,1,0
1,439,439,53,21,32,3,2

3,288,288,10,5,5,2,1
2,324,324,33,27,6,2,1
4,332,332,67,67,0,1,0
0,335,335,18,2,16,2,1
1,479,479,5,5,0,1,0

0,348,348,33,33,0,1,0
2,386,386,15,9,6,3,2
3,407,407,82,26,56,3,2
1,481,481,33,23,10,2,1

1,123,123,1,1,0,1,0
4,280,280,56,4,52,3,2
0,283,283,42,42,0,1,0
2,347,347,4,4,0,1,0
3,367,367,12,3,9,2,1

0,144,144,10,1,9,4,3
4,268,268,54,5,49,2,1
2,438,438,8,2,6,3,2
3,460,460,48,48,0,1,0
1,482,482,4,4,0,1,0

0,294,294,7,7,0,1,0
3,397,397,80,12,68,3,2
1,401,401,23,23,0,1,0
2,435,435,52,7,45,4,3

2,136,136,15,10,5,2,1
0,206,206,13,13,0,1,0
1,236,236,8,8,0,1,0
3,254,254,51,51,0,1,0

1,197,197,38,18,20,4,3
2,212,212,43,7,36,2,1
0,248,248,2,2,0,1,0

2,169,169,34,8,26,2,1
1,249,249,7,3,4,2,1
0,484,484,84,57,27,4,3

5,100,100,20,20,0,1,0
4,248,248,16,13,3,2,1
1,289,289,16,9,7,3,2
0,391,391,5,2,3,2,1
2,484,484,16,16,0,1,0
3,489,489,17,17,0,1,0

3,245,245,19,19,0,1,0
0,262,262,9,2,7,2,1
4,305,305,17,17,0,1,0
2,315,315,7,7,0,1,0
5,334,334,67,13,54,3,2
1,467,467,6,6,0,1,0

2,141,141,4,4,0,1,0
1,148,148,22,22,0,1,0
0,307,307,8,8,0,1,0
3,486,486,98,98,0,1,0

2,155,155,31,7,24,4,3
0,358,358,43,43,0,1,0
1,479,479,39,39,0,1,0

2,104,104,2,2,0,1,0
0,200,200,32,18,14,2,1
3,458,458,92,26,66,3,2
1,471,471,10,10,0,1,0

4,182,182,37,22,15,4,3
2,225,225,1,1,0,1,0
0,262,262,4,4,0,1,0
3,483,483,34,21,13,4,3
1,488,488,54,54,0,1,0

0,112,112,23,7,16,2,1
1,154,154,31,16,15,4,3

4,108,108,22,2,20,4,3
2,249,249,26,8,18,4,3
3,352,352,27,27,0,1,0
1,428,428,6,6,0,1,0
0,444,444,3,3,0,1,0

0,296,296,60,36,24,2,1
1,353,353,71,71,0,1,0

2,115,115,5,1,4,2,1
0,229,229,25,5,20,3,2
1,380,380,18,18,0,1,0
3,423,423,85,37,48,4,3

3,179,179,36,1,35,2,1
2,251,251,33,33,0,1,0
0,281,281,2,2,0,1,0
1,336,336,21,21,0,1,0

1,164,164,18,13,5,2,1
0,195,195,18,15,3,2,1
2,497,497,100,24,76,4,3

2,262,262,53,53,0,1,0
0,293,293,55,24,31,4,3
1,368,368,5,5,0,1,0

2,101,101,21,21,0,1,0
0,231,231,4,4,0,1,0
1,441,441,81,81,0,1,0

0,318,318,25,25,0,1,0
2,322,322,65,44,21,4,3
1,435,435,53,53,0,1,0

1,176,176,13,13,0,1,0
0,292,292,19,16,3,2,1
3,434,434,87,20,67,4,3
2,494,494,31,6,25,2,1

2,132,132,9,9,0,1,0
1,306,306,11,11,0,1,0
4,365,365,73,13,60,3,2
3,432,432,30,30,0,1,0
0,436,436,12,12,0,1,0

3,120,120,24,10,14,4,3
1,165,165,7,1,6,2,1
2,240,240,28,10,18,4,3
0,416,416,18,7,11,2,1

3,165,165,33,13,20,4,3
2,167,167,3,3,0,1,0
0,391,391,59,35,24,3,2
1,468,468,15,15,0,1,0

1,335,335,59,5,54,3,2
2,364,364,73,19,54,4,3
0,384,384,10,4,6,2,1

4,266,266,54,14,40,2,1
0,348,348,4,4,0,1,0
2,430,430,66,35,31,2,1
3,437,437,2,2,0,1,0
1,487,487,15,15,0,1,0

4,203,203,41,18,23,2,1
1,273,273,1,1,0,1,0
0,437,437,11,11,0,1,0
2,467,467,48,40,8,3,2
3,481,481,33,33,0,1,0

2,181,181,37,16,21,4,3
0,262,262,18,18,0,1,0
1,391,391,52,36,16,3,2

0,230,230,46,46,0,1,0
1,271,271,55,48,7,2,1

0,144,144,28,28,0,1,0
2,307,307,62,62,0,1,0
1,337,337,2,2,0,1,0

0,284,284,1,1,0,1,0
1,317,317,19,19,0,1,0
2,360,360,50,50,0,1,0
3,420,420,84,58,26,2,1

0,259,259,52,52,0,1,0
1,418,418,84,12,72,4,3

0,146,146,26,20,6,3,2
1,186,186,5,5,0,1,0
2,475,475,95,89,6,3,2

0,247,247,23,1,22,3,2
2,384,384,13,10,3,2,1
1,438,438,33,9,24,2,1
3,496,496,100,82,18,4,3

1,209,209,42,36,6,2,1
0,356,356,72,72,0,1,0

6,175,175,35,21,14,2,1
5,316,316,32,23,9,4,3
1,328,328,4,4,0,1,0
2,376,376,11,1,10,2,1
3,382,382,5,5,0,1,0
4,412,412,18,12,6,3,2
0,495,495,1,1,0,1,0

0,245,245,30,2,28,4,3
1,319,319,1,1,0,1,0
3,468,468,94,94,0,1,0
2,477,477,36,36,0,1,0

2,238,238,48,15,33,2,1
0,395,395,33,7,26,2,1
1,500,500,59,23,36,2,1

0,110,110,13,13,0,1,0
1,271,271,23,23,0,1,0
2,300,300,60,2,58,3,2

1,174,174,19,19,0,1,0
2,218,218,44,44,0,1,0
0,251,251,23,6,17,2,1

1,190,190,7,7,0,1,0
2,307,307,62,32,30,4,3
0,438,438,73,28,45,2,1

1,267,267,30,10,20,2,1
2,321,321,15,15,0,1,0
3,428,428,86,86,0,1,0
0,479,479,21,17,4,2,1

1,131,131,6,2,4,2,1
3,144,144,11,8,3,2,1
5,161,161,33,33,0,1,0
2,264,264,2,2,0,1,0
4,455,455,7,4,3,2,1
0,469,469,26,4,22,2,1

0,155,155,3,3,0,1,0
2,157,157,19,19,0,1,0
4,167,167,34,18,16,2,1
3,197,197,2,2,0,1,0
1,212,212,11,3,8,2,1

1,178,178,1,1,0,1,0
0,285,285,3,3,0,1,0
3,309,309,62,62,0,1,0
2,455,455,84,47,37,2,1

0,192,192,39,39,0,1,0
1,252,252,51,51,0,1,0

2,137,137,8,8,0,1,0
0,188,188,3,3,0,1,0
3,403,403,81,11,70,3,2
1,443,443,57,45,12,2,1

0,346,346,11,11,0,1,0
2,371,371,75,25,50,2,1
1,486,486,82,82,0,1,0

0,141,141,29,29,0,1,0
1,357,357,72,6,66,3,2

3,131,131,4,4,0,1,0
4,183,183,37,33,4,2,1
2,239,239,18,1,17,2,1
0,328,328,5,5,0,1,0
1,471,471,38,32,6,2,1

0,119,119,2,2,0,1,0
1,249,249,46,46,0,1,0
2,448,448,90,62,28,3,2

0,238,238,5,1,4,2,1
3,287,287,58,19,39,4,3
1,299,299,42,21,21,4,3
2,412,412,16,16,0,1,0

2,264,264,30,2,28,3,2
1,295,295,5,5,0,1,0
0,347,347,17,17,0,1,0
3,352,352,8,2,6,3,2
4,407,407,82,82,0,1,0

1,182,182,12,1,11,2,1
3,305,305,61,61,0,1,0
2,354,354,21,21,0,1,0
0,380,380,29,29,0,1,0

4,105,105,13,13,0,1,0
5,117,117,24,24,0,1,0
0,250,250,4,1,3,2,1
2,380,380,19,1,18,3,2
1,383,383,5,5,0,1,0
3,469,469,2,2,0,1,0

3,219,219,6,6,0,1,0
4,244,244,49,49,0,1,0
2,312,312,7,4,3,2,1
1,425,425,38,38,0,1,0
0,488,488,30,12,18,3,2

2,107,107,1,1,0,1,0
6,156,156,32,26,6,3,2
1,198,198,29,8,21,2,1
3,319,319,9,9,0,1,0
5,340,340,2,2,0,1,0
4,413,413,3,3,0,1,0
0,463,463,2,2,0,1,0

4,145,145,29,29,0,1,0
0,411,411,25,25,0,1,0
1,446,446,18,8,10,3,2
3,457,457,35,3,32,4,3
2,496,496,12,12,0,1,0

0,161,161,15,6,9,4,3
2,171,171,12,12,0,1,0
1,224,224,9,9,0,1,0
3,314,314,63,40,23,2,1

2,133,133,8,8,0,1,0
3,163,163,33,33,0,1,0
1,238,238,32,32,0,1,0
0,252,252,2,2,0,1,0

4,161,161,33,23,10,3,2
1,234,234,19,19,0,1,0
0,370,370,1,1,0,1,0
3,376,376,29,29,0,1,0
2,477,477,19,19,0,1,0

1,357,357,58,58,0,1,0
2,392,392,79,72,7,2,1
0,427,427,17,10,7,2,1

3,128,128,26,22,4,2,1
0,398,398,2,2,0,1,0
2,430,430,16,9,7,2,1
1,447,447,71,47,24,4,3

4,301,301,61,22,39,4,3
3,322,322,1,1,0,1,0
0,346,346,25,12,13,3,2
2,364,364,26,26,0,1,0
1,432,432,24,24,0,1,0

0,136,136,1,1,0,1,0
4,186,186,38,15,23,2,1
1,327,327,14,14,0,1,0
3,456,456,3,3,0,1,0
2,468,468,68,68,0,1,0

2,116,116,14,14,0,1,0
3,384,384,77,77,0,1,0
0,418,418,23,23,0,1,0
1,493,493,14,2,12,4,3

0,189,189,11,11,0,1,0
1,203,203,7,7,0,1,0
2,355,355,11,8,3,2,1
4,395,395,79,32,47,2,1
3,416,416,32,32,0,1,0

2,185,185,37,23,14,3,2
0,189,189,22,22,0,1,0
1,236,236,20,20,0,1,0

3,174,174,1,1,0,1,0
2,212,212,16,16,0,1,0
0,221,221,14,5,9,4,3
4,250,250,50,50,0,1,0
1,471,471,27,27,0,1,0

7,148,148,2,2,0,1,0
8,218,218,6,6,0,1,0
0,227,227,7,7,0,1,0
4,248,248,1,1,0,1,0
1,298,298,1,1,0,1,0
3,342,342,1,1,0,1,0
6,361,361,10,6,4,2,1
2,409,409,18,18,0,1,0
5,429,429,20,20,0,1,0
9,432,432,87,87,0,1,0

1,282,282,50,50,0,1,0
2,328,328,66,44,22,2,1
0,385,385,10,10,0,1,0

2,119,119,11,2,9,4,3
1,146,146,4,1,3,2,1
3,265,265,53,39,14,2,1
0,401,401,33,3,30,2,1

2,114,114,1,1,0,1,0
4,116,116,24,24,0,1,0
1,240,240,18,18,0,1,0
3,322,322,29,24,5,2,1
0,339,339,9,9,0,1,0

3,283,283,57,57,0,1,0
0,331,331,3,3,0,1,0
1,407,407,69,69,0,1,0
2,453,453,10,10,0,1,0

1,287,287,53,35,18,2,1
0,388,388,6,3,3,2,1
2,496,496,100,100,0,1,0

1,207,207,42,42,0,1,0
0,338,338,68,68,0,1,0

0,215,215,3,3,0,1,0
1,222,222,34,13,21,2,1
2,240,240,2,2,0,1,0
3,277,277,7,7,0,1,0
4,455,455,91,58,33,4,3

0,359,359,72,26,46,3,2
1,449,449,90,90,0,1,0

2,231,231,3,3,0,1,0
0,363,363,14,14,0,1,0
3,408,408,82,43,39,2,1
1,456,456,68,38,30,3,2

2,210,210,42,42,0,1,0
1,317,317,14,14,0,1,0
0,390,390,61,5,56,3,2

0,138,138,15,15,0,1,0
2,201,201,41,35,6,3,2
1,474,474,44,44,0,1,0

1,232,232,1,1,0,1,0
3,284,284,43,11,32,2,1
2,336,336,9,3,6,2,1
4,337,337,68,68,0,1,0
0,391,391,7,7,0,1,0

3,244,244,49,25,24,4,3
1,291,291,3,3,0,1,0
2,357,357,67,2,65,4,3
0,429,429,1,1,0,1,0

3,153,153,31,31,0,1,0
2,160,160,2,2,0,1,0
1,245,245,23,23,0,1,0
0,469,469,46,33,13,2,1

1,186,186,19,19,0,1,0
3,199,199,40,40,0,1,0
2,367,367,1,1,0,1,0
0,387,387,37,4,33,2,1

1,303,303,10,4,6,3,2
3,312,312,63,25,38,3,2
0,335,335,3,3,0,1,0
2,441,441,70,33,37,2,1

3,156,156,4,1,3,2,1
2,211,211,14,14,0,1,0
0,292,292,4,1,3,2,1
4,306,306,26,4,22,2,1
5,434,434,87,19,68,4,3
1,447,447,5,5,0,1,0

1,194,194,37,6,31,2,1
0,389,389,5,5,0,1,0
2,416,416,84,32,52,4,3

0,149,149,2,2,0,1,0
1,358,358,57,46,11,2,1
2,405,405,12,12,0,1,0
3,446,446,90,12,78,4,3

1,167,167,9,9,0,1,0
2,202,202,25,25,0,1,0
3,303,303,61,44,17,2,1
0,439,439,10,10,0,1,0

3,179,179,6,6,0,1,0
0,223,223,1,1,0,1,0
4,307,307,62,51,11,2,1
2,364,364,23,7,16,3,2
1,451,451,46,11,35,2,1

1,135,135,7,4,3,2,1
0,169,169,10,1,9,4,3
4,249,249,4,4,0,1,0
7,286,286,58,28,30,2,1
5,307,307,1,1,0,1,0
2,323,323,18,8,10,2,1
6,362,362,1,1,0,1,0
3,480,480,6,6,0,1,0

0,195,195,12,12,0,1,0
1,247,247,9,9,0,1,0
3,311,311,20,20,0,1,0
2,365,365,14,5,9,4,3
4,413,413,83,1,82,3,2

3,300,300,60,18,42,3,2
0,319,319,9,1,8,3,2
1,319,319,18,4,14,2,1
2,327,327,38,38,0,1,0

1,398,398,43,43,0,1,0
3,416,416,84,84,0,1,0
2,444,444,28,19,9,4,3
0,467,467,14,14,0,1,0

6,123,123,25,5,20,2,1
3,193,193,1,1,0,1,0
1,259,259,15,7,8,2,1
4,330,330,3,3,0,1,0
0,396,396,42,13,29,2,1
5,408,408,5,5,0,1,0
2,440,440,5,5,0,1,0

0,217,217,23,5,18,3,2
2,313,313,63,20,43,4,3
1,380,380,36,3,33,2,1

0,356,356,67,67,0,1,0
1,389,389,5,5,0,1,0
2,396,396,80,50,30,2,1

0,247,247,22,22,0,1,0
2,272,272,28,10,18,4,3
3,331,331,67,47,20,2,1
1,433,433,5,5,0,1,0

0,209,209,33,33,0,1,0
2,388,388,10,2,8,2,1
3,406,406,82,30,52,3,2
1,477,477,8,8,0,1,0

5,180,180,36,6,30,3,2
2,200,200,12,4,8,3,2
3,202,202,3,3,0,1,0
4,289,289,20,20,0,1,0
0,301,301,9,3,6,3,2
1,457,457,13,1,12,4,3

4,142,142,3,3,0,1,0
2,164,164,13,13,0,1,0
3,247,247,5,2,3,2,1
5,283,283,57,10,47,2,1
1,294,294,6,6,0,1,0
0,382,382,24,24,0,1,0

0,147,147,3,3,0,1,0
2,168,168,1,1,0,1,0
3,345,345,69,24,45,4,3
1,437,437,76,76,0,1,0

4,164,164,1,1,0,1,0
5,246,246,50,50,0,1,0
3,269,269,11,11,0,1,0
1,306,306,11,11,0,1,0
2,352,352,34,8,26,3,2
0,400,400,10,1,9,3,2

0,104,104,3,3,0,1,0
4,163,163,33,33,0,1,0
1,191,191,27,5,22,2,1
3,206,206,3,3,0,1,0
2,313,313,5,2,3,2,1

0,135,135,8,8,0,1,0
2,149,149,4,4,0,1,0
5,200,200,40,8,32,3,2
3,317,317,15,12,3,2,1
1,363,363,13,13,0,1,0
4,435,435,14,2,12,3,2

0,164,164,22,10,12,4,3
1,326,326,3,3,0,1,0
3,361,361,73,73,0,1,0
2,386,386,22,2,20,3,2

3,240,240,48,40,8,3,2
2,267,267,26,4,22,3,2
0,278,278,8,8,0,1,0
1,494,494,37,32,5,2,1

2,148,148,30,30,0,1,0
0,397,397,63,63,0,1,0
1,413,413,18,18,0,1,0

5,125,125,25,5,20,3,2
3,156,156,3,3,0,1,0
4,203,203,15,3,12,3,2
1,239,239,8,8,0,1,0
2,399,399,4,4,0,1,0
0,473,473,31,31,0,1,0

0,165,165,2,2,0,1,0
2,239,239,48,17,31,2,1
1,469,469,89,62,27,4,3

1,216,216,44,44,0,1,0
0,309,309,62,32,30,3,2

2,223,223,21,21,0,1,0
0,254,254,20,20,0,1,0
3,287,287,4,4,0,1,0
1,343,343,5,2,3,2,1
4,372,372,75,75,0,1,0

0,144,144,1,1,0,1,0
2,201,201,13,13,0,1,0
4,393,393,79,43,36,4,3
3,425,425,15,15,0,1,0
1,482,482,45,12,33,4,3

1,333,333,67,26,41,3,2
0,464,464,93,93,0,1,0

5,130,130,26,12,14,3,2
2,158,158,3,3,0,1,0
1,232,232,21,21,0,1,0
4,300,300,15,15,0,1,0
3,418,418,13,13,0,1,0
0,438,438,5,5,0,1,0

1,188,188,6,6,0,1,0
3,197,197,23,13,10,2,1
2,273,273,10,5,5,2,1
0,307,307,5,5,0,1,0
4,453,453,91,9,82,3,2

1,177,177,7,7,0,1,0
2,274,274,55,55,0,1,0
0,317,317,52,52,0,1,0

2,105,105,21,21,0,1,0
0,309,309,30,23,7,2,1
1,475,475,49,49,0,1,0

1,102,102,21,9,12,2,1
0,151,151,31,31,0,1,0

1,118,118,4,1,3,2,1
0,144,144,2,2,0,1,0
4,268,268,2,2,0,1,0
3,294,294,5,1,4,2,1
5,337,337,68,29,39,2,1
2,457,457,60,60,0,1,0

4,112,112,23,4,19,2,1
0,212,212,12,2,10,2,1
1,246,246,18,4,14,2,1
2,318,318,9,9,0,1,0
3,468,468,20,20,0,1,0

0,141,141,29,29,0,1,0
1,200,200,40,26,14,2,1

4,112,112,23,23,0,1,0
2,237,237,2,2,0,1,0
1,270,270,15,5,10,2,1
0,297,297,33,33,0,1,0
3,347,347,9,2,7,2,1

3,192,192,39,39,0,1,0
0,336,336,24,24,0,1,0
1,426,426,33,33,0,1,0
2,474,474,25,25,0,1,0

0,152,152,6,3,3,2,1
2,205,205,1,1,0,1,0
3,218,218,6,2,4,2,1
5,374,374,75,75,0,1,0
1,432,432,2,2,0,1,0
4,439,439,55,10,45,4,3

2,147,147,4,4,0,1,0
3,188,188,38,38,0,1,0
0,195,195,28,28,0,1,0
1,256,256,8,8,0,1,0

3,196,196,40,40,0,1,0
1,304,304,17,1,16,3,2
0,406,406,47,47,0,1,0
2,434,434,13,13,0,1,0

1,145,145,6,6,0,1,0
3,147,147,30,8,22,3,2
2,345,345,34,34,0,1,0
0,472,472,29,14,15,4,3

0,147,147,14,14,0,1,0
1,240,240,26,26,0,1,0
2,249,249,50,46,4,2,1

5,163,163,33,33,0,1,0
3,218,218,4,1,3,2,1
0,290,290,23,17,6,2,1
1,346,346,10,10,0,1,0
4,454,454,7,7,0,1,0
2,480,480,28,22,6,2,1

6,176,176,8,4,4,2,1
0,203,203,10,1,9,2,1
8,220,220,44,17,27,2,1
4,276,276,6,1,5,2,1
5,282,282,1,1,0,1,0
7,359,359,12,6,6,3,2
1,422,422,12,8,4,2,1
3,429,429,2,2,0,1,0
2,490,490,7,7,0,1,0

1,179,179,11,11,0,1,0
0,255,255,36,31,5,2,1
2,421,421,85,75,10,2,1

1,269,269,54,54,0,1,0
0,402,402,81,35,46,2,1

0,110,110,1,1,0,1,0
1,156,156,9,9,0,1,0
2,227,227,31,21,10,2,1
3,480,480,96,96,0,1,0

2,263,263,53,18,35,3,2
1,269,269,6,6,0,1,0
0,290,290,52,52,0,1,0

1,163,163,10,7,3,2,1
0,334,334,47,41,6,3,2
2,387,387,78,16,62,4,3

2,364,364,73,73,0,1,0
0,412,412,66,66,0,1,0
1,498,498,20,20,0,1,0

1,150,150,23,9,14,3,2
0,346,346,10,10,0,1,0
2,400,400,8,8,0,1,0
3,414,414,83,83,0,1,0

0,286,286,31,2,29,4,3
1,386,386,36,36,0,1,0
2,434,434,87,83,4,2,1

1,299,299,60,34,26,3,2
0,494,494,99,36,63,4,3

1,445,445,89,89,0,1,0
0,462,462,93,93,0,1,0

0,168,168,18,18,0,1,0
3,288,288,1,1,0,1,0
2,302,302,5,5,0,1,0
4,376,376,76,76,0,1,0
1,471,471,35,35,0,1,0

0,151,151,18,1,17,2,1
1,168,168,14,14,0,1,0
2,445,445,89,89,0,1,0

1,297,297,60,7,53,4,3
0,404,404,81,81,0,1,0

3,149,149,10,3,7,2,1
0,232,232,10,2,8,2,1
1,352,352,27,15,12,3,2
2,469,469,8,2,6,3,2
4,471,471,95,95,0,1,0

1,215,215,13,13,0,1,0
0,232,232,33,33,0,1,0
2,447,447,90,90,0,1,0

2,132,132,17,17,0,1,0
3,197,197,40,7,33,2,1
0,313,313,8,8,0,1,0
1,342,342,16,16,0,1,0

1,129,129,1,1,0,1,0
5,139,139,28,28,0,1,0
2,154,154,5,5,0,1,0
0,359,359,12,12,0,1,0
3,450,450,11,11,0,1,0
4,478,478,49,43,6,3,2

1,165,165,1,1,0,1,0
0,217,217,1,1,0,1,0
5,248,248,5,5,0,1,0
6,396,396,80,59,21,2,1
4,408,408,36,4,32,2,1
2,417,417,10,10,0,1,0
3,460,460,27,21,6,2,1

0,119,119,10,10,0,1,0
3,155,155,13,13,0,1,0
1,168,168,5,2,3,2,1
2,422,422,3,3,0,1,0
4,499,499,100,100,0,1,0

0,242,242,49,49,0,1,0
1,492,492,99,99,0,1,0

1,136,136,12,2,10,2,1
2,231,231,7,1,6,3,2
4,242,242,49,49,0,1,0
0,268,268,7,7,0,1,0
3,417,417,24,8,16,2,1

1,113,113,12,12,0,1,0
2,134,134,2,2,0,1,0
4,197,197,6,1,5,2,1
0,338,338,14,14,0,1,0
5,338,338,68,68,0,1,0
3,339,339,4,4,0,1,0

0,293,293,8,2,6,3,2
1,377,377,11,11,0,1,0
3,403,403,81,10,71,3,2
2,434,434,63,63,0,1,0

0,149,149,16,16,0,1,0
2,204,204,3,3,0,1,0
4,204,204,41,41,0,1,0
1,248,248,13,13,0,1,0
3,324,324,9,2,7,2,1

3,172,172,35,14,21,4,3
1,246,246,17,17,0,1,0
2,301,301,26,7,19,2,1
0,347,347,16,4,12,2,1

0,146,146,2,2,0,1,0
2,147,147,7,7,0,1,0
5,190,190,38,20,18,4,3
1,336,336,10,10,0,1,0
3,373,373,22,1,21,2,1
4,497,497,25,22,3,2,1

1,174,174,4,4,0,1,0
2,208,208,29,29,0,1,0
3,241,241,3,3,0,1,0
4,349,349,70,38,32,3,2
0,422,422,12,3,9,4,3

1,364,364,25,17,8,2,1
2,409,409,82,30,52,3,2
0,427,427,57,57,0,1,0

0,340,340,69,34,35,4,3
1,454,454,91,21,70,4,3

2,184,184,11,11,0,1,0
1,283,283,18,18,0,1,0
4,300,300,60,60,0,1,0
3,373,373,14,2,12,2,1
0,417,417,17,17,0,1,0

3,217,217,44,12,32,3,2
1,231,231,21,21,0,1,0
2,276,276,12,7,5,2,1
0,368,368,25,4,21,2,1

3,169,169,34,34,0,1,0
0,221,221,4,4,0,1,0
2,382,382,10,10,0,1,0
1,389,389,61,12,49,2,1

2,128,128,26,26,0,1,0
1,286,286,7,7,0,1,0
0,317,317,56,56,0,1,0

0,110,110,2,2,0,1,0
1,295,295,36,9,27,4,3
2,353,353,22,22,0,1,0
3,419,419,84,32,52,3,2

1,181,181,37,37,0,1,0
0,390,390,79,51,28,2,1

0,278,278,56,56,0,1,0
1,337,337,68,41,27,4,3

1,101,101,3,3,0,1,0
0,280,280,16,6,10,3,2
4,367,367,74,17,57,4,3
2,383,383,13,13,0,1,0
3,419,419,34,34,0,1,0

1,118,118,19,19,0,1,0
3,126,126,26,2,24,2,1
0,139,139,1,1,0,1,0
2,162,162,6,6,0,1,0

1,148,148,30,10,20,2,1
0,423,423,85,85,0,1,0

4,135,135,27,27,0,1,0
0,249,249,8,3,5,2,1
2,253,253,24,24,0,1,0
1,343,343,13,13,0,1,0
3,440,440,16,16,0,1,0

1,116,116,1,1,0,1,0
2,139,139,16,16,0,1,0
0,191,191,4,4,0,1,0
4,215,215,43,7,36,3,2
3,267,267,15,15,0,1,0

0,253,253,19,19,0,1,0
3,402,402,81,24,57,4,3
1,434,434,1,1,0,1,0
2,458,458,57,57,0,1,0

2,202,202,26,2,24,2,1
3,255,255,51,6,45,2,1
1,330,330,4,4,0,1,0
0,346,346,21,3,18,4,3

1,217,217,5,5,0,1,0
0,226,226,41,41,0,1,0
2,287,287,58,52,6,3,2

1,207,207,42,42,0,1,0
0,357,357,72,72,0,1,0

2,139,139,2,2,0,1,0
3,140,140,28,6,22,3,2
1,188,188,24,8,16,2,1
0,358,358,23,23,0,1,0

1,287,287,27,3,24,3,2
2,312,312,63,63,0,1,0
0,488,488,52,2,50,3,2

1,108,108,22,1,21,4,3
0,174,174,35,15,20,2,1

2,251,251,51,51,0,1,0
1,302,302,35,35,0,1,0
0,311,311,27,20,7,2,1

0,315,315,16,16,0,1,0
5,317,317,64,64,0,1,0
4,363,363,10,10,0,1,0
1,380,380,11,11,0,1,0
3,447,447,23,23,0,1,0
2,466,466,20,20,0,1,0

1,197,197,40,31,9,4,3
0,472,472,95,95,0,1,0

0,180,180,17,17,0,1,0
4,250,250,50,50,0,1,0
3,332,332,8,8,0,1,0
1,386,386,15,15,0,1,0
2,395,395,18,18,0,1,0

0,106,106,21,12,9,4,3
2,130,130,26,26,0,1,0
1,179,179,1,1,0,1,0

0,213,213,34,34,0,1,0
2,475,475,95,63,32,3,2
1,497,497,21,21,0,1,0

0,133,133,5,5,0,1,0
2,345,345,69,46,23,2,1
1,347,347,57,19,38,3,2

2,163,163,1,1,0,1,0
4,226,226,46,46,0,1,0
1,296,296,26,26,0,1,0
3,302,302,28,28,0,1,0
0,395,395,6,6,0,1,0

2,163,163,7,1,6,2,1
0,325,325,17,17,0,1,0
3,387,387,78,75,3,2,1
1,456,456,49,13,36,4,3

4,123,123,1,1,0,1,0
1,143,143,19,19,0,1,0
2,208,208,5,5,0,1,0
0,288,288,10,7,3,2,1
5,369,369,74,47,27,4,3
3,472,472,1,1,0,1,0

0,114,114,1,1,0,1,0
1,119,119,1,1,0,1,0
2,146,146,1,1,0,1,0
3,275,275,15,15,0,1,0
4,281,281,25,13,12,3,2
5,302,302,10,4,6,3,2
6,349,349,70,70,0,1,0

0,145,145,10,10,0,1,0
3,354,354,71,38,33,4,3
2,359,359,45,45,0,1,0
1,443,443,3,3,0,1,0

0,186,186,18,18,0,1,0
1,218,218,7,7,0,1,0
3,249,249,3,3,0,1,0
2,322,322,20,6,14,2,1
4,364,364,73,46,27,2,1

5,111,111,23,23,0,1,0
0,174,174,7,3,4,2,1
1,221,221,1,1,0,1,0
3,244,244,29,15,14,2,1
2,287,287,3,3,0,1,0
4,466,466,13,13,0,1,0

1,373,373,54,54,0,1,0
2,389,389,78,32,46,3,2
0,424,424,24,6,18,4,3

2,104,104,7,7,0,1,0
4,259,259,52,52,0,1,0
1,347,347,38,38,0,1,0
0,348,348,6,6,0,1,0
3,457,457,3,3,0,1,0

0,179,179,5,5,0,1,0
2,378,378,15,15,0,1,0
3,390,390,78,42,36,3,2
1,489,489,66,66,0,1,0

1,124,124,2,2,0,1,0
0,150,150,7,7,0,1,0
3,209,209,42,39,3,2,1
2,256,256,36,36,0,1,0

0,260,260,9,3,6,2,1
3,332,332,6,1,5,2,1
4,368,368,32,28,4,2,1
2,436,436,21,21,0,1,0
5,457,457,92,92,0,1,0
1,490,490,7,7,0,1,0

0,198,198,8,8,0,1,0
4,265,265,53,11,42,3,2
3,276,276,3,3,0,1,0
1,326,326,31,25,6,2,1
2,478,478,27,3,24,3,2

4,158,158,32,16,16,2,1
1,251,251,9,9,0,1,0
3,334,334,16,16,0,1,0
2,461,461,52,10,42,3,2
0,472,472,2,2,0,1,0

0,148,148,1,1,0,1,0
3,193,193,6,6,0,1,0
5,231,231,47,47,0,1,0
2,304,304,16,16,0,1,0
4,317,317,34,27,7,2,1
1,366,366,1,1,0,1,0

1,136,136,4,4,0,1,0
3,173,173,35,35,0,1,0
0,320,320,50,26,24,2,1
2,446,446,7,7,0,1,0

2,118,118,6,6,0,1,0
3,314,314,63,63,0,1,0
0,375,375,27,27,0,1,0
1,469,469,40,4,36,3,2

2,204,204,41,41,0,1,0
1,429,429,20,17,3,2,1
0,432,432,67,58,9,2,1

3,241,241,49,13,36,2,1
2,296,296,4,4,0,1,0
0,327,327,1,1,0,1,0
1,427,427,79,79,0,1,0

2,267,267,11,7,4,2,1
3,405,405,81,4,77,3,2
0,436,436,52,10,42,3,2
1,489,489,20,4,16,4,3

0,104,104,10,5,5,2,1
1,367,367,39,33,6,2,1
2,429,429,86,14,72,3,2

0,153,153,11,8,3,2,1
2,256,256,15,10,5,2,1
3,326,326,66,66,0,1,0
1,497,497,35,29,6,3,2

1,141,141,29,1,28,2,1
0,337,337,68,47,21,4,3

2,111,111,23,5,18,3,2
0,196,196,16,6,10,2,1
1,295,295,35,7,28,3,2

0,184,184,7,1,6,2,1
1,251,251,2,2,0,1,0
3,329,329,9,4,5,2,1
2,349,349,45,45,0,1,0
4,401,401,81,12,69,4,3

2,101,101,12,12,0,1,0
3,285,285,57,57,0,1,0
0,305,305,13,13,0,1,0
1,342,342,16,16,0,1,0

1,345,345,33,33,0,1,0
2,384,384,5,2,3,2,1
0,395,395,37,19,18,4,3
3,471,471,95,85,10,2,1

4,129,129,26,5,21,2,1
1,172,172,16,4,12,4,3
0,384,384,4,4,0,1,0
3,406,406,24,24,0,1,0
2,478,478,18,8,10,2,1

0,263,263,15,15,0,1,0
1,330,330,48,48,0,1,0
2,424,424,85,67,18,4,3

2,114,114,3,3,0,1,0
0,120,120,4,4,0,1,0
4,186,186,38,2,36,3,2
3,330,330,37,37,0,1,0
1,384,384,12,3,9,2,1

1,323,323,11,11,0,1,0
2,386,386,33,33,0,1,0
3,434,434,87,87,0,1,0
0,444,444,36,11,25,2,1

0,226,226,11,11,0,1,0
3,258,258,1,1,0,1,0
2,278,278,21,21,0,1,0
5,336,336,68,47,21,2,1
4,370,370,7,1,6,3,2
1,455,455,25,19,6,2,1

1,202,202,1,1,0,1,0
2,218,218,14,14,0,1,0
3,239,239,48,36,12,4,3
0,493,493,66,38,28,3,2

1,128,128,6,6,0,1,0
0,260,260,41,6,35,2,1
2,485,485,97,47,50,3,2

2,114,114,23,23,0,1,0
0,287,287,8,8,0,1,0
1,426,426,74,74,0,1,0

0,120,120,6,1,5,2,1
1,370,370,56,18,38,3,2
2,393,393,79,21,58,3,2

4,184,184,8,8,0,1,0
1,238,238,9,9,0,1,0
3,333,333,16,11,5,2,1
2,352,352,15,1,14,2,1
5,381,381,77,2,75,4,3
0,440,440,14,2,12,3,2

2,140,140,9,9,0,1,0
0,372,372,29,22,7,2,1
3,409,409,15,6,9,2,1
4,456,456,92,88,4,2,1
1,499,499,11,2,9,2,1

1,320,320,27,15,12,2,1
0,461,461,42,42,0,1,0
3,493,493,99,89,10,2,1
2,495,495,13,13,0,1,0

1,199,199,8,2,6,3,2
0,239,239,39,39,0,1,0
2,434,434,87,43,44,3,2

3,266,266,54,18,36,2,1
2,309,309,14,6,8,2,1
1,427,427,29,29,0,1,0
0,495,495,43,43,0,1,0

0,312,312,30,30,0,1,0
1,322,322,34,34,0,1,0
2,423,423,85,85,0,1,0

0,179,179,5,1,4,2,1
5,342,342,69,51,18,2,1
4,363,363,8,8,0,1,0
1,364,364,11,7,4,2,1
3,396,396,10,3,7,2,1
2,474,474,45,45,0,1,0

1,221,221,28,6,22,3,2
2,273,273,55,9,46,3,2
0,447,447,34,25,9,4,3

0,125,125,16,16,0,1,0
2,141,141,9,1,8,2,1
1,281,281,4,4,0,1,0
3,376,376,76,21,55,4,3

6,102,102,21,11,10,2,1
5,125,125,1,1,0,1,0
3,227,227,1,1,0,1,0
0,345,345,12,12,0,1,0
1,370,370,1,1,0,1,0
4,478,478,60,33,27,4,3
2,491,491,13,13,0,1,0

0,132,132,14,10,4,2,1
1,187,187,1,1,0,1,0
3,189,189,4,4,0,1,0
5,202,202,4,4,0,1,0
4,224,224,8,8,0,1,0
6,229,229,46,25,21,4,3
2,416,416,7,7,0,1,0

0,295,295,59,36,23,2,1
1,441,441,89,89,0,1,0

1,280,280,56,35,21,4,3
0,491,491,99,99,0,1,0

2,316,316,64,36,28,3,2
0,368,368,22,22,0,1,0
1,476,476,67,67,0,1,0

0,167,167,22,22,0,1,0
1,237,237,11,11,0,1,0
3,380,380,76,35,41,2,1
2,473,473,11,11,0,1,0

1,151,151,1,1,0,1,0
2,222,222,27,13,14,3,2
4,326,326,3,3,0,1,0
3,367,367,6,1,5,2,1
6,395,395,79,7,72,4,3
5,481,481,6,6,0,1,0
0,484,484,17,17,0,1,0

0,123,123,19,19,0,1,0
1,308,308,15,15,0,1,0
2,436,436,88,66,22,3,2

3,187,187,38,38,0,1,0
2,315,315,15,15,0,1,0
0,489,489,39,13,26,3,2
1,498,498,37,25,12,4,3

0,142,142,29,8,21,2,1
1,352,352,71,71,0,1,0

2,161,161,33,33,0,1,0
1,171,171,33,33,0,1,0
0,313,313,3,3,0,1,0

0,234,234,47,29,18,2,1
1,300,300,60,38,22,3,2

0,128,128,2,2,0,1,0
6,161,161,2,2,0,1,0
4,171,171,1,1,0,1,0
7,318,318,64,18,46,3,2
2,337,337,2,2,0,1,0
5,414,414,39,39,0,1,0
3,469,469,2,2,0,1,0
1,490,490,33,3,30,3,2

1,279,279,1,1,0,1,0
2,279,279,54,54,0,1,0
0,408,408,2,2,0,1,0
3,480,480,96,38,58,4,3

2,187,187,8,8,0,1,0
3,404,404,81,37,44,3,2
0,411,411,38,38,0,1,0
1,432,432,30,30,0,1,0

3,132,132,6,6,0,1,0
4,135,135,27,27,0,1,0
2,139,139,1,1,0,1,0
1,321,321,16,13,3,2,1
0,413,413,41,14,27,2,1

3,186,186,6,6,0,1,0
2,199,199,17,5,12,4,3
4,368,368,74,37,37,2,1
1,438,438,20,3,17,3,2
0,449,449,18,18,0,1,0

2,108,108,14,11,3,2,1
3,161,161,5,5,0,1,0
4,329,329,66,66,0,1,0
0,388,388,13,6,7,2,1
1,407,407,3,3,0,1,0

2,106,106,4,4,0,1,0
3,125,125,2,2,0,1,0
4,132,132,1,1,0,1,0
1,147,147,4,4,0,1,0
0,279,279,32,3,29,2,1
5,383,383,77,50,27,4,3

0,115,115,10,10,0,1,0
1,119,119,8,2,6,3,2
2,141,141,7,7,0,1,0
3,184,184,37,26,11,2,1

0,168,168,8,8,0,1,0
1,233,233,36,36,0,1,0
2,491,491,99,27,72,4,3

1,163,163,33,33,0,1,0
0,178,178,36,19,17,2,1

1,241,241,18,18,0,1,0
3,255,255,51,22,29,2,1
2,454,454,46,25,21,4,3
0,487,487,12,8,4,2,1

0,141,141,6,6,0,1,0
2,223,223,10,5,5,2,1
1,230,230,26,14,12,3,2
3,235,235,47,47,0,1,0

1,210,210,10,2,8,2,1
0,330,330,8,3,5,2,1
4,364,364,73,29,44,3,2
2,385,385,33,17,16,2,1
3,438,438,19,10,9,2,1

1,204,204,1,1,0,1,0
3,224,224,12,8,4,2,1
0,337,337,37,28,9,2,1
4,411,411,83,53,30,3,2
2,488,488,17,17,0,1,0

2,205,205,41,26,15,4,3
1,387,387,36,22,14,2,1
0,402,402,44,44,0,1,0

0,169,169,21,21,0,1,0
4,204,204,1,1,0,1,0
1,214,214,1,1,0,1,0
5,240,240,48,48,0,1,0
2,285,285,13,13,0,1,0
3,462,462,10,10,0,1,0

1,101,101,8,4,4,2,1
0,272,272,33,5,28,3,2
2,339,339,68,61,7,2,1

3,137,137,8,8,0,1,0
1,174,174,1,1,0,1,0
2,333,333,32,20,12,2,1
0,391,391,16,8,8,2,1
4,400,400,80,72,8,3,2

2,111,111,23,8,15,2,1
1,410,410,55,55,0,1,0
0,455,455,30,30,0,1,0

3,233,233,47,47,0,1,0
2,311,311,16,13,3,2,1
1,384,384,42,26,16,3,2
0,500,500,21,5,16,2,1

1,230,230,46,46,0,1,0
0,330,330,67,67,0,1,0

2,293,293,59,59,0,1,0
1,348,348,25,25,0,1,0
0,485,485,63,63,0,1,0

0,237,237,2,2,0,1,0
2,272,272,52,28,24,4,3
1,399,399,1,1,0,1,0
3,404,404,81,81,0,1,0

1,195,195,39,39,0,1,0
0,406,406,82,12,70,3,2

2,228,228,28,28,0,1,0
1,272,272,7,7,0,1,0
4,315,315,63,38,25,2,1
0,385,385,16,16,0,1,0
3,447,447,5,5,0,1,0

0,160,160,1,1,0,1,0
4,256,256,21,5,16,4,3
2,355,355,6,3,3,2,1
5,399,399,80,11,69,3,2
1,409,409,13,13,0,1,0
3,486,486,31,31,0,1,0

1,325,325,38,38,0,1,0
3,334,334,67,67,0,1,0
2,428,428,14,14,0,1,0
0,498,498,26,20,6,3,2

4,196,196,40,3,37,3,2
0,222,222,8,1,7,3,2
1,223,223,10,7,3,2,1
3,328,328,10,2,8,2,1
2,376,376,34,34,0,1,0

5,109,109,22,22,0,1,0
2,112,112,12,5,7,2,1
3,118,118,3,3,0,1,0
1,159,159,3,3,0,1,0
4,368,368,4,1,3,2,1
0,423,423,17,11,6,3,2

4,106,106,2,2,0,1,0
0,122,122,4,1,3,2,1
1,156,156,8,8,0,1,0
2,236,236,14,6,8,2,1
3,376,376,15,15,0,1,0
5,436,436,88,88,0,1,0

0,128,128,12,12,0,1,0
2,253,253,9,9,0,1,0
3,256,256,3,3,0,1,0
4,389,389,78,59,19,2,1
1,451,451,28,28,0,1,0

3,151,151,31,31,0,1,0
1,246,246,12,12,0,1,0
2,283,283,15,9,6,2,1
0,463,463,47,35,12,3,2

0,129,129,4,4,0,1,0
4,187,187,38,38,0,1,0
2,294,294,13,3,10,3,2
3,392,392,26,8,18,4,3
1,471,471,28,6,22,3,2

2,143,143,12,1,11,3,2
3,235,235,47,47,0,1,0
1,320,320,11,1,10,3,2
0,383,383,32,2,30,3,2

1,299,299,60,43,17,2,1
0,387,387,78,16,62,3,2

2,215,215,32,32,0,1,0
1,275,275,8,8,0,1,0
3,346,346,70,50,20,2,1
0,476,476,11,6,5,2,1

1,102,102,3,3,0,1,0
2,126,126,13,13,0,1,0
3,202,202,10,1,9,2,1
0,315,315,6,2,4,2,1
4,482,482,97,22,75,4,3

4,160,160,32,32,0,1,0
2,167,167,9,3,6,3,2
0,356,356,33,18,15,4,3
3,401,401,10,2,8,2,1
1,457,457,14,5,9,2,1

0,186,186,28,28,0,1,0
1,264,264,14,8,6,2,1
2,439,439,88,44,44,3,2

5,121,121,25,7,18,2,1
3,124,124,2,2,0,1,0
2,181,181,16,4,12,4,3
0,268,268,4,4,0,1,0
1,299,299,14,14,0,1,0
4,491,491,17,17,0,1,0

1,160,160,18,18,0,1,0
2,303,303,61,47,14,2,1
0,438,438,41,8,33,4,3

3,121,121,1,1,0,1,0
4,276,276,36,27,9,2,1
5,349,349,70,70,0,1,0
0,428,428,1,1,0,1,0
1,429,429,11,11,0,1,0
2,477,477,16,16,0,1,0

0,216,216,6,6,0,1,0
2,219,219,20,20,0,1,0
1,227,227,19,19,0,1,0
3,256,256,52,39,13,2,1

2,200,200,5,5,0,1,0
1,283,283,38,38,0,1,0
3,374,374,75,27,48,4,3
0,484,484,21,21,0,1,0

3,150,150,30,30,0,1,0
2,162,162,2,2,0,1,0
1,398,398,39,39,0,1,0
0,496,496,47,47,0,1,0

0,183,183,37,37,0,1,0
1,433,433,87,87,0,1,0

1,259,259,52,27,25,2,1
0,415,415,84,65,19,2,1

1,299,299,14,10,4,2,1
2,466,466,94,62,32,3,2
0,470,470,72,72,0,1,0

5,109,109,22,22,0,1,0
0,127,127,1,1,0,1,0
3,272,272,27,27,0,1,0
1,433,433,2,2,0,1,0
2,458,458,40,40,0,1,0
4,476,476,1,1,0,1,0

3,213,213,43,31,12,2,1
1,299,299,6,6,0,1,0
2,374,374,49,49,0,1,0
0,418,418,21,21,0,1,0

2,105,105,4,4,0,1,0
1,265,265,24,10,14,2,1
0,331,331,25,25,0,1,0
3,342,342,69,22,47,2,1

0,195,195,3,3,0,1,0
2,196,196,23,19,4,2,1
3,355,355,71,2,69,4,3
1,377,377,26,26,0,1,0

5,182,182,37,37,0,1,0
4,266,266,3,3,0,1,0
0,330,330,14,7,7,2,1
1,367,367,14,14,0,1,0
3,417,417,30,30,0,1,0
2,480,480,18,18,0,1,0

5,135,135,27,22,5,2,1
4,149,149,2,2,0,1,0
3,172,172,1,1,0,1,0
1,191,191,15,7,8,3,2
2,342,342,36,36,0,1,0
0,398,398,1,1,0,1,0

0,209,209,18,18,0,1,0
3,218,218,44,33,11,2,1
1,309,309,35,35,0,1,0
2,496,496,1,1,0,1,0

0,120,120,5,2,3,2,1
1,176,176,28,28,0,1,0
2,323,323,65,65,0,1,0

1,127,127,19,1,18,3,2
0,195,195,11,3,8,3,2
2,275,275,55,55,0,1,0

2,123,123,4,4,0,1,0
1,248,248,38,7,31,2,1
0,441,441,9,9,0,1,0
3,486,486,98,9,89,3,2

2,108,108,8,8,0,1,0
3,145,145,29,22,7,2,1
0,167,167,3,3,0,1,0
1,335,335,37,37,0,1,0

2,118,118,24,24,0,1,0
0,280,280,11,11,0,1,0
1,486,486,79,59,20,3,2

2,103,103,3,3,0,1,0
1,205,205,25,10,15,2,1
0,265,265,15,3,12,4,3
3,495,495,99,90,9,4,3

4,130,130,26,26,0,1,0
3,170,170,2,2,0,1,0
0,192,192,25,25,0,1,0
1,439,439,1,1,0,1,0
2,450,450,27,27,0,1,0

4,191,191,6,6,0,1,0
5,288,288,3,3,0,1,0
1,324,324,14,2,12,3,2
0,360,360,12,12,0,1,0
6,372,372,75,47,28,3,2
2,425,425,16,2,14,3,2
3,457,457,21,21,0,1,0

0,200,200,24,24,0,1,0
2,342,342,69,69,0,1,0
1,356,356,29,15,14,3,2

1,150,150,14,14,0,1,0
5,193,193,39,39,0,1,0
3,204,204,1,1,0,1,0
4,217,217,11,8,3,2,1
2,221,221,1,1,0,1,0
0,343,343,16,10,6,2,1

2,265,265,3,3,0,1,0
0,323,323,39,9,30,4,3
3,345,345,69,19,50,2,1
1,447,447,31,31,0,1,0

0,307,307,62,2,60,3,2
1,373,373,75,75,0,1,0

0,189,189,38,6,32,3,2
1,445,445,89,16,73,4,3

3,302,302,61,61,0,1,0
0,439,439,28,28,0,1,0
2,457,457,48,44,4,2,1
1,476,476,15,9,6,2,1

0,187,187,1,1,0,1,0
4,214,214,27,27,0,1,0
1,221,221,7,3,4,2,1
2,327,327,9,9,0,1,0
3,392,392,5,5,0,1,0
5,476,476,96,60,36,4,3

1,160,160,21,21,0,1,0
3,217,217,44,44,0,1,0
0,229,229,4,1,3,2,1
2,469,469,25,16,9,4,3

8,122,122,25,5,20,2,1
4,145,145,1,1,0,1,0
3,193,193,1,1,0,1,0
5,215,215,1,1,0,1,0
6,229,229,1,1,0,1,0
0,241,241,21,21,0,1,0
1,372,372,1,1,0,1,0
7,406,406,13,7,6,3,2
2,417,417,24,17,7,2,1

3,163,163,33,13,20,2,1
2,187,187,6,1,5,2,1
0,390,390,8,8,0,1,0
1,393,393,59,5,54,4,3

2,120,120,3,3,0,1,0
4,182,182,3,3,0,1,0
6,193,193,14,14,0,1,0
3,247,247,1,1,0,1,0
7,288,288,58,58,0,1,0
0,383,383,15,6,9,4,3
5,413,413,3,3,0,1,0
1,446,446,18,18,0,1,0

2,478,478,96,68,28,3,2
0,484,484,37,20,17,2,1
1,485,485,60,60,0,1,0

0,193,193,9,9,0,1,0
1,195,195,30,11,19,2,1
2,374,374,75,11,64,3,2

0,111,111,12,7,5,2,1
3,114,114,7,7,0,1,0
2,354,354,1,1,0,1,0
4,417,417,11,3,8,2,1
1,438,438,1,1,0,1,0
5,452,452,91,82,9,2,1

3,246,246,22,22,0,1,0
0,340,340,16,3,13,2,1
2,357,357,13,9,4,2,1
1,467,467,14,2,12,4,3
4,490,490,98,20,78,4,3

0,403,403,81,66,15,2,1
1,405,405,81,81,0,1,0

3,192,192,2,2,0,1,0
0,244,244,6,6,0,1,0
4,254,254,1,1,0,1,0
1,353,353,11,2,9,4,3
5,422,422,14,14,0,1,0
2,441,441,36,28,8,2,1
6,453,453,7,7,0,1,0
7,470,470,94,55,39,4,3

0,201,201,16,16,0,1,0
4,232,232,3,3,0,1,0
6,349,349,70,22,48,4,3
1,371,371,1,1,0,1,0
2,404,404,5,5,0,1,0
3,466,466,8,2,6,2,1
5,488,488,37,37,0,1,0

0,227,227,14,14,0,1,0
1,286,286,20,14,6,2,1
2,404,404,28,28,0,1,0
3,483,483,97,80,17,2,1

0,201,201,12,12,0,1,0
1,369,369,33,33,0,1,0
2,435,435,23,23,0,1,0
3,470,470,94,94,0,1,0

0,272,272,55,55,0,1,0
1,393,393,79,32,47,2,1

1,111,111,1,1,0,1,0
2,126,126,6,1,5,2,1
5,185,185,1,1,0,1,0
0,202,202,1,1,0,1,0
6,223,223,2,2,0,1,0
4,280,280,22,14,8,3,2
7,311,311,6,6,0,1,0
8,416,416,84,34,50,3,2
3,449,449,13,13,0,1,0

4,205,205,6,6,0,1,0
5,277,277,6,6,0,1,0
1,354,354,5,5,0,1,0
6,362,362,73,73,0,1,0
2,375,375,1,1,0,1,0
0,414,414,28,28,0,1,0
3,430,430,29,5,24,2,1

1,290,290,8,8,0,1,0
0,316,316,55,4,51,3,2
2,383,383,77,77,0,1,0

2,351,351,71,4,67,4,3
1,369,369,36,12,24,4,3
0,434,434,45,45,0,1,0

0,116,116,5,2,3,2,1
1,209,209,25,25,0,1,0
2,289,289,11,3,8,2,1
3,355,355,71,71,0,1,0

1,222,222,45,45,0,1,0
0,255,255,51,51,0,1,0

1,425,425,76,6,70,3,2
2,433,433,87,87,0,1,0
0,485,485,11,8,3,2,1

3,141,141,29,21,8,2,1
1,185,185,1,1,0,1,0
2,191,191,5,5,0,1,0
0,271,271,47,47,0,1,0

0,162,162,20,14,6,2,1
2,433,433,87,87,0,1,0
1,467,467,36,6,30,2,1

0,390,390,79,10,69,4,3
1,402,402,81,81,0,1,0

2,465,465,93,27,66,4,3
1,469,469,19,19,0,1,0
0,482,482,77,77,0,1,0

0,178,178,9,9,0,1,0
1,353,353,30,30,0,1,0
3,454,454,91,84,7,2,1
2,483,483,32,16,16,3,2

2,108,108,22,22,0,1,0
1,155,155,11,11,0,1,0
0,285,285,37,19,18,4,3

0,122,122,18,1,17,2,1
2,299,299,15,6,9,4,3
1,324,324,1,1,0,1,0
3,330,330,66,66,0,1,0

0,327,327,45,45,0,1,0
1,372,372,24,24,0,1,0
2,426,426,86,86,0,1,0

1,110,110,6,2,4,2,1
3,154,154,9,9,0,1,0
4,227,227,8,8,0,1,0
2,257,257,10,4,6,3,2
0,331,331,5,1,4,2,1
5,351,351,71,9,62,3,2

4,114,114,23,23,0,1,0
2,129,129,4,4,0,1,0
3,201,201,12,12,0,1,0
0,425,425,22,22,0,1,0
1,491,491,29,29,0,1,0

4,101,101,21,13,8,3,2
0,188,188,1,1,0,1,0
1,229,229,14,14,0,1,0
3,239,239,9,3,6,3,2
2,475,475,47,47,0,1,0

0,186,186,38,23,15,4,3
1,200,200,40,40,0,1,0

1,347,347,70,29,41,3,2
0,349,349,70,70,0,1,0

0,315,315,26,26,0,1,0
1,341,341,18,18,0,1,0
3,352,352,13,13,0,1,0
4,460,460,92,79,13,4,3
2,499,499,15,15,0,1,0

6,127,127,26,26,0,1,0
1,217,217,1,1,0,1,0
4,277,277,2,2,0,1,0
5,315,315,12,9,3,2,1
3,352,352,16,16,0,1,0
2,353,353,12,3,9,2,1
0,372,372,27,9,18,2,1

