8,110,110,11,2,9,2,1
2,152,152,4,4,0,1,0
10,209,209,28,28,0,1,0
4,222,222,22,14,8,3,2
12,266,266,10,1,9,4,3
1,267,267,51,18,33,4,3
7,282,282,2,2,0,1,0
3,367,367,44,44,0,1,0
11,429,429,54,49,5,2,1
9,449,449,18,18,0,1,0
5,460,460,6,6,0,1,0
6,460,460,22,22,0,1,0
0,488,488,48,48,0,1,0
13,498,498,90,22,68,3,2

7,178,178,21,5,16,3,2
4,250,250,20,20,0,1,0
2,255,255,49,49,0,1,0
3,280,280,14,14,0,1,0
1,358,358,82,18,64,3,2
5,365,365,15,15,0,1,0
8,367,367,7,1,6,3,2
6,372,372,6,3,3,2,1
0,408,408,54,14,40,4,3
9,484,484,163,137,26,3,2

7,113,113,12,12,0,1,0
6,183,183,8,8,0,1,0
11,190,190,12,12,0,1,0
1,225,225,7,7,0,1,0
10,339,339,51,51,0,1,0
5,355,355,75,75,0,1,0
8,372,372,58,58,0,1,0
4,379,379,74,12,62,4,3
9,422,422,38,38,0,1,0
3,426,426,1,1,0,1,0
0,454,454,1,1,0,1,0
2,475,475,75,11,64,4,3

9,112,112,17,2,15,2,1
10,124,124,19,9,10,2,1
0,126,126,6,6,0,1,0
5,136,136,6,2,4,2,1
6,146,146,4,4,0,1,0
11,147,147,10,10,0,1,0
2,179,179,5,2,3,2,1
4,186,186,3,3,0,1,0
13,216,216,19,5,14,2,1
14,290,290,44,29,15,4,3
3,369,369,23,6,17,3,2
12,372,372,3,3,0,1,0
8,406,406,38,6,32,3,2
7,473,473,24,24,0,1,0
1,479,479,111,79,32,3,2

7,111,111,1,1,0,1,0
10,167,167,47,47,0,1,0
12,211,211,5,5,0,1,0
5,218,218,1,1,0,1,0
9,221,221,49,18,31,2,1
1,225,225,101,101,0,1,0
8,283,283,19,3,16,3,2
6,352,352,6,2,4,2,1
3,366,366,10,10,0,1,0
11,418,418,2,2,0,1,0
2,430,430,1,1,0,1,0
13,445,445,6,1,5,2,1
0,449,449,40,11,29,2,1
4,491,491,4,4,0,1,0

9,125,125,3,3,0,1,0
0,127,127,10,4,6,2,1
5,140,140,20,20,0,1,0
7,213,213,7,7,0,1,0
3,231,231,42,42,0,1,0
1,277,277,28,1,27,4,3
10,285,285,98,53,45,4,3
6,343,343,13,5,8,2,1
11,399,399,34,34,0,1,0
2,428,428,39,10,29,2,1
4,440,440,3,3,0,1,0
8,492,492,45,14,31,2,1

4,138,138,28,28,0,1,0
11,153,153,18,18,0,1,0
3,202,202,34,6,28,3,2
9,209,209,18,18,0,1,0
1,277,277,1,1,0,1,0
0,294,294,36,36,0,1,0
10,300,300,80,80,0,1,0
5,363,363,5,5,0,1,0
2,409,409,19,19,0,1,0
13,419,419,33,10,23,2,1
7,452,452,19,19,0,1,0
8,466,466,21,21,0,1,0
6,478,478,1,1,0,1,0
12,480,480,9,9,0,1,0

1,129,129,2,2,0,1,0
11,149,149,1,1,0,1,0
9,156,156,20,20,0,1,0
2,183,183,2,2,0,1,0
15,199,199,17,17,0,1,0
7,236,236,28,19,9,2,1
10,250,250,6,6,0,1,0
0,339,339,2,2,0,1,0
8,346,346,5,5,0,1,0
13,381,381,51,39,12,4,3
6,412,412,31,31,0,1,0
5,412,412,45,18,27,2,1
3,413,413,22,22,0,1,0
12,450,450,39,39,0,1,0
4,467,467,22,22,0,1,0
16,467,467,101,101,0,1,0
14,481,481,39,39,0,1,0

6,143,143,14,3,11,2,1
12,150,150,16,9,7,2,1
3,152,152,8,8,0,1,0
5,162,162,13,7,6,3,2
4,207,207,9,9,0,1,0
10,297,297,1,1,0,1,0
11,333,333,19,7,12,2,1
7,358,358,17,2,15,4,3
9,362,362,72,44,28,2,1
13,367,367,38,38,0,1,0
2,399,399,25,17,8,3,2
14,413,413,59,59,0,1,0
8,420,420,6,6,0,1,0
1,424,424,55,55,0,1,0
0,461,461,34,34,0,1,0

3,139,139,1,1,0,1,0
2,156,156,16,2,14,2,1
12,157,157,26,2,24,4,3
9,219,219,24,13,11,2,1
10,221,221,14,14,0,1,0
0,243,243,7,7,0,1,0
1,282,282,61,20,41,2,1
5,288,288,20,4,16,3,2
8,292,292,17,17,0,1,0
4,375,375,63,21,42,4,3
6,412,412,4,4,0,1,0
11,424,424,51,51,0,1,0
7,431,431,41,41,0,1,0

9,112,112,5,5,0,1,0
6,126,126,25,25,0,1,0
3,128,128,5,2,3,2,1
0,140,140,5,5,0,1,0
8,155,155,46,46,0,1,0
1,243,243,7,1,6,2,1
12,255,255,26,26,0,1,0
5,295,295,30,30,0,1,0
4,309,309,51,3,48,3,2
7,332,332,26,26,0,1,0
10,345,345,23,11,12,3,2
2,348,348,13,13,0,1,0
11,394,394,9,9,0,1,0

13,123,123,2,2,0,1,0
5,140,140,1,1,0,1,0
12,238,238,13,13,0,1,0
2,257,257,19,19,0,1,0
4,298,298,37,37,0,1,0
0,311,311,9,9,0,1,0
3,350,350,32,14,18,3,2
9,374,374,143,75,68,4,3
6,410,410,56,43,13,2,1
10,437,437,23,14,9,4,3
11,444,444,11,11,0,1,0
8,473,473,39,39,0,1,0
1,484,484,63,63,0,1,0
7,486,486,4,4,0,1,0

3,183,183,25,3,22,2,1
13,200,200,1,1,0,1,0
5,214,214,9,9,0,1,0
6,233,233,13,2,11,2,1
10,268,268,10,2,8,2,1
11,315,315,78,66,12,2,1
12,315,315,8,8,0,1,0
7,360,360,68,20,48,3,2
2,404,404,12,12,0,1,0
8,448,448,37,37,0,1,0
0,455,455,32,32,0,1,0
4,455,455,28,2,26,3,2
1,459,459,7,4,3,2,1
9,498,498,106,75,31,2,1

6,134,134,3,3,0,1,0
4,194,194,33,33,0,1,0
14,235,235,14,14,0,1,0
10,245,245,14,14,0,1,0
1,261,261,9,9,0,1,0
7,273,273,1,1,0,1,0
5,298,298,41,41,0,1,0
13,304,304,15,15,0,1,0
3,308,308,6,6,0,1,0
8,326,326,32,32,0,1,0
16,331,331,60,60,0,1,0
0,358,358,19,5,14,3,2
12,368,368,101,101,0,1,0
11,404,404,3,3,0,1,0
15,444,444,15,15,0,1,0
2,468,468,1,1,0,1,0
9,484,484,1,1,0,1,0

1,120,120,10,1,9,2,1
6,170,170,16,9,7,2,1
8,207,207,1,1,0,1,0
9,306,306,50,22,28,2,1
3,307,307,7,7,0,1,0
4,322,322,25,25,0,1,0
5,335,335,128,107,21,3,2
2,404,404,14,14,0,1,0
10,411,411,16,2,14,2,1
7,431,431,112,60,52,3,2
0,455,455,1,1,0,1,0
11,488,488,23,6,17,2,1

1,114,114,6,6,0,1,0
0,115,115,12,12,0,1,0
12,141,141,8,8,0,1,0
8,156,156,1,1,0,1,0
2,168,168,9,9,0,1,0
7,254,254,2,2,0,1,0
6,306,306,21,14,7,2,1
3,377,377,85,64,21,4,3
4,378,378,11,11,0,1,0
9,381,381,3,3,0,1,0
10,408,408,93,47,46,2,1
11,425,425,38,5,33,2,1
13,446,446,44,11,33,4,3
5,463,463,25,15,10,2,1
14,472,472,61,25,36,3,2

9,151,151,5,2,3,2,1
2,153,153,48,4,44,3,2
1,206,206,9,1,8,3,2
5,256,256,20,4,16,2,1
3,276,276,26,26,0,1,0
10,313,313,2,2,0,1,0
8,342,342,53,17,36,2,1
0,365,365,50,37,13,2,1
4,424,424,5,5,0,1,0
7,433,433,140,96,44,2,1
6,460,460,7,7,0,1,0

4,108,108,1,1,0,1,0
8,127,127,39,7,32,3,2
11,188,188,25,6,19,4,3
13,225,225,15,4,11,2,1
0,227,227,14,9,5,2,1
1,237,237,22,10,12,3,2
7,256,256,9,9,0,1,0
9,272,272,17,17,0,1,0
5,293,293,1,1,0,1,0
6,306,306,10,4,6,3,2
10,315,315,5,1,4,2,1
12,328,328,81,54,27,2,1
14,338,338,28,28,0,1,0
2,452,452,23,15,8,3,2
3,495,495,5,5,0,1,0

1,109,109,10,10,0,1,0
5,172,172,10,2,8,3,2
0,184,184,6,6,0,1,0
9,227,227,25,25,0,1,0
7,267,267,16,6,10,2,1
4,277,277,30,30,0,1,0
3,381,381,31,31,0,1,0
2,431,431,171,138,33,4,3
6,467,467,67,67,0,1,0
8,498,498,64,64,0,1,0

12,105,105,22,7,15,4,3
0,113,113,14,14,0,1,0
14,129,129,26,15,11,2,1
2,152,152,5,1,4,2,1
1,214,214,30,20,10,3,2
5,235,235,3,3,0,1,0
11,267,267,3,3,0,1,0
3,274,274,5,5,0,1,0
6,282,282,23,23,0,1,0
8,291,291,2,2,0,1,0
4,310,310,4,4,0,1,0
9,311,311,17,12,5,2,1
13,348,348,44,5,39,2,1
7,398,398,69,48,21,2,1
10,454,454,7,2,5,2,1

4,130,130,13,3,10,4,3
10,212,212,3,3,0,1,0
9,226,226,4,4,0,1,0
0,235,235,38,10,28,2,1
7,271,271,37,37,0,1,0
12,296,296,41,41,0,1,0
2,349,349,40,6,34,3,2
3,357,357,22,22,0,1,0
11,422,422,23,9,14,3,2
5,427,427,6,6,0,1,0
8,433,433,107,107,0,1,0
1,473,473,9,3,6,3,2
6,473,473,62,62,0,1,0

11,113,113,1,1,0,1,0
7,116,116,25,25,0,1,0
12,212,212,41,41,0,1,0
9,218,218,20,6,14,2,1
13,250,250,6,6,0,1,0
1,294,294,5,5,0,1,0
4,339,339,45,27,18,4,3
3,367,367,52,7,45,4,3
0,372,372,2,2,0,1,0
8,397,397,46,46,0,1,0
2,448,448,21,21,0,1,0
6,460,460,20,6,14,2,1
5,467,467,1,1,0,1,0
10,469,469,83,83,0,1,0

1,121,121,2,2,0,1,0
6,125,125,2,2,0,1,0
0,183,183,110,64,46,2,1
5,209,209,94,94,0,1,0
2,393,393,28,28,0,1,0
4,406,406,15,3,12,4,3
3,423,423,11,3,8,3,2

2,100,100,1,1,0,1,0
8,135,135,12,12,0,1,0
0,166,166,21,6,15,4,3
1,207,207,41,41,0,1,0
5,289,289,6,1,5,2,1
4,343,343,60,48,12,4,3
3,347,347,32,32,0,1,0
6,375,375,60,35,25,2,1
10,447,447,10,1,9,4,3
9,467,467,136,25,111,4,3
7,493,493,15,15,0,1,0

5,178,178,11,11,0,1,0
11,185,185,2,2,0,1,0
3,270,270,22,6,16,2,1
12,271,271,1,1,0,1,0
6,288,288,27,10,17,2,1
10,328,328,104,104,0,1,0
1,367,367,6,2,4,2,1
9,371,371,88,29,59,3,2
7,445,445,111,39,72,4,3
0,450,450,9,9,0,1,0
2,472,472,7,2,5,2,1
13,475,475,14,2,12,4,3
8,478,478,5,1,4,2,1
4,479,479,30,30,0,1,0

2,162,162,8,8,0,1,0
4,187,187,8,8,0,1,0
7,205,205,62,62,0,1,0
3,219,219,24,24,0,1,0
0,243,243,2,2,0,1,0
8,284,284,14,14,0,1,0
1,342,342,186,162,24,2,1
5,440,440,15,15,0,1,0
6,444,444,32,14,18,4,3

4,162,162,2,2,0,1,0
5,166,166,10,10,0,1,0
1,310,310,7,7,0,1,0
8,313,313,29,4,25,4,3
2,353,353,12,2,10,2,1
6,363,363,100,100,0,1,0
7,398,398,9,4,5,2,1
3,412,412,61,61,0,1,0
0,449,449,244,100,144,4,3

10,115,115,11,1,10,4,3
9,169,169,15,12,3,2,1
4,212,212,8,8,0,1,0
7,302,302,26,26,0,1,0
3,303,303,61,25,36,2,1
8,369,369,43,43,0,1,0
1,419,419,1,1,0,1,0
2,433,433,28,12,16,3,2
6,480,480,17,17,0,1,0
0,485,485,144,144,0,1,0
5,488,488,91,82,9,4,3

10,128,128,31,31,0,1,0
6,139,139,18,18,0,1,0
11,158,158,16,7,9,4,3
4,168,168,8,8,0,1,0
8,228,228,10,6,4,2,1
9,249,249,7,2,5,2,1
0,356,356,34,13,21,4,3
2,360,360,1,1,0,1,0
5,400,400,2,2,0,1,0
1,408,408,92,52,40,2,1
3,483,483,109,83,26,3,2
7,498,498,37,26,11,2,1

4,108,108,20,9,11,2,1
9,160,160,11,6,5,2,1
8,165,165,27,7,20,2,1
7,203,203,19,12,7,2,1
10,210,210,24,24,0,1,0
2,222,222,1,1,0,1,0
6,246,246,20,20,0,1,0
0,264,264,82,82,0,1,0
5,286,286,27,27,0,1,0
1,331,331,19,1,18,2,1
3,491,491,21,21,0,1,0

0,167,167,19,16,3,2,1
7,173,173,46,46,0,1,0
5,199,199,2,2,0,1,0
3,206,206,50,50,0,1,0
6,248,248,17,17,0,1,0
2,352,352,18,18,0,1,0
8,385,385,9,4,5,2,1
4,428,428,49,39,10,3,2
9,461,461,59,59,0,1,0
1,465,465,91,67,24,4,3

4,121,121,15,3,12,2,1
5,126,126,5,5,0,1,0
7,130,130,6,1,5,2,1
10,154,154,11,11,0,1,0
11,221,221,25,25,0,1,0
3,272,272,55,41,14,3,2
9,292,292,38,8,30,2,1
1,406,406,16,16,0,1,0
8,409,409,67,15,52,3,2
6,411,411,15,6,9,4,3
2,430,430,40,40,0,1,0
12,442,442,42,10,32,2,1
0,488,488,33,33,0,1,0

0,112,112,1,1,0,1,0
11,114,114,16,16,0,1,0
1,138,138,4,1,3,2,1
16,142,142,12,2,10,3,2
7,147,147,11,5,6,3,2
15,186,186,1,1,0,1,0
3,191,191,22,22,0,1,0
4,201,201,2,2,0,1,0
8,228,228,15,15,0,1,0
9,254,254,17,17,0,1,0
10,287,287,2,2,0,1,0
14,316,316,26,20,6,3,2
6,354,354,22,18,4,2,1
5,362,362,49,49,0,1,0
2,399,399,11,11,0,1,0
13,428,428,4,4,0,1,0
12,492,492,146,146,0,1,0

0,125,125,17,3,14,4,3
5,138,138,10,1,9,2,1
6,150,150,8,4,4,2,1
8,216,216,77,77,0,1,0
7,317,317,2,2,0,1,0
4,383,383,35,32,3,2,1
3,396,396,12,12,0,1,0
1,404,404,138,9,129,4,3
2,411,411,51,14,37,3,2

4,123,123,18,5,13,2,1
8,138,138,40,40,0,1,0
7,156,156,8,8,0,1,0
12,239,239,54,28,26,2,1
11,243,243,2,2,0,1,0
1,282,282,64,37,27,4,3
6,284,284,3,3,0,1,0
2,311,311,26,26,0,1,0
0,366,366,26,4,22,2,1
5,391,391,8,8,0,1,0
9,440,440,15,15,0,1,0
3,451,451,20,12,8,3,2
10,464,464,2,2,0,1,0

10,100,100,26,8,18,2,1
2,129,129,13,13,0,1,0
0,153,153,17,17,0,1,0
5,172,172,26,26,0,1,0
11,190,190,7,1,6,3,2
8,228,228,22,4,18,2,1
1,231,231,34,8,26,3,2
7,331,331,42,42,0,1,0
4,388,388,2,2,0,1,0
3,433,433,38,38,0,1,0
6,454,454,35,35,0,1,0
9,470,470,3,3,0,1,0

4,164,164,5,5,0,1,0
1,233,233,2,2,0,1,0
7,241,241,26,26,0,1,0
5,244,244,15,15,0,1,0
0,277,277,89,40,49,4,3
9,319,319,72,72,0,1,0
10,356,356,80,80,0,1,0
3,359,359,53,53,0,1,0
11,442,442,18,14,4,2,1
12,462,462,2,2,0,1,0
8,466,466,4,4,0,1,0
6,476,476,5,5,0,1,0
2,488,488,10,10,0,1,0

0,121,121,26,26,0,1,0
5,260,260,16,4,12,4,3
6,351,351,74,59,15,4,3
4,373,373,27,13,14,2,1
3,392,392,57,4,53,4,3
7,395,395,9,9,0,1,0
2,411,411,129,119,10,3,2
1,416,416,30,2,28,3,2
8,462,462,45,45,0,1,0

4,108,108,12,8,4,2,1
3,122,122,6,3,3,2,1
0,187,187,17,17,0,1,0
7,201,201,6,6,0,1,0
10,264,264,44,1,43,2,1
12,279,279,16,16,0,1,0
8,318,318,46,14,32,2,1
13,392,392,39,4,35,2,1
2,407,407,52,44,8,2,1
1,421,421,24,24,0,1,0
5,436,436,39,18,21,2,1
6,466,466,21,1,20,3,2
9,473,473,56,23,33,4,3
11,492,492,10,10,0,1,0

4,108,108,6,6,0,1,0
2,127,127,34,10,24,4,3
10,149,149,33,33,0,1,0
3,161,161,5,5,0,1,0
5,275,275,19,19,0,1,0
7,368,368,56,56,0,1,0
0,376,376,51,51,0,1,0
9,441,441,14,14,0,1,0
6,448,448,3,3,0,1,0
8,450,450,6,6,0,1,0
11,466,466,86,86,0,1,0
1,479,479,21,21,0,1,0

6,118,118,2,2,0,1,0
0,130,130,47,47,0,1,0
5,145,145,5,5,0,1,0
4,193,193,3,3,0,1,0
7,326,326,38,10,28,4,3
3,396,396,9,3,6,3,2
2,418,418,46,46,0,1,0
9,435,435,135,60,75,4,3
10,435,435,36,36,0,1,0
1,458,458,42,18,24,2,1
8,489,489,27,11,16,3,2

10,108,108,1,1,0,1,0
5,137,137,3,3,0,1,0
0,142,142,8,8,0,1,0
14,149,149,14,14,0,1,0
13,151,151,42,21,21,2,1
3,178,178,25,9,16,2,1
11,178,178,32,26,6,2,1
12,225,225,2,2,0,1,0
8,243,243,34,16,18,3,2
7,280,280,15,15,0,1,0
9,285,285,12,12,0,1,0
6,417,417,25,25,0,1,0
4,451,451,11,11,0,1,0
2,453,453,17,6,11,2,1
1,466,466,32,10,22,3,2

4,162,162,15,15,0,1,0
3,163,163,2,2,0,1,0
6,208,208,15,15,0,1,0
12,232,232,67,23,44,3,2
11,263,263,13,13,0,1,0
7,294,294,2,2,0,1,0
9,396,396,83,45,38,2,1
0,406,406,8,4,4,2,1
8,411,411,4,4,0,1,0
13,436,436,20,5,15,3,2
2,451,451,4,4,0,1,0
1,472,472,67,67,0,1,0
5,475,475,118,72,46,4,3
10,494,494,2,2,0,1,0

6,137,137,32,32,0,1,0
0,161,161,2,2,0,1,0
5,184,184,4,4,0,1,0
7,196,196,24,13,11,2,1
10,203,203,32,2,30,3,2
3,248,248,10,10,0,1,0
11,265,265,8,4,4,2,1
4,309,309,46,46,0,1,0
9,347,347,31,31,0,1,0
1,351,351,35,24,11,2,1
8,384,384,70,70,0,1,0
2,456,456,21,3,18,2,1
12,477,477,13,13,0,1,0

1,105,105,11,1,10,2,1
8,144,144,7,7,0,1,0
7,210,210,18,7,11,2,1
15,213,213,4,4,0,1,0
3,282,282,27,23,4,2,1
4,324,324,4,4,0,1,0
10,338,338,67,67,0,1,0
2,339,339,14,14,0,1,0
11,360,360,40,40,0,1,0
12,375,375,5,5,0,1,0
9,379,379,46,22,24,4,3
6,382,382,1,1,0,1,0
13,426,426,8,8,0,1,0
14,438,438,110,77,33,2,1
5,448,448,24,5,19,2,1
0,498,498,18,18,0,1,0

11,177,177,5,5,0,1,0
9,207,207,11,11,0,1,0
3,208,208,5,2,3,2,1
2,250,250,34,24,10,3,2
13,255,255,41,41,0,1,0
12,273,273,19,19,0,1,0
1,277,277,6,6,0,1,0
8,304,304,58,32,26,3,2
6,344,344,7,4,3,2,1
5,345,345,14,2,12,3,2
7,351,351,19,19,0,1,0
10,370,370,31,31,0,1,0
14,380,380,82,57,25,4,3
4,436,436,3,3,0,1,0
0,489,489,53,53,0,1,0

12,160,160,25,22,3,2,1
0,185,185,2,2,0,1,0
3,197,197,3,3,0,1,0
2,233,233,3,3,0,1,0
1,250,250,11,11,0,1,0
6,267,267,61,1,60,4,3
5,272,272,1,1,0,1,0
7,316,316,10,7,3,2,1
11,338,338,9,9,0,1,0
8,368,368,70,34,36,4,3
9,376,376,35,32,3,2,1
4,459,459,30,30,0,1,0
10,488,488,116,116,0,1,0
14,495,495,38,38,0,1,0
13,498,498,9,9,0,1,0

4,113,113,20,20,0,1,0
0,131,131,16,12,4,2,1
5,287,287,44,44,0,1,0
8,323,323,5,5,0,1,0
3,398,398,67,67,0,1,0
1,401,401,99,6,93,4,3
2,430,430,28,19,9,4,3
9,438,438,94,47,47,2,1
6,486,486,10,4,6,2,1
7,492,492,16,16,0,1,0

6,124,124,3,3,0,1,0
2,137,137,14,6,8,3,2
16,158,158,1,1,0,1,0
13,181,181,5,5,0,1,0
7,191,191,1,1,0,1,0
17,217,217,46,46,0,1,0
14,218,218,54,54,0,1,0
5,229,229,1,1,0,1,0
12,238,238,5,5,0,1,0
1,309,309,59,59,0,1,0
8,313,313,10,10,0,1,0
0,316,316,11,1,10,2,1
4,329,329,1,1,0,1,0
10,372,372,15,15,0,1,0
3,398,398,3,3,0,1,0
11,413,413,50,50,0,1,0
9,465,465,17,10,7,2,1
15,482,482,49,30,19,2,1

0,103,103,1,1,0,1,0
11,121,121,5,5,0,1,0
13,155,155,9,9,0,1,0
1,163,163,1,1,0,1,0
6,203,203,7,7,0,1,0
10,263,263,24,24,0,1,0
3,264,264,69,69,0,1,0
9,365,365,83,71,12,2,1
7,455,455,20,20,0,1,0
8,459,459,81,81,0,1,0
2,462,462,61,16,45,2,1
4,467,467,40,24,16,3,2
12,484,484,7,4,3,2,1
5,495,495,14,5,9,2,1

4,110,110,6,6,0,1,0
7,135,135,6,2,4,2,1
9,172,172,24,24,0,1,0
3,278,278,12,1,11,2,1
2,300,300,16,3,13,2,1
8,305,305,101,65,36,4,3
0,348,348,168,100,68,3,2
6,358,358,11,11,0,1,0
1,421,421,9,9,0,1,0
5,493,493,7,2,5,2,1

9,129,129,1,1,0,1,0
19,153,153,1,1,0,1,0
11,184,184,5,5,0,1,0
17,210,210,28,2,26,2,1
5,236,236,3,3,0,1,0
16,262,262,8,8,0,1,0
14,281,281,21,1,20,3,2
7,282,282,14,14,0,1,0
0,324,324,74,74,0,1,0
12,334,334,40,1,39,2,1
2,357,357,1,1,0,1,0
15,377,377,11,5,6,2,1
4,378,378,5,5,0,1,0
3,390,390,22,6,16,2,1
13,397,397,18,6,12,4,3
8,410,410,9,9,0,1,0
1,434,434,2,2,0,1,0
6,444,444,4,4,0,1,0
10,474,474,1,1,0,1,0
18,497,497,168,144,24,4,3

13,126,126,26,21,5,2,1
15,131,131,19,5,14,3,2
2,164,164,4,4,0,1,0
9,206,206,14,14,0,1,0
14,215,215,9,9,0,1,0
4,219,219,26,5,21,4,3
1,238,238,17,9,8,3,2
8,244,244,4,1,3,2,1
10,252,252,22,22,0,1,0
3,262,262,7,7,0,1,0
16,295,295,34,34,0,1,0
5,301,301,8,8,0,1,0
6,317,317,30,16,14,3,2
11,343,343,25,10,15,2,1
12,420,420,14,2,12,4,3
7,427,427,1,1,0,1,0
0,462,462,31,31,0,1,0

2,108,108,10,10,0,1,0
11,111,111,1,1,0,1,0
8,151,151,29,12,17,2,1
5,258,258,12,12,0,1,0
1,312,312,34,16,18,4,3
7,343,343,94,94,0,1,0
4,375,375,12,4,8,2,1
10,377,377,13,13,0,1,0
3,398,398,50,11,39,2,1
6,402,402,44,44,0,1,0
12,438,438,21,21,0,1,0
9,446,446,23,9,14,3,2
0,493,493,43,23,20,3,2

4,107,107,7,2,5,2,1
6,114,114,5,5,0,1,0
13,121,121,13,4,9,4,3
5,184,184,13,13,0,1,0
8,281,281,7,4,3,2,1
2,311,311,22,16,6,3,2
3,340,340,32,2,30,4,3
15,352,352,103,25,78,4,3
11,368,368,3,3,0,1,0
12,386,386,6,6,0,1,0
10,412,412,22,16,6,3,2
0,415,415,2,2,0,1,0
7,433,433,52,46,6,3,2
1,438,438,25,19,6,3,2
9,483,483,24,3,21,4,3
14,498,498,66,66,0,1,0

5,112,112,7,7,0,1,0
3,141,141,9,9,0,1,0
6,141,141,1,1,0,1,0
0,246,246,46,15,31,2,1
8,289,289,14,14,0,1,0
11,291,291,49,13,36,3,2
12,302,302,5,2,3,2,1
9,330,330,29,5,24,4,3
7,411,411,77,77,0,1,0
1,422,422,27,3,24,4,3
10,437,437,122,44,78,3,2
13,468,468,4,4,0,1,0
4,478,478,13,4,9,2,1
2,489,489,1,1,0,1,0

8,147,147,11,11,0,1,0
4,169,169,18,18,0,1,0
6,174,174,7,7,0,1,0
10,221,221,23,23,0,1,0
5,229,229,13,8,5,2,1
2,234,234,2,2,0,1,0
7,238,238,35,25,10,2,1
9,270,270,53,26,27,4,3
1,310,310,15,15,0,1,0
0,376,376,50,4,46,2,1
3,410,410,126,90,36,4,3

6,107,107,13,13,0,1,0
8,229,229,43,10,33,2,1
1,288,288,126,52,74,3,2
2,351,351,57,21,36,2,1
4,375,375,37,37,0,1,0
3,450,450,33,15,18,4,3
7,464,464,45,21,24,4,3
5,478,478,17,17,0,1,0
0,500,500,1,1,0,1,0

9,103,103,13,13,0,1,0
3,131,131,13,13,0,1,0
2,176,176,19,8,11,2,1
1,197,197,32,32,0,1,0
7,222,222,8,1,7,2,1
0,255,255,5,5,0,1,0
8,276,276,9,9,0,1,0
4,289,289,61,61,0,1,0
5,299,299,68,68,0,1,0
10,326,326,56,14,42,2,1
6,454,454,10,10,0,1,0

6,122,122,9,9,0,1,0
12,153,153,26,17,9,4,3
3,161,161,3,3,0,1,0
5,190,190,26,26,0,1,0
2,191,191,23,23,0,1,0
9,195,195,41,23,18,3,2
11,222,222,10,10,0,1,0
10,282,282,1,1,0,1,0
1,333,333,40,40,0,1,0
8,349,349,54,24,30,3,2
0,359,359,7,2,5,2,1
13,397,397,11,8,3,2,1
7,487,487,44,44,0,1,0
4,498,498,11,11,0,1,0

9,109,109,3,3,0,1,0
1,129,129,13,13,0,1,0
3,142,142,3,3,0,1,0
11,225,225,27,27,0,1,0
0,277,277,6,6,0,1,0
13,282,282,54,54,0,1,0
5,290,290,5,2,3,2,1
4,291,291,1,1,0,1,0
7,321,321,8,8,0,1,0
2,345,345,30,10,20,3,2
6,380,380,14,10,4,2,1
14,380,380,1,1,0,1,0
12,414,414,17,7,10,3,2
8,467,467,135,135,0,1,0
10,482,482,111,76,35,2,1

6,124,124,2,2,0,1,0
2,155,155,4,4,0,1,0
4,171,171,57,33,24,3,2
5,270,270,18,18,0,1,0
7,291,291,24,12,12,4,3
8,315,315,22,22,0,1,0
1,351,351,19,19,0,1,0
3,357,357,23,14,9,4,3
10,376,376,28,18,10,2,1
0,424,424,53,53,0,1,0
9,431,431,131,131,0,1,0

3,111,111,2,2,0,1,0
10,130,130,36,27,9,2,1
0,184,184,7,1,6,3,2
1,224,224,68,68,0,1,0
4,236,236,12,12,0,1,0
9,311,311,34,7,27,2,1
5,313,313,12,12,0,1,0
6,413,413,46,24,22,2,1
8,436,436,28,12,16,3,2
7,459,459,22,6,16,2,1
11,471,471,1,1,0,1,0
2,482,482,74,50,24,4,3

6,129,129,20,20,0,1,0
4,172,172,19,19,0,1,0
8,175,175,31,10,21,4,3
9,176,176,12,12,0,1,0
2,231,231,28,10,18,3,2
5,262,262,11,11,0,1,0
1,318,318,72,72,0,1,0
7,320,320,22,22,0,1,0
3,345,345,19,19,0,1,0
0,384,384,76,24,52,3,2

1,111,111,20,6,14,4,3
2,136,136,26,4,22,2,1
7,155,155,5,5,0,1,0
0,236,236,34,3,31,2,1
6,324,324,23,23,0,1,0
8,347,347,10,2,8,2,1
5,368,368,11,2,9,4,3
10,390,390,5,5,0,1,0
3,474,474,17,17,0,1,0
9,475,475,208,196,12,3,2
4,484,484,24,24,0,1,0

8,102,102,6,6,0,1,0
12,108,108,16,16,0,1,0
2,124,124,1,1,0,1,0
1,175,175,2,2,0,1,0
11,177,177,7,2,5,2,1
10,193,193,31,31,0,1,0
4,203,203,26,26,0,1,0
7,212,212,2,2,0,1,0
9,219,219,5,5,0,1,0
3,402,402,59,59,0,1,0
5,450,450,57,20,37,2,1
13,455,455,84,84,0,1,0
6,473,473,56,36,20,2,1
0,485,485,26,10,16,3,2

1,108,108,1,1,0,1,0
8,130,130,6,6,0,1,0
6,148,148,8,3,5,2,1
16,163,163,9,4,5,2,1
14,182,182,31,31,0,1,0
13,214,214,21,21,0,1,0
15,221,221,3,3,0,1,0
7,252,252,23,23,0,1,0
11,264,264,58,58,0,1,0
12,316,316,18,9,9,2,1
9,323,323,14,14,0,1,0
3,411,411,1,1,0,1,0
5,433,433,71,71,0,1,0
10,436,436,7,2,5,2,1
2,438,438,10,10,0,1,0
4,442,442,42,42,0,1,0
0,484,484,28,2,26,4,3

9,108,108,4,4,0,1,0
6,115,115,17,17,0,1,0
5,133,133,12,6,6,3,2
12,134,134,25,7,18,3,2
3,142,142,2,2,0,1,0
8,197,197,14,14,0,1,0
14,202,202,21,21,0,1,0
11,225,225,17,4,13,2,1
4,233,233,9,9,0,1,0
0,239,239,1,1,0,1,0
7,297,297,31,26,5,2,1
15,334,334,5,5,0,1,0
1,354,354,31,19,12,2,1
13,357,357,70,64,6,2,1
2,429,429,5,5,0,1,0
10,454,454,13,13,0,1,0

11,103,103,3,3,0,1,0
10,125,125,24,24,0,1,0
9,135,135,1,1,0,1,0
7,155,155,12,12,0,1,0
1,248,248,35,27,8,2,1
5,362,362,23,23,0,1,0
2,422,422,8,8,0,1,0
3,447,447,72,72,0,1,0
8,475,475,39,30,9,4,3
0,479,479,22,22,0,1,0
6,490,490,111,86,25,2,1
4,494,494,84,30,54,4,3

6,104,104,6,1,5,2,1
8,175,175,14,5,9,2,1
2,188,188,51,51,0,1,0
1,303,303,39,1,38,2,1
9,311,311,14,2,12,2,1
5,345,345,4,4,0,1,0
4,400,400,35,5,30,3,2
7,406,406,135,135,0,1,0
0,441,441,10,10,0,1,0
3,493,493,88,66,22,2,1

12,176,176,11,11,0,1,0
3,210,210,5,5,0,1,0
6,239,239,17,5,12,3,2
9,281,281,66,9,57,3,2
1,289,289,5,1,4,2,1
4,319,319,3,3,0,1,0
0,336,336,54,54,0,1,0
7,345,345,22,19,3,2,1
5,423,423,28,20,8,3,2
8,461,461,9,3,6,2,1
10,488,488,86,62,24,4,3
2,497,497,125,67,58,4,3
11,499,499,28,28,0,1,0

6,123,123,18,3,15,4,3
1,135,135,15,12,3,2,1
3,180,180,38,38,0,1,0
0,184,184,13,6,7,2,1
4,201,201,22,22,0,1,0
5,240,240,10,2,8,2,1
2,310,310,31,16,15,2,1
7,370,370,6,6,0,1,0
10,433,433,88,83,5,2,1
9,471,471,74,58,16,2,1
8,485,485,21,7,14,3,2

11,115,115,7,7,0,1,0
0,141,141,3,3,0,1,0
15,157,157,10,10,0,1,0
1,170,170,10,10,0,1,0
3,171,171,14,14,0,1,0
7,214,214,4,4,0,1,0
12,222,222,28,28,0,1,0
9,227,227,17,17,0,1,0
13,235,235,18,18,0,1,0
10,268,268,26,26,0,1,0
16,364,364,59,44,15,2,1
14,370,370,49,49,0,1,0
6,410,410,14,6,8,2,1
5,431,431,5,5,0,1,0
4,441,441,54,8,46,3,2
8,482,482,15,10,5,2,1
2,483,483,24,24,0,1,0

9,123,123,12,12,0,1,0
10,144,144,20,10,10,3,2
11,169,169,23,23,0,1,0
3,227,227,13,5,8,2,1
6,264,264,39,3,36,2,1
1,268,268,106,57,49,2,1
5,274,274,6,6,0,1,0
7,283,283,16,3,13,3,2
0,321,321,4,1,3,2,1
2,393,393,20,20,0,1,0
8,468,468,19,7,12,3,2
4,480,480,31,8,23,2,1

11,122,122,12,12,0,1,0
8,132,132,15,7,8,3,2
12,194,194,46,46,0,1,0
6,223,223,34,34,0,1,0
0,237,237,4,4,0,1,0
4,282,282,1,1,0,1,0
2,374,374,17,1,16,3,2
1,377,377,14,14,0,1,0
5,456,456,18,18,0,1,0
3,464,464,142,116,26,3,2
7,471,471,28,12,16,2,1
10,476,476,4,4,0,1,0
9,482,482,44,44,0,1,0

1,139,139,1,1,0,1,0
7,160,160,19,9,10,2,1
14,236,236,41,5,36,4,3
9,240,240,10,10,0,1,0
13,245,245,4,4,0,1,0
8,267,267,14,7,7,2,1
11,267,267,63,45,18,4,3
3,291,291,42,26,16,2,1
6,319,319,6,6,0,1,0
5,374,374,30,30,0,1,0
0,375,375,35,19,16,4,3
2,386,386,19,10,9,4,3
12,408,408,37,31,6,3,2
10,457,457,23,13,10,4,3
4,462,462,18,7,11,4,3

9,107,107,3,3,0,1,0
8,132,132,19,13,6,3,2
10,132,132,3,3,0,1,0
7,135,135,24,24,0,1,0
4,231,231,33,3,30,2,1
0,252,252,31,31,0,1,0
5,311,311,72,72,0,1,0
6,406,406,9,4,5,2,1
3,460,460,59,38,21,4,3
1,493,493,41,41,0,1,0
2,496,496,63,27,36,4,3

0,126,126,7,7,0,1,0
5,166,166,7,7,0,1,0
12,184,184,13,13,0,1,0
11,193,193,28,28,0,1,0
1,204,204,38,22,16,2,1
2,217,217,4,4,0,1,0
9,259,259,30,30,0,1,0
6,424,424,53,35,18,4,3
7,430,430,79,49,30,4,3
3,438,438,30,24,6,3,2
8,467,467,30,30,0,1,0
4,475,475,50,24,26,2,1
10,493,493,17,1,16,3,2

3,120,120,15,15,0,1,0
6,162,162,26,2,24,3,2
10,168,168,3,3,0,1,0
7,178,178,24,10,14,2,1
11,184,184,41,27,14,3,2
5,226,226,22,8,14,2,1
0,234,234,18,18,0,1,0
8,235,235,25,25,0,1,0
2,354,354,2,2,0,1,0
9,360,360,22,22,0,1,0
12,371,371,26,26,0,1,0
1,378,378,44,35,9,2,1
4,395,395,8,8,0,1,0

11,132,132,1,1,0,1,0
10,135,135,6,6,0,1,0
0,155,155,8,8,0,1,0
5,158,158,17,9,8,2,1
12,166,166,16,9,7,2,1
13,179,179,15,15,0,1,0
8,207,207,10,10,0,1,0
7,263,263,1,1,0,1,0
1,279,279,2,2,0,1,0
9,289,289,27,27,0,1,0
14,306,306,88,28,60,4,3
4,378,378,4,4,0,1,0
6,443,443,67,9,58,3,2
2,472,472,36,36,0,1,0
3,479,479,71,5,66,3,2

8,155,155,11,2,9,4,3
5,157,157,9,3,6,2,1
10,174,174,16,16,0,1,0
7,203,203,37,37,0,1,0
2,208,208,16,6,10,3,2
0,320,320,63,32,31,4,3
6,383,383,66,36,30,3,2
1,418,418,48,48,0,1,0
9,436,436,20,13,7,2,1
4,467,467,1,1,0,1,0
3,468,468,98,47,51,4,3

10,111,111,22,10,12,4,3
2,132,132,16,1,15,2,1
5,147,147,3,3,0,1,0
11,169,169,5,5,0,1,0
7,180,180,26,26,0,1,0
13,186,186,10,10,0,1,0
0,215,215,18,18,0,1,0
6,272,272,1,1,0,1,0
4,274,274,4,4,0,1,0
3,289,289,55,51,4,2,1
12,290,290,13,1,12,4,3
1,327,327,8,8,0,1,0
8,381,381,56,56,0,1,0
9,458,458,62,5,57,4,3

4,106,106,5,1,4,2,1
7,108,108,12,5,7,2,1
9,119,119,9,9,0,1,0
1,232,232,1,1,0,1,0
3,296,296,39,3,36,4,3
8,304,304,19,2,17,2,1
12,328,328,51,20,31,2,1
2,336,336,9,9,0,1,0
6,337,337,1,1,0,1,0
0,358,358,80,80,0,1,0
13,388,388,74,10,64,3,2
11,435,435,40,34,6,3,2
10,470,470,17,2,15,3,2
5,483,483,27,6,21,4,3

4,188,188,1,1,0,1,0
0,199,199,31,31,0,1,0
6,321,321,38,16,22,3,2
3,339,339,12,12,0,1,0
7,342,342,89,25,64,3,2
2,395,395,92,92,0,1,0
5,446,446,65,1,64,4,3
1,469,469,100,62,38,4,3
8,500,500,20,20,0,1,0

3,149,149,16,2,14,3,2
1,206,206,50,50,0,1,0
4,218,218,47,47,0,1,0
7,228,228,53,26,27,4,3
9,260,260,10,4,6,3,2
8,268,268,18,2,16,3,2
2,274,274,23,23,0,1,0
6,301,301,16,8,8,3,2
5,412,412,2,2,0,1,0
0,453,453,78,10,68,3,2

5,106,106,11,4,7,2,1
4,118,118,14,14,0,1,0
3,133,133,10,4,6,2,1
8,165,165,10,10,0,1,0
11,171,171,1,1,0,1,0
9,181,181,35,25,10,2,1
6,253,253,28,10,18,4,3
1,297,297,49,49,0,1,0
0,385,385,1,1,0,1,0
7,387,387,4,4,0,1,0
2,402,402,10,10,0,1,0
10,435,435,146,146,0,1,0
12,461,461,1,1,0,1,0

2,168,168,11,11,0,1,0
14,208,208,24,12,12,4,3
9,240,240,19,19,0,1,0
7,274,274,12,2,10,2,1
8,276,276,3,3,0,1,0
15,291,291,50,50,0,1,0
5,300,300,21,21,0,1,0
3,311,311,29,7,22,3,2
11,369,369,71,11,60,4,3
10,373,373,15,3,12,3,2
1,381,381,18,9,9,2,1
4,383,383,40,40,0,1,0
0,396,396,9,2,7,2,1
12,397,397,26,26,0,1,0
13,398,398,9,9,0,1,0
6,472,472,31,27,4,2,1

4,132,132,4,1,3,2,1
3,141,141,15,9,6,3,2
5,164,164,37,11,26,2,1
10,165,165,10,10,0,1,0
8,221,221,29,29,0,1,0
2,289,289,34,4,30,4,3
9,305,305,12,1,11,2,1
0,310,310,29,5,24,3,2
7,375,375,21,10,11,2,1
1,433,433,13,4,9,4,3
6,474,474,121,52,69,4,3
11,475,475,31,13,18,4,3

13,106,106,5,5,0,1,0
14,107,107,10,3,7,2,1
7,123,123,5,1,4,2,1
2,182,182,6,6,0,1,0
12,197,197,14,14,0,1,0
5,231,231,13,13,0,1,0
1,236,236,4,4,0,1,0
9,322,322,105,12,93,4,3
3,334,334,43,20,23,2,1
4,339,339,2,2,0,1,0
10,364,364,2,2,0,1,0
6,429,429,18,18,0,1,0
8,433,433,18,18,0,1,0
11,467,467,36,36,0,1,0
0,469,469,111,111,0,1,0

6,103,103,1,1,0,1,0
11,111,111,6,2,4,2,1
8,145,145,20,20,0,1,0
10,168,168,59,59,0,1,0
3,198,198,66,18,48,4,3
7,215,215,3,3,0,1,0
1,332,332,28,6,22,2,1
12,357,357,1,1,0,1,0
2,361,361,12,12,0,1,0
9,369,369,24,24,0,1,0
5,373,373,8,8,0,1,0
13,396,396,1,1,0,1,0
4,401,401,10,10,0,1,0
0,410,410,34,34,0,1,0

15,106,106,26,9,17,2,1
2,111,111,4,1,3,2,1
6,112,112,1,1,0,1,0
5,161,161,11,2,9,4,3
1,175,175,31,31,0,1,0
12,212,212,27,9,18,4,3
0,217,217,17,17,0,1,0
3,360,360,9,9,0,1,0
10,366,366,6,6,0,1,0
13,368,368,49,49,0,1,0
7,370,370,6,1,5,2,1
9,375,375,36,36,0,1,0
4,383,383,34,30,4,2,1
14,384,384,31,16,15,4,3
11,454,454,5,5,0,1,0
8,474,474,3,3,0,1,0

16,146,146,2,2,0,1,0
8,146,146,2,2,0,1,0
9,170,170,11,11,0,1,0
18,174,174,30,30,0,1,0
5,190,190,28,28,0,1,0
15,209,209,18,18,0,1,0
0,254,254,6,3,3,2,1
1,257,257,14,2,12,2,1
11,261,261,6,6,0,1,0
12,272,272,2,2,0,1,0
2,289,289,20,20,0,1,0
10,304,304,1,1,0,1,0
13,314,314,9,4,5,2,1
7,331,331,17,11,6,2,1
17,335,335,47,47,0,1,0
3,355,355,36,1,35,3,2
4,364,364,1,1,0,1,0
6,381,381,15,3,12,3,2
14,407,407,71,32,39,4,3

4,161,161,15,15,0,1,0
11,186,186,1,1,0,1,0
2,231,231,17,17,0,1,0
1,241,241,58,58,0,1,0
8,241,241,73,35,38,3,2
10,264,264,4,1,3,2,1
0,289,289,6,6,0,1,0
5,299,299,28,14,14,3,2
7,328,328,8,2,6,2,1
12,352,352,90,63,27,4,3
3,364,364,22,11,11,2,1
6,379,379,7,7,0,1,0
9,400,400,4,4,0,1,0

11,114,114,9,3,6,2,1
5,146,146,5,5,0,1,0
10,199,199,3,3,0,1,0
9,220,220,28,2,26,3,2
6,222,222,16,16,0,1,0
13,252,252,36,36,0,1,0
8,298,298,36,36,0,1,0
12,356,356,44,30,14,2,1
2,367,367,41,41,0,1,0
1,368,368,22,17,5,2,1
3,396,396,106,106,0,1,0
7,431,431,1,1,0,1,0
4,455,455,11,11,0,1,0
0,488,488,14,6,8,3,2

2,101,101,22,22,0,1,0
9,116,116,4,4,0,1,0
5,189,189,6,6,0,1,0
10,205,205,39,13,26,3,2
7,241,241,36,36,0,1,0
3,281,281,62,62,0,1,0
1,372,372,6,6,0,1,0
6,389,389,7,7,0,1,0
0,390,390,37,37,0,1,0
8,472,472,91,91,0,1,0
4,486,486,25,7,18,4,3

10,131,131,8,8,0,1,0
3,187,187,40,24,16,4,3
7,212,212,26,26,0,1,0
9,217,217,50,20,30,3,2
4,237,237,2,2,0,1,0
8,273,273,17,5,12,3,2
5,285,285,30,14,16,2,1
1,326,326,71,60,11,2,1
0,343,343,37,22,15,4,3
6,385,385,11,11,0,1,0
2,466,466,25,6,19,3,2

10,117,117,1,1,0,1,0
9,155,155,4,4,0,1,0
5,163,163,14,14,0,1,0
1,166,166,15,15,0,1,0
7,220,220,66,66,0,1,0
4,250,250,38,7,31,2,1
8,268,268,5,5,0,1,0
6,297,297,5,2,3,2,1
2,384,384,19,19,0,1,0
0,396,396,62,62,0,1,0
3,427,427,22,22,0,1,0
12,462,462,1,1,0,1,0
11,472,472,121,121,0,1,0

1,168,168,98,89,9,4,3
5,168,168,19,19,0,1,0
4,190,190,18,18,0,1,0
6,278,278,28,28,0,1,0
3,387,387,67,48,19,2,1
0,388,388,2,2,0,1,0
2,417,417,5,5,0,1,0
7,417,417,13,13,0,1,0
8,463,463,46,46,0,1,0

9,131,131,1,1,0,1,0
6,145,145,7,1,6,3,2
14,146,146,23,17,6,3,2
4,152,152,2,2,0,1,0
1,153,153,8,2,6,3,2
8,176,176,2,2,0,1,0
7,181,181,19,14,5,2,1
11,184,184,15,15,0,1,0
0,304,304,57,57,0,1,0
5,304,304,1,1,0,1,0
13,323,323,30,30,0,1,0
2,342,342,46,18,28,2,1
12,424,424,74,30,44,2,1
10,434,434,43,43,0,1,0
3,459,459,21,21,0,1,0

8,116,116,6,6,0,1,0
14,159,159,10,10,0,1,0
2,166,166,2,2,0,1,0
6,167,167,41,41,0,1,0
11,167,167,2,2,0,1,0
7,182,182,1,1,0,1,0
3,223,223,3,3,0,1,0
0,231,231,16,13,3,2,1
4,314,314,37,7,30,3,2
9,325,325,67,23,44,4,3
1,399,399,4,4,0,1,0
10,466,466,23,4,19,2,1
12,468,468,2,2,0,1,0
5,480,480,37,4,33,2,1
13,488,488,136,136,0,1,0

6,162,162,14,14,0,1,0
4,179,179,1,1,0,1,0
0,205,205,17,1,16,3,2
2,227,227,41,11,30,3,2
9,279,279,35,16,19,2,1
3,348,348,82,82,0,1,0
5,356,356,4,4,0,1,0
8,381,381,19,6,13,2,1
1,425,425,42,42,0,1,0
7,447,447,56,47,9,4,3
10,488,488,103,56,47,4,3

11,121,121,11,11,0,1,0
10,144,144,1,1,0,1,0
2,179,179,1,1,0,1,0
6,205,205,15,15,0,1,0
1,237,237,44,44,0,1,0
8,297,297,13,13,0,1,0
0,324,324,17,3,14,3,2
7,345,345,30,16,14,2,1
5,362,362,23,1,22,2,1
4,377,377,33,33,0,1,0
3,417,417,20,20,0,1,0
13,431,431,17,5,12,2,1
12,488,488,92,2,90,4,3
9,500,500,123,123,0,1,0

1,114,114,20,20,0,1,0
5,124,124,2,2,0,1,0
8,127,127,8,2,6,3,2
9,156,156,11,11,0,1,0
12,220,220,23,23,0,1,0
7,230,230,13,1,12,2,1
4,305,305,29,6,23,2,1
13,330,330,95,55,40,4,3
10,339,339,1,1,0,1,0
11,340,340,30,30,0,1,0
2,394,394,1,1,0,1,0
0,420,420,7,7,0,1,0
3,449,449,13,2,11,2,1
6,467,467,99,45,54,4,3

5,158,158,12,12,0,1,0
10,167,167,2,2,0,1,0
4,223,223,76,37,39,2,1
6,274,274,28,28,0,1,0
7,280,280,38,38,0,1,0
0,313,313,15,15,0,1,0
11,356,356,40,8,32,3,2
3,370,370,11,2,9,4,3
9,400,400,60,60,0,1,0
8,401,401,41,21,20,3,2
2,407,407,31,6,25,2,1
1,481,481,17,12,5,2,1

10,115,115,4,1,3,2,1
5,141,141,25,25,0,1,0
4,148,148,18,15,3,2,1
1,227,227,40,40,0,1,0
6,232,232,18,18,0,1,0
3,348,348,43,43,0,1,0
7,373,373,91,81,10,2,1
8,416,416,9,9,0,1,0
9,419,419,27,27,0,1,0
0,422,422,65,3,62,3,2
2,486,486,15,3,12,3,2

5,113,113,7,1,6,3,2
6,136,136,5,5,0,1,0
1,140,140,5,5,0,1,0
0,206,206,12,12,0,1,0
2,228,228,30,1,29,2,1
13,285,285,71,26,45,4,3
12,291,291,49,3,46,4,3
8,301,301,17,11,6,2,1
4,342,342,32,19,13,2,1
10,394,394,3,3,0,1,0
7,412,412,44,44,0,1,0
3,414,414,32,1,31,4,3
11,454,454,7,7,0,1,0
9,455,455,50,8,42,3,2

5,195,195,3,3,0,1,0
0,208,208,13,13,0,1,0
6,210,210,16,16,0,1,0
9,214,214,80,11,69,4,3
7,230,230,16,3,13,3,2
8,352,352,9,9,0,1,0
1,384,384,167,91,76,3,2
2,409,409,40,22,18,2,1
3,472,472,3,3,0,1,0
4,474,474,23,9,14,2,1

2,112,112,1,1,0,1,0
7,171,171,15,11,4,2,1
0,194,194,35,35,0,1,0
6,213,213,44,24,20,3,2
10,220,220,4,4,0,1,0
8,269,269,40,40,0,1,0
3,319,319,19,3,16,3,2
5,348,348,1,1,0,1,0
1,376,376,88,40,48,4,3
9,390,390,45,45,0,1,0
11,394,394,15,15,0,1,0
4,472,472,54,9,45,4,3

7,114,114,5,2,3,2,1
1,129,129,8,8,0,1,0
13,133,133,1,1,0,1,0
0,142,142,1,1,0,1,0
3,149,149,9,2,7,2,1
14,225,225,46,46,0,1,0
4,238,238,65,65,0,1,0
2,251,251,13,13,0,1,0
12,297,297,4,4,0,1,0
11,310,310,44,38,6,3,2
5,332,332,6,1,5,2,1
15,345,345,1,1,0,1,0
10,358,358,7,2,5,2,1
6,395,395,16,3,13,2,1
9,396,396,2,2,0,1,0
8,460,460,9,9,0,1,0
16,460,460,113,113,0,1,0

2,122,122,5,1,4,2,1
11,141,141,31,14,17,2,1
4,145,145,21,9,12,4,3
1,163,163,14,4,10,3,2
6,165,165,14,14,0,1,0
10,165,165,18,18,0,1,0
5,189,189,8,1,7,3,2
8,234,234,16,7,9,4,3
0,260,260,10,10,0,1,0
12,264,264,33,15,18,2,1
7,325,325,11,11,0,1,0
9,396,396,23,23,0,1,0
3,445,445,58,42,16,2,1
13,479,479,15,6,9,2,1

7,100,100,14,14,0,1,0
0,201,201,4,4,0,1,0
1,255,255,64,10,54,3,2
4,280,280,35,35,0,1,0
5,287,287,18,1,17,2,1
6,293,293,44,4,40,3,2
2,337,337,68,36,32,2,1
9,363,363,50,42,8,2,1
3,374,374,2,2,0,1,0
10,376,376,39,39,0,1,0
8,394,394,6,6,0,1,0

7,109,109,1,1,0,1,0
4,146,146,1,1,0,1,0
2,257,257,2,2,0,1,0
0,268,268,12,12,0,1,0
9,308,308,15,3,12,2,1
6,353,353,98,35,63,4,3
8,412,412,13,1,12,3,2
11,419,419,77,77,0,1,0
3,445,445,51,3,48,4,3
12,454,454,81,81,0,1,0
1,468,468,62,62,0,1,0
10,470,470,74,36,38,3,2
5,483,483,8,8,0,1,0

0,104,104,18,18,0,1,0
1,172,172,2,2,0,1,0
9,185,185,15,15,0,1,0
5,214,214,18,18,0,1,0
3,223,223,21,16,5,2,1
7,257,257,56,50,6,3,2
2,262,262,38,38,0,1,0
10,312,312,30,30,0,1,0
11,434,434,13,3,10,2,1
6,439,439,49,5,44,3,2
8,465,465,35,21,14,2,1
4,498,498,46,16,30,4,3

3,107,107,26,26,0,1,0
0,169,169,4,4,0,1,0
10,205,205,31,3,28,3,2
5,226,226,23,2,21,2,1
4,231,231,40,9,31,4,3
1,233,233,15,15,0,1,0
7,233,233,11,1,10,3,2
2,276,276,27,27,0,1,0
6,324,324,47,30,17,2,1
9,347,347,19,3,16,2,1
8,457,457,54,43,11,2,1

10,148,148,3,3,0,1,0
6,166,166,4,4,0,1,0
11,214,214,32,8,24,3,2
5,223,223,65,16,49,2,1
8,262,262,39,31,8,3,2
9,278,278,20,20,0,1,0
1,287,287,24,11,13,3,2
3,313,313,10,4,6,2,1
2,320,320,17,2,15,4,3
7,320,320,63,63,0,1,0
0,339,339,4,4,0,1,0
4,401,401,53,53,0,1,0

12,114,114,18,18,0,1,0
5,120,120,10,1,9,4,3
11,136,136,21,21,0,1,0
9,177,177,2,2,0,1,0
8,178,178,10,10,0,1,0
0,212,212,1,1,0,1,0
10,219,219,9,1,8,2,1
6,255,255,16,11,5,2,1
13,285,285,19,19,0,1,0
3,295,295,20,4,16,3,2
1,326,326,8,4,4,2,1
2,349,349,15,15,0,1,0
14,473,473,86,39,47,2,1
4,477,477,59,20,39,2,1
7,492,492,67,67,0,1,0

0,122,122,27,15,12,2,1
1,157,157,9,2,7,2,1
8,181,181,7,7,0,1,0
9,221,221,8,2,6,3,2
7,231,231,48,17,31,4,3
6,254,254,27,23,4,2,1
10,256,256,28,18,10,3,2
3,268,268,67,18,49,2,1
5,380,380,42,2,40,2,1
4,389,389,6,2,4,2,1
2,413,413,24,24,0,1,0

5,151,151,2,2,0,1,0
10,152,152,9,5,4,2,1
8,209,209,2,2,0,1,0
7,220,220,63,3,60,4,3
9,302,302,10,10,0,1,0
2,351,351,7,4,3,2,1
1,356,356,52,9,43,2,1
6,369,369,6,6,0,1,0
4,414,414,41,1,40,2,1
12,415,415,2,2,0,1,0
0,432,432,33,33,0,1,0
3,492,492,113,42,71,4,3
11,497,497,107,107,0,1,0

6,119,119,1,1,0,1,0
10,123,123,6,6,0,1,0
4,226,226,21,2,19,2,1
2,264,264,15,11,4,2,1
11,275,275,69,43,26,3,2
8,289,289,9,9,0,1,0
12,304,304,35,5,30,4,3
1,306,306,43,43,0,1,0
13,345,345,6,6,0,1,0
7,355,355,31,31,0,1,0
5,434,434,8,8,0,1,0
9,435,435,68,32,36,3,2
14,438,438,11,5,6,2,1
3,487,487,39,24,15,2,1
0,493,493,42,42,0,1,0

11,156,156,39,10,29,4,3
0,157,157,1,1,0,1,0
10,162,162,12,4,8,2,1
14,201,201,4,4,0,1,0
12,221,221,12,12,0,1,0
3,228,228,35,23,12,3,2
13,245,245,29,17,12,2,1
9,253,253,25,7,18,2,1
7,308,308,1,1,0,1,0
1,310,310,84,84,0,1,0
4,375,375,3,3,0,1,0
8,385,385,11,11,0,1,0
5,394,394,37,21,16,3,2
6,419,419,13,13,0,1,0
2,475,475,3,3,0,1,0

6,109,109,14,14,0,1,0
7,130,130,7,2,5,2,1
2,155,155,6,6,0,1,0
11,158,158,33,12,21,2,1
0,164,164,5,5,0,1,0
12,184,184,4,1,3,2,1
10,185,185,52,34,18,3,2
1,238,238,50,50,0,1,0
9,297,297,1,1,0,1,0
5,306,306,9,9,0,1,0
8,346,346,16,1,15,4,3
4,438,438,26,8,18,2,1
3,483,483,54,27,27,4,3

10,121,121,2,2,0,1,0
7,158,158,6,6,0,1,0
16,187,187,41,41,0,1,0
4,190,190,1,1,0,1,0
19,201,201,29,29,0,1,0
15,232,232,15,6,9,3,2
9,256,256,1,1,0,1,0
18,313,313,36,36,0,1,0
12,326,326,1,1,0,1,0
0,355,355,113,113,0,1,0
11,359,359,5,5,0,1,0
3,384,384,4,4,0,1,0
17,384,384,3,3,0,1,0
5,385,385,14,14,0,1,0
1,433,433,33,11,22,3,2
2,437,437,7,4,3,2,1
8,455,455,4,4,0,1,0
13,462,462,16,10,6,2,1
14,483,483,29,29,0,1,0
6,486,486,10,1,9,3,2

1,111,111,10,2,8,3,2
9,124,124,6,3,3,2,1
0,161,161,4,4,0,1,0
8,228,228,10,10,0,1,0
12,236,236,28,4,24,2,1
7,240,240,5,5,0,1,0
3,255,255,46,9,37,2,1
5,292,292,14,4,10,2,1
6,304,304,4,4,0,1,0
2,315,315,55,4,51,4,3
11,333,333,5,5,0,1,0
4,374,374,19,19,0,1,0
10,392,392,94,67,27,4,3
13,459,459,67,67,0,1,0

10,103,103,7,7,0,1,0
2,123,123,4,4,0,1,0
5,147,147,5,5,0,1,0
0,202,202,42,10,32,2,1
1,206,206,5,5,0,1,0
12,227,227,1,1,0,1,0
9,242,242,30,30,0,1,0
7,248,248,32,26,6,3,2
11,265,265,88,88,0,1,0
4,299,299,18,13,5,2,1
3,311,311,7,7,0,1,0
8,316,316,11,11,0,1,0
13,386,386,19,1,18,3,2
6,432,432,39,21,18,2,1

13,130,130,7,7,0,1,0
8,131,131,11,2,9,4,3
5,179,179,8,3,5,2,1
4,183,183,2,2,0,1,0
3,190,190,6,3,3,2,1
2,210,210,4,4,0,1,0
15,234,234,44,36,8,3,2
10,246,246,1,1,0,1,0
1,337,337,34,25,9,4,3
0,338,338,46,10,36,4,3
6,346,346,43,26,17,2,1
12,372,372,13,13,0,1,0
7,389,389,4,4,0,1,0
14,394,394,34,3,31,2,1
9,398,398,16,10,6,2,1
11,413,413,101,93,8,3,2

7,140,140,24,24,0,1,0
0,164,164,41,41,0,1,0
10,164,164,14,14,0,1,0
2,187,187,49,5,44,2,1
9,218,218,3,3,0,1,0
3,225,225,4,4,0,1,0
5,256,256,8,8,0,1,0
11,349,349,9,9,0,1,0
1,414,414,1,1,0,1,0
6,416,416,112,29,83,4,3
8,489,489,26,26,0,1,0
4,499,499,19,1,18,4,3

6,122,122,3,3,0,1,0
4,123,123,1,1,0,1,0
9,157,157,25,4,21,2,1
5,180,180,3,3,0,1,0
14,185,185,17,17,0,1,0
3,194,194,7,4,3,2,1
12,237,237,22,2,20,3,2
10,246,246,5,5,0,1,0
8,247,247,26,26,0,1,0
0,341,341,64,64,0,1,0
13,348,348,47,47,0,1,0
2,357,357,34,34,0,1,0
11,383,383,44,25,19,3,2
7,444,444,38,38,0,1,0
1,457,457,19,6,13,2,1

11,113,113,5,5,0,1,0
9,174,174,26,26,0,1,0
8,219,219,10,10,0,1,0
6,241,241,11,7,4,2,1
10,287,287,7,7,0,1,0
5,305,305,42,42,0,1,0
3,306,306,44,44,0,1,0
4,320,320,5,5,0,1,0
7,327,327,100,91,9,2,1
1,356,356,16,2,14,2,1
0,387,387,61,61,0,1,0
2,409,409,42,42,0,1,0

3,116,116,11,11,0,1,0
7,143,143,11,11,0,1,0
6,145,145,10,1,9,4,3
2,184,184,12,9,3,2,1
8,212,212,7,7,0,1,0
9,251,251,70,1,69,4,3
1,291,291,75,48,27,4,3
4,334,334,5,5,0,1,0
0,397,397,73,35,38,2,1
5,417,417,60,60,0,1,0

12,170,170,4,4,0,1,0
13,177,177,16,16,0,1,0
15,185,185,30,12,18,4,3
6,226,226,18,18,0,1,0
9,247,247,11,4,7,2,1
7,255,255,10,10,0,1,0
1,268,268,2,2,0,1,0
4,279,279,36,22,14,2,1
8,282,282,10,10,0,1,0
3,294,294,42,10,32,3,2
2,336,336,29,6,23,2,1
5,357,357,12,2,10,3,2
10,379,379,98,16,82,3,2
0,464,464,1,1,0,1,0
11,476,476,30,30,0,1,0
14,489,489,8,8,0,1,0

9,115,115,4,4,0,1,0
4,146,146,7,7,0,1,0
0,230,230,9,6,3,2,1
1,242,242,101,89,12,4,3
7,255,255,19,19,0,1,0
11,257,257,17,17,0,1,0
3,266,266,14,14,0,1,0
6,275,275,60,42,18,4,3
5,301,301,6,6,0,1,0
8,316,316,10,10,0,1,0
2,393,393,10,3,7,2,1
10,410,410,76,58,18,4,3

11,105,105,13,13,0,1,0
4,160,160,4,4,0,1,0
12,198,198,37,15,22,3,2
13,215,215,19,19,0,1,0
14,283,283,8,3,5,2,1
9,285,285,48,32,16,3,2
5,320,320,2,2,0,1,0
2,343,343,22,22,0,1,0
3,375,375,23,23,0,1,0
10,379,379,7,7,0,1,0
0,389,389,13,4,9,4,3
1,432,432,109,1,108,4,3
7,459,459,35,17,18,4,3
8,471,471,2,2,0,1,0
6,493,493,38,38,0,1,0

6,101,101,10,4,6,2,1
4,120,120,41,38,3,2,1
8,129,129,34,34,0,1,0
9,130,130,8,8,0,1,0
0,141,141,15,3,12,3,2
10,151,151,21,21,0,1,0
1,182,182,12,5,7,2,1
2,317,317,6,6,0,1,0
7,317,317,16,16,0,1,0
5,363,363,1,1,0,1,0
3,443,443,33,20,13,2,1

4,144,144,4,1,3,2,1
6,183,183,23,11,12,2,1
0,275,275,62,3,59,4,3
7,284,284,41,17,24,2,1
8,289,289,21,9,12,2,1
2,307,307,41,41,0,1,0
5,323,323,47,43,4,2,1
9,333,333,3,3,0,1,0
1,374,374,59,36,23,2,1
10,412,412,46,46,0,1,0
3,458,458,26,26,0,1,0

3,127,127,1,1,0,1,0
4,138,138,9,4,5,2,1
6,147,147,35,7,28,3,2
11,197,197,9,9,0,1,0
1,208,208,9,3,6,2,1
7,212,212,12,12,0,1,0
9,217,217,46,46,0,1,0
8,226,226,5,5,0,1,0
10,297,297,40,24,16,2,1
12,360,360,67,37,30,3,2
2,369,369,14,5,9,2,1
13,402,402,4,4,0,1,0
5,490,490,14,2,12,3,2
0,496,496,62,44,18,4,3

11,121,121,6,2,4,2,1
14,135,135,18,11,7,2,1
4,183,183,1,1,0,1,0
8,188,188,39,33,6,2,1
5,200,200,1,1,0,1,0
0,230,230,1,1,0,1,0
3,242,242,28,1,27,4,3
1,252,252,11,5,6,3,2
2,252,252,11,11,0,1,0
7,253,253,12,12,0,1,0
13,264,264,7,3,4,2,1
6,294,294,21,21,0,1,0
10,303,303,25,25,0,1,0
9,307,307,18,6,12,3,2
12,413,413,50,2,48,4,3
15,431,431,88,88,0,1,0

4,120,120,27,9,18,2,1
8,168,168,14,6,8,2,1
9,220,220,46,46,0,1,0
1,292,292,43,7,36,4,3
0,319,319,27,1,26,2,1
10,434,434,37,37,0,1,0
3,437,437,62,62,0,1,0
6,451,451,24,4,20,4,3
5,463,463,18,5,13,2,1
2,469,469,2,2,0,1,0
7,483,483,69,40,29,2,1

7,109,109,2,2,0,1,0
15,149,149,12,12,0,1,0
13,217,217,3,3,0,1,0
6,219,219,7,2,5,2,1
4,236,236,1,1,0,1,0
0,290,290,15,15,0,1,0
8,314,314,4,4,0,1,0
10,337,337,46,13,33,4,3
2,397,397,33,33,0,1,0
12,401,401,16,6,10,2,1
1,435,435,5,1,4,2,1
9,469,469,47,13,34,3,2
5,474,474,19,12,7,2,1
3,487,487,120,71,49,2,1
11,487,487,92,14,78,4,3
14,498,498,75,51,24,4,3

3,210,210,7,7,0,1,0
5,229,229,20,14,6,3,2
10,233,233,28,6,22,3,2
2,238,238,15,15,0,1,0
9,320,320,18,13,5,2,1
4,322,322,31,31,0,1,0
6,400,400,25,13,12,4,3
8,406,406,51,5,46,3,2
7,464,464,74,74,0,1,0
1,490,490,41,7,34,2,1
0,499,499,162,162,0,1,0

5,172,172,21,21,0,1,0
6,175,175,12,12,0,1,0
4,181,181,26,26,0,1,0
8,224,224,8,4,4,2,1
7,243,243,48,9,39,4,3
2,276,276,1,1,0,1,0
1,277,277,1,1,0,1,0
0,281,281,37,22,15,4,3
10,315,315,48,48,0,1,0
9,355,355,13,13,0,1,0
3,457,457,147,147,0,1,0

1,139,139,3,3,0,1,0
4,145,145,6,6,0,1,0
10,156,156,15,15,0,1,0
6,177,177,2,2,0,1,0
9,192,192,10,2,8,3,2
12,209,209,29,14,15,4,3
8,267,267,48,48,0,1,0
11,310,310,3,3,0,1,0
5,330,330,45,19,26,2,1
14,385,385,16,16,0,1,0
7,402,402,45,10,35,3,2
13,418,418,114,63,51,4,3
2,468,468,26,20,6,2,1
0,481,481,18,18,0,1,0
3,481,481,4,4,0,1,0

0,119,119,4,1,3,2,1
4,123,123,10,10,0,1,0
9,161,161,8,8,0,1,0
5,171,171,13,13,0,1,0
13,189,189,31,31,0,1,0
1,263,263,41,41,0,1,0
10,297,297,74,16,58,3,2
12,312,312,32,8,24,2,1
11,357,357,11,11,0,1,0
6,363,363,8,8,0,1,0
2,415,415,33,33,0,1,0
7,434,434,39,39,0,1,0
8,452,452,6,6,0,1,0
3,484,484,31,19,12,3,2

7,143,143,13,13,0,1,0
8,162,162,1,1,0,1,0
0,176,176,7,7,0,1,0
2,192,192,17,17,0,1,0
13,210,210,46,8,38,3,2
9,226,226,16,16,0,1,0
11,260,260,8,8,0,1,0
12,263,263,25,22,3,2,1
15,270,270,13,13,0,1,0
4,301,301,22,9,13,2,1
16,312,312,50,15,35,2,1
1,432,432,16,7,9,4,3
14,434,434,26,26,0,1,0
5,448,448,40,27,13,2,1
6,453,453,30,30,0,1,0
10,465,465,8,2,6,2,1
3,481,481,11,3,8,3,2

7,102,102,3,3,0,1,0
6,109,109,1,1,0,1,0
12,153,153,25,25,0,1,0
1,173,173,46,2,44,2,1
5,203,203,1,1,0,1,0
10,220,220,20,4,16,2,1
9,233,233,6,6,0,1,0
8,278,278,55,21,34,3,2
11,385,385,23,14,9,4,3
13,389,389,30,30,0,1,0
3,394,394,43,43,0,1,0
4,431,431,56,56,0,1,0
2,458,458,2,2,0,1,0
0,490,490,26,26,0,1,0

11,111,111,10,10,0,1,0
9,169,169,1,1,0,1,0
10,179,179,2,2,0,1,0
4,216,216,38,8,30,4,3
0,250,250,25,13,12,4,3
7,265,265,11,2,9,4,3
6,318,318,77,47,30,4,3
1,332,332,2,2,0,1,0
5,352,352,27,27,0,1,0
8,438,438,96,96,0,1,0
2,457,457,14,2,12,3,2
3,492,492,105,64,41,4,3

4,143,143,1,1,0,1,0
8,232,232,13,4,9,4,3
12,240,240,1,1,0,1,0
7,242,242,20,20,0,1,0
10,254,254,22,22,0,1,0
11,255,255,15,15,0,1,0
2,267,267,43,8,35,2,1
15,270,270,106,46,60,3,2
5,273,273,11,4,7,2,1
14,353,353,20,20,0,1,0
13,378,378,6,6,0,1,0
6,445,445,50,50,0,1,0
0,457,457,8,8,0,1,0
1,468,468,27,27,0,1,0
3,469,469,14,14,0,1,0
9,491,491,18,10,8,3,2

10,126,126,5,5,0,1,0
3,139,139,1,1,0,1,0
0,144,144,4,4,0,1,0
11,187,187,14,14,0,1,0
1,214,214,14,1,13,2,1
9,219,219,5,2,3,2,1
6,254,254,6,6,0,1,0
4,257,257,45,45,0,1,0
13,308,308,27,27,0,1,0
15,335,335,38,2,36,3,2
14,361,361,50,50,0,1,0
2,376,376,5,5,0,1,0
12,399,399,64,45,19,2,1
8,429,429,79,79,0,1,0
7,442,442,22,22,0,1,0
5,451,451,14,14,0,1,0

8,108,108,2,2,0,1,0
3,149,149,2,2,0,1,0
4,186,186,52,46,6,2,1
1,243,243,35,35,0,1,0
7,249,249,26,26,0,1,0
5,354,354,44,44,0,1,0
0,419,419,84,84,0,1,0
2,432,432,111,66,45,4,3
6,474,474,35,35,0,1,0

10,118,118,42,42,0,1,0
11,194,194,1,1,0,1,0
5,196,196,16,16,0,1,0
4,220,220,19,11,8,2,1
0,230,230,38,26,12,4,3
1,256,256,6,6,0,1,0
8,294,294,4,4,0,1,0
2,351,351,53,9,44,3,2
7,394,394,26,6,20,3,2
3,435,435,41,41,0,1,0
9,452,452,42,22,20,4,3
6,492,492,37,17,20,3,2

4,149,149,32,5,27,2,1
9,186,186,28,28,0,1,0
7,190,190,30,9,21,2,1
0,227,227,64,24,40,3,2
6,316,316,1,1,0,1,0
2,358,358,13,1,12,2,1
5,412,412,23,12,11,2,1
8,421,421,14,2,12,4,3
3,432,432,52,26,26,3,2
1,451,451,73,21,52,3,2

3,105,105,4,4,0,1,0
11,135,135,21,8,13,2,1
14,155,155,12,12,0,1,0
0,171,171,3,3,0,1,0
1,199,199,12,5,7,2,1
9,199,199,16,5,11,2,1
12,236,236,6,6,0,1,0
8,291,291,1,1,0,1,0
2,310,310,31,7,24,4,3
4,311,311,10,10,0,1,0
10,360,360,2,2,0,1,0
7,361,361,6,3,3,2,1
5,367,367,43,43,0,1,0
13,376,376,102,66,36,4,3
6,428,428,93,46,47,4,3

5,117,117,3,3,0,1,0
15,119,119,14,14,0,1,0
10,125,125,4,4,0,1,0
12,145,145,4,1,3,2,1
7,183,183,3,3,0,1,0
3,263,263,6,6,0,1,0
6,300,300,20,20,0,1,0
0,303,303,7,1,6,2,1
11,303,303,89,47,42,3,2
14,328,328,47,35,12,3,2
8,340,340,14,14,0,1,0
13,360,360,2,2,0,1,0
2,368,368,39,24,15,2,1
9,413,413,29,5,24,4,3
1,418,418,95,67,28,2,1
4,489,489,1,1,0,1,0

5,248,248,7,7,0,1,0
1,277,277,58,13,45,2,1
10,305,305,11,11,0,1,0
4,349,349,66,30,36,3,2
6,360,360,88,88,0,1,0
2,369,369,10,10,0,1,0
3,373,373,18,18,0,1,0
9,418,418,1,1,0,1,0
7,427,427,19,19,0,1,0
0,437,437,44,35,9,4,3
11,457,457,104,40,64,3,2
8,484,484,27,17,10,3,2

15,131,131,3,3,0,1,0
12,186,186,29,8,21,4,3
11,201,201,6,2,4,2,1
8,243,243,33,33,0,1,0
13,244,244,16,4,12,3,2
17,245,245,1,1,0,1,0
5,255,255,14,14,0,1,0
7,309,309,1,1,0,1,0
1,311,311,1,1,0,1,0
14,322,322,11,4,7,2,1
6,333,333,23,9,14,4,3
16,334,334,111,12,99,4,3
4,372,372,16,11,5,2,1
10,385,385,17,1,16,3,2
0,448,448,22,8,14,3,2
9,455,455,9,9,0,1,0
3,486,486,19,19,0,1,0
2,498,498,56,56,0,1,0

6,113,113,21,21,0,1,0
4,139,139,4,4,0,1,0
5,168,168,9,3,6,2,1
10,194,194,7,7,0,1,0
2,240,240,35,35,0,1,0
7,248,248,1,1,0,1,0
3,310,310,47,17,30,4,3
8,323,323,103,91,12,4,3
9,326,326,5,1,4,2,1
0,362,362,87,87,0,1,0
1,412,412,16,1,15,2,1

0,150,150,3,3,0,1,0
12,154,154,4,4,0,1,0
13,162,162,52,45,7,2,1
1,231,231,26,26,0,1,0
4,236,236,35,35,0,1,0
5,244,244,9,9,0,1,0
14,270,270,6,6,0,1,0
9,280,280,18,18,0,1,0
7,312,312,5,5,0,1,0
15,321,321,36,36,0,1,0
11,332,332,29,29,0,1,0
3,355,355,21,21,0,1,0
10,400,400,17,17,0,1,0
6,427,427,10,4,6,3,2
8,478,478,7,7,0,1,0
2,499,499,54,12,42,2,1

5,121,121,9,3,6,2,1
3,137,137,7,2,5,2,1
0,194,194,30,30,0,1,0
6,205,205,13,13,0,1,0
10,228,228,10,3,7,2,1
4,268,268,17,12,5,2,1
9,270,270,80,34,46,2,1
1,294,294,18,11,7,2,1
7,309,309,5,5,0,1,0
11,362,362,8,8,0,1,0
8,377,377,20,20,0,1,0
2,381,381,45,25,20,3,2
12,450,450,62,14,48,2,1
13,456,456,25,25,0,1,0

6,158,158,26,9,17,2,1
8,195,195,5,5,0,1,0
1,203,203,2,2,0,1,0
2,261,261,7,7,0,1,0
4,288,288,35,17,18,3,2
9,299,299,21,21,0,1,0
10,316,316,25,4,21,4,3
5,442,442,48,23,25,2,1
3,460,460,165,165,0,1,0
7,473,473,74,44,30,3,2
0,482,482,41,15,26,3,2

3,102,102,1,1,0,1,0
10,116,116,8,8,0,1,0
1,129,129,12,3,9,4,3
4,133,133,10,6,4,2,1
0,156,156,58,25,33,4,3
8,190,190,36,24,12,4,3
6,269,269,14,2,12,3,2
11,346,346,23,7,16,2,1
5,373,373,13,13,0,1,0
7,410,410,87,87,0,1,0
9,429,429,10,10,0,1,0
2,451,451,7,7,0,1,0

13,106,106,9,3,6,3,2
1,143,143,20,8,12,3,2
15,169,169,6,6,0,1,0
3,236,236,4,4,0,1,0
14,240,240,75,41,34,3,2
9,274,274,1,1,0,1,0
5,284,284,34,24,10,3,2
6,319,319,34,1,33,2,1
0,348,348,9,9,0,1,0
11,349,349,20,14,6,3,2
8,354,354,1,1,0,1,0
2,367,367,18,18,0,1,0
16,374,374,2,2,0,1,0
12,431,431,53,53,0,1,0
10,445,445,9,6,3,2,1
4,453,453,20,8,12,4,3
7,497,497,36,20,16,2,1

9,199,199,56,8,48,4,3
3,216,216,15,10,5,2,1
11,223,223,6,6,0,1,0
1,276,276,55,55,0,1,0
7,276,276,6,6,0,1,0
10,321,321,17,17,0,1,0
5,339,339,52,52,0,1,0
6,373,373,32,32,0,1,0
2,374,374,12,12,0,1,0
8,409,409,59,26,33,2,1
4,433,433,18,18,0,1,0
0,478,478,51,4,47,2,1

8,102,102,2,2,0,1,0
12,177,177,1,1,0,1,0
2,218,218,53,4,49,4,3
6,270,270,22,22,0,1,0
0,354,354,5,5,0,1,0
4,357,357,36,7,29,2,1
5,391,391,16,13,3,2,1
1,435,435,43,43,0,1,0
10,443,443,17,17,0,1,0
11,447,447,56,18,38,2,1
3,480,480,11,5,6,2,1
9,492,492,204,204,0,1,0
7,495,495,6,6,0,1,0

9,113,113,9,9,0,1,0
2,136,136,18,6,12,4,3
6,184,184,3,3,0,1,0
1,210,210,22,2,20,3,2
3,210,210,7,7,0,1,0
7,211,211,1,1,0,1,0
10,280,280,22,14,8,3,2
11,312,312,7,4,3,2,1
5,358,358,53,53,0,1,0
4,384,384,51,51,0,1,0
8,430,430,176,125,51,4,3
0,469,469,24,24,0,1,0

1,107,107,13,13,0,1,0
0,143,143,7,4,3,2,1
8,146,146,19,19,0,1,0
11,153,153,6,6,0,1,0
10,204,204,27,11,16,2,1
7,222,222,19,10,9,4,3
3,232,232,5,5,0,1,0
12,266,266,43,43,0,1,0
13,285,285,26,4,22,2,1
6,300,300,4,4,0,1,0
9,330,330,11,11,0,1,0
4,335,335,15,15,0,1,0
5,355,355,6,6,0,1,0
2,357,357,31,31,0,1,0
15,360,360,62,62,0,1,0
14,440,440,8,8,0,1,0

7,138,138,17,17,0,1,0
11,139,139,55,25,30,3,2
0,197,197,41,41,0,1,0
6,216,216,1,1,0,1,0
10,279,279,14,14,0,1,0
2,293,293,66,66,0,1,0
4,360,360,15,3,12,2,1
1,379,379,20,12,8,3,2
3,391,391,13,1,12,4,3
5,429,429,17,17,0,1,0
9,450,450,3,3,0,1,0
8,451,451,16,16,0,1,0

4,106,106,11,11,0,1,0
12,106,106,18,8,10,3,2
15,179,179,18,12,6,3,2
13,183,183,17,17,0,1,0
5,204,204,7,4,3,2,1
10,240,240,7,1,6,2,1
1,242,242,15,15,0,1,0
7,266,266,27,27,0,1,0
11,296,296,62,62,0,1,0
0,324,324,5,5,0,1,0
9,333,333,13,4,9,2,1
6,340,340,14,14,0,1,0
2,343,343,23,23,0,1,0
8,345,345,28,28,0,1,0
3,384,384,21,21,0,1,0
14,402,402,6,6,0,1,0

10,101,101,4,4,0,1,0
1,127,127,2,2,0,1,0
4,187,187,3,3,0,1,0
2,229,229,26,5,21,4,3
6,234,234,11,2,9,2,1
7,348,348,99,99,0,1,0
0,359,359,125,28,97,4,3
11,362,362,47,13,34,2,1
9,368,368,3,3,0,1,0
3,395,395,25,25,0,1,0
5,419,419,19,19,0,1,0
8,492,492,51,51,0,1,0

4,117,117,9,9,0,1,0
9,139,139,19,11,8,2,1
10,177,177,3,3,0,1,0
8,197,197,25,3,22,3,2
6,198,198,31,31,0,1,0
0,254,254,40,28,12,4,3
5,263,263,16,6,10,3,2
2,381,381,32,18,14,2,1
7,398,398,47,47,0,1,0
3,452,452,59,59,0,1,0
1,489,489,74,6,68,4,3

10,124,124,11,11,0,1,0
15,150,150,30,30,0,1,0
12,185,185,2,2,0,1,0
3,188,188,20,12,8,3,2
5,200,200,6,6,0,1,0
1,202,202,9,9,0,1,0
9,226,226,39,39,0,1,0
8,254,254,6,6,0,1,0
13,288,288,2,2,0,1,0
4,305,305,12,2,10,3,2
2,363,363,27,14,13,2,1
0,408,408,6,6,0,1,0
6,422,422,25,25,0,1,0
11,434,434,65,37,28,2,1
7,472,472,18,18,0,1,0
14,487,487,78,78,0,1,0

0,125,125,15,3,12,2,1
9,294,294,8,4,4,2,1
5,319,319,62,8,54,3,2
6,341,341,29,15,14,2,1
1,417,417,124,114,10,3,2
4,442,442,82,75,7,2,1
8,481,481,14,7,7,2,1
2,485,485,88,75,13,2,1
7,496,496,42,26,16,2,1
3,499,499,1,1,0,1,0

6,149,149,33,33,0,1,0
9,154,154,11,7,4,2,1
5,163,163,5,5,0,1,0
0,218,218,14,4,10,2,1
8,254,254,42,42,0,1,0
3,274,274,66,66,0,1,0
2,342,342,14,14,0,1,0
7,367,367,48,48,0,1,0
4,383,383,55,55,0,1,0
11,447,447,4,1,3,2,1
10,478,478,8,8,0,1,0
1,500,500,40,40,0,1,0

11,108,108,25,3,22,2,1
10,139,139,3,3,0,1,0
2,186,186,24,19,5,2,1
7,207,207,35,35,0,1,0
1,255,255,29,2,27,4,3
6,278,278,17,17,0,1,0
0,297,297,67,9,58,4,3
8,372,372,20,20,0,1,0
3,388,388,21,3,18,3,2
9,403,403,31,2,29,4,3
4,407,407,16,16,0,1,0
5,428,428,17,17,0,1,0

3,131,131,10,10,0,1,0
4,227,227,5,5,0,1,0
1,233,233,80,56,24,3,2
7,235,235,15,7,8,3,2
0,283,283,11,11,0,1,0
5,343,343,44,12,32,2,1
2,407,407,50,50,0,1,0
9,426,426,22,22,0,1,0
10,438,438,45,45,0,1,0
6,440,440,102,20,82,3,2
8,459,459,14,14,0,1,0

9,129,129,8,2,6,3,2
8,138,138,24,24,0,1,0
1,144,144,18,9,9,2,1
10,163,163,6,1,5,2,1
5,186,186,49,49,0,1,0
4,272,272,50,26,24,3,2
0,275,275,63,63,0,1,0
3,309,309,5,5,0,1,0
2,345,345,17,17,0,1,0
7,467,467,12,4,8,3,2
6,495,495,26,26,0,1,0

7,142,142,14,14,0,1,0
9,189,189,2,2,0,1,0
10,266,266,4,4,0,1,0
4,292,292,43,29,14,3,2
8,329,329,18,9,9,2,1
2,383,383,1,1,0,1,0
3,383,383,45,3,42,4,3
6,405,405,2,2,0,1,0
0,416,416,55,28,27,2,1
11,437,437,184,184,0,1,0
5,470,470,46,46,0,1,0
1,487,487,48,38,10,2,1
12,494,494,4,4,0,1,0

11,102,102,4,1,3,2,1
1,118,118,6,6,0,1,0
6,121,121,18,18,0,1,0
0,136,136,32,5,27,4,3
8,160,160,3,3,0,1,0
2,180,180,12,12,0,1,0
4,357,357,12,3,9,4,3
7,377,377,66,21,45,3,2
9,420,420,86,64,22,2,1
3,421,421,81,49,32,2,1
10,430,430,14,14,0,1,0
5,480,480,11,3,8,3,2

17,159,159,25,1,24,2,1
1,231,231,1,1,0,1,0
14,244,244,36,8,28,2,1
10,249,249,23,23,0,1,0
8,253,253,4,4,0,1,0
5,265,265,25,5,20,2,1
6,290,290,22,22,0,1,0
3,298,298,18,2,16,4,3
13,311,311,6,6,0,1,0
2,324,324,34,22,12,2,1
0,349,349,6,6,0,1,0
4,385,385,1,1,0,1,0
15,397,397,101,13,88,3,2
7,399,399,6,6,0,1,0
9,430,430,19,8,11,2,1
11,471,471,35,22,13,2,1
12,471,471,9,9,0,1,0
16,476,476,5,2,3,2,1

13,143,143,21,21,0,1,0
2,145,145,4,4,0,1,0
11,193,193,21,6,15,4,3
3,224,224,5,5,0,1,0
1,249,249,48,6,42,3,2
12,260,260,18,18,0,1,0
15,271,271,55,40,15,4,3
6,291,291,4,1,3,2,1
8,307,307,5,2,3,2,1
10,322,322,1,1,0,1,0
9,338,338,21,14,7,2,1
14,349,349,28,28,0,1,0
0,385,385,39,39,0,1,0
4,397,397,40,12,28,3,2
5,481,481,3,3,0,1,0
7,482,482,28,28,0,1,0

1,149,149,5,5,0,1,0
8,163,163,9,9,0,1,0
15,163,163,5,5,0,1,0
14,166,166,32,14,18,2,1
6,176,176,16,16,0,1,0
13,206,206,24,24,0,1,0
10,207,207,11,11,0,1,0
7,253,253,10,6,4,2,1
3,267,267,15,9,6,2,1
12,284,284,38,14,24,3,2
0,311,311,3,3,0,1,0
4,313,313,54,54,0,1,0
5,317,317,18,9,9,2,1
11,343,343,29,7,22,3,2
2,369,369,31,31,0,1,0
9,434,434,1,1,0,1,0

11,107,107,26,2,24,4,3
10,113,113,13,13,0,1,0
6,117,117,28,10,18,4,3
1,186,186,7,4,3,2,1
8,207,207,1,1,0,1,0
2,224,224,27,27,0,1,0
3,245,245,25,15,10,3,2
12,268,268,34,34,0,1,0
9,271,271,13,1,12,2,1
7,318,318,5,2,3,2,1
0,326,326,18,18,0,1,0
5,365,365,1,1,0,1,0
14,373,373,1,1,0,1,0
4,448,448,10,1,9,4,3
13,488,488,40,32,8,2,1

2,116,116,12,3,9,4,3
0,148,148,6,6,0,1,0
12,162,162,12,4,8,2,1
10,207,207,33,17,16,2,1
7,230,230,1,1,0,1,0
15,241,241,10,3,7,2,1
11,249,249,4,4,0,1,0
14,304,304,52,6,46,3,2
4,311,311,28,4,24,4,3
8,326,326,15,7,8,3,2
13,343,343,53,53,0,1,0
1,350,350,9,9,0,1,0
3,370,370,8,8,0,1,0
9,388,388,2,2,0,1,0
6,409,409,83,36,47,4,3
5,415,415,25,20,5,2,1

3,177,177,1,1,0,1,0
1,181,181,4,4,0,1,0
2,249,249,14,14,0,1,0
6,274,274,26,26,0,1,0
9,278,278,48,48,0,1,0
10,278,278,26,8,18,4,3
8,283,283,10,5,5,2,1
4,298,298,15,3,12,4,3
7,367,367,55,22,33,4,3
0,404,404,70,70,0,1,0
5,416,416,122,18,104,4,3
11,454,454,30,17,13,2,1

7,105,105,3,3,0,1,0
10,148,148,20,8,12,2,1
5,187,187,4,4,0,1,0
6,188,188,23,23,0,1,0
0,265,265,43,43,0,1,0
2,284,284,16,16,0,1,0
11,285,285,9,9,0,1,0
3,308,308,59,59,0,1,0
12,326,326,107,107,0,1,0
4,333,333,1,1,0,1,0
1,383,383,18,18,0,1,0
9,414,414,33,33,0,1,0
8,428,428,5,5,0,1,0

4,114,114,11,4,7,2,1
7,121,121,10,10,0,1,0
10,141,141,16,16,0,1,0
14,153,153,4,4,0,1,0
2,184,184,26,26,0,1,0
8,193,193,2,2,0,1,0
6,206,206,5,1,4,2,1
1,211,211,17,6,11,2,1
3,292,292,9,1,8,2,1
11,369,369,22,12,10,3,2
12,386,386,24,24,0,1,0
9,393,393,80,80,0,1,0
5,457,457,25,4,21,2,1
0,467,467,37,8,29,2,1
13,493,493,71,71,0,1,0

8,103,103,1,1,0,1,0
9,130,130,2,2,0,1,0
4,145,145,4,1,3,2,1
11,170,170,19,1,18,4,3
1,207,207,5,5,0,1,0
3,238,238,5,5,0,1,0
6,254,254,61,61,0,1,0
0,309,309,43,43,0,1,0
12,329,329,97,97,0,1,0
14,386,386,13,3,10,3,2
13,424,424,59,59,0,1,0
5,438,438,8,8,0,1,0
2,459,459,17,14,3,2,1
10,474,474,8,8,0,1,0
7,487,487,43,15,28,2,1

8,181,181,11,11,0,1,0
3,193,193,24,24,0,1,0
10,207,207,27,27,0,1,0
2,231,231,2,2,0,1,0
1,311,311,103,69,34,2,1
6,323,323,13,13,0,1,0
5,327,327,13,13,0,1,0
11,336,336,48,48,0,1,0
7,375,375,1,1,0,1,0
9,417,417,68,18,50,3,2
4,439,439,19,19,0,1,0
12,465,465,52,29,23,2,1
0,475,475,6,6,0,1,0

4,120,120,24,4,20,2,1
0,142,142,13,13,0,1,0
5,244,244,11,2,9,4,3
8,274,274,70,70,0,1,0
3,304,304,4,4,0,1,0
1,315,315,59,59,0,1,0
7,320,320,31,5,26,2,1
6,448,448,2,2,0,1,0
2,476,476,153,129,24,4,3

9,117,117,11,11,0,1,0
12,129,129,6,6,0,1,0
6,147,147,9,9,0,1,0
3,156,156,16,4,12,4,3
0,190,190,24,24,0,1,0
8,210,210,40,40,0,1,0
2,235,235,1,1,0,1,0
10,248,248,1,1,0,1,0
5,255,255,43,10,33,2,1
11,379,379,17,1,16,2,1
1,409,409,2,2,0,1,0
4,460,460,63,36,27,4,3
7,463,463,109,11,98,4,3

7,137,137,2,2,0,1,0
9,144,144,27,27,0,1,0
5,154,154,11,5,6,2,1
1,289,289,54,17,37,2,1
3,318,318,10,5,5,2,1
4,337,337,53,32,21,4,3
0,372,372,118,56,62,3,2
2,399,399,26,20,6,2,1
6,463,463,65,39,26,2,1
8,494,494,19,19,0,1,0

6,159,159,10,10,0,1,0
5,191,191,46,22,24,2,1
10,214,214,24,19,5,2,1
4,268,268,27,27,0,1,0
3,287,287,2,2,0,1,0
9,296,296,34,29,5,2,1
7,310,310,6,3,3,2,1
2,334,334,8,8,0,1,0
0,382,382,83,75,8,2,1
1,434,434,109,57,52,3,2
8,439,439,26,11,15,4,3

7,122,122,7,1,6,2,1
11,140,140,25,25,0,1,0
5,148,148,5,5,0,1,0
1,204,204,25,10,15,4,3
8,215,215,2,2,0,1,0
13,338,338,31,9,22,3,2
2,357,357,1,1,0,1,0
0,361,361,18,8,10,2,1
10,397,397,5,5,0,1,0
4,411,411,25,8,17,3,2
14,430,430,51,51,0,1,0
9,439,439,26,26,0,1,0
15,445,445,28,24,4,2,1
12,449,449,66,53,13,2,1
6,476,476,84,84,0,1,0
3,487,487,14,11,3,2,1

1,211,211,39,39,0,1,0
4,211,211,28,16,12,2,1
5,216,216,44,44,0,1,0
0,287,287,17,17,0,1,0
8,295,295,31,10,21,4,3
3,316,316,44,2,42,3,2
9,396,396,10,10,0,1,0
6,450,450,48,5,43,2,1
2,451,451,99,76,23,3,2
7,499,499,19,2,17,2,1

15,112,112,10,10,0,1,0
14,129,129,14,14,0,1,0
13,136,136,23,23,0,1,0
3,229,229,1,1,0,1,0
4,230,230,24,2,22,3,2
0,233,233,2,2,0,1,0
11,265,265,20,6,14,3,2
8,323,323,9,9,0,1,0
9,323,323,27,7,20,2,1
2,331,331,20,20,0,1,0
6,358,358,60,60,0,1,0
1,366,366,6,6,0,1,0
10,373,373,2,2,0,1,0
5,405,405,11,7,4,2,1
7,443,443,45,33,12,4,3
12,455,455,79,11,68,4,3

14,106,106,4,4,0,1,0
8,110,110,1,1,0,1,0
4,128,128,1,1,0,1,0
11,194,194,24,2,22,3,2
2,215,215,5,1,4,2,1
1,246,246,34,34,0,1,0
0,267,267,7,1,6,2,1
6,338,338,1,1,0,1,0
12,345,345,89,56,33,4,3
5,365,365,45,45,0,1,0
3,405,405,10,1,9,2,1
13,405,405,21,21,0,1,0
10,443,443,61,61,0,1,0
9,455,455,3,3,0,1,0
7,492,492,124,124,0,1,0

2,111,111,7,1,6,2,1
6,120,120,33,25,8,3,2
10,150,150,6,6,0,1,0
0,169,169,23,23,0,1,0
5,240,240,13,4,9,4,3
9,250,250,4,4,0,1,0
8,339,339,67,67,0,1,0
7,354,354,12,12,0,1,0
4,356,356,94,94,0,1,0
1,376,376,37,5,32,2,1
3,398,398,16,4,12,3,2

11,123,123,1,1,0,1,0
0,127,127,1,1,0,1,0
13,140,140,10,4,6,3,2
1,182,182,19,11,8,2,1
3,184,184,6,6,0,1,0
6,184,184,8,8,0,1,0
4,202,202,27,9,18,2,1
8,239,239,29,22,7,2,1
15,240,240,16,4,12,4,3
5,269,269,18,3,15,4,3
7,269,269,2,2,0,1,0
9,302,302,11,11,0,1,0
10,319,319,48,48,0,1,0
12,347,347,65,26,39,4,3
2,453,453,21,21,0,1,0
14,480,480,63,48,15,2,1

11,167,167,3,3,0,1,0
3,207,207,18,18,0,1,0
6,237,237,9,9,0,1,0
12,263,263,23,23,0,1,0
1,272,272,66,63,3,2,1
2,275,275,1,1,0,1,0
9,306,306,56,14,42,4,3
4,313,313,13,5,8,2,1
8,381,381,7,1,6,2,1
5,394,394,29,29,0,1,0
7,396,396,29,1,28,2,1
10,401,401,56,56,0,1,0
0,438,438,18,1,17,2,1
13,500,500,82,49,33,4,3

0,152,152,5,5,0,1,0
7,158,158,3,3,0,1,0
5,171,171,3,3,0,1,0
2,184,184,14,5,9,2,1
13,188,188,22,22,0,1,0
8,216,216,9,2,7,2,1
11,246,246,23,14,9,4,3
10,267,267,4,4,0,1,0
3,301,301,6,6,0,1,0
12,381,381,6,3,3,2,1
6,403,403,100,100,0,1,0
4,418,418,23,10,13,2,1
9,419,419,14,14,0,1,0
14,450,450,151,151,0,1,0
1,467,467,43,21,22,3,2

1,118,118,22,22,0,1,0
5,119,119,15,6,9,2,1
0,213,213,81,23,58,3,2
6,239,239,42,20,22,3,2
7,264,264,23,23,0,1,0
2,286,286,10,2,8,2,1
4,347,347,25,1,24,3,2
3,438,438,44,8,36,4,3
8,493,493,27,27,0,1,0

5,113,113,14,7,7,2,1
1,147,147,83,83,0,1,0
3,216,216,19,19,0,1,0
6,272,272,27,18,9,2,1
4,276,276,38,38,0,1,0
2,300,300,25,13,12,2,1
7,394,394,32,11,21,4,3
0,432,432,16,8,8,3,2

2,105,105,9,9,0,1,0
11,125,125,40,40,0,1,0
6,152,152,26,4,22,2,1
9,231,231,5,5,0,1,0
8,264,264,11,1,10,3,2
1,267,267,6,2,4,2,1
10,273,273,38,38,0,1,0
12,293,293,23,2,21,4,3
5,334,334,14,14,0,1,0
7,339,339,17,1,16,2,1
13,363,363,3,3,0,1,0
3,396,396,40,40,0,1,0
0,405,405,4,4,0,1,0
4,437,437,52,52,0,1,0

7,141,141,8,8,0,1,0
15,163,163,17,17,0,1,0
8,202,202,15,15,0,1,0
14,230,230,41,41,0,1,0
0,253,253,1,1,0,1,0
6,260,260,7,7,0,1,0
5,269,269,17,5,12,4,3
11,287,287,48,48,0,1,0
3,316,316,6,6,0,1,0
12,330,330,47,4,43,3,2
1,342,342,2,2,0,1,0
4,348,348,17,10,7,2,1
2,351,351,58,58,0,1,0
16,394,394,3,3,0,1,0
10,424,424,51,11,40,3,2
9,490,490,8,8,0,1,0
13,494,494,7,3,4,2,1

1,109,109,26,2,24,3,2
9,110,110,6,6,0,1,0
4,182,182,25,2,23,4,3
7,237,237,28,28,0,1,0
0,250,250,26,26,0,1,0
8,391,391,41,15,26,3,2
3,408,408,19,19,0,1,0
2,412,412,87,66,21,3,2
6,446,446,21,8,13,2,1
5,482,482,71,71,0,1,0

8,208,208,17,8,9,4,3
3,236,236,60,60,0,1,0
1,268,268,32,32,0,1,0
7,336,336,44,14,30,4,3
4,341,341,17,17,0,1,0
9,380,380,30,30,0,1,0
5,393,393,80,80,0,1,0
6,402,402,25,25,0,1,0
0,456,456,97,9,88,4,3
2,463,463,8,2,6,3,2

4,122,122,18,6,12,2,1
8,211,211,4,4,0,1,0
11,262,262,30,11,19,4,3
6,264,264,2,2,0,1,0
9,277,277,3,3,0,1,0
3,304,304,46,38,8,2,1
2,326,326,10,2,8,3,2
10,354,354,22,13,9,4,3
5,364,364,45,35,10,2,1
1,380,380,25,8,17,2,1
7,452,452,179,39,140,4,3
0,458,458,38,7,31,2,1

2,141,141,4,4,0,1,0
9,211,211,30,30,0,1,0
10,263,263,63,63,0,1,0
4,333,333,117,64,53,4,3
8,353,353,19,5,14,2,1
6,368,368,37,11,26,2,1
1,388,388,80,80,0,1,0
7,390,390,7,7,0,1,0
0,424,424,6,1,5,2,1
3,430,430,1,1,0,1,0
5,474,474,27,27,0,1,0

6,128,128,4,4,0,1,0
3,148,148,8,8,0,1,0
5,180,180,19,15,4,2,1
11,229,229,13,13,0,1,0
9,231,231,14,11,3,2,1
8,241,241,68,68,0,1,0
1,249,249,2,2,0,1,0
2,278,278,10,10,0,1,0
10,278,278,37,37,0,1,0
4,312,312,36,20,16,4,3
12,318,318,20,11,9,4,3
0,365,365,3,3,0,1,0
13,366,366,8,1,7,2,1
7,449,449,109,109,0,1,0

0,138,138,9,9,0,1,0
9,174,174,15,5,10,2,1
7,185,185,20,20,0,1,0
3,203,203,21,15,6,2,1
13,260,260,17,17,0,1,0
12,281,281,17,17,0,1,0
10,295,295,107,85,22,3,2
1,333,333,6,6,0,1,0
4,365,365,2,2,0,1,0
2,400,400,36,36,0,1,0
5,413,413,71,55,16,2,1
8,434,434,14,14,0,1,0
11,467,467,1,1,0,1,0
6,493,493,19,10,9,2,1

4,114,114,4,1,3,2,1
3,119,119,13,13,0,1,0
1,152,152,1,1,0,1,0
10,153,153,2,2,0,1,0
13,153,153,11,11,0,1,0
8,163,163,8,8,0,1,0
11,164,164,9,5,4,2,1
5,208,208,30,13,17,2,1
0,281,281,5,5,0,1,0
16,295,295,1,1,0,1,0
15,342,342,12,12,0,1,0
6,396,396,14,14,0,1,0
12,399,399,5,5,0,1,0
17,402,402,45,45,0,1,0
9,411,411,28,4,24,4,3
7,423,423,27,10,17,3,2
14,476,476,179,116,63,4,3
2,486,486,3,3,0,1,0

8,116,116,15,15,0,1,0
6,159,159,22,22,0,1,0
4,170,170,2,2,0,1,0
9,182,182,5,5,0,1,0
7,213,213,20,20,0,1,0
3,223,223,30,10,20,3,2
1,336,336,3,3,0,1,0
2,356,356,44,44,0,1,0
0,358,358,36,36,0,1,0
5,382,382,32,13,19,4,3
12,393,393,69,51,18,2,1
10,459,459,10,4,6,3,2
11,465,465,79,79,0,1,0

7,168,168,9,2,7,2,1
0,251,251,51,51,0,1,0
2,256,256,83,24,59,3,2
1,291,291,19,19,0,1,0
9,324,324,114,12,102,4,3
3,357,357,3,3,0,1,0
4,413,413,10,10,0,1,0
5,424,424,25,8,17,4,3
8,433,433,38,4,34,3,2
6,485,485,15,15,0,1,0

0,123,123,5,5,0,1,0
9,134,134,46,9,37,3,2
4,148,148,3,3,0,1,0
14,158,158,11,3,8,2,1
11,159,159,15,15,0,1,0
2,189,189,18,5,13,2,1
13,192,192,3,3,0,1,0
12,232,232,15,15,0,1,0
3,276,276,12,7,5,2,1
8,281,281,14,3,11,2,1
10,304,304,9,3,6,2,1
6,361,361,37,9,28,3,2
1,388,388,54,39,15,4,3
5,407,407,19,19,0,1,0
7,445,445,28,28,0,1,0

9,136,136,2,2,0,1,0
6,138,138,33,33,0,1,0
2,155,155,15,15,0,1,0
4,183,183,5,1,4,2,1
5,218,218,1,1,0,1,0
8,226,226,7,3,4,2,1
10,249,249,60,60,0,1,0
1,259,259,25,7,18,2,1
11,325,325,2,2,0,1,0
0,371,371,6,6,0,1,0
7,399,399,30,19,11,2,1
3,423,423,153,101,52,3,2

1,200,200,18,18,0,1,0
5,229,229,4,4,0,1,0
14,257,257,55,55,0,1,0
10,318,318,24,24,0,1,0
13,319,319,12,12,0,1,0
6,325,325,8,8,0,1,0
8,387,387,5,2,3,2,1
3,397,397,15,15,0,1,0
0,398,398,44,44,0,1,0
11,413,413,34,34,0,1,0
4,417,417,6,6,0,1,0
7,434,434,24,16,8,2,1
16,435,435,48,12,36,2,1
15,453,453,18,5,13,2,1
17,461,461,44,44,0,1,0
2,485,485,21,6,15,2,1
12,497,497,56,43,13,2,1
9,500,500,19,19,0,1,0

2,168,168,39,39,0,1,0
8,304,304,2,2,0,1,0
1,363,363,58,58,0,1,0
5,366,366,85,29,56,3,2
7,370,370,58,19,39,3,2
0,401,401,85,13,72,4,3
4,423,423,62,32,30,3,2
3,441,441,13,8,5,2,1
6,482,482,17,12,5,2,1

6,120,120,6,2,4,2,1
1,153,153,36,12,24,4,3
10,172,172,17,7,10,2,1
9,191,191,28,28,0,1,0
7,194,194,53,53,0,1,0
5,223,223,23,3,20,4,3
2,230,230,6,3,3,2,1
4,250,250,6,6,0,1,0
3,315,315,7,7,0,1,0
11,322,322,12,12,0,1,0
0,385,385,73,41,32,2,1
8,484,484,4,4,0,1,0

7,130,130,21,21,0,1,0
5,206,206,8,2,6,3,2
2,272,272,1,1,0,1,0
4,287,287,46,28,18,4,3
3,357,357,14,14,0,1,0
1,415,415,109,88,21,3,2
10,428,428,100,34,66,4,3
0,445,445,61,61,0,1,0
9,466,466,9,1,8,3,2
6,471,471,56,56,0,1,0
8,491,491,20,20,0,1,0

11,102,102,6,6,0,1,0
14,136,136,32,32,0,1,0
2,185,185,2,2,0,1,0
3,212,212,24,24,0,1,0
15,226,226,41,41,0,1,0
12,227,227,11,11,0,1,0
1,236,236,20,20,0,1,0
5,254,254,38,38,0,1,0
0,273,273,5,5,0,1,0
4,308,308,23,23,0,1,0
7,326,326,31,9,22,3,2
10,338,338,18,18,0,1,0
6,350,350,2,2,0,1,0
9,363,363,2,2,0,1,0
13,417,417,14,4,10,3,2
8,445,445,20,20,0,1,0

6,100,100,9,9,0,1,0
4,138,138,3,3,0,1,0
11,170,170,1,1,0,1,0
9,177,177,7,7,0,1,0
0,193,193,37,8,29,2,1
8,233,233,9,9,0,1,0
10,271,271,29,5,24,3,2
7,293,293,100,46,54,3,2
1,377,377,10,2,8,2,1
3,383,383,84,72,12,2,1
5,394,394,45,27,18,4,3
2,410,410,11,2,9,4,3

5,113,113,5,5,0,1,0
3,148,148,13,13,0,1,0
10,168,168,9,6,3,2,1
6,245,245,1,1,0,1,0
13,280,280,19,19,0,1,0
15,297,297,10,4,6,2,1
1,319,319,4,4,0,1,0
7,336,336,10,3,7,2,1
11,356,356,3,3,0,1,0
16,359,359,41,41,0,1,0
12,384,384,99,54,45,4,3
4,387,387,49,20,29,4,3
14,390,390,50,38,12,2,1
2,396,396,11,11,0,1,0
0,430,430,47,23,24,3,2
9,448,448,32,32,0,1,0
8,493,493,19,11,8,3,2

4,128,128,37,9,28,3,2
8,128,128,13,5,8,2,1
7,193,193,6,6,0,1,0
2,197,197,57,43,14,2,1
3,212,212,2,2,0,1,0
6,277,277,8,8,0,1,0
1,315,315,72,58,14,2,1
0,400,400,34,34,0,1,0
5,500,500,75,22,53,4,3

9,207,207,3,3,0,1,0
1,214,214,7,7,0,1,0
3,245,245,48,48,0,1,0
0,318,318,37,27,10,3,2
4,325,325,66,66,0,1,0
2,365,365,19,19,0,1,0
6,382,382,101,77,24,3,2
5,425,425,53,17,36,3,2
8,451,451,14,14,0,1,0
7,452,452,75,75,0,1,0
10,453,453,3,3,0,1,0

7,217,217,5,5,0,1,0
6,226,226,24,3,21,2,1
5,297,297,42,9,33,4,3
3,298,298,5,5,0,1,0
2,358,358,41,41,0,1,0
4,400,400,82,82,0,1,0
0,466,466,116,116,0,1,0
1,496,496,175,102,73,4,3

9,186,186,18,8,10,3,2
5,236,236,47,47,0,1,0
2,263,263,1,1,0,1,0
1,279,279,1,1,0,1,0
3,285,285,70,44,26,2,1
11,336,336,4,4,0,1,0
12,388,388,75,33,42,4,3
6,391,391,9,4,5,2,1
8,393,393,28,16,12,4,3
4,416,416,17,14,3,2,1
7,420,420,76,45,31,2,1
0,456,456,39,23,16,3,2
10,491,491,27,13,14,3,2

13,223,223,18,2,16,2,1
8,225,225,2,2,0,1,0
16,235,235,59,59,0,1,0
2,282,282,10,10,0,1,0
4,282,282,2,2,0,1,0
9,289,289,4,4,0,1,0
11,325,325,41,41,0,1,0
1,383,383,26,1,25,2,1
15,386,386,27,6,21,2,1
0,388,388,141,37,104,4,3
3,395,395,5,5,0,1,0
10,407,407,5,5,0,1,0
6,457,457,14,6,8,2,1
5,459,459,22,22,0,1,0
14,462,462,31,3,28,2,1
7,484,484,1,1,0,1,0
12,487,487,7,2,5,2,1

5,113,113,10,10,0,1,0
10,133,133,2,2,0,1,0
0,305,305,30,14,16,4,3
6,348,348,46,46,0,1,0
2,357,357,24,7,17,2,1
1,397,397,50,30,20,3,2
3,430,430,8,2,6,2,1
7,433,433,34,34,0,1,0
4,467,467,33,15,18,2,1
12,467,467,85,77,8,2,1
9,479,479,115,115,0,1,0
8,496,496,37,37,0,1,0
11,498,498,11,7,4,2,1

2,108,108,2,2,0,1,0
13,120,120,17,5,12,2,1
9,121,121,2,2,0,1,0
4,159,159,1,1,0,1,0
14,160,160,22,2,20,4,3
8,167,167,16,16,0,1,0
12,225,225,27,27,0,1,0
1,244,244,5,5,0,1,0
10,246,246,1,1,0,1,0
11,318,318,52,52,0,1,0
3,334,334,55,31,24,3,2
16,380,380,1,1,0,1,0
5,416,416,29,2,27,2,1
15,460,460,22,22,0,1,0
6,470,470,5,5,0,1,0
0,470,470,71,30,41,2,1
7,477,477,21,14,7,2,1

3,100,100,3,3,0,1,0
11,172,172,2,2,0,1,0
5,224,224,1,1,0,1,0
12,244,244,28,28,0,1,0
9,250,250,7,4,3,2,1
4,307,307,1,1,0,1,0
10,354,354,20,1,19,2,1
6,404,404,3,3,0,1,0
1,432,432,56,56,0,1,0
7,436,436,55,55,0,1,0
8,436,436,119,119,0,1,0
0,444,444,147,63,84,3,2
2,454,454,43,43,0,1,0

8,140,140,25,12,13,2,1
12,232,232,60,38,22,2,1
2,247,247,33,33,0,1,0
6,252,252,12,12,0,1,0
9,272,272,15,15,0,1,0
7,336,336,11,11,0,1,0
11,344,344,11,11,0,1,0
3,373,373,1,1,0,1,0
10,421,421,24,2,22,3,2
4,444,444,10,10,0,1,0
5,478,478,76,44,32,2,1
1,485,485,67,67,0,1,0
0,486,486,48,28,20,3,2

5,170,170,30,30,0,1,0
0,228,228,29,29,0,1,0
7,234,234,12,2,10,2,1
3,256,256,43,34,9,4,3
6,261,261,8,3,5,2,1
2,278,278,90,10,80,3,2
4,349,349,56,5,51,4,3
8,414,414,10,2,8,3,2
1,495,495,75,75,0,1,0

11,113,113,15,15,0,1,0
8,120,120,5,5,0,1,0
1,121,121,7,1,6,3,2
3,146,146,8,8,0,1,0
14,225,225,16,4,12,3,2
9,230,230,27,19,8,2,1
15,231,231,8,8,0,1,0
7,236,236,12,4,8,3,2
5,251,251,36,36,0,1,0
4,281,281,4,4,0,1,0
10,296,296,3,3,0,1,0
2,312,312,25,25,0,1,0
6,350,350,2,2,0,1,0
0,394,394,15,5,10,2,1
13,401,401,139,80,59,4,3
12,452,452,9,4,5,2,1

10,120,120,28,20,8,2,1
6,136,136,2,2,0,1,0
13,138,138,9,9,0,1,0
8,151,151,2,2,0,1,0
9,156,156,6,6,0,1,0
12,169,169,36,26,10,2,1
15,181,181,8,8,0,1,0
0,236,236,39,39,0,1,0
3,257,257,25,22,3,2,1
14,265,265,9,9,0,1,0
4,267,267,24,18,6,2,1
2,309,309,52,5,47,2,1
1,352,352,1,1,0,1,0
11,415,415,13,7,6,3,2
7,440,440,1,1,0,1,0
5,479,479,6,6,0,1,0

5,120,120,2,2,0,1,0
0,128,128,9,9,0,1,0
2,198,198,1,1,0,1,0
6,214,214,22,4,18,2,1
10,264,264,15,6,9,4,3
3,293,293,108,108,0,1,0
1,301,301,6,6,0,1,0
11,313,313,8,2,6,3,2
9,387,387,54,9,45,2,1
7,399,399,100,52,48,4,3
4,401,401,51,51,0,1,0
8,416,416,14,1,13,2,1

5,122,122,3,3,0,1,0
3,127,127,20,20,0,1,0
6,156,156,4,4,0,1,0
9,173,173,54,48,6,2,1
1,184,184,27,27,0,1,0
4,201,201,22,22,0,1,0
8,214,214,31,3,28,3,2
2,287,287,20,20,0,1,0
7,369,369,6,6,0,1,0
10,392,392,36,36,0,1,0
0,395,395,47,29,18,2,1

7,113,113,15,15,0,1,0
6,120,120,4,1,3,2,1
0,139,139,11,11,0,1,0
12,209,209,9,9,0,1,0
10,234,234,14,14,0,1,0
3,256,256,22,13,9,2,1
14,300,300,33,33,0,1,0
4,333,333,18,18,0,1,0
9,333,333,4,4,0,1,0
5,337,337,1,1,0,1,0
11,338,338,22,22,0,1,0
13,342,342,92,2,90,4,3
8,361,361,1,1,0,1,0
15,363,363,23,18,5,2,1
2,375,375,56,17,39,4,3
1,419,419,20,20,0,1,0

7,102,102,2,2,0,1,0
2,119,119,50,50,0,1,0
6,150,150,15,15,0,1,0
0,155,155,11,11,0,1,0
5,222,222,4,1,3,2,1
9,251,251,38,31,7,2,1
3,269,269,2,2,0,1,0
4,289,289,51,5,46,2,1
1,295,295,30,16,14,3,2
8,375,375,55,55,0,1,0

0,122,122,5,5,0,1,0
1,215,215,11,1,10,3,2
12,249,249,1,1,0,1,0
8,258,258,37,3,34,3,2
2,267,267,17,17,0,1,0
6,270,270,44,44,0,1,0
3,292,292,20,10,10,2,1
4,307,307,27,11,16,2,1
11,323,323,53,49,4,2,1
5,325,325,41,41,0,1,0
10,352,352,47,47,0,1,0
9,429,429,42,18,24,3,2
7,439,439,30,30,0,1,0

6,149,149,7,7,0,1,0
9,214,214,32,32,0,1,0
0,217,217,18,18,0,1,0
4,235,235,2,2,0,1,0
3,283,283,66,66,0,1,0
7,318,318,16,8,8,3,2
2,369,369,53,53,0,1,0
8,390,390,35,35,0,1,0
1,410,410,58,58,0,1,0
5,440,440,119,41,78,4,3

0,139,139,13,13,0,1,0
15,209,209,10,2,8,2,1
6,222,222,13,10,3,2,1
9,243,243,28,28,0,1,0
13,260,260,12,7,5,2,1
3,283,283,37,11,26,2,1
8,333,333,12,12,0,1,0
5,339,339,8,2,6,2,1
14,370,370,7,7,0,1,0
1,375,375,20,17,3,2,1
12,390,390,93,93,0,1,0
10,416,416,39,13,26,3,2
4,421,421,27,27,0,1,0
2,422,422,10,10,0,1,0
11,448,448,73,73,0,1,0
7,493,493,1,1,0,1,0

9,100,100,18,18,0,1,0
4,181,181,7,1,6,3,2
1,183,183,10,3,7,2,1
11,185,185,48,48,0,1,0
5,207,207,33,33,0,1,0
8,349,349,11,5,6,2,1
10,357,357,44,9,35,3,2
3,402,402,100,100,0,1,0
7,414,414,3,3,0,1,0
6,423,423,4,4,0,1,0
0,463,463,39,39,0,1,0
2,477,477,8,8,0,1,0

9,217,217,1,1,0,1,0
6,243,243,10,10,0,1,0
5,254,254,43,11,32,3,2
3,262,262,15,9,6,3,2
10,312,312,55,55,0,1,0
2,321,321,33,21,12,2,1
7,329,329,26,14,12,2,1
0,352,352,7,7,0,1,0
8,364,364,92,74,18,4,3
1,394,394,48,48,0,1,0
4,415,415,54,6,48,3,2
11,457,457,23,23,0,1,0

1,106,106,6,6,0,1,0
13,108,108,4,4,0,1,0
0,156,156,1,1,0,1,0
6,158,158,5,2,3,2,1
11,159,159,8,8,0,1,0
2,185,185,3,3,0,1,0
4,194,194,15,1,14,2,1
5,205,205,2,2,0,1,0
14,213,213,27,16,11,2,1
16,213,213,12,12,0,1,0
12,280,280,41,29,12,2,1
17,321,321,15,15,0,1,0
3,349,349,20,4,16,3,2
15,363,363,32,32,0,1,0
7,369,369,1,1,0,1,0
8,374,374,15,8,7,2,1
10,377,377,31,31,0,1,0
9,400,400,10,10,0,1,0
18,465,465,117,81,36,3,2

4,147,147,32,32,0,1,0
10,211,211,59,5,54,3,2
8,250,250,27,27,0,1,0
11,255,255,18,18,0,1,0
9,301,301,17,17,0,1,0
3,309,309,3,3,0,1,0
13,356,356,19,1,18,4,3
7,357,357,4,4,0,1,0
12,373,373,17,9,8,3,2
1,389,389,81,31,50,4,3
2,409,409,27,9,18,3,2
6,413,413,24,14,10,3,2
5,420,420,12,3,9,4,3
0,485,485,1,1,0,1,0

13,108,108,6,6,0,1,0
0,123,123,9,9,0,1,0
9,124,124,3,3,0,1,0
7,135,135,2,2,0,1,0
4,179,179,43,13,30,4,3
11,232,232,50,35,15,2,1
12,260,260,18,18,0,1,0
1,272,272,48,18,30,4,3
5,307,307,11,11,0,1,0
2,349,349,8,8,0,1,0
6,349,349,5,5,0,1,0
10,356,356,66,66,0,1,0
3,364,364,9,3,6,2,1
8,447,447,29,29,0,1,0

14,113,113,15,3,12,4,3
12,136,136,4,4,0,1,0
13,140,140,2,2,0,1,0
11,159,159,60,60,0,1,0
7,197,197,16,2,14,2,1
2,206,206,18,1,17,2,1
0,252,252,7,7,0,1,0
8,262,262,25,25,0,1,0
5,300,300,1,1,0,1,0
9,323,323,2,2,0,1,0
3,325,325,11,11,0,1,0
1,385,385,4,1,3,2,1
4,401,401,20,2,18,4,3
6,431,431,92,20,72,4,3
10,445,445,25,9,16,2,1

6,129,129,1,1,0,1,0
0,138,138,4,4,0,1,0
4,151,151,10,7,3,2,1
10,152,152,4,1,3,2,1
9,214,214,97,97,0,1,0
8,243,243,10,6,4,2,1
13,251,251,2,2,0,1,0
1,273,273,28,6,22,3,2
14,327,327,25,14,11,2,1
3,332,332,7,7,0,1,0
5,365,365,17,5,12,2,1
2,387,387,7,2,5,2,1
11,470,470,3,3,0,1,0
12,480,480,21,21,0,1,0
7,483,483,130,104,26,2,1

8,112,112,2,2,0,1,0
1,149,149,44,28,16,2,1
10,167,167,18,18,0,1,0
6,185,185,5,5,0,1,0
11,216,216,21,2,19,3,2
4,253,253,3,3,0,1,0
5,264,264,4,4,0,1,0
3,280,280,19,19,0,1,0
7,321,321,24,13,11,2,1
12,323,323,38,38,0,1,0
9,340,340,10,10,0,1,0
13,462,462,111,111,0,1,0
0,466,466,5,5,0,1,0
2,494,494,49,37,12,3,2

1,141,141,4,4,0,1,0
0,150,150,11,11,0,1,0
7,178,178,13,8,5,2,1
8,229,229,22,10,12,2,1
4,366,366,23,23,0,1,0
12,370,370,36,3,33,4,3
9,372,372,19,2,17,2,1
5,407,407,34,2,32,3,2
10,412,412,70,47,23,2,1
2,430,430,94,10,84,4,3
11,443,443,56,56,0,1,0
6,491,491,13,5,8,2,1
3,495,495,53,53,0,1,0

9,108,108,6,6,0,1,0
8,122,122,3,3,0,1,0
1,138,138,8,8,0,1,0
2,157,157,11,2,9,3,2
11,168,168,4,1,3,2,1
16,177,177,10,4,6,3,2
12,188,188,35,8,27,4,3
10,209,209,26,14,12,3,2
13,282,282,27,27,0,1,0
3,299,299,1,1,0,1,0
14,318,318,56,56,0,1,0
0,319,319,22,15,7,2,1
4,356,356,28,28,0,1,0
6,367,367,7,7,0,1,0
5,425,425,25,25,0,1,0
15,427,427,31,31,0,1,0
7,454,454,19,19,0,1,0

6,122,122,19,19,0,1,0
3,132,132,26,26,0,1,0
5,162,162,1,1,0,1,0
0,230,230,76,4,72,4,3
8,397,397,25,7,18,4,3
4,400,400,12,12,0,1,0
1,434,434,9,9,0,1,0
9,438,438,70,70,0,1,0
7,461,461,91,25,66,3,2
2,472,472,26,10,16,2,1

8,106,106,3,3,0,1,0
3,110,110,3,3,0,1,0
7,148,148,9,9,0,1,0
1,190,190,18,18,0,1,0
5,253,253,15,15,0,1,0
0,262,262,1,1,0,1,0
6,269,269,92,92,0,1,0
11,337,337,16,1,15,2,1
4,403,403,5,5,0,1,0
9,460,460,102,12,90,3,2
2,462,462,29,25,4,2,1
10,466,466,69,1,68,3,2
12,499,499,51,33,18,4,3

4,120,120,26,12,14,4,3
10,174,174,69,69,0,1,0
7,201,201,13,10,3,2,1
2,211,211,21,15,6,3,2
0,212,212,1,1,0,1,0
6,222,222,21,9,12,4,3
3,246,246,26,2,24,3,2
11,262,262,2,2,0,1,0
9,273,273,11,11,0,1,0
8,341,341,2,2,0,1,0
1,395,395,60,10,50,2,1
5,485,485,11,11,0,1,0

8,152,152,32,24,8,3,2
6,162,162,6,1,5,2,1
2,173,173,36,36,0,1,0
4,198,198,5,5,0,1,0
10,208,208,40,12,28,4,3
7,219,219,25,25,0,1,0
1,244,244,9,9,0,1,0
0,314,314,76,25,51,4,3
11,316,316,7,7,0,1,0
9,333,333,12,12,0,1,0
5,390,390,23,5,18,4,3
3,451,451,14,14,0,1,0

6,136,136,21,21,0,1,0
3,210,210,65,65,0,1,0
11,215,215,3,3,0,1,0
1,251,251,1,1,0,1,0
7,279,279,9,9,0,1,0
2,340,340,23,2,21,2,1
0,395,395,6,1,5,2,1
10,406,406,23,11,12,4,3
5,422,422,27,20,7,2,1
4,438,438,62,62,0,1,0
9,448,448,47,32,15,4,3
8,458,458,113,110,3,2,1

7,220,220,6,6,0,1,0
12,228,228,47,47,0,1,0
9,263,263,2,2,0,1,0
3,295,295,39,39,0,1,0
11,328,328,16,16,0,1,0
10,369,369,19,7,12,2,1
5,385,385,82,22,60,4,3
2,389,389,42,5,37,3,2
8,391,391,106,23,83,4,3
0,394,394,19,19,0,1,0
4,482,482,5,2,3,2,1
1,488,488,1,1,0,1,0
6,489,489,43,17,26,3,2

8,117,117,13,13,0,1,0
5,136,136,41,23,18,4,3
11,170,170,22,7,15,4,3
0,182,182,25,25,0,1,0
9,212,212,1,1,0,1,0
3,232,232,5,2,3,2,1
1,263,263,12,12,0,1,0
7,265,265,4,4,0,1,0
10,339,339,38,11,27,2,1
6,348,348,85,19,66,3,2
4,440,440,13,13,0,1,0
2,484,484,32,15,17,2,1

11,121,121,3,3,0,1,0
1,127,127,26,15,11,2,1
12,175,175,57,57,0,1,0
7,206,206,26,26,0,1,0
0,271,271,28,28,0,1,0
6,274,274,14,14,0,1,0
3,284,284,14,4,10,3,2
4,312,312,18,4,14,2,1
8,326,326,19,14,5,2,1
2,419,419,25,25,0,1,0
10,430,430,23,23,0,1,0
5,454,454,35,35,0,1,0
9,471,471,11,11,0,1,0

2,104,104,2,2,0,1,0
11,147,147,10,6,4,2,1
16,159,159,23,11,12,2,1
19,219,219,13,13,0,1,0
5,222,222,5,5,0,1,0
14,226,226,7,1,6,3,2
9,267,267,24,10,14,3,2
18,280,280,17,17,0,1,0
7,315,315,5,5,0,1,0
0,331,331,21,21,0,1,0
4,342,342,39,39,0,1,0
6,357,357,3,3,0,1,0
17,381,381,34,2,32,2,1
3,393,393,3,3,0,1,0
12,411,411,16,16,0,1,0
10,418,418,18,4,14,3,2
20,447,447,91,44,47,2,1
13,453,453,12,12,0,1,0
8,469,469,6,6,0,1,0
1,482,482,19,4,15,2,1
15,493,493,24,12,12,4,3

9,123,123,1,1,0,1,0
1,176,176,5,5,0,1,0
4,216,216,33,33,0,1,0
5,229,229,6,6,0,1,0
3,249,249,83,83,0,1,0
10,287,287,29,29,0,1,0
11,307,307,59,59,0,1,0
6,312,312,21,21,0,1,0
8,326,326,26,26,0,1,0
2,335,335,13,13,0,1,0
0,475,475,11,11,0,1,0
7,486,486,80,10,70,3,2

3,104,104,6,6,0,1,0
10,170,170,2,2,0,1,0
9,198,198,12,5,7,2,1
6,208,208,9,9,0,1,0
12,228,228,28,28,0,1,0
8,231,231,23,11,12,2,1
13,246,246,70,70,0,1,0
0,269,269,19,10,9,4,3
5,273,273,30,8,22,2,1
11,356,356,13,13,0,1,0
7,357,357,33,6,27,4,3
1,387,387,7,1,6,2,1
2,409,409,46,46,0,1,0
4,418,418,40,13,27,2,1

8,136,136,30,30,0,1,0
2,156,156,53,53,0,1,0
5,217,217,29,2,27,3,2
9,283,283,19,19,0,1,0
0,286,286,6,6,0,1,0
4,325,325,63,52,11,2,1
10,358,358,25,25,0,1,0
3,379,379,9,2,7,2,1
1,408,408,10,7,3,2,1
7,490,490,10,10,0,1,0
6,497,497,49,49,0,1,0

10,134,134,1,1,0,1,0
2,214,214,56,56,0,1,0
5,220,220,17,5,12,2,1
9,239,239,47,47,0,1,0
3,245,245,17,1,16,2,1
1,312,312,47,7,40,3,2
7,330,330,36,3,33,2,1
0,386,386,9,2,7,2,1
8,461,461,27,13,14,3,2
4,472,472,45,24,21,4,3
6,493,493,81,81,0,1,0

7,198,198,25,25,0,1,0
8,204,204,19,11,8,2,1
5,207,207,56,56,0,1,0
4,301,301,11,11,0,1,0
0,330,330,74,21,53,3,2
9,384,384,12,4,8,2,1
3,426,426,52,52,0,1,0
6,430,430,22,22,0,1,0
2,469,469,112,80,32,3,2
1,495,495,8,8,0,1,0

6,111,111,17,14,3,2,1
10,126,126,12,12,0,1,0
3,160,160,31,9,22,2,1
0,195,195,1,1,0,1,0
1,247,247,18,18,0,1,0
4,308,308,11,11,0,1,0
2,313,313,92,92,0,1,0
7,328,328,33,33,0,1,0
5,333,333,42,11,31,2,1
8,401,401,13,13,0,1,0
9,470,470,51,51,0,1,0

5,117,117,21,1,20,3,2
0,175,175,13,13,0,1,0
9,179,179,21,16,5,2,1
3,202,202,14,14,0,1,0
6,219,219,20,11,9,2,1
1,275,275,36,27,9,2,1
11,278,278,40,10,30,2,1
8,280,280,57,39,18,2,1
10,329,329,1,1,0,1,0
7,356,356,18,9,9,2,1
4,403,403,4,4,0,1,0
2,415,415,57,5,52,3,2

9,134,134,13,3,10,2,1
11,139,139,3,3,0,1,0
8,290,290,31,31,0,1,0
0,291,291,35,11,24,4,3
3,325,325,36,15,21,4,3
4,371,371,31,7,24,3,2
5,371,371,6,6,0,1,0
10,401,401,48,48,0,1,0
1,415,415,57,39,18,3,2
7,454,454,24,15,9,2,1
6,475,475,101,101,0,1,0
2,485,485,64,64,0,1,0

11,158,158,45,45,0,1,0
0,175,175,28,28,0,1,0
1,293,293,6,6,0,1,0
6,296,296,36,36,0,1,0
5,300,300,5,5,0,1,0
10,328,328,16,16,0,1,0
13,329,329,31,31,0,1,0
9,380,380,41,41,0,1,0
4,387,387,51,51,0,1,0
12,405,405,29,19,10,2,1
7,421,421,21,15,6,3,2
3,470,470,5,5,0,1,0
8,478,478,2,2,0,1,0
2,497,497,45,45,0,1,0

11,102,102,9,1,8,2,1
4,105,105,1,1,0,1,0
9,105,105,10,2,8,2,1
2,134,134,1,1,0,1,0
6,144,144,9,9,0,1,0
1,164,164,23,16,7,2,1
0,166,166,22,12,10,3,2
5,167,167,25,25,0,1,0
10,408,408,2,2,0,1,0
3,421,421,69,69,0,1,0
7,459,459,64,2,62,3,2
8,463,463,105,105,0,1,0

4,130,130,2,2,0,1,0
7,146,146,1,1,0,1,0
5,211,211,36,6,30,3,2
2,213,213,1,1,0,1,0
8,229,229,25,18,7,2,1
9,248,248,40,8,32,2,1
3,303,303,46,46,0,1,0
6,306,306,63,63,0,1,0
11,327,327,59,5,54,3,2
10,377,377,56,10,46,3,2
1,378,378,1,1,0,1,0
12,386,386,2,2,0,1,0
0,465,465,24,12,12,4,3

6,128,128,19,19,0,1,0
5,140,140,13,9,4,2,1
9,180,180,12,5,7,2,1
10,202,202,32,7,25,2,1
7,273,273,4,4,0,1,0
3,318,318,56,10,46,4,3
4,345,345,7,4,3,2,1
11,356,356,51,51,0,1,0
0,371,371,5,5,0,1,0
8,383,383,31,31,0,1,0
2,389,389,16,2,14,2,1
1,425,425,47,47,0,1,0
12,438,438,64,14,50,3,2

2,104,104,27,3,24,4,3
11,110,110,2,2,0,1,0
8,124,124,37,33,4,2,1
4,154,154,15,15,0,1,0
9,194,194,16,16,0,1,0
7,237,237,6,3,3,2,1
6,287,287,8,2,6,2,1
12,289,289,14,3,11,3,2
1,331,331,20,4,16,2,1
3,353,353,20,20,0,1,0
5,407,407,30,30,0,1,0
0,477,477,13,4,9,2,1
10,482,482,69,69,0,1,0

6,115,115,4,4,0,1,0
10,191,191,24,4,20,2,1
5,194,194,8,8,0,1,0
11,254,254,13,13,0,1,0
1,286,286,23,5,18,3,2
8,296,296,6,6,0,1,0
3,301,301,39,39,0,1,0
7,305,305,72,72,0,1,0
0,391,391,65,57,8,2,1
2,394,394,29,23,6,2,1
9,468,468,68,20,48,2,1
4,469,469,53,53,0,1,0

1,106,106,11,3,8,2,1
6,133,133,12,6,6,3,2
3,220,220,1,1,0,1,0
0,222,222,8,3,5,2,1
2,236,236,13,13,0,1,0
15,268,268,23,23,0,1,0
9,271,271,23,18,5,2,1
11,275,275,11,5,6,3,2
8,293,293,27,17,10,3,2
7,316,316,14,2,12,3,2
10,353,353,5,5,0,1,0
5,357,357,19,7,12,3,2
13,364,364,85,58,27,4,3
14,374,374,13,13,0,1,0
4,383,383,15,10,5,2,1
12,418,418,86,56,30,2,1

0,162,162,12,2,10,3,2
6,203,203,6,1,5,2,1
10,227,227,11,8,3,2,1
7,266,266,102,102,0,1,0
8,287,287,3,3,0,1,0
3,325,325,2,2,0,1,0
1,457,457,109,49,60,4,3
5,464,464,33,19,14,2,1
2,472,472,40,40,0,1,0
11,488,488,65,11,54,4,3
4,491,491,62,62,0,1,0
9,494,494,3,3,0,1,0

1,102,102,11,3,8,3,2
7,125,125,7,2,5,2,1
10,129,129,12,12,0,1,0
9,158,158,42,27,15,4,3
3,163,163,13,13,0,1,0
8,165,165,25,25,0,1,0
0,214,214,3,3,0,1,0
5,222,222,6,6,0,1,0
4,227,227,87,40,47,3,2
6,285,285,7,7,0,1,0
2,457,457,7,7,0,1,0

1,152,152,5,5,0,1,0
8,161,161,31,24,7,2,1
11,165,165,3,3,0,1,0
9,166,166,19,13,6,3,2
5,262,262,6,6,0,1,0
10,310,310,38,9,29,4,3
4,363,363,2,2,0,1,0
7,373,373,28,28,0,1,0
0,414,414,62,62,0,1,0
3,416,416,64,64,0,1,0
2,474,474,113,71,42,2,1
6,490,490,44,23,21,4,3

6,102,102,7,1,6,2,1
3,122,122,5,5,0,1,0
12,126,126,5,5,0,1,0
1,127,127,4,4,0,1,0
0,170,170,33,33,0,1,0
2,199,199,21,21,0,1,0
9,213,213,10,4,6,3,2
4,231,231,17,17,0,1,0
8,279,279,2,2,0,1,0
7,303,303,2,2,0,1,0
14,321,321,71,37,34,3,2
10,381,381,2,2,0,1,0
13,390,390,80,16,64,3,2
11,410,410,36,36,0,1,0
5,436,436,32,8,24,4,3

8,101,101,15,15,0,1,0
11,154,154,2,2,0,1,0
0,162,162,1,1,0,1,0
9,217,217,17,17,0,1,0
1,222,222,2,2,0,1,0
10,275,275,34,15,19,2,1
2,307,307,63,63,0,1,0
6,320,320,29,10,19,2,1
3,324,324,6,6,0,1,0
7,366,366,23,23,0,1,0
4,391,391,20,20,0,1,0
5,414,414,65,27,38,3,2
12,427,427,3,3,0,1,0
13,479,479,118,45,73,4,3

1,117,117,2,2,0,1,0
11,131,131,11,11,0,1,0
12,172,172,48,18,30,3,2
9,185,185,12,12,0,1,0
4,202,202,15,15,0,1,0
0,208,208,11,11,0,1,0
5,229,229,17,17,0,1,0
3,235,235,16,16,0,1,0
7,268,268,7,7,0,1,0
2,347,347,60,15,45,4,3
8,373,373,10,10,0,1,0
6,445,445,63,63,0,1,0
10,472,472,60,27,33,2,1

15,128,128,7,1,6,2,1
11,138,138,27,27,0,1,0
9,146,146,6,6,0,1,0
10,179,179,11,5,6,2,1
7,209,209,9,9,0,1,0
2,224,224,20,20,0,1,0
8,276,276,14,14,0,1,0
3,292,292,12,7,5,2,1
14,302,302,51,51,0,1,0
4,350,350,16,12,4,2,1
6,352,352,37,15,22,2,1
0,399,399,9,9,0,1,0
13,429,429,44,44,0,1,0
5,444,444,55,28,27,4,3
12,483,483,14,14,0,1,0
1,492,492,20,2,18,2,1

4,107,107,6,6,0,1,0
1,141,141,7,1,6,2,1
5,147,147,13,13,0,1,0
2,159,159,1,1,0,1,0
6,283,283,14,14,0,1,0
3,326,326,41,41,0,1,0
0,374,374,84,44,40,3,2
11,426,426,27,27,0,1,0
9,429,429,16,2,14,3,2
7,440,440,21,21,0,1,0
8,473,473,66,32,34,3,2
12,495,495,130,64,66,3,2
10,496,496,28,28,0,1,0

10,138,138,8,5,3,2,1
5,161,161,3,3,0,1,0
0,239,239,25,25,0,1,0
6,247,247,29,29,0,1,0
3,280,280,11,11,0,1,0
12,333,333,13,7,6,3,2
8,345,345,101,77,24,3,2
13,353,353,51,51,0,1,0
9,355,355,1,1,0,1,0
11,372,372,26,12,14,3,2
1,394,394,15,15,0,1,0
2,417,417,36,36,0,1,0
7,444,444,75,75,0,1,0
4,485,485,13,1,12,2,1

1,123,123,14,14,0,1,0
8,159,159,10,7,3,2,1
2,174,174,34,34,0,1,0
7,238,238,15,15,0,1,0
0,257,257,75,64,11,2,1
4,389,389,21,21,0,1,0
6,418,418,137,77,60,4,3
5,445,445,43,43,0,1,0
3,461,461,1,1,0,1,0

7,134,134,3,3,0,1,0
0,147,147,17,1,16,4,3
6,203,203,9,9,0,1,0
4,232,232,16,16,0,1,0
8,243,243,14,14,0,1,0
11,362,362,8,8,0,1,0
2,400,400,24,12,12,2,1
5,435,435,26,26,0,1,0
3,463,463,74,46,28,4,3
9,465,465,96,27,69,3,2
1,467,467,64,48,16,2,1
10,473,473,122,117,5,2,1

2,141,141,6,6,0,1,0
6,142,142,3,3,0,1,0
4,161,161,9,9,0,1,0
1,244,244,13,13,0,1,0
8,252,252,12,3,9,2,1
7,314,314,13,13,0,1,0
10,320,320,43,43,0,1,0
3,340,340,30,15,15,4,3
11,396,396,48,48,0,1,0
12,422,422,48,48,0,1,0
5,441,441,84,20,64,3,2
9,445,445,67,26,41,4,3
0,464,464,70,44,26,2,1

11,100,100,5,2,3,2,1
7,142,142,2,2,0,1,0
9,142,142,1,1,0,1,0
1,171,171,29,3,26,4,3
13,194,194,21,21,0,1,0
5,225,225,15,15,0,1,0
12,308,308,28,28,0,1,0
2,341,341,19,19,0,1,0
8,389,389,104,104,0,1,0
4,407,407,1,1,0,1,0
10,444,444,42,12,30,4,3
3,445,445,57,57,0,1,0
0,450,450,49,19,30,2,1
6,456,456,28,8,20,3,2

7,133,133,22,22,0,1,0
8,134,134,2,2,0,1,0
11,157,157,6,6,0,1,0
10,167,167,19,19,0,1,0
6,190,190,19,9,10,2,1
12,194,194,41,29,12,4,3
3,412,412,49,10,39,4,3
9,415,415,30,30,0,1,0
4,418,418,5,2,3,2,1
1,426,426,48,48,0,1,0
0,427,427,7,7,0,1,0
2,453,453,56,56,0,1,0
5,469,469,56,26,30,4,3

4,103,103,11,5,6,3,2
5,124,124,13,3,10,2,1
1,161,161,1,1,0,1,0
9,167,167,8,8,0,1,0
13,171,171,13,5,8,3,2
7,244,244,4,4,0,1,0
15,245,245,14,14,0,1,0
6,257,257,10,10,0,1,0
14,269,269,7,7,0,1,0
0,293,293,13,9,4,2,1
2,315,315,11,11,0,1,0
3,370,370,19,19,0,1,0
10,411,411,19,10,9,2,1
12,448,448,62,46,16,3,2
16,459,459,126,74,52,4,3
11,470,470,18,2,16,3,2
8,479,479,50,43,7,2,1

3,124,124,1,1,0,1,0
2,153,153,1,1,0,1,0
11,189,189,15,4,11,2,1
0,192,192,2,2,0,1,0
8,193,193,26,13,13,2,1
4,202,202,13,13,0,1,0
6,267,267,62,62,0,1,0
7,282,282,2,2,0,1,0
5,293,293,24,19,5,2,1
10,328,328,38,38,0,1,0
1,335,335,64,64,0,1,0
13,354,354,20,4,16,2,1
12,370,370,78,63,15,4,3
9,458,458,4,1,3,2,1

4,118,118,15,15,0,1,0
3,119,119,7,7,0,1,0
2,140,140,2,2,0,1,0
5,295,295,74,44,30,4,3
7,322,322,110,78,32,3,2
9,360,360,12,2,10,3,2
11,366,366,29,14,15,4,3
10,383,383,20,14,6,2,1
8,384,384,3,3,0,1,0
6,392,392,36,36,0,1,0
0,408,408,56,29,27,2,1
1,487,487,6,2,4,2,1

2,149,149,28,3,25,2,1
6,163,163,4,1,3,2,1
3,172,172,2,2,0,1,0
13,197,197,38,22,16,3,2
10,213,213,20,8,12,3,2
4,216,216,23,23,0,1,0
8,239,239,40,40,0,1,0
7,240,240,9,3,6,3,2
0,389,389,13,7,6,3,2
12,445,445,22,7,15,2,1
5,478,478,42,42,0,1,0
9,495,495,4,4,0,1,0
11,495,495,49,4,45,3,2
1,496,496,56,8,48,2,1

5,111,111,1,1,0,1,0
7,115,115,2,2,0,1,0
8,120,120,8,8,0,1,0
13,163,163,4,4,0,1,0
12,228,228,13,5,8,3,2
0,232,232,11,11,0,1,0
2,273,273,9,9,0,1,0
14,330,330,26,26,0,1,0
3,338,338,16,16,0,1,0
15,372,372,59,1,58,4,3
17,424,424,115,115,0,1,0
11,427,427,13,1,12,3,2
1,442,442,32,29,3,2,1
9,457,457,20,14,6,2,1
4,464,464,30,6,24,3,2
6,470,470,36,36,0,1,0
10,484,484,45,33,12,3,2
16,492,492,12,12,0,1,0

12,197,197,7,7,0,1,0
8,210,210,27,10,17,2,1
6,243,243,1,1,0,1,0
5,289,289,7,1,6,2,1
2,299,299,12,1,11,4,3
7,304,304,2,2,0,1,0
14,314,314,62,8,54,3,2
0,346,346,13,13,0,1,0
4,352,352,8,8,0,1,0
10,380,380,62,62,0,1,0
1,421,421,76,76,0,1,0
11,437,437,39,22,17,2,1
13,450,450,20,6,14,3,2
9,459,459,38,35,3,2,1
3,470,470,75,75,0,1,0

10,131,131,2,2,0,1,0
9,181,181,11,11,0,1,0
5,207,207,37,28,9,4,3
4,215,215,1,1,0,1,0
11,219,219,91,48,43,2,1
0,263,263,45,45,0,1,0
7,314,314,28,28,0,1,0
8,316,316,10,2,8,3,2
3,394,394,11,11,0,1,0
1,398,398,28,13,15,2,1
2,400,400,59,41,18,2,1
6,444,444,1,1,0,1,0

2,149,149,30,2,28,2,1
1,227,227,36,36,0,1,0
3,231,231,21,21,0,1,0
4,266,266,18,6,12,2,1
5,314,314,28,28,0,1,0
9,346,346,98,98,0,1,0
0,358,358,54,54,0,1,0
6,448,448,34,34,0,1,0
7,470,470,2,2,0,1,0
8,474,474,41,41,0,1,0

4,107,107,1,1,0,1,0
5,110,110,4,4,0,1,0
3,140,140,11,5,6,3,2
7,181,181,14,14,0,1,0
15,204,204,18,18,0,1,0
12,263,263,4,4,0,1,0
11,289,289,5,5,0,1,0
8,299,299,4,4,0,1,0
9,301,301,4,4,0,1,0
16,329,329,2,2,0,1,0
6,372,372,64,64,0,1,0
13,378,378,78,19,59,4,3
0,382,382,9,9,0,1,0
14,382,382,10,10,0,1,0
10,425,425,1,1,0,1,0
1,434,434,12,3,9,4,3
17,467,467,125,88,37,2,1
2,491,491,64,17,47,4,3

13,109,109,2,2,0,1,0
10,140,140,10,10,0,1,0
14,162,162,5,1,4,2,1
16,163,163,50,26,24,3,2
3,170,170,1,1,0,1,0
11,213,213,33,33,0,1,0
6,223,223,15,15,0,1,0
8,242,242,2,2,0,1,0
9,257,257,1,1,0,1,0
7,331,331,34,6,28,3,2
15,346,346,34,34,0,1,0
1,354,354,30,3,27,4,3
2,380,380,12,12,0,1,0
12,394,394,6,6,0,1,0
0,451,451,50,32,18,4,3
5,480,480,6,6,0,1,0
4,485,485,51,51,0,1,0

5,112,112,6,6,0,1,0
1,117,117,24,14,10,2,1
2,134,134,14,14,0,1,0
4,178,178,16,16,0,1,0
9,186,186,28,10,18,2,1
0,320,320,17,17,0,1,0
8,353,353,10,10,0,1,0
3,359,359,86,29,57,4,3
7,366,366,24,4,20,3,2
6,427,427,96,74,22,2,1

6,103,103,1,1,0,1,0
7,129,129,1,1,0,1,0
9,147,147,11,8,3,2,1
11,156,156,3,3,0,1,0
0,198,198,1,1,0,1,0
12,214,214,4,1,3,2,1
2,250,250,25,14,11,2,1
3,257,257,44,4,40,2,1
10,258,258,4,4,0,1,0
8,259,259,11,1,10,3,2
1,288,288,24,11,13,3,2
13,306,306,33,33,0,1,0
5,348,348,30,26,4,2,1
4,350,350,2,2,0,1,0
15,356,356,53,53,0,1,0
16,360,360,99,99,0,1,0
14,364,364,13,7,6,2,1

12,101,101,3,3,0,1,0
13,125,125,9,9,0,1,0
4,176,176,9,9,0,1,0
5,189,189,3,3,0,1,0
9,190,190,16,16,0,1,0
11,206,206,14,6,8,2,1
3,215,215,7,7,0,1,0
2,239,239,20,10,10,3,2
0,298,298,37,37,0,1,0
7,395,395,76,27,49,2,1
6,396,396,8,1,7,2,1
1,449,449,36,6,30,4,3
8,482,482,172,55,117,4,3
10,483,483,1,1,0,1,0

7,105,105,3,3,0,1,0
2,153,153,29,29,0,1,0
4,213,213,14,14,0,1,0
3,217,217,3,3,0,1,0
14,223,223,14,14,0,1,0
8,225,225,12,12,0,1,0
0,241,241,7,2,5,2,1
12,312,312,59,13,46,4,3
13,329,329,1,1,0,1,0
5,334,334,20,12,8,3,2
11,389,389,78,54,24,4,3
15,406,406,26,4,22,3,2
6,438,438,26,19,7,2,1
10,438,438,40,16,24,3,2
1,447,447,10,10,0,1,0
9,500,500,40,29,11,2,1

12,110,110,3,3,0,1,0
2,110,110,1,1,0,1,0
1,121,121,28,7,21,2,1
10,133,133,2,2,0,1,0
4,151,151,4,4,0,1,0
8,159,159,1,1,0,1,0
14,209,209,18,18,0,1,0
16,219,219,7,7,0,1,0
3,275,275,1,1,0,1,0
17,276,276,61,61,0,1,0
5,291,291,13,9,4,2,1
13,294,294,55,55,0,1,0
7,348,348,9,9,0,1,0
6,377,377,33,33,0,1,0
0,424,424,57,57,0,1,0
9,432,432,2,2,0,1,0
15,440,440,28,28,0,1,0
11,466,466,6,6,0,1,0

13,101,101,18,7,11,2,1
2,114,114,14,14,0,1,0
1,121,121,22,11,11,2,1
9,128,128,38,38,0,1,0
3,164,164,1,1,0,1,0
10,190,190,7,1,6,3,2
8,195,195,14,14,0,1,0
5,274,274,1,1,0,1,0
12,305,305,21,8,13,2,1
0,309,309,21,6,15,4,3
11,335,335,10,4,6,3,2
4,344,344,22,6,16,2,1
14,443,443,5,5,0,1,0
6,461,461,6,2,4,2,1
7,497,497,36,36,0,1,0

0,105,105,1,1,0,1,0
2,111,111,17,17,0,1,0
8,123,123,17,17,0,1,0
12,214,214,46,46,0,1,0
1,216,216,46,7,39,2,1
7,232,232,1,1,0,1,0
6,280,280,4,4,0,1,0
5,304,304,1,1,0,1,0
10,319,319,7,7,0,1,0
9,324,324,49,11,38,3,2
4,343,343,71,38,33,4,3
11,408,408,34,8,26,4,3
3,444,444,1,1,0,1,0

5,139,139,18,18,0,1,0
10,149,149,6,6,0,1,0
3,165,165,9,9,0,1,0
11,215,215,29,29,0,1,0
0,219,219,6,6,0,1,0
9,240,240,21,21,0,1,0
1,249,249,80,44,36,4,3
7,252,252,14,14,0,1,0
4,281,281,20,6,14,2,1
2,315,315,1,1,0,1,0
6,344,344,16,10,6,2,1
8,382,382,96,37,59,4,3

8,101,101,2,2,0,1,0
7,172,172,17,2,15,4,3
1,179,179,9,3,6,2,1
5,197,197,18,9,9,2,1
2,217,217,9,9,0,1,0
6,317,317,5,5,0,1,0
3,368,368,85,85,0,1,0
4,386,386,5,1,4,2,1
9,422,422,157,157,0,1,0
0,429,429,119,59,60,4,3

8,157,157,17,17,0,1,0
5,173,173,7,7,0,1,0
2,178,178,8,8,0,1,0
3,207,207,41,17,24,3,2
1,216,216,4,4,0,1,0
7,300,300,28,13,15,4,3
4,335,335,35,35,0,1,0
9,357,357,26,20,6,2,1
0,406,406,138,68,70,4,3
6,478,478,92,41,51,4,3

4,117,117,5,2,3,2,1
12,135,135,32,32,0,1,0
2,139,139,12,12,0,1,0
0,270,270,28,28,0,1,0
10,280,280,3,3,0,1,0
13,309,309,26,5,21,4,3
9,310,310,1,1,0,1,0
7,347,347,15,15,0,1,0
5,365,365,14,7,7,2,1
6,371,371,79,10,69,4,3
14,380,380,20,20,0,1,0
15,389,389,20,5,15,2,1
8,448,448,1,1,0,1,0
16,457,457,84,84,0,1,0
1,473,473,16,5,11,2,1
11,488,488,1,1,0,1,0
3,496,496,12,12,0,1,0

9,147,147,6,3,3,2,1
1,172,172,20,5,15,2,1
4,173,173,16,16,0,1,0
10,174,174,12,12,0,1,0
3,195,195,27,27,0,1,0
2,230,230,56,19,37,2,1
6,327,327,62,62,0,1,0
5,363,363,21,21,0,1,0
0,401,401,4,4,0,1,0
8,413,413,64,16,48,4,3
7,487,487,46,11,35,2,1

9,142,142,1,1,0,1,0
0,245,245,81,13,68,3,2
2,248,248,48,48,0,1,0
5,292,292,57,15,42,2,1
3,349,349,18,15,3,2,1
7,365,365,16,7,9,2,1
1,398,398,10,10,0,1,0
8,435,435,51,51,0,1,0
6,467,467,6,6,0,1,0
4,474,474,110,104,6,2,1

13,132,132,21,3,18,2,1
0,152,152,1,1,0,1,0
4,189,189,1,1,0,1,0
7,192,192,19,7,12,2,1
8,205,205,1,1,0,1,0
10,229,229,13,13,0,1,0
14,255,255,29,22,7,2,1
12,266,266,5,5,0,1,0
2,290,290,44,6,38,2,1
3,363,363,25,25,0,1,0
15,370,370,30,30,0,1,0
6,372,372,34,1,33,4,3
5,389,389,19,7,12,3,2
11,389,389,70,70,0,1,0
1,417,417,21,3,18,3,2
9,443,443,33,13,20,2,1

1,146,146,27,27,0,1,0
6,146,146,12,12,0,1,0
2,165,165,41,4,37,2,1
3,262,262,3,3,0,1,0
9,282,282,10,10,0,1,0
8,341,341,15,2,13,2,1
7,351,351,70,52,18,2,1
0,385,385,60,56,4,2,1
4,397,397,41,7,34,4,3
5,449,449,65,65,0,1,0

0,102,102,30,1,29,3,2
5,141,141,2,2,0,1,0
1,156,156,1,1,0,1,0
8,271,271,44,44,0,1,0
7,312,312,10,10,0,1,0
3,324,324,93,93,0,1,0
6,432,432,1,1,0,1,0
2,489,489,147,131,16,3,2
4,493,493,53,3,50,3,2

0,110,110,46,3,43,2,1
1,135,135,25,6,19,4,3
2,152,152,4,1,3,2,1
6,216,216,13,3,10,2,1
3,248,248,57,18,39,3,2
7,334,334,9,9,0,1,0
4,404,404,62,62,0,1,0
5,450,450,54,42,12,4,3

8,104,104,2,2,0,1,0
2,125,125,2,2,0,1,0
9,242,242,42,42,0,1,0
5,255,255,40,40,0,1,0
7,255,255,19,2,17,2,1
3,279,279,1,1,0,1,0
1,310,310,91,16,75,4,3
0,336,336,37,37,0,1,0
10,410,410,23,23,0,1,0
6,414,414,101,101,0,1,0
11,440,440,22,4,18,4,3
4,496,496,11,11,0,1,0

0,100,100,20,8,12,2,1
4,101,101,2,2,0,1,0
2,115,115,28,28,0,1,0
5,215,215,1,1,0,1,0
1,268,268,26,26,0,1,0
9,331,331,48,48,0,1,0
3,332,332,12,3,9,4,3
7,343,343,36,26,10,3,2
11,353,353,10,3,7,2,1
8,442,442,53,21,32,2,1
6,454,454,5,5,0,1,0
10,470,470,94,8,86,4,3

0,116,116,3,3,0,1,0
7,144,144,12,1,11,2,1
9,186,186,50,29,21,4,3
3,251,251,36,36,0,1,0
1,252,252,5,5,0,1,0
5,282,282,17,17,0,1,0
2,399,399,165,102,63,4,3
8,421,421,74,74,0,1,0
4,447,447,8,8,0,1,0
6,492,492,1,1,0,1,0

8,130,130,9,9,0,1,0
12,187,187,3,3,0,1,0
4,194,194,10,10,0,1,0
14,196,196,16,9,7,2,1
13,208,208,29,11,18,3,2
15,215,215,32,19,13,2,1
2,220,220,12,2,10,2,1
0,266,266,7,7,0,1,0
11,288,288,17,17,0,1,0
5,306,306,1,1,0,1,0
6,326,326,37,15,22,3,2
9,358,358,58,58,0,1,0
10,397,397,67,40,27,2,1
1,414,414,45,45,0,1,0
3,450,450,5,5,0,1,0
7,481,481,1,1,0,1,0

7,123,123,1,1,0,1,0
12,140,140,29,7,22,3,2
0,147,147,6,6,0,1,0
1,175,175,20,20,0,1,0
9,176,176,17,1,16,3,2
10,181,181,5,5,0,1,0
4,215,215,39,39,0,1,0
2,263,263,5,5,0,1,0
3,325,325,41,41,0,1,0
5,346,346,36,36,0,1,0
6,373,373,6,6,0,1,0
8,437,437,10,10,0,1,0
11,462,462,119,98,21,4,3

5,147,147,12,6,6,2,1
0,152,152,3,3,0,1,0
7,155,155,10,3,7,2,1
6,228,228,36,4,32,3,2
2,230,230,10,4,6,2,1
10,269,269,7,7,0,1,0
8,321,321,17,17,0,1,0
3,332,332,31,31,0,1,0
12,335,335,45,15,30,3,2
11,345,345,64,32,32,2,1
4,395,395,72,51,21,4,3
9,428,428,62,62,0,1,0
1,494,494,12,12,0,1,0

11,104,104,4,1,3,2,1
6,130,130,21,5,16,4,3
8,135,135,22,22,0,1,0
4,184,184,21,21,0,1,0
12,188,188,11,11,0,1,0
5,220,220,36,24,12,3,2
0,224,224,4,4,0,1,0
9,243,243,48,48,0,1,0
3,264,264,19,19,0,1,0
2,329,329,19,19,0,1,0
7,344,344,19,19,0,1,0
1,487,487,10,7,3,2,1
10,490,490,52,52,0,1,0

5,155,155,1,1,0,1,0
14,157,157,14,3,11,2,1
8,193,193,2,2,0,1,0
3,197,197,7,4,3,2,1
10,216,216,32,32,0,1,0
15,246,246,3,3,0,1,0
2,256,256,8,8,0,1,0
13,267,267,33,12,21,2,1
4,274,274,68,18,50,3,2
1,293,293,7,7,0,1,0
9,317,317,30,15,15,2,1
7,367,367,34,34,0,1,0
12,409,409,24,24,0,1,0
11,433,433,76,27,49,4,3
0,436,436,16,6,10,3,2
6,459,459,10,10,0,1,0

4,142,142,9,1,8,3,2
10,208,208,19,1,18,2,1
5,224,224,48,48,0,1,0
8,322,322,17,17,0,1,0
2,349,349,9,3,6,2,1
1,367,367,52,4,48,4,3
7,376,376,102,102,0,1,0
6,382,382,46,31,15,2,1
0,423,423,42,9,33,4,3
11,429,429,19,5,14,2,1
9,466,466,14,14,0,1,0
3,475,475,27,11,16,2,1

2,109,109,7,7,0,1,0
11,111,111,1,1,0,1,0
6,127,127,15,1,14,3,2
10,138,138,35,35,0,1,0
3,188,188,45,1,44,2,1
5,217,217,21,6,15,4,3
4,230,230,16,16,0,1,0
7,260,260,41,41,0,1,0
1,296,296,15,1,14,2,1
9,363,363,22,12,10,3,2
8,448,448,9,9,0,1,0
0,492,492,40,40,0,1,0

2,143,143,1,1,0,1,0
1,174,174,3,3,0,1,0
9,205,205,6,6,0,1,0
3,211,211,30,9,21,4,3
11,242,242,2,2,0,1,0
12,253,253,12,12,0,1,0
10,264,264,25,4,21,2,1
6,303,303,78,78,0,1,0
7,304,304,1,1,0,1,0
14,336,336,122,122,0,1,0
4,358,358,10,10,0,1,0
0,368,368,35,35,0,1,0
8,382,382,19,7,12,3,2
5,459,459,1,1,0,1,0
13,485,485,32,2,30,2,1

9,166,166,30,12,18,3,2
5,237,237,9,6,3,2,1
6,261,261,23,17,6,2,1
0,263,263,3,3,0,1,0
2,288,288,1,1,0,1,0
8,317,317,13,13,0,1,0
3,349,349,7,7,0,1,0
4,402,402,42,2,40,3,2
1,414,414,191,183,8,2,1
10,461,461,34,20,14,3,2
7,485,485,91,91,0,1,0

11,125,125,17,4,13,4,3
0,126,126,13,13,0,1,0
10,142,142,1,1,0,1,0
9,218,218,34,18,16,2,1
6,229,229,3,3,0,1,0
4,232,232,40,40,0,1,0
2,237,237,33,33,0,1,0
8,262,262,28,1,27,2,1
1,273,273,11,4,7,2,1
13,385,385,46,46,0,1,0
3,386,386,6,2,4,2,1
7,404,404,14,5,9,4,3
5,429,429,35,12,23,2,1
12,500,500,42,27,15,2,1

1,153,153,11,11,0,1,0
13,171,171,1,1,0,1,0
8,222,222,14,2,12,2,1
9,237,237,51,30,21,3,2
2,239,239,15,15,0,1,0
11,239,239,15,15,0,1,0
0,264,264,7,7,0,1,0
3,275,275,3,3,0,1,0
6,281,281,8,8,0,1,0
4,284,284,33,33,0,1,0
7,295,295,58,29,29,2,1
5,310,310,27,7,20,3,2
12,343,343,10,2,8,3,2
10,494,494,118,97,21,2,1

10,103,103,5,2,3,2,1
3,114,114,9,9,0,1,0
0,126,126,1,1,0,1,0
5,178,178,30,3,27,4,3
12,189,189,21,21,0,1,0
9,219,219,15,5,10,3,2
7,282,282,15,9,6,2,1
11,342,342,25,25,0,1,0
2,357,357,33,18,15,4,3
6,377,377,21,9,12,2,1
1,405,405,19,12,7,3,2
8,414,414,9,9,0,1,0
4,436,436,43,5,38,4,3
13,496,496,145,134,11,2,1

8,154,154,4,4,0,1,0
5,266,266,74,74,0,1,0
12,272,272,91,31,60,4,3
7,280,280,10,6,4,2,1
10,280,280,9,3,6,3,2
0,305,305,32,32,0,1,0
2,306,306,28,28,0,1,0
3,414,414,3,3,0,1,0
1,443,443,10,2,8,2,1
6,446,446,39,39,0,1,0
9,460,460,18,15,3,2,1
4,469,469,4,4,0,1,0
11,499,499,71,71,0,1,0

0,105,105,10,10,0,1,0
4,145,145,9,1,8,3,2
6,164,164,9,1,8,2,1
3,186,186,10,10,0,1,0
12,210,210,7,7,0,1,0
11,216,216,33,33,0,1,0
13,218,218,6,6,0,1,0
1,236,236,6,6,0,1,0
9,284,284,42,42,0,1,0
8,328,328,63,20,43,2,1
5,358,358,19,4,15,2,1
2,394,394,93,93,0,1,0
10,419,419,24,2,22,2,1
7,472,472,10,10,0,1,0

0,112,112,5,2,3,2,1
6,120,120,11,11,0,1,0
11,145,145,5,1,4,2,1
3,180,180,28,28,0,1,0
1,210,210,21,21,0,1,0
9,263,263,2,2,0,1,0
4,279,279,19,19,0,1,0
7,284,284,36,36,0,1,0
10,306,306,42,15,27,2,1
2,342,342,47,8,39,4,3
8,342,342,83,7,76,3,2
12,429,429,26,5,21,2,1
5,471,471,4,4,0,1,0

2,134,134,22,22,0,1,0
6,205,205,7,7,0,1,0
3,207,207,8,8,0,1,0
10,264,264,17,17,0,1,0
9,305,305,19,19,0,1,0
1,310,310,18,3,15,4,3
7,335,335,25,20,5,2,1
11,362,362,22,4,18,4,3
4,384,384,16,16,0,1,0
5,410,410,14,1,13,2,1
0,464,464,108,42,66,4,3
8,478,478,72,72,0,1,0
12,485,485,95,49,46,3,2

10,155,155,2,2,0,1,0
12,167,167,41,31,10,2,1
6,178,178,5,5,0,1,0
8,185,185,14,2,12,3,2
2,238,238,12,12,0,1,0
7,274,274,64,51,13,2,1
3,314,314,17,17,0,1,0
5,323,323,67,33,34,3,2
1,357,357,20,15,5,2,1
0,361,361,38,18,20,3,2
9,414,414,10,10,0,1,0
4,445,445,45,15,30,2,1
11,459,459,10,10,0,1,0

12,104,104,4,4,0,1,0
5,113,113,1,1,0,1,0
6,124,124,5,5,0,1,0
2,144,144,38,8,30,4,3
11,148,148,19,19,0,1,0
1,185,185,26,26,0,1,0
7,198,198,8,8,0,1,0
9,218,218,10,3,7,2,1
8,254,254,25,25,0,1,0
3,263,263,10,10,0,1,0
0,282,282,11,5,6,3,2
10,285,285,33,33,0,1,0
4,337,337,11,11,0,1,0
13,490,490,93,75,18,2,1

10,115,115,35,20,15,4,3
13,141,141,20,20,0,1,0
3,197,197,9,1,8,3,2
1,236,236,11,11,0,1,0
2,256,256,54,20,34,3,2
9,280,280,5,5,0,1,0
4,302,302,42,42,0,1,0
6,309,309,16,16,0,1,0
11,325,325,15,7,8,2,1
0,360,360,28,4,24,2,1
5,385,385,1,1,0,1,0
7,415,415,11,11,0,1,0
8,467,467,45,19,26,2,1
12,467,467,2,2,0,1,0

4,106,106,5,5,0,1,0
8,123,123,6,6,0,1,0
6,173,173,1,1,0,1,0
11,173,173,25,13,12,4,3
2,194,194,2,2,0,1,0
5,213,213,29,23,6,3,2
3,238,238,7,7,0,1,0
13,253,253,60,40,20,2,1
14,256,256,1,1,0,1,0
12,262,262,28,28,0,1,0
1,314,314,5,2,3,2,1
10,398,398,40,4,36,4,3
16,407,407,6,3,3,2,1
7,408,408,37,14,23,2,1
9,422,422,30,30,0,1,0
15,439,439,48,4,44,2,1
0,444,444,20,20,0,1,0

3,106,106,11,5,6,3,2
11,143,143,39,36,3,2,1
10,196,196,13,2,11,2,1
8,202,202,8,8,0,1,0
6,235,235,22,2,20,2,1
0,316,316,3,3,0,1,0
9,321,321,18,18,0,1,0
4,345,345,1,1,0,1,0
1,404,404,58,58,0,1,0
14,425,425,23,2,21,2,1
7,431,431,1,1,0,1,0
2,434,434,32,2,30,3,2
5,449,449,61,11,50,2,1
12,460,460,57,12,45,4,3
13,481,481,19,19,0,1,0

3,115,115,10,1,9,4,3
7,146,146,11,2,9,4,3
8,199,199,25,3,22,2,1
1,210,210,35,5,30,4,3
0,228,228,53,10,43,2,1
6,291,291,52,52,0,1,0
4,379,379,50,50,0,1,0
2,418,418,84,84,0,1,0
5,418,418,6,6,0,1,0

2,243,243,20,10,10,3,2
4,304,304,29,7,22,3,2
6,321,321,32,26,6,2,1
5,340,340,5,5,0,1,0
8,354,354,25,25,0,1,0
1,376,376,139,41,98,3,2
0,379,379,3,3,0,1,0
11,380,380,3,3,0,1,0
7,408,408,130,126,4,2,1
10,433,433,21,3,18,3,2
9,436,436,29,3,26,2,1
3,449,449,14,2,12,3,2

10,117,117,24,15,9,2,1
8,128,128,5,1,4,2,1
11,152,152,30,30,0,1,0
4,154,154,4,4,0,1,0
12,157,157,1,1,0,1,0
1,229,229,22,2,20,3,2
3,245,245,34,24,10,2,1
6,312,312,31,31,0,1,0
13,348,348,30,15,15,4,3
9,404,404,33,33,0,1,0
7,412,412,66,33,33,4,3
0,419,419,2,2,0,1,0
5,453,453,25,7,18,4,3
2,460,460,10,10,0,1,0

6,183,183,8,2,6,3,2
5,200,200,21,21,0,1,0
1,205,205,51,18,33,2,1
7,233,233,71,71,0,1,0
9,239,239,10,10,0,1,0
4,337,337,13,13,0,1,0
0,376,376,8,8,0,1,0
10,386,386,6,6,0,1,0
3,414,414,95,22,73,4,3
8,437,437,44,44,0,1,0
2,475,475,30,30,0,1,0

0,184,184,10,10,0,1,0
9,196,196,39,8,31,3,2
5,250,250,9,1,8,3,2
2,266,266,12,12,0,1,0
3,282,282,44,36,8,3,2
7,432,432,38,15,23,2,1
1,446,446,155,32,123,4,3
8,474,474,35,35,0,1,0
4,497,497,88,52,36,2,1
6,498,498,17,8,9,4,3

1,115,115,9,3,6,2,1
7,130,130,14,6,8,2,1
10,138,138,4,4,0,1,0
0,152,152,2,2,0,1,0
11,154,154,24,24,0,1,0
13,161,161,6,6,0,1,0
9,194,194,41,1,40,2,1
8,260,260,30,30,0,1,0
2,368,368,29,23,6,3,2
5,411,411,17,5,12,3,2
4,447,447,56,24,32,3,2
6,466,466,1,1,0,1,0
12,490,490,35,5,30,4,3
3,497,497,77,77,0,1,0

11,103,103,15,15,0,1,0
1,175,175,14,14,0,1,0
4,189,189,16,16,0,1,0
9,210,210,3,3,0,1,0
0,241,241,26,1,25,3,2
2,322,322,78,78,0,1,0
3,345,345,5,5,0,1,0
5,346,346,25,25,0,1,0
10,379,379,43,43,0,1,0
8,393,393,26,9,17,4,3
6,434,434,82,82,0,1,0
7,476,476,40,40,0,1,0

1,102,102,39,39,0,1,0
2,162,162,16,16,0,1,0
7,183,183,4,4,0,1,0
8,193,193,5,5,0,1,0
4,276,276,15,4,11,2,1
9,329,329,42,11,31,2,1
6,385,385,64,25,39,2,1
5,400,400,86,86,0,1,0
0,483,483,55,22,33,4,3
3,499,499,3,3,0,1,0

11,157,157,8,8,0,1,0
6,186,186,69,54,15,4,3
7,213,213,4,4,0,1,0
2,296,296,31,31,0,1,0
0,312,312,43,28,15,4,3
9,388,388,1,1,0,1,0
10,390,390,12,12,0,1,0
1,418,418,2,2,0,1,0
3,450,450,96,96,0,1,0
5,462,462,55,55,0,1,0
8,476,476,65,46,19,2,1
4,491,491,10,10,0,1,0

9,104,104,2,2,0,1,0
6,108,108,8,8,0,1,0
1,112,112,2,2,0,1,0
5,138,138,3,3,0,1,0
10,153,153,14,14,0,1,0
0,174,174,11,11,0,1,0
3,190,190,37,37,0,1,0
12,238,238,40,30,10,2,1
8,244,244,4,4,0,1,0
2,330,330,41,41,0,1,0
11,349,349,7,3,4,2,1
4,357,357,35,17,18,2,1
13,430,430,128,8,120,4,3
7,500,500,4,4,0,1,0

1,138,138,20,9,11,2,1
2,164,164,30,1,29,2,1
12,168,168,47,47,0,1,0
3,184,184,24,24,0,1,0
9,190,190,1,1,0,1,0
0,200,200,3,3,0,1,0
5,205,205,1,1,0,1,0
4,209,209,1,1,0,1,0
7,222,222,23,23,0,1,0
11,316,316,33,7,26,3,2
13,317,317,24,24,0,1,0
6,355,355,6,6,0,1,0
10,372,372,34,34,0,1,0
8,495,495,27,27,0,1,0

8,119,119,16,16,0,1,0
1,125,125,18,9,9,2,1
2,176,176,40,40,0,1,0
0,182,182,6,6,0,1,0
4,191,191,5,2,3,2,1
5,192,192,12,8,4,2,1
3,251,251,27,27,0,1,0
10,297,297,41,13,28,2,1
11,299,299,8,8,0,1,0
6,303,303,2,2,0,1,0
9,328,328,56,40,16,3,2
7,449,449,62,7,55,4,3

4,112,112,16,16,0,1,0
6,122,122,9,9,0,1,0
1,162,162,15,15,0,1,0
3,164,164,10,10,0,1,0
8,243,243,52,18,34,2,1
7,247,247,2,2,0,1,0
9,268,268,57,37,20,3,2
11,333,333,8,8,0,1,0
0,363,363,5,5,0,1,0
10,379,379,2,2,0,1,0
5,390,390,13,1,12,2,1
12,439,439,63,63,0,1,0
2,498,498,93,48,45,2,1

3,103,103,4,4,0,1,0
10,103,103,19,19,0,1,0
5,118,118,2,2,0,1,0
4,169,169,15,9,6,2,1
9,187,187,24,21,3,2,1
13,193,193,4,4,0,1,0
2,232,232,17,17,0,1,0
14,244,244,78,26,52,3,2
6,268,268,3,3,0,1,0
7,277,277,15,4,11,2,1
0,285,285,14,9,5,2,1
11,292,292,9,1,8,2,1
8,341,341,38,38,0,1,0
15,357,357,10,10,0,1,0
12,402,402,13,13,0,1,0
1,493,493,16,16,0,1,0

13,103,103,4,4,0,1,0
6,104,104,5,2,3,2,1
3,198,198,16,1,15,2,1
7,225,225,11,5,6,3,2
4,231,231,2,2,0,1,0
5,255,255,25,25,0,1,0
8,269,269,21,21,0,1,0
0,273,273,1,1,0,1,0
12,312,312,109,6,103,4,3
2,333,333,77,62,15,4,3
11,353,353,27,27,0,1,0
1,385,385,32,28,4,2,1
9,446,446,7,7,0,1,0
10,471,471,25,25,0,1,0

10,112,112,24,10,14,4,3
11,113,113,1,1,0,1,0
6,125,125,2,2,0,1,0
3,142,142,2,2,0,1,0
1,170,170,44,32,12,2,1
0,228,228,38,18,20,3,2
8,248,248,13,13,0,1,0
12,334,334,43,43,0,1,0
7,339,339,22,22,0,1,0
2,372,372,36,5,31,2,1
4,386,386,2,2,0,1,0
5,450,450,20,20,0,1,0
9,465,465,67,67,0,1,0

1,135,135,2,2,0,1,0
0,138,138,47,47,0,1,0
3,200,200,3,3,0,1,0
10,211,211,4,4,0,1,0
11,263,263,25,16,9,4,3
2,267,267,15,15,0,1,0
9,312,312,26,16,10,3,2
6,322,322,22,22,0,1,0
7,357,357,92,48,44,3,2
5,417,417,49,34,15,2,1
8,461,461,38,4,34,2,1
4,468,468,27,27,0,1,0

1,128,128,17,17,0,1,0
7,206,206,6,6,0,1,0
8,223,223,4,4,0,1,0
0,230,230,6,6,0,1,0
9,261,261,19,19,0,1,0
13,265,265,5,1,4,2,1
4,303,303,38,38,0,1,0
3,313,313,16,7,9,2,1
10,338,338,19,19,0,1,0
2,350,350,36,9,27,4,3
12,365,365,103,103,0,1,0
11,401,401,66,32,34,3,2
6,464,464,30,30,0,1,0
5,490,490,35,1,34,2,1

1,195,195,29,29,0,1,0
3,299,299,4,1,3,2,1
2,311,311,1,1,0,1,0
7,328,328,15,15,0,1,0
13,331,331,116,116,0,1,0
8,335,335,20,20,0,1,0
11,368,368,7,1,6,2,1
6,391,391,32,32,0,1,0
14,425,425,23,23,0,1,0
0,437,437,53,53,0,1,0
4,455,455,7,7,0,1,0
5,457,457,26,26,0,1,0
9,465,465,26,26,0,1,0
15,467,467,47,47,0,1,0
12,488,488,31,31,0,1,0
10,494,494,10,10,0,1,0

10,156,156,2,2,0,1,0
11,159,159,7,7,0,1,0
8,165,165,6,6,0,1,0
14,174,174,40,40,0,1,0
6,190,190,2,2,0,1,0
3,196,196,11,11,0,1,0
1,267,267,39,19,20,2,1
15,283,283,23,23,0,1,0
9,310,310,8,2,6,2,1
12,333,333,44,16,28,3,2
13,373,373,28,4,24,3,2
5,382,382,30,30,0,1,0
0,385,385,16,16,0,1,0
17,414,414,14,3,11,2,1
7,416,416,9,9,0,1,0
4,418,418,13,13,0,1,0
2,420,420,42,42,0,1,0
16,477,477,29,29,0,1,0

10,131,131,3,3,0,1,0
8,149,149,3,3,0,1,0
5,155,155,2,2,0,1,0
6,158,158,13,13,0,1,0
4,212,212,12,3,9,4,3
7,277,277,5,5,0,1,0
3,286,286,6,1,5,2,1
0,305,305,18,9,9,2,1
1,360,360,125,3,122,4,3
9,366,366,17,4,13,2,1
11,487,487,205,142,63,4,3
2,496,496,54,30,24,2,1

12,170,170,7,7,0,1,0
13,178,178,13,4,9,2,1
14,212,212,55,10,45,2,1
3,215,215,2,2,0,1,0
11,227,227,13,13,0,1,0
0,230,230,16,2,14,3,2
2,230,230,32,32,0,1,0
1,247,247,16,16,0,1,0
6,259,259,29,29,0,1,0
9,266,266,36,36,0,1,0
5,271,271,27,27,0,1,0
10,280,280,11,4,7,2,1
8,352,352,7,7,0,1,0
4,378,378,1,1,0,1,0
7,490,490,42,42,0,1,0

4,118,118,9,4,5,2,1
3,129,129,5,1,4,2,1
16,142,142,7,1,6,3,2
15,173,173,17,5,12,3,2
12,209,209,8,8,0,1,0
11,222,222,48,48,0,1,0
2,245,245,6,6,0,1,0
10,271,271,10,10,0,1,0
5,302,302,13,13,0,1,0
7,332,332,15,6,9,2,1
8,332,332,23,6,17,2,1
9,336,336,25,25,0,1,0
0,343,343,11,4,7,3,2
6,366,366,1,1,0,1,0
1,372,372,59,59,0,1,0
14,438,438,31,31,0,1,0
13,482,482,67,67,0,1,0

0,148,148,4,4,0,1,0
9,179,179,3,3,0,1,0
7,249,249,27,19,8,2,1
6,336,336,1,1,0,1,0
3,364,364,92,18,74,3,2
11,383,383,111,78,33,4,3
2,395,395,13,13,0,1,0
8,463,463,60,60,0,1,0
1,490,490,20,20,0,1,0
10,491,491,31,3,28,3,2
5,493,493,39,21,18,3,2
4,496,496,84,15,69,4,3

10,101,101,10,5,5,2,1
1,124,124,6,6,0,1,0
7,226,226,30,15,15,4,3
5,237,237,35,35,0,1,0
8,245,245,66,66,0,1,0
6,254,254,6,6,0,1,0
3,264,264,1,1,0,1,0
2,302,302,93,75,18,3,2
11,309,309,17,17,0,1,0
9,339,339,11,1,10,2,1
0,357,357,16,6,10,3,2
4,398,398,20,12,8,3,2

3,202,202,21,21,0,1,0
1,215,215,15,5,10,2,1
0,219,219,17,17,0,1,0
8,228,228,19,11,8,2,1
2,311,311,60,1,59,4,3
9,337,337,46,7,39,3,2
5,370,370,74,74,0,1,0
7,380,380,31,31,0,1,0
4,409,409,64,64,0,1,0
6,450,450,30,15,15,4,3
10,451,451,20,2,18,4,3

5,133,133,46,7,39,4,3
10,173,173,23,1,22,2,1
3,197,197,11,11,0,1,0
9,246,246,24,20,4,2,1
0,364,364,30,9,21,4,3
8,386,386,43,43,0,1,0
1,425,425,11,11,0,1,0
2,430,430,14,14,0,1,0
4,436,436,27,16,11,4,3
7,441,441,31,31,0,1,0
11,442,442,30,30,0,1,0
6,495,495,64,52,12,4,3

6,205,205,79,22,57,3,2
10,245,245,6,6,0,1,0
3,298,298,44,10,34,3,2
4,326,326,34,34,0,1,0
2,345,345,62,24,38,3,2
1,358,358,4,4,0,1,0
11,380,380,5,5,0,1,0
8,390,390,19,19,0,1,0
0,432,432,65,9,56,4,3
9,446,446,12,12,0,1,0
7,450,450,50,50,0,1,0
5,468,468,4,1,3,2,1

3,144,144,14,5,9,2,1
12,165,165,40,1,39,4,3
10,170,170,17,5,12,4,3
7,198,198,4,1,3,2,1
5,221,221,34,11,23,2,1
9,303,303,58,58,0,1,0
6,375,375,1,1,0,1,0
0,377,377,87,87,0,1,0
13,411,411,20,5,15,2,1
4,451,451,5,5,0,1,0
8,457,457,9,3,6,2,1
2,458,458,19,19,0,1,0
11,486,486,5,5,0,1,0
1,492,492,23,23,0,1,0

6,236,236,52,52,0,1,0
0,290,290,12,12,0,1,0
8,300,300,27,23,4,2,1
1,305,305,80,80,0,1,0
9,336,336,2,2,0,1,0
10,339,339,47,17,30,3,2
4,376,376,68,68,0,1,0
5,416,416,16,2,14,3,2
2,442,442,46,1,45,2,1
7,477,477,57,30,27,3,2
3,493,493,6,6,0,1,0

5,109,109,24,11,13,2,1
11,122,122,7,7,0,1,0
0,142,142,9,9,0,1,0
8,176,176,22,22,0,1,0
10,196,196,25,6,19,2,1
6,244,244,26,2,24,4,3
4,273,273,13,13,0,1,0
9,275,275,17,17,0,1,0
3,349,349,7,4,3,2,1
1,373,373,2,2,0,1,0
7,379,379,18,9,9,4,3
2,434,434,39,39,0,1,0
12,449,449,48,48,0,1,0
13,455,455,60,60,0,1,0

8,150,150,11,11,0,1,0
2,213,213,32,32,0,1,0
7,228,228,24,24,0,1,0
5,235,235,21,8,13,3,2
0,236,236,7,3,4,2,1
9,298,298,108,14,94,3,2
12,301,301,10,10,0,1,0
6,315,315,45,22,23,2,1
10,334,334,5,5,0,1,0
1,382,382,39,27,12,4,3
4,428,428,18,15,3,2,1
3,452,452,20,8,12,3,2
11,452,452,11,8,3,2,1

7,122,122,16,16,0,1,0
5,124,124,19,19,0,1,0
8,125,125,28,28,0,1,0
0,181,181,8,2,6,3,2
9,186,186,3,3,0,1,0
6,228,228,2,2,0,1,0
1,232,232,53,53,0,1,0
4,276,276,24,24,0,1,0
3,339,339,14,2,12,2,1
2,365,365,105,90,15,2,1

1,145,145,73,22,51,4,3
7,223,223,14,14,0,1,0
0,308,308,30,14,16,2,1
3,357,357,19,11,8,2,1
4,373,373,7,7,0,1,0
2,410,410,93,93,0,1,0
5,445,445,67,7,60,3,2
6,477,477,45,18,27,4,3

12,108,108,4,4,0,1,0
10,120,120,15,15,0,1,0
8,153,153,18,2,16,3,2
7,157,157,2,2,0,1,0
3,197,197,15,15,0,1,0
14,225,225,20,1,19,4,3
0,246,246,3,3,0,1,0
4,246,246,8,8,0,1,0
13,352,352,44,14,30,4,3
5,386,386,29,11,18,4,3
6,431,431,19,19,0,1,0
11,457,457,28,13,15,2,1
1,486,486,71,71,0,1,0
9,493,493,91,83,8,2,1
2,495,495,42,18,24,2,1

9,104,104,26,7,19,2,1
2,194,194,18,10,8,2,1
0,211,211,10,6,4,2,1
1,223,223,13,13,0,1,0
12,330,330,24,10,14,3,2
11,336,336,30,30,0,1,0
10,356,356,28,28,0,1,0
8,358,358,42,9,33,4,3
7,361,361,1,1,0,1,0
3,387,387,27,27,0,1,0
5,406,406,65,2,63,4,3
4,444,444,67,10,57,4,3
6,469,469,10,1,9,2,1

5,150,150,34,34,0,1,0
8,175,175,2,2,0,1,0
9,185,185,26,2,24,2,1
1,230,230,4,4,0,1,0
6,257,257,22,22,0,1,0
2,262,262,20,13,7,2,1
0,336,336,3,3,0,1,0
4,344,344,80,57,23,4,3
10,422,422,45,36,9,2,1
3,460,460,18,13,5,2,1
7,463,463,61,61,0,1,0
11,465,465,63,63,0,1,0

0,103,103,3,3,0,1,0
2,111,111,14,14,0,1,0
5,114,114,1,1,0,1,0
11,149,149,27,27,0,1,0
10,201,201,3,3,0,1,0
8,214,214,5,5,0,1,0
9,217,217,15,9,6,2,1
7,237,237,6,1,5,2,1
6,297,297,48,48,0,1,0
3,344,344,27,5,22,3,2
4,368,368,31,19,12,2,1
12,406,406,61,61,0,1,0
13,478,478,83,47,36,2,1
1,481,481,42,42,0,1,0

0,125,125,10,10,0,1,0
8,139,139,20,20,0,1,0
5,175,175,25,13,12,4,3
2,219,219,25,25,0,1,0
1,228,228,1,1,0,1,0
11,254,254,52,52,0,1,0
7,261,261,13,8,5,2,1
3,263,263,4,4,0,1,0
10,276,276,43,13,30,4,3
6,307,307,26,26,0,1,0
9,381,381,21,21,0,1,0
4,393,393,44,30,14,3,2
13,402,402,18,18,0,1,0
12,443,443,5,1,4,2,1

8,121,121,13,5,8,3,2
0,148,148,5,5,0,1,0
4,219,219,14,14,0,1,0
1,223,223,8,8,0,1,0
5,335,335,74,20,54,4,3
6,360,360,3,3,0,1,0
9,384,384,12,12,0,1,0
7,390,390,24,24,0,1,0
3,417,417,88,7,81,4,3
10,480,480,84,62,22,2,1
2,481,481,124,124,0,1,0

5,146,146,3,3,0,1,0
12,151,151,8,2,6,2,1
9,162,162,12,12,0,1,0
21,179,179,2,2,0,1,0
15,182,182,4,4,0,1,0
6,208,208,13,13,0,1,0
0,224,224,14,14,0,1,0
2,243,243,7,1,6,3,2
17,271,271,46,10,36,3,2
10,279,279,26,26,0,1,0
19,321,321,3,3,0,1,0
16,333,333,15,15,0,1,0
4,357,357,13,2,11,2,1
11,360,360,1,1,0,1,0
1,364,364,6,3,3,2,1
14,394,394,6,6,0,1,0
20,403,403,7,7,0,1,0
7,414,414,17,17,0,1,0
13,434,434,5,5,0,1,0
8,453,453,4,4,0,1,0
3,485,485,27,3,24,2,1
18,500,500,180,93,87,4,3

9,120,120,4,4,0,1,0
3,188,188,7,7,0,1,0
5,194,194,79,17,62,4,3
8,203,203,49,7,42,4,3
11,214,214,28,2,26,3,2
6,239,239,2,2,0,1,0
2,345,345,21,21,0,1,0
10,361,361,51,21,30,3,2
7,371,371,21,2,19,2,1
0,414,414,4,1,3,2,1
1,433,433,31,7,24,2,1
4,439,439,6,6,0,1,0

12,133,133,7,2,5,2,1
0,135,135,20,20,0,1,0
8,144,144,1,1,0,1,0
4,157,157,13,13,0,1,0
6,185,185,6,6,0,1,0
7,214,214,4,4,0,1,0
13,270,270,72,39,33,4,3
11,289,289,40,22,18,4,3
1,302,302,54,54,0,1,0
5,330,330,9,1,8,3,2
3,358,358,6,3,3,2,1
9,432,432,61,11,50,3,2
10,449,449,2,2,0,1,0
2,486,486,47,14,33,4,3

4,106,106,1,1,0,1,0
0,110,110,1,1,0,1,0
13,112,112,8,1,7,2,1
8,164,164,11,11,0,1,0
11,176,176,38,8,30,4,3
1,194,194,10,10,0,1,0
6,216,216,19,19,0,1,0
14,229,229,28,12,16,2,1
7,253,253,19,13,6,3,2
9,256,256,5,5,0,1,0
2,288,288,3,3,0,1,0
10,332,332,49,49,0,1,0
5,342,342,30,30,0,1,0
12,405,405,17,17,0,1,0
3,413,413,85,37,48,3,2

4,122,122,1,1,0,1,0
14,140,140,2,2,0,1,0
12,191,191,65,65,0,1,0
7,256,256,22,15,7,2,1
8,353,353,47,13,34,3,2
2,354,354,14,5,9,2,1
1,357,357,21,12,9,2,1
0,360,360,22,15,7,2,1
6,373,373,14,4,10,2,1
10,409,409,27,27,0,1,0
13,437,437,21,21,0,1,0
5,446,446,76,48,28,3,2
3,456,456,3,3,0,1,0
11,485,485,49,49,0,1,0
9,494,494,18,9,9,4,3

8,115,115,42,42,0,1,0
12,119,119,29,29,0,1,0
1,146,146,6,6,0,1,0
10,174,174,29,29,0,1,0
13,181,181,2,2,0,1,0
5,188,188,3,3,0,1,0
14,199,199,16,4,12,3,2
7,226,226,1,1,0,1,0
11,275,275,13,5,8,3,2
2,293,293,20,9,11,2,1
6,308,308,15,15,0,1,0
3,318,318,4,4,0,1,0
9,328,328,22,22,0,1,0
0,405,405,12,12,0,1,0
4,488,488,7,7,0,1,0

15,114,114,2,2,0,1,0
3,125,125,2,2,0,1,0
5,130,130,20,20,0,1,0
1,168,168,8,8,0,1,0
2,217,217,8,8,0,1,0
9,229,229,2,2,0,1,0
14,254,254,26,6,20,3,2
7,272,272,10,10,0,1,0
11,289,289,17,17,0,1,0
6,291,291,2,2,0,1,0
8,302,302,53,24,29,2,1
4,308,308,13,13,0,1,0
12,322,322,54,24,30,3,2
10,373,373,53,53,0,1,0
0,413,413,32,14,18,4,3
13,442,442,56,8,48,2,1

4,215,215,25,4,21,4,3
6,246,246,20,20,0,1,0
2,405,405,43,43,0,1,0
3,437,437,10,10,0,1,0
0,460,460,97,77,20,2,1
5,460,460,124,34,90,4,3
1,466,466,132,51,81,4,3
8,480,480,44,5,39,2,1
7,481,481,14,2,12,2,1

9,129,129,16,16,0,1,0
3,148,148,6,1,5,2,1
5,209,209,10,10,0,1,0
6,229,229,39,39,0,1,0
7,230,230,21,11,10,4,3
2,237,237,42,42,0,1,0
8,248,248,32,10,22,3,2
0,381,381,25,25,0,1,0
4,398,398,118,61,57,4,3
1,403,403,9,9,0,1,0
10,481,481,28,16,12,3,2

0,140,140,16,10,6,3,2
11,162,162,7,7,0,1,0
9,165,165,32,21,11,3,2
13,165,165,14,14,0,1,0
6,195,195,1,1,0,1,0
10,217,217,7,1,6,2,1
1,272,272,77,77,0,1,0
5,300,300,5,5,0,1,0
2,308,308,1,1,0,1,0
8,329,329,51,47,4,2,1
12,340,340,36,36,0,1,0
4,409,409,9,3,6,3,2
7,416,416,13,13,0,1,0
3,498,498,62,14,48,3,2

0,202,202,8,1,7,2,1
6,284,284,8,3,5,2,1
3,305,305,18,3,15,4,3
2,314,314,40,12,28,3,2
1,322,322,9,6,3,2,1
4,334,334,116,116,0,1,0
10,382,382,15,6,9,4,3
8,400,400,111,111,0,1,0
5,408,408,40,40,0,1,0
9,437,437,29,29,0,1,0
7,440,440,43,6,37,2,1

4,121,121,18,18,0,1,0
10,156,156,8,8,0,1,0
2,183,183,18,18,0,1,0
12,222,222,26,14,12,2,1
8,304,304,40,10,30,2,1
6,316,316,77,61,16,3,2
1,319,319,2,2,0,1,0
9,328,328,65,47,18,2,1
3,385,385,3,3,0,1,0
7,406,406,12,12,0,1,0
11,408,408,36,36,0,1,0
5,430,430,35,35,0,1,0
0,441,441,7,7,0,1,0

1,125,125,1,1,0,1,0
12,188,188,33,33,0,1,0
8,197,197,4,4,0,1,0
4,205,205,22,13,9,4,3
9,220,220,1,1,0,1,0
10,220,220,66,26,40,3,2
3,245,245,10,2,8,3,2
5,396,396,53,5,48,4,3
6,397,397,66,52,14,2,1
2,441,441,44,44,0,1,0
11,454,454,14,2,12,2,1
7,458,458,35,25,10,3,2
0,495,495,23,23,0,1,0

11,148,148,20,7,13,2,1
14,151,151,2,2,0,1,0
13,211,211,3,3,0,1,0
9,225,225,44,36,8,2,1
8,261,261,10,7,3,2,1
10,288,288,25,10,15,4,3
6,296,296,11,7,4,2,1
4,305,305,5,5,0,1,0
1,359,359,90,41,49,2,1
5,359,359,6,3,3,2,1
3,365,365,5,5,0,1,0
2,386,386,8,8,0,1,0
0,420,420,52,52,0,1,0
12,462,462,80,71,9,4,3
7,471,471,39,18,21,4,3

13,170,170,5,5,0,1,0
8,186,186,8,8,0,1,0
5,202,202,19,5,14,2,1
4,221,221,7,7,0,1,0
7,230,230,8,8,0,1,0
3,244,244,1,1,0,1,0
6,253,253,32,32,0,1,0
0,314,314,37,37,0,1,0
11,335,335,3,3,0,1,0
9,381,381,10,10,0,1,0
14,408,408,124,88,36,2,1
10,441,441,41,17,24,2,1
2,481,481,30,30,0,1,0
12,483,483,70,70,0,1,0
1,485,485,42,9,33,4,3

10,119,119,12,6,6,2,1
0,184,184,12,2,10,2,1
9,233,233,31,1,30,3,2
7,245,245,12,12,0,1,0
1,361,361,35,35,0,1,0
3,364,364,99,63,36,3,2
11,370,370,12,2,10,3,2
6,399,399,66,12,54,4,3
8,399,399,51,7,44,2,1
4,423,423,51,35,16,2,1
2,448,448,8,1,7,2,1
5,457,457,13,7,6,2,1

1,114,114,22,10,12,3,2
3,114,114,9,9,0,1,0
7,130,130,25,25,0,1,0
6,174,174,18,18,0,1,0
2,201,201,6,6,0,1,0
12,216,216,26,26,0,1,0
0,263,263,7,1,6,2,1
4,267,267,21,1,20,3,2
5,300,300,28,28,0,1,0
10,306,306,43,19,24,2,1
11,367,367,20,20,0,1,0
9,371,371,13,13,0,1,0
8,441,441,28,12,16,3,2

0,103,103,1,1,0,1,0
1,128,128,42,34,8,2,1
7,185,185,74,74,0,1,0
3,208,208,10,10,0,1,0
5,211,211,26,26,0,1,0
8,308,308,16,16,0,1,0
9,319,319,16,16,0,1,0
6,338,338,1,1,0,1,0
4,362,362,24,24,0,1,0
11,410,410,38,38,0,1,0
2,434,434,11,11,0,1,0
10,435,435,6,2,4,2,1

7,214,214,18,18,0,1,0
2,230,230,1,1,0,1,0
12,248,248,24,24,0,1,0
8,262,262,24,24,0,1,0
5,281,281,24,2,22,2,1
9,305,305,23,23,0,1,0
13,338,338,65,23,42,3,2
0,367,367,6,6,0,1,0
6,378,378,37,37,0,1,0
10,386,386,52,26,26,2,1
3,407,407,48,7,41,2,1
1,417,417,64,64,0,1,0
11,422,422,10,10,0,1,0
4,489,489,20,10,10,3,2

10,124,124,16,4,12,4,3
5,180,180,18,1,17,2,1
7,210,210,8,8,0,1,0
3,240,240,73,27,46,3,2
2,320,320,45,13,32,2,1
6,325,325,1,1,0,1,0
9,379,379,63,63,0,1,0
8,382,382,70,45,25,4,3
4,413,413,12,3,9,2,1
0,421,421,2,2,0,1,0
1,432,432,53,53,0,1,0

8,109,109,2,2,0,1,0
3,134,134,1,1,0,1,0
6,143,143,2,2,0,1,0
9,179,179,4,4,0,1,0
7,188,188,13,13,0,1,0
4,193,193,42,42,0,1,0
10,193,193,5,5,0,1,0
5,256,256,119,53,66,3,2
0,271,271,34,4,30,3,2
2,360,360,22,7,15,2,1
1,425,425,82,17,65,3,2

9,101,101,1,1,0,1,0
1,168,168,13,13,0,1,0
4,201,201,10,10,0,1,0
5,249,249,17,17,0,1,0
6,249,249,9,1,8,2,1
11,287,287,47,9,38,4,3
2,297,297,37,37,0,1,0
12,344,344,19,19,0,1,0
10,406,406,77,39,38,3,2
3,456,456,73,38,35,2,1
0,462,462,40,40,0,1,0
7,493,493,44,44,0,1,0
8,499,499,52,52,0,1,0

1,141,141,56,16,40,4,3
0,189,189,33,22,11,2,1
2,194,194,6,6,0,1,0
3,215,215,2,2,0,1,0
5,233,233,10,10,0,1,0
6,287,287,7,7,0,1,0
8,368,368,15,15,0,1,0
4,406,406,14,14,0,1,0
7,409,409,188,158,30,2,1

13,129,129,1,1,0,1,0
8,181,181,8,8,0,1,0
1,207,207,4,4,0,1,0
6,213,213,11,5,6,3,2
4,265,265,82,46,36,2,1
0,274,274,8,8,0,1,0
3,284,284,3,3,0,1,0
9,309,309,33,13,20,3,2
10,334,334,27,27,0,1,0
2,338,338,46,46,0,1,0
12,380,380,64,9,55,4,3
5,402,402,6,6,0,1,0
7,418,418,13,13,0,1,0
11,471,471,95,16,79,4,3

7,135,135,1,1,0,1,0
2,157,157,1,1,0,1,0
4,198,198,28,28,0,1,0
11,237,237,25,25,0,1,0
1,267,267,36,36,0,1,0
5,267,267,26,16,10,3,2
0,270,270,6,6,0,1,0
9,306,306,30,13,17,2,1
3,333,333,3,3,0,1,0
12,357,357,13,13,0,1,0
10,363,363,57,57,0,1,0
8,386,386,54,54,0,1,0
13,432,432,29,29,0,1,0
6,488,488,90,24,66,4,3

8,267,267,40,40,0,1,0
5,269,269,16,16,0,1,0
7,330,330,40,40,0,1,0
6,368,368,12,12,0,1,0
3,408,408,7,2,5,2,1
4,435,435,100,100,0,1,0
0,446,446,84,48,36,4,3
2,460,460,79,52,27,4,3
1,489,489,118,10,108,4,3

2,116,116,7,2,5,2,1
7,129,129,19,10,9,4,3
9,131,131,24,24,0,1,0
6,159,159,21,21,0,1,0
8,173,173,19,19,0,1,0
3,179,179,24,3,21,2,1
5,207,207,3,3,0,1,0
0,292,292,22,22,0,1,0
4,444,444,61,61,0,1,0
1,455,455,88,88,0,1,0
10,497,497,16,3,13,2,1

1,135,135,7,7,0,1,0
0,139,139,1,1,0,1,0
3,160,160,38,38,0,1,0
9,179,179,6,6,0,1,0
6,221,221,14,7,7,2,1
5,230,230,37,37,0,1,0
8,253,253,5,5,0,1,0
11,264,264,18,18,0,1,0
7,275,275,10,2,8,3,2
4,369,369,17,17,0,1,0
10,465,465,181,112,69,4,3
2,488,488,49,49,0,1,0

4,129,129,11,3,8,3,2
5,166,166,10,4,6,3,2
2,190,190,5,5,0,1,0
10,226,226,32,9,23,2,1
11,234,234,12,4,8,2,1
1,296,296,5,5,0,1,0
9,303,303,65,46,19,2,1
6,356,356,22,22,0,1,0
8,357,357,32,32,0,1,0
7,369,369,19,19,0,1,0
0,450,450,171,171,0,1,0
3,490,490,16,11,5,2,1

6,123,123,15,15,0,1,0
9,189,189,39,39,0,1,0
7,198,198,45,45,0,1,0
2,273,273,8,8,0,1,0
10,284,284,9,4,5,2,1
0,313,313,52,29,23,2,1
8,316,316,4,4,0,1,0
5,325,325,5,1,4,2,1
3,355,355,8,2,6,2,1
1,428,428,52,52,0,1,0
4,461,461,121,106,15,4,3

1,152,152,15,15,0,1,0
4,193,193,92,92,0,1,0
2,259,259,97,97,0,1,0
3,266,266,34,34,0,1,0
6,290,290,2,2,0,1,0
8,351,351,6,6,0,1,0
5,369,369,17,13,4,2,1
7,377,377,15,1,14,3,2
0,394,394,1,1,0,1,0
9,491,491,11,5,6,2,1

11,119,119,19,19,0,1,0
10,182,182,5,5,0,1,0
6,209,209,29,1,28,3,2
2,221,221,10,10,0,1,0
8,229,229,9,9,0,1,0
1,249,249,6,6,0,1,0
12,257,257,11,5,6,3,2
9,320,320,36,6,30,2,1
7,321,321,74,74,0,1,0
0,323,323,66,37,29,2,1
4,372,372,4,4,0,1,0
3,429,429,47,29,18,3,2
5,497,497,35,20,15,2,1

9,121,121,32,4,28,3,2
8,136,136,1,1,0,1,0
6,203,203,31,31,0,1,0
7,206,206,4,4,0,1,0
2,231,231,13,1,12,3,2
0,281,281,28,1,27,2,1
4,293,293,31,1,30,2,1
10,298,298,44,7,37,2,1
11,392,392,9,9,0,1,0
5,397,397,35,29,6,3,2
3,448,448,39,39,0,1,0
1,484,484,79,13,66,4,3

4,152,152,3,3,0,1,0
9,177,177,1,1,0,1,0
0,213,213,43,43,0,1,0
6,260,260,68,68,0,1,0
8,263,263,9,9,0,1,0
2,329,329,71,22,49,3,2
5,360,360,3,3,0,1,0
1,371,371,53,53,0,1,0
7,414,414,118,53,65,4,3
3,477,477,19,19,0,1,0

3,116,116,4,4,0,1,0
7,122,122,3,3,0,1,0
6,170,170,49,49,0,1,0
11,203,203,19,19,0,1,0
2,245,245,25,25,0,1,0
10,245,245,6,6,0,1,0
9,285,285,48,6,42,4,3
4,288,288,37,4,33,2,1
5,302,302,43,23,20,2,1
1,337,337,38,38,0,1,0
8,369,369,5,5,0,1,0
0,457,457,38,16,22,2,1

4,113,113,8,1,7,2,1
12,118,118,30,25,5,2,1
6,156,156,4,4,0,1,0
7,182,182,20,13,7,3,2
10,238,238,33,12,21,4,3
3,257,257,12,12,0,1,0
9,304,304,14,7,7,3,2
11,316,316,5,1,4,2,1
5,345,345,17,10,7,2,1
0,418,418,78,78,0,1,0
8,458,458,21,21,0,1,0
2,462,462,84,84,0,1,0
1,499,499,22,4,18,4,3

6,228,228,16,16,0,1,0
0,285,285,12,12,0,1,0
7,288,288,14,8,6,2,1
8,329,329,9,6,3,2,1
1,416,416,1,1,0,1,0
10,426,426,8,8,0,1,0
3,440,440,112,41,71,4,3
2,447,447,31,31,0,1,0
9,451,451,191,191,0,1,0
5,458,458,10,5,5,2,1
4,498,498,116,116,0,1,0

1,131,131,41,41,0,1,0
0,164,164,13,13,0,1,0
3,200,200,6,6,0,1,0
5,219,219,36,20,16,2,1
6,253,253,1,1,0,1,0
7,340,340,14,4,10,2,1
2,342,342,72,72,0,1,0
4,379,379,47,47,0,1,0
8,465,465,115,61,54,4,3

9,113,113,1,1,0,1,0
5,135,135,1,1,0,1,0
13,166,166,4,4,0,1,0
7,209,209,19,19,0,1,0
8,240,240,23,13,10,2,1
0,249,249,29,3,26,3,2
10,308,308,54,6,48,2,1
2,327,327,30,8,22,3,2
6,378,378,4,1,3,2,1
14,421,421,30,5,25,2,1
3,426,426,49,49,0,1,0
11,430,430,14,14,0,1,0
4,432,432,7,7,0,1,0
15,482,482,89,1,88,3,2
1,499,499,25,25,0,1,0
12,500,500,60,3,57,4,3

5,123,123,11,11,0,1,0
10,147,147,11,6,5,2,1
7,151,151,27,27,0,1,0
8,168,168,3,3,0,1,0
6,171,171,28,28,0,1,0
2,258,258,4,4,0,1,0
0,264,264,28,28,0,1,0
1,267,267,13,13,0,1,0
3,294,294,12,12,0,1,0
9,346,346,64,64,0,1,0
12,425,425,15,15,0,1,0
11,426,426,52,28,24,4,3
4,430,430,60,60,0,1,0

1,149,149,11,8,3,2,1
4,153,153,13,13,0,1,0
0,159,159,11,1,10,2,1
10,208,208,62,62,0,1,0
5,223,223,23,23,0,1,0
12,226,226,20,20,0,1,0
8,317,317,24,4,20,2,1
7,330,330,5,5,0,1,0
11,332,332,8,8,0,1,0
13,372,372,34,34,0,1,0
6,373,373,17,6,11,2,1
2,386,386,51,28,23,2,1
9,441,441,16,3,13,2,1
3,457,457,36,36,0,1,0

9,107,107,13,13,0,1,0
4,121,121,4,1,3,2,1
11,123,123,25,7,18,3,2
5,142,142,11,11,0,1,0
7,219,219,7,7,0,1,0
8,232,232,1,1,0,1,0
2,238,238,28,22,6,3,2
1,297,297,27,21,6,2,1
6,317,317,64,64,0,1,0
3,393,393,109,98,11,4,3
10,399,399,19,4,15,4,3
0,401,401,4,4,0,1,0

5,105,105,1,1,0,1,0
8,252,252,15,11,4,2,1
10,258,258,23,23,0,1,0
6,318,318,19,19,0,1,0
0,324,324,65,65,0,1,0
7,353,353,66,66,0,1,0
4,360,360,38,38,0,1,0
3,408,408,19,9,10,3,2
1,438,438,77,77,0,1,0
9,453,453,95,95,0,1,0
2,473,473,34,14,20,2,1

0,110,110,3,3,0,1,0
1,115,115,3,3,0,1,0
10,116,116,4,4,0,1,0
5,146,146,9,5,4,2,1
9,176,176,19,10,9,2,1
8,234,234,54,54,0,1,0
11,312,312,4,4,0,1,0
13,318,318,19,19,0,1,0
3,329,329,6,1,5,2,1
7,412,412,9,9,0,1,0
2,420,420,17,17,0,1,0
12,421,421,71,57,14,2,1
6,448,448,67,4,63,4,3
4,450,450,115,115,0,1,0

11,117,117,19,10,9,4,3
8,145,145,7,7,0,1,0
5,147,147,1,1,0,1,0
14,229,229,8,8,0,1,0
0,245,245,64,52,12,3,2
13,301,301,55,39,16,2,1
6,315,315,2,2,0,1,0
1,364,364,10,10,0,1,0
7,393,393,7,7,0,1,0
3,401,401,48,15,33,2,1
9,442,442,47,32,15,4,3
10,443,443,9,1,8,2,1
2,449,449,2,2,0,1,0
12,459,459,47,47,0,1,0
4,468,468,51,13,38,2,1

12,122,122,3,3,0,1,0
10,183,183,13,1,12,4,3
14,187,187,66,26,40,3,2
4,198,198,22,7,15,4,3
11,205,205,19,10,9,2,1
9,212,212,10,5,5,2,1
8,246,246,5,2,3,2,1
3,285,285,10,10,0,1,0
7,316,316,62,29,33,4,3
5,369,369,10,6,4,2,1
1,397,397,4,4,0,1,0
0,443,443,30,2,28,2,1
13,446,446,10,6,4,2,1
2,463,463,30,24,6,3,2
6,470,470,33,7,26,3,2

1,100,100,19,19,0,1,0
4,112,112,16,10,6,2,1
11,196,196,1,1,0,1,0
6,203,203,19,19,0,1,0
7,206,206,57,19,38,2,1
9,207,207,5,1,4,2,1
8,243,243,10,10,0,1,0
12,273,273,41,21,20,2,1
5,290,290,4,1,3,2,1
2,324,324,19,19,0,1,0
10,364,364,42,21,21,2,1
3,369,369,25,13,12,2,1
0,414,414,15,6,9,4,3

16,123,123,4,1,3,2,1
6,209,209,19,11,8,3,2
10,231,231,8,3,5,2,1
12,260,260,9,3,6,2,1
15,294,294,108,74,34,2,1
2,305,305,7,7,0,1,0
9,315,315,30,19,11,2,1
14,319,319,3,3,0,1,0
11,370,370,18,12,6,3,2
5,407,407,1,1,0,1,0
3,412,412,48,10,38,4,3
4,418,418,55,22,33,2,1
8,438,438,8,5,3,2,1
7,454,454,17,11,6,2,1
1,455,455,9,9,0,1,0
0,471,471,16,16,0,1,0
13,496,496,56,23,33,4,3

4,127,127,8,8,0,1,0
10,151,151,17,17,0,1,0
13,176,176,25,25,0,1,0
5,209,209,49,49,0,1,0
0,242,242,1,1,0,1,0
11,243,243,25,19,6,3,2
3,267,267,6,6,0,1,0
2,300,300,31,31,0,1,0
14,300,300,36,36,0,1,0
8,345,345,25,19,6,2,1
7,382,382,37,26,11,2,1
6,437,437,1,1,0,1,0
9,451,451,23,23,0,1,0
12,461,461,38,5,33,2,1
1,498,498,1,1,0,1,0

4,173,173,14,14,0,1,0
3,192,192,3,3,0,1,0
11,205,205,3,3,0,1,0
2,207,207,1,1,0,1,0
9,228,228,7,3,4,2,1
6,258,258,42,1,41,2,1
0,320,320,16,16,0,1,0
10,407,407,15,15,0,1,0
15,436,436,61,27,34,3,2
14,442,442,63,20,43,2,1
8,447,447,9,9,0,1,0
5,453,453,102,65,37,2,1
1,459,459,2,2,0,1,0
7,462,462,3,3,0,1,0
13,481,481,56,41,15,4,3
12,485,485,75,53,22,3,2

4,124,124,2,2,0,1,0
8,131,131,26,8,18,4,3
3,154,154,14,2,12,3,2
1,181,181,6,6,0,1,0
7,217,217,9,9,0,1,0
2,251,251,80,80,0,1,0
6,292,292,41,41,0,1,0
10,308,308,36,17,19,2,1
5,346,346,13,13,0,1,0
9,407,407,33,6,27,4,3
0,444,444,63,48,15,2,1

1,128,128,16,16,0,1,0
5,134,134,21,1,20,3,2
8,196,196,17,8,9,4,3
11,205,205,43,43,0,1,0
14,235,235,24,24,0,1,0
6,290,290,19,19,0,1,0
3,364,364,26,26,0,1,0
4,364,364,2,2,0,1,0
9,377,377,44,20,24,3,2
7,393,393,18,3,15,2,1
10,417,417,9,9,0,1,0
13,438,438,62,35,27,4,3
2,459,459,2,2,0,1,0
0,468,468,20,20,0,1,0
12,494,494,10,10,0,1,0

3,156,156,30,6,24,3,2
7,168,168,12,12,0,1,0
8,172,172,7,1,6,2,1
0,178,178,35,35,0,1,0
5,180,180,31,26,5,2,1
4,183,183,18,18,0,1,0
1,216,216,27,27,0,1,0
2,253,253,71,50,21,2,1
6,401,401,16,4,12,2,1

1,127,127,1,1,0,1,0
4,179,179,28,28,0,1,0
5,182,182,40,26,14,2,1
9,184,184,18,18,0,1,0
3,185,185,7,7,0,1,0
7,203,203,26,2,24,3,2
6,207,207,16,16,0,1,0
8,225,225,50,50,0,1,0
10,239,239,6,6,0,1,0
12,291,291,39,35,4,2,1
0,355,355,15,15,0,1,0
11,434,434,4,4,0,1,0
2,483,483,30,11,19,2,1

14,122,122,11,3,8,3,2
10,124,124,2,2,0,1,0
6,174,174,1,1,0,1,0
7,204,204,18,8,10,3,2
0,205,205,4,1,3,2,1
2,214,214,2,2,0,1,0
12,302,302,49,49,0,1,0
13,327,327,3,3,0,1,0
5,384,384,52,24,28,3,2
9,387,387,119,78,41,2,1
8,400,400,5,5,0,1,0
11,427,427,10,3,7,2,1
4,432,432,19,4,15,4,3
3,473,473,57,7,50,3,2
1,477,477,79,3,76,3,2

5,148,148,45,24,21,2,1
3,173,173,3,3,0,1,0
2,186,186,11,11,0,1,0
11,252,252,37,37,0,1,0
0,258,258,6,2,4,2,1
12,288,288,10,10,0,1,0
8,329,329,18,18,0,1,0
10,339,339,5,2,3,2,1
6,392,392,16,16,0,1,0
7,392,392,80,26,54,4,3
1,427,427,17,13,4,2,1
9,429,429,66,14,52,3,2
4,475,475,55,55,0,1,0

4,105,105,5,5,0,1,0
8,177,177,35,29,6,3,2
1,183,183,5,1,4,2,1
0,204,204,17,3,14,3,2
9,256,256,16,16,0,1,0
2,295,295,72,60,12,3,2
5,329,329,41,7,34,2,1
3,355,355,26,19,7,2,1
7,371,371,51,51,0,1,0
11,395,395,23,23,0,1,0
10,435,435,32,1,31,4,3
6,462,462,37,37,0,1,0

3,134,134,2,2,0,1,0
6,149,149,5,2,3,2,1
4,203,203,63,63,0,1,0
5,260,260,13,5,8,2,1
0,349,349,28,28,0,1,0
8,362,362,19,4,15,2,1
1,389,389,1,1,0,1,0
2,395,395,76,76,0,1,0
7,407,407,162,84,78,4,3
10,458,458,3,3,0,1,0
9,474,474,31,31,0,1,0

13,114,114,16,12,4,2,1
14,147,147,20,15,5,2,1
7,150,150,6,6,0,1,0
10,171,171,8,8,0,1,0
15,173,173,10,10,0,1,0
16,190,190,23,7,16,2,1
8,204,204,5,1,4,2,1
11,216,216,32,26,6,2,1
6,228,228,1,1,0,1,0
3,256,256,21,21,0,1,0
12,307,307,6,2,4,2,1
2,328,328,20,15,5,2,1
0,369,369,1,1,0,1,0
4,376,376,52,6,46,2,1
9,390,390,55,55,0,1,0
5,420,420,7,7,0,1,0
1,452,452,20,5,15,2,1

7,110,110,1,1,0,1,0
5,179,179,26,26,0,1,0
3,206,206,2,2,0,1,0
13,208,208,10,4,6,2,1
16,214,214,42,42,0,1,0
0,226,226,1,1,0,1,0
10,234,234,21,2,19,2,1
14,257,257,41,27,14,2,1
17,299,299,13,4,9,2,1
2,299,299,23,23,0,1,0
8,343,343,2,2,0,1,0
11,402,402,2,2,0,1,0
9,424,424,40,20,20,3,2
6,441,441,8,8,0,1,0
4,448,448,35,35,0,1,0
1,456,456,15,3,12,4,3
15,472,472,74,74,0,1,0
18,472,472,1,1,0,1,0
12,495,495,16,16,0,1,0

0,154,154,1,1,0,1,0
1,158,158,1,1,0,1,0
5,189,189,8,8,0,1,0
7,216,216,40,40,0,1,0
8,216,216,2,2,0,1,0
10,234,234,10,4,6,3,2
14,250,250,23,11,12,2,1
3,289,289,26,26,0,1,0
4,290,290,49,29,20,2,1
12,309,309,43,43,0,1,0
6,332,332,13,3,10,3,2
13,421,421,34,34,0,1,0
2,430,430,24,24,0,1,0
9,445,445,30,13,17,2,1
11,450,450,84,84,0,1,0

2,130,130,6,6,0,1,0
0,142,142,7,7,0,1,0
8,178,178,25,18,7,2,1
1,222,222,27,22,5,2,1
9,236,236,63,63,0,1,0
3,262,262,73,19,54,4,3
5,265,265,27,6,21,2,1
6,275,275,1,1,0,1,0
7,276,276,19,19,0,1,0
4,480,480,51,51,0,1,0
10,500,500,16,16,0,1,0

3,103,103,2,2,0,1,0
7,154,154,2,2,0,1,0
8,195,195,18,1,17,2,1
1,264,264,9,9,0,1,0
4,344,344,38,24,14,2,1
0,352,352,122,122,0,1,0
9,368,368,7,7,0,1,0
2,369,369,9,9,0,1,0
11,378,378,71,44,27,4,3
6,436,436,84,16,68,4,3
10,443,443,49,49,0,1,0
5,500,500,33,7,26,3,2

10,126,126,26,14,12,3,2
4,157,157,15,15,0,1,0
8,159,159,2,2,0,1,0
13,227,227,4,4,0,1,0
0,238,238,7,7,0,1,0
11,271,271,8,8,0,1,0
2,274,274,24,6,18,4,3
9,299,299,51,51,0,1,0
6,322,322,33,33,0,1,0
1,349,349,1,1,0,1,0
5,357,357,5,5,0,1,0
7,373,373,13,13,0,1,0
12,441,441,77,56,21,2,1
3,452,452,106,43,63,4,3

11,107,107,3,3,0,1,0
8,190,190,3,3,0,1,0
5,199,199,33,33,0,1,0
0,216,216,8,8,0,1,0
12,264,264,63,63,0,1,0
6,332,332,31,31,0,1,0
1,371,371,37,28,9,4,3
4,379,379,10,10,0,1,0
2,407,407,53,45,8,3,2
10,417,417,3,3,0,1,0
7,424,424,31,31,0,1,0
9,457,457,112,59,53,4,3
3,492,492,24,4,20,3,2

7,142,142,5,2,3,2,1
6,155,155,28,10,18,4,3
8,172,172,18,12,6,2,1
11,202,202,11,11,0,1,0
1,245,245,1,1,0,1,0
5,266,266,66,66,0,1,0
0,359,359,1,1,0,1,0
13,378,378,68,21,47,4,3
4,382,382,21,9,12,2,1
10,384,384,29,11,18,3,2
2,399,399,9,9,0,1,0
12,448,448,65,31,34,2,1
3,483,483,25,25,0,1,0
9,493,493,23,23,0,1,0

10,107,107,5,5,0,1,0
6,167,167,17,17,0,1,0
9,221,221,52,35,17,2,1
3,238,238,7,7,0,1,0
0,306,306,108,108,0,1,0
4,324,324,10,10,0,1,0
8,353,353,11,11,0,1,0
5,391,391,25,25,0,1,0
7,395,395,52,22,30,2,1
1,472,472,56,46,10,2,1
2,494,494,35,35,0,1,0

11,120,120,3,3,0,1,0
18,171,171,25,10,15,2,1
3,236,236,1,1,0,1,0
9,250,250,8,8,0,1,0
0,281,281,28,20,8,2,1
10,298,298,7,7,0,1,0
1,306,306,14,14,0,1,0
6,320,320,11,7,4,2,1
4,333,333,20,11,9,4,3
14,335,335,99,99,0,1,0
5,338,338,48,39,9,4,3
17,343,343,5,5,0,1,0
7,380,380,22,22,0,1,0
2,381,381,15,15,0,1,0
8,387,387,9,4,5,2,1
16,401,401,52,52,0,1,0
15,463,463,9,9,0,1,0
12,487,487,7,1,6,3,2
13,491,491,2,2,0,1,0

11,102,102,6,6,0,1,0
3,135,135,2,2,0,1,0
1,197,197,2,2,0,1,0
12,200,200,27,27,0,1,0
14,207,207,52,5,47,2,1
2,223,223,3,3,0,1,0
5,240,240,49,1,48,2,1
8,263,263,3,3,0,1,0
0,296,296,26,26,0,1,0
10,300,300,14,2,12,3,2
6,325,325,7,7,0,1,0
9,346,346,37,37,0,1,0
7,378,378,36,30,6,2,1
13,379,379,6,6,0,1,0
4,387,387,56,47,9,4,3

4,104,104,4,4,0,1,0
1,109,109,9,9,0,1,0
2,160,160,13,1,12,4,3
7,170,170,16,7,9,2,1
9,264,264,23,5,18,4,3
0,265,265,39,39,0,1,0
3,284,284,48,15,33,3,2
10,297,297,9,9,0,1,0
12,355,355,7,7,0,1,0
5,357,357,16,16,0,1,0
6,360,360,14,14,0,1,0
8,436,436,140,120,20,3,2
11,448,448,26,26,0,1,0

6,115,115,8,8,0,1,0
18,126,126,10,1,9,2,1
2,127,127,3,3,0,1,0
3,176,176,31,31,0,1,0
13,207,207,37,19,18,4,3
9,208,208,6,6,0,1,0
5,209,209,7,7,0,1,0
15,228,228,16,16,0,1,0
8,242,242,1,1,0,1,0
1,242,242,5,1,4,2,1
12,246,246,25,25,0,1,0
17,293,293,30,3,27,4,3
16,323,323,32,20,12,4,3
4,371,371,3,3,0,1,0
14,398,398,32,4,28,3,2
10,448,448,6,1,5,2,1
0,450,450,21,10,11,2,1
7,465,465,7,7,0,1,0
11,482,482,30,2,28,4,3

10,138,138,23,2,21,4,3
7,178,178,20,20,0,1,0
4,199,199,4,4,0,1,0
11,240,240,5,2,3,2,1
1,275,275,21,21,0,1,0
3,312,312,33,33,0,1,0
5,332,332,5,5,0,1,0
8,366,366,62,62,0,1,0
0,409,409,78,16,62,3,2
9,418,418,47,47,0,1,0
2,440,440,85,59,26,3,2
6,462,462,13,13,0,1,0

4,134,134,17,8,9,2,1
2,151,151,31,9,22,2,1
0,172,172,23,17,6,3,2
3,213,213,51,45,6,3,2
5,287,287,37,29,8,2,1
6,297,297,7,1,6,3,2
1,358,358,9,9,0,1,0
7,418,418,39,39,0,1,0
8,423,423,66,66,0,1,0
9,432,432,34,34,0,1,0

5,114,114,37,5,32,2,1
2,146,146,18,14,4,2,1
8,158,158,4,4,0,1,0
7,183,183,4,1,3,2,1
1,198,198,9,9,0,1,0
6,229,229,17,17,0,1,0
4,378,378,34,1,33,2,1
0,439,439,192,192,0,1,0
3,445,445,35,22,13,2,1

9,117,117,2,2,0,1,0
4,124,124,7,3,4,2,1
11,191,191,13,1,12,2,1
1,228,228,34,34,0,1,0
3,229,229,45,45,0,1,0
0,230,230,18,9,9,2,1
10,243,243,2,2,0,1,0
5,267,267,9,9,0,1,0
6,318,318,49,49,0,1,0
7,319,319,65,39,26,2,1
2,337,337,30,1,29,2,1
8,339,339,57,4,53,4,3

2,122,122,36,36,0,1,0
8,177,177,1,1,0,1,0
11,192,192,15,15,0,1,0
1,225,225,10,10,0,1,0
7,233,233,11,11,0,1,0
3,252,252,2,2,0,1,0
9,263,263,21,21,0,1,0
4,298,298,10,10,0,1,0
5,324,324,55,19,36,4,3
0,329,329,17,17,0,1,0
6,377,377,38,38,0,1,0
10,485,485,145,115,30,2,1

13,110,110,5,1,4,2,1
10,149,149,22,22,0,1,0
9,177,177,2,2,0,1,0
0,251,251,1,1,0,1,0
2,252,252,2,2,0,1,0
12,261,261,11,11,0,1,0
3,267,267,34,5,29,4,3
6,346,346,2,2,0,1,0
5,350,350,113,26,87,4,3
4,369,369,22,9,13,2,1
11,413,413,148,115,33,4,3
1,438,438,5,5,0,1,0
8,439,439,7,7,0,1,0
7,495,495,31,8,23,4,3

4,101,101,1,1,0,1,0
11,105,105,10,10,0,1,0
12,128,128,22,4,18,2,1
3,130,130,9,2,7,2,1
10,158,158,1,1,0,1,0
0,163,163,12,12,0,1,0
14,169,169,9,3,6,3,2
5,206,206,1,1,0,1,0
7,228,228,4,4,0,1,0
13,256,256,46,8,38,2,1
9,266,266,26,26,0,1,0
6,304,304,3,3,0,1,0
1,317,317,15,15,0,1,0
8,421,421,43,43,0,1,0
2,437,437,74,40,34,3,2
15,466,466,48,48,0,1,0

15,102,102,14,14,0,1,0
12,116,116,3,3,0,1,0
4,120,120,9,6,3,2,1
0,143,143,15,15,0,1,0
3,151,151,17,3,14,3,2
14,242,242,5,5,0,1,0
6,270,270,38,14,24,4,3
5,296,296,1,1,0,1,0
16,339,339,78,42,36,2,1
2,340,340,5,5,0,1,0
11,386,386,47,27,20,3,2
7,420,420,23,5,18,4,3
9,425,425,3,3,0,1,0
8,448,448,14,14,0,1,0
10,449,449,23,23,0,1,0
13,449,449,34,34,0,1,0
1,452,452,2,2,0,1,0

1,125,125,1,1,0,1,0
10,184,184,1,1,0,1,0
12,211,211,12,12,0,1,0
11,215,215,11,11,0,1,0
2,246,246,6,6,0,1,0
13,246,246,34,5,29,3,2
8,301,301,49,49,0,1,0
16,316,316,25,25,0,1,0
9,332,332,31,31,0,1,0
5,372,372,1,1,0,1,0
15,379,379,106,52,54,3,2
7,404,404,10,2,8,2,1
3,421,421,46,26,20,2,1
14,423,423,5,5,0,1,0
0,435,435,32,32,0,1,0
4,438,438,32,32,0,1,0
6,484,484,11,7,4,2,1

10,117,117,4,4,0,1,0
7,177,177,1,1,0,1,0
2,206,206,17,17,0,1,0
3,216,216,11,11,0,1,0
5,217,217,10,10,0,1,0
6,231,231,15,15,0,1,0
15,242,242,9,9,0,1,0
11,246,246,5,5,0,1,0
9,269,269,9,9,0,1,0
16,286,286,4,4,0,1,0
18,344,344,30,30,0,1,0
1,346,346,29,29,0,1,0
17,391,391,47,19,28,3,2
12,415,415,4,4,0,1,0
0,448,448,52,14,38,3,2
13,453,453,100,100,0,1,0
14,485,485,62,34,28,3,2
8,491,491,4,1,3,2,1
4,496,496,23,23,0,1,0

2,106,106,28,22,6,3,2
10,122,122,12,12,0,1,0
8,151,151,36,36,0,1,0
11,156,156,11,11,0,1,0
0,164,164,5,5,0,1,0
6,191,191,21,7,14,3,2
1,220,220,17,2,15,4,3
3,296,296,43,43,0,1,0
7,323,323,4,1,3,2,1
4,433,433,20,2,18,3,2
9,472,472,41,41,0,1,0
5,499,499,19,11,8,2,1

12,156,156,29,7,22,3,2
6,179,179,26,8,18,2,1
3,189,189,6,2,4,2,1
5,219,219,4,4,0,1,0
8,265,265,83,83,0,1,0
9,279,279,8,2,6,3,2
7,353,353,20,11,9,4,3
2,359,359,84,70,14,2,1
4,359,359,2,2,0,1,0
0,365,365,38,38,0,1,0
1,386,386,25,13,12,4,3
11,406,406,9,9,0,1,0
10,430,430,2,2,0,1,0

5,103,103,13,1,12,4,3
4,125,125,7,4,3,2,1
3,130,130,1,1,0,1,0
6,318,318,58,31,27,4,3
7,335,335,42,17,25,2,1
8,356,356,29,29,0,1,0
2,403,403,58,58,0,1,0
1,419,419,59,24,35,4,3
9,443,443,22,5,17,2,1
0,490,490,153,153,0,1,0

11,139,139,6,3,3,2,1
0,192,192,8,2,6,2,1
13,207,207,27,9,18,2,1
7,253,253,27,15,12,2,1
8,265,265,50,36,14,2,1
10,296,296,10,10,0,1,0
5,304,304,2,2,0,1,0
15,317,317,87,29,58,3,2
1,386,386,61,3,58,3,2
4,388,388,4,4,0,1,0
9,421,421,5,5,0,1,0
3,428,428,6,1,5,2,1
14,432,432,16,6,10,3,2
2,442,442,12,12,0,1,0
12,444,444,15,15,0,1,0
16,454,454,41,41,0,1,0
6,491,491,1,1,0,1,0

6,207,207,23,15,8,3,2
7,215,215,4,1,3,2,1
1,239,239,29,21,8,3,2
11,276,276,21,3,18,4,3
8,316,316,21,21,0,1,0
12,335,335,27,5,22,2,1
4,354,354,18,9,9,2,1
14,376,376,93,93,0,1,0
2,412,412,21,21,0,1,0
10,418,418,12,12,0,1,0
3,424,424,13,13,0,1,0
5,425,425,41,3,38,2,1
13,431,431,17,9,8,2,1
0,459,459,25,25,0,1,0
9,463,463,64,28,36,2,1

5,141,141,2,2,0,1,0
2,163,163,43,43,0,1,0
0,198,198,7,7,0,1,0
4,201,201,15,15,0,1,0
1,211,211,33,15,18,4,3
8,229,229,37,7,30,2,1
11,233,233,59,11,48,4,3
9,341,341,16,16,0,1,0
10,348,348,19,2,17,3,2
3,399,399,23,8,15,2,1
6,423,423,21,21,0,1,0
7,437,437,19,19,0,1,0

11,100,100,11,3,8,3,2
4,148,148,15,8,7,2,1
6,174,174,6,2,4,2,1
5,226,226,22,2,20,3,2
0,235,235,27,9,18,4,3
3,263,263,1,1,0,1,0
12,279,279,10,6,4,2,1
14,294,294,13,13,0,1,0
9,333,333,2,2,0,1,0
10,349,349,141,141,0,1,0
2,353,353,16,16,0,1,0
15,362,362,5,2,3,2,1
13,364,364,2,2,0,1,0
1,405,405,1,1,0,1,0
8,414,414,34,14,20,3,2
7,422,422,48,21,27,4,3

3,117,117,9,9,0,1,0
1,121,121,6,3,3,2,1
7,184,184,29,29,0,1,0
10,215,215,9,3,6,2,1
13,321,321,39,39,0,1,0
5,365,365,74,23,51,4,3
6,374,374,13,3,10,2,1
11,375,375,6,6,0,1,0
2,378,378,12,12,0,1,0
8,415,415,18,10,8,2,1
0,437,437,13,13,0,1,0
9,483,483,71,71,0,1,0
12,498,498,117,21,96,4,3
4,500,500,9,4,5,2,1

7,136,136,9,9,0,1,0
5,170,170,10,10,0,1,0
6,240,240,61,5,56,3,2
8,286,286,41,1,40,2,1
1,351,351,153,147,6,2,1
2,388,388,28,28,0,1,0
3,439,439,15,15,0,1,0
4,443,443,31,31,0,1,0
9,446,446,8,8,0,1,0
0,475,475,28,14,14,3,2

7,174,174,16,16,0,1,0
9,200,200,1,1,0,1,0
0,233,233,3,3,0,1,0
5,262,262,4,4,0,1,0
14,270,270,3,3,0,1,0
4,274,274,1,1,0,1,0
3,302,302,15,15,0,1,0
11,314,314,52,27,25,2,1
6,349,349,3,3,0,1,0
8,350,350,88,88,0,1,0
12,427,427,54,10,44,2,1
2,440,440,36,32,4,2,1
13,478,478,36,36,0,1,0
10,489,489,109,73,36,4,3
1,493,493,43,43,0,1,0

3,119,119,17,17,0,1,0
6,124,124,7,3,4,2,1
12,149,149,18,18,0,1,0
11,177,177,11,11,0,1,0
8,191,191,55,6,49,2,1
2,203,203,1,1,0,1,0
9,221,221,7,7,0,1,0
4,284,284,66,34,32,3,2
1,300,300,5,5,0,1,0
10,322,322,20,2,18,3,2
0,326,326,7,4,3,2,1
13,438,438,24,5,19,4,3
7,453,453,42,42,0,1,0
5,493,493,17,17,0,1,0

10,100,100,1,1,0,1,0
2,113,113,6,6,0,1,0
15,127,127,11,11,0,1,0
3,136,136,5,5,0,1,0
13,139,139,20,20,0,1,0
4,160,160,25,16,9,2,1
11,169,169,5,5,0,1,0
8,185,185,1,1,0,1,0
16,187,187,14,14,0,1,0
12,250,250,58,52,6,3,2
7,261,261,14,6,8,2,1
5,284,284,31,31,0,1,0
9,291,291,5,5,0,1,0
14,392,392,19,19,0,1,0
0,395,395,34,34,0,1,0
6,433,433,13,3,10,3,2
1,479,479,25,25,0,1,0

16,107,107,3,3,0,1,0
11,138,138,1,1,0,1,0
10,164,164,31,19,12,3,2
13,180,180,23,2,21,4,3
0,206,206,5,5,0,1,0
3,226,226,5,2,3,2,1
5,237,237,4,4,0,1,0
14,260,260,48,48,0,1,0
8,260,260,14,2,12,2,1
12,261,261,61,36,25,2,1
6,291,291,5,5,0,1,0
1,329,329,6,6,0,1,0
7,368,368,26,26,0,1,0
15,386,386,12,12,0,1,0
4,389,389,36,2,34,3,2
2,410,410,37,5,32,2,1
9,436,436,4,4,0,1,0

11,111,111,8,8,0,1,0
4,114,114,20,20,0,1,0
0,139,139,9,2,7,2,1
12,168,168,1,1,0,1,0
3,178,178,18,18,0,1,0
5,184,184,4,4,0,1,0
8,198,198,18,18,0,1,0
1,212,212,5,5,0,1,0
2,256,256,3,3,0,1,0
7,258,258,46,46,0,1,0
13,280,280,9,3,6,3,2
6,297,297,7,3,4,2,1
10,478,478,177,121,56,3,2
9,483,483,21,21,0,1,0

2,156,156,9,2,7,2,1
3,244,244,58,58,0,1,0
4,269,269,5,5,0,1,0
9,294,294,14,6,8,3,2
1,317,317,53,15,38,4,3
5,327,327,44,44,0,1,0
0,329,329,46,46,0,1,0
8,366,366,54,54,0,1,0
6,480,480,45,9,36,3,2
7,497,497,82,82,0,1,0

15,169,169,21,21,0,1,0
6,175,175,17,4,13,2,1
2,205,205,9,3,6,2,1
14,205,205,8,2,6,3,2
4,218,218,32,32,0,1,0
9,263,263,33,23,10,2,1
8,294,294,1,1,0,1,0
13,294,294,3,3,0,1,0
11,301,301,33,33,0,1,0
5,313,313,8,3,5,2,1
0,324,324,5,5,0,1,0
3,344,344,25,4,21,4,3
1,351,351,5,5,0,1,0
12,361,361,1,1,0,1,0
10,373,373,123,72,51,3,2
7,405,405,23,8,15,2,1

9,106,106,3,3,0,1,0
4,165,165,10,7,3,2,1
13,169,169,3,3,0,1,0
6,195,195,12,2,10,2,1
0,200,200,9,2,7,3,2
7,226,226,26,26,0,1,0
10,279,279,52,10,42,4,3
11,338,338,8,8,0,1,0
3,360,360,49,49,0,1,0
12,362,362,73,41,32,4,3
1,363,363,39,18,21,4,3
5,412,412,20,8,12,4,3
8,418,418,62,62,0,1,0
2,498,498,13,4,9,4,3

2,117,117,4,4,0,1,0
6,123,123,26,26,0,1,0
11,128,128,6,6,0,1,0
5,131,131,8,3,5,2,1
3,192,192,62,30,32,2,1
8,199,199,37,37,0,1,0
9,211,211,26,2,24,4,3
1,254,254,41,41,0,1,0
7,344,344,14,14,0,1,0
4,357,357,6,3,3,2,1
10,425,425,5,5,0,1,0
0,481,481,2,2,0,1,0

2,104,104,4,4,0,1,0
0,205,205,29,3,26,2,1
11,229,229,13,3,10,3,2
12,230,230,89,50,39,4,3
10,289,289,9,9,0,1,0
13,324,324,25,25,0,1,0
4,338,338,31,10,21,4,3
3,375,375,1,1,0,1,0
6,381,381,28,28,0,1,0
9,415,415,22,22,0,1,0
1,432,432,2,2,0,1,0
8,435,435,1,1,0,1,0
7,450,450,105,105,0,1,0
5,477,477,7,7,0,1,0

8,132,132,3,3,0,1,0
2,135,135,4,4,0,1,0
16,222,222,18,5,13,2,1
3,237,237,17,17,0,1,0
14,246,246,5,5,0,1,0
0,255,255,32,32,0,1,0
5,257,257,10,4,6,3,2
7,267,267,10,10,0,1,0
1,326,326,37,34,3,2,1
11,340,340,21,21,0,1,0
9,348,348,6,6,0,1,0
12,366,366,76,76,0,1,0
13,393,393,59,26,33,4,3
15,417,417,38,14,24,2,1
6,435,435,32,1,31,3,2
4,467,467,24,24,0,1,0
10,467,467,9,9,0,1,0

13,102,102,14,3,11,2,1
14,105,105,15,15,0,1,0
11,124,124,6,6,0,1,0
1,178,178,26,26,0,1,0
2,195,195,13,13,0,1,0
3,197,197,4,4,0,1,0
0,210,210,2,2,0,1,0
5,230,230,17,2,15,4,3
6,239,239,13,13,0,1,0
12,310,310,32,13,19,2,1
4,402,402,1,1,0,1,0
9,419,419,4,4,0,1,0
10,428,428,76,56,20,2,1
7,440,440,39,32,7,2,1
8,458,458,64,64,0,1,0

5,111,111,27,6,21,2,1
11,122,122,10,10,0,1,0
7,131,131,1,1,0,1,0
10,141,141,9,2,7,2,1
3,146,146,4,1,3,2,1
9,183,183,26,26,0,1,0
8,190,190,44,44,0,1,0
4,192,192,16,13,3,2,1
0,249,249,22,2,20,2,1
6,294,294,16,16,0,1,0
1,332,332,18,6,12,2,1
13,384,384,29,29,0,1,0
2,395,395,19,12,7,2,1
12,475,475,13,13,0,1,0

7,100,100,1,1,0,1,0
6,148,148,10,1,9,4,3
1,157,157,14,1,13,2,1
3,247,247,1,1,0,1,0
0,298,298,10,1,9,2,1
5,341,341,5,5,0,1,0
8,348,348,70,58,12,2,1
2,381,381,73,73,0,1,0
4,402,402,114,57,57,3,2
10,454,454,87,3,84,3,2
9,477,477,64,36,28,3,2

0,104,104,29,2,27,4,3
8,135,135,12,12,0,1,0
5,230,230,1,1,0,1,0
9,245,245,54,36,18,4,3
10,291,291,16,2,14,2,1
2,320,320,25,25,0,1,0
3,323,323,2,2,0,1,0
11,359,359,14,14,0,1,0
6,392,392,30,30,0,1,0
1,422,422,28,4,24,4,3
7,422,422,56,56,0,1,0
4,426,426,72,68,4,2,1

7,169,169,6,6,0,1,0
0,219,219,22,4,18,3,2
12,234,234,39,9,30,3,2
5,244,244,54,39,15,2,1
8,244,244,46,46,0,1,0
11,310,310,40,40,0,1,0
1,351,351,14,14,0,1,0
9,372,372,3,3,0,1,0
2,405,405,22,12,10,2,1
3,421,421,6,6,0,1,0
10,425,425,33,33,0,1,0
6,453,453,42,32,10,2,1
4,493,493,38,16,22,3,2

1,101,101,60,60,0,1,0
7,134,134,12,4,8,2,1
6,238,238,7,1,6,3,2
0,263,263,2,2,0,1,0
3,273,273,31,12,19,3,2
5,420,420,78,56,22,3,2
4,429,429,41,33,8,2,1
2,461,461,46,20,26,3,2

0,104,104,18,4,14,2,1
9,144,144,6,2,4,2,1
2,157,157,17,1,16,3,2
3,180,180,1,1,0,1,0
7,181,181,3,3,0,1,0
8,227,227,7,7,0,1,0
6,288,288,41,41,0,1,0
12,301,301,34,34,0,1,0
5,321,321,21,7,14,3,2
10,347,347,8,8,0,1,0
11,373,373,145,16,129,4,3
4,374,374,9,9,0,1,0
1,497,497,42,9,33,2,1

11,117,117,27,27,0,1,0
2,121,121,18,9,9,4,3
14,174,174,9,2,7,2,1
3,185,185,10,10,0,1,0
6,194,194,6,6,0,1,0
1,241,241,18,10,8,2,1
0,284,284,31,31,0,1,0
13,319,319,31,31,0,1,0
9,339,339,3,3,0,1,0
15,354,354,32,12,20,3,2
5,357,357,1,1,0,1,0
10,367,367,4,4,0,1,0
4,392,392,18,12,6,2,1
12,421,421,57,38,19,2,1
7,449,449,2,2,0,1,0
8,467,467,57,19,38,2,1

9,112,112,4,4,0,1,0
5,114,114,23,5,18,3,2
13,130,130,20,9,11,4,3
7,140,140,19,5,14,2,1
12,154,154,5,5,0,1,0
4,161,161,17,5,12,4,3
6,193,193,9,9,0,1,0
14,220,220,12,1,11,2,1
0,245,245,3,3,0,1,0
10,253,253,7,7,0,1,0
15,273,273,70,70,0,1,0
3,292,292,14,3,11,3,2
8,296,296,1,1,0,1,0
2,333,333,1,1,0,1,0
11,359,359,35,35,0,1,0
1,476,476,8,8,0,1,0

13,118,118,8,8,0,1,0
8,132,132,4,4,0,1,0
9,155,155,11,11,0,1,0
3,183,183,1,1,0,1,0
0,260,260,6,6,0,1,0
12,266,266,30,30,0,1,0
1,289,289,10,10,0,1,0
14,298,298,32,32,0,1,0
15,304,304,57,19,38,3,2
7,329,329,1,1,0,1,0
4,332,332,57,57,0,1,0
10,398,398,23,23,0,1,0
16,408,408,23,23,0,1,0
6,418,418,66,57,9,4,3
11,433,433,32,8,24,2,1
2,447,447,17,12,5,2,1
5,467,467,4,1,3,2,1

2,110,110,1,1,0,1,0
5,153,153,1,1,0,1,0
4,198,198,37,19,18,3,2
12,205,205,13,7,6,3,2
6,212,212,20,2,18,2,1
7,268,268,7,7,0,1,0
10,294,294,46,20,26,2,1
3,310,310,1,1,0,1,0
1,346,346,35,7,28,2,1
13,358,358,47,47,0,1,0
9,367,367,72,36,36,3,2
14,416,416,14,10,4,2,1
8,461,461,36,36,0,1,0
11,471,471,12,12,0,1,0
0,499,499,48,42,6,3,2

7,102,102,2,2,0,1,0
8,176,176,15,15,0,1,0
9,180,180,29,21,8,3,2
3,181,181,10,7,3,2,1
5,193,193,11,11,0,1,0
10,203,203,46,16,30,2,1
0,289,289,21,21,0,1,0
2,353,353,1,1,0,1,0
6,365,365,22,22,0,1,0
4,405,405,73,29,44,3,2
1,429,429,124,106,18,4,3

0,174,174,25,6,19,4,3
10,176,176,21,17,4,2,1
1,211,211,3,3,0,1,0
11,212,212,42,24,18,4,3
2,222,222,57,18,39,4,3
7,267,267,4,4,0,1,0
4,281,281,4,4,0,1,0
6,339,339,29,29,0,1,0
3,350,350,13,13,0,1,0
5,425,425,57,57,0,1,0
8,446,446,64,64,0,1,0
9,483,483,22,22,0,1,0

2,117,117,16,16,0,1,0
7,135,135,18,12,6,2,1
13,159,159,6,6,0,1,0
4,162,162,15,15,0,1,0
5,182,182,12,8,4,2,1
3,200,200,3,3,0,1,0
1,273,273,18,12,6,2,1
8,403,403,6,6,0,1,0
0,406,406,25,25,0,1,0
6,416,416,14,14,0,1,0
12,438,438,89,3,86,3,2
9,442,442,79,13,66,3,2
10,462,462,49,21,28,2,1
11,497,497,33,33,0,1,0

8,130,130,11,8,3,2,1
3,135,135,36,36,0,1,0
11,141,141,30,30,0,1,0
4,172,172,9,9,0,1,0
6,208,208,43,5,38,3,2
1,254,254,50,50,0,1,0
9,300,300,5,2,3,2,1
0,328,328,1,1,0,1,0
5,357,357,25,25,0,1,0
10,470,470,41,32,9,4,3
7,478,478,3,3,0,1,0
2,479,479,6,6,0,1,0

2,102,102,18,18,0,1,0
6,114,114,9,1,8,3,2
0,126,126,11,5,6,2,1
1,150,150,10,10,0,1,0
3,213,213,5,5,0,1,0
11,218,218,14,11,3,2,1
10,283,283,74,68,6,3,2
5,289,289,65,65,0,1,0
9,320,320,13,13,0,1,0
8,363,363,9,6,3,2,1
4,372,372,9,9,0,1,0
7,431,431,63,17,46,2,1

7,146,146,13,13,0,1,0
0,151,151,23,23,0,1,0
2,172,172,69,69,0,1,0
6,179,179,3,3,0,1,0
9,197,197,14,1,13,4,3
1,303,303,2,2,0,1,0
8,364,364,2,2,0,1,0
4,398,398,147,128,19,2,1
3,438,438,18,7,11,2,1
5,477,477,28,6,22,4,3

3,135,135,12,4,8,2,1
6,169,169,3,3,0,1,0
5,191,191,37,1,36,4,3
8,206,206,3,3,0,1,0
10,211,211,34,34,0,1,0
9,213,213,5,5,0,1,0
7,234,234,5,5,0,1,0
1,242,242,35,2,33,4,3
12,366,366,32,24,8,2,1
15,370,370,19,19,0,1,0
11,383,383,65,65,0,1,0
4,388,388,32,14,18,3,2
13,421,421,10,10,0,1,0
0,444,444,7,7,0,1,0
14,469,469,55,33,22,3,2
2,493,493,1,1,0,1,0

12,110,110,12,12,0,1,0
2,113,113,2,2,0,1,0
7,126,126,21,21,0,1,0
0,209,209,4,1,3,2,1
6,209,209,1,1,0,1,0
11,256,256,3,3,0,1,0
10,268,268,2,2,0,1,0
13,331,331,117,87,30,4,3
9,335,335,42,27,15,4,3
4,337,337,66,66,0,1,0
3,355,355,22,22,0,1,0
8,415,415,1,1,0,1,0
5,444,444,50,12,38,2,1
1,460,460,10,4,6,2,1

8,163,163,16,16,0,1,0
11,181,181,20,14,6,3,2
10,245,245,22,7,15,4,3
2,257,257,26,16,10,2,1
7,305,305,72,26,46,2,1
5,352,352,3,3,0,1,0
4,413,413,90,12,78,4,3
3,433,433,26,26,0,1,0
1,442,442,36,36,0,1,0
6,447,447,27,27,0,1,0
0,466,466,62,49,13,2,1
9,467,467,8,8,0,1,0

1,137,137,3,3,0,1,0
5,142,142,18,18,0,1,0
11,217,217,28,10,18,3,2
8,233,233,21,6,15,2,1
0,236,236,13,13,0,1,0
6,292,292,37,37,0,1,0
3,327,327,22,22,0,1,0
4,366,366,33,33,0,1,0
9,411,411,21,21,0,1,0
10,430,430,37,37,0,1,0
2,432,432,104,104,0,1,0
7,484,484,62,40,22,3,2

10,165,165,28,28,0,1,0
5,181,181,40,27,13,2,1
8,249,249,19,19,0,1,0
7,283,283,10,4,6,2,1
0,296,296,40,18,22,2,1
9,317,317,17,17,0,1,0
1,333,333,50,42,8,2,1
6,360,360,22,22,0,1,0
2,391,391,65,21,44,2,1
3,428,428,53,11,42,2,1
4,437,437,11,11,0,1,0

0,189,189,31,31,0,1,0
6,262,262,19,19,0,1,0
9,283,283,12,5,7,2,1
3,340,340,119,5,114,4,3
8,385,385,53,31,22,2,1
5,397,397,27,27,0,1,0
2,421,421,15,1,14,3,2
4,442,442,101,71,30,3,2
1,454,454,23,23,0,1,0
7,483,483,29,29,0,1,0

7,102,102,3,3,0,1,0
9,144,144,9,9,0,1,0
2,145,145,13,13,0,1,0
3,186,186,33,13,20,3,2
0,200,200,23,23,0,1,0
10,230,230,26,26,0,1,0
1,237,237,43,38,5,2,1
6,244,244,45,14,31,4,3
5,260,260,8,2,6,2,1
11,309,309,14,2,12,2,1
4,316,316,2,2,0,1,0
8,455,455,81,1,80,3,2

7,157,157,20,20,0,1,0
5,186,186,8,8,0,1,0
9,264,264,11,2,9,4,3
6,335,335,81,51,30,4,3
8,351,351,21,13,8,2,1
4,371,371,39,39,0,1,0
0,381,381,22,22,0,1,0
2,446,446,117,72,45,4,3
3,469,469,84,39,45,4,3
1,474,474,48,48,0,1,0

10,111,111,1,1,0,1,0
5,146,146,15,15,0,1,0
11,159,159,17,17,0,1,0
15,247,247,11,11,0,1,0
0,254,254,1,1,0,1,0
7,270,270,35,29,6,3,2
4,295,295,8,8,0,1,0
8,325,325,11,2,9,4,3
12,337,337,45,29,16,3,2
2,340,340,10,7,3,2,1
9,355,355,19,10,9,4,3
3,362,362,13,13,0,1,0
13,381,381,47,23,24,4,3
14,388,388,4,4,0,1,0
17,439,439,29,29,0,1,0
1,474,474,15,15,0,1,0
16,475,475,109,109,0,1,0
6,479,479,19,8,11,2,1

8,102,102,12,7,5,2,1
2,110,110,5,5,0,1,0
10,110,110,6,6,0,1,0
4,157,157,8,8,0,1,0
7,167,167,22,22,0,1,0
6,240,240,18,2,16,2,1
0,297,297,11,1,10,2,1
5,387,387,108,108,0,1,0
9,419,419,85,85,0,1,0
11,436,436,16,11,5,2,1
3,443,443,55,43,12,4,3
1,486,486,32,32,0,1,0

5,222,222,20,20,0,1,0
8,225,225,17,17,0,1,0
4,243,243,20,20,0,1,0
7,252,252,20,8,12,2,1
6,256,256,3,3,0,1,0
1,262,262,15,15,0,1,0
0,288,288,46,13,33,4,3
9,305,305,18,12,6,2,1
3,311,311,25,25,0,1,0
2,408,408,90,90,0,1,0
10,480,480,140,140,0,1,0

3,190,190,10,3,7,2,1
7,201,201,52,12,40,2,1
2,247,247,12,1,11,2,1
0,257,257,10,10,0,1,0
10,275,275,4,4,0,1,0
8,350,350,31,7,24,3,2
6,353,353,42,30,12,4,3
5,420,420,93,63,30,3,2
4,454,454,5,2,3,2,1
1,470,470,107,11,96,4,3
9,489,489,16,6,10,3,2
11,491,491,47,47,0,1,0

4,191,191,1,1,0,1,0
3,209,209,18,1,17,4,3
0,306,306,69,35,34,2,1
6,318,318,20,6,14,2,1
1,396,396,28,25,3,2,1
8,412,412,153,100,53,4,3
5,454,454,31,7,24,2,1
7,463,463,9,9,0,1,0
2,491,491,150,126,24,2,1

5,124,124,4,4,0,1,0
6,135,135,12,12,0,1,0
4,151,151,4,4,0,1,0
7,181,181,64,35,29,2,1
1,285,285,124,124,0,1,0
2,411,411,27,27,0,1,0
3,426,426,27,1,26,2,1
8,431,431,21,8,13,2,1
0,482,482,48,18,30,4,3

6,111,111,1,1,0,1,0
3,166,166,4,4,0,1,0
13,210,210,13,13,0,1,0
1,223,223,8,8,0,1,0
2,224,224,6,2,4,2,1
15,234,234,37,10,27,4,3
12,256,256,5,5,0,1,0
4,280,280,12,6,6,2,1
14,285,285,17,17,0,1,0
5,301,301,17,2,15,4,3
0,307,307,28,24,4,2,1
10,357,357,25,15,10,2,1
11,375,375,32,32,0,1,0
9,389,389,13,10,3,2,1
16,420,420,94,70,24,4,3
8,438,438,85,52,33,4,3
7,474,474,8,2,6,3,2

5,142,142,4,1,3,2,1
9,164,164,14,14,0,1,0
2,167,167,19,19,0,1,0
6,230,230,8,8,0,1,0
0,293,293,5,2,3,2,1
11,309,309,58,58,0,1,0
8,337,337,51,32,19,2,1
3,350,350,1,1,0,1,0
1,438,438,56,46,10,3,2
7,438,438,43,43,0,1,0
10,445,445,24,17,7,2,1
4,456,456,144,105,39,2,1

12,118,118,9,9,0,1,0
1,130,130,24,14,10,2,1
11,153,153,16,8,8,3,2
8,157,157,3,3,0,1,0
13,215,215,21,21,0,1,0
10,284,284,48,20,28,2,1
5,315,315,36,22,14,2,1
6,337,337,24,24,0,1,0
4,339,339,32,19,13,2,1
9,353,353,54,38,16,2,1
7,383,383,20,6,14,2,1
3,397,397,1,1,0,1,0
0,443,443,24,24,0,1,0
2,486,486,13,13,0,1,0

4,114,114,1,1,0,1,0
5,117,117,9,3,6,2,1
1,145,145,11,11,0,1,0
3,189,189,1,1,0,1,0
0,220,220,26,26,0,1,0
7,236,236,41,19,22,3,2
2,260,260,61,61,0,1,0
8,276,276,71,33,38,2,1
6,340,340,28,13,15,4,3
12,374,374,1,1,0,1,0
9,393,393,9,9,0,1,0
10,425,425,56,32,24,2,1
11,437,437,9,9,0,1,0

8,119,119,28,28,0,1,0
7,123,123,9,3,6,3,2
10,147,147,32,11,21,4,3
13,155,155,19,7,12,4,3
2,161,161,39,5,34,3,2
6,189,189,2,2,0,1,0
4,192,192,6,6,0,1,0
5,207,207,13,1,12,2,1
12,208,208,2,2,0,1,0
3,285,285,25,25,0,1,0
11,305,305,3,3,0,1,0
1,351,351,19,19,0,1,0
0,377,377,15,3,12,3,2
9,457,457,7,7,0,1,0

1,102,102,1,1,0,1,0
6,141,141,1,1,0,1,0
7,147,147,6,6,0,1,0
0,240,240,22,22,0,1,0
13,246,246,21,18,3,2,1
8,247,247,12,2,10,3,2
12,290,290,39,18,21,2,1
5,328,328,8,8,0,1,0
15,346,346,17,17,0,1,0
10,374,374,56,56,0,1,0
14,387,387,12,2,10,4,3
11,407,407,64,64,0,1,0
3,422,422,9,9,0,1,0
2,429,429,10,1,9,2,1
9,462,462,31,31,0,1,0
4,491,491,131,119,12,3,2

3,114,114,5,2,3,2,1
14,129,129,41,35,6,2,1
11,171,171,1,1,0,1,0
2,180,180,4,4,0,1,0
7,190,190,10,1,9,2,1
5,194,194,26,26,0,1,0
13,209,209,18,18,0,1,0
4,221,221,1,1,0,1,0
8,232,232,15,3,12,3,2
12,252,252,5,5,0,1,0
16,279,279,21,3,18,3,2
9,283,283,4,4,0,1,0
1,305,305,12,6,6,2,1
0,342,342,26,8,18,3,2
15,350,350,37,37,0,1,0
10,431,431,37,13,24,4,3
6,433,433,28,28,0,1,0

8,108,108,15,15,0,1,0
7,110,110,4,4,0,1,0
1,139,139,15,15,0,1,0
9,191,191,7,7,0,1,0
12,194,194,56,16,40,3,2
10,260,260,16,16,0,1,0
5,262,262,47,47,0,1,0
13,279,279,11,11,0,1,0
4,289,289,28,10,18,2,1
11,305,305,15,15,0,1,0
0,336,336,13,13,0,1,0
2,382,382,31,7,24,2,1
6,386,386,18,18,0,1,0
3,478,478,7,2,5,2,1

13,123,123,8,8,0,1,0
7,193,193,1,1,0,1,0
2,204,204,2,2,0,1,0
6,206,206,19,4,15,4,3
3,237,237,26,26,0,1,0
5,295,295,16,16,0,1,0
1,348,348,6,6,0,1,0
11,350,350,7,7,0,1,0
10,359,359,16,16,0,1,0
0,360,360,11,11,0,1,0
12,370,370,40,27,13,2,1
14,392,392,56,16,40,3,2
4,405,405,109,58,51,4,3
9,409,409,95,11,84,4,3
8,460,460,6,6,0,1,0

0,112,112,11,6,5,2,1
11,151,151,2,2,0,1,0
5,153,153,2,2,0,1,0
3,289,289,22,22,0,1,0
2,296,296,1,1,0,1,0
7,342,342,18,18,0,1,0
9,382,382,49,13,36,4,3
1,395,395,48,48,0,1,0
4,395,395,116,86,30,2,1
8,431,431,49,49,0,1,0
10,482,482,103,55,48,4,3
6,490,490,41,14,27,4,3

12,149,149,31,5,26,2,1
0,167,167,4,4,0,1,0
7,182,182,19,19,0,1,0
11,210,210,9,9,0,1,0
8,243,243,14,4,10,2,1
9,253,253,45,21,24,4,3
10,303,303,9,1,8,3,2
1,323,323,6,6,0,1,0
2,327,327,42,42,0,1,0
3,351,351,9,1,8,2,1
5,387,387,43,43,0,1,0
6,396,396,109,109,0,1,0
4,409,409,7,7,0,1,0

8,136,136,1,1,0,1,0
7,167,167,1,1,0,1,0
4,207,207,1,1,0,1,0
2,217,217,8,1,7,2,1
6,305,305,17,5,12,3,2
3,311,311,88,2,86,4,3
5,329,329,93,5,88,3,2
0,338,338,26,26,0,1,0
1,405,405,83,77,6,2,1
9,409,409,107,107,0,1,0

12,111,111,7,7,0,1,0
13,167,167,16,2,14,2,1
1,174,174,18,2,16,3,2
5,201,201,5,5,0,1,0
14,289,289,17,17,0,1,0
2,318,318,29,29,0,1,0
3,365,365,16,16,0,1,0
0,368,368,19,1,18,2,1
11,376,376,79,13,66,3,2
4,378,378,39,32,7,2,1
6,392,392,13,13,0,1,0
8,402,402,19,5,14,2,1
7,408,408,37,37,0,1,0
15,431,431,30,30,0,1,0
10,433,433,49,8,41,4,3
9,475,475,6,6,0,1,0

15,113,113,11,5,6,3,2
12,189,189,3,3,0,1,0
17,207,207,47,39,8,2,1
5,215,215,6,6,0,1,0
2,233,233,6,6,0,1,0
16,244,244,1,1,0,1,0
0,277,277,4,4,0,1,0
8,309,309,20,8,12,4,3
3,311,311,20,4,16,2,1
14,328,328,73,1,72,4,3
7,333,333,57,7,50,2,1
13,347,347,16,1,15,4,3
4,360,360,23,23,0,1,0
10,362,362,6,3,3,2,1
11,362,362,1,1,0,1,0
6,383,383,17,9,8,2,1
9,432,432,17,5,12,4,3
1,475,475,32,32,0,1,0

6,103,103,1,1,0,1,0
15,107,107,13,13,0,1,0
0,112,112,7,7,0,1,0
3,116,116,1,1,0,1,0
10,123,123,9,5,4,2,1
8,170,170,24,13,11,3,2
9,191,191,19,6,13,2,1
4,201,201,26,26,0,1,0
12,266,266,49,45,4,2,1
11,273,273,10,10,0,1,0
14,299,299,4,4,0,1,0
1,302,302,10,10,0,1,0
2,375,375,10,1,9,4,3
5,413,413,5,5,0,1,0
13,442,442,79,79,0,1,0
7,483,483,39,7,32,2,1

6,122,122,26,26,0,1,0
1,129,129,29,7,22,2,1
4,134,134,5,5,0,1,0
3,154,154,40,40,0,1,0
0,168,168,13,13,0,1,0
7,186,186,6,6,0,1,0
8,301,301,83,17,66,4,3
5,332,332,14,14,0,1,0
10,355,355,2,2,0,1,0
9,377,377,16,16,0,1,0
2,396,396,1,1,0,1,0

1,162,162,7,3,4,2,1
5,167,167,12,2,10,2,1
11,269,269,1,1,0,1,0
2,280,280,63,16,47,2,1
6,296,296,29,20,9,4,3
7,298,298,36,29,7,2,1
8,345,345,50,31,19,3,2
3,389,389,60,60,0,1,0
4,418,418,3,3,0,1,0
9,432,432,42,42,0,1,0
0,485,485,1,1,0,1,0
12,485,485,7,7,0,1,0
10,500,500,113,83,30,4,3

9,133,133,6,6,0,1,0
16,137,137,6,6,0,1,0
11,140,140,1,1,0,1,0
10,148,148,11,11,0,1,0
13,157,157,1,1,0,1,0
0,181,181,1,1,0,1,0
6,236,236,10,10,0,1,0
5,241,241,6,3,3,2,1
12,241,241,9,1,8,2,1
8,242,242,3,3,0,1,0
2,257,257,28,28,0,1,0
7,305,305,45,45,0,1,0
1,323,323,22,22,0,1,0
15,345,345,26,26,0,1,0
3,369,369,4,1,3,2,1
18,379,379,33,33,0,1,0
14,434,434,95,51,44,2,1
4,458,458,8,2,6,3,2
17,485,485,88,2,86,3,2

1,126,126,2,2,0,1,0
8,186,186,3,3,0,1,0
0,231,231,34,25,9,2,1
7,261,261,16,16,0,1,0
6,278,278,11,11,0,1,0
5,281,281,50,50,0,1,0
2,451,451,140,2,138,4,3
3,469,469,60,60,0,1,0
4,480,480,107,19,88,3,2
9,482,482,46,46,0,1,0

0,130,130,4,1,3,2,1
6,193,193,26,26,0,1,0
5,201,201,6,3,3,2,1
2,202,202,11,11,0,1,0
1,206,206,1,1,0,1,0
9,229,229,11,11,0,1,0
10,242,242,33,9,24,4,3
11,340,340,51,11,40,2,1
7,375,375,31,31,0,1,0
4,416,416,10,10,0,1,0
8,430,430,25,10,15,4,3
3,455,455,209,190,19,2,1

4,127,127,2,2,0,1,0
8,145,145,1,1,0,1,0
10,186,186,18,18,0,1,0
11,190,190,39,39,0,1,0
15,196,196,1,1,0,1,0
0,272,272,19,2,17,2,1
7,315,315,9,3,6,3,2
3,344,344,30,30,0,1,0
9,387,387,56,56,0,1,0
12,402,402,47,47,0,1,0
13,409,409,76,66,10,3,2
2,411,411,56,8,48,3,2
1,429,429,27,27,0,1,0
14,447,447,1,1,0,1,0
5,456,456,1,1,0,1,0
6,467,467,22,22,0,1,0

2,179,179,7,1,6,3,2
9,224,224,37,15,22,2,1
13,250,250,14,2,12,3,2
12,252,252,28,28,0,1,0
3,322,322,28,8,20,3,2
5,331,331,34,34,0,1,0
4,337,337,39,9,30,4,3
8,357,357,10,10,0,1,0
11,401,401,28,17,11,2,1
7,435,435,31,31,0,1,0
0,457,457,39,3,36,2,1
6,457,457,22,22,0,1,0
14,475,475,5,5,0,1,0
10,481,481,95,88,7,2,1
1,486,486,12,12,0,1,0

9,187,187,23,3,20,2,1
0,280,280,26,26,0,1,0
10,326,326,6,6,0,1,0
7,341,341,45,45,0,1,0
4,345,345,19,16,3,2,1
2,349,349,56,9,47,2,1
5,398,398,59,59,0,1,0
3,415,415,87,87,0,1,0
1,444,444,37,2,35,2,1
8,465,465,57,57,0,1,0
6,496,496,32,24,8,3,2

8,109,109,2,2,0,1,0
5,123,123,11,11,0,1,0
7,132,132,23,23,0,1,0
2,225,225,15,15,0,1,0
0,278,278,25,16,9,2,1
10,283,283,61,61,0,1,0
3,290,290,3,3,0,1,0
9,316,316,19,4,15,4,3
4,337,337,93,78,15,2,1
6,368,368,21,21,0,1,0
1,482,482,76,12,64,3,2

11,113,113,18,18,0,1,0
2,126,126,37,37,0,1,0
12,151,151,3,3,0,1,0
3,163,163,15,15,0,1,0
0,251,251,4,4,0,1,0
9,259,259,13,1,12,2,1
6,333,333,34,20,14,3,2
10,345,345,67,51,16,2,1
7,382,382,55,13,42,2,1
1,422,422,2,2,0,1,0
8,473,473,21,6,15,4,3
4,481,481,17,6,11,2,1
5,490,490,29,29,0,1,0

9,148,148,9,9,0,1,0
1,159,159,1,1,0,1,0
3,258,258,35,18,17,2,1
5,318,318,76,60,16,3,2
13,363,363,51,51,0,1,0
2,366,366,27,2,25,2,1
0,384,384,10,2,8,3,2
4,391,391,3,3,0,1,0
10,414,414,34,27,7,2,1
6,426,426,34,9,25,2,1
8,427,427,30,30,0,1,0
11,466,466,105,78,27,4,3
7,468,468,15,5,10,3,2
12,468,468,13,13,0,1,0

3,178,178,11,11,0,1,0
9,180,180,1,1,0,1,0
5,198,198,1,1,0,1,0
15,198,198,38,38,0,1,0
6,199,199,10,1,9,4,3
0,254,254,57,47,10,3,2
10,272,272,5,5,0,1,0
16,281,281,33,27,6,2,1
4,317,317,4,4,0,1,0
8,360,360,2,2,0,1,0
2,369,369,9,9,0,1,0
7,369,369,67,24,43,2,1
14,390,390,74,74,0,1,0
12,406,406,13,13,0,1,0
1,429,429,5,5,0,1,0
11,446,446,2,2,0,1,0
13,495,495,36,8,28,3,2

1,119,119,7,1,6,3,2
10,122,122,2,2,0,1,0
3,137,137,2,2,0,1,0
7,222,222,21,21,0,1,0
11,243,243,38,24,14,2,1
6,256,256,7,7,0,1,0
9,266,266,39,13,26,2,1
12,298,298,23,16,7,2,1
2,317,317,2,2,0,1,0
5,333,333,53,9,44,2,1
0,351,351,113,16,97,4,3
4,389,389,5,5,0,1,0
8,440,440,53,19,34,2,1

13,103,103,7,7,0,1,0
0,141,141,10,10,0,1,0
9,155,155,46,34,12,3,2
6,208,208,28,20,8,2,1
7,210,210,1,1,0,1,0
12,216,216,15,7,8,2,1
11,235,235,15,3,12,3,2
4,319,319,1,1,0,1,0
10,370,370,23,10,13,2,1
2,408,408,11,1,10,2,1
8,439,439,53,53,0,1,0
14,446,446,22,22,0,1,0
5,471,471,37,1,36,3,2
1,476,476,29,29,0,1,0
3,495,495,50,50,0,1,0

6,112,112,2,2,0,1,0
9,140,140,21,18,3,2,1
12,173,173,15,11,4,2,1
1,194,194,25,25,0,1,0
8,197,197,5,5,0,1,0
3,270,270,65,65,0,1,0
10,325,325,28,19,9,4,3
7,337,337,72,46,26,2,1
4,372,372,10,10,0,1,0
0,382,382,9,9,0,1,0
2,407,407,58,38,20,3,2
11,425,425,23,23,0,1,0
5,494,494,10,10,0,1,0

17,117,117,11,4,7,2,1
8,157,157,6,6,0,1,0
10,165,165,1,1,0,1,0
5,184,184,25,25,0,1,0
6,186,186,1,1,0,1,0
3,199,199,5,5,0,1,0
2,203,203,4,4,0,1,0
18,242,242,8,8,0,1,0
11,267,267,1,1,0,1,0
14,300,300,19,19,0,1,0
16,314,314,16,16,0,1,0
1,339,339,67,28,39,4,3
4,341,341,9,5,4,2,1
9,391,391,18,18,0,1,0
0,407,407,2,2,0,1,0
15,437,437,60,15,45,2,1
13,460,460,108,108,0,1,0
12,493,493,6,2,4,2,1
7,497,497,40,13,27,4,3

11,106,106,20,5,15,4,3
13,112,112,8,1,7,2,1
12,150,150,18,18,0,1,0
6,238,238,65,5,60,3,2
1,255,255,15,6,9,2,1
4,264,264,14,2,12,4,3
9,294,294,41,41,0,1,0
5,296,296,6,1,5,2,1
8,297,297,2,2,0,1,0
7,304,304,12,12,0,1,0
3,333,333,18,2,16,2,1
2,349,349,33,20,13,4,3
0,413,413,4,4,0,1,0
10,489,489,46,37,9,2,1

2,126,126,21,18,3,2,1
5,218,218,1,1,0,1,0
10,245,245,1,1,0,1,0
0,271,271,34,5,29,2,1
4,280,280,18,18,0,1,0
6,302,302,86,65,21,4,3
3,322,322,69,39,30,2,1
9,362,362,26,26,0,1,0
8,381,381,67,67,0,1,0
1,421,421,13,13,0,1,0
7,431,431,29,29,0,1,0

8,112,112,14,8,6,2,1
5,147,147,10,10,0,1,0
2,148,148,7,7,0,1,0
1,248,248,60,22,38,3,2
0,249,249,79,79,0,1,0
3,296,296,81,30,51,4,3
7,300,300,27,27,0,1,0
6,341,341,4,4,0,1,0
4,408,408,20,20,0,1,0

5,138,138,43,6,37,2,1
3,191,191,9,9,0,1,0
9,197,197,14,14,0,1,0
6,261,261,15,8,7,2,1
7,293,293,4,4,0,1,0
1,309,309,64,61,3,2,1
8,363,363,54,54,0,1,0
4,407,407,2,2,0,1,0
0,438,438,112,76,36,2,1
2,493,493,46,10,36,4,3

5,105,105,9,9,0,1,0
10,124,124,17,17,0,1,0
3,134,134,9,1,8,3,2
13,153,153,15,5,10,2,1
6,165,165,27,27,0,1,0
0,175,175,3,3,0,1,0
2,232,232,4,4,0,1,0
14,242,242,31,21,10,3,2
4,275,275,6,6,0,1,0
11,286,286,4,4,0,1,0
9,339,339,20,20,0,1,0
12,344,344,54,54,0,1,0
15,370,370,31,31,0,1,0
8,394,394,7,2,5,2,1
7,413,413,40,40,0,1,0
1,427,427,23,9,14,2,1

4,112,112,1,1,0,1,0
12,112,112,6,6,0,1,0
3,113,113,34,25,9,4,3
2,116,116,3,3,0,1,0
7,118,118,18,2,16,3,2
9,125,125,10,6,4,2,1
8,147,147,1,1,0,1,0
0,160,160,15,15,0,1,0
10,202,202,22,22,0,1,0
11,332,332,70,70,0,1,0
6,335,335,27,27,0,1,0
5,415,415,33,33,0,1,0
1,495,495,6,6,0,1,0

7,183,183,4,4,0,1,0
3,202,202,29,14,15,4,3
1,289,289,123,123,0,1,0
4,317,317,50,44,6,2,1
5,418,418,7,7,0,1,0
6,453,453,71,7,64,3,2
0,458,458,80,80,0,1,0
2,463,463,51,29,22,2,1

8,139,139,23,2,21,2,1
4,150,150,22,22,0,1,0
9,208,208,14,4,10,2,1
6,392,392,5,5,0,1,0
1,403,403,84,74,10,3,2
3,411,411,54,54,0,1,0
0,416,416,17,17,0,1,0
7,417,417,25,25,0,1,0
5,444,444,90,2,88,3,2
2,471,471,37,24,13,2,1
10,475,475,49,9,40,2,1

9,118,118,2,2,0,1,0
12,130,130,19,19,0,1,0
1,205,205,3,3,0,1,0
0,206,206,1,1,0,1,0
2,236,236,24,10,14,3,2
8,305,305,68,68,0,1,0
7,306,306,12,12,0,1,0
4,355,355,62,62,0,1,0
6,391,391,32,32,0,1,0
11,402,402,36,20,16,3,2
5,437,437,4,4,0,1,0
3,460,460,99,94,5,2,1
10,496,496,45,45,0,1,0

1,272,272,5,2,3,2,1
7,290,290,8,5,3,2,1
2,303,303,27,12,15,2,1
0,348,348,121,52,69,4,3
6,356,356,51,13,38,2,1
8,361,361,56,56,0,1,0
9,387,387,53,53,0,1,0
10,391,391,32,11,21,4,3
4,448,448,18,2,16,3,2
3,481,481,51,51,0,1,0
5,496,496,32,5,27,2,1

8,120,120,4,4,0,1,0
10,126,126,11,1,10,2,1
2,138,138,9,9,0,1,0
12,139,139,21,9,12,2,1
14,160,160,5,5,0,1,0
4,188,188,4,4,0,1,0
7,215,215,1,1,0,1,0
9,215,215,5,5,0,1,0
16,238,238,13,13,0,1,0
0,312,312,16,16,0,1,0
3,323,323,50,14,36,4,3
15,360,360,41,13,28,2,1
13,399,399,15,15,0,1,0
5,427,427,15,11,4,2,1
1,456,456,41,16,25,3,2
11,458,458,100,100,0,1,0
6,468,468,19,7,12,3,2

8,122,122,4,4,0,1,0
0,174,174,26,15,11,2,1
9,183,183,16,10,6,2,1
4,222,222,6,3,3,2,1
6,247,247,92,46,46,3,2
2,367,367,1,1,0,1,0
1,380,380,28,3,25,3,2
5,439,439,16,16,0,1,0
7,468,468,28,16,12,2,1
3,494,494,185,165,20,3,2

2,141,141,24,11,13,2,1
6,182,182,1,1,0,1,0
8,192,192,12,7,5,2,1
0,204,204,30,25,5,2,1
11,218,218,30,22,8,2,1
12,222,222,4,1,3,2,1
10,249,249,2,2,0,1,0
7,284,284,5,5,0,1,0
3,353,353,39,1,38,2,1
9,368,368,62,59,3,2,1
5,388,388,27,27,0,1,0
1,396,396,5,5,0,1,0
14,415,415,37,37,0,1,0
4,437,437,4,4,0,1,0
13,482,482,88,41,47,2,1

1,132,132,24,24,0,1,0
11,154,154,1,1,0,1,0
6,254,254,33,21,12,2,1
0,296,296,33,33,0,1,0
8,298,298,15,2,13,2,1
10,317,317,111,45,66,4,3
7,324,324,20,16,4,2,1
3,347,347,8,8,0,1,0
2,419,419,44,44,0,1,0
9,450,450,4,1,3,2,1
4,453,453,12,12,0,1,0
5,484,484,74,40,34,2,1

11,171,171,27,1,26,3,2
10,197,197,21,21,0,1,0
6,201,201,34,28,6,3,2
0,321,321,36,36,0,1,0
8,346,346,2,2,0,1,0
7,358,358,61,3,58,4,3
4,400,400,1,1,0,1,0
1,406,406,36,36,0,1,0
2,415,415,62,62,0,1,0
5,416,416,18,18,0,1,0
3,436,436,16,16,0,1,0
12,445,445,9,3,6,2,1
9,479,479,72,60,12,3,2

4,135,135,19,9,10,3,2
10,160,160,8,2,6,3,2
6,180,180,10,1,9,4,3
9,185,185,9,9,0,1,0
5,204,204,3,3,0,1,0
11,234,234,3,3,0,1,0
8,269,269,103,19,84,4,3
1,293,293,13,3,10,3,2
2,294,294,6,6,0,1,0
12,350,350,29,20,9,2,1
7,351,351,13,13,0,1,0
3,374,374,8,1,7,3,2
0,456,456,140,83,57,3,2

1,120,120,1,1,0,1,0
11,137,137,6,6,0,1,0
7,155,155,7,1,6,2,1
8,173,173,1,1,0,1,0
6,189,189,9,1,8,2,1
2,229,229,54,54,0,1,0
13,232,232,18,18,0,1,0
10,302,302,17,17,0,1,0
5,352,352,17,17,0,1,0
12,372,372,70,63,7,2,1
14,399,399,43,7,36,3,2
9,426,426,59,36,23,2,1
0,451,451,21,21,0,1,0
4,472,472,29,7,22,3,2
3,484,484,49,38,11,2,1

10,130,130,21,18,3,2,1
7,154,154,12,6,6,2,1
9,162,162,2,2,0,1,0
5,164,164,12,12,0,1,0
0,216,216,38,1,37,4,3
4,278,278,43,43,0,1,0
11,336,336,81,30,51,4,3
6,349,349,25,1,24,2,1
1,405,405,24,6,18,2,1
2,411,411,17,2,15,2,1
3,435,435,42,6,36,2,1
8,490,490,25,25,0,1,0

2,101,101,20,20,0,1,0
7,122,122,12,12,0,1,0
9,123,123,3,3,0,1,0
4,148,148,9,9,0,1,0
12,257,257,49,30,19,2,1
8,299,299,58,36,22,2,1
3,302,302,38,38,0,1,0
11,350,350,25,22,3,2,1
6,410,410,9,3,6,3,2
10,444,444,20,20,0,1,0
0,483,483,5,5,0,1,0
1,489,489,45,6,39,2,1
5,495,495,46,8,38,2,1

5,108,108,12,12,0,1,0
9,173,173,8,8,0,1,0
1,178,178,18,18,0,1,0
3,224,224,12,7,5,2,1
11,224,224,6,3,3,2,1
0,242,242,15,15,0,1,0
2,266,266,24,3,21,2,1
8,313,313,28,28,0,1,0
7,336,336,61,61,0,1,0
10,381,381,42,42,0,1,0
6,397,397,61,61,0,1,0
4,492,492,92,92,0,1,0

8,119,119,4,4,0,1,0
5,158,158,1,1,0,1,0
0,195,195,37,37,0,1,0
14,197,197,5,1,4,2,1
15,210,210,16,11,5,2,1
12,224,224,2,2,0,1,0
2,236,236,6,6,0,1,0
3,251,251,11,7,4,2,1
7,255,255,2,2,0,1,0
6,268,268,16,4,12,4,3
10,373,373,30,30,0,1,0
11,415,415,110,110,0,1,0
9,427,427,1,1,0,1,0
1,445,445,26,26,0,1,0
4,458,458,80,4,76,4,3
13,467,467,72,72,0,1,0

1,197,197,41,27,14,3,2
7,207,207,39,15,24,4,3
4,210,210,11,3,8,2,1
2,217,217,22,11,11,2,1
6,256,256,53,37,16,3,2
5,304,304,1,1,0,1,0
0,343,343,135,84,51,4,3
3,452,452,27,19,8,3,2

11,159,159,19,10,9,4,3
5,185,185,7,1,6,3,2
4,204,204,14,10,4,2,1
0,206,206,37,10,27,4,3
10,247,247,39,22,17,2,1
9,277,277,23,5,18,2,1
7,296,296,18,18,0,1,0
12,315,315,33,3,30,3,2
8,351,351,50,50,0,1,0
14,413,413,19,7,12,2,1
2,433,433,1,1,0,1,0
13,451,451,44,38,6,2,1
6,472,472,19,19,0,1,0
3,479,479,15,15,0,1,0
1,489,489,18,18,0,1,0

16,128,128,10,10,0,1,0
1,133,133,14,14,0,1,0
14,146,146,6,6,0,1,0
9,188,188,1,1,0,1,0
5,240,240,4,4,0,1,0
0,241,241,3,3,0,1,0
3,258,258,4,4,0,1,0
12,261,261,26,18,8,2,1
4,348,348,1,1,0,1,0
10,360,360,29,29,0,1,0
7,362,362,4,4,0,1,0
11,364,364,19,1,18,4,3
15,364,364,69,69,0,1,0
8,376,376,84,7,77,4,3
6,400,400,9,3,6,3,2
17,447,447,59,15,44,3,2
13,455,455,33,33,0,1,0
2,473,473,25,4,21,2,1

12,121,121,14,14,0,1,0
9,136,136,7,7,0,1,0
5,167,167,10,10,0,1,0
1,185,185,38,38,0,1,0
0,197,197,8,8,0,1,0
10,211,211,14,14,0,1,0
2,232,232,19,2,17,2,1
11,237,237,27,27,0,1,0
3,259,259,26,26,0,1,0
7,394,394,3,3,0,1,0
6,421,421,21,21,0,1,0
8,440,440,111,9,102,4,3
13,469,469,8,8,0,1,0
4,489,489,27,27,0,1,0

3,100,100,4,4,0,1,0
9,106,106,14,14,0,1,0
8,135,135,9,9,0,1,0
1,165,165,6,6,0,1,0
11,169,169,12,6,6,3,2
0,296,296,20,3,17,2,1
6,309,309,17,8,9,2,1
12,317,317,9,2,7,2,1
7,351,351,26,6,20,2,1
5,387,387,34,10,24,3,2
10,416,416,101,14,87,4,3
2,451,451,105,21,84,3,2
4,482,482,40,40,0,1,0

2,146,146,70,55,15,3,2
8,180,180,30,14,16,2,1
5,227,227,2,2,0,1,0
1,312,312,9,9,0,1,0
0,351,351,33,15,18,2,1
6,370,370,119,119,0,1,0
3,399,399,2,2,0,1,0
7,413,413,23,23,0,1,0
4,425,425,23,23,0,1,0

7,147,147,28,7,21,2,1
12,216,216,4,4,0,1,0
6,234,234,56,44,12,2,1
0,261,261,8,5,3,2,1
10,324,324,74,23,51,3,2
4,338,338,16,16,0,1,0
9,380,380,12,12,0,1,0
1,417,417,6,6,0,1,0
2,419,419,16,4,12,4,3
3,422,422,10,10,0,1,0
5,425,425,8,1,7,2,1
8,436,436,89,89,0,1,0
13,446,446,10,10,0,1,0
11,454,454,47,47,0,1,0

6,110,110,10,10,0,1,0
12,112,112,15,15,0,1,0
8,113,113,14,14,0,1,0
3,132,132,3,3,0,1,0
4,164,164,10,10,0,1,0
5,205,205,24,24,0,1,0
13,216,216,17,17,0,1,0
9,233,233,1,1,0,1,0
0,235,235,1,1,0,1,0
14,245,245,21,18,3,2,1
11,285,285,2,2,0,1,0
7,320,320,1,1,0,1,0
17,387,387,18,18,0,1,0
1,423,423,3,3,0,1,0
15,442,442,113,113,0,1,0
16,459,459,6,6,0,1,0
10,478,478,44,12,32,4,3
2,486,486,34,19,15,4,3

9,101,101,6,6,0,1,0
3,121,121,27,16,11,2,1
2,122,122,6,6,0,1,0
13,155,155,1,1,0,1,0
1,226,226,27,27,0,1,0
14,227,227,10,10,0,1,0
6,267,267,19,12,7,3,2
12,269,269,27,2,25,2,1
11,290,290,17,17,0,1,0
7,383,383,6,6,0,1,0
0,413,413,20,20,0,1,0
4,418,418,13,2,11,2,1
5,432,432,3,3,0,1,0
10,495,495,167,72,95,4,3
8,497,497,18,18,0,1,0

8,100,100,3,3,0,1,0
13,147,147,10,10,0,1,0
4,155,155,6,6,0,1,0
3,158,158,9,9,0,1,0
17,159,159,6,6,0,1,0
0,213,213,14,4,10,3,2
14,223,223,85,40,45,2,1
7,226,226,48,3,45,4,3
15,232,232,8,8,0,1,0
1,242,242,14,1,13,2,1
12,260,260,4,4,0,1,0
10,266,266,1,1,0,1,0
16,301,301,7,1,6,2,1
9,314,314,15,15,0,1,0
11,403,403,1,1,0,1,0
2,432,432,16,2,14,2,1
6,434,434,1,1,0,1,0
5,462,462,14,6,8,2,1
18,469,469,34,21,13,2,1

12,151,151,27,27,0,1,0
11,188,188,11,11,0,1,0
7,201,201,14,14,0,1,0
5,208,208,9,9,0,1,0
6,215,215,35,19,16,3,2
0,226,226,11,11,0,1,0
4,231,231,2,2,0,1,0
1,258,258,26,26,0,1,0
9,313,313,62,25,37,2,1
8,337,337,43,10,33,4,3
13,339,339,14,3,11,2,1
3,359,359,9,9,0,1,0
10,391,391,3,3,0,1,0
2,467,467,67,67,0,1,0

8,117,117,3,3,0,1,0
0,136,136,1,1,0,1,0
9,148,148,5,5,0,1,0
5,223,223,41,41,0,1,0
4,224,224,27,4,23,4,3
6,274,274,33,11,22,3,2
2,294,294,6,6,0,1,0
3,375,375,52,5,47,2,1
1,383,383,4,4,0,1,0
7,383,383,21,12,9,2,1
10,423,423,23,17,6,2,1
12,423,423,122,44,78,3,2
11,496,496,74,31,43,2,1

9,121,121,1,1,0,1,0
10,138,138,12,12,0,1,0
3,139,139,4,4,0,1,0
8,147,147,17,17,0,1,0
0,151,151,9,1,8,2,1
2,243,243,8,8,0,1,0
7,272,272,32,32,0,1,0
4,399,399,125,125,0,1,0
5,428,428,78,30,48,4,3
1,435,435,73,73,0,1,0
6,442,442,45,45,0,1,0

5,102,102,11,11,0,1,0
3,170,170,40,40,0,1,0
4,254,254,60,60,0,1,0
1,278,278,19,19,0,1,0
9,299,299,46,23,23,2,1
7,336,336,7,2,5,2,1
6,407,407,22,22,0,1,0
8,418,418,105,6,99,4,3
0,421,421,18,18,0,1,0
10,427,427,11,11,0,1,0
2,455,455,8,8,0,1,0

4,143,143,5,5,0,1,0
7,148,148,1,1,0,1,0
10,179,179,24,6,18,2,1
5,207,207,9,1,8,3,2
15,249,249,12,4,8,2,1
12,332,332,45,3,42,3,2
8,333,333,12,12,0,1,0
11,342,342,59,59,0,1,0
13,361,361,37,13,24,2,1
9,369,369,13,6,7,2,1
1,387,387,9,3,6,2,1
3,403,403,60,20,40,3,2
0,409,409,41,24,17,2,1
2,453,453,70,25,45,4,3
6,457,457,8,8,0,1,0
14,475,475,9,9,0,1,0

6,125,125,6,6,0,1,0
9,146,146,31,1,30,4,3
8,298,298,28,28,0,1,0
0,319,319,2,2,0,1,0
3,329,329,71,71,0,1,0
5,338,338,45,39,6,3,2
4,352,352,4,4,0,1,0
1,361,361,97,97,0,1,0
7,419,419,48,16,32,3,2
2,471,471,52,52,0,1,0

5,108,108,9,4,5,2,1
9,112,112,4,4,0,1,0
3,125,125,5,5,0,1,0
1,160,160,21,21,0,1,0
0,299,299,48,48,0,1,0
4,361,361,35,26,9,4,3
10,366,366,30,30,0,1,0
7,369,369,20,20,0,1,0
2,378,378,34,7,27,3,2
8,395,395,24,24,0,1,0
11,445,445,159,159,0,1,0
6,478,478,10,2,8,3,2

8,132,132,1,1,0,1,0
2,135,135,13,13,0,1,0
5,197,197,52,28,24,4,3
6,268,268,52,52,0,1,0
11,290,290,9,9,0,1,0
4,300,300,4,4,0,1,0
1,355,355,27,27,0,1,0
9,386,386,55,13,42,3,2
0,406,406,58,44,14,2,1
3,413,413,5,5,0,1,0
7,489,489,59,59,0,1,0
10,491,491,55,55,0,1,0

4,132,132,2,2,0,1,0
6,133,133,1,1,0,1,0
7,135,135,9,6,3,2,1
11,148,148,20,20,0,1,0
8,174,174,44,44,0,1,0
1,185,185,20,20,0,1,0
0,225,225,73,34,39,4,3
3,279,279,16,13,3,2,1
13,301,301,37,37,0,1,0
12,341,341,4,4,0,1,0
2,352,352,4,4,0,1,0
10,377,377,14,1,13,2,1
9,380,380,18,9,9,2,1
5,429,429,5,5,0,1,0

2,178,178,9,3,6,2,1
8,193,193,5,5,0,1,0
6,199,199,11,6,5,2,1
5,222,222,16,13,3,2,1
0,236,236,21,12,9,4,3
7,248,248,14,14,0,1,0
3,268,268,49,8,41,4,3
4,432,432,94,94,0,1,0
1,475,475,221,133,88,3,2

3,119,119,19,19,0,1,0
6,240,240,4,4,0,1,0
2,268,268,52,2,50,2,1
8,277,277,30,25,5,2,1
5,361,361,21,21,0,1,0
1,369,369,4,4,0,1,0
0,424,424,60,45,15,4,3
4,426,426,16,2,14,2,1
10,435,435,55,55,0,1,0
7,444,444,76,45,31,2,1
11,444,444,20,20,0,1,0
9,467,467,68,62,6,2,1

12,106,106,8,8,0,1,0
9,123,123,23,8,15,4,3
0,137,137,1,1,0,1,0
7,195,195,6,6,0,1,0
3,208,208,23,23,0,1,0
5,214,214,24,24,0,1,0
13,244,244,11,11,0,1,0
10,247,247,7,7,0,1,0
1,308,308,9,9,0,1,0
14,314,314,27,21,6,2,1
11,327,327,64,36,28,3,2
8,345,345,55,25,30,2,1
6,402,402,6,6,0,1,0
2,415,415,53,2,51,4,3
4,442,442,4,4,0,1,0

5,134,134,1,1,0,1,0
8,183,183,10,10,0,1,0
1,194,194,28,28,0,1,0
2,239,239,16,16,0,1,0
4,256,256,54,54,0,1,0
7,306,306,46,46,0,1,0
0,324,324,117,117,0,1,0
3,383,383,11,6,5,2,1
9,387,387,55,46,9,3,2
6,457,457,20,20,0,1,0

6,104,104,3,3,0,1,0
2,121,121,11,3,8,2,1
8,122,122,29,29,0,1,0
0,183,183,11,11,0,1,0
10,223,223,15,15,0,1,0
3,227,227,11,11,0,1,0
7,258,258,3,3,0,1,0
9,283,283,61,4,57,3,2
4,331,331,2,2,0,1,0
11,429,429,20,7,13,3,2
1,439,439,93,93,0,1,0
5,464,464,85,27,58,3,2

0,110,110,17,17,0,1,0
3,135,135,1,1,0,1,0
9,189,189,10,10,0,1,0
1,242,242,46,19,27,2,1
4,243,243,1,1,0,1,0
12,249,249,15,15,0,1,0
5,302,302,1,1,0,1,0
2,387,387,6,2,4,2,1
7,413,413,27,27,0,1,0
8,414,414,86,3,83,4,3
10,449,449,10,4,6,3,2
6,479,479,77,67,10,2,1
11,479,479,65,5,60,3,2
13,497,497,66,22,44,3,2

0,114,114,1,1,0,1,0
13,121,121,1,1,0,1,0
7,202,202,13,13,0,1,0
10,236,236,2,2,0,1,0
6,244,244,11,5,6,3,2
12,268,268,39,39,0,1,0
14,342,342,64,22,42,2,1
5,344,344,15,8,7,2,1
1,348,348,36,16,20,3,2
9,351,351,40,28,12,4,3
2,364,364,7,7,0,1,0
15,408,408,45,33,12,3,2
3,416,416,64,64,0,1,0
4,453,453,1,1,0,1,0
8,460,460,22,22,0,1,0
11,469,469,72,24,48,3,2

6,143,143,22,1,21,2,1
1,230,230,29,2,27,2,1
3,234,234,48,48,0,1,0
7,263,263,42,42,0,1,0
9,266,266,38,20,18,4,3
2,327,327,11,11,0,1,0
0,331,331,78,10,68,3,2
5,341,341,28,14,14,2,1
8,369,369,2,2,0,1,0
4,415,415,29,11,18,4,3

15,118,118,8,4,4,2,1
11,194,194,19,14,5,2,1
16,204,204,9,9,0,1,0
7,205,205,1,1,0,1,0
9,229,229,47,47,0,1,0
3,252,252,5,5,0,1,0
14,254,254,2,2,0,1,0
5,259,259,15,15,0,1,0
1,283,283,33,3,30,2,1
2,352,352,7,7,0,1,0
0,354,354,17,3,14,2,1
4,421,421,1,1,0,1,0
6,442,442,33,19,14,3,2
8,458,458,1,1,0,1,0
13,479,479,44,20,24,4,3
10,485,485,24,15,9,4,3
12,497,497,154,115,39,2,1

3,170,170,10,7,3,2,1
6,208,208,8,4,4,2,1
9,244,244,11,1,10,2,1
11,252,252,3,3,0,1,0
8,315,315,95,72,23,4,3
7,350,350,38,38,0,1,0
4,353,353,67,49,18,4,3
1,417,417,1,1,0,1,0
2,438,438,60,60,0,1,0
0,476,476,54,54,0,1,0
5,493,493,49,12,37,3,2
10,500,500,52,52,0,1,0

7,118,118,23,20,3,2,1
0,200,200,5,5,0,1,0
3,205,205,23,23,0,1,0
5,240,240,3,3,0,1,0
2,314,314,10,1,9,4,3
13,329,329,27,18,9,3,2
11,331,331,37,21,16,3,2
8,334,334,3,3,0,1,0
12,337,337,43,1,42,2,1
9,386,386,104,32,72,4,3
1,409,409,18,12,6,2,1
4,444,444,81,35,46,4,3
6,461,461,2,2,0,1,0
10,467,467,5,5,0,1,0

2,101,101,9,9,0,1,0
4,104,104,4,4,0,1,0
7,114,114,19,10,9,4,3
10,165,165,5,5,0,1,0
6,197,197,1,1,0,1,0
3,220,220,17,17,0,1,0
11,234,234,12,12,0,1,0
5,235,235,11,11,0,1,0
12,289,289,4,4,0,1,0
9,301,301,14,14,0,1,0
8,379,379,115,64,51,4,3
0,409,409,92,92,0,1,0
1,438,438,54,24,30,3,2

3,149,149,1,1,0,1,0
0,176,176,11,5,6,2,1
4,225,225,37,37,0,1,0
10,235,235,14,2,12,2,1
8,247,247,47,7,40,3,2
5,267,267,12,12,0,1,0
9,313,313,5,5,0,1,0
2,339,339,56,56,0,1,0
6,377,377,21,21,0,1,0
7,396,396,96,96,0,1,0
1,473,473,97,88,9,4,3

10,133,133,6,6,0,1,0
2,155,155,16,4,12,2,1
14,184,184,7,7,0,1,0
11,287,287,9,1,8,3,2
5,302,302,2,2,0,1,0
0,322,322,7,7,0,1,0
13,349,349,66,16,50,2,1
4,352,352,8,1,7,2,1
8,353,353,19,6,13,2,1
6,365,365,79,56,23,2,1
16,415,415,123,84,39,4,3
9,417,417,1,1,0,1,0
15,441,441,5,5,0,1,0
1,477,477,5,5,0,1,0
7,480,480,18,8,10,2,1
3,494,494,43,13,30,2,1
12,498,498,21,6,15,4,3

0,105,105,6,6,0,1,0
2,180,180,20,20,0,1,0
12,184,184,29,14,15,4,3
1,273,273,15,3,12,3,2
10,287,287,38,38,0,1,0
11,306,306,8,8,0,1,0
6,318,318,27,10,17,2,1
3,322,322,43,43,0,1,0
7,334,334,62,55,7,2,1
4,337,337,37,9,28,3,2
9,380,380,35,30,5,2,1
8,387,387,7,3,4,2,1
5,412,412,21,7,14,2,1

0,102,102,1,1,0,1,0
4,130,130,15,15,0,1,0
14,164,164,6,6,0,1,0
7,166,166,11,2,9,4,3
13,167,167,13,7,6,3,2
1,178,178,21,18,3,2,1
5,198,198,22,14,8,2,1
12,202,202,27,14,13,2,1
10,225,225,6,6,0,1,0
6,252,252,6,6,0,1,0
9,370,370,17,13,4,2,1
11,375,375,91,76,15,2,1
15,433,433,38,5,33,4,3
8,466,466,25,25,0,1,0
2,476,476,12,12,0,1,0
3,496,496,16,16,0,1,0

0,160,160,54,54,0,1,0
3,226,226,23,23,0,1,0
5,265,265,21,21,0,1,0
2,269,269,19,2,17,2,1
7,296,296,47,5,42,4,3
1,334,334,88,20,68,3,2
6,370,370,21,1,20,3,2
4,470,470,67,48,19,3,2

9,122,122,3,3,0,1,0
13,163,163,11,1,10,3,2
7,165,165,1,1,0,1,0
4,183,183,14,5,9,4,3
0,184,184,4,4,0,1,0
10,211,211,10,10,0,1,0
6,293,293,1,1,0,1,0
5,303,303,4,4,0,1,0
2,374,374,45,25,20,2,1
1,382,382,2,2,0,1,0
8,392,392,138,85,53,4,3
3,400,400,143,143,0,1,0
11,450,450,48,48,0,1,0
12,482,482,7,4,3,2,1

5,105,105,5,5,0,1,0
8,108,108,14,14,0,1,0
11,110,110,6,6,0,1,0
10,126,126,3,3,0,1,0
2,188,188,6,6,0,1,0
9,199,199,43,13,30,4,3
7,203,203,21,21,0,1,0
4,314,314,89,14,75,4,3
1,341,341,30,30,0,1,0
6,353,353,18,4,14,4,3
3,369,369,3,3,0,1,0
12,400,400,36,9,27,4,3
0,458,458,42,42,0,1,0

9,117,117,1,1,0,1,0
11,143,143,31,15,16,3,2
1,156,156,16,3,13,2,1
7,240,240,34,34,0,1,0
2,260,260,14,14,0,1,0
8,291,291,9,9,0,1,0
5,383,383,38,38,0,1,0
3,389,389,22,22,0,1,0
0,393,393,91,91,0,1,0
4,393,393,23,5,18,4,3
6,408,408,31,23,8,2,1
10,492,492,68,19,49,3,2

11,102,102,4,4,0,1,0
0,128,128,3,3,0,1,0
13,129,129,7,7,0,1,0
5,134,134,10,10,0,1,0
4,157,157,1,1,0,1,0
16,170,170,19,19,0,1,0
10,225,225,13,13,0,1,0
14,283,283,27,17,10,3,2
1,310,310,1,1,0,1,0
12,312,312,60,60,0,1,0
3,321,321,1,1,0,1,0
7,326,326,92,92,0,1,0
6,341,341,6,6,0,1,0
9,368,368,46,25,21,3,2
15,384,384,48,33,15,4,3
8,462,462,1,1,0,1,0
2,491,491,4,4,0,1,0

3,119,119,7,7,0,1,0
9,210,210,33,25,8,3,2
5,236,236,1,1,0,1,0
11,244,244,8,4,4,2,1
1,245,245,40,40,0,1,0
10,277,277,43,12,31,2,1
6,278,278,8,8,0,1,0
4,343,343,38,8,30,3,2
2,372,372,1,1,0,1,0
0,394,394,103,73,30,2,1
7,399,399,65,20,45,4,3
8,404,404,28,16,12,3,2

6,108,108,7,7,0,1,0
1,145,145,6,3,3,2,1
11,158,158,18,18,0,1,0
3,161,161,6,2,4,2,1
14,170,170,6,6,0,1,0
0,214,214,3,3,0,1,0
18,216,216,5,1,4,2,1
2,218,218,8,8,0,1,0
12,251,251,16,16,0,1,0
16,258,258,44,44,0,1,0
15,279,279,44,4,40,2,1
4,356,356,1,1,0,1,0
7,369,369,37,29,8,2,1
13,452,452,41,11,30,3,2
17,460,460,62,32,30,3,2
8,475,475,10,1,9,4,3
10,482,482,7,7,0,1,0
5,487,487,35,35,0,1,0
9,488,488,9,9,0,1,0

7,161,161,27,7,20,3,2
8,162,162,7,7,0,1,0
1,189,189,7,3,4,2,1
3,238,238,15,1,14,2,1
4,241,241,9,3,6,3,2
2,362,362,74,57,17,3,2
5,397,397,51,51,0,1,0
0,425,425,127,31,96,3,2
9,448,448,37,37,0,1,0
6,452,452,69,3,66,3,2

6,183,183,31,2,29,2,1
7,261,261,10,2,8,3,2
8,294,294,24,12,12,3,2
2,328,328,20,8,12,3,2
0,400,400,133,87,46,2,1
3,418,418,39,15,24,2,1
5,462,462,6,6,0,1,0
1,463,463,97,43,54,3,2
4,472,472,102,10,92,3,2

16,123,123,5,2,3,2,1
8,123,123,1,1,0,1,0
2,126,126,1,1,0,1,0
11,148,148,27,5,22,3,2
0,228,228,29,17,12,4,3
7,255,255,1,1,0,1,0
3,279,279,4,4,0,1,0
14,335,335,49,8,41,2,1
4,335,335,5,5,0,1,0
10,354,354,14,10,4,2,1
1,385,385,40,17,23,2,1
15,405,405,92,44,48,4,3
5,407,407,6,6,0,1,0
13,409,409,1,1,0,1,0
6,423,423,94,23,71,4,3
9,441,441,20,20,0,1,0
12,484,484,7,2,5,2,1

15,125,125,2,2,0,1,0
10,133,133,5,5,0,1,0
1,161,161,2,2,0,1,0
4,168,168,5,5,0,1,0
3,197,197,23,7,16,3,2
8,219,219,9,9,0,1,0
5,239,239,16,9,7,2,1
6,239,239,16,16,0,1,0
2,259,259,30,9,21,2,1
13,276,276,72,4,68,4,3
0,286,286,18,18,0,1,0
11,302,302,54,39,15,2,1
9,335,335,4,4,0,1,0
14,389,389,18,18,0,1,0
12,429,429,31,31,0,1,0
7,434,434,34,22,12,2,1

7,128,128,2,2,0,1,0
12,150,150,6,1,5,2,1
6,154,154,8,8,0,1,0
1,187,187,4,4,0,1,0
4,218,218,1,1,0,1,0
8,306,306,21,21,0,1,0
5,307,307,32,11,21,4,3
3,313,313,52,52,0,1,0
0,338,338,36,36,0,1,0
10,338,338,28,13,15,4,3
9,379,379,5,1,4,2,1
15,400,400,24,24,0,1,0
14,414,414,67,29,38,3,2
11,434,434,92,69,23,2,1
2,439,439,22,18,4,2,1
13,481,481,25,25,0,1,0

2,139,139,54,26,28,2,1
1,195,195,28,15,13,2,1
3,242,242,14,14,0,1,0
6,245,245,2,2,0,1,0
8,252,252,11,11,0,1,0
5,278,278,12,2,10,2,1
0,358,358,5,5,0,1,0
7,414,414,129,63,66,3,2
4,427,427,19,19,0,1,0
9,454,454,74,29,45,4,3

8,187,187,13,13,0,1,0
4,209,209,7,1,6,2,1
7,258,258,59,53,6,3,2
1,279,279,11,4,7,2,1
9,292,292,39,39,0,1,0
3,358,358,4,4,0,1,0
5,367,367,80,51,29,2,1
11,371,371,36,18,18,3,2
12,373,373,30,18,12,3,2
0,390,390,89,59,30,4,3
10,424,424,2,2,0,1,0
2,438,438,10,10,0,1,0
6,485,485,23,23,0,1,0

2,104,104,2,2,0,1,0
8,181,181,61,46,15,2,1
7,182,182,16,7,9,4,3
5,225,225,2,2,0,1,0
12,234,234,12,12,0,1,0
3,246,246,18,14,4,2,1
11,327,327,7,7,0,1,0
10,357,357,14,14,0,1,0
1,395,395,8,8,0,1,0
4,412,412,95,2,93,4,3
0,418,418,1,1,0,1,0
6,461,461,114,30,84,4,3
9,463,463,34,34,0,1,0

7,115,115,2,2,0,1,0
4,164,164,15,15,0,1,0
2,167,167,20,4,16,3,2
5,257,257,56,56,0,1,0
8,309,309,54,54,0,1,0
1,343,343,7,7,0,1,0
3,381,381,47,38,9,4,3
0,384,384,1,1,0,1,0
9,437,437,41,41,0,1,0
11,449,449,3,3,0,1,0
12,452,452,24,13,11,2,1
6,474,474,6,6,0,1,0
10,497,497,126,126,0,1,0
13,498,498,11,11,0,1,0

3,113,113,9,9,0,1,0
9,136,136,12,4,8,2,1
10,141,141,23,10,13,2,1
4,222,222,11,11,0,1,0
1,244,244,25,25,0,1,0
6,339,339,70,33,37,2,1
0,342,342,9,1,8,2,1
2,396,396,27,27,0,1,0
8,415,415,45,45,0,1,0
7,448,448,19,10,9,2,1
5,454,454,125,77,48,3,2
11,459,459,1,1,0,1,0

7,187,187,20,20,0,1,0
0,222,222,26,10,16,3,2
3,241,241,18,6,12,3,2
6,251,251,40,11,29,2,1
8,298,298,48,48,0,1,0
4,376,376,11,11,0,1,0
1,416,416,113,113,0,1,0
5,419,419,34,28,6,2,1
2,443,443,94,7,87,4,3

5,103,103,23,23,0,1,0
8,139,139,5,1,4,2,1
10,149,149,4,4,0,1,0
6,216,216,11,6,5,2,1
3,252,252,24,12,12,2,1
9,307,307,14,14,0,1,0
0,388,388,1,1,0,1,0
1,395,395,39,28,11,2,1
2,396,396,157,22,135,4,3
7,443,443,104,71,33,4,3
4,458,458,4,4,0,1,0

3,141,141,41,2,39,2,1
9,183,183,27,18,9,4,3
10,234,234,27,16,11,2,1
2,269,269,8,8,0,1,0
6,281,281,62,62,0,1,0
7,340,340,1,1,0,1,0
8,345,345,18,18,0,1,0
4,347,347,5,5,0,1,0
5,376,376,27,12,15,4,3
0,423,423,44,32,12,3,2
1,475,475,77,77,0,1,0

4,146,146,42,42,0,1,0
1,177,177,29,14,15,4,3
6,207,207,32,32,0,1,0
7,211,211,11,11,0,1,0
9,235,235,19,4,15,2,1
5,283,283,4,4,0,1,0
2,328,328,108,72,36,3,2
0,356,356,13,13,0,1,0
3,411,411,29,29,0,1,0
8,444,444,10,10,0,1,0

13,118,118,4,4,0,1,0
2,127,127,15,15,0,1,0
6,130,130,20,5,15,4,3
7,196,196,12,6,6,2,1
10,299,299,51,31,20,3,2
5,305,305,14,5,9,2,1
1,328,328,10,1,9,2,1
12,328,328,61,20,41,2,1
9,365,365,73,19,54,3,2
0,368,368,42,42,0,1,0
4,382,382,1,1,0,1,0
8,413,413,5,5,0,1,0
3,458,458,36,36,0,1,0
11,491,491,4,4,0,1,0

7,133,133,6,3,3,2,1
8,166,166,11,11,0,1,0
10,167,167,15,9,6,2,1
5,236,236,15,3,12,2,1
2,268,268,1,1,0,1,0
9,287,287,19,19,0,1,0
6,289,289,6,6,0,1,0
14,292,292,38,1,37,2,1
12,302,302,62,16,46,2,1
3,384,384,30,30,0,1,0
4,385,385,85,85,0,1,0
0,390,390,28,16,12,3,2
13,397,397,27,17,10,2,1
1,420,420,14,14,0,1,0
11,461,461,23,23,0,1,0

0,203,203,28,16,12,2,1
8,203,203,40,40,0,1,0
5,228,228,10,10,0,1,0
1,237,237,4,4,0,1,0
10,240,240,23,13,10,2,1
9,251,251,38,38,0,1,0
2,265,265,1,1,0,1,0
12,312,312,24,6,18,4,3
3,367,367,13,13,0,1,0
11,380,380,12,12,0,1,0
6,414,414,13,13,0,1,0
4,443,443,38,38,0,1,0
13,473,473,28,28,0,1,0
7,488,488,120,1,119,4,3

5,115,115,19,3,16,2,1
3,127,127,22,22,0,1,0
9,131,131,9,3,6,3,2
4,204,204,14,14,0,1,0
2,240,240,1,1,0,1,0
8,242,242,20,1,19,3,2
1,330,330,17,17,0,1,0
0,388,388,118,118,0,1,0
6,400,400,32,3,29,2,1
7,458,458,76,36,40,2,1
10,471,471,23,1,22,4,3

4,108,108,5,5,0,1,0
5,227,227,62,62,0,1,0
3,243,243,4,4,0,1,0
0,257,257,50,50,0,1,0
6,274,274,7,7,0,1,0
7,344,344,80,1,79,4,3
8,429,429,8,8,0,1,0
1,466,466,98,69,29,2,1
2,486,486,95,95,0,1,0

7,119,119,5,2,3,2,1
14,142,142,14,14,0,1,0
4,169,169,3,3,0,1,0
3,175,175,3,3,0,1,0
12,177,177,2,2,0,1,0
8,219,219,10,10,0,1,0
6,271,271,38,38,0,1,0
5,328,328,14,14,0,1,0
13,360,360,17,17,0,1,0
9,387,387,49,36,13,2,1
1,388,388,59,18,41,2,1
2,423,423,23,23,0,1,0
11,443,443,38,38,0,1,0
10,459,459,111,32,79,3,2
0,465,465,43,43,0,1,0

6,131,131,1,1,0,1,0
13,141,141,20,20,0,1,0
9,154,154,23,6,17,2,1
11,171,171,8,8,0,1,0
7,177,177,22,2,20,3,2
5,197,197,17,6,11,2,1
0,220,220,1,1,0,1,0
12,231,231,5,5,0,1,0
2,356,356,31,16,15,4,3
14,359,359,28,28,0,1,0
8,362,362,46,46,0,1,0
1,369,369,26,8,18,3,2
3,391,391,4,4,0,1,0
4,405,405,34,24,10,3,2
10,493,493,86,18,68,3,2

4,134,134,22,15,7,2,1
2,136,136,14,14,0,1,0
1,209,209,27,1,26,3,2
5,210,210,17,9,8,2,1
0,243,243,69,9,60,3,2
6,304,304,32,14,18,2,1
3,317,317,27,6,21,3,2
7,352,352,58,58,0,1,0
9,377,377,33,22,11,2,1
8,447,447,7,1,6,3,2

4,109,109,13,13,0,1,0
2,154,154,1,1,0,1,0
15,165,165,6,6,0,1,0
5,203,203,4,4,0,1,0
8,206,206,1,1,0,1,0
13,221,221,34,34,0,1,0
1,272,272,7,1,6,3,2
12,273,273,13,1,12,2,1
14,276,276,11,11,0,1,0
9,293,293,35,20,15,2,1
11,383,383,110,74,36,4,3
10,408,408,20,20,0,1,0
0,413,413,13,13,0,1,0
6,418,418,24,24,0,1,0
7,485,485,21,21,0,1,0
3,486,486,85,85,0,1,0

3,105,105,6,3,3,2,1
8,205,205,8,8,0,1,0
13,214,214,1,1,0,1,0
0,225,225,9,4,5,2,1
2,232,232,28,16,12,2,1
11,259,259,50,50,0,1,0
5,326,326,6,1,5,2,1
10,341,341,97,97,0,1,0
1,363,363,48,48,0,1,0
4,371,371,41,41,0,1,0
12,380,380,8,8,0,1,0
7,388,388,39,39,0,1,0
6,433,433,9,4,5,2,1
9,463,463,32,26,6,2,1

1,129,129,1,1,0,1,0
3,159,159,3,3,0,1,0
7,164,164,8,8,0,1,0
5,210,210,55,3,52,4,3
2,212,212,25,11,14,3,2
8,263,263,17,11,6,3,2
10,282,282,82,82,0,1,0
13,313,313,10,4,6,2,1
11,314,314,2,2,0,1,0
0,337,337,18,18,0,1,0
6,367,367,25,25,0,1,0
9,384,384,13,13,0,1,0
4,412,412,11,11,0,1,0
12,487,487,87,35,52,4,3

14,121,121,40,8,32,3,2
8,138,138,13,7,6,2,1
2,186,186,5,5,0,1,0
5,202,202,44,44,0,1,0
1,203,203,4,4,0,1,0
12,224,224,2,2,0,1,0
6,247,247,19,2,17,4,3
3,286,286,3,3,0,1,0
10,322,322,51,43,8,2,1
9,331,331,7,7,0,1,0
13,348,348,2,2,0,1,0
15,385,385,40,40,0,1,0
0,386,386,15,15,0,1,0
7,390,390,26,10,16,2,1
11,432,432,4,4,0,1,0
4,465,465,14,14,0,1,0

8,136,136,20,14,6,3,2
0,137,137,1,1,0,1,0
9,184,184,11,11,0,1,0
5,212,212,59,17,42,3,2
4,314,314,9,9,0,1,0
10,333,333,64,64,0,1,0
11,367,367,20,2,18,4,3
3,372,372,26,2,24,2,1
2,403,403,38,38,0,1,0
6,419,419,44,30,14,2,1
7,465,465,24,24,0,1,0
1,480,480,60,60,0,1,0

9,171,171,17,8,9,4,3
13,183,183,34,8,26,3,2
8,217,217,22,22,0,1,0
1,235,235,7,7,0,1,0
5,243,243,7,7,0,1,0
14,250,250,21,21,0,1,0
0,306,306,9,9,0,1,0
10,340,340,44,34,10,2,1
3,371,371,85,85,0,1,0
12,385,385,22,22,0,1,0
4,403,403,23,4,19,2,1
2,420,420,29,11,18,4,3
11,461,461,27,6,21,2,1
7,475,475,10,4,6,2,1
6,491,491,17,1,16,3,2

0,177,177,52,52,0,1,0
7,188,188,21,21,0,1,0
1,207,207,19,6,13,2,1
2,242,242,18,18,0,1,0
9,259,259,50,50,0,1,0
4,297,297,6,6,0,1,0
8,325,325,20,20,0,1,0
10,335,335,42,26,16,2,1
6,349,349,8,8,0,1,0
5,416,416,38,38,0,1,0
3,488,488,60,60,0,1,0

10,103,103,23,8,15,4,3
8,113,113,14,10,4,2,1
0,224,224,4,4,0,1,0
7,284,284,2,2,0,1,0
9,342,342,11,2,9,4,3
5,354,354,35,35,0,1,0
1,370,370,70,21,49,2,1
2,411,411,41,15,26,2,1
3,419,419,114,114,0,1,0
6,463,463,61,61,0,1,0
4,484,484,11,11,0,1,0

11,210,210,4,4,0,1,0
2,218,218,38,1,37,2,1
9,231,231,15,15,0,1,0
5,254,254,3,3,0,1,0
3,267,267,24,24,0,1,0
10,277,277,93,39,54,4,3
8,295,295,7,7,0,1,0
12,308,308,28,28,0,1,0
4,337,337,50,11,39,2,1
6,358,358,11,11,0,1,0
7,368,368,27,27,0,1,0
0,411,411,54,33,21,2,1
1,464,464,7,1,6,3,2

9,114,114,2,2,0,1,0
5,121,121,8,5,3,2,1
10,147,147,16,16,0,1,0
6,149,149,10,2,8,3,2
11,157,157,3,3,0,1,0
4,168,168,1,1,0,1,0
12,188,188,29,29,0,1,0
1,210,210,1,1,0,1,0
8,294,294,61,49,12,4,3
7,392,392,44,6,38,3,2
0,393,393,76,34,42,3,2
2,445,445,4,4,0,1,0
3,477,477,123,123,0,1,0

1,112,112,31,27,4,2,1
7,178,178,17,9,8,3,2
2,186,186,20,20,0,1,0
4,239,239,12,12,0,1,0
8,312,312,14,14,0,1,0
5,322,322,121,85,36,4,3
6,324,324,12,12,0,1,0
9,356,356,2,2,0,1,0
10,387,387,20,20,0,1,0
0,406,406,44,22,22,3,2
3,415,415,24,16,8,3,2

0,101,101,10,2,8,3,2
11,116,116,2,2,0,1,0
5,120,120,22,2,20,3,2
7,144,144,19,19,0,1,0
8,204,204,26,5,21,4,3
2,219,219,1,1,0,1,0
3,235,235,4,4,0,1,0
6,397,397,44,44,0,1,0
10,447,447,8,8,0,1,0
4,455,455,68,34,34,3,2
9,465,465,95,51,44,2,1
1,499,499,75,11,64,4,3

0,182,182,42,42,0,1,0
8,240,240,15,15,0,1,0
2,254,254,39,39,0,1,0
1,282,282,61,23,38,2,1
4,323,323,9,9,0,1,0
7,332,332,17,11,6,2,1
5,342,342,126,84,42,4,3
3,448,448,1,1,0,1,0
6,463,463,45,11,34,3,2

3,100,100,21,1,20,2,1
0,200,200,43,43,0,1,0
10,239,239,9,9,0,1,0
7,310,310,24,24,0,1,0
5,313,313,45,23,22,3,2
8,338,338,72,41,31,2,1
1,358,358,24,9,15,4,3
6,359,359,44,20,24,2,1
2,421,421,36,36,0,1,0
4,428,428,10,2,8,3,2
9,471,471,6,6,0,1,0

2,130,130,1,1,0,1,0
10,132,132,1,1,0,1,0
7,152,152,37,37,0,1,0
4,196,196,2,2,0,1,0
8,203,203,22,22,0,1,0
12,238,238,24,24,0,1,0
1,314,314,3,3,0,1,0
11,344,344,33,27,6,3,2
3,406,406,98,56,42,4,3
0,429,429,80,71,9,4,3
9,464,464,26,6,20,2,1
6,477,477,50,50,0,1,0
5,484,484,20,20,0,1,0

7,103,103,7,7,0,1,0
3,127,127,5,5,0,1,0
11,147,147,57,42,15,2,1
4,218,218,31,31,0,1,0
10,258,258,1,1,0,1,0
8,260,260,12,6,6,3,2
9,275,275,11,3,8,2,1
2,285,285,56,56,0,1,0
1,321,321,4,4,0,1,0
6,419,419,29,29,0,1,0
5,430,430,3,3,0,1,0
0,477,477,97,97,0,1,0

0,112,112,1,1,0,1,0
3,112,112,13,13,0,1,0
2,185,185,27,18,9,2,1
10,241,241,11,11,0,1,0
5,264,264,16,16,0,1,0
9,359,359,3,3,0,1,0
4,422,422,135,10,125,4,3
1,437,437,5,5,0,1,0
6,451,451,71,34,37,2,1
8,474,474,7,7,0,1,0
7,497,497,160,76,84,4,3

2,176,176,88,88,0,1,0
3,200,200,53,53,0,1,0
5,223,223,12,12,0,1,0
6,312,312,26,26,0,1,0
1,334,334,13,5,8,3,2
4,334,334,43,43,0,1,0
8,390,390,9,6,3,2,1
0,455,455,29,17,12,2,1
7,496,496,28,28,0,1,0

0,103,103,9,4,5,2,1
2,121,121,11,1,10,2,1
4,156,156,7,2,5,2,1
12,185,185,5,5,0,1,0
10,197,197,40,40,0,1,0
1,202,202,2,2,0,1,0
11,217,217,25,5,20,2,1
6,267,267,40,40,0,1,0
3,280,280,57,57,0,1,0
7,285,285,14,1,13,4,3
5,313,313,5,5,0,1,0
9,446,446,14,14,0,1,0
8,484,484,91,91,0,1,0

13,174,174,30,30,0,1,0
7,179,179,15,15,0,1,0
3,200,200,9,9,0,1,0
6,208,208,16,12,4,2,1
11,213,213,15,6,9,4,3
12,219,219,16,1,15,2,1
1,334,334,23,14,9,4,3
8,347,347,8,1,7,2,1
2,349,349,51,51,0,1,0
9,403,403,31,1,30,3,2
10,416,416,81,81,0,1,0
0,459,459,30,30,0,1,0
5,485,485,45,45,0,1,0
4,491,491,12,12,0,1,0

2,122,122,4,4,0,1,0
8,261,261,39,10,29,2,1
7,275,275,15,15,0,1,0
0,306,306,64,1,63,4,3
1,330,330,48,48,0,1,0
10,331,331,24,9,15,4,3
11,341,341,7,2,5,2,1
3,350,350,21,21,0,1,0
9,354,354,97,97,0,1,0
6,386,386,16,16,0,1,0
5,457,457,63,20,43,3,2
4,470,470,7,2,5,2,1

4,101,101,2,2,0,1,0
0,114,114,20,20,0,1,0
10,124,124,12,12,0,1,0
12,226,226,74,59,15,4,3
5,241,241,24,24,0,1,0
3,242,242,1,1,0,1,0
11,272,272,2,2,0,1,0
9,301,301,4,4,0,1,0
6,353,353,1,1,0,1,0
8,360,360,52,34,18,4,3
1,461,461,17,17,0,1,0
7,467,467,10,10,0,1,0
2,497,497,131,131,0,1,0

2,152,152,2,2,0,1,0
5,169,169,7,7,0,1,0
0,192,192,102,61,41,4,3
7,201,201,28,28,0,1,0
11,221,221,7,3,4,2,1
9,249,249,28,14,14,3,2
6,254,254,33,33,0,1,0
3,264,264,1,1,0,1,0
8,316,316,36,15,21,4,3
10,444,444,35,12,23,2,1
4,460,460,2,2,0,1,0
1,487,487,5,5,0,1,0

13,104,104,1,1,0,1,0
2,120,120,11,3,8,2,1
10,136,136,34,10,24,2,1
12,150,150,1,1,0,1,0
8,246,246,1,1,0,1,0
0,260,260,10,1,9,3,2
3,269,269,49,3,46,2,1
6,270,270,36,18,18,4,3
9,271,271,76,76,0,1,0
4,280,280,8,2,6,3,2
11,297,297,9,5,4,2,1
7,354,354,21,9,12,2,1
5,374,374,4,4,0,1,0
1,438,438,23,8,15,4,3
14,455,455,18,18,0,1,0

4,126,126,13,13,0,1,0
5,169,169,12,12,0,1,0
8,218,218,55,55,0,1,0
3,234,234,1,1,0,1,0
6,290,290,36,36,0,1,0
7,314,314,2,2,0,1,0
9,377,377,15,15,0,1,0
2,385,385,38,26,12,4,3
0,389,389,64,10,54,3,2
10,430,430,49,13,36,3,2
1,453,453,104,25,79,4,3

1,112,112,3,3,0,1,0
2,172,172,40,2,38,3,2
10,172,172,3,3,0,1,0
5,249,249,9,6,3,2,1
8,292,292,22,7,15,2,1
0,300,300,15,15,0,1,0
7,312,312,17,17,0,1,0
4,321,321,51,36,15,4,3
3,359,359,35,23,12,4,3
6,441,441,4,4,0,1,0
9,457,457,128,80,48,4,3
11,481,481,84,6,78,3,2

8,124,124,41,41,0,1,0
11,135,135,16,16,0,1,0
1,158,158,5,5,0,1,0
0,172,172,1,1,0,1,0
3,183,183,8,8,0,1,0
12,235,235,6,6,0,1,0
13,235,235,30,11,19,2,1
2,245,245,9,4,5,2,1
5,260,260,4,4,0,1,0
10,285,285,1,1,0,1,0
9,350,350,3,3,0,1,0
4,395,395,116,116,0,1,0
6,432,432,12,12,0,1,0
7,475,475,69,33,36,3,2

6,142,142,7,7,0,1,0
2,217,217,5,5,0,1,0
11,251,251,33,12,21,2,1
7,270,270,24,24,0,1,0
1,274,274,1,1,0,1,0
5,284,284,53,46,7,2,1
9,346,346,40,6,34,2,1
4,363,363,79,79,0,1,0
0,380,380,39,39,0,1,0
8,423,423,87,17,70,3,2
10,438,438,9,3,6,2,1
3,465,465,31,1,30,2,1

7,105,105,8,8,0,1,0
12,169,169,4,4,0,1,0
11,192,192,24,24,0,1,0
10,244,244,35,35,0,1,0
6,246,246,13,13,0,1,0
0,262,262,42,33,9,4,3
8,262,262,1,1,0,1,0
2,285,285,41,41,0,1,0
4,321,321,4,4,0,1,0
1,403,403,56,56,0,1,0
3,417,417,6,1,5,2,1
9,435,435,12,12,0,1,0
13,437,437,126,82,44,3,2
5,455,455,3,3,0,1,0

7,137,137,2,2,0,1,0
9,168,168,59,15,44,3,2
4,170,170,1,1,0,1,0
0,185,185,3,3,0,1,0
3,262,262,48,15,33,2,1
11,292,292,1,1,0,1,0
10,327,327,45,45,0,1,0
6,337,337,6,6,0,1,0
1,341,341,24,16,8,3,2
12,372,372,31,13,18,2,1
2,378,378,54,54,0,1,0
5,429,429,71,71,0,1,0
8,445,445,9,4,5,2,1

11,109,109,1,1,0,1,0
7,121,121,2,2,0,1,0
8,183,183,70,41,29,2,1
5,197,197,85,68,17,4,3
9,234,234,26,14,12,4,3
4,237,237,1,1,0,1,0
1,282,282,2,2,0,1,0
3,330,330,4,1,3,2,1
10,336,336,32,24,8,2,1
0,360,360,45,8,37,4,3
6,361,361,3,3,0,1,0
2,397,397,8,3,5,2,1

2,147,147,21,17,4,2,1
5,214,214,4,4,0,1,0
7,303,303,55,55,0,1,0
6,336,336,22,7,15,4,3
8,359,359,25,7,18,4,3
1,409,409,108,108,0,1,0
9,426,426,7,1,6,3,2
0,430,430,3,3,0,1,0
3,435,435,56,26,30,2,1
4,452,452,26,26,0,1,0
10,454,454,117,27,90,4,3

3,147,147,9,1,8,2,1
5,152,152,9,4,5,2,1
4,220,220,23,5,18,2,1
0,233,233,36,36,0,1,0
8,273,273,83,40,43,2,1
1,343,343,94,27,67,3,2
7,357,357,22,13,9,4,3
2,379,379,65,11,54,4,3
6,427,427,8,8,0,1,0

1,101,101,1,1,0,1,0
6,125,125,19,19,0,1,0
3,142,142,2,2,0,1,0
10,156,156,33,23,10,3,2
4,162,162,3,3,0,1,0
13,200,200,1,1,0,1,0
8,203,203,12,12,0,1,0
14,203,203,40,40,0,1,0
15,268,268,9,9,0,1,0
5,276,276,5,5,0,1,0
0,299,299,19,14,5,2,1
11,356,356,52,52,0,1,0
2,381,381,41,41,0,1,0
9,392,392,46,46,0,1,0
7,409,409,17,17,0,1,0
12,425,425,7,7,0,1,0

7,131,131,1,1,0,1,0
10,147,147,14,14,0,1,0
4,148,148,4,4,0,1,0
11,165,165,5,2,3,2,1
2,209,209,22,13,9,4,3
6,231,231,17,17,0,1,0
9,271,271,5,5,0,1,0
1,280,280,15,5,10,2,1
8,320,320,6,6,0,1,0
5,366,366,96,13,83,4,3
3,367,367,13,13,0,1,0
12,379,379,19,19,0,1,0
0,420,420,15,15,0,1,0
13,475,475,186,120,66,4,3

11,110,110,4,1,3,2,1
5,111,111,8,8,0,1,0
7,112,112,1,1,0,1,0
6,139,139,2,2,0,1,0
0,200,200,36,14,22,3,2
14,241,241,3,3,0,1,0
8,305,305,33,33,0,1,0
13,321,321,38,38,0,1,0
10,344,344,34,17,17,2,1
3,386,386,7,7,0,1,0
2,402,402,30,11,19,2,1
12,420,420,65,65,0,1,0
1,428,428,17,5,12,4,3
4,439,439,38,38,0,1,0
9,459,459,90,90,0,1,0

8,133,133,2,2,0,1,0
0,161,161,51,6,45,2,1
5,263,263,1,1,0,1,0
11,271,271,4,4,0,1,0
4,274,274,24,10,14,3,2
6,291,291,23,23,0,1,0
10,291,291,15,12,3,2,1
3,348,348,13,13,0,1,0
1,361,361,1,1,0,1,0
9,414,414,123,97,26,3,2
2,433,433,67,21,46,4,3
7,468,468,69,26,43,4,3

14,118,118,18,12,6,3,2
9,143,143,17,17,0,1,0
11,175,175,5,1,4,2,1
16,175,175,18,7,11,2,1
10,181,181,8,8,0,1,0
3,221,221,4,4,0,1,0
5,246,246,9,9,0,1,0
13,283,283,2,2,0,1,0
17,346,346,7,7,0,1,0
4,356,356,9,9,0,1,0
1,364,364,12,2,10,2,1
12,365,365,71,71,0,1,0
15,405,405,56,56,0,1,0
7,413,413,60,8,52,3,2
8,436,436,8,2,6,3,2
0,436,436,5,2,3,2,1
6,441,441,34,1,33,4,3
2,461,461,20,20,0,1,0

9,154,154,56,4,52,3,2
8,174,174,19,19,0,1,0
11,193,193,3,3,0,1,0
1,198,198,21,21,0,1,0
6,240,240,7,1,6,2,1
4,255,255,8,2,6,2,1
2,265,265,17,5,12,4,3
10,268,268,1,1,0,1,0
7,269,269,25,12,13,2,1
0,304,304,61,21,40,4,3
3,328,328,64,64,0,1,0
5,414,414,2,2,0,1,0

15,112,112,1,1,0,1,0
13,130,130,38,11,27,4,3
3,154,154,4,4,0,1,0
6,158,158,5,1,4,2,1
16,162,162,11,11,0,1,0
4,204,204,4,4,0,1,0
11,218,218,10,10,0,1,0
0,223,223,12,12,0,1,0
1,253,253,5,5,0,1,0
10,357,357,3,3,0,1,0
2,372,372,78,42,36,2,1
7,380,380,2,2,0,1,0
9,389,389,1,1,0,1,0
5,431,431,96,80,16,2,1
14,454,454,9,9,0,1,0
12,458,458,83,19,64,3,2
8,464,464,1,1,0,1,0

1,102,102,21,21,0,1,0
3,103,103,1,1,0,1,0
4,105,105,2,2,0,1,0
8,109,109,29,29,0,1,0
13,124,124,4,4,0,1,0
2,235,235,34,2,32,3,2
7,280,280,22,8,14,2,1
10,323,323,58,19,39,2,1
0,325,325,1,1,0,1,0
5,418,418,35,35,0,1,0
9,424,424,16,16,0,1,0
6,459,459,27,27,0,1,0
12,496,496,19,11,8,2,1
11,499,499,28,6,22,2,1

0,104,104,1,1,0,1,0
3,112,112,18,18,0,1,0
9,136,136,1,1,0,1,0
12,152,152,7,1,6,3,2
11,161,161,55,2,53,4,3
5,167,167,13,13,0,1,0
8,169,169,19,19,0,1,0
7,211,211,18,18,0,1,0
6,234,234,15,15,0,1,0
2,244,244,11,3,8,2,1
10,267,267,8,8,0,1,0
1,422,422,67,15,52,3,2
4,426,426,37,37,0,1,0

12,113,113,13,13,0,1,0
1,148,148,1,1,0,1,0
10,155,155,4,4,0,1,0
11,179,179,23,8,15,4,3
3,316,316,31,7,24,3,2
4,323,323,45,34,11,4,3
13,360,360,56,56,0,1,0
2,374,374,34,12,22,2,1
7,407,407,40,40,0,1,0
8,413,413,6,6,0,1,0
5,425,425,1,1,0,1,0
9,431,431,76,47,29,3,2
6,446,446,25,5,20,3,2
0,472,472,52,52,0,1,0

4,207,207,11,11,0,1,0
1,293,293,22,4,18,4,3
5,293,293,52,8,44,4,3
7,323,323,73,49,24,2,1
8,324,324,34,10,24,4,3
11,341,341,18,18,0,1,0
12,344,344,21,3,18,4,3
10,361,361,10,5,5,2,1
6,368,368,5,5,0,1,0
3,369,369,102,102,0,1,0
2,393,393,1,1,0,1,0
0,407,407,1,1,0,1,0
9,456,456,63,63,0,1,0

3,197,197,19,19,0,1,0
2,259,259,20,20,0,1,0
4,296,296,20,20,0,1,0
5,300,300,86,23,63,4,3
7,308,308,2,2,0,1,0
6,368,368,23,5,18,4,3
8,372,372,35,35,0,1,0
1,383,383,118,86,32,3,2
0,426,426,93,55,38,2,1

13,101,101,23,23,0,1,0
9,144,144,7,7,0,1,0
12,160,160,9,9,0,1,0
3,191,191,4,4,0,1,0
4,198,198,3,3,0,1,0
1,202,202,1,1,0,1,0
10,260,260,35,35,0,1,0
14,271,271,27,27,0,1,0
8,276,276,24,24,0,1,0
2,278,278,10,3,7,2,1
6,302,302,102,46,56,4,3
5,307,307,25,5,20,4,3
0,317,317,1,1,0,1,0
7,479,479,8,5,3,2,1
11,492,492,25,25,0,1,0

4,190,190,7,7,0,1,0
11,229,229,8,8,0,1,0
0,232,232,36,7,29,2,1
5,232,232,8,8,0,1,0
8,248,248,12,12,0,1,0
9,271,271,17,17,0,1,0
3,288,288,10,10,0,1,0
6,294,294,22,22,0,1,0
1,341,341,12,8,4,2,1
7,369,369,84,55,29,3,2
12,375,375,24,7,17,3,2
2,400,400,1,1,0,1,0
13,417,417,34,34,0,1,0
10,421,421,134,82,52,3,2

4,124,124,24,24,0,1,0
3,150,150,22,12,10,3,2
5,150,150,14,2,12,3,2
11,198,198,64,25,39,2,1
6,232,232,13,3,10,2,1
2,240,240,16,16,0,1,0
8,260,260,3,3,0,1,0
9,333,333,17,17,0,1,0
10,345,345,15,15,0,1,0
1,363,363,25,16,9,2,1
0,383,383,13,13,0,1,0
7,470,470,57,57,0,1,0

13,104,104,24,24,0,1,0
8,120,120,2,2,0,1,0
9,121,121,2,2,0,1,0
7,126,126,16,16,0,1,0
3,150,150,16,7,9,4,3
6,240,240,41,18,23,2,1
5,275,275,9,3,6,3,2
11,335,335,92,71,21,2,1
4,403,403,13,8,5,2,1
2,435,435,24,24,0,1,0
12,437,437,12,12,0,1,0
1,444,444,1,1,0,1,0
10,468,468,27,27,0,1,0
0,485,485,36,36,0,1,0

9,105,105,5,5,0,1,0
3,151,151,7,1,6,3,2
11,216,216,49,49,0,1,0
4,224,224,1,1,0,1,0
8,242,242,12,3,9,2,1
7,249,249,3,3,0,1,0
0,268,268,5,5,0,1,0
1,383,383,83,83,0,1,0
5,391,391,23,23,0,1,0
10,442,442,63,35,28,2,1
6,472,472,64,17,47,4,3
2,490,490,125,125,0,1,0

11,102,102,5,5,0,1,0
3,105,105,3,3,0,1,0
5,158,158,7,7,0,1,0
8,163,163,25,8,17,2,1
2,180,180,36,36,0,1,0
7,200,200,36,36,0,1,0
4,211,211,23,13,10,2,1
9,214,214,27,21,6,2,1
12,233,233,16,16,0,1,0
1,245,245,32,32,0,1,0
0,261,261,15,15,0,1,0
6,265,265,8,8,0,1,0
10,447,447,20,12,8,3,2

7,113,113,10,5,5,2,1
5,122,122,10,10,0,1,0
3,137,137,5,5,0,1,0
9,178,178,2,2,0,1,0
10,212,212,31,31,0,1,0
0,224,224,19,19,0,1,0
14,234,234,62,62,0,1,0
13,275,275,30,30,0,1,0
8,328,328,38,38,0,1,0
2,410,410,23,23,0,1,0
4,436,436,23,23,0,1,0
1,453,453,12,6,6,2,1
6,455,455,26,26,0,1,0
12,476,476,22,22,0,1,0
11,496,496,16,10,6,2,1

9,121,121,1,1,0,1,0
3,139,139,53,53,0,1,0
8,144,144,2,2,0,1,0
12,161,161,33,33,0,1,0
10,175,175,10,10,0,1,0
7,208,208,10,10,0,1,0
2,270,270,4,4,0,1,0
13,291,291,32,14,18,3,2
15,324,324,18,18,0,1,0
1,352,352,7,7,0,1,0
5,363,363,5,5,0,1,0
11,431,431,13,13,0,1,0
14,432,432,68,14,54,4,3
6,442,442,2,2,0,1,0
0,454,454,35,11,24,4,3
4,464,464,9,9,0,1,0

2,114,114,5,2,3,2,1
0,130,130,9,9,0,1,0
4,168,168,3,3,0,1,0
1,219,219,46,16,30,3,2
5,253,253,7,7,0,1,0
6,323,323,60,36,24,3,2
8,338,338,44,33,11,2,1
12,352,352,13,13,0,1,0
9,387,387,7,7,0,1,0
3,389,389,18,4,14,2,1
10,420,420,135,85,50,4,3
7,499,499,50,50,0,1,0
11,499,499,1,1,0,1,0

8,109,109,4,4,0,1,0
5,112,112,2,2,0,1,0
10,153,153,26,5,21,2,1
2,158,158,2,2,0,1,0
7,183,183,34,29,5,2,1
9,215,215,1,1,0,1,0
6,285,285,58,58,0,1,0
3,359,359,71,7,64,3,2
1,374,374,5,5,0,1,0
4,446,446,10,10,0,1,0
0,453,453,161,11,150,4,3

14,120,120,13,3,10,4,3
13,145,145,1,1,0,1,0
2,193,193,1,1,0,1,0
7,229,229,28,28,0,1,0
0,231,231,3,3,0,1,0
4,237,237,23,14,9,4,3
8,305,305,29,29,0,1,0
1,351,351,48,21,27,2,1
6,368,368,7,7,0,1,0
9,368,368,28,1,27,4,3
10,389,389,68,68,0,1,0
15,389,389,10,10,0,1,0
5,401,401,4,4,0,1,0
12,433,433,115,110,5,2,1
3,438,438,12,12,0,1,0
11,496,496,12,6,6,2,1

2,123,123,7,1,6,3,2
11,140,140,14,14,0,1,0
5,143,143,24,24,0,1,0
7,144,144,1,1,0,1,0
13,178,178,12,12,0,1,0
10,179,179,12,3,9,4,3
3,183,183,5,5,0,1,0
12,191,191,41,41,0,1,0
9,327,327,3,3,0,1,0
4,334,334,22,22,0,1,0
1,432,432,50,6,44,2,1
8,443,443,71,21,50,2,1
0,481,481,32,32,0,1,0
6,492,492,49,35,14,3,2

0,114,114,6,6,0,1,0
12,153,153,13,1,12,3,2
2,156,156,4,1,3,2,1
9,162,162,6,6,0,1,0
1,177,177,11,11,0,1,0
5,185,185,24,24,0,1,0
3,198,198,17,17,0,1,0
6,215,215,3,3,0,1,0
7,246,246,8,8,0,1,0
10,261,261,39,39,0,1,0
8,267,267,17,5,12,4,3
13,285,285,82,45,37,4,3
14,349,349,4,4,0,1,0
4,371,371,51,6,45,2,1
11,497,497,20,2,18,4,3

4,121,121,2,2,0,1,0
5,140,140,7,7,0,1,0
6,190,190,6,6,0,1,0
7,297,297,109,103,6,3,2
8,348,348,24,24,0,1,0
3,364,364,3,3,0,1,0
1,378,378,42,16,26,3,2
9,420,420,33,23,10,2,1
0,463,463,150,150,0,1,0
2,478,478,76,58,18,3,2

1,124,124,13,13,0,1,0
8,124,124,9,9,0,1,0
5,263,263,5,5,0,1,0
6,301,301,17,1,16,3,2
9,308,308,89,49,40,2,1
3,337,337,16,6,10,2,1
2,341,341,1,1,0,1,0
11,346,346,6,2,4,2,1
0,382,382,10,1,9,2,1
12,412,412,19,19,0,1,0
4,439,439,152,16,136,4,3
10,466,466,51,51,0,1,0
7,472,472,35,26,9,4,3

3,122,122,1,1,0,1,0
13,140,140,1,1,0,1,0
4,150,150,10,4,6,3,2
11,158,158,58,33,25,2,1
6,196,196,1,1,0,1,0
0,220,220,40,40,0,1,0
10,233,233,14,6,8,2,1
7,270,270,7,7,0,1,0
12,274,274,32,13,19,2,1
9,287,287,2,2,0,1,0
15,289,289,11,1,10,2,1
5,322,322,1,1,0,1,0
16,369,369,1,1,0,1,0
8,381,381,13,13,0,1,0
2,438,438,65,65,0,1,0
1,469,469,28,3,25,2,1
14,473,473,38,38,0,1,0

11,100,100,3,3,0,1,0
10,118,118,16,16,0,1,0
6,133,133,15,2,13,2,1
1,145,145,39,39,0,1,0
2,184,184,1,1,0,1,0
5,196,196,17,17,0,1,0
4,246,246,7,7,0,1,0
8,248,248,67,67,0,1,0
0,309,309,20,20,0,1,0
12,374,374,14,14,0,1,0
7,423,423,37,7,30,2,1
9,435,435,26,5,21,2,1
3,472,472,19,19,0,1,0

12,107,107,3,3,0,1,0
13,261,261,71,71,0,1,0
2,304,304,14,14,0,1,0
11,317,317,3,3,0,1,0
5,325,325,15,15,0,1,0
1,357,357,10,10,0,1,0
7,364,364,31,9,22,3,2
4,390,390,46,46,0,1,0
8,397,397,43,43,0,1,0
0,434,434,26,12,14,2,1
10,444,444,66,47,19,4,3
3,453,453,35,7,28,3,2
6,483,483,68,18,50,3,2
9,485,485,25,21,4,2,1

2,108,108,8,8,0,1,0
3,232,232,12,12,0,1,0
7,256,256,8,1,7,2,1
1,306,306,107,19,88,3,2
0,309,309,55,40,15,4,3
6,350,350,19,1,18,2,1
8,358,358,86,4,82,4,3
4,370,370,45,31,14,2,1
5,459,459,51,51,0,1,0

5,140,140,8,8,0,1,0
9,170,170,19,16,3,2,1
10,172,172,12,3,9,4,3
12,192,192,55,8,47,2,1
1,202,202,13,13,0,1,0
13,284,284,19,19,0,1,0
2,299,299,19,19,0,1,0
6,323,323,9,9,0,1,0
4,327,327,14,14,0,1,0
14,368,368,26,10,16,3,2
3,372,372,16,16,0,1,0
7,463,463,22,9,13,2,1
0,475,475,80,80,0,1,0
11,495,495,5,5,0,1,0
8,497,497,43,7,36,2,1

9,171,171,6,3,3,2,1
0,173,173,27,27,0,1,0
2,178,178,20,7,13,2,1
5,219,219,2,2,0,1,0
3,300,300,2,2,0,1,0
8,351,351,51,24,27,2,1
6,378,378,55,16,39,4,3
7,404,404,100,38,62,3,2
10,460,460,14,14,0,1,0
4,473,473,3,3,0,1,0
1,476,476,152,152,0,1,0

6,238,238,20,15,5,2,1
0,267,267,26,26,0,1,0
1,273,273,78,78,0,1,0
8,298,298,21,21,0,1,0
4,327,327,49,5,44,3,2
5,330,330,2,2,0,1,0
7,400,400,80,80,0,1,0
3,417,417,42,10,32,2,1
2,441,441,96,56,40,3,2

12,105,105,4,4,0,1,0
11,128,128,51,7,44,2,1
6,137,137,1,1,0,1,0
5,142,142,12,2,10,2,1
0,182,182,25,25,0,1,0
1,209,209,15,3,12,3,2
3,233,233,40,26,14,3,2
7,258,258,1,1,0,1,0
15,270,270,11,11,0,1,0
9,290,290,1,1,0,1,0
10,313,313,21,21,0,1,0
8,351,351,5,5,0,1,0
4,396,396,35,14,21,4,3
2,436,436,9,1,8,2,1
13,436,436,24,24,0,1,0
14,477,477,10,10,0,1,0

4,104,104,13,13,0,1,0
5,105,105,33,3,30,2,1
7,110,110,1,1,0,1,0
0,124,124,7,7,0,1,0
1,145,145,2,2,0,1,0
2,194,194,8,8,0,1,0
3,259,259,4,4,0,1,0
8,294,294,5,2,3,2,1
13,308,308,45,28,17,2,1
10,362,362,69,26,43,2,1
12,411,411,15,3,12,4,3
6,436,436,13,13,0,1,0
11,452,452,27,27,0,1,0
9,492,492,78,44,34,3,2

10,161,161,7,1,6,2,1
9,201,201,27,18,9,2,1
4,216,216,10,1,9,2,1
0,224,224,64,4,60,3,2
2,324,324,23,23,0,1,0
7,351,351,80,62,18,3,2
5,373,373,40,40,0,1,0
3,377,377,33,12,21,4,3
8,405,405,20,11,9,2,1
6,440,440,3,3,0,1,0
11,459,459,70,40,30,2,1
1,477,477,2,2,0,1,0

3,137,137,25,20,5,2,1
0,169,169,29,29,0,1,0
6,172,172,20,20,0,1,0
1,208,208,32,32,0,1,0
10,231,231,67,27,40,3,2
2,334,334,26,26,0,1,0
8,343,343,28,10,18,3,2
5,358,358,18,9,9,2,1
7,396,396,15,2,13,3,2
9,432,432,15,7,8,2,1
4,465,465,7,1,6,2,1

13,128,128,1,1,0,1,0
15,175,175,54,54,0,1,0
4,191,191,6,6,0,1,0
2,232,232,1,1,0,1,0
11,238,238,29,29,0,1,0
9,256,256,38,38,0,1,0
8,257,257,52,52,0,1,0
1,290,290,3,3,0,1,0
14,339,339,7,7,0,1,0
12,376,376,30,30,0,1,0
0,378,378,6,3,3,2,1
10,418,418,31,31,0,1,0
5,444,444,3,3,0,1,0
3,450,450,5,5,0,1,0
7,457,457,30,30,0,1,0
6,471,471,49,5,44,4,3

7,143,143,14,14,0,1,0
6,151,151,2,2,0,1,0
11,193,193,13,13,0,1,0
4,222,222,28,14,14,3,2
12,243,243,4,4,0,1,0
2,289,289,33,16,17,2,1
8,303,303,85,53,32,3,2
9,307,307,6,6,0,1,0
3,318,318,19,19,0,1,0
0,400,400,14,14,0,1,0
1,401,401,17,17,0,1,0
10,435,435,10,10,0,1,0
5,439,439,51,3,48,2,1
13,456,456,93,63,30,3,2

5,106,106,4,4,0,1,0
6,112,112,4,4,0,1,0
4,121,121,5,5,0,1,0
10,122,122,11,3,8,3,2
13,122,122,5,5,0,1,0
1,176,176,24,24,0,1,0
14,247,247,15,15,0,1,0
3,255,255,1,1,0,1,0
8,263,263,75,75,0,1,0
2,304,304,11,11,0,1,0
7,411,411,5,5,0,1,0
12,414,414,1,1,0,1,0
11,419,419,35,35,0,1,0
0,429,429,6,6,0,1,0
9,437,437,146,72,74,4,3

4,112,112,19,16,3,2,1
5,197,197,3,3,0,1,0
2,236,236,2,2,0,1,0
9,241,241,11,11,0,1,0
11,242,242,8,8,0,1,0
1,271,271,10,10,0,1,0
7,273,273,8,2,6,3,2
6,394,394,120,63,57,4,3
3,410,410,67,5,62,3,2
8,441,441,60,60,0,1,0
0,444,444,92,92,0,1,0
10,477,477,30,30,0,1,0

3,168,168,24,24,0,1,0
2,196,196,28,28,0,1,0
10,214,214,21,5,16,4,3
9,230,230,12,4,8,2,1
5,243,243,1,1,0,1,0
11,255,255,20,4,16,3,2
4,321,321,27,27,0,1,0
1,340,340,25,25,0,1,0
7,344,344,87,87,0,1,0
8,367,367,5,5,0,1,0
0,376,376,51,51,0,1,0
12,420,420,49,49,0,1,0
6,492,492,9,6,3,2,1

14,106,106,11,11,0,1,0
12,183,183,6,6,0,1,0
6,209,209,8,8,0,1,0
11,210,210,27,17,10,2,1
9,211,211,20,20,0,1,0
3,273,273,36,14,22,3,2
1,295,295,9,9,0,1,0
7,315,315,12,12,0,1,0
5,316,316,17,17,0,1,0
0,354,354,36,3,33,4,3
15,410,410,99,99,0,1,0
8,417,417,3,3,0,1,0
10,419,419,2,2,0,1,0
2,453,453,15,1,14,2,1
4,475,475,32,32,0,1,0
13,482,482,17,17,0,1,0
16,490,490,36,6,30,2,1

9,133,133,11,11,0,1,0
2,168,168,12,12,0,1,0
5,196,196,4,4,0,1,0
6,209,209,11,11,0,1,0
15,217,217,34,10,24,4,3
10,219,219,16,7,9,4,3
17,219,219,2,2,0,1,0
11,260,260,1,1,0,1,0
8,266,266,10,10,0,1,0
16,288,288,19,14,5,2,1
18,322,322,17,14,3,2,1
3,331,331,10,3,7,2,1
13,339,339,102,74,28,3,2
7,343,343,35,25,10,2,1
12,353,353,17,17,0,1,0
0,367,367,22,22,0,1,0
14,384,384,10,7,3,2,1
1,438,438,7,7,0,1,0
4,475,475,1,1,0,1,0

12,117,117,1,1,0,1,0
11,122,122,43,7,36,3,2
2,128,128,1,1,0,1,0
4,137,137,24,24,0,1,0
8,186,186,2,2,0,1,0
6,190,190,14,2,12,3,2
1,244,244,18,9,9,2,1
13,245,245,22,22,0,1,0
9,251,251,1,1,0,1,0
7,260,260,2,2,0,1,0
14,285,285,2,2,0,1,0
10,306,306,1,1,0,1,0
0,307,307,8,8,0,1,0
16,311,311,13,3,10,3,2
3,334,334,14,14,0,1,0
15,357,357,44,44,0,1,0
5,431,431,77,77,0,1,0

11,112,112,14,11,3,2,1
0,127,127,15,6,9,4,3
10,159,159,12,12,0,1,0
5,206,206,20,20,0,1,0
1,220,220,22,7,15,2,1
2,230,230,37,2,35,2,1
6,266,266,7,7,0,1,0
3,282,282,24,16,8,3,2
9,344,344,35,35,0,1,0
4,351,351,14,14,0,1,0
7,373,373,34,34,0,1,0
8,389,389,73,57,16,3,2

8,120,120,7,7,0,1,0
7,158,158,20,20,0,1,0
2,215,215,1,1,0,1,0
12,228,228,5,5,0,1,0
4,240,240,13,4,9,2,1
3,244,244,34,12,22,2,1
9,263,263,73,73,0,1,0
5,305,305,34,34,0,1,0
6,308,308,16,13,3,2,1
10,332,332,31,25,6,3,2
13,350,350,9,9,0,1,0
14,375,375,28,28,0,1,0
0,398,398,7,7,0,1,0
11,442,442,52,16,36,2,1
1,468,468,18,9,9,2,1

6,102,102,10,3,7,2,1
2,180,180,33,9,24,3,2
11,226,226,51,51,0,1,0
5,277,277,26,26,0,1,0
4,284,284,7,7,0,1,0
9,288,288,16,11,5,2,1
10,288,288,44,44,0,1,0
3,293,293,39,39,0,1,0
7,370,370,26,3,23,3,2
8,383,383,29,24,5,2,1
0,387,387,25,25,0,1,0
12,389,389,11,11,0,1,0
1,439,439,3,3,0,1,0

10,160,160,31,31,0,1,0
7,201,201,31,1,30,3,2
0,305,305,7,1,6,3,2
1,306,306,72,42,30,2,1
9,306,306,15,15,0,1,0
5,320,320,8,8,0,1,0
8,329,329,4,4,0,1,0
3,386,386,74,74,0,1,0
6,390,390,71,71,0,1,0
4,436,436,50,25,25,2,1
2,500,500,18,6,12,4,3

6,152,152,9,3,6,2,1
13,187,187,31,31,0,1,0
2,233,233,2,2,0,1,0
11,248,248,7,7,0,1,0
9,302,302,58,58,0,1,0
8,330,330,40,24,16,3,2
12,343,343,28,28,0,1,0
3,349,349,57,13,44,3,2
0,363,363,44,9,35,4,3
10,430,430,9,9,0,1,0
1,432,432,36,23,13,2,1
7,437,437,43,43,0,1,0
5,441,441,15,15,0,1,0
4,469,469,16,4,12,2,1

12,109,109,20,13,7,2,1
5,158,158,5,2,3,2,1
8,161,161,4,4,0,1,0
9,168,168,23,7,16,2,1
10,170,170,3,3,0,1,0
1,205,205,1,1,0,1,0
6,258,258,45,22,23,2,1
3,308,308,36,6,30,3,2
2,338,338,37,22,15,2,1
13,359,359,55,35,20,3,2
11,398,398,39,39,0,1,0
4,440,440,2,2,0,1,0
7,450,450,47,47,0,1,0
0,455,455,25,25,0,1,0

9,117,117,3,3,0,1,0
4,181,181,9,1,8,3,2
6,205,205,12,12,0,1,0
7,278,278,47,41,6,3,2
11,314,314,13,13,0,1,0
10,331,331,8,8,0,1,0
8,340,340,99,99,0,1,0
1,356,356,99,78,21,2,1
2,467,467,46,46,0,1,0
5,472,472,28,8,20,2,1
3,482,482,2,2,0,1,0
0,497,497,55,19,36,3,2

0,114,114,6,6,0,1,0
1,125,125,1,1,0,1,0
16,126,126,33,1,32,2,1
17,147,147,6,2,4,2,1
14,156,156,13,13,0,1,0
5,157,157,3,3,0,1,0
3,194,194,6,3,3,2,1
7,208,208,1,1,0,1,0
2,262,262,50,50,0,1,0
6,268,268,7,7,0,1,0
9,268,268,27,3,24,3,2
10,276,276,10,10,0,1,0
13,308,308,29,16,13,2,1
11,351,351,30,4,26,2,1
8,359,359,11,5,6,2,1
4,371,371,6,3,3,2,1
12,491,491,35,35,0,1,0
15,494,494,33,15,18,4,3

7,124,124,14,8,6,3,2
2,168,168,33,13,20,3,2
14,174,174,18,4,14,3,2
1,194,194,3,3,0,1,0
3,216,216,1,1,0,1,0
8,235,235,7,4,3,2,1
4,241,241,2,2,0,1,0
11,264,264,12,2,10,3,2
5,304,304,29,29,0,1,0
13,329,329,58,58,0,1,0
16,347,347,29,29,0,1,0
9,349,349,2,2,0,1,0
15,359,359,45,45,0,1,0
0,410,410,9,9,0,1,0
12,473,473,36,15,21,4,3
6,478,478,51,27,24,4,3
10,499,499,2,2,0,1,0

5,107,107,8,8,0,1,0
11,173,173,3,3,0,1,0
12,209,209,72,72,0,1,0
0,230,230,12,12,0,1,0
9,287,287,37,37,0,1,0
10,290,290,10,7,3,2,1
1,310,310,49,17,32,4,3
6,344,344,25,25,0,1,0
8,378,378,30,18,12,4,3
3,390,390,49,49,0,1,0
4,392,392,39,39,0,1,0
2,442,442,8,8,0,1,0
7,449,449,1,1,0,1,0

4,142,142,37,13,24,4,3
10,217,217,3,3,0,1,0
9,218,218,1,1,0,1,0
7,241,241,40,40,0,1,0
0,252,252,19,19,0,1,0
8,287,287,108,47,61,3,2
2,304,304,11,11,0,1,0
6,308,308,2,2,0,1,0
5,323,323,15,15,0,1,0
1,398,398,44,23,21,4,3
3,448,448,53,49,4,2,1

1,126,126,9,9,0,1,0
12,149,149,11,5,6,2,1
11,166,166,19,19,0,1,0
2,213,213,11,11,0,1,0
4,225,225,40,35,5,2,1
10,248,248,14,14,0,1,0
9,266,266,8,4,4,2,1
14,272,272,55,13,42,2,1
8,273,273,4,4,0,1,0
6,282,282,9,9,0,1,0
5,341,341,16,16,0,1,0
7,360,360,2,2,0,1,0
13,462,462,63,63,0,1,0
3,474,474,38,16,22,2,1
0,481,481,58,42,16,3,2

0,135,135,3,3,0,1,0
3,185,185,48,48,0,1,0
9,204,204,21,21,0,1,0
1,273,273,80,66,14,2,1
2,293,293,5,5,0,1,0
4,309,309,3,3,0,1,0
5,377,377,2,2,0,1,0
6,385,385,9,9,0,1,0
8,437,437,4,4,0,1,0
7,472,472,169,121,48,3,2
10,485,485,54,42,12,4,3

7,119,119,10,1,9,4,3
11,183,183,23,7,16,2,1
4,302,302,17,5,12,2,1
0,321,321,66,66,0,1,0
3,341,341,39,39,0,1,0
6,357,357,4,4,0,1,0
1,408,408,37,37,0,1,0
5,439,439,13,13,0,1,0
9,441,441,40,12,28,2,1
8,449,449,30,6,24,3,2
10,472,472,107,81,26,3,2
2,496,496,52,52,0,1,0

7,124,124,20,20,0,1,0
1,189,189,12,12,0,1,0
2,211,211,41,17,24,4,3
5,273,273,4,4,0,1,0
6,387,387,42,24,18,4,3
9,404,404,14,14,0,1,0
4,430,430,56,26,30,2,1
0,467,467,69,60,9,2,1
3,467,467,91,19,72,3,2
8,469,469,73,73,0,1,0

0,105,105,10,10,0,1,0
5,197,197,14,9,5,2,1
4,213,213,10,10,0,1,0
3,216,216,17,9,8,2,1
8,233,233,23,8,15,4,3
1,351,351,50,50,0,1,0
7,377,377,7,1,6,2,1
6,429,429,125,53,72,4,3
2,473,473,172,70,102,4,3

6,131,131,31,12,19,2,1
7,200,200,52,23,29,2,1
2,243,243,21,3,18,2,1
8,248,248,16,1,15,2,1
10,283,283,26,1,25,2,1
5,349,349,4,4,0,1,0
3,354,354,3,3,0,1,0
1,357,357,38,29,9,4,3
12,390,390,20,2,18,2,1
9,438,438,11,11,0,1,0
4,439,439,32,32,0,1,0
11,457,457,53,31,22,2,1
0,478,478,39,17,22,2,1

15,112,112,3,3,0,1,0
16,142,142,42,35,7,2,1
0,161,161,7,7,0,1,0
13,162,162,7,4,3,2,1
18,194,194,10,1,9,4,3
8,199,199,5,5,0,1,0
12,229,229,5,5,0,1,0
17,242,242,26,26,0,1,0
2,248,248,11,5,6,3,2
9,279,279,6,6,0,1,0
1,301,301,15,15,0,1,0
11,302,302,25,17,8,2,1
3,327,327,4,1,3,2,1
4,334,334,4,4,0,1,0
6,394,394,9,9,0,1,0
10,403,403,7,7,0,1,0
5,407,407,9,5,4,2,1
14,409,409,45,45,0,1,0
7,442,442,32,32,0,1,0
19,463,463,40,28,12,3,2
20,468,468,24,24,0,1,0

4,138,138,10,10,0,1,0
1,158,158,2,2,0,1,0
8,163,163,4,4,0,1,0
6,166,166,13,13,0,1,0
11,240,240,3,3,0,1,0
12,282,282,17,17,0,1,0
15,286,286,24,14,10,3,2
3,314,314,45,39,6,2,1
7,332,332,12,12,0,1,0
14,339,339,1,1,0,1,0
13,339,339,97,86,11,2,1
0,368,368,21,21,0,1,0
2,422,422,52,52,0,1,0
5,426,426,4,1,3,2,1
10,452,452,19,19,0,1,0
9,497,497,1,1,0,1,0
16,497,497,82,36,46,4,3

6,182,182,2,2,0,1,0
5,199,199,9,9,0,1,0
7,202,202,31,13,18,4,3
3,259,259,91,79,12,3,2
0,261,261,8,8,0,1,0
2,283,283,79,17,62,3,2
8,324,324,8,8,0,1,0
4,409,409,11,5,6,3,2
1,494,494,145,118,27,4,3

6,100,100,11,4,7,2,1
11,121,121,17,17,0,1,0
10,149,149,4,1,3,2,1
7,191,191,32,32,0,1,0
5,274,274,51,8,43,2,1
8,293,293,19,15,4,2,1
9,306,306,34,6,28,3,2
0,336,336,35,11,24,4,3
3,349,349,21,3,18,3,2
4,375,375,78,69,9,4,3
2,420,420,11,11,0,1,0
1,487,487,8,8,0,1,0

5,110,110,1,1,0,1,0
10,133,133,5,2,3,2,1
2,142,142,1,1,0,1,0
9,164,164,34,28,6,2,1
6,185,185,8,1,7,2,1
1,218,218,5,2,3,2,1
12,274,274,35,29,6,3,2
7,321,321,14,14,0,1,0
3,379,379,16,16,0,1,0
11,390,390,68,68,0,1,0
0,432,432,77,22,55,4,3
8,447,447,11,5,6,2,1
4,462,462,139,124,15,4,3

6,137,137,11,11,0,1,0
1,153,153,23,23,0,1,0
3,193,193,26,26,0,1,0
9,197,197,35,15,20,3,2
0,203,203,52,52,0,1,0
7,249,249,79,56,23,4,3
5,295,295,3,3,0,1,0
2,313,313,20,20,0,1,0
8,391,391,6,6,0,1,0
4,468,468,6,6,0,1,0

11,118,118,12,12,0,1,0
6,187,187,11,1,10,3,2
8,233,233,19,7,12,4,3
7,236,236,65,19,46,2,1
2,293,293,13,13,0,1,0
4,296,296,17,17,0,1,0
5,300,300,25,25,0,1,0
10,323,323,24,24,0,1,0
3,341,341,11,11,0,1,0
9,391,391,4,4,0,1,0
1,429,429,1,1,0,1,0
0,456,456,148,127,21,2,1
12,459,459,31,31,0,1,0

9,118,118,4,1,3,2,1
11,118,118,30,9,21,4,3
8,163,163,14,14,0,1,0
4,164,164,6,6,0,1,0
14,169,169,16,16,0,1,0
1,206,206,9,5,4,2,1
13,217,217,18,1,17,2,1
6,235,235,10,2,8,2,1
12,263,263,2,2,0,1,0
5,294,294,31,3,28,4,3
15,316,316,25,16,9,2,1
7,333,333,2,2,0,1,0
2,341,341,22,13,9,3,2
3,353,353,10,10,0,1,0
0,427,427,67,18,49,2,1
10,445,445,40,40,0,1,0

5,107,107,35,35,0,1,0
6,189,189,8,3,5,2,1
3,229,229,19,16,3,2,1
2,239,239,21,12,9,2,1
9,275,275,13,13,0,1,0
8,303,303,6,2,4,2,1
4,393,393,66,7,59,4,3
0,459,459,57,57,0,1,0
7,482,482,5,5,0,1,0
1,488,488,149,149,0,1,0

6,112,112,10,1,9,2,1
4,194,194,19,19,0,1,0
0,222,222,78,29,49,3,2
5,228,228,15,15,0,1,0
10,293,293,53,53,0,1,0
7,330,330,26,26,0,1,0
8,391,391,41,16,25,2,1
1,400,400,27,3,24,2,1
2,405,405,20,16,4,2,1
3,418,418,16,16,0,1,0
9,459,459,39,19,20,2,1

4,142,142,5,5,0,1,0
1,160,160,40,40,0,1,0
7,166,166,15,15,0,1,0
5,198,198,3,3,0,1,0
10,228,228,25,16,9,2,1
11,255,255,1,1,0,1,0
8,264,264,9,9,0,1,0
0,359,359,36,36,0,1,0
6,359,359,45,6,39,2,1
2,364,364,43,43,0,1,0
9,413,413,102,102,0,1,0
3,426,426,35,29,6,3,2

1,107,107,33,33,0,1,0
3,147,147,9,9,0,1,0
9,172,172,1,1,0,1,0
5,274,274,20,20,0,1,0
4,371,371,13,1,12,4,3
7,372,372,21,21,0,1,0
2,373,373,69,69,0,1,0
0,385,385,4,4,0,1,0
6,410,410,107,107,0,1,0
10,428,428,43,43,0,1,0
8,452,452,51,51,0,1,0

5,131,131,1,1,0,1,0
2,143,143,1,1,0,1,0
12,143,143,9,9,0,1,0
11,148,148,31,9,22,2,1
4,174,174,2,2,0,1,0
7,211,211,1,1,0,1,0
6,240,240,23,3,20,3,2
10,240,240,43,43,0,1,0
1,309,309,26,26,0,1,0
9,329,329,42,42,0,1,0
8,424,424,13,13,0,1,0
3,428,428,164,101,63,3,2
0,446,446,6,6,0,1,0

7,104,104,2,2,0,1,0
14,139,139,15,15,0,1,0
10,156,156,30,10,20,2,1
3,178,178,9,9,0,1,0
15,231,231,9,1,8,3,2
11,268,268,5,5,0,1,0
2,286,286,5,2,3,2,1
8,296,296,21,6,15,2,1
5,309,309,31,31,0,1,0
4,341,341,21,15,6,2,1
13,348,348,61,15,46,3,2
0,460,460,12,12,0,1,0
1,464,464,28,28,0,1,0
6,484,484,36,36,0,1,0
9,485,485,58,42,16,3,2
12,488,488,41,41,0,1,0

6,109,109,9,9,0,1,0
8,120,120,6,3,3,2,1
3,131,131,8,8,0,1,0
2,167,167,30,3,27,2,1
15,205,205,16,16,0,1,0
9,237,237,13,13,0,1,0
14,245,245,10,10,0,1,0
7,295,295,1,1,0,1,0
12,301,301,11,11,0,1,0
0,316,316,19,19,0,1,0
11,339,339,108,57,51,4,3
4,390,390,5,1,4,2,1
1,460,460,4,4,0,1,0
10,466,466,17,11,6,3,2
13,474,474,45,45,0,1,0
5,498,498,45,45,0,1,0

2,106,106,8,8,0,1,0
3,110,110,3,3,0,1,0
12,116,116,11,11,0,1,0
5,124,124,5,5,0,1,0
0,159,159,31,31,0,1,0
6,276,276,13,2,11,2,1
7,276,276,17,17,0,1,0
10,282,282,11,1,10,2,1
9,312,312,110,65,45,4,3
8,355,355,16,16,0,1,0
1,370,370,24,24,0,1,0
14,376,376,20,20,0,1,0
11,382,382,1,1,0,1,0
4,418,418,19,4,15,2,1
13,489,489,33,15,18,4,3

6,140,140,19,4,15,2,1
4,216,216,11,11,0,1,0
2,224,224,14,4,10,2,1
10,328,328,11,11,0,1,0
5,333,333,116,12,104,4,3
1,390,390,125,125,0,1,0
8,405,405,5,1,4,2,1
0,432,432,43,43,0,1,0
7,462,462,15,15,0,1,0
9,468,468,23,23,0,1,0
3,472,472,33,33,0,1,0

8,107,107,6,2,4,2,1
12,107,107,6,3,3,2,1
0,151,151,44,44,0,1,0
11,189,189,11,11,0,1,0
10,221,221,64,16,48,4,3
1,269,269,4,4,0,1,0
7,306,306,6,1,5,2,1
6,313,313,33,11,22,3,2
13,386,386,6,2,4,2,1
2,463,463,3,3,0,1,0
3,472,472,62,19,43,2,1
4,472,472,12,12,0,1,0
9,479,479,68,24,44,2,1
5,485,485,4,4,0,1,0

4,107,107,4,1,3,2,1
1,120,120,1,1,0,1,0
2,210,210,17,3,14,3,2
8,223,223,4,4,0,1,0
9,232,232,2,2,0,1,0
5,234,234,2,2,0,1,0
14,254,254,18,4,14,2,1
11,269,269,1,1,0,1,0
15,274,274,24,21,3,2,1
10,348,348,8,4,4,2,1
13,361,361,7,7,0,1,0
7,378,378,59,47,12,3,2
6,417,417,24,8,16,2,1
16,435,435,2,2,0,1,0
0,443,443,82,4,78,4,3
3,470,470,8,8,0,1,0
12,485,485,203,182,21,4,3

7,102,102,1,1,0,1,0
12,112,112,11,2,9,3,2
4,148,148,11,11,0,1,0
1,170,170,3,3,0,1,0
0,204,204,26,14,12,4,3
9,251,251,5,2,3,2,1
3,272,272,25,25,0,1,0
11,350,350,37,37,0,1,0
6,367,367,1,1,0,1,0
10,418,418,45,15,30,4,3
2,426,426,11,11,0,1,0
5,441,441,109,19,90,4,3
13,465,465,54,30,24,3,2
8,474,474,2,2,0,1,0
14,480,480,78,78,0,1,0

2,111,111,3,3,0,1,0
1,181,181,15,15,0,1,0
9,235,235,56,56,0,1,0
10,243,243,20,20,0,1,0
0,257,257,44,16,28,3,2
6,332,332,29,5,24,4,3
8,349,349,15,15,0,1,0
7,431,431,58,28,30,3,2
3,440,440,54,54,0,1,0
4,453,453,89,83,6,3,2
5,478,478,11,11,0,1,0

11,157,157,13,13,0,1,0
6,215,215,59,24,35,2,1
5,260,260,3,3,0,1,0
4,273,273,37,9,28,3,2
9,294,294,31,15,16,4,3
3,338,338,99,99,0,1,0
0,373,373,33,17,16,3,2
8,439,439,17,17,0,1,0
2,453,453,22,4,18,2,1
7,479,479,3,3,0,1,0
10,480,480,48,48,0,1,0
1,499,499,13,13,0,1,0

14,100,100,22,1,21,4,3
13,108,108,8,4,4,2,1
4,115,115,2,2,0,1,0
2,157,157,3,3,0,1,0
12,176,176,46,12,34,3,2
7,177,177,14,14,0,1,0
3,180,180,14,6,8,2,1
15,184,184,6,2,4,2,1
10,229,229,1,1,0,1,0
5,249,249,1,1,0,1,0
9,255,255,1,1,0,1,0
8,300,300,69,13,56,3,2
0,340,340,43,43,0,1,0
1,407,407,8,8,0,1,0
11,440,440,10,3,7,2,1
6,499,499,13,13,0,1,0

8,206,206,49,49,0,1,0
1,217,217,19,19,0,1,0
4,219,219,38,30,8,2,1
10,228,228,11,11,0,1,0
6,246,246,32,4,28,3,2
3,256,256,46,35,11,2,1
7,318,318,18,1,17,2,1
9,372,372,42,32,10,2,1
2,439,439,64,22,42,4,3
0,456,456,8,8,0,1,0
5,480,480,11,11,0,1,0

3,174,174,18,4,14,2,1
2,202,202,40,40,0,1,0
11,207,207,1,1,0,1,0
10,264,264,44,44,0,1,0
0,342,342,24,6,18,3,2
4,360,360,1,1,0,1,0
6,399,399,63,1,62,3,2
8,403,403,18,18,0,1,0
9,456,456,5,5,0,1,0
5,461,461,104,104,0,1,0
7,469,469,106,39,67,3,2
1,474,474,1,1,0,1,0

5,104,104,11,1,10,2,1
7,108,108,2,2,0,1,0
10,119,119,5,5,0,1,0
0,156,156,15,15,0,1,0
11,246,246,69,9,60,4,3
1,258,258,15,3,12,3,2
9,312,312,6,6,0,1,0
12,317,317,8,8,0,1,0
6,346,346,5,5,0,1,0
13,377,377,12,12,0,1,0
8,386,386,80,80,0,1,0
3,448,448,55,55,0,1,0
2,453,453,49,49,0,1,0
4,476,476,40,1,39,4,3

8,115,115,2,2,0,1,0
5,169,169,2,2,0,1,0
1,188,188,13,7,6,3,2
9,193,193,14,6,8,2,1
2,210,210,11,7,4,2,1
6,245,245,22,22,0,1,0
0,290,290,125,125,0,1,0
7,369,369,107,64,43,2,1
4,391,391,51,5,46,3,2
3,457,457,22,11,11,2,1

9,118,118,9,9,0,1,0
3,126,126,2,2,0,1,0
1,139,139,18,18,0,1,0
2,150,150,14,14,0,1,0
7,183,183,3,3,0,1,0
14,227,227,48,26,22,3,2
11,229,229,54,6,48,3,2
5,244,244,10,4,6,2,1
16,287,287,2,2,0,1,0
8,313,313,27,19,8,2,1
10,338,338,13,2,11,2,1
0,410,410,6,3,3,2,1
13,435,435,7,7,0,1,0
12,440,440,60,60,0,1,0
4,463,463,2,2,0,1,0
6,467,467,40,28,12,2,1
15,474,474,3,3,0,1,0

0,109,109,2,2,0,1,0
1,166,166,12,3,9,2,1
3,205,205,28,7,21,4,3
2,240,240,1,1,0,1,0
14,246,246,16,13,3,2,1
12,291,291,2,2,0,1,0
8,325,325,75,3,72,3,2
9,325,325,50,47,3,2,1
5,329,329,21,2,19,3,2
13,356,356,26,18,8,2,1
11,381,381,10,10,0,1,0
4,409,409,2,2,0,1,0
10,476,476,136,136,0,1,0
6,483,483,1,1,0,1,0
7,492,492,34,34,0,1,0

0,182,182,49,49,0,1,0
6,182,182,4,4,0,1,0
8,219,219,48,48,0,1,0
5,258,258,23,14,9,4,3
2,271,271,43,5,38,2,1
7,301,301,14,14,0,1,0
3,302,302,13,1,12,2,1
1,321,321,42,18,24,3,2
9,332,332,2,2,0,1,0
4,366,366,85,85,0,1,0

0,181,181,21,9,12,4,3
6,196,196,11,3,8,2,1
10,212,212,21,6,15,2,1
1,234,234,4,4,0,1,0
3,241,241,1,1,0,1,0
12,323,323,36,6,30,3,2
7,328,328,74,56,18,4,3
5,337,337,22,22,0,1,0
11,356,356,50,26,24,3,2
13,395,395,53,53,0,1,0
9,402,402,16,16,0,1,0
4,427,427,6,6,0,1,0
8,427,427,14,2,12,3,2
14,432,432,37,20,17,2,1
2,447,447,31,31,0,1,0

4,147,147,12,12,0,1,0
7,179,179,3,3,0,1,0
0,193,193,65,56,9,4,3
1,201,201,53,53,0,1,0
2,216,216,25,25,0,1,0
6,262,262,8,8,0,1,0
5,288,288,88,64,24,3,2
3,414,414,27,7,20,3,2

10,106,106,14,14,0,1,0
3,144,144,7,7,0,1,0
2,154,154,1,1,0,1,0
11,159,159,5,5,0,1,0
15,169,169,7,7,0,1,0
1,172,172,6,6,0,1,0
16,173,173,5,5,0,1,0
6,194,194,7,7,0,1,0
20,199,199,28,15,13,2,1
13,221,221,5,5,0,1,0
8,276,276,3,3,0,1,0
7,278,278,2,2,0,1,0
12,297,297,8,2,6,3,2
14,341,341,25,5,20,3,2
0,363,363,5,5,0,1,0
9,391,391,10,2,8,3,2
5,392,392,39,10,29,2,1
19,394,394,55,33,22,3,2
4,421,421,13,4,9,3,2
17,442,442,112,30,82,4,3
18,473,473,3,3,0,1,0

1,164,164,25,17,8,3,2
0,190,190,4,4,0,1,0
8,191,191,44,23,21,2,1
2,252,252,108,108,0,1,0
4,296,296,3,3,0,1,0
6,324,324,33,33,0,1,0
3,415,415,49,49,0,1,0
7,455,455,9,9,0,1,0
5,494,494,65,65,0,1,0

1,102,102,4,4,0,1,0
2,110,110,3,3,0,1,0
5,127,127,12,4,8,3,2
9,144,144,39,31,8,2,1
8,146,146,2,2,0,1,0
10,155,155,2,2,0,1,0
6,204,204,42,18,24,3,2
7,324,324,35,35,0,1,0
11,407,407,12,12,0,1,0
12,438,438,36,14,22,2,1
13,463,463,95,74,21,4,3
4,474,474,17,1,16,3,2
0,476,476,21,2,19,2,1
3,498,498,24,24,0,1,0

8,122,122,8,8,0,1,0
3,177,177,13,13,0,1,0
4,298,298,54,12,42,4,3
9,382,382,25,25,0,1,0
6,411,411,65,25,40,3,2
2,413,413,8,8,0,1,0
5,420,420,13,13,0,1,0
0,430,430,43,43,0,1,0
10,458,458,7,7,0,1,0
1,466,466,91,87,4,2,1
7,473,473,116,9,107,4,3
11,489,489,30,30,0,1,0

5,119,119,3,3,0,1,0
15,148,148,4,4,0,1,0
0,155,155,24,24,0,1,0
18,174,174,29,29,0,1,0
14,199,199,2,2,0,1,0
2,203,203,4,4,0,1,0
4,212,212,11,11,0,1,0
11,273,273,1,1,0,1,0
10,291,291,4,4,0,1,0
12,321,321,16,8,8,3,2
6,331,331,5,1,4,2,1
13,365,365,14,14,0,1,0
9,395,395,32,10,22,3,2
7,423,423,50,16,34,2,1
17,444,444,34,34,0,1,0
3,452,452,17,17,0,1,0
16,453,453,134,38,96,4,3
1,480,480,12,9,3,2,1
8,481,481,3,3,0,1,0

5,120,120,2,2,0,1,0
2,130,130,21,21,0,1,0
3,141,141,42,42,0,1,0
10,167,167,18,18,0,1,0
1,180,180,12,6,6,3,2
6,230,230,6,2,4,2,1
7,272,272,20,20,0,1,0
8,291,291,14,14,0,1,0
0,330,330,2,2,0,1,0
4,350,350,24,6,18,3,2
9,409,409,140,140,0,1,0

13,136,136,4,4,0,1,0
10,165,165,38,38,0,1,0
4,172,172,8,2,6,2,1
12,196,196,12,12,0,1,0
1,238,238,1,1,0,1,0
11,247,247,17,17,0,1,0
0,269,269,65,5,60,4,3
5,273,273,9,4,5,2,1
8,385,385,27,27,0,1,0
3,387,387,31,31,0,1,0
14,399,399,48,15,33,2,1
9,403,403,43,17,26,2,1
2,426,426,26,23,3,2,1
7,439,439,9,9,0,1,0
6,486,486,21,7,14,2,1

1,100,100,19,6,13,2,1
6,138,138,10,10,0,1,0
12,217,217,11,4,7,2,1
10,267,267,24,24,0,1,0
2,283,283,6,6,0,1,0
9,313,313,17,17,0,1,0
8,318,318,85,85,0,1,0
7,319,319,4,4,0,1,0
3,382,382,17,17,0,1,0
11,392,392,54,54,0,1,0
0,421,421,87,25,62,4,3
4,435,435,26,3,23,2,1
5,444,444,4,4,0,1,0

10,156,156,5,5,0,1,0
8,201,201,51,4,47,2,1
7,317,317,42,42,0,1,0
6,328,328,20,8,12,2,1
3,348,348,9,9,0,1,0
4,354,354,119,100,19,2,1
5,365,365,12,12,0,1,0
2,383,383,18,6,12,2,1
9,394,394,38,38,0,1,0
0,455,455,46,34,12,3,2
1,459,459,42,1,41,2,1

1,119,119,3,3,0,1,0
9,188,188,34,34,0,1,0
3,192,192,5,5,0,1,0
2,206,206,17,5,12,4,3
0,216,216,40,1,39,4,3
4,237,237,16,16,0,1,0
12,275,275,45,33,12,3,2
5,281,281,27,27,0,1,0
6,364,364,43,20,23,3,2
8,381,381,26,14,12,4,3
10,445,445,9,9,0,1,0
11,448,448,41,3,38,2,1
7,452,452,37,12,25,2,1

0,128,128,1,1,0,1,0
12,172,172,19,19,0,1,0
5,287,287,1,1,0,1,0
11,287,287,16,1,15,2,1
8,317,317,55,23,32,2,1
10,326,326,34,34,0,1,0
1,349,349,4,4,0,1,0
3,349,349,37,37,0,1,0
4,375,375,21,3,18,3,2
2,382,382,120,69,51,4,3
6,395,395,40,4,36,2,1
9,458,458,7,7,0,1,0
7,467,467,71,28,43,4,3

17,134,134,14,14,0,1,0
8,158,158,3,3,0,1,0
2,165,165,14,14,0,1,0
1,180,180,13,9,4,2,1
14,205,205,2,2,0,1,0
9,207,207,18,9,9,4,3
12,237,237,5,5,0,1,0
15,254,254,5,5,0,1,0
13,258,258,53,27,26,3,2
7,280,280,11,11,0,1,0
16,284,284,73,25,48,2,1
5,306,306,11,11,0,1,0
3,309,309,28,13,15,2,1
10,313,313,21,11,10,3,2
4,347,347,3,3,0,1,0
6,435,435,1,1,0,1,0
11,446,446,21,21,0,1,0
0,453,453,21,3,18,3,2

1,115,115,9,1,8,3,2
3,130,130,1,1,0,1,0
8,178,178,20,20,0,1,0
6,191,191,7,7,0,1,0
4,295,295,68,68,0,1,0
10,349,349,42,30,12,4,3
2,363,363,56,44,12,2,1
0,388,388,43,43,0,1,0
7,402,402,115,85,30,3,2
11,409,409,2,2,0,1,0
9,471,471,22,22,0,1,0
5,495,495,10,1,9,4,3

5,117,117,3,3,0,1,0
7,132,132,16,7,9,4,3
6,148,148,13,13,0,1,0
0,204,204,2,2,0,1,0
1,206,206,29,9,20,3,2
3,214,214,7,7,0,1,0
9,234,234,9,9,0,1,0
8,259,259,24,24,0,1,0
10,279,279,24,8,16,3,2
12,319,319,39,4,35,2,1
4,337,337,48,9,39,4,3
11,362,362,57,57,0,1,0
2,408,408,18,18,0,1,0
13,423,423,48,4,44,2,1

12,109,109,2,2,0,1,0
6,152,152,11,11,0,1,0
9,155,155,5,1,4,2,1
7,194,194,18,18,0,1,0
1,229,229,32,32,0,1,0
10,324,324,25,25,0,1,0
4,332,332,9,9,0,1,0
13,380,380,126,92,34,3,2
8,391,391,15,15,0,1,0
5,426,426,6,1,5,2,1
3,455,455,1,1,0,1,0
11,460,460,54,2,52,3,2
2,464,464,37,37,0,1,0
0,465,465,82,47,35,3,2

0,123,123,53,53,0,1,0
4,201,201,61,61,0,1,0
6,215,215,25,25,0,1,0
2,251,251,37,9,28,2,1
5,339,339,30,18,12,2,1
7,346,346,15,1,14,3,2
3,390,390,10,5,5,2,1
1,474,474,12,12,0,1,0
8,484,484,15,15,0,1,0

2,110,110,2,2,0,1,0
7,153,153,4,4,0,1,0
1,209,209,39,7,32,2,1
10,246,246,66,66,0,1,0
0,331,331,52,52,0,1,0
12,332,332,9,9,0,1,0
4,347,347,16,6,10,2,1
8,384,384,4,1,3,2,1
6,443,443,52,6,46,2,1
11,444,444,21,21,0,1,0
3,457,457,10,10,0,1,0
5,469,469,25,25,0,1,0
9,469,469,109,109,0,1,0

3,106,106,2,2,0,1,0
1,122,122,13,6,7,2,1
2,122,122,3,3,0,1,0
0,160,160,4,4,0,1,0
15,199,199,7,3,4,2,1
10,218,218,33,17,16,3,2
7,300,300,25,25,0,1,0
9,335,335,51,51,0,1,0
12,337,337,66,8,58,3,2
14,344,344,31,31,0,1,0
6,366,366,21,1,20,3,2
5,397,397,34,15,19,2,1
13,429,429,39,39,0,1,0
4,433,433,1,1,0,1,0
11,433,433,21,8,13,2,1
8,463,463,21,12,9,4,3

3,192,192,25,25,0,1,0
8,195,195,7,7,0,1,0
7,205,205,20,20,0,1,0
9,206,206,5,5,0,1,0
14,232,232,24,24,0,1,0
10,239,239,45,23,22,2,1
1,243,243,5,5,0,1,0
2,294,294,11,7,4,2,1
12,348,348,1,1,0,1,0
15,351,351,28,12,16,2,1
5,365,365,65,65,0,1,0
11,402,402,3,3,0,1,0
13,416,416,96,96,0,1,0
4,453,453,25,25,0,1,0
6,469,469,9,9,0,1,0
0,478,478,2,2,0,1,0

2,137,137,22,22,0,1,0
9,153,153,19,6,13,4,3
5,234,234,3,3,0,1,0
1,245,245,60,42,18,3,2
0,320,320,1,1,0,1,0
4,321,321,9,9,0,1,0
7,366,366,13,1,12,4,3
10,371,371,25,3,22,2,1
6,430,430,119,119,0,1,0
8,445,445,40,26,14,3,2
3,490,490,81,38,43,2,1

10,115,115,7,7,0,1,0
2,128,128,9,9,0,1,0
14,140,140,30,3,27,2,1
4,148,148,1,1,0,1,0
9,152,152,9,3,6,2,1
0,287,287,15,9,6,3,2
15,289,289,47,47,0,1,0
5,296,296,3,3,0,1,0
1,306,306,53,7,46,2,1
8,307,307,31,31,0,1,0
6,325,325,14,14,0,1,0
11,328,328,7,7,0,1,0
13,336,336,59,59,0,1,0
3,339,339,3,3,0,1,0
12,404,404,11,3,8,2,1
16,410,410,5,2,3,2,1
7,494,494,8,4,4,2,1

2,133,133,33,25,8,3,2
8,169,169,43,2,41,2,1
12,200,200,8,8,0,1,0
11,213,213,29,6,23,2,1
1,283,283,3,3,0,1,0
10,295,295,28,28,0,1,0
3,330,330,8,8,0,1,0
5,377,377,4,4,0,1,0
4,392,392,8,8,0,1,0
7,394,394,39,5,34,3,2
13,432,432,31,31,0,1,0
9,468,468,4,1,3,2,1
6,474,474,72,10,62,4,3
0,486,486,18,9,9,2,1

10,126,126,46,43,3,2,1
11,159,159,2,2,0,1,0
2,168,168,8,5,3,2,1
1,186,186,1,1,0,1,0
9,262,262,16,12,4,2,1
7,264,264,10,5,5,2,1
4,275,275,96,72,24,4,3
3,314,314,23,16,7,2,1
12,316,316,10,10,0,1,0
0,357,357,20,2,18,4,3
13,370,370,37,27,10,2,1
5,403,403,13,9,4,2,1
8,442,442,16,16,0,1,0
6,468,468,1,1,0,1,0

5,125,125,20,20,0,1,0
7,141,141,8,8,0,1,0
2,167,167,20,16,4,2,1
0,321,321,132,97,35,2,1
1,332,332,63,63,0,1,0
4,427,427,75,40,35,3,2
3,447,447,6,6,0,1,0
6,468,468,40,40,0,1,0

7,134,134,17,3,14,3,2
3,160,160,25,1,24,4,3
6,264,264,36,3,33,2,1
1,272,272,130,103,27,4,3
4,290,290,2,2,0,1,0
2,313,313,30,10,20,4,3
8,322,322,57,35,22,2,1
5,421,421,5,5,0,1,0
0,479,479,14,2,12,4,3

1,114,114,6,6,0,1,0
8,147,147,12,12,0,1,0
12,169,169,27,6,21,2,1
4,192,192,25,17,8,3,2
9,248,248,15,15,0,1,0
0,307,307,4,1,3,2,1
2,314,314,7,7,0,1,0
10,315,315,49,16,33,2,1
6,325,325,34,34,0,1,0
5,343,343,85,85,0,1,0
11,364,364,6,2,4,2,1
7,378,378,54,54,0,1,0
3,446,446,14,2,12,3,2

10,166,166,11,3,8,3,2
4,177,177,3,3,0,1,0
15,200,200,16,16,0,1,0
13,201,201,32,32,0,1,0
0,254,254,26,26,0,1,0
11,262,262,7,1,6,3,2
2,281,281,31,31,0,1,0
7,298,298,9,6,3,2,1
5,300,300,7,4,3,2,1
1,322,322,4,4,0,1,0
14,366,366,38,38,0,1,0
6,373,373,69,47,22,2,1
17,401,401,39,39,0,1,0
9,407,407,6,6,0,1,0
3,408,408,3,3,0,1,0
16,462,462,59,59,0,1,0
8,468,468,3,3,0,1,0
12,481,481,21,18,3,2,1

12,119,119,9,9,0,1,0
4,145,145,7,1,6,2,1
0,152,152,41,9,32,2,1
6,191,191,14,14,0,1,0
5,216,216,2,2,0,1,0
1,266,266,37,23,14,2,1
8,299,299,47,47,0,1,0
11,339,339,10,10,0,1,0
2,346,346,21,21,0,1,0
9,368,368,99,99,0,1,0
7,446,446,26,26,0,1,0
3,500,500,1,1,0,1,0
10,500,500,9,3,6,3,2

3,111,111,32,32,0,1,0
6,142,142,25,22,3,2,1
9,156,156,33,10,23,3,2
8,166,166,9,9,0,1,0
7,212,212,8,8,0,1,0
0,347,347,78,78,0,1,0
2,369,369,33,33,0,1,0
5,388,388,17,17,0,1,0
1,435,435,2,2,0,1,0
4,494,494,45,25,20,2,1

5,100,100,11,1,10,3,2
16,130,130,3,3,0,1,0
3,149,149,5,5,0,1,0
2,169,169,17,1,16,3,2
7,184,184,15,15,0,1,0
1,203,203,1,1,0,1,0
14,206,206,6,3,3,2,1
0,288,288,34,12,22,3,2
11,298,298,60,60,0,1,0
13,403,403,74,74,0,1,0
4,422,422,11,11,0,1,0
9,454,454,19,19,0,1,0
6,459,459,7,7,0,1,0
10,466,466,17,8,9,2,1
8,472,472,15,10,5,2,1
12,492,492,67,52,15,3,2
15,497,497,20,17,3,2,1

6,110,110,6,6,0,1,0
4,117,117,8,8,0,1,0
1,121,121,5,5,0,1,0
9,221,221,39,39,0,1,0
10,244,244,3,3,0,1,0
2,249,249,27,27,0,1,0
5,252,252,23,23,0,1,0
7,257,257,63,14,49,2,1
8,362,362,13,13,0,1,0
0,370,370,53,46,7,2,1
3,422,422,103,95,8,2,1

1,113,113,36,36,0,1,0
2,268,268,2,2,0,1,0
7,308,308,11,7,4,2,1
5,352,352,54,46,8,2,1
0,390,390,113,77,36,3,2
3,418,418,73,73,0,1,0
4,476,476,109,79,30,3,2
6,495,495,5,1,4,2,1

9,103,103,7,7,0,1,0
4,122,122,3,3,0,1,0
6,124,124,26,2,24,4,3
0,185,185,3,3,0,1,0
2,225,225,1,1,0,1,0
1,350,350,192,158,34,3,2
8,371,371,55,55,0,1,0
7,376,376,3,3,0,1,0
5,383,383,60,60,0,1,0
3,389,389,12,2,10,2,1

1,103,103,16,1,15,4,3
0,331,331,148,148,0,1,0
4,343,343,21,16,5,2,1
3,367,367,6,6,0,1,0
6,368,368,29,29,0,1,0
5,393,393,122,38,84,4,3
2,413,413,22,8,14,2,1
7,445,445,40,25,15,4,3

16,106,106,3,3,0,1,0
0,106,106,8,5,3,2,1
3,121,121,1,1,0,1,0
12,138,138,13,13,0,1,0
4,142,142,2,2,0,1,0
11,156,156,3,3,0,1,0
8,198,198,12,12,0,1,0
6,205,205,19,4,15,4,3
17,207,207,3,3,0,1,0
1,260,260,34,19,15,4,3
5,320,320,1,1,0,1,0
14,398,398,19,5,14,3,2
2,419,419,2,2,0,1,0
13,420,420,158,101,57,4,3
15,448,448,21,3,18,2,1
7,470,470,28,28,0,1,0
9,471,471,49,49,0,1,0
10,496,496,15,5,10,2,1

11,121,121,5,5,0,1,0
8,249,249,29,29,0,1,0
1,274,274,20,14,6,2,1
4,297,297,21,5,16,3,2
6,324,324,57,15,42,2,1
0,349,349,32,12,20,2,1
5,356,356,12,12,0,1,0
12,389,389,64,23,41,2,1
10,407,407,77,45,32,2,1
9,424,424,6,6,0,1,0
2,431,431,7,7,0,1,0
3,486,486,68,8,60,4,3
7,488,488,40,40,0,1,0

9,101,101,8,8,0,1,0
7,150,150,1,1,0,1,0
11,158,158,15,15,0,1,0
16,186,186,27,3,24,2,1
12,195,195,40,19,21,4,3
4,206,206,5,5,0,1,0
8,240,240,2,2,0,1,0
0,279,279,22,7,15,4,3
10,286,286,8,2,6,2,1
1,303,303,2,2,0,1,0
6,333,333,11,11,0,1,0
19,348,348,4,4,0,1,0
18,348,348,22,22,0,1,0
3,357,357,4,1,3,2,1
15,358,358,49,49,0,1,0
17,385,385,68,56,12,4,3
5,432,432,4,4,0,1,0
2,482,482,5,5,0,1,0
14,483,483,38,2,36,3,2
13,486,486,3,3,0,1,0

1,149,149,10,7,3,2,1
5,171,171,1,1,0,1,0
0,212,212,8,5,3,2,1
12,222,222,4,4,0,1,0
6,253,253,41,7,34,2,1
10,265,265,10,2,8,3,2
2,284,284,5,5,0,1,0
4,291,291,13,13,0,1,0
13,292,292,23,23,0,1,0
14,294,294,23,23,0,1,0
7,297,297,48,48,0,1,0
15,380,380,54,41,13,2,1
8,430,430,10,4,6,2,1
11,440,440,114,84,30,4,3
9,446,446,10,10,0,1,0
3,460,460,27,27,0,1,0

7,121,121,1,1,0,1,0
11,137,137,5,5,0,1,0
5,173,173,32,32,0,1,0
10,182,182,39,6,33,4,3
4,274,274,55,4,51,3,2
2,313,313,11,8,3,2,1
6,317,317,1,1,0,1,0
3,354,354,13,7,6,3,2
0,385,385,53,35,18,3,2
1,412,412,4,4,0,1,0
8,435,435,80,80,0,1,0
9,468,468,81,81,0,1,0

4,111,111,5,5,0,1,0
11,135,135,1,1,0,1,0
3,152,152,9,5,4,2,1
6,156,156,5,2,3,2,1
2,174,174,19,9,10,4,3
9,199,199,25,11,14,2,1
12,231,231,54,39,15,4,3
0,245,245,17,10,7,2,1
8,253,253,15,15,0,1,0
7,318,318,2,2,0,1,0
5,388,388,61,19,42,3,2
10,426,426,77,77,0,1,0
1,462,462,62,48,14,3,2

2,134,134,30,5,25,3,2
5,155,155,21,11,10,3,2
10,212,212,3,3,0,1,0
7,239,239,37,37,0,1,0
3,284,284,27,27,0,1,0
1,297,297,74,4,70,3,2
4,301,301,9,9,0,1,0
0,352,352,1,1,0,1,0
8,398,398,26,10,16,2,1
9,456,456,72,72,0,1,0
6,483,483,40,26,14,2,1

2,192,192,42,42,0,1,0
7,233,233,2,2,0,1,0
8,240,240,14,10,4,2,1
9,291,291,28,3,25,2,1
0,363,363,5,1,4,2,1
4,410,410,89,41,48,4,3
10,438,438,141,96,45,2,1
1,460,460,69,27,42,3,2
5,484,484,30,2,28,2,1
3,493,493,1,1,0,1,0
6,496,496,30,30,0,1,0

11,140,140,6,6,0,1,0
12,153,153,18,8,10,3,2
9,156,156,55,35,20,2,1
8,161,161,10,10,0,1,0
3,182,182,25,9,16,3,2
2,219,219,6,2,4,2,1
10,371,371,4,4,0,1,0
7,373,373,5,5,0,1,0
4,393,393,68,68,0,1,0
13,414,414,13,13,0,1,0
5,428,428,7,7,0,1,0
1,454,454,25,12,13,2,1
0,481,481,39,39,0,1,0
6,486,486,47,5,42,2,1

1,117,117,4,4,0,1,0
11,131,131,28,28,0,1,0
7,137,137,20,16,4,2,1
3,154,154,19,15,4,2,1
4,178,178,21,4,17,2,1
10,231,231,5,5,0,1,0
0,272,272,51,51,0,1,0
2,339,339,5,5,0,1,0
8,350,350,2,2,0,1,0
5,397,397,49,49,0,1,0
9,411,411,55,22,33,2,1
6,473,473,43,35,8,3,2

0,126,126,17,17,0,1,0
1,133,133,10,10,0,1,0
12,162,162,3,3,0,1,0
9,200,200,24,8,16,4,3
2,208,208,7,7,0,1,0
10,224,224,17,17,0,1,0
6,253,253,46,34,12,4,3
5,264,264,27,18,9,4,3
7,381,381,42,27,15,2,1
4,405,405,3,3,0,1,0
3,422,422,28,14,14,3,2
8,467,467,93,79,14,3,2
11,496,496,42,42,0,1,0

7,113,113,3,3,0,1,0
5,177,177,17,5,12,4,3
3,186,186,20,20,0,1,0
10,188,188,12,12,0,1,0
9,236,236,73,73,0,1,0
1,302,302,72,34,38,2,1
8,351,351,36,36,0,1,0
6,358,358,8,2,6,3,2
0,396,396,14,14,0,1,0
4,464,464,55,8,47,2,1
2,470,470,48,48,0,1,0

5,117,117,17,17,0,1,0
10,137,137,11,3,8,3,2
7,169,169,1,1,0,1,0
1,170,170,5,5,0,1,0
4,204,204,20,2,18,4,3
9,258,258,2,2,0,1,0
8,284,284,5,5,0,1,0
3,292,292,17,6,11,4,3
2,302,302,124,54,70,3,2
6,338,338,120,82,38,3,2
0,471,471,2,2,0,1,0

13,102,102,15,3,12,2,1
9,109,109,3,3,0,1,0
2,182,182,4,4,0,1,0
6,193,193,4,4,0,1,0
3,243,243,36,36,0,1,0
0,251,251,8,8,0,1,0
11,276,276,33,19,14,2,1
7,277,277,8,8,0,1,0
10,283,283,61,55,6,2,1
1,298,298,28,24,4,2,1
8,311,311,32,18,14,2,1
14,322,322,29,29,0,1,0
5,430,430,29,8,21,2,1
12,466,466,7,7,0,1,0
4,493,493,42,37,5,2,1

6,111,111,5,1,4,2,1
9,155,155,6,6,0,1,0
0,199,199,37,5,32,2,1
3,232,232,55,14,41,2,1
7,269,269,35,35,0,1,0
4,290,290,3,3,0,1,0
8,391,391,129,129,0,1,0
2,437,437,4,4,0,1,0
5,473,473,30,30,0,1,0
1,481,481,82,40,42,3,2

7,126,126,3,3,0,1,0
18,127,127,10,5,5,2,1
5,131,131,8,2,6,2,1
14,132,132,1,1,0,1,0
10,132,132,1,1,0,1,0
15,138,138,2,2,0,1,0
0,156,156,15,15,0,1,0
13,188,188,86,86,0,1,0
3,201,201,24,24,0,1,0
6,222,222,6,6,0,1,0
8,228,228,6,6,0,1,0
16,245,245,4,4,0,1,0
1,259,259,14,14,0,1,0
4,294,294,1,1,0,1,0
12,362,362,27,7,20,2,1
9,379,379,7,7,0,1,0
11,414,414,32,32,0,1,0
2,435,435,5,5,0,1,0
17,450,450,19,19,0,1,0

2,137,137,10,1,9,2,1
1,149,149,8,8,0,1,0
3,190,190,21,21,0,1,0
11,229,229,13,13,0,1,0
12,231,231,11,11,0,1,0
9,240,240,1,1,0,1,0
10,286,286,46,34,12,2,1
8,301,301,31,10,21,3,2
4,326,326,4,4,0,1,0
5,353,353,1,1,0,1,0
0,362,362,14,2,12,2,1
6,404,404,56,4,52,3,2
13,405,405,97,49,48,4,3
7,440,440,75,39,36,2,1

3,127,127,11,1,10,2,1
0,145,145,4,4,0,1,0
5,200,200,29,15,14,3,2
8,242,242,12,3,9,4,3
4,290,290,4,4,0,1,0
7,295,295,33,33,0,1,0
6,411,411,2,2,0,1,0
2,415,415,77,9,68,3,2
12,416,416,81,4,77,4,3
1,424,424,58,58,0,1,0
10,443,443,66,66,0,1,0
9,460,460,42,10,32,2,1
11,460,460,6,6,0,1,0

9,129,129,11,4,7,2,1
10,181,181,10,10,0,1,0
4,208,208,3,3,0,1,0
13,230,230,28,10,18,2,1
3,239,239,32,29,3,2,1
2,268,268,10,10,0,1,0
0,276,276,31,2,29,4,3
11,282,282,23,23,0,1,0
6,297,297,7,7,0,1,0
12,301,301,34,34,0,1,0
15,321,321,46,6,40,2,1
5,341,341,8,8,0,1,0
14,354,354,29,15,14,2,1
1,361,361,3,3,0,1,0
17,449,449,55,4,51,4,3
7,457,457,7,7,0,1,0
16,465,465,14,9,5,2,1
8,471,471,6,1,5,2,1

10,108,108,3,3,0,1,0
4,109,109,9,5,4,2,1
9,110,110,10,10,0,1,0
2,116,116,31,16,15,4,3
7,180,180,32,32,0,1,0
1,182,182,3,3,0,1,0
8,193,193,55,12,43,2,1
3,243,243,17,9,8,3,2
5,307,307,4,1,3,2,1
6,342,342,6,6,0,1,0
0,422,422,72,22,50,2,1

7,136,136,14,5,9,2,1
13,168,168,52,46,6,2,1
12,213,213,23,10,13,2,1
8,260,260,41,31,10,2,1
10,276,276,7,2,5,2,1
4,303,303,14,14,0,1,0
11,330,330,30,18,12,2,1
2,331,331,1,1,0,1,0
14,342,342,5,5,0,1,0
5,360,360,21,5,16,3,2
6,376,376,77,25,52,3,2
0,430,430,8,8,0,1,0
9,462,462,27,27,0,1,0
1,476,476,3,3,0,1,0
3,492,492,2,2,0,1,0

5,115,115,16,16,0,1,0
7,162,162,4,1,3,2,1
8,181,181,34,20,14,3,2
0,182,182,14,6,8,3,2
2,237,237,18,9,9,4,3
3,332,332,9,1,8,2,1
6,334,334,9,4,5,2,1
9,347,347,67,16,51,3,2
4,385,385,91,51,40,2,1
10,403,403,17,17,0,1,0
1,404,404,75,75,0,1,0

2,108,108,4,4,0,1,0
13,128,128,5,5,0,1,0
16,152,152,17,17,0,1,0
3,171,171,25,1,24,4,3
7,200,200,1,1,0,1,0
15,204,204,6,3,3,2,1
11,252,252,13,3,10,2,1
8,261,261,10,10,0,1,0
10,263,263,13,6,7,2,1
0,280,280,20,11,9,4,3
1,285,285,5,5,0,1,0
5,346,346,12,12,0,1,0
6,363,363,26,10,16,2,1
4,371,371,14,14,0,1,0
12,381,381,24,13,11,2,1
14,403,403,127,111,16,3,2
9,467,467,44,44,0,1,0

13,189,189,3,3,0,1,0
8,196,196,1,1,0,1,0
1,224,224,17,9,8,2,1
2,245,245,1,1,0,1,0
9,249,249,18,18,0,1,0
0,268,268,15,15,0,1,0
5,270,270,3,3,0,1,0
3,309,309,23,23,0,1,0
11,311,311,7,7,0,1,0
6,329,329,5,5,0,1,0
10,339,339,61,44,17,2,1
4,362,362,47,47,0,1,0
7,382,382,61,57,4,2,1
12,452,452,159,150,9,4,3
15,465,465,14,14,0,1,0
14,497,497,5,1,4,2,1

14,117,117,10,4,6,2,1
12,140,140,8,8,0,1,0
0,164,164,1,1,0,1,0
10,178,178,18,18,0,1,0
2,183,183,20,12,8,2,1
3,194,194,9,2,7,2,1
13,218,218,28,10,18,3,2
6,285,285,2,2,0,1,0
7,322,322,4,1,3,2,1
9,388,388,14,10,4,2,1
4,395,395,3,3,0,1,0
8,456,456,150,53,97,4,3
11,464,464,98,48,50,3,2
1,480,480,33,33,0,1,0
5,492,492,7,7,0,1,0

7,169,169,6,6,0,1,0
3,175,175,4,4,0,1,0
10,187,187,2,2,0,1,0
12,226,226,14,14,0,1,0
5,271,271,34,7,27,3,2
6,272,272,2,2,0,1,0
0,285,285,24,10,14,3,2
1,301,301,51,51,0,1,0
8,345,345,78,78,0,1,0
9,359,359,86,4,82,3,2
11,418,418,18,18,0,1,0
2,476,476,23,5,18,3,2
4,486,486,70,70,0,1,0

12,162,162,20,6,14,3,2
3,169,169,21,3,18,4,3
9,198,198,6,6,0,1,0
11,208,208,30,24,6,3,2
6,238,238,6,6,0,1,0
4,292,292,4,4,0,1,0
8,321,321,15,6,9,4,3
10,374,374,34,34,0,1,0
2,385,385,95,50,45,2,1
5,391,391,4,4,0,1,0
1,458,458,80,80,0,1,0
7,463,463,82,31,51,4,3
0,467,467,4,4,0,1,0

2,157,157,3,3,0,1,0
8,233,233,8,8,0,1,0
10,313,313,36,9,27,4,3
1,349,349,7,4,3,2,1
4,353,353,103,103,0,1,0
5,374,374,32,1,31,2,1
13,387,387,107,91,16,2,1
12,406,406,36,36,0,1,0
6,412,412,28,10,18,2,1
3,417,417,11,11,0,1,0
0,421,421,25,25,0,1,0
7,440,440,14,2,12,3,2
11,448,448,38,16,22,2,1
9,485,485,4,4,0,1,0

11,113,113,29,29,0,1,0
2,132,132,9,3,6,2,1
5,154,154,14,2,12,4,3
8,166,166,14,3,11,2,1
7,253,253,6,3,3,2,1
1,304,304,35,35,0,1,0
9,342,342,46,32,14,2,1
0,351,351,39,39,0,1,0
3,370,370,64,6,58,4,3
4,378,378,18,6,12,4,3
10,424,424,40,32,8,3,2
6,467,467,12,12,0,1,0

9,170,170,21,21,0,1,0
5,175,175,7,7,0,1,0
2,189,189,30,27,3,2,1
1,203,203,1,1,0,1,0
6,236,236,2,2,0,1,0
11,287,287,76,13,63,4,3
7,295,295,24,24,0,1,0
10,308,308,32,32,0,1,0
8,409,409,12,12,0,1,0
0,420,420,47,47,0,1,0
4,483,483,58,44,14,3,2
3,494,494,82,82,0,1,0

5,170,170,4,1,3,2,1
1,173,173,6,3,3,2,1
2,188,188,13,13,0,1,0
10,250,250,16,8,8,3,2
6,318,318,11,11,0,1,0
8,330,330,55,55,0,1,0
4,337,337,62,62,0,1,0
7,339,339,9,1,8,3,2
9,425,425,21,1,20,4,3
3,428,428,54,54,0,1,0
0,434,434,71,71,0,1,0
11,436,436,118,118,0,1,0

9,227,227,19,2,17,2,1
1,231,231,40,24,16,3,2
2,279,279,8,2,6,2,1
5,286,286,1,1,0,1,0
13,298,298,44,44,0,1,0
0,300,300,30,18,12,3,2
4,316,316,22,22,0,1,0
11,343,343,25,25,0,1,0
8,366,366,8,8,0,1,0
12,377,377,1,1,0,1,0
14,391,391,109,109,0,1,0
3,401,401,53,53,0,1,0
6,412,412,20,20,0,1,0
7,498,498,12,8,4,2,1
10,499,499,11,3,8,3,2

6,208,208,8,8,0,1,0
7,287,287,39,39,0,1,0
0,304,304,52,34,18,4,3
2,335,335,133,34,99,4,3
4,398,398,8,8,0,1,0
8,409,409,4,4,0,1,0
5,418,418,73,34,39,3,2
3,494,494,116,52,64,3,2
1,496,496,17,6,11,2,1

6,120,120,30,8,22,3,2
10,181,181,19,10,9,2,1
9,311,311,10,5,5,2,1
3,347,347,6,6,0,1,0
7,362,362,27,27,0,1,0
11,400,400,18,18,0,1,0
2,407,407,78,50,28,2,1
1,419,419,3,3,0,1,0
8,453,453,46,16,30,4,3
5,455,455,51,51,0,1,0
4,480,480,112,112,0,1,0
0,498,498,20,20,0,1,0

9,113,113,2,2,0,1,0
6,218,218,20,9,11,2,1
5,221,221,24,3,21,3,2
3,270,270,27,27,0,1,0
8,278,278,52,40,12,2,1
2,345,345,60,30,30,3,2
4,351,351,35,35,0,1,0
0,362,362,49,49,0,1,0
1,370,370,71,13,58,3,2
7,480,480,53,53,0,1,0

9,106,106,19,3,16,2,1
11,150,150,5,5,0,1,0
1,156,156,7,7,0,1,0
7,163,163,37,16,21,2,1
10,170,170,8,8,0,1,0
4,187,187,39,30,9,2,1
8,249,249,26,26,0,1,0
0,282,282,8,8,0,1,0
6,285,285,9,9,0,1,0
5,370,370,33,33,0,1,0
2,476,476,38,38,0,1,0
3,477,477,72,37,35,2,1

7,130,130,5,5,0,1,0
2,141,141,24,24,0,1,0
8,167,167,11,3,8,2,1
1,239,239,5,5,0,1,0
12,246,246,35,32,3,2,1
4,250,250,13,13,0,1,0
11,261,261,9,3,6,2,1
3,290,290,13,1,12,2,1
5,314,314,46,15,31,4,3
13,356,356,62,62,0,1,0
9,357,357,67,31,36,4,3
6,387,387,11,11,0,1,0
0,453,453,45,45,0,1,0
10,463,463,2,2,0,1,0

0,104,104,34,3,31,2,1
7,131,131,3,3,0,1,0
5,213,213,7,7,0,1,0
4,361,361,23,23,0,1,0
2,367,367,14,14,0,1,0
1,371,371,88,63,25,2,1
3,434,434,67,45,22,2,1
6,458,458,105,69,36,4,3
8,494,494,54,54,0,1,0

12,100,100,1,1,0,1,0
6,101,101,22,22,0,1,0
7,135,135,24,24,0,1,0
5,205,205,1,1,0,1,0
10,272,272,16,12,4,2,1
1,337,337,26,26,0,1,0
11,393,393,162,153,9,2,1
4,406,406,6,6,0,1,0
8,407,407,28,1,27,3,2
2,444,444,1,1,0,1,0
0,458,458,45,41,4,2,1
9,471,471,29,29,0,1,0
13,478,478,1,1,0,1,0
3,494,494,4,4,0,1,0

1,170,170,1,1,0,1,0
3,193,193,18,2,16,3,2
11,226,226,45,45,0,1,0
7,288,288,1,1,0,1,0
9,298,298,62,8,54,3,2
2,300,300,27,27,0,1,0
0,340,340,4,4,0,1,0
5,375,375,61,26,35,2,1
10,399,399,27,27,0,1,0
4,460,460,109,28,81,4,3
8,470,470,22,6,16,3,2
6,496,496,42,42,0,1,0

7,125,125,9,9,0,1,0
12,133,133,6,3,3,2,1
13,149,149,9,3,6,3,2
15,183,183,32,32,0,1,0
5,210,210,3,3,0,1,0
14,216,216,32,32,0,1,0
6,253,253,13,4,9,4,3
8,295,295,51,39,12,4,3
9,339,339,37,25,12,4,3
0,386,386,17,2,15,4,3
11,414,414,27,27,0,1,0
10,450,450,58,58,0,1,0
4,463,463,2,2,0,1,0
3,465,465,6,6,0,1,0
1,469,469,40,4,36,3,2
2,498,498,18,2,16,3,2

3,147,147,1,1,0,1,0
9,184,184,29,29,0,1,0
2,197,197,16,16,0,1,0
5,301,301,37,37,0,1,0
4,304,304,3,3,0,1,0
0,309,309,43,43,0,1,0
1,345,345,129,122,7,2,1
6,381,381,21,9,12,3,2
7,422,422,103,46,57,4,3
8,436,436,8,8,0,1,0

14,127,127,22,10,12,4,3
6,143,143,6,2,4,2,1
12,166,166,34,21,13,2,1
5,183,183,12,4,8,3,2
10,189,189,6,6,0,1,0
9,272,272,1,1,0,1,0
4,275,275,1,1,0,1,0
11,316,316,19,1,18,2,1
8,338,338,5,5,0,1,0
7,340,340,58,58,0,1,0
1,359,359,10,10,0,1,0
16,392,392,54,54,0,1,0
15,415,415,10,2,8,2,1
3,423,423,35,35,0,1,0
13,451,451,17,17,0,1,0
2,461,461,6,6,0,1,0
0,481,481,42,5,37,2,1
17,492,492,17,17,0,1,0

2,110,110,23,5,18,4,3
6,162,162,21,21,0,1,0
8,203,203,3,3,0,1,0
0,397,397,56,7,49,2,1
3,406,406,31,31,0,1,0
5,451,451,76,76,0,1,0
4,478,478,72,59,13,2,1
1,490,490,126,126,0,1,0
7,493,493,36,4,32,3,2

8,136,136,11,11,0,1,0
13,153,153,2,2,0,1,0
5,163,163,5,1,4,2,1
6,211,211,20,20,0,1,0
11,222,222,30,30,0,1,0
3,224,224,10,4,6,2,1
4,279,279,20,20,0,1,0
9,322,322,28,28,0,1,0
2,334,334,65,37,28,2,1
7,335,335,18,18,0,1,0
1,365,365,14,14,0,1,0
12,377,377,77,77,0,1,0
0,461,461,34,34,0,1,0
10,469,469,41,41,0,1,0

12,155,155,8,8,0,1,0
11,239,239,18,18,0,1,0
8,247,247,82,13,69,4,3
2,265,265,17,17,0,1,0
7,265,265,17,17,0,1,0
1,283,283,44,44,0,1,0
0,315,315,12,4,8,2,1
6,335,335,29,29,0,1,0
4,344,344,12,12,0,1,0
13,398,398,38,38,0,1,0
3,404,404,10,1,9,4,3
9,413,413,9,5,4,2,1
10,420,420,14,2,12,3,2
5,481,481,64,64,0,1,0

2,128,128,39,24,15,4,3
8,154,154,16,6,10,3,2
7,156,156,1,1,0,1,0
9,171,171,50,11,39,4,3
3,174,174,36,36,0,1,0
0,212,212,5,2,3,2,1
10,220,220,16,16,0,1,0
1,279,279,11,11,0,1,0
6,294,294,42,42,0,1,0
4,477,477,13,9,4,2,1
5,484,484,1,1,0,1,0

1,100,100,3,3,0,1,0
0,139,139,12,9,3,2,1
11,151,151,29,14,15,4,3
6,192,192,15,15,0,1,0
3,225,225,45,45,0,1,0
14,233,233,16,16,0,1,0
7,285,285,15,15,0,1,0
5,299,299,8,8,0,1,0
10,335,335,9,2,7,2,1
2,353,353,11,11,0,1,0
9,428,428,20,20,0,1,0
8,445,445,42,30,12,3,2
4,449,449,1,1,0,1,0
13,489,489,128,25,103,4,3
12,490,490,5,5,0,1,0

6,102,102,4,4,0,1,0
5,107,107,3,3,0,1,0
9,153,153,6,6,0,1,0
3,189,189,56,50,6,2,1
15,192,192,6,6,0,1,0
13,207,207,22,22,0,1,0
11,241,241,18,6,12,4,3
12,248,248,46,28,18,4,3
7,278,278,7,1,6,3,2
10,278,278,12,6,6,2,1
8,343,343,1,1,0,1,0
2,346,346,29,13,16,3,2
0,397,397,7,1,6,3,2
4,416,416,7,7,0,1,0
1,494,494,27,17,10,3,2
14,500,500,86,86,0,1,0

4,136,136,3,3,0,1,0
0,148,148,5,5,0,1,0
9,230,230,50,12,38,2,1
13,236,236,11,6,5,2,1
8,261,261,13,13,0,1,0
11,282,282,64,14,50,2,1
3,297,297,24,24,0,1,0
5,304,304,4,4,0,1,0
7,346,346,40,21,19,2,1
12,358,358,2,2,0,1,0
2,365,365,42,24,18,2,1
14,390,390,25,12,13,2,1
6,394,394,1,1,0,1,0
1,447,447,75,75,0,1,0
10,497,497,23,23,0,1,0

6,130,130,8,2,6,3,2
9,135,135,21,3,18,3,2
8,206,206,4,4,0,1,0
13,256,256,10,10,0,1,0
12,261,261,22,22,0,1,0
5,288,288,13,4,9,2,1
2,308,308,30,30,0,1,0
1,343,343,52,22,30,3,2
3,345,345,20,9,11,2,1
11,364,364,13,1,12,2,1
0,368,368,30,6,24,4,3
10,439,439,125,26,99,4,3
7,473,473,48,3,45,2,1
4,488,488,2,2,0,1,0

0,110,110,1,1,0,1,0
10,122,122,10,10,0,1,0
3,126,126,4,4,0,1,0
7,138,138,1,1,0,1,0
2,154,154,24,6,18,4,3
13,191,191,13,6,7,2,1
11,275,275,1,1,0,1,0
1,308,308,1,1,0,1,0
4,321,321,5,5,0,1,0
5,328,328,22,22,0,1,0
16,343,343,13,13,0,1,0
15,348,348,38,27,11,2,1
14,355,355,32,12,20,2,1
6,359,359,12,4,8,2,1
9,394,394,21,3,18,2,1
17,442,442,41,21,20,2,1
18,444,444,95,34,61,3,2
12,462,462,14,3,11,2,1
8,489,489,53,53,0,1,0

10,107,107,2,2,0,1,0
5,113,113,10,2,8,2,1
3,118,118,3,3,0,1,0
11,146,146,24,24,0,1,0
7,157,157,15,6,9,4,3
9,220,220,50,2,48,2,1
0,234,234,86,86,0,1,0
4,257,257,1,1,0,1,0
6,396,396,21,21,0,1,0
1,458,458,48,18,30,4,3
2,462,462,6,6,0,1,0
8,465,465,26,26,0,1,0

0,107,107,5,5,0,1,0
11,126,126,1,1,0,1,0
7,130,130,2,2,0,1,0
8,158,158,49,49,0,1,0
1,233,233,57,19,38,2,1
2,238,238,1,1,0,1,0
3,264,264,77,77,0,1,0
5,271,271,3,3,0,1,0
6,380,380,40,40,0,1,0
9,389,389,36,24,12,3,2
4,440,440,1,1,0,1,0
10,488,488,38,14,24,4,3

4,124,124,16,16,0,1,0
10,127,127,26,17,9,2,1
7,171,171,17,17,0,1,0
3,195,195,8,2,6,3,2
0,215,215,39,31,8,2,1
9,219,219,18,8,10,2,1
5,226,226,2,2,0,1,0
2,236,236,32,14,18,4,3
11,293,293,5,1,4,2,1
6,310,310,19,19,0,1,0
8,371,371,56,18,38,3,2
1,389,389,41,41,0,1,0

8,106,106,12,12,0,1,0
1,171,171,1,1,0,1,0
7,171,171,20,6,14,2,1
2,173,173,40,30,10,2,1
5,179,179,7,1,6,2,1
6,252,252,9,3,6,2,1
3,267,267,11,11,0,1,0
9,297,297,48,41,7,2,1
4,355,355,53,53,0,1,0
0,368,368,119,29,90,3,2

15,138,138,2,2,0,1,0
14,169,169,21,21,0,1,0
2,189,189,14,14,0,1,0
3,195,195,1,1,0,1,0
0,219,219,4,4,0,1,0
6,236,236,2,2,0,1,0
5,249,249,59,20,39,3,2
11,270,270,64,41,23,4,3
8,303,303,14,9,5,2,1
13,311,311,12,8,4,2,1
10,343,343,13,13,0,1,0
1,415,415,7,7,0,1,0
4,434,434,34,34,0,1,0
9,448,448,37,32,5,2,1
12,450,450,72,41,31,2,1
7,468,468,16,10,6,3,2

0,122,122,7,7,0,1,0
2,144,144,1,1,0,1,0
16,147,147,7,7,0,1,0
1,149,149,3,3,0,1,0
3,163,163,7,4,3,2,1
6,187,187,4,1,3,2,1
8,205,205,13,5,8,3,2
5,213,213,9,9,0,1,0
7,234,234,6,6,0,1,0
12,245,245,19,10,9,2,1
13,311,311,72,42,30,3,2
14,317,317,23,11,12,3,2
15,341,341,2,2,0,1,0
4,344,344,29,19,10,2,1
9,384,384,2,2,0,1,0
11,397,397,30,30,0,1,0
10,412,412,64,64,0,1,0
17,444,444,78,78,0,1,0

2,101,101,4,1,3,2,1
3,126,126,11,7,4,2,1
10,130,130,10,10,0,1,0
9,147,147,40,2,38,2,1
0,150,150,45,3,42,2,1
6,226,226,3,3,0,1,0
1,233,233,2,2,0,1,0
5,301,301,6,2,4,2,1
4,391,391,57,57,0,1,0
11,451,451,36,22,14,3,2
7,468,468,34,34,0,1,0
8,477,477,46,12,34,3,2

0,164,164,8,8,0,1,0
7,193,193,12,3,9,4,3
2,297,297,32,32,0,1,0
6,356,356,30,30,0,1,0
1,372,372,7,7,0,1,0
11,372,372,51,21,30,4,3
3,380,380,25,25,0,1,0
8,380,380,60,60,0,1,0
4,390,390,46,11,35,2,1
5,408,408,65,65,0,1,0
10,436,436,3,3,0,1,0
12,446,446,31,25,6,2,1
9,455,455,79,79,0,1,0

10,111,111,1,1,0,1,0
7,121,121,2,2,0,1,0
3,144,144,3,3,0,1,0
16,166,166,15,8,7,2,1
6,170,170,1,1,0,1,0
9,214,214,22,22,0,1,0
4,265,265,1,1,0,1,0
0,270,270,7,1,6,3,2
2,282,282,1,1,0,1,0
1,290,290,2,2,0,1,0
17,291,291,3,3,0,1,0
13,325,325,52,16,36,3,2
12,356,356,4,4,0,1,0
18,360,360,4,4,0,1,0
11,365,365,33,8,25,2,1
8,390,390,13,1,12,2,1
5,402,402,45,45,0,1,0
15,441,441,48,48,0,1,0
19,464,464,128,56,72,3,2
14,479,479,54,45,9,4,3

12,104,104,19,11,8,2,1
13,121,121,8,8,0,1,0
11,123,123,8,8,0,1,0
1,151,151,5,5,0,1,0
10,155,155,32,32,0,1,0
4,205,205,12,4,8,3,2
3,244,244,9,9,0,1,0
6,264,264,50,50,0,1,0
5,277,277,11,3,8,2,1
0,307,307,5,2,3,2,1
8,357,357,11,11,0,1,0
7,397,397,77,77,0,1,0
9,458,458,33,33,0,1,0
2,486,486,1,1,0,1,0
14,488,488,10,10,0,1,0

4,108,108,21,13,8,3,2
5,120,120,6,1,5,2,1
6,157,157,13,1,12,3,2
9,201,201,51,27,24,2,1
3,204,204,24,14,10,3,2
10,222,222,31,13,18,4,3
1,350,350,11,1,10,2,1
2,374,374,10,10,0,1,0
8,375,375,28,28,0,1,0
0,385,385,90,81,9,4,3
7,437,437,5,5,0,1,0

11,107,107,32,2,30,4,3
5,122,122,2,2,0,1,0
1,141,141,7,7,0,1,0
6,151,151,23,13,10,3,2
9,235,235,3,3,0,1,0
0,265,265,2,2,0,1,0
3,278,278,34,34,0,1,0
8,281,281,1,1,0,1,0
10,382,382,16,16,0,1,0
7,431,431,44,40,4,2,1
2,444,444,128,44,84,3,2
4,469,469,56,56,0,1,0

7,127,127,7,7,0,1,0
0,132,132,73,73,0,1,0
2,163,163,4,4,0,1,0
8,246,246,28,28,0,1,0
4,351,351,94,94,0,1,0
6,373,373,20,3,17,4,3
3,436,436,28,28,0,1,0
1,469,469,13,7,6,2,1
5,477,477,27,13,14,3,2

5,108,108,5,5,0,1,0
1,142,142,10,10,0,1,0
3,233,233,13,13,0,1,0
9,257,257,7,3,4,2,1
8,294,294,21,3,18,4,3
2,333,333,32,32,0,1,0
13,352,352,12,4,8,3,2
7,368,368,1,1,0,1,0
0,374,374,15,15,0,1,0
4,404,404,54,54,0,1,0
11,432,432,96,96,0,1,0
12,457,457,58,58,0,1,0
10,458,458,59,59,0,1,0
6,459,459,72,33,39,2,1

7,117,117,2,2,0,1,0
15,220,220,8,8,0,1,0
3,238,238,4,4,0,1,0
1,251,251,26,26,0,1,0
14,299,299,2,2,0,1,0
9,305,305,22,22,0,1,0
6,308,308,10,4,6,3,2
10,311,311,8,8,0,1,0
13,347,347,62,32,30,4,3
5,380,380,30,30,0,1,0
8,400,400,9,1,8,2,1
2,440,440,29,22,7,2,1
12,454,454,47,8,39,2,1
0,462,462,28,28,0,1,0
4,479,479,63,63,0,1,0
11,488,488,125,97,28,4,3

3,107,107,10,10,0,1,0
12,121,121,3,3,0,1,0
7,203,203,29,9,20,3,2
4,204,204,14,11,3,2,1
8,207,207,73,66,7,2,1
2,219,219,5,5,0,1,0
9,227,227,3,3,0,1,0
11,251,251,7,7,0,1,0
5,268,268,9,3,6,3,2
1,309,309,100,58,42,2,1
0,416,416,5,5,0,1,0
6,456,456,21,21,0,1,0
10,469,469,24,24,0,1,0

9,147,147,1,1,0,1,0
2,155,155,1,1,0,1,0
8,171,171,11,11,0,1,0
4,204,204,20,5,15,4,3
6,225,225,8,8,0,1,0
5,239,239,20,3,17,2,1
11,264,264,44,44,0,1,0
7,371,371,44,12,32,3,2
12,391,391,29,29,0,1,0
10,397,397,70,39,31,2,1
1,465,465,34,4,30,3,2
3,478,478,21,4,17,4,3
0,496,496,130,7,123,4,3

10,170,170,4,4,0,1,0
8,187,187,28,28,0,1,0
7,207,207,15,2,13,2,1
5,235,235,8,8,0,1,0
6,254,254,80,20,60,4,3
3,280,280,12,12,0,1,0
11,287,287,2,2,0,1,0
1,306,306,69,11,58,4,3
2,334,334,1,1,0,1,0
9,374,374,19,2,17,2,1
0,428,428,20,20,0,1,0
4,432,432,108,33,75,4,3

4,112,112,13,8,5,2,1
6,114,114,16,16,0,1,0
13,140,140,5,5,0,1,0
1,152,152,22,10,12,3,2
10,152,152,40,40,0,1,0
7,212,212,2,2,0,1,0
9,270,270,10,10,0,1,0
5,313,313,4,4,0,1,0
3,327,327,7,7,0,1,0
8,341,341,52,52,0,1,0
0,430,430,37,5,32,2,1
11,439,439,52,52,0,1,0
12,475,475,1,1,0,1,0
2,495,495,35,11,24,4,3

13,109,109,20,14,6,2,1
6,114,114,1,1,0,1,0
10,116,116,26,18,8,2,1
11,152,152,4,4,0,1,0
5,217,217,15,7,8,3,2
1,228,228,21,8,13,2,1
2,248,248,19,6,13,2,1
12,250,250,37,37,0,1,0
0,274,274,46,46,0,1,0
8,280,280,5,5,0,1,0
7,332,332,13,13,0,1,0
9,341,341,5,5,0,1,0
3,456,456,64,1,63,4,3
4,493,493,4,1,3,2,1

6,119,119,8,8,0,1,0
4,185,185,2,2,0,1,0
8,205,205,5,5,0,1,0
7,256,256,26,16,10,2,1
5,360,360,62,62,0,1,0
1,364,364,58,2,56,4,3
12,415,415,33,14,19,2,1
9,417,417,156,156,0,1,0
11,419,419,7,1,6,3,2
2,434,434,20,20,0,1,0
3,450,450,5,1,4,2,1
10,479,479,6,2,4,2,1
0,484,484,66,9,57,3,2

6,166,166,1,1,0,1,0
3,227,227,10,10,0,1,0
1,297,297,31,9,22,2,1
0,329,329,25,4,21,2,1
4,333,333,48,39,9,4,3
8,348,348,80,74,6,2,1
2,425,425,32,32,0,1,0
9,434,434,9,4,5,2,1
10,454,454,4,4,0,1,0
7,464,464,62,62,0,1,0
5,469,469,74,68,6,3,2
11,492,492,104,104,0,1,0

1,134,134,1,1,0,1,0
5,155,155,4,4,0,1,0
7,156,156,34,34,0,1,0
6,224,224,29,14,15,4,3
2,228,228,40,40,0,1,0
3,244,244,12,12,0,1,0
4,285,285,96,96,0,1,0
10,331,331,31,31,0,1,0
0,350,350,2,2,0,1,0
8,366,366,11,11,0,1,0
9,465,465,61,61,0,1,0
11,470,470,3,3,0,1,0

7,118,118,11,11,0,1,0
8,222,222,17,11,6,3,2
6,254,254,3,3,0,1,0
10,255,255,56,24,32,2,1
11,299,299,37,37,0,1,0
0,321,321,16,7,9,2,1
1,328,328,45,45,0,1,0
2,412,412,36,36,0,1,0
3,416,416,111,111,0,1,0
5,416,416,3,3,0,1,0
4,485,485,26,26,0,1,0
9,485,485,44,25,19,2,1

5,122,122,8,8,0,1,0
4,222,222,11,11,0,1,0
9,255,255,1,1,0,1,0
2,293,293,74,74,0,1,0
7,329,329,53,8,45,4,3
3,330,330,58,58,0,1,0
1,391,391,24,10,14,3,2
10,401,401,80,80,0,1,0
0,451,451,28,10,18,4,3
8,484,484,30,15,15,4,3
6,495,495,60,30,30,4,3

7,162,162,33,4,29,2,1
9,186,186,23,23,0,1,0
3,202,202,21,8,13,4,3
2,207,207,4,4,0,1,0
11,214,214,26,13,13,2,1
10,249,249,26,14,12,2,1
5,296,296,65,27,38,3,2
6,318,318,54,54,0,1,0
12,384,384,3,3,0,1,0
4,393,393,3,3,0,1,0
0,439,439,34,34,0,1,0
1,443,443,1,1,0,1,0
8,454,454,23,23,0,1,0

9,145,145,31,31,0,1,0
10,146,146,6,6,0,1,0
2,152,152,28,28,0,1,0
7,156,156,11,1,10,3,2
5,190,190,1,1,0,1,0
4,210,210,39,9,30,4,3
12,235,235,43,43,0,1,0
8,245,245,9,9,0,1,0
3,293,293,2,2,0,1,0
0,343,343,4,4,0,1,0
1,443,443,17,17,0,1,0
11,473,473,33,33,0,1,0
6,482,482,81,15,66,4,3

5,106,106,7,7,0,1,0
2,109,109,8,8,0,1,0
10,125,125,17,11,6,2,1
0,133,133,25,25,0,1,0
6,182,182,8,8,0,1,0
4,185,185,7,1,6,3,2
1,327,327,13,13,0,1,0
7,350,350,45,45,0,1,0
8,439,439,27,8,19,2,1
9,478,478,85,58,27,3,2
3,496,496,131,85,46,4,3

6,215,215,3,3,0,1,0
3,304,304,25,25,0,1,0
0,323,323,35,35,0,1,0
7,326,326,57,45,12,2,1
4,339,339,2,2,0,1,0
5,431,431,101,93,8,2,1
1,470,470,232,206,26,2,1
2,494,494,47,47,0,1,0

6,201,201,6,2,4,2,1
4,250,250,64,64,0,1,0
1,252,252,15,3,12,4,3
8,341,341,35,3,32,2,1
11,345,345,23,23,0,1,0
3,359,359,19,19,0,1,0
5,366,366,15,10,5,2,1
9,410,410,23,23,0,1,0
2,412,412,61,61,0,1,0
10,417,417,42,42,0,1,0
0,465,465,20,5,15,2,1
7,488,488,123,123,0,1,0

1,119,119,12,4,8,2,1
11,166,166,2,2,0,1,0
6,172,172,38,14,24,2,1
4,183,183,5,1,4,2,1
8,231,231,12,12,0,1,0
9,331,331,59,59,0,1,0
2,377,377,30,30,0,1,0
7,390,390,13,10,3,2,1
0,392,392,52,20,32,2,1
3,434,434,100,76,24,4,3
10,469,469,53,53,0,1,0
5,499,499,15,3,12,2,1

4,124,124,7,7,0,1,0
10,141,141,10,10,0,1,0
11,216,216,16,4,12,2,1
7,219,219,6,6,0,1,0
3,243,243,43,9,34,2,1
1,262,262,10,5,5,2,1
5,265,265,9,9,0,1,0
12,284,284,40,15,25,4,3
0,329,329,2,2,0,1,0
6,343,343,82,42,40,4,3
9,444,444,36,33,3,2,1
8,457,457,100,100,0,1,0
2,492,492,25,25,0,1,0

7,109,109,10,10,0,1,0
3,117,117,7,7,0,1,0
11,173,173,38,38,0,1,0
9,198,198,18,13,5,2,1
10,241,241,13,13,0,1,0
0,252,252,39,28,11,2,1
8,276,276,18,2,16,3,2
4,311,311,44,31,13,2,1
1,327,327,25,5,20,2,1
2,346,346,31,18,13,2,1
5,473,473,37,37,0,1,0
6,492,492,45,45,0,1,0

0,104,104,9,9,0,1,0
14,113,113,2,2,0,1,0
2,126,126,1,1,0,1,0
3,126,126,1,1,0,1,0
11,160,160,3,3,0,1,0
1,187,187,2,2,0,1,0
13,212,212,39,39,0,1,0
18,218,218,32,10,22,2,1
15,250,250,20,5,15,2,1
17,257,257,35,13,22,2,1
9,282,282,37,8,29,2,1
16,329,329,18,4,14,3,2
8,345,345,17,17,0,1,0
7,367,367,8,8,0,1,0
12,405,405,40,6,34,3,2
5,436,436,60,60,0,1,0
4,486,486,11,11,0,1,0
10,495,495,3,3,0,1,0
6,496,496,1,1,0,1,0

2,108,108,16,16,0,1,0
9,117,117,10,5,5,2,1
1,170,170,45,21,24,3,2
3,203,203,27,27,0,1,0
7,212,212,16,10,6,3,2
8,279,279,4,4,0,1,0
5,333,333,44,44,0,1,0
6,421,421,62,3,59,4,3
4,461,461,72,72,0,1,0
0,495,495,27,27,0,1,0

3,120,120,4,4,0,1,0
6,129,129,15,15,0,1,0
7,132,132,20,20,0,1,0
0,232,232,45,3,42,2,1
8,261,261,17,17,0,1,0
5,362,362,59,23,36,3,2
4,368,368,43,23,20,2,1
10,381,381,19,10,9,2,1
1,427,427,58,58,0,1,0
9,454,454,32,32,0,1,0
2,498,498,61,15,46,3,2

8,107,107,2,2,0,1,0
1,168,168,23,10,13,2,1
2,328,328,29,2,27,4,3
0,344,344,129,29,100,3,2
4,377,377,12,12,0,1,0
6,384,384,49,25,24,4,3
5,411,411,14,6,8,3,2
3,437,437,42,42,0,1,0
7,445,445,136,32,104,4,3

4,101,101,5,5,0,1,0
7,123,123,6,6,0,1,0
0,132,132,21,21,0,1,0
6,154,154,36,36,0,1,0
3,187,187,67,3,64,3,2
5,239,239,65,54,11,2,1
1,328,328,1,1,0,1,0
9,335,335,4,4,0,1,0
2,475,475,38,38,0,1,0
8,498,498,1,1,0,1,0

6,113,113,25,10,15,2,1
2,145,145,41,41,0,1,0
5,156,156,24,24,0,1,0
0,157,157,12,12,0,1,0
7,220,220,3,3,0,1,0
3,226,226,51,51,0,1,0
4,233,233,2,2,0,1,0
1,274,274,5,5,0,1,0
8,341,341,9,6,3,2,1
9,456,456,89,89,0,1,0

1,121,121,1,1,0,1,0
13,148,148,30,30,0,1,0
6,159,159,13,13,0,1,0
12,170,170,4,4,0,1,0
7,182,182,12,12,0,1,0
5,216,216,10,10,0,1,0
0,253,253,51,51,0,1,0
3,277,277,21,10,11,2,1
2,280,280,3,3,0,1,0
11,305,305,53,53,0,1,0
9,313,313,53,10,43,2,1
4,316,316,35,35,0,1,0
10,318,318,11,4,7,2,1
8,437,437,6,6,0,1,0

3,156,156,15,5,10,3,2
1,168,168,1,1,0,1,0
11,168,168,21,21,0,1,0
9,194,194,6,6,0,1,0
2,239,239,14,6,8,3,2
16,243,243,8,8,0,1,0
6,248,248,21,21,0,1,0
13,310,310,1,1,0,1,0
10,315,315,18,5,13,3,2
15,345,345,14,10,4,2,1
7,372,372,27,1,26,2,1
0,391,391,2,2,0,1,0
8,408,408,36,7,29,3,2
4,422,422,1,1,0,1,0
5,454,454,45,45,0,1,0
12,471,471,132,78,54,3,2
14,481,481,63,17,46,3,2

12,112,112,9,9,0,1,0
7,157,157,15,15,0,1,0
9,158,158,14,4,10,2,1
11,163,163,20,20,0,1,0
14,172,172,28,6,22,2,1
0,194,194,4,1,3,2,1
1,215,215,46,19,27,4,3
13,256,256,23,23,0,1,0
2,271,271,13,6,7,2,1
6,290,290,22,4,18,4,3
8,323,323,2,2,0,1,0
3,382,382,1,1,0,1,0
10,467,467,34,34,0,1,0
4,477,477,28,21,7,2,1
5,483,483,38,5,33,4,3

5,110,110,2,2,0,1,0
0,112,112,1,1,0,1,0
1,172,172,13,13,0,1,0
11,251,251,34,1,33,4,3
9,283,283,52,13,39,2,1
7,298,298,54,18,36,2,1
6,367,367,19,10,9,4,3
2,425,425,19,19,0,1,0
4,454,454,57,30,27,2,1
3,461,461,154,94,60,4,3
10,488,488,22,4,18,4,3
8,497,497,6,6,0,1,0

11,112,112,2,2,0,1,0
0,122,122,1,1,0,1,0
5,127,127,20,20,0,1,0
16,138,138,10,1,9,4,3
10,158,158,7,7,0,1,0
2,205,205,8,8,0,1,0
9,232,232,4,4,0,1,0
12,261,261,6,6,0,1,0
13,264,264,20,20,0,1,0
6,326,326,2,2,0,1,0
15,356,356,82,82,0,1,0
8,361,361,73,38,35,2,1
14,365,365,74,74,0,1,0
1,377,377,13,13,0,1,0
17,381,381,2,2,0,1,0
7,439,439,4,1,3,2,1
3,443,443,6,1,5,2,1
4,475,475,26,26,0,1,0

1,101,101,43,21,22,4,3
5,157,157,5,5,0,1,0
0,217,217,39,34,5,2,1
2,219,219,14,8,6,3,2
3,234,234,42,33,9,4,3
7,277,277,17,17,0,1,0
6,394,394,12,7,5,2,1
4,435,435,107,2,105,4,3

3,151,151,7,4,3,2,1
9,190,190,41,2,39,2,1
5,205,205,3,3,0,1,0
8,273,273,16,1,15,4,3
10,301,301,65,13,52,3,2
7,372,372,35,1,34,3,2
0,428,428,53,3,50,2,1
1,430,430,68,68,0,1,0
4,433,433,43,43,0,1,0
2,474,474,77,70,7,2,1
6,476,476,4,4,0,1,0
11,499,499,6,6,0,1,0

9,104,104,17,17,0,1,0
7,146,146,18,6,12,3,2
8,212,212,17,7,10,2,1
5,219,219,10,10,0,1,0
2,327,327,31,12,19,2,1
10,360,360,50,32,18,4,3
3,361,361,120,96,24,2,1
6,385,385,25,20,5,2,1
0,392,392,15,15,0,1,0
1,439,439,54,14,40,4,3
4,451,451,6,3,3,2,1

3,144,144,6,6,0,1,0
13,178,178,25,25,0,1,0
0,181,181,16,13,3,2,1
9,251,251,51,51,0,1,0
1,285,285,39,35,4,2,1
7,324,324,34,4,30,2,1
5,331,331,51,25,26,2,1
11,340,340,27,15,12,4,3
6,341,341,4,4,0,1,0
14,353,353,43,16,27,4,3
2,365,365,19,4,15,4,3
8,365,365,3,3,0,1,0
12,395,395,11,5,6,2,1
10,402,402,14,1,13,2,1
4,458,458,2,2,0,1,0

16,143,143,11,2,9,2,1
2,171,171,10,3,7,3,2
5,175,175,3,3,0,1,0
4,180,180,8,8,0,1,0
15,181,181,17,9,8,3,2
0,194,194,6,6,0,1,0
6,206,206,22,22,0,1,0
1,284,284,3,3,0,1,0
12,289,289,22,8,14,3,2
9,340,340,30,30,0,1,0
3,381,381,4,4,0,1,0
8,382,382,24,4,20,2,1
10,382,382,42,42,0,1,0
13,439,439,9,9,0,1,0
11,445,445,126,107,19,2,1
14,464,464,28,28,0,1,0
7,496,496,30,13,17,2,1

4,110,110,11,3,8,2,1
8,185,185,22,22,0,1,0
2,195,195,8,8,0,1,0
12,204,204,6,6,0,1,0
9,248,248,28,28,0,1,0
13,284,284,73,46,27,4,3
11,331,331,1,1,0,1,0
1,350,350,3,3,0,1,0
5,370,370,3,3,0,1,0
6,397,397,62,62,0,1,0
10,398,398,35,13,22,3,2
3,430,430,81,60,21,3,2
7,473,473,13,13,0,1,0
0,498,498,35,1,34,3,2

9,100,100,7,7,0,1,0
0,167,167,13,4,9,2,1
3,175,175,12,12,0,1,0
2,217,217,1,1,0,1,0
7,258,258,73,54,19,4,3
5,309,309,69,69,0,1,0
10,339,339,9,9,0,1,0
6,398,398,81,3,78,3,2
8,409,409,2,2,0,1,0
11,410,410,11,6,5,2,1
1,437,437,15,10,5,2,1
4,459,459,88,4,84,3,2

6,116,116,7,1,6,2,1
7,212,212,26,23,3,2,1
1,236,236,80,6,74,3,2
5,240,240,1,1,0,1,0
0,309,309,81,38,43,4,3
3,334,334,64,57,7,2,1
4,335,335,31,23,8,3,2
2,397,397,54,28,26,3,2

7,196,196,4,4,0,1,0
11,200,200,3,3,0,1,0
8,202,202,21,21,0,1,0
1,246,246,28,23,5,2,1
3,271,271,23,23,0,1,0
5,274,274,33,33,0,1,0
14,309,309,23,23,0,1,0
4,369,369,15,9,6,3,2
6,404,404,16,2,14,2,1
2,432,432,24,24,0,1,0
9,436,436,33,27,6,2,1
10,450,450,18,18,0,1,0
12,450,450,91,20,71,4,3
0,475,475,10,4,6,2,1
13,482,482,97,97,0,1,0

12,135,135,21,21,0,1,0
0,169,169,36,29,7,2,1
1,213,213,20,6,14,4,3
7,223,223,15,15,0,1,0
9,225,225,25,8,17,2,1
13,238,238,3,3,0,1,0
8,264,264,11,11,0,1,0
2,287,287,9,9,0,1,0
4,352,352,11,4,7,2,1
5,438,438,1,1,0,1,0
3,470,470,59,12,47,2,1
11,470,470,106,30,76,3,2
10,484,484,30,30,0,1,0
6,486,486,18,10,8,3,2

3,137,137,55,55,0,1,0
0,168,168,20,4,16,2,1
4,208,208,2,2,0,1,0
6,231,231,18,18,0,1,0
1,242,242,110,101,9,2,1
8,277,277,5,5,0,1,0
5,343,343,24,24,0,1,0
2,362,362,10,10,0,1,0
7,499,499,19,19,0,1,0

6,135,135,10,10,0,1,0
1,158,158,1,1,0,1,0
7,172,172,21,21,0,1,0
10,184,184,1,1,0,1,0
0,205,205,29,7,22,3,2
4,253,253,5,5,0,1,0
5,268,268,26,26,0,1,0
3,316,316,48,28,20,2,1
9,364,364,19,19,0,1,0
12,378,378,21,21,0,1,0
8,436,436,20,20,0,1,0
11,457,457,150,58,92,4,3
2,493,493,54,54,0,1,0

6,149,149,11,1,10,2,1
2,153,153,1,1,0,1,0
10,163,163,34,2,32,2,1
1,228,228,42,37,5,2,1
0,248,248,52,21,31,2,1
7,309,309,3,3,0,1,0
11,318,318,66,32,34,2,1
3,321,321,12,3,9,2,1
5,335,335,23,3,20,2,1
4,454,454,43,43,0,1,0
8,470,470,45,45,0,1,0
9,473,473,8,8,0,1,0

2,169,169,32,10,22,2,1
6,171,171,2,2,0,1,0
3,265,265,31,6,25,3,2
0,275,275,80,80,0,1,0
9,300,300,17,17,0,1,0
7,322,322,87,66,21,4,3
1,342,342,1,1,0,1,0
8,406,406,26,18,8,3,2
4,411,411,71,39,32,4,3
5,479,479,18,8,10,3,2

3,128,128,1,1,0,1,0
2,170,170,7,1,6,3,2
1,180,180,22,4,18,3,2
4,181,181,66,24,42,4,3
7,197,197,30,21,9,4,3
6,328,328,52,3,49,3,2
8,334,334,35,35,0,1,0
5,355,355,26,26,0,1,0
0,427,427,29,1,28,4,3
10,436,436,14,3,11,2,1
9,500,500,45,45,0,1,0

9,132,132,21,21,0,1,0
0,155,155,26,26,0,1,0
3,188,188,49,49,0,1,0
6,292,292,33,20,13,2,1
10,325,325,41,41,0,1,0
8,327,327,1,1,0,1,0
2,358,358,15,9,6,2,1
4,434,434,42,20,22,2,1
7,439,439,29,1,28,2,1
5,444,444,63,63,0,1,0
1,486,486,17,8,9,2,1

3,108,108,7,7,0,1,0
7,144,144,23,23,0,1,0
6,166,166,12,12,0,1,0
9,167,167,1,1,0,1,0
8,238,238,79,43,36,3,2
10,357,357,5,5,0,1,0
5,404,404,14,5,9,4,3
1,405,405,13,13,0,1,0
4,410,410,58,34,24,4,3
11,421,421,10,3,7,2,1
0,452,452,38,24,14,2,1
2,491,491,120,90,30,3,2

5,104,104,13,4,9,4,3
1,121,121,1,1,0,1,0
8,134,134,12,6,6,2,1
3,215,215,3,3,0,1,0
12,226,226,44,4,40,2,1
9,232,232,10,2,8,3,2
0,242,242,80,80,0,1,0
6,254,254,22,17,5,2,1
10,284,284,3,3,0,1,0
2,414,414,1,1,0,1,0
4,427,427,15,7,8,3,2
11,460,460,116,73,43,4,3
7,470,470,11,5,6,3,2

9,104,104,8,8,0,1,0
10,113,113,26,6,20,2,1
4,114,114,4,4,0,1,0
8,163,163,2,2,0,1,0
0,174,174,2,2,0,1,0
2,197,197,26,26,0,1,0
3,272,272,5,5,0,1,0
12,285,285,35,23,12,4,3
7,301,301,15,15,0,1,0
6,330,330,24,24,0,1,0
13,338,338,46,46,0,1,0
1,342,342,8,8,0,1,0
11,363,363,13,13,0,1,0
5,435,435,112,106,6,2,1

2,106,106,5,2,3,2,1
1,117,117,1,1,0,1,0
9,132,132,13,8,5,2,1
0,136,136,5,1,4,2,1
5,156,156,6,6,0,1,0
4,199,199,11,2,9,4,3
13,251,251,2,2,0,1,0
14,254,254,82,82,0,1,0
8,267,267,61,33,28,2,1
12,286,286,25,4,21,2,1
6,307,307,9,9,0,1,0
10,382,382,34,34,0,1,0
7,398,398,61,61,0,1,0
11,469,469,4,4,0,1,0
3,473,473,2,2,0,1,0

8,136,136,5,1,4,2,1
4,193,193,1,1,0,1,0
2,206,206,2,2,0,1,0
1,256,256,14,5,9,2,1
11,288,288,14,11,3,2,1
9,291,291,102,63,39,4,3
6,317,317,27,11,16,3,2
3,340,340,42,42,0,1,0
12,347,347,10,4,6,3,2
5,356,356,11,8,3,2,1
7,419,419,33,15,18,3,2
0,422,422,90,50,40,2,1
10,465,465,51,51,0,1,0
13,496,496,20,20,0,1,0

3,155,155,25,21,4,2,1
1,162,162,8,5,3,2,1
5,217,217,43,43,0,1,0
7,247,247,9,9,0,1,0
2,250,250,21,9,12,2,1
9,302,302,86,40,46,4,3
10,304,304,2,2,0,1,0
8,333,333,38,34,4,2,1
4,364,364,26,18,8,2,1
11,390,390,7,1,6,2,1
6,442,442,65,49,16,2,1
0,474,474,17,6,11,2,1

11,103,103,1,1,0,1,0
1,106,106,9,4,5,2,1
8,215,215,62,62,0,1,0
6,227,227,53,17,36,3,2
0,229,229,10,4,6,3,2
2,265,265,1,1,0,1,0
10,321,321,60,60,0,1,0
4,339,339,50,50,0,1,0
7,374,374,33,33,0,1,0
12,384,384,11,3,8,3,2
9,385,385,5,1,4,2,1
3,406,406,22,22,0,1,0
5,455,455,15,15,0,1,0

6,156,156,26,8,18,2,1
4,174,174,35,35,0,1,0
10,174,174,5,5,0,1,0
11,187,187,13,13,0,1,0
0,196,196,12,12,0,1,0
2,245,245,1,1,0,1,0
5,255,255,2,2,0,1,0
7,281,281,6,1,5,2,1
8,310,310,44,44,0,1,0
9,444,444,78,3,75,4,3
1,449,449,106,88,18,2,1
3,466,466,42,42,0,1,0

7,199,199,27,27,0,1,0
0,217,217,104,14,90,3,2
6,229,229,23,19,4,2,1
1,266,266,14,2,12,3,2
8,299,299,18,18,0,1,0
5,389,389,44,34,10,2,1
3,397,397,48,48,0,1,0
4,433,433,35,35,0,1,0
2,468,468,32,32,0,1,0

5,113,113,16,1,15,3,2
0,166,166,2,2,0,1,0
4,177,177,1,1,0,1,0
2,183,183,3,3,0,1,0
9,213,213,10,2,8,3,2
1,255,255,26,26,0,1,0
12,255,255,22,22,0,1,0
7,361,361,22,22,0,1,0
8,369,369,44,11,33,4,3
3,388,388,43,1,42,4,3
10,408,408,4,1,3,2,1
14,436,436,58,58,0,1,0
13,441,441,137,43,94,3,2
6,446,446,14,2,12,4,3
11,499,499,13,13,0,1,0

1,126,126,42,42,0,1,0
8,145,145,1,1,0,1,0
9,158,158,73,47,26,2,1
2,179,179,29,14,15,4,3
7,180,180,11,1,10,2,1
10,270,270,1,1,0,1,0
0,271,271,5,1,4,2,1
4,288,288,12,9,3,2,1
6,300,300,4,4,0,1,0
3,362,362,17,1,16,3,2
5,426,426,27,27,0,1,0

13,111,111,9,9,0,1,0
2,218,218,9,2,7,2,1
6,227,227,19,10,9,2,1
4,257,257,2,2,0,1,0
14,284,284,44,31,13,2,1
10,286,286,18,1,17,2,1
12,307,307,2,2,0,1,0
11,348,348,30,30,0,1,0
3,349,349,5,5,0,1,0
8,353,353,29,29,0,1,0
1,361,361,1,1,0,1,0
5,387,387,48,48,0,1,0
9,393,393,89,71,18,3,2
0,452,452,36,25,11,2,1
7,461,461,76,47,29,2,1

10,173,173,17,17,0,1,0
5,200,200,2,2,0,1,0
0,208,208,3,3,0,1,0
3,232,232,53,53,0,1,0
2,260,260,15,2,13,2,1
11,297,297,6,6,0,1,0
4,320,320,16,16,0,1,0
7,422,422,99,51,48,2,1
8,423,423,49,49,0,1,0
12,439,439,42,11,31,2,1
9,455,455,22,11,11,2,1
6,458,458,98,4,94,3,2
1,485,485,13,3,10,3,2

5,200,200,20,1,19,4,3
10,230,230,23,7,16,4,3
12,234,234,42,42,0,1,0
8,239,239,10,2,8,2,1
1,250,250,22,12,10,3,2
3,300,300,5,5,0,1,0
2,314,314,31,31,0,1,0
4,370,370,23,23,0,1,0
6,379,379,25,14,11,2,1
9,382,382,14,14,0,1,0
7,421,421,87,5,82,3,2
0,471,471,80,47,33,2,1
11,472,472,22,4,18,2,1

2,122,122,1,1,0,1,0
0,143,143,40,2,38,3,2
9,213,213,39,39,0,1,0
6,262,262,47,21,26,2,1
4,285,285,33,6,27,4,3
8,297,297,15,15,0,1,0
1,340,340,33,33,0,1,0
5,365,365,2,2,0,1,0
3,428,428,93,93,0,1,0
7,449,449,33,3,30,2,1

4,181,181,29,6,23,2,1
0,203,203,2,2,0,1,0
3,256,256,56,56,0,1,0
6,283,283,60,60,0,1,0
8,334,334,13,1,12,2,1
2,359,359,6,6,0,1,0
7,369,369,18,6,12,4,3
5,383,383,50,36,14,3,2
1,411,411,146,116,30,3,2
9,451,451,9,9,0,1,0

2,168,168,25,25,0,1,0
10,172,172,8,8,0,1,0
11,178,178,14,14,0,1,0
1,279,279,21,21,0,1,0
6,312,312,34,34,0,1,0
12,316,316,17,5,12,2,1
4,332,332,13,13,0,1,0
9,338,338,59,59,0,1,0
5,340,340,14,14,0,1,0
3,382,382,45,37,8,3,2
0,391,391,28,28,0,1,0
8,493,493,53,20,33,4,3
7,494,494,74,50,24,4,3

7,186,186,20,10,10,2,1
1,197,197,3,3,0,1,0
4,213,213,24,24,0,1,0
0,230,230,1,1,0,1,0
2,300,300,65,25,40,4,3
5,300,300,89,13,76,4,3
10,357,357,41,25,16,3,2
6,360,360,2,2,0,1,0
3,404,404,102,102,0,1,0
8,421,421,11,2,9,2,1
9,469,469,29,6,23,2,1

5,128,128,11,1,10,2,1
11,151,151,5,5,0,1,0
12,151,151,16,16,0,1,0
3,164,164,2,2,0,1,0
10,164,164,10,10,0,1,0
8,235,235,43,33,10,3,2
4,300,300,99,75,24,4,3
1,334,334,1,1,0,1,0
9,352,352,57,57,0,1,0
0,380,380,32,32,0,1,0
6,443,443,32,7,25,3,2
2,478,478,6,6,0,1,0
7,497,497,35,35,0,1,0

0,128,128,16,16,0,1,0
17,154,154,5,1,4,2,1
3,156,156,7,7,0,1,0
13,160,160,9,3,6,3,2
10,173,173,1,1,0,1,0
4,173,173,7,1,6,3,2
15,178,178,2,2,0,1,0
14,186,186,38,38,0,1,0
6,237,237,25,25,0,1,0
9,240,240,8,8,0,1,0
5,278,278,1,1,0,1,0
8,328,328,2,2,0,1,0
1,352,352,37,15,22,3,2
12,396,396,23,23,0,1,0
11,403,403,22,13,9,4,3
7,408,408,25,1,24,4,3
16,480,480,122,100,22,2,1
2,497,497,8,8,0,1,0

5,194,194,26,26,0,1,0
8,195,195,2,2,0,1,0
11,199,199,10,2,8,3,2
4,305,305,13,6,7,2,1
9,350,350,47,8,39,2,1
1,375,375,123,12,111,4,3
3,407,407,26,8,18,4,3
0,453,453,3,3,0,1,0
10,453,453,22,22,0,1,0
7,463,463,15,15,0,1,0
6,480,480,160,128,32,2,1
2,497,497,14,14,0,1,0

9,112,112,4,4,0,1,0
3,179,179,41,5,36,2,1
12,183,183,22,4,18,3,2
5,215,215,22,22,0,1,0
11,229,229,16,7,9,4,3
2,268,268,12,6,6,2,1
4,296,296,12,12,0,1,0
13,320,320,7,7,0,1,0
8,333,333,23,11,12,2,1
0,359,359,4,1,3,2,1
1,363,363,14,14,0,1,0
10,395,395,118,24,94,3,2
7,429,429,41,6,35,3,2
6,438,438,17,13,4,2,1

9,146,146,2,2,0,1,0
8,147,147,3,3,0,1,0
1,192,192,33,2,31,2,1
0,208,208,23,3,20,3,2
7,245,245,9,1,8,3,2
5,250,250,22,22,0,1,0
4,282,282,71,60,11,2,1
10,293,293,31,17,14,2,1
2,342,342,4,4,0,1,0
3,349,349,19,19,0,1,0
6,485,485,169,169,0,1,0

0,148,148,6,1,5,2,1
4,149,149,40,40,0,1,0
1,150,150,8,8,0,1,0
6,202,202,35,14,21,4,3
7,248,248,4,4,0,1,0
5,274,274,13,5,8,2,1
11,279,279,11,11,0,1,0
3,286,286,39,39,0,1,0
9,324,324,14,14,0,1,0
2,330,330,18,18,0,1,0
10,342,342,66,66,0,1,0
8,374,374,55,38,17,2,1

5,108,108,7,7,0,1,0
12,123,123,4,4,0,1,0
4,145,145,6,3,3,2,1
1,151,151,19,5,14,3,2
8,158,158,7,7,0,1,0
3,197,197,7,7,0,1,0
9,219,219,22,4,18,4,3
10,315,315,9,9,0,1,0
11,355,355,22,22,0,1,0
15,367,367,14,5,9,4,3
2,400,400,7,1,6,3,2
7,412,412,41,41,0,1,0
14,414,414,131,131,0,1,0
0,433,433,7,7,0,1,0
13,433,433,58,42,16,3,2
6,480,480,27,11,16,2,1

8,128,128,2,2,0,1,0
12,129,129,4,4,0,1,0
3,145,145,19,3,16,3,2
4,149,149,6,6,0,1,0
14,150,150,18,18,0,1,0
13,163,163,39,39,0,1,0
9,179,179,21,14,7,2,1
7,216,216,1,1,0,1,0
0,222,222,20,3,17,2,1
5,245,245,46,46,0,1,0
6,249,249,7,7,0,1,0
2,273,273,21,14,7,2,1
11,356,356,4,1,3,2,1
10,376,376,37,37,0,1,0
1,453,453,14,14,0,1,0

1,138,138,40,20,20,2,1
9,142,142,35,35,0,1,0
7,147,147,7,7,0,1,0
8,179,179,4,4,0,1,0
6,218,218,21,1,20,2,1
2,259,259,56,56,0,1,0
5,261,261,16,6,10,2,1
0,286,286,19,2,17,2,1
4,313,313,44,17,27,4,3
3,321,321,9,4,5,2,1

4,106,106,1,1,0,1,0
3,129,129,28,28,0,1,0
5,151,151,4,1,3,2,1
0,158,158,9,4,5,2,1
8,160,160,7,7,0,1,0
11,203,203,14,5,9,2,1
12,227,227,13,13,0,1,0
14,227,227,17,2,15,2,1
1,270,270,29,25,4,2,1
13,308,308,47,18,29,2,1
6,317,317,15,15,0,1,0
7,359,359,26,1,25,2,1
2,458,458,10,3,7,2,1
10,472,472,3,3,0,1,0
9,491,491,121,111,10,2,1

3,130,130,2,2,0,1,0
4,165,165,5,5,0,1,0
6,166,166,20,20,0,1,0
7,189,189,37,37,0,1,0
0,217,217,26,26,0,1,0
5,219,219,1,1,0,1,0
10,240,240,14,7,7,2,1
1,311,311,8,8,0,1,0
11,343,343,28,28,0,1,0
9,345,345,4,4,0,1,0
8,360,360,49,49,0,1,0
12,360,360,47,47,0,1,0
2,445,445,128,90,38,3,2

12,129,129,1,1,0,1,0
4,175,175,9,9,0,1,0
2,197,197,1,1,0,1,0
8,229,229,22,22,0,1,0
9,258,258,1,1,0,1,0
10,289,289,8,8,0,1,0
3,290,290,41,41,0,1,0
6,308,308,8,5,3,2,1
7,365,365,51,51,0,1,0
1,393,393,12,9,3,2,1
13,409,409,1,1,0,1,0
15,412,412,108,36,72,4,3
5,415,415,12,5,7,2,1
14,430,430,26,26,0,1,0
16,445,445,21,6,15,4,3
0,455,455,23,5,18,4,3
11,478,478,110,47,63,4,3

4,116,116,13,13,0,1,0
3,130,130,21,12,9,4,3
11,173,173,5,5,0,1,0
6,186,186,13,13,0,1,0
0,235,235,27,15,12,4,3
1,242,242,7,7,0,1,0
9,357,357,5,1,4,2,1
2,427,427,39,39,0,1,0
8,443,443,18,18,0,1,0
5,456,456,42,11,31,2,1
10,471,471,76,71,5,2,1
7,474,474,141,125,16,3,2

12,125,125,1,1,0,1,0
13,162,162,46,1,45,4,3
8,165,165,23,23,0,1,0
4,175,175,3,3,0,1,0
9,211,211,13,13,0,1,0
10,265,265,7,7,0,1,0
5,300,300,30,21,9,4,3
15,311,311,12,5,7,2,1
6,326,326,1,1,0,1,0
0,346,346,11,11,0,1,0
7,387,387,24,24,0,1,0
14,389,389,93,51,42,2,1
2,394,394,22,4,18,4,3
11,445,445,9,9,0,1,0
3,454,454,54,54,0,1,0
1,469,469,7,4,3,2,1

5,107,107,2,2,0,1,0
8,119,119,14,14,0,1,0
3,179,179,31,12,19,3,2
9,207,207,13,13,0,1,0
10,246,246,69,69,0,1,0
0,335,335,30,30,0,1,0
1,347,347,22,13,9,4,3
7,397,397,2,2,0,1,0
4,414,414,27,27,0,1,0
12,421,421,41,41,0,1,0
2,455,455,79,55,24,4,3
11,460,460,23,15,8,2,1
6,498,498,9,4,5,2,1

7,130,130,18,18,0,1,0
9,147,147,20,16,4,2,1
5,166,166,14,14,0,1,0
1,195,195,19,19,0,1,0
8,208,208,9,1,8,3,2
6,263,263,49,49,0,1,0
2,288,288,27,2,25,4,3
3,337,337,43,19,24,4,3
0,341,341,16,7,9,2,1
4,380,380,90,48,42,2,1
10,426,426,14,14,0,1,0

3,170,170,61,61,0,1,0
7,178,178,6,6,0,1,0
10,180,180,17,5,12,4,3
11,212,212,4,4,0,1,0
12,220,220,79,28,51,4,3
9,253,253,22,22,0,1,0
4,319,319,14,4,10,3,2
1,322,322,35,35,0,1,0
2,383,383,2,2,0,1,0
8,403,403,8,2,6,3,2
0,447,447,27,27,0,1,0
5,491,491,4,4,0,1,0
6,494,494,8,8,0,1,0

11,112,112,28,28,0,1,0
8,119,119,8,5,3,2,1
3,174,174,4,4,0,1,0
1,194,194,30,30,0,1,0
13,194,194,28,14,14,3,2
10,202,202,2,2,0,1,0
12,235,235,43,9,34,4,3
0,260,260,1,1,0,1,0
14,299,299,6,3,3,2,1
9,309,309,2,2,0,1,0
2,310,310,3,3,0,1,0
5,339,339,4,4,0,1,0
7,348,348,67,67,0,1,0
4,360,360,5,2,3,2,1
6,398,398,50,50,0,1,0

11,103,103,9,9,0,1,0
6,107,107,1,1,0,1,0
3,126,126,53,37,16,2,1
0,215,215,1,1,0,1,0
9,217,217,69,51,18,4,3
1,253,253,15,3,12,4,3
5,257,257,4,4,0,1,0
10,263,263,2,2,0,1,0
12,322,322,38,3,35,2,1
2,361,361,3,3,0,1,0
8,384,384,11,11,0,1,0
7,385,385,24,24,0,1,0
4,391,391,8,8,0,1,0
13,444,444,26,26,0,1,0

3,137,137,1,1,0,1,0
7,142,142,1,1,0,1,0
1,158,158,12,5,7,2,1
12,159,159,8,8,0,1,0
14,167,167,50,50,0,1,0
13,172,172,6,6,0,1,0
2,180,180,5,5,0,1,0
10,191,191,13,13,0,1,0
6,211,211,25,25,0,1,0
5,258,258,1,1,0,1,0
15,275,275,42,42,0,1,0
4,332,332,23,13,10,3,2
0,448,448,63,12,51,4,3
11,453,453,4,4,0,1,0
8,476,476,53,53,0,1,0
9,494,494,19,15,4,2,1

13,101,101,10,10,0,1,0
5,111,111,4,4,0,1,0
1,134,134,16,16,0,1,0
2,134,134,2,2,0,1,0
10,175,175,32,32,0,1,0
4,181,181,9,9,0,1,0
3,212,212,7,7,0,1,0
7,244,244,17,8,9,4,3
12,255,255,6,2,4,2,1
9,263,263,26,26,0,1,0
14,266,266,2,2,0,1,0
0,273,273,13,13,0,1,0
11,442,442,92,52,40,2,1
8,463,463,64,21,43,2,1
6,466,466,43,19,24,4,3

9,119,119,4,4,0,1,0
13,121,121,2,2,0,1,0
0,165,165,1,1,0,1,0
8,176,176,6,2,4,2,1
10,214,214,92,32,60,4,3
11,215,215,2,2,0,1,0
1,234,234,38,8,30,3,2
3,247,247,35,5,30,2,1
12,311,311,29,29,0,1,0
4,315,315,3,3,0,1,0
7,322,322,22,19,3,2,1
6,367,367,41,41,0,1,0
5,405,405,25,25,0,1,0
2,417,417,17,2,15,3,2

11,106,106,42,8,34,4,3
8,163,163,23,23,0,1,0
3,198,198,1,1,0,1,0
5,208,208,1,1,0,1,0
14,217,217,12,2,10,3,2
2,220,220,1,1,0,1,0
12,267,267,2,2,0,1,0
1,277,277,19,5,14,2,1
9,321,321,4,4,0,1,0
0,346,346,44,1,43,2,1
10,361,361,21,21,0,1,0
13,395,395,34,34,0,1,0
4,409,409,13,13,0,1,0
6,443,443,96,84,12,4,3
7,475,475,3,3,0,1,0

2,178,178,12,12,0,1,0
5,217,217,45,2,43,2,1
3,234,234,11,4,7,2,1
11,300,300,30,30,0,1,0
9,350,350,2,2,0,1,0
10,356,356,119,119,0,1,0
0,387,387,19,19,0,1,0
6,415,415,2,2,0,1,0
8,433,433,37,37,0,1,0
4,440,440,64,64,0,1,0
1,454,454,38,9,29,2,1
7,496,496,39,39,0,1,0

6,149,149,7,7,0,1,0
1,177,177,14,6,8,3,2
10,188,188,18,18,0,1,0
7,193,193,26,26,0,1,0
5,199,199,5,1,4,2,1
2,200,200,19,4,15,3,2
9,203,203,31,31,0,1,0
12,217,217,12,1,11,3,2
13,244,244,5,5,0,1,0
14,282,282,73,73,0,1,0
0,284,284,3,3,0,1,0
4,317,317,45,45,0,1,0
3,332,332,4,1,3,2,1
11,370,370,11,11,0,1,0
8,372,372,21,1,20,3,2

5,131,131,1,1,0,1,0
2,172,172,20,4,16,3,2
1,175,175,1,1,0,1,0
3,205,205,8,8,0,1,0
4,224,224,26,19,7,2,1
9,226,226,20,1,19,2,1
7,341,341,88,88,0,1,0
11,358,358,38,21,17,2,1
6,373,373,5,1,4,2,1
8,373,373,10,1,9,2,1
13,411,411,31,31,0,1,0
0,441,441,20,20,0,1,0
12,450,450,13,13,0,1,0
10,500,500,140,112,28,3,2

5,103,103,35,35,0,1,0
7,210,210,1,1,0,1,0
1,217,217,28,28,0,1,0
0,221,221,22,12,10,3,2
4,347,347,6,6,0,1,0
11,347,347,147,147,0,1,0
9,348,348,18,18,0,1,0
3,363,363,4,4,0,1,0
10,398,398,24,6,18,4,3
6,403,403,17,5,12,3,2
2,420,420,2,2,0,1,0
8,459,459,11,11,0,1,0

15,183,183,1,1,0,1,0
11,184,184,64,46,18,3,2
1,201,201,4,4,0,1,0
10,232,232,25,25,0,1,0
0,245,245,1,1,0,1,0
4,254,254,15,15,0,1,0
3,258,258,14,14,0,1,0
5,297,297,19,19,0,1,0
9,299,299,1,1,0,1,0
12,329,329,1,1,0,1,0
2,342,342,40,26,14,3,2
8,375,375,22,22,0,1,0
7,382,382,61,61,0,1,0
13,439,439,33,33,0,1,0
14,458,458,31,31,0,1,0
6,492,492,31,31,0,1,0

7,100,100,7,7,0,1,0
3,163,163,20,20,0,1,0
6,202,202,32,32,0,1,0
2,402,402,73,73,0,1,0
4,406,406,33,33,0,1,0
1,410,410,61,61,0,1,0
0,443,443,200,200,0,1,0
5,477,477,2,2,0,1,0

1,107,107,1,1,0,1,0
2,111,111,11,3,8,3,2
10,139,139,6,1,5,2,1
7,152,152,12,12,0,1,0
9,158,158,2,2,0,1,0
8,217,217,30,30,0,1,0
6,322,322,39,19,20,3,2
3,411,411,32,6,26,3,2
5,416,416,93,47,46,3,2
0,431,431,113,113,0,1,0
4,490,490,75,19,56,3,2

6,111,111,27,27,0,1,0
12,116,116,5,5,0,1,0
3,201,201,9,9,0,1,0
5,203,203,3,3,0,1,0
2,224,224,27,12,15,4,3
11,232,232,32,14,18,2,1
10,237,237,37,3,34,3,2
8,275,275,8,8,0,1,0
0,303,303,4,4,0,1,0
4,305,305,4,4,0,1,0
1,332,332,27,13,14,3,2
7,344,344,14,14,0,1,0
13,427,427,94,67,27,4,3
9,434,434,16,16,0,1,0
14,492,492,10,10,0,1,0

1,133,133,14,14,0,1,0
11,178,178,9,6,3,2,1
12,184,184,20,20,0,1,0
13,190,190,3,3,0,1,0
7,191,191,2,2,0,1,0
10,192,192,3,3,0,1,0
4,193,193,28,28,0,1,0
8,210,210,4,4,0,1,0
5,241,241,6,1,5,2,1
6,271,271,37,21,16,2,1
9,320,320,14,8,6,2,1
0,357,357,29,29,0,1,0
14,387,387,146,114,32,4,3
2,403,403,8,8,0,1,0
3,418,418,26,26,0,1,0

1,131,131,11,11,0,1,0
14,145,145,49,27,22,3,2
13,149,149,12,12,0,1,0
5,176,176,1,1,0,1,0
4,180,180,6,6,0,1,0
9,218,218,8,8,0,1,0
10,221,221,13,9,4,2,1
6,273,273,34,4,30,2,1
2,312,312,36,6,30,2,1
3,364,364,55,55,0,1,0
12,422,422,26,11,15,2,1
11,472,472,18,6,12,4,3
8,475,475,6,1,5,2,1
0,479,479,1,1,0,1,0
7,495,495,36,9,27,2,1

13,101,101,24,8,16,3,2
14,104,104,4,4,0,1,0
4,111,111,1,1,0,1,0
2,120,120,17,1,16,3,2
7,146,146,1,1,0,1,0
18,163,163,11,11,0,1,0
10,185,185,7,3,4,2,1
15,204,204,30,30,0,1,0
8,222,222,3,3,0,1,0
16,283,283,26,13,13,2,1
11,317,317,1,1,0,1,0
3,349,349,6,6,0,1,0
9,358,358,28,28,0,1,0
0,366,366,21,7,14,2,1
6,373,373,2,2,0,1,0
17,393,393,15,15,0,1,0
12,469,469,29,29,0,1,0
5,480,480,26,26,0,1,0
1,497,497,57,27,30,4,3

1,149,149,11,3,8,2,1
5,166,166,20,20,0,1,0
9,175,175,14,14,0,1,0
4,217,217,50,34,16,2,1
3,228,228,39,35,4,2,1
0,273,273,89,89,0,1,0
7,285,285,6,6,0,1,0
6,304,304,31,8,23,2,1
2,333,333,10,1,9,4,3
8,491,491,27,13,14,2,1

10,121,121,25,19,6,2,1
6,162,162,14,14,0,1,0
2,218,218,11,11,0,1,0
3,233,233,63,24,39,2,1
0,273,273,37,37,0,1,0
4,298,298,31,31,0,1,0
8,308,308,32,9,23,4,3
9,309,309,24,24,0,1,0
1,321,321,13,6,7,2,1
5,394,394,49,49,0,1,0
7,395,395,8,8,0,1,0

12,120,120,2,2,0,1,0
8,224,224,41,5,36,3,2
3,260,260,11,11,0,1,0
10,269,269,9,3,6,2,1
9,277,277,6,6,0,1,0
2,283,283,46,46,0,1,0
1,325,325,41,17,24,2,1
13,329,329,13,13,0,1,0
5,334,334,10,10,0,1,0
4,414,414,4,4,0,1,0
7,423,423,43,43,0,1,0
6,428,428,26,26,0,1,0
0,458,458,31,26,5,2,1
11,465,465,151,134,17,2,1

2,112,112,4,4,0,1,0
9,158,158,18,18,0,1,0
1,224,224,27,27,0,1,0
11,226,226,4,4,0,1,0
10,239,239,1,1,0,1,0
3,293,293,10,4,6,3,2
4,319,319,92,80,12,2,1
0,406,406,35,35,0,1,0
5,411,411,15,15,0,1,0
8,413,413,16,2,14,3,2
7,415,415,160,111,49,3,2
6,468,468,25,25,0,1,0

2,105,105,7,7,0,1,0
4,107,107,8,8,0,1,0
7,136,136,24,4,20,3,2
5,145,145,11,3,8,2,1
10,229,229,57,39,18,2,1
0,291,291,25,25,0,1,0
6,297,297,12,12,0,1,0
11,354,354,22,22,0,1,0
1,362,362,49,18,31,2,1
3,414,414,67,47,20,3,2
8,487,487,26,7,19,4,3
9,491,491,13,5,8,2,1

5,110,110,4,4,0,1,0
3,111,111,4,4,0,1,0
1,189,189,25,13,12,4,3
7,354,354,11,5,6,3,2
9,375,375,43,43,0,1,0
10,391,391,28,10,18,4,3
12,399,399,92,92,0,1,0
2,402,402,1,1,0,1,0
6,411,411,69,15,54,4,3
8,416,416,57,13,44,4,3
4,422,422,18,18,0,1,0
0,435,435,66,30,36,2,1
13,441,441,18,1,17,4,3
11,470,470,4,4,0,1,0

1,110,110,1,1,0,1,0
8,181,181,15,6,9,4,3
2,198,198,10,6,4,2,1
7,200,200,9,3,6,3,2
9,265,265,9,3,6,2,1
0,273,273,11,11,0,1,0
4,294,294,4,4,0,1,0
11,303,303,31,31,0,1,0
5,328,328,47,13,34,3,2
13,329,329,14,6,8,2,1
16,392,392,8,8,0,1,0
6,427,427,63,63,0,1,0
10,433,433,2,2,0,1,0
12,460,460,134,134,0,1,0
3,469,469,14,14,0,1,0
14,472,472,31,31,0,1,0
15,496,496,41,41,0,1,0

2,107,107,1,1,0,1,0
1,200,200,10,2,8,3,2
3,212,212,13,7,6,3,2
11,259,259,64,46,18,4,3
4,271,271,47,47,0,1,0
13,296,296,20,8,12,4,3
9,310,310,5,1,4,2,1
6,342,342,42,12,30,4,3
7,386,386,54,54,0,1,0
10,388,388,10,7,3,2,1
0,400,400,3,3,0,1,0
12,418,418,13,13,0,1,0
8,434,434,96,12,84,4,3
5,455,455,17,17,0,1,0

3,121,121,51,18,33,4,3
5,148,148,1,1,0,1,0
8,193,193,14,14,0,1,0
0,270,270,64,37,27,4,3
1,271,271,31,26,5,2,1
7,405,405,14,14,0,1,0
2,438,438,109,26,83,4,3
6,442,442,8,8,0,1,0
4,448,448,28,28,0,1,0

5,162,162,20,8,12,2,1
8,196,196,18,18,0,1,0
3,205,205,19,10,9,2,1
9,311,311,51,32,19,3,2
1,317,317,11,1,10,3,2
2,338,338,63,63,0,1,0
6,351,351,40,19,21,4,3
7,354,354,47,21,26,3,2
0,386,386,18,7,11,2,1
12,438,438,53,2,51,4,3
4,440,440,2,2,0,1,0
11,451,451,17,17,0,1,0
10,490,490,30,30,0,1,0

0,130,130,79,35,44,2,1
6,131,131,43,43,0,1,0
3,200,200,9,9,0,1,0
2,206,206,21,3,18,3,2
4,270,270,3,3,0,1,0
1,334,334,26,26,0,1,0
5,344,344,15,15,0,1,0

2,146,146,8,2,6,2,1
11,174,174,18,18,0,1,0
0,179,179,5,5,0,1,0
10,211,211,36,3,33,4,3
7,318,318,12,12,0,1,0
3,324,324,53,47,6,3,2
6,346,346,25,25,0,1,0
9,349,349,73,57,16,2,1
4,372,372,100,86,14,2,1
8,410,410,6,6,0,1,0
1,421,421,22,22,0,1,0
5,490,490,16,7,9,2,1

13,123,123,5,5,0,1,0
15,142,142,56,56,0,1,0
10,146,146,5,2,3,2,1
16,184,184,6,6,0,1,0
8,190,190,6,6,0,1,0
1,229,229,12,12,0,1,0
7,262,262,7,1,6,3,2
12,292,292,16,16,0,1,0
2,354,354,16,16,0,1,0
14,385,385,30,30,0,1,0
0,389,389,26,26,0,1,0
4,400,400,43,43,0,1,0
9,405,405,10,10,0,1,0
17,405,405,12,3,9,4,3
6,428,428,47,13,34,3,2
11,445,445,10,10,0,1,0
18,452,452,18,2,16,4,3
3,483,483,9,9,0,1,0
5,496,496,3,3,0,1,0

1,120,120,4,4,0,1,0
12,134,134,1,1,0,1,0
10,137,137,9,9,0,1,0
4,216,216,1,1,0,1,0
14,223,223,7,7,0,1,0
15,238,238,29,29,0,1,0
9,274,274,12,12,0,1,0
5,277,277,7,7,0,1,0
8,341,341,39,36,3,2,1
11,342,342,2,2,0,1,0
2,372,372,51,11,40,2,1
3,374,374,8,8,0,1,0
7,377,377,43,5,38,3,2
13,415,415,156,156,0,1,0
6,422,422,5,2,3,2,1
0,451,451,44,44,0,1,0

11,249,249,41,5,36,2,1
12,257,257,45,45,0,1,0
7,323,323,31,7,24,4,3
6,344,344,39,39,0,1,0
1,362,362,61,61,0,1,0
5,395,395,3,3,0,1,0
13,396,396,8,2,6,3,2
0,406,406,2,2,0,1,0
4,414,414,4,4,0,1,0
8,440,440,45,35,10,2,1
2,450,450,21,13,8,2,1
9,476,476,17,10,7,2,1
10,488,488,53,33,20,3,2
3,494,494,77,19,58,3,2

8,220,220,10,10,0,1,0
0,244,244,7,4,3,2,1
7,261,261,7,7,0,1,0
12,283,283,28,2,26,2,1
6,297,297,24,24,0,1,0
3,318,318,11,11,0,1,0
5,343,343,56,56,0,1,0
2,390,390,24,6,18,3,2
9,412,412,101,89,12,4,3
11,427,427,11,11,0,1,0
10,451,451,75,26,49,2,1
1,477,477,69,69,0,1,0
4,497,497,44,44,0,1,0

10,127,127,9,9,0,1,0
11,129,129,19,9,10,2,1
1,199,199,37,20,17,2,1
2,262,262,28,23,5,2,1
0,273,273,15,9,6,3,2
4,371,371,9,9,0,1,0
12,371,371,5,2,3,2,1
6,380,380,38,11,27,2,1
8,387,387,55,19,36,4,3
5,413,413,35,35,0,1,0
9,445,445,59,31,28,3,2
7,447,447,46,11,35,2,1
3,484,484,22,22,0,1,0

1,112,112,5,5,0,1,0
3,167,167,35,13,22,3,2
9,187,187,26,1,25,2,1
4,214,214,17,17,0,1,0
0,237,237,9,6,3,2,1
7,259,259,61,61,0,1,0
6,268,268,7,7,0,1,0
2,272,272,63,63,0,1,0
5,386,386,19,10,9,4,3
8,393,393,23,1,22,3,2
10,400,400,40,1,39,4,3

3,172,172,18,18,0,1,0
8,200,200,12,12,0,1,0
9,245,245,8,8,0,1,0
1,279,279,32,2,30,3,2
10,281,281,88,75,13,4,3
6,291,291,45,45,0,1,0
0,326,326,31,8,23,2,1
4,350,350,24,24,0,1,0
2,364,364,79,51,28,4,3
7,376,376,3,3,0,1,0
5,427,427,17,2,15,4,3

0,113,113,13,13,0,1,0
8,135,135,6,6,0,1,0
4,137,137,44,44,0,1,0
5,144,144,4,4,0,1,0
1,271,271,14,2,12,4,3
3,273,273,6,2,4,2,1
7,288,288,3,3,0,1,0
9,294,294,59,21,38,2,1
2,372,372,154,154,0,1,0
6,470,470,9,3,6,2,1

14,107,107,11,2,9,4,3
15,107,107,18,18,0,1,0
9,112,112,1,1,0,1,0
8,149,149,1,1,0,1,0
7,176,176,22,17,5,2,1
12,200,200,30,30,0,1,0
2,261,261,2,2,0,1,0
6,274,274,7,7,0,1,0
0,290,290,39,39,0,1,0
13,302,302,34,34,0,1,0
4,350,350,16,10,6,2,1
11,372,372,1,1,0,1,0
5,402,402,66,36,30,3,2
1,414,414,24,8,16,4,3
3,432,432,12,12,0,1,0
10,444,444,34,11,23,2,1

10,120,120,3,3,0,1,0
4,139,139,1,1,0,1,0
2,237,237,7,1,6,3,2
14,248,248,34,34,0,1,0
12,263,263,3,3,0,1,0
5,270,270,52,52,0,1,0
9,271,271,10,10,0,1,0
6,291,291,6,1,5,2,1
17,291,291,7,4,3,2,1
15,302,302,68,60,8,3,2
8,341,341,11,11,0,1,0
7,355,355,15,15,0,1,0
0,366,366,8,4,4,2,1
1,368,368,50,18,32,4,3
11,400,400,5,5,0,1,0
13,404,404,67,27,40,4,3
18,422,422,4,4,0,1,0
16,432,432,21,21,0,1,0
3,483,483,16,16,0,1,0

4,134,134,11,5,6,3,2
6,134,134,13,13,0,1,0
10,140,140,2,2,0,1,0
11,154,154,22,4,18,3,2
0,173,173,6,6,0,1,0
3,276,276,1,1,0,1,0
5,280,280,2,2,0,1,0
13,284,284,91,91,0,1,0
8,287,287,46,3,43,2,1
7,291,291,2,2,0,1,0
12,300,300,20,20,0,1,0
2,335,335,53,12,41,4,3
15,400,400,20,10,10,3,2
1,408,408,17,17,0,1,0
14,445,445,7,1,6,2,1
9,466,466,4,4,0,1,0

8,132,132,11,11,0,1,0
0,198,198,8,3,5,2,1
11,212,212,20,3,17,2,1
7,218,218,3,3,0,1,0
10,265,265,104,60,44,4,3
3,284,284,2,2,0,1,0
6,286,286,3,3,0,1,0
1,356,356,4,4,0,1,0
5,361,361,175,175,0,1,0
9,369,369,6,6,0,1,0
4,417,417,11,11,0,1,0
2,454,454,14,14,0,1,0

3,109,109,8,8,0,1,0
5,129,129,1,1,0,1,0
1,256,256,19,7,12,2,1
9,283,283,19,19,0,1,0
0,297,297,30,9,21,4,3
13,315,315,19,19,0,1,0
7,318,318,77,77,0,1,0
6,324,324,4,4,0,1,0
10,327,327,2,2,0,1,0
12,350,350,24,7,17,2,1
11,369,369,100,100,0,1,0
8,370,370,50,50,0,1,0
2,395,395,12,12,0,1,0
4,405,405,24,17,7,2,1

7,115,115,3,3,0,1,0
3,163,163,36,12,24,3,2
5,179,179,43,4,39,4,3
6,203,203,3,3,0,1,0
10,210,210,43,29,14,2,1
11,253,253,52,8,44,4,3
0,286,286,1,1,0,1,0
9,288,288,45,14,31,2,1
8,320,320,4,4,0,1,0
2,331,331,7,7,0,1,0
1,405,405,28,28,0,1,0
4,460,460,22,22,0,1,0

4,115,115,3,3,0,1,0
6,128,128,10,1,9,4,3
12,129,129,1,1,0,1,0
8,167,167,11,5,6,2,1
5,174,174,17,4,13,2,1
3,226,226,47,36,11,2,1
11,239,239,11,3,8,3,2
7,296,296,110,86,24,4,3
9,326,326,2,2,0,1,0
2,386,386,32,32,0,1,0
10,431,431,51,12,39,4,3
1,457,457,2,2,0,1,0
0,460,460,50,3,47,2,1

1,101,101,1,1,0,1,0
17,109,109,15,1,14,2,1
9,126,126,2,2,0,1,0
16,167,167,29,17,12,2,1
10,197,197,8,1,7,2,1
20,198,198,26,22,4,2,1
14,212,212,1,1,0,1,0
6,249,249,16,16,0,1,0
11,289,289,7,7,0,1,0
8,289,289,28,28,0,1,0
13,302,302,8,4,4,2,1
5,305,305,32,1,31,3,2
15,331,331,14,14,0,1,0
2,344,344,7,7,0,1,0
7,350,350,10,1,9,4,3
12,365,365,38,38,0,1,0
0,379,379,6,2,4,2,1
19,410,410,35,35,0,1,0
18,438,438,22,22,0,1,0
3,453,453,12,4,8,2,1
4,474,474,10,6,4,2,1

6,100,100,2,2,0,1,0
8,114,114,15,15,0,1,0
3,132,132,5,5,0,1,0
9,150,150,23,1,22,2,1
10,229,229,5,5,0,1,0
5,266,266,34,20,14,2,1
4,296,296,49,49,0,1,0
0,321,321,50,50,0,1,0
7,322,322,52,52,0,1,0
1,402,402,89,70,19,4,3
2,489,489,10,10,0,1,0

12,116,116,19,19,0,1,0
4,127,127,10,10,0,1,0
5,134,134,20,20,0,1,0
6,163,163,36,36,0,1,0
0,206,206,7,7,0,1,0
2,236,236,12,12,0,1,0
11,303,303,28,28,0,1,0
10,308,308,39,39,0,1,0
7,334,334,67,22,45,2,1
1,365,365,10,10,0,1,0
9,390,390,4,4,0,1,0
8,397,397,7,7,0,1,0
3,417,417,17,7,10,3,2

3,165,165,39,39,0,1,0
12,181,181,36,9,27,4,3
10,203,203,1,1,0,1,0
11,218,218,13,2,11,2,1
7,244,244,6,2,4,2,1
0,283,283,18,3,15,2,1
8,381,381,6,6,0,1,0
9,409,409,28,11,17,2,1
13,415,415,109,4,105,4,3
5,434,434,25,25,0,1,0
2,437,437,12,12,0,1,0
6,458,458,3,3,0,1,0
4,459,459,53,53,0,1,0
1,494,494,34,12,22,2,1

4,256,256,75,10,65,4,3
11,267,267,31,31,0,1,0
5,282,282,23,23,0,1,0
3,298,298,31,22,9,4,3
7,332,332,6,6,0,1,0
10,352,352,29,29,0,1,0
0,355,355,19,2,17,2,1
1,366,366,15,5,10,2,1
9,378,378,100,100,0,1,0
2,452,452,13,13,0,1,0
8,460,460,37,6,31,2,1
6,482,482,22,6,16,2,1

3,106,106,4,4,0,1,0
6,108,108,5,5,0,1,0
0,124,124,4,4,0,1,0
2,128,128,47,47,0,1,0
8,165,165,9,3,6,3,2
9,238,238,42,9,33,4,3
4,361,361,18,18,0,1,0
1,368,368,42,42,0,1,0
7,400,400,2,2,0,1,0
5,413,413,67,67,0,1,0
10,495,495,85,85,0,1,0

12,148,148,17,5,12,2,1
5,206,206,7,7,0,1,0
9,213,213,50,50,0,1,0
8,217,217,28,28,0,1,0
2,229,229,1,1,0,1,0
7,244,244,17,17,0,1,0
4,260,260,8,8,0,1,0
0,343,343,54,18,36,3,2
11,397,397,1,1,0,1,0
6,405,405,37,37,0,1,0
3,440,440,39,3,36,2,1
10,468,468,28,11,17,3,2
1,470,470,91,91,0,1,0

4,118,118,7,7,0,1,0
10,205,205,37,37,0,1,0
2,264,264,21,21,0,1,0
1,324,324,95,95,0,1,0
7,325,325,78,23,55,3,2
8,325,325,16,16,0,1,0
9,365,365,7,7,0,1,0
3,370,370,41,41,0,1,0
5,379,379,14,14,0,1,0
0,433,433,25,16,9,4,3
6,500,500,41,35,6,2,1

2,134,134,2,2,0,1,0
1,183,183,9,3,6,3,2
9,227,227,5,5,0,1,0
4,307,307,7,7,0,1,0
6,349,349,19,19,0,1,0
3,364,364,76,55,21,2,1
0,369,369,121,90,31,4,3
5,384,384,38,5,33,4,3
8,408,408,123,18,105,4,3
7,453,453,49,1,48,3,2

7,177,177,9,2,7,2,1
3,190,190,17,17,0,1,0
9,229,229,17,14,3,2,1
11,250,250,7,7,0,1,0
8,264,264,4,4,0,1,0
6,293,293,30,30,0,1,0
4,307,307,26,8,18,3,2
0,331,331,31,15,16,2,1
15,338,338,6,6,0,1,0
5,383,383,11,8,3,2,1
10,384,384,75,69,6,2,1
1,403,403,1,1,0,1,0
14,438,438,69,69,0,1,0
2,451,451,27,27,0,1,0
12,471,471,14,11,3,2,1
13,491,491,87,50,37,3,2

4,111,111,5,2,3,2,1
5,117,117,2,2,0,1,0
3,193,193,2,2,0,1,0
1,222,222,89,89,0,1,0
7,327,327,41,32,9,2,1
0,377,377,4,4,0,1,0
8,394,394,39,6,33,2,1
2,444,444,61,3,58,4,3
10,464,464,69,17,52,3,2
6,465,465,59,47,12,4,3
9,480,480,44,44,0,1,0

1,107,107,1,1,0,1,0
9,170,170,30,30,0,1,0
7,211,211,5,1,4,2,1
10,225,225,45,4,41,2,1
5,250,250,1,1,0,1,0
2,256,256,35,28,7,2,1
11,308,308,4,1,3,2,1
4,336,336,11,11,0,1,0
3,393,393,131,33,98,4,3
8,432,432,14,14,0,1,0
0,435,435,38,2,36,2,1
6,479,479,78,78,0,1,0

7,123,123,1,1,0,1,0
8,166,166,1,1,0,1,0
4,168,168,8,8,0,1,0
5,271,271,52,52,0,1,0
1,273,273,23,5,18,4,3
2,295,295,66,48,18,4,3
9,303,303,62,62,0,1,0
0,362,362,81,76,5,2,1
3,399,399,28,28,0,1,0
6,485,485,75,67,8,3,2

11,104,104,9,9,0,1,0
5,106,106,10,10,0,1,0
9,130,130,5,5,0,1,0
1,155,155,6,6,0,1,0
2,170,170,17,17,0,1,0
0,295,295,3,3,0,1,0
8,299,299,59,37,22,3,2
6,316,316,59,59,0,1,0
10,331,331,33,3,30,4,3
3,353,353,47,29,18,4,3
7,403,403,2,2,0,1,0
4,438,438,102,24,78,4,3

6,140,140,2,2,0,1,0
2,187,187,9,9,0,1,0
9,189,189,7,7,0,1,0
3,212,212,17,17,0,1,0
12,243,243,41,11,30,3,2
8,258,258,24,24,0,1,0
11,276,276,6,6,0,1,0
5,284,284,24,4,20,3,2
14,314,314,14,14,0,1,0
0,343,343,7,7,0,1,0
17,360,360,2,2,0,1,0
7,374,374,7,3,4,2,1
13,385,385,15,7,8,3,2
1,423,423,19,19,0,1,0
10,425,425,35,35,0,1,0
4,464,464,27,27,0,1,0
16,474,474,24,12,12,2,1
15,498,498,149,80,69,4,3

10,107,107,5,5,0,1,0
8,139,139,1,1,0,1,0
5,155,155,6,6,0,1,0
4,216,216,5,5,0,1,0
3,261,261,13,1,12,4,3
7,267,267,14,8,6,3,2
12,284,284,88,70,18,4,3
9,289,289,20,20,0,1,0
14,312,312,3,3,0,1,0
0,319,319,54,10,44,3,2
15,340,340,19,8,11,2,1
6,390,390,27,27,0,1,0
11,401,401,58,13,45,3,2
13,416,416,19,19,0,1,0
1,417,417,44,23,21,4,3
2,463,463,8,2,6,3,2

2,238,238,36,36,0,1,0
5,239,239,42,27,15,2,1
7,250,250,4,4,0,1,0
4,251,251,1,1,0,1,0
12,257,257,26,26,0,1,0
13,305,305,37,3,34,3,2
8,332,332,77,65,12,4,3
10,389,389,12,12,0,1,0
9,399,399,43,3,40,3,2
6,434,434,62,62,0,1,0
1,465,465,11,1,10,3,2
11,465,465,8,8,0,1,0
0,480,480,39,25,14,2,1
3,480,480,3,3,0,1,0

2,102,102,20,20,0,1,0
10,121,121,13,1,12,4,3
4,126,126,27,16,11,2,1
3,129,129,4,1,3,2,1
5,143,143,4,4,0,1,0
6,207,207,11,11,0,1,0
11,221,221,14,14,0,1,0
9,368,368,7,7,0,1,0
7,397,397,4,4,0,1,0
12,405,405,11,11,0,1,0
0,457,457,8,8,0,1,0
1,457,457,29,1,28,2,1
8,482,482,183,93,90,3,2

2,137,137,1,1,0,1,0
9,164,164,4,4,0,1,0
12,188,188,5,5,0,1,0
0,221,221,2,2,0,1,0
8,227,227,34,34,0,1,0
5,248,248,38,38,0,1,0
1,257,257,38,6,32,2,1
10,275,275,7,2,5,2,1
6,287,287,43,43,0,1,0
3,288,288,18,18,0,1,0
11,382,382,127,7,120,4,3
7,426,426,23,23,0,1,0
4,454,454,33,24,9,4,3

1,103,103,13,5,8,3,2
0,111,111,2,2,0,1,0
10,118,118,4,4,0,1,0
5,129,129,23,11,12,3,2
7,136,136,3,3,0,1,0
2,191,191,35,9,26,3,2
8,208,208,11,11,0,1,0
6,270,270,48,48,0,1,0
3,279,279,71,71,0,1,0
4,299,299,6,6,0,1,0
9,372,372,55,55,0,1,0

0,116,116,24,9,15,2,1
3,147,147,8,3,5,2,1
9,186,186,19,4,15,4,3
1,190,190,4,4,0,1,0
2,211,211,35,14,21,2,1
11,221,221,18,11,7,2,1
8,260,260,5,5,0,1,0
4,280,280,26,10,16,2,1
10,329,329,68,62,6,2,1
7,362,362,42,37,5,2,1
5,462,462,28,12,16,2,1
6,498,498,44,24,20,2,1

2,115,115,5,5,0,1,0
0,253,253,10,1,9,4,3
8,257,257,45,45,0,1,0
3,268,268,51,23,28,3,2
9,293,293,68,68,0,1,0
7,314,314,9,9,0,1,0
5,319,319,23,23,0,1,0
6,355,355,23,2,21,4,3
1,430,430,46,42,4,2,1
4,478,478,106,78,28,2,1
10,496,496,17,13,4,2,1

0,100,100,14,14,0,1,0
12,131,131,48,15,33,2,1
14,144,144,10,10,0,1,0
7,157,157,6,6,0,1,0
3,172,172,2,2,0,1,0
1,206,206,1,1,0,1,0
6,208,208,19,19,0,1,0
13,252,252,5,2,3,2,1
10,255,255,28,28,0,1,0
5,368,368,52,7,45,2,1
11,371,371,3,3,0,1,0
9,426,426,16,16,0,1,0
2,446,446,46,25,21,4,3
4,457,457,5,5,0,1,0
8,485,485,29,29,0,1,0

4,107,107,1,1,0,1,0
5,109,109,8,2,6,2,1
0,114,114,1,1,0,1,0
9,126,126,11,4,7,2,1
10,155,155,17,17,0,1,0
12,170,170,29,29,0,1,0
11,210,210,14,14,0,1,0
14,247,247,21,3,18,4,3
8,261,261,37,37,0,1,0
2,306,306,38,35,3,2,1
6,324,324,3,3,0,1,0
1,384,384,17,17,0,1,0
7,413,413,3,3,0,1,0
3,415,415,76,30,46,2,1
13,490,490,48,48,0,1,0

1,163,163,15,15,0,1,0
6,190,190,25,13,12,3,2
8,191,191,14,14,0,1,0
10,216,216,22,14,8,3,2
3,225,225,2,2,0,1,0
0,294,294,84,84,0,1,0
2,335,335,41,20,21,4,3
5,358,358,42,15,27,2,1
9,384,384,35,35,0,1,0
4,403,403,37,17,20,3,2
7,471,471,45,24,21,2,1

1,108,108,14,10,4,2,1
7,148,148,5,5,0,1,0
4,203,203,19,11,8,2,1
11,226,226,43,43,0,1,0
2,283,283,1,1,0,1,0
6,293,293,6,6,0,1,0
8,303,303,39,23,16,2,1
9,359,359,28,28,0,1,0
0,364,364,26,26,0,1,0
5,367,367,42,16,26,3,2
10,401,401,68,32,36,4,3
3,461,461,87,54,33,4,3

5,125,125,17,3,14,3,2
7,150,150,10,7,3,2,1
11,165,165,3,3,0,1,0
14,170,170,10,10,0,1,0
12,198,198,4,1,3,2,1
13,198,198,44,3,41,2,1
3,286,286,6,6,0,1,0
4,301,301,29,29,0,1,0
2,304,304,7,1,6,3,2
10,327,327,7,1,6,3,2
8,394,394,10,10,0,1,0
9,421,421,115,49,66,3,2
1,427,427,12,1,11,2,1
0,471,471,35,20,15,4,3
6,495,495,64,18,46,4,3

3,129,129,1,1,0,1,0
8,172,172,34,20,14,3,2
4,174,174,24,24,0,1,0
9,188,188,29,29,0,1,0
7,231,231,3,3,0,1,0
6,238,238,51,51,0,1,0
11,257,257,4,4,0,1,0
10,355,355,7,7,0,1,0
1,360,360,72,66,6,2,1
5,421,421,22,22,0,1,0
0,426,426,6,1,5,2,1
2,426,426,81,81,0,1,0

7,114,114,3,3,0,1,0
2,142,142,44,14,30,2,1
4,229,229,36,36,0,1,0
1,235,235,13,5,8,3,2
5,263,263,65,15,50,3,2
8,277,277,32,4,28,3,2
9,279,279,7,1,6,3,2
3,433,433,36,36,0,1,0
0,480,480,73,73,0,1,0
6,500,500,19,19,0,1,0

10,127,127,8,8,0,1,0
8,142,142,50,35,15,2,1
3,160,160,28,7,21,4,3
9,171,171,9,9,0,1,0
4,195,195,64,48,16,2,1
6,315,315,14,8,6,2,1
1,334,334,4,4,0,1,0
7,401,401,21,21,0,1,0
2,478,478,40,33,7,2,1
5,497,497,25,6,19,2,1
0,499,499,1,1,0,1,0

3,180,180,4,1,3,2,1
5,195,195,53,53,0,1,0
8,209,209,17,17,0,1,0
10,225,225,22,22,0,1,0
7,238,238,15,15,0,1,0
1,279,279,15,6,9,2,1
2,293,293,1,1,0,1,0
0,364,364,47,47,0,1,0
6,382,382,28,28,0,1,0
9,418,418,8,8,0,1,0
4,429,429,168,51,117,4,3

6,146,146,9,9,0,1,0
7,149,149,2,2,0,1,0
3,210,210,9,6,3,2,1
5,266,266,48,30,18,2,1
2,289,289,10,2,8,2,1
4,300,300,84,1,83,3,2
8,310,310,12,12,0,1,0
1,355,355,120,120,0,1,0
0,440,440,101,83,18,4,3

5,108,108,10,5,5,2,1
8,129,129,19,3,16,3,2
3,201,201,34,34,0,1,0
0,280,280,82,8,74,3,2
9,291,291,3,3,0,1,0
1,307,307,2,2,0,1,0
10,361,361,20,20,0,1,0
2,372,372,31,7,24,3,2
4,437,437,22,22,0,1,0
7,482,482,86,34,52,3,2
6,498,498,65,38,27,2,1

4,130,130,6,2,4,2,1
1,131,131,15,6,9,4,3
3,141,141,19,8,11,2,1
8,196,196,44,14,30,4,3
0,251,251,46,16,30,2,1
7,259,259,21,14,7,2,1
2,346,346,105,38,67,4,3
5,372,372,1,1,0,1,0
6,477,477,62,20,42,4,3

5,138,138,2,2,0,1,0
0,238,238,142,112,30,3,2
7,322,322,6,6,0,1,0
1,352,352,2,2,0,1,0
4,411,411,7,7,0,1,0
6,428,428,11,5,6,2,1
3,434,434,89,41,48,4,3
2,445,445,146,142,4,2,1

1,103,103,1,1,0,1,0
3,107,107,8,8,0,1,0
5,110,110,1,1,0,1,0
6,115,115,7,7,0,1,0
0,154,154,10,10,0,1,0
12,178,178,13,13,0,1,0
7,222,222,11,11,0,1,0
2,260,260,27,5,22,2,1
8,284,284,4,1,3,2,1
10,371,371,95,25,70,4,3
11,391,391,5,2,3,2,1
4,450,450,128,128,0,1,0
9,495,495,102,102,0,1,0

10,119,119,3,3,0,1,0
1,125,125,6,1,5,2,1
8,183,183,41,26,15,4,3
9,292,292,15,15,0,1,0
0,298,298,34,34,0,1,0
6,306,306,83,75,8,2,1
3,369,369,9,9,0,1,0
5,369,369,15,3,12,3,2
2,370,370,1,1,0,1,0
7,375,375,18,18,0,1,0
11,376,376,16,7,9,4,3
12,457,457,101,32,69,4,3
4,465,465,46,8,38,3,2

4,125,125,8,8,0,1,0
1,158,158,4,4,0,1,0
11,262,262,12,12,0,1,0
3,277,277,1,1,0,1,0
9,277,277,9,9,0,1,0
7,278,278,20,6,14,2,1
6,296,296,67,67,0,1,0
2,298,298,14,8,6,2,1
5,299,299,4,1,3,2,1
8,352,352,53,53,0,1,0
10,425,425,126,40,86,3,2
12,442,442,19,19,0,1,0
13,446,446,19,19,0,1,0
0,486,486,73,69,4,2,1

5,119,119,4,4,0,1,0
10,121,121,11,1,10,3,2
14,210,210,8,8,0,1,0
1,230,230,1,1,0,1,0
0,268,268,11,5,6,3,2
7,273,273,22,22,0,1,0
3,275,275,37,37,0,1,0
12,288,288,8,8,0,1,0
6,290,290,5,1,4,2,1
9,334,334,2,2,0,1,0
2,350,350,52,52,0,1,0
15,355,355,37,3,34,3,2
8,399,399,6,1,5,2,1
11,420,420,42,42,0,1,0
13,469,469,118,29,89,4,3
4,476,476,57,57,0,1,0

6,138,138,3,3,0,1,0
0,174,174,20,20,0,1,0
9,184,184,14,1,13,2,1
7,243,243,9,5,4,2,1
1,267,267,84,34,50,2,1
8,270,270,18,18,0,1,0
4,322,322,24,24,0,1,0
5,327,327,38,22,16,3,2
10,347,347,101,101,0,1,0
2,372,372,16,2,14,2,1
3,423,423,23,23,0,1,0

11,108,108,15,9,6,2,1
2,119,119,11,1,10,2,1
8,139,139,2,2,0,1,0
13,139,139,18,18,0,1,0
10,205,205,9,3,6,3,2
4,231,231,18,6,12,3,2
6,338,338,17,17,0,1,0
14,342,342,8,2,6,2,1
5,344,344,39,23,16,3,2
0,357,357,10,10,0,1,0
3,375,375,14,14,0,1,0
7,379,379,59,59,0,1,0
1,484,484,15,15,0,1,0
12,485,485,4,1,3,2,1
9,486,486,134,119,15,2,1

8,109,109,17,2,15,2,1
9,119,119,2,2,0,1,0
0,168,168,45,45,0,1,0
6,235,235,16,2,14,2,1
12,243,243,58,58,0,1,0
10,271,271,27,27,0,1,0
2,324,324,52,4,48,2,1
3,336,336,5,2,3,2,1
4,370,370,10,6,4,2,1
11,380,380,8,8,0,1,0
7,396,396,31,31,0,1,0
5,443,443,2,2,0,1,0
1,488,488,29,2,27,2,1

7,113,113,2,2,0,1,0
4,127,127,5,1,4,2,1
9,164,164,28,12,16,2,1
1,187,187,13,8,5,2,1
3,196,196,17,17,0,1,0
2,214,214,9,2,7,2,1
8,273,273,36,10,26,3,2
5,274,274,14,4,10,3,2
0,345,345,97,87,10,3,2
11,379,379,19,19,0,1,0
6,392,392,8,8,0,1,0
10,397,397,36,7,29,4,3
13,402,402,58,58,0,1,0
12,475,475,12,12,0,1,0

5,111,111,13,13,0,1,0
9,188,188,23,23,0,1,0
4,269,269,9,6,3,2,1
1,309,309,14,14,0,1,0
7,323,323,38,38,0,1,0
11,332,332,5,5,0,1,0
2,357,357,56,22,34,3,2
6,360,360,47,47,0,1,0
8,449,449,55,55,0,1,0
0,456,456,80,80,0,1,0
3,466,466,36,8,28,3,2
10,498,498,52,26,26,2,1

1,198,198,1,1,0,1,0
8,206,206,2,2,0,1,0
4,220,220,15,15,0,1,0
5,348,348,15,15,0,1,0
2,360,360,44,10,34,4,3
3,363,363,128,94,34,2,1
10,394,394,92,71,21,2,1
7,409,409,79,15,64,3,2
9,453,453,46,26,20,2,1
0,455,455,24,6,18,2,1
6,488,488,14,14,0,1,0

13,102,102,17,8,9,4,3
2,108,108,4,1,3,2,1
10,141,141,1,1,0,1,0
15,176,176,2,2,0,1,0
17,184,184,46,46,0,1,0
16,215,215,9,3,6,3,2
5,301,301,36,18,18,3,2
6,326,326,5,5,0,1,0
9,371,371,12,12,0,1,0
12,378,378,41,41,0,1,0
14,384,384,14,14,0,1,0
7,420,420,26,26,0,1,0
8,434,434,18,18,0,1,0
1,453,453,46,4,42,4,3
0,477,477,1,1,0,1,0
3,484,484,3,3,0,1,0
11,488,488,68,68,0,1,0
4,490,490,18,10,8,3,2

2,106,106,3,3,0,1,0
5,106,106,8,8,0,1,0
9,118,118,12,12,0,1,0
11,236,236,49,16,33,2,1
6,281,281,12,12,0,1,0
12,325,325,5,5,0,1,0
4,332,332,54,39,15,2,1
1,341,341,46,46,0,1,0
8,385,385,21,21,0,1,0
0,391,391,1,1,0,1,0
3,403,403,63,63,0,1,0
10,411,411,60,60,0,1,0
7,423,423,35,11,24,4,3

12,103,103,8,2,6,3,2
0,133,133,1,1,0,1,0
2,138,138,6,6,0,1,0
10,193,193,7,7,0,1,0
4,200,200,1,1,0,1,0
14,209,209,29,14,15,4,3
15,280,280,30,10,20,2,1
8,292,292,33,33,0,1,0
1,306,306,16,6,10,2,1
13,324,324,35,35,0,1,0
5,338,338,11,11,0,1,0
7,441,441,31,22,9,4,3
11,456,456,71,71,0,1,0
6,471,471,24,6,18,3,2
9,485,485,18,18,0,1,0
3,492,492,93,16,77,4,3

5,124,124,27,19,8,2,1
8,145,145,1,1,0,1,0
4,146,146,1,1,0,1,0
11,156,156,15,10,5,2,1
0,229,229,1,1,0,1,0
9,316,316,50,50,0,1,0
10,347,347,61,56,5,2,1
6,384,384,40,40,0,1,0
2,419,419,3,3,0,1,0
7,440,440,35,14,21,3,2
3,445,445,43,43,0,1,0
1,500,500,137,70,67,3,2

3,126,126,22,22,0,1,0
2,215,215,57,57,0,1,0
4,230,230,12,3,9,2,1
1,272,272,53,53,0,1,0
7,382,382,3,3,0,1,0
0,388,388,56,56,0,1,0
5,400,400,32,32,0,1,0
8,453,453,13,1,12,4,3
6,485,485,130,121,9,4,3

12,137,137,1,1,0,1,0
8,138,138,20,20,0,1,0
1,161,161,13,1,12,3,2
14,165,165,5,5,0,1,0
0,186,186,5,1,4,2,1
3,191,191,1,1,0,1,0
6,217,217,32,16,16,3,2
13,220,220,72,24,48,4,3
4,239,239,25,2,23,3,2
11,248,248,7,7,0,1,0
2,264,264,13,4,9,2,1
10,335,335,24,24,0,1,0
5,380,380,1,1,0,1,0
9,415,415,62,54,8,2,1
7,475,475,20,20,0,1,0

16,170,170,45,15,30,3,2
14,177,177,1,1,0,1,0
9,193,193,5,5,0,1,0
1,235,235,1,1,0,1,0
2,245,245,6,6,0,1,0
13,246,246,55,44,11,2,1
12,268,268,19,10,9,3,2
7,291,291,14,14,0,1,0
3,292,292,47,47,0,1,0
4,310,310,7,7,0,1,0
5,320,320,9,9,0,1,0
6,327,327,21,17,4,2,1
15,353,353,6,6,0,1,0
10,374,374,46,4,42,3,2
11,398,398,13,10,3,2,1
8,410,410,37,37,0,1,0
0,477,477,4,4,0,1,0

2,198,198,92,46,46,3,2
10,223,223,12,12,0,1,0
8,247,247,34,34,0,1,0
0,362,362,1,1,0,1,0
1,364,364,21,21,0,1,0
11,409,409,60,14,46,2,1
4,425,425,22,8,14,4,3
9,427,427,25,25,0,1,0
3,460,460,8,8,0,1,0
5,463,463,3,3,0,1,0
6,468,468,82,34,48,3,2
7,490,490,17,17,0,1,0

7,115,115,8,3,5,2,1
8,120,120,12,12,0,1,0
9,152,152,30,30,0,1,0
4,168,168,60,60,0,1,0
11,187,187,44,44,0,1,0
1,210,210,18,6,12,4,3
2,223,223,2,2,0,1,0
5,259,259,3,3,0,1,0
10,365,365,1,1,0,1,0
3,404,404,54,54,0,1,0
6,455,455,7,7,0,1,0
0,485,485,3,3,0,1,0

4,163,163,1,1,0,1,0
2,247,247,20,13,7,2,1
6,270,270,15,6,9,4,3
9,272,272,90,78,12,4,3
8,273,273,6,6,0,1,0
3,317,317,153,100,53,4,3
1,369,369,6,6,0,1,0
0,444,444,9,3,6,3,2
5,467,467,44,44,0,1,0
7,473,473,50,7,43,2,1

0,116,116,1,1,0,1,0
11,129,129,15,15,0,1,0
12,150,150,24,2,22,2,1
3,220,220,43,25,18,2,1
4,226,226,8,8,0,1,0
8,238,238,21,21,0,1,0
7,289,289,15,15,0,1,0
6,335,335,38,38,0,1,0
1,354,354,10,1,9,4,3
2,402,402,45,6,39,2,1
5,420,420,45,3,42,4,3
9,420,420,72,42,30,2,1
10,429,429,10,10,0,1,0

10,123,123,29,19,10,3,2
4,154,154,15,3,12,2,1
5,289,289,9,5,4,2,1
1,298,298,13,13,0,1,0
8,313,313,12,12,0,1,0
3,320,320,128,128,0,1,0
2,368,368,19,8,11,2,1
9,461,461,5,5,0,1,0
6,473,473,94,94,0,1,0
7,480,480,43,10,33,4,3
0,497,497,5,5,0,1,0

9,114,114,4,4,0,1,0
1,147,147,13,13,0,1,0
11,150,150,7,7,0,1,0
7,186,186,10,2,8,3,2
6,203,203,19,1,18,2,1
2,260,260,11,5,6,3,2
13,273,273,5,5,0,1,0
12,317,317,86,45,41,2,1
10,334,334,1,1,0,1,0
0,414,414,67,4,63,4,3
5,414,414,7,1,6,3,2
8,436,436,103,53,50,3,2
3,463,463,28,4,24,2,1
4,492,492,41,31,10,2,1

7,161,161,47,9,38,2,1
4,322,322,22,22,0,1,0
2,336,336,66,66,0,1,0
8,340,340,28,28,0,1,0
6,347,347,32,13,19,2,1
5,351,351,3,3,0,1,0
10,363,363,44,20,24,2,1
9,383,383,7,7,0,1,0
3,401,401,2,2,0,1,0
0,441,441,51,40,11,2,1
1,446,446,96,69,27,2,1

9,111,111,3,3,0,1,0
10,127,127,12,12,0,1,0
4,130,130,4,1,3,2,1
16,140,140,18,18,0,1,0
12,158,158,3,3,0,1,0
2,158,158,1,1,0,1,0
8,173,173,13,1,12,2,1
1,221,221,43,43,0,1,0
7,231,231,9,3,6,2,1
14,278,278,19,19,0,1,0
15,371,371,99,99,0,1,0
11,376,376,10,10,0,1,0
13,408,408,43,7,36,4,3
3,420,420,7,3,4,2,1
0,434,434,29,29,0,1,0
6,469,469,6,6,0,1,0
5,494,494,20,2,18,2,1

11,110,110,8,8,0,1,0
0,152,152,36,36,0,1,0
3,159,159,6,2,4,2,1
12,229,229,6,6,0,1,0
14,253,253,29,29,0,1,0
4,274,274,22,22,0,1,0
2,335,335,16,16,0,1,0
5,368,368,3,3,0,1,0
1,420,420,24,24,0,1,0
7,436,436,14,8,6,2,1
15,438,438,5,5,0,1,0
6,447,447,5,2,3,2,1
10,457,457,10,10,0,1,0
13,458,458,41,2,39,4,3
16,471,471,140,83,57,4,3
9,486,486,23,5,18,2,1
8,494,494,10,10,0,1,0

1,125,125,6,1,5,2,1
6,139,139,25,10,15,2,1
7,274,274,53,17,36,4,3
11,307,307,45,23,22,2,1
3,331,331,1,1,0,1,0
4,339,339,127,108,19,2,1
5,350,350,40,23,17,2,1
8,356,356,12,12,0,1,0
2,404,404,24,3,21,3,2
10,408,408,7,7,0,1,0
9,459,459,17,17,0,1,0
0,480,480,1,1,0,1,0

6,133,133,34,2,32,3,2
10,187,187,12,8,4,2,1
4,277,277,13,13,0,1,0
3,285,285,63,63,0,1,0
5,298,298,15,6,9,4,3
2,364,364,27,4,23,2,1
1,374,374,20,20,0,1,0
9,410,410,12,12,0,1,0
8,417,417,60,60,0,1,0
7,423,423,1,1,0,1,0
0,439,439,69,69,0,1,0
11,462,462,54,8,46,4,3

5,105,105,10,2,8,3,2
4,159,159,6,6,0,1,0
8,196,196,22,14,8,3,2
1,225,225,39,5,34,2,1
0,266,266,13,13,0,1,0
10,288,288,16,1,15,4,3
7,290,290,50,50,0,1,0
2,298,298,19,19,0,1,0
3,316,316,88,88,0,1,0
9,399,399,71,71,0,1,0
6,462,462,1,1,0,1,0

15,101,101,5,2,3,2,1
14,102,102,7,7,0,1,0
2,128,128,3,3,0,1,0
3,134,134,15,4,11,2,1
1,142,142,2,2,0,1,0
12,269,269,47,8,39,2,1
0,298,298,15,5,10,2,1
8,306,306,5,5,0,1,0
7,308,308,69,39,30,2,1
6,311,311,35,14,21,4,3
5,315,315,1,1,0,1,0
13,355,355,30,9,21,4,3
9,373,373,3,3,0,1,0
11,415,415,73,21,52,3,2
10,464,464,33,27,6,2,1
4,471,471,18,8,10,3,2

10,135,135,40,9,31,4,3
4,171,171,1,1,0,1,0
5,189,189,17,17,0,1,0
0,204,204,69,69,0,1,0
6,219,219,3,3,0,1,0
11,247,247,13,13,0,1,0
8,306,306,40,40,0,1,0
7,331,331,33,3,30,3,2
2,351,351,20,20,0,1,0
1,372,372,25,25,0,1,0
12,391,391,8,8,0,1,0
3,423,423,13,6,7,2,1
9,474,474,7,7,0,1,0

0,163,163,18,4,14,3,2
6,221,221,10,10,0,1,0
2,239,239,10,7,3,2,1
1,290,290,81,81,0,1,0
10,300,300,34,34,0,1,0
7,325,325,33,33,0,1,0
3,408,408,41,41,0,1,0
9,424,424,119,119,0,1,0
8,432,432,2,2,0,1,0
4,445,445,31,16,15,2,1
5,498,498,33,33,0,1,0

0,105,105,2,2,0,1,0
10,107,107,26,19,7,2,1
6,129,129,3,3,0,1,0
7,136,136,9,9,0,1,0
1,180,180,12,9,3,2,1
4,216,216,43,43,0,1,0
3,226,226,6,3,3,2,1
5,253,253,3,3,0,1,0
2,268,268,75,75,0,1,0
9,324,324,13,9,4,2,1
11,406,406,57,30,27,4,3
8,486,486,51,10,41,2,1

3,104,104,34,34,0,1,0
4,131,131,19,19,0,1,0
6,159,159,1,1,0,1,0
8,165,165,13,7,6,2,1
5,242,242,46,28,18,3,2
7,271,271,42,6,36,2,1
1,327,327,77,77,0,1,0
0,361,361,8,8,0,1,0
2,383,383,8,2,6,3,2
9,466,466,21,21,0,1,0

6,105,105,7,2,5,2,1
0,144,144,25,25,0,1,0
4,146,146,22,22,0,1,0
10,158,158,6,6,0,1,0
11,164,164,5,5,0,1,0
7,167,167,11,11,0,1,0
3,199,199,36,36,0,1,0
9,228,228,5,5,0,1,0
1,313,313,7,2,5,2,1
2,324,324,18,18,0,1,0
5,426,426,8,8,0,1,0
8,444,444,172,150,22,2,1

9,119,119,12,12,0,1,0
3,124,124,1,1,0,1,0
0,126,126,4,4,0,1,0
4,140,140,2,2,0,1,0
13,209,209,4,4,0,1,0
10,274,274,36,24,12,3,2
8,299,299,13,1,12,2,1
7,310,310,24,24,0,1,0
11,339,339,49,49,0,1,0
2,398,398,90,50,40,2,1
5,412,412,36,8,28,2,1
6,424,424,38,38,0,1,0
1,438,438,29,6,23,4,3
12,449,449,78,78,0,1,0

3,189,189,39,17,22,3,2
9,249,249,5,5,0,1,0
0,280,280,2,2,0,1,0
4,292,292,49,37,12,2,1
2,400,400,44,44,0,1,0
8,402,402,53,53,0,1,0
7,454,454,54,54,0,1,0
1,456,456,128,14,114,4,3
6,490,490,18,8,10,3,2
5,495,495,68,20,48,4,3

8,109,109,2,2,0,1,0
2,191,191,75,37,38,3,2
0,298,298,19,8,11,2,1
3,306,306,28,4,24,3,2
11,316,316,14,2,12,2,1
1,325,325,5,2,3,2,1
9,328,328,138,21,117,4,3
6,368,368,8,8,0,1,0
7,379,379,32,2,30,2,1
5,412,412,11,6,5,2,1
4,470,470,5,1,4,2,1
10,492,492,10,10,0,1,0

8,155,155,27,18,9,4,3
0,360,360,83,15,68,3,2
7,371,371,18,6,12,2,1
9,374,374,6,3,3,2,1
3,379,379,42,42,0,1,0
6,385,385,42,42,0,1,0
2,389,389,79,16,63,4,3
5,401,401,102,27,75,3,2
10,430,430,4,4,0,1,0
4,460,460,2,2,0,1,0
1,489,489,26,26,0,1,0

9,103,103,11,11,0,1,0
5,151,151,13,1,12,3,2
0,160,160,45,25,20,3,2
7,247,247,29,5,24,4,3
2,317,317,38,38,0,1,0
8,376,376,52,2,50,4,3
1,390,390,57,46,11,2,1
4,426,426,57,57,0,1,0
3,429,429,23,23,0,1,0
6,443,443,13,13,0,1,0

3,106,106,21,5,16,3,2
6,177,177,14,1,13,2,1
9,333,333,31,31,0,1,0
2,390,390,84,84,0,1,0
1,393,393,57,57,0,1,0
4,421,421,6,6,0,1,0
7,432,432,98,59,39,3,2
5,477,477,45,45,0,1,0
0,483,483,24,24,0,1,0
8,486,486,50,50,0,1,0

7,207,207,29,29,0,1,0
3,261,261,40,8,32,3,2
2,283,283,105,55,50,2,1
1,297,297,9,9,0,1,0
5,308,308,26,13,13,2,1
8,346,346,26,2,24,2,1
4,361,361,37,25,12,4,3
6,370,370,41,41,0,1,0
9,473,473,47,47,0,1,0
0,496,496,23,2,21,2,1

3,105,105,3,3,0,1,0
2,112,112,1,1,0,1,0
7,124,124,3,3,0,1,0
13,136,136,9,1,8,3,2
4,169,169,7,1,6,3,2
0,176,176,1,1,0,1,0
15,208,208,3,3,0,1,0
6,224,224,2,2,0,1,0
5,388,388,44,2,42,3,2
8,438,438,19,3,16,2,1
1,440,440,3,3,0,1,0
11,443,443,51,44,7,2,1
10,448,448,2,2,0,1,0
9,449,449,144,54,90,4,3
14,472,472,21,21,0,1,0
12,477,477,174,151,23,2,1

11,109,109,11,11,0,1,0
12,110,110,8,1,7,2,1
1,111,111,29,29,0,1,0
5,118,118,1,1,0,1,0
10,126,126,27,13,14,3,2
9,268,268,41,41,0,1,0
7,363,363,3,3,0,1,0
0,375,375,32,32,0,1,0
2,390,390,11,11,0,1,0
6,410,410,19,1,18,4,3
8,419,419,26,18,8,2,1
3,478,478,32,32,0,1,0
4,499,499,52,42,10,2,1

1,150,150,34,34,0,1,0
2,198,198,58,24,34,2,1
5,206,206,20,20,0,1,0
3,230,230,7,7,0,1,0
8,257,257,7,7,0,1,0
7,302,302,89,29,60,3,2
9,347,347,47,35,12,4,3
6,360,360,8,8,0,1,0
0,428,428,23,23,0,1,0
4,460,460,16,16,0,1,0

7,103,103,3,3,0,1,0
0,163,163,3,3,0,1,0
13,166,166,8,8,0,1,0
6,253,253,26,26,0,1,0
3,254,254,1,1,0,1,0
4,293,293,3,3,0,1,0
14,295,295,10,10,0,1,0
12,310,310,43,43,0,1,0
11,333,333,3,3,0,1,0
9,341,341,27,27,0,1,0
5,357,357,4,4,0,1,0
10,397,397,120,45,75,4,3
2,435,435,55,55,0,1,0
8,457,457,1,1,0,1,0
1,464,464,138,118,20,3,2

6,126,126,35,35,0,1,0
5,146,146,3,3,0,1,0
1,159,159,26,14,12,4,3
2,175,175,14,14,0,1,0
11,300,300,5,5,0,1,0
0,323,323,32,5,27,2,1
7,357,357,4,1,3,2,1
3,372,372,15,15,0,1,0
8,378,378,6,6,0,1,0
10,423,423,9,1,8,3,2
9,436,436,117,61,56,3,2
4,466,466,94,94,0,1,0

11,212,212,55,35,20,4,3
8,232,232,18,18,0,1,0
4,240,240,30,30,0,1,0
0,245,245,4,4,0,1,0
12,252,252,12,7,5,2,1
3,291,291,8,8,0,1,0
13,292,292,9,9,0,1,0
2,321,321,7,3,4,2,1
14,369,369,33,9,24,3,2
6,386,386,62,20,42,4,3
7,420,420,46,20,26,3,2
9,420,420,53,5,48,4,3
1,436,436,19,14,5,2,1
10,462,462,25,25,0,1,0
5,475,475,10,10,0,1,0

16,116,116,13,13,0,1,0
9,134,134,15,6,9,2,1
0,186,186,2,2,0,1,0
1,200,200,23,7,16,3,2
14,245,245,7,7,0,1,0
8,267,267,2,2,0,1,0
12,275,275,87,54,33,4,3
11,313,313,10,1,9,2,1
4,348,348,9,1,8,2,1
2,356,356,1,1,0,1,0
13,386,386,46,1,45,2,1
15,400,400,3,3,0,1,0
3,404,404,37,37,0,1,0
6,424,424,52,18,34,2,1
7,425,425,1,1,0,1,0
5,492,492,26,13,13,2,1
10,500,500,29,8,21,4,3

5,100,100,16,1,15,2,1
10,138,138,28,4,24,2,1
9,153,153,40,3,37,2,1
7,235,235,15,1,14,3,2
6,236,236,8,5,3,2,1
2,238,238,1,1,0,1,0
0,284,284,27,12,15,4,3
14,296,296,13,10,3,2,1
4,302,302,12,1,11,2,1
11,307,307,4,1,3,2,1
3,314,314,21,9,12,3,2
1,328,328,4,1,3,2,1
13,437,437,37,3,34,4,3
12,447,447,4,4,0,1,0
8,451,451,57,1,56,3,2

12,148,148,30,14,16,3,2
0,229,229,1,1,0,1,0
9,229,229,37,37,0,1,0
4,292,292,13,13,0,1,0
5,299,299,82,70,12,3,2
2,304,304,39,11,28,2,1
8,345,345,6,1,5,2,1
7,401,401,13,7,6,2,1
13,432,432,45,15,30,3,2
10,435,435,32,32,0,1,0
1,440,440,11,11,0,1,0
14,468,468,17,17,0,1,0
3,474,474,4,4,0,1,0
11,474,474,16,3,13,2,1
6,487,487,32,2,30,2,1

15,117,117,26,1,25,2,1
7,124,124,12,12,0,1,0
13,154,154,43,21,22,3,2
9,155,155,13,9,4,2,1
5,161,161,23,5,18,4,3
4,176,176,6,6,0,1,0
0,193,193,2,2,0,1,0
2,202,202,1,1,0,1,0
12,205,205,11,7,4,2,1
3,258,258,13,1,12,4,3
8,258,258,20,20,0,1,0
11,259,259,7,7,0,1,0
6,418,418,1,1,0,1,0
10,446,446,9,9,0,1,0
1,468,468,46,1,45,2,1
14,500,500,3,3,0,1,0

10,101,101,6,2,4,2,1
2,133,133,3,3,0,1,0
7,137,137,1,1,0,1,0
6,156,156,9,9,0,1,0
9,193,193,42,2,40,2,1
8,196,196,18,8,10,3,2
11,280,280,52,24,28,3,2
3,328,328,37,15,22,2,1
0,329,329,11,11,0,1,0
1,346,346,41,41,0,1,0
4,486,486,88,85,3,2,1
5,491,491,65,65,0,1,0

1,152,152,24,8,16,2,1
3,227,227,45,2,43,2,1
2,324,324,50,50,0,1,0
7,345,345,43,43,0,1,0
4,375,375,2,2,0,1,0
0,432,432,192,160,32,4,3
5,469,469,23,23,0,1,0
6,473,473,36,6,30,4,3

5,141,141,11,11,0,1,0
0,187,187,43,43,0,1,0
1,214,214,43,43,0,1,0
2,249,249,43,1,42,2,1
8,271,271,21,21,0,1,0
4,287,287,63,42,21,2,1
3,372,372,21,21,0,1,0
7,436,436,71,71,0,1,0
6,439,439,6,6,0,1,0

1,101,101,8,8,0,1,0
6,144,144,20,20,0,1,0
8,180,180,1,1,0,1,0
5,262,262,1,1,0,1,0
2,272,272,2,2,0,1,0
4,277,277,24,18,6,2,1
9,339,339,19,19,0,1,0
10,350,350,32,21,11,2,1
0,351,351,53,5,48,4,3
11,352,352,77,23,54,3,2
7,418,418,68,68,0,1,0
12,458,458,35,35,0,1,0
3,485,485,65,50,15,4,3

8,103,103,7,7,0,1,0
11,189,189,10,10,0,1,0
7,273,273,27,3,24,4,3
4,277,277,23,23,0,1,0
13,317,317,30,30,0,1,0
10,326,326,29,21,8,2,1
0,370,370,35,35,0,1,0
9,381,381,89,50,39,4,3
3,383,383,33,26,7,2,1
1,385,385,30,12,18,4,3
5,388,388,14,14,0,1,0
6,415,415,23,1,22,2,1
14,449,449,28,18,10,3,2
12,465,465,36,36,0,1,0
2,494,494,2,2,0,1,0

1,104,104,1,1,0,1,0
2,128,128,27,27,0,1,0
11,170,170,30,30,0,1,0
7,198,198,21,3,18,2,1
0,222,222,49,19,30,2,1
6,236,236,10,10,0,1,0
9,251,251,48,38,10,2,1
3,265,265,1,1,0,1,0
4,277,277,40,16,24,2,1
10,333,333,23,5,18,2,1
8,340,340,11,11,0,1,0
5,431,431,5,5,0,1,0

2,167,167,3,3,0,1,0
5,167,167,9,9,0,1,0
1,202,202,1,1,0,1,0
8,213,213,9,9,0,1,0
15,219,219,30,22,8,3,2
11,228,228,5,1,4,2,1
7,255,255,1,1,0,1,0
13,262,262,32,32,0,1,0
3,306,306,7,7,0,1,0
12,310,310,49,14,35,2,1
14,353,353,30,30,0,1,0
4,389,389,4,4,0,1,0
9,404,404,40,40,0,1,0
0,475,475,24,24,0,1,0
6,476,476,141,116,25,2,1
10,498,498,45,15,30,3,2

6,123,123,10,6,4,2,1
3,133,133,2,2,0,1,0
10,135,135,1,1,0,1,0
1,198,198,46,46,0,1,0
5,199,199,15,9,6,3,2
8,235,235,53,26,27,4,3
4,305,305,1,1,0,1,0
2,348,348,22,1,21,4,3
11,388,388,24,24,0,1,0
12,406,406,70,34,36,4,3
0,416,416,56,56,0,1,0
9,432,432,4,4,0,1,0
7,468,468,63,9,54,4,3

15,163,163,3,3,0,1,0
3,175,175,1,1,0,1,0
10,180,180,48,11,37,4,3
4,191,191,1,1,0,1,0
12,196,196,29,6,23,4,3
8,222,222,46,14,32,3,2
6,231,231,11,11,0,1,0
2,250,250,1,1,0,1,0
7,275,275,5,1,4,2,1
11,282,282,1,1,0,1,0
5,291,291,52,38,14,3,2
9,291,291,9,9,0,1,0
1,321,321,19,12,7,2,1
0,364,364,16,16,0,1,0
13,440,440,17,17,0,1,0
14,495,495,66,18,48,2,1

3,101,101,1,1,0,1,0
9,104,104,6,6,0,1,0
8,126,126,10,1,9,4,3
12,169,169,24,5,19,2,1
10,181,181,11,3,8,2,1
5,247,247,3,3,0,1,0
14,317,317,4,4,0,1,0
1,324,324,14,2,12,3,2
6,340,340,3,3,0,1,0
2,367,367,63,2,61,4,3
13,412,412,114,67,47,2,1
4,425,425,11,11,0,1,0
11,474,474,33,8,25,4,3
0,483,483,90,67,23,3,2
7,493,493,34,9,25,2,1

1,106,106,4,1,3,2,1
11,114,114,20,5,15,4,3
10,126,126,2,2,0,1,0
0,163,163,13,13,0,1,0
5,207,207,12,12,0,1,0
12,219,219,21,9,12,2,1
9,239,239,15,15,0,1,0
8,276,276,65,47,18,2,1
3,281,281,13,4,9,2,1
6,294,294,65,41,24,4,3
7,296,296,8,8,0,1,0
2,300,300,13,13,0,1,0
4,421,421,49,49,0,1,0

13,145,145,9,1,8,3,2
6,154,154,4,4,0,1,0
0,165,165,5,5,0,1,0
11,226,226,42,42,0,1,0
4,245,245,43,43,0,1,0
8,284,284,1,1,0,1,0
10,285,285,52,52,0,1,0
9,328,328,20,5,15,2,1
7,385,385,42,22,20,2,1
5,398,398,4,4,0,1,0
14,459,459,21,21,0,1,0
12,467,467,35,9,26,3,2
3,479,479,22,3,19,2,1
1,492,492,2,2,0,1,0
2,500,500,99,83,16,2,1

8,105,105,4,4,0,1,0
11,119,119,19,19,0,1,0
1,135,135,30,2,28,2,1
12,171,171,1,1,0,1,0
9,190,190,31,1,30,3,2
3,253,253,18,4,14,3,2
2,266,266,16,2,14,3,2
10,325,325,74,69,5,2,1
6,339,339,25,25,0,1,0
0,386,386,35,17,18,4,3
5,412,412,13,13,0,1,0
7,428,428,8,3,5,2,1
4,486,486,25,25,0,1,0

13,100,100,2,2,0,1,0
10,166,166,15,15,0,1,0
0,191,191,28,18,10,2,1
3,199,199,1,1,0,1,0
11,230,230,73,73,0,1,0
1,265,265,32,8,24,4,3
8,273,273,6,6,0,1,0
4,314,314,26,9,17,3,2
7,320,320,22,22,0,1,0
12,343,343,11,2,9,4,3
2,378,378,48,40,8,3,2
9,438,438,57,15,42,2,1
6,463,463,16,9,7,3,2
5,470,470,7,7,0,1,0

5,104,104,5,2,3,2,1
0,129,129,26,26,0,1,0
3,148,148,18,11,7,2,1
7,228,228,52,28,24,4,3
8,244,244,2,2,0,1,0
4,314,314,43,14,29,2,1
6,338,338,24,24,0,1,0
1,369,369,88,81,7,2,1
2,435,435,70,70,0,1,0

10,120,120,9,6,3,2,1
6,166,166,7,7,0,1,0
1,172,172,27,27,0,1,0
5,192,192,21,21,0,1,0
7,259,259,21,1,20,3,2
4,302,302,72,72,0,1,0
0,324,324,3,3,0,1,0
8,381,381,112,49,63,4,3
9,409,409,2,2,0,1,0
3,414,414,72,64,8,2,1
2,417,417,10,4,6,3,2

2,141,141,19,19,0,1,0
6,184,184,2,2,0,1,0
5,273,273,2,2,0,1,0
1,289,289,75,75,0,1,0
4,291,291,6,2,4,2,1
7,307,307,24,7,17,3,2
3,332,332,119,90,29,2,1
0,344,344,118,118,0,1,0

6,182,182,46,46,0,1,0
0,185,185,11,3,8,3,2
12,237,237,75,6,69,4,3
11,240,240,6,6,0,1,0
1,261,261,16,16,0,1,0
2,275,275,10,10,0,1,0
3,313,313,4,1,3,2,1
9,342,342,59,59,0,1,0
10,371,371,27,11,16,3,2
4,377,377,25,25,0,1,0
5,378,378,44,17,27,2,1
7,403,403,4,4,0,1,0
8,453,453,5,5,0,1,0

3,108,108,10,1,9,4,3
1,120,120,9,3,6,2,1
9,131,131,18,7,11,2,1
5,141,141,5,1,4,2,1
8,163,163,16,11,5,2,1
12,203,203,10,2,8,3,2
13,315,315,24,24,0,1,0
4,322,322,40,40,0,1,0
7,340,340,10,1,9,4,3
10,414,414,72,20,52,3,2
2,447,447,70,70,0,1,0
0,455,455,26,26,0,1,0
11,456,456,37,37,0,1,0
6,496,496,15,15,0,1,0

10,157,157,12,4,8,2,1
11,201,201,30,18,12,2,1
0,253,253,20,8,12,2,1
5,274,274,57,57,0,1,0
9,276,276,4,4,0,1,0
7,361,361,9,9,0,1,0
4,370,370,63,63,0,1,0
6,377,377,1,1,0,1,0
3,378,378,12,12,0,1,0
8,433,433,55,43,12,3,2
12,460,460,102,81,21,2,1
1,472,472,16,4,12,4,3
2,495,495,37,37,0,1,0

1,101,101,2,2,0,1,0
4,105,105,9,6,3,2,1
10,163,163,41,41,0,1,0
12,170,170,16,16,0,1,0
14,173,173,3,3,0,1,0
7,237,237,19,19,0,1,0
5,257,257,4,4,0,1,0
13,268,268,46,1,45,4,3
8,269,269,20,7,13,2,1
15,339,339,4,1,3,2,1
9,356,356,2,2,0,1,0
11,359,359,23,13,10,3,2
3,390,390,17,13,4,2,1
2,400,400,36,6,30,4,3
0,430,430,9,9,0,1,0
6,442,442,73,34,39,4,3

3,118,118,12,12,0,1,0
14,126,126,5,5,0,1,0
1,165,165,2,2,0,1,0
13,240,240,3,3,0,1,0
8,304,304,2,2,0,1,0
11,333,333,17,5,12,3,2
12,333,333,12,12,0,1,0
10,341,341,146,103,43,4,3
7,343,343,1,1,0,1,0
4,378,378,44,17,27,2,1
2,385,385,86,82,4,2,1
5,387,387,4,4,0,1,0
9,453,453,20,20,0,1,0
0,468,468,38,29,9,4,3
6,489,489,23,11,12,2,1

4,159,159,51,38,13,2,1
9,166,166,3,3,0,1,0
7,191,191,26,26,0,1,0
6,255,255,32,20,12,3,2
3,331,331,108,64,44,2,1
0,351,351,38,22,16,3,2
1,387,387,21,16,5,2,1
5,391,391,2,2,0,1,0
8,408,408,2,2,0,1,0
2,461,461,52,7,45,2,1

6,110,110,17,1,16,4,3
2,152,152,27,3,24,4,3
4,153,153,42,2,40,2,1
9,158,158,4,4,0,1,0
0,179,179,50,50,0,1,0
3,248,248,11,3,8,2,1
5,301,301,4,1,3,2,1
7,400,400,14,14,0,1,0
1,437,437,44,44,0,1,0
8,495,495,56,56,0,1,0

5,160,160,23,8,15,4,3
2,172,172,6,6,0,1,0
12,221,221,7,7,0,1,0
8,241,241,3,3,0,1,0
1,317,317,1,1,0,1,0
10,327,327,135,68,67,3,2
0,329,329,5,5,0,1,0
3,403,403,6,6,0,1,0
4,426,426,2,2,0,1,0
9,432,432,22,22,0,1,0
7,460,460,6,6,0,1,0
11,461,461,42,6,36,2,1
6,466,466,179,103,76,3,2

10,136,136,31,31,0,1,0
8,150,150,10,1,9,2,1
5,155,155,12,2,10,2,1
6,155,155,3,3,0,1,0
3,191,191,3,3,0,1,0
11,205,205,19,2,17,4,3
4,274,274,4,4,0,1,0
7,301,301,13,13,0,1,0
2,377,377,114,39,75,4,3
0,410,410,12,12,0,1,0
12,425,425,55,19,36,4,3
9,432,432,24,24,0,1,0
1,468,468,69,21,48,4,3

10,155,155,30,30,0,1,0
1,179,179,14,4,10,3,2
8,183,183,6,6,0,1,0
4,193,193,57,57,0,1,0
9,193,193,4,4,0,1,0
7,209,209,38,38,0,1,0
5,279,279,24,7,17,2,1
0,349,349,8,8,0,1,0
6,363,363,36,36,0,1,0
2,385,385,19,19,0,1,0
3,482,482,75,30,45,4,3

10,136,136,1,1,0,1,0
9,147,147,9,2,7,2,1
6,174,174,3,3,0,1,0
7,239,239,20,14,6,2,1
5,248,248,46,46,0,1,0
1,353,353,29,7,22,3,2
8,392,392,102,69,33,2,1
3,395,395,47,47,0,1,0
4,443,443,20,2,18,2,1
2,468,468,135,49,86,3,2
0,472,472,31,31,0,1,0

7,106,106,5,5,0,1,0
13,120,120,13,13,0,1,0
1,148,148,6,2,4,2,1
11,157,157,2,2,0,1,0
18,167,167,4,1,3,2,1
6,179,179,9,9,0,1,0
2,198,198,1,1,0,1,0
14,199,199,1,1,0,1,0
0,200,200,13,4,9,2,1
4,201,201,8,8,0,1,0
3,234,234,12,12,0,1,0
15,299,299,4,1,3,2,1
16,307,307,19,4,15,2,1
8,331,331,10,1,9,2,1
17,333,333,133,55,78,3,2
5,372,372,1,1,0,1,0
12,396,396,31,31,0,1,0
9,398,398,55,11,44,3,2
10,415,415,17,17,0,1,0

10,109,109,3,3,0,1,0
8,263,263,47,47,0,1,0
7,273,273,60,60,0,1,0
1,282,282,12,12,0,1,0
6,286,286,3,3,0,1,0
9,290,290,42,42,0,1,0
0,390,390,31,31,0,1,0
2,395,395,146,125,21,2,1
3,419,419,11,11,0,1,0
5,429,429,12,12,0,1,0
4,481,481,40,19,21,4,3

9,133,133,1,1,0,1,0
10,157,157,14,14,0,1,0
4,163,163,10,6,4,2,1
3,165,165,6,6,0,1,0
8,171,171,5,5,0,1,0
6,183,183,7,1,6,2,1
15,186,186,3,3,0,1,0
16,188,188,20,10,10,3,2
1,234,234,7,7,0,1,0
7,243,243,10,10,0,1,0
0,244,244,4,1,3,2,1
2,265,265,18,18,0,1,0
11,304,304,8,8,0,1,0
13,329,329,52,37,15,4,3
14,382,382,93,39,54,3,2
12,448,448,26,26,0,1,0
5,459,459,72,17,55,4,3
17,477,477,12,12,0,1,0

9,121,121,11,11,0,1,0
4,131,131,1,1,0,1,0
0,133,133,1,1,0,1,0
6,136,136,5,5,0,1,0
5,170,170,13,1,12,3,2
11,177,177,13,13,0,1,0
14,270,270,3,3,0,1,0
7,332,332,5,5,0,1,0
12,359,359,24,24,0,1,0
1,360,360,19,19,0,1,0
15,402,402,9,9,0,1,0
13,452,452,155,44,111,4,3
10,457,457,43,38,5,2,1
8,466,466,7,7,0,1,0
2,469,469,106,62,44,3,2
3,480,480,36,36,0,1,0

7,176,176,25,25,0,1,0
1,216,216,32,32,0,1,0
10,300,300,7,7,0,1,0
3,338,338,9,9,0,1,0
0,378,378,10,10,0,1,0
2,381,381,1,1,0,1,0
5,413,413,69,9,60,4,3
9,450,450,36,6,30,3,2
4,454,454,105,57,48,3,2
8,455,455,10,10,0,1,0
11,463,463,13,13,0,1,0
6,467,467,147,59,88,4,3

3,115,115,4,4,0,1,0
8,123,123,12,12,0,1,0
11,196,196,6,6,0,1,0
6,199,199,4,4,0,1,0
1,207,207,59,19,40,2,1
9,226,226,9,3,6,2,1
4,228,228,15,15,0,1,0
2,345,345,4,1,3,2,1
10,379,379,74,43,31,4,3
0,386,386,35,8,27,2,1
7,483,483,112,54,58,4,3
5,484,484,55,55,0,1,0

2,118,118,15,15,0,1,0
3,184,184,11,1,10,2,1
1,215,215,12,12,0,1,0
9,252,252,10,10,0,1,0
6,260,260,44,38,6,2,1
4,289,289,1,1,0,1,0
10,325,325,105,15,90,4,3
5,362,362,23,23,0,1,0
12,376,376,51,17,34,4,3
8,393,393,7,7,0,1,0
11,423,423,9,2,7,2,1
7,469,469,34,34,0,1,0
0,497,497,62,27,35,2,1

10,100,100,13,7,6,3,2
7,148,148,6,6,0,1,0
6,341,341,10,10,0,1,0
9,352,352,73,73,0,1,0
5,391,391,32,7,25,2,1
8,403,403,40,27,13,2,1
1,427,427,9,9,0,1,0
2,429,429,31,31,0,1,0
3,441,441,119,119,0,1,0
4,452,452,19,19,0,1,0
11,486,486,49,33,16,2,1
0,490,490,56,56,0,1,0

6,145,145,39,39,0,1,0
2,183,183,22,22,0,1,0
7,222,222,3,3,0,1,0
3,289,289,40,40,0,1,0
0,325,325,98,18,80,4,3
1,362,362,15,1,14,3,2
8,397,397,4,1,3,2,1
9,455,455,60,23,37,4,3
4,480,480,77,23,54,4,3
5,488,488,14,2,12,2,1

1,144,144,2,2,0,1,0
5,145,145,26,26,0,1,0
8,264,264,15,15,0,1,0
2,277,277,26,5,21,4,3
11,298,298,8,1,7,2,1
10,309,309,11,11,0,1,0
3,315,315,41,29,12,3,2
7,335,335,91,91,0,1,0
0,348,348,9,3,6,3,2
12,376,376,24,24,0,1,0
4,407,407,37,37,0,1,0
9,438,438,68,68,0,1,0
6,458,458,31,11,20,2,1

11,219,219,63,15,48,3,2
10,243,243,3,3,0,1,0
14,261,261,8,3,5,2,1
12,270,270,16,16,0,1,0
7,275,275,7,7,0,1,0
13,320,320,65,65,0,1,0
8,331,331,3,3,0,1,0
3,376,376,1,1,0,1,0
0,398,398,41,41,0,1,0
9,403,403,11,7,4,2,1
5,417,417,18,18,0,1,0
2,437,437,41,37,4,2,1
6,444,444,58,42,16,3,2
15,445,445,7,4,3,2,1
4,497,497,61,27,34,3,2
1,499,499,22,12,10,3,2

11,174,174,5,5,0,1,0
7,186,186,31,7,24,3,2
13,202,202,1,1,0,1,0
1,227,227,1,1,0,1,0
9,276,276,15,8,7,2,1
4,348,348,11,11,0,1,0
8,394,394,127,111,16,3,2
5,404,404,45,45,0,1,0
3,421,421,62,62,0,1,0
6,433,433,36,24,12,4,3
0,451,451,21,21,0,1,0
10,478,478,86,86,0,1,0
12,497,497,8,8,0,1,0
2,500,500,7,7,0,1,0

4,139,139,3,3,0,1,0
6,192,192,24,24,0,1,0
9,257,257,37,7,30,3,2
13,269,269,61,35,26,2,1
12,313,313,31,20,11,2,1
0,316,316,13,13,0,1,0
5,316,316,94,94,0,1,0
8,421,421,10,10,0,1,0
7,422,422,30,2,28,4,3
3,429,429,8,8,0,1,0
2,437,437,1,1,0,1,0
11,461,461,13,13,0,1,0
1,491,491,12,12,0,1,0
10,498,498,44,22,22,3,2

3,118,118,16,16,0,1,0
0,253,253,46,46,0,1,0
2,298,298,29,5,24,4,3
5,375,375,29,29,0,1,0
4,385,385,67,1,66,4,3
7,387,387,57,57,0,1,0
1,417,417,135,121,14,3,2
8,490,490,13,3,10,2,1
6,499,499,24,20,4,2,1

7,106,106,8,8,0,1,0
8,164,164,22,11,11,2,1
9,199,199,21,21,0,1,0
0,212,212,8,8,0,1,0
4,264,264,30,30,0,1,0
5,293,293,29,29,0,1,0
1,313,313,33,33,0,1,0
10,376,376,53,53,0,1,0
2,380,380,69,45,24,2,1
3,383,383,24,10,14,2,1
6,409,409,64,38,26,2,1
11,427,427,1,1,0,1,0

5,230,230,2,2,0,1,0
3,247,247,20,20,0,1,0
9,251,251,13,2,11,2,1
7,255,255,14,14,0,1,0
8,262,262,23,14,9,4,3
2,304,304,16,8,8,3,2
4,355,355,102,85,17,2,1
1,422,422,101,21,80,3,2
0,461,461,105,9,96,4,3
6,498,498,59,59,0,1,0

13,154,154,8,2,6,2,1
6,190,190,2,2,0,1,0
15,193,193,9,4,5,2,1
3,204,204,24,5,19,2,1
14,225,225,45,41,4,2,1
10,236,236,10,4,6,2,1
9,244,244,44,8,36,2,1
0,249,249,7,7,0,1,0
16,262,262,45,22,23,2,1
2,265,265,7,7,0,1,0
4,286,286,30,16,14,2,1
11,292,292,9,9,0,1,0
1,306,306,17,9,8,2,1
8,335,335,7,7,0,1,0
12,368,368,41,29,12,4,3
5,427,427,2,2,0,1,0
7,487,487,5,5,0,1,0

4,129,129,1,1,0,1,0
14,169,169,20,1,19,3,2
13,205,205,5,5,0,1,0
11,220,220,15,15,0,1,0
7,222,222,2,2,0,1,0
1,257,257,33,33,0,1,0
6,293,293,25,3,22,2,1
5,337,337,1,1,0,1,0
3,388,388,30,30,0,1,0
0,390,390,25,25,0,1,0
9,395,395,120,25,95,4,3
8,401,401,9,6,3,2,1
12,411,411,9,9,0,1,0
10,445,445,34,34,0,1,0
2,477,477,97,25,72,3,2

13,116,116,7,7,0,1,0
9,158,158,3,3,0,1,0
4,208,208,18,18,0,1,0
2,216,216,1,1,0,1,0
6,228,228,16,7,9,2,1
11,242,242,27,7,20,3,2
1,253,253,13,1,12,2,1
5,279,279,7,7,0,1,0
12,363,363,76,76,0,1,0
10,366,366,61,61,0,1,0
0,433,433,55,28,27,4,3
8,441,441,19,19,0,1,0
3,456,456,99,87,12,2,1
7,475,475,9,9,0,1,0

0,100,100,34,16,18,4,3
6,100,100,1,1,0,1,0
9,136,136,10,2,8,3,2
3,143,143,9,3,6,2,1
7,203,203,50,50,0,1,0
12,263,263,1,1,0,1,0
5,327,327,15,12,3,2,1
2,342,342,1,1,0,1,0
10,361,361,39,9,30,3,2
8,370,370,53,19,34,3,2
11,383,383,14,2,12,3,2
4,447,447,8,8,0,1,0
1,477,477,60,60,0,1,0

5,110,110,3,3,0,1,0
11,178,178,22,4,18,2,1
2,211,211,33,33,0,1,0
0,224,224,19,19,0,1,0
9,228,228,3,3,0,1,0
10,325,325,69,69,0,1,0
13,330,330,38,2,36,4,3
12,331,331,22,22,0,1,0
1,363,363,4,4,0,1,0
8,379,379,31,31,0,1,0
3,381,381,22,5,17,2,1
4,422,422,20,8,12,4,3
6,429,429,74,74,0,1,0
7,462,462,20,10,10,2,1

10,118,118,14,14,0,1,0
5,133,133,15,15,0,1,0
8,141,141,19,3,16,3,2
11,176,176,30,18,12,4,3
0,202,202,8,8,0,1,0
9,215,215,20,14,6,3,2
6,226,226,7,7,0,1,0
3,256,256,6,6,0,1,0
1,261,261,50,11,39,4,3
2,285,285,37,22,15,4,3
4,383,383,41,35,6,3,2
7,412,412,30,30,0,1,0

10,130,130,5,2,3,2,1
14,136,136,3,3,0,1,0
2,141,141,8,4,4,2,1
12,147,147,45,45,0,1,0
9,246,246,3,3,0,1,0
6,267,267,36,36,0,1,0
7,279,279,1,1,0,1,0
4,341,341,1,1,0,1,0
8,387,387,26,1,25,2,1
3,388,388,22,22,0,1,0
0,411,411,26,26,0,1,0
5,446,446,55,27,28,2,1
1,469,469,43,31,12,2,1
11,470,470,23,11,12,2,1
13,472,472,86,60,26,2,1

4,100,100,2,2,0,1,0
1,184,184,85,21,64,3,2
2,194,194,12,6,6,3,2
10,213,213,31,31,0,1,0
8,220,220,17,17,0,1,0
9,350,350,27,9,18,4,3
0,364,364,4,4,0,1,0
7,406,406,30,27,3,2,1
5,410,410,33,14,19,2,1
3,426,426,22,22,0,1,0
6,494,494,76,76,0,1,0

9,190,190,7,7,0,1,0
0,194,194,27,27,0,1,0
6,227,227,20,20,0,1,0
3,260,260,21,3,18,3,2
4,268,268,1,1,0,1,0
11,353,353,48,16,32,3,2
8,381,381,99,93,6,3,2
10,384,384,15,15,0,1,0
12,439,439,3,3,0,1,0
1,462,462,65,20,45,2,1
2,469,469,26,1,25,2,1
7,469,469,62,41,21,4,3
5,497,497,46,5,41,2,1

7,101,101,6,6,0,1,0
3,123,123,1,1,0,1,0
0,270,270,26,26,0,1,0
10,288,288,23,23,0,1,0
2,307,307,7,2,5,2,1
8,308,308,48,16,32,3,2
4,324,324,42,6,36,4,3
5,397,397,32,3,29,2,1
9,423,423,66,66,0,1,0
1,442,442,152,152,0,1,0
6,459,459,40,8,32,4,3

6,118,118,10,3,7,2,1
2,128,128,52,52,0,1,0
3,184,184,17,5,12,3,2
8,184,184,74,74,0,1,0
5,228,228,5,1,4,2,1
4,238,238,3,3,0,1,0
7,383,383,2,2,0,1,0
1,435,435,39,1,38,3,2
9,440,440,41,17,24,4,3
0,476,476,7,7,0,1,0

0,108,108,21,21,0,1,0
5,113,113,10,2,8,3,2
1,194,194,9,9,0,1,0
9,208,208,15,15,0,1,0
4,235,235,7,7,0,1,0
12,261,261,12,3,9,4,3
11,262,262,39,39,0,1,0
8,329,329,35,35,0,1,0
6,337,337,30,26,4,2,1
7,337,337,58,10,48,2,1
2,366,366,3,3,0,1,0
10,428,428,28,1,27,3,2
3,485,485,71,19,52,3,2

6,101,101,7,7,0,1,0
10,116,116,6,6,0,1,0
7,200,200,43,31,12,2,1
1,247,247,13,7,6,3,2
0,248,248,6,6,0,1,0
11,300,300,41,41,0,1,0
8,308,308,34,26,8,3,2
12,319,319,4,4,0,1,0
2,400,400,67,67,0,1,0
4,409,409,68,68,0,1,0
5,440,440,2,2,0,1,0
9,448,448,39,39,0,1,0
3,460,460,55,40,15,2,1

0,133,133,17,1,16,2,1
6,212,212,23,23,0,1,0
10,273,273,7,1,6,3,2
8,283,283,25,16,9,4,3
9,406,406,11,11,0,1,0
7,422,422,126,30,96,4,3
4,438,438,85,85,0,1,0
1,452,452,31,3,28,3,2
3,466,466,69,69,0,1,0
5,467,467,28,20,8,2,1
2,492,492,31,31,0,1,0

11,128,128,17,17,0,1,0
1,140,140,20,20,0,1,0
14,157,157,2,2,0,1,0
7,169,169,2,2,0,1,0
16,176,176,15,2,13,2,1
2,176,176,16,16,0,1,0
13,202,202,57,57,0,1,0
10,205,205,4,4,0,1,0
3,244,244,6,6,0,1,0
6,267,267,19,10,9,4,3
5,275,275,2,2,0,1,0
0,304,304,40,25,15,2,1
8,358,358,15,9,6,3,2
15,393,393,30,30,0,1,0
4,406,406,1,1,0,1,0
9,467,467,28,28,0,1,0
12,469,469,11,5,6,3,2

0,137,137,38,38,0,1,0
8,164,164,5,2,3,2,1
7,173,173,16,16,0,1,0
2,177,177,3,3,0,1,0
6,220,220,30,30,0,1,0
5,225,225,12,12,0,1,0
1,334,334,103,62,41,2,1
4,455,455,73,49,24,2,1
3,486,486,69,69,0,1,0

1,104,104,18,4,14,3,2
14,135,135,11,3,8,3,2
5,144,144,1,1,0,1,0
10,144,144,14,14,0,1,0
0,153,153,1,1,0,1,0
8,192,192,3,3,0,1,0
13,194,194,40,18,22,2,1
9,200,200,7,7,0,1,0
2,236,236,42,4,38,3,2
12,241,241,4,4,0,1,0
3,267,267,16,8,8,3,2
4,279,279,21,21,0,1,0
15,378,378,23,23,0,1,0
7,393,393,13,13,0,1,0
6,460,460,8,2,6,3,2
11,471,471,72,6,66,3,2

8,101,101,6,6,0,1,0
1,184,184,2,2,0,1,0
7,264,264,20,14,6,2,1
4,270,270,43,43,0,1,0
6,321,321,94,94,0,1,0
2,378,378,11,5,6,2,1
5,379,379,4,1,3,2,1
3,388,388,103,46,57,4,3
0,420,420,57,57,0,1,0
10,433,433,21,21,0,1,0
9,485,485,60,60,0,1,0

6,140,140,11,1,10,3,2
2,150,150,35,35,0,1,0
10,154,154,16,12,4,2,1
0,271,271,35,4,31,2,1
8,310,310,34,20,14,2,1
5,418,418,9,9,0,1,0
7,443,443,38,38,0,1,0
3,446,446,46,18,28,2,1
9,452,452,96,96,0,1,0
4,470,470,4,1,3,2,1
1,487,487,62,34,28,2,1

6,135,135,4,4,0,1,0
10,188,188,12,12,0,1,0
5,218,218,41,41,0,1,0
2,255,255,37,37,0,1,0
4,292,292,24,4,20,3,2
1,379,379,51,51,0,1,0
9,386,386,4,4,0,1,0
0,389,389,75,46,29,2,1
8,399,399,102,41,61,4,3
7,411,411,26,4,22,2,1
3,417,417,20,11,9,4,3

0,107,107,1,1,0,1,0
2,131,131,10,10,0,1,0
12,145,145,12,6,6,3,2
6,160,160,22,12,10,3,2
5,187,187,2,2,0,1,0
8,192,192,5,2,3,2,1
3,228,228,10,10,0,1,0
14,241,241,13,13,0,1,0
13,246,246,21,21,0,1,0
10,263,263,6,6,0,1,0
7,271,271,17,17,0,1,0
11,295,295,9,9,0,1,0
9,325,325,8,8,0,1,0
16,341,341,110,16,94,3,2
4,438,438,64,9,55,3,2
15,440,440,15,3,12,4,3
1,443,443,18,18,0,1,0

0,100,100,4,4,0,1,0
2,105,105,15,6,9,2,1
12,169,169,3,3,0,1,0
6,170,170,21,21,0,1,0
7,241,241,8,8,0,1,0
3,271,271,56,56,0,1,0
4,352,352,24,24,0,1,0
9,361,361,27,9,18,4,3
10,444,444,15,2,13,2,1
8,446,446,40,40,0,1,0
1,459,459,9,9,0,1,0
5,477,477,2,2,0,1,0
11,479,479,171,171,0,1,0

5,116,116,3,3,0,1,0
4,173,173,32,16,16,3,2
7,180,180,4,4,0,1,0
3,185,185,3,3,0,1,0
1,191,191,20,20,0,1,0
12,240,240,34,28,6,2,1
2,255,255,19,3,16,2,1
11,312,312,65,31,34,3,2
10,317,317,25,25,0,1,0
6,382,382,45,12,33,4,3
0,447,447,35,3,32,2,1
9,488,488,41,41,0,1,0
8,489,489,37,37,0,1,0

4,107,107,18,6,12,3,2
5,108,108,17,11,6,3,2
0,152,152,25,1,24,4,3
7,154,154,7,7,0,1,0
3,208,208,3,3,0,1,0
2,237,237,3,3,0,1,0
6,273,273,58,11,47,4,3
1,456,456,199,154,45,2,1

3,132,132,6,6,0,1,0
11,163,163,22,13,9,2,1
7,193,193,23,3,20,2,1
6,204,204,29,29,0,1,0
4,326,326,97,14,83,3,2
9,355,355,39,39,0,1,0
1,386,386,81,70,11,3,2
2,393,393,11,1,10,2,1
5,403,403,7,7,0,1,0
8,426,426,37,4,33,2,1
10,441,441,10,4,6,2,1
0,485,485,2,2,0,1,0

12,117,117,7,7,0,1,0
1,130,130,6,3,3,2,1
10,138,138,2,2,0,1,0
7,145,145,28,9,19,2,1
6,228,228,5,1,4,2,1
5,241,241,35,35,0,1,0
9,246,246,67,20,47,2,1
8,306,306,20,20,0,1,0
0,337,337,18,10,8,2,1
11,398,398,14,14,0,1,0
13,418,418,69,39,30,2,1
4,419,419,1,1,0,1,0
3,438,438,22,13,9,2,1
2,461,461,41,23,18,2,1

0,106,106,3,3,0,1,0
5,121,121,1,1,0,1,0
2,126,126,12,12,0,1,0
15,146,146,20,11,9,4,3
13,154,154,22,5,17,2,1
18,164,164,30,6,24,2,1
6,165,165,8,8,0,1,0
16,191,191,11,1,10,3,2
17,286,286,9,9,0,1,0
11,288,288,16,4,12,3,2
8,313,313,6,6,0,1,0
10,331,331,34,17,17,2,1
1,378,378,3,3,0,1,0
3,389,389,1,1,0,1,0
9,399,399,42,42,0,1,0
14,423,423,28,28,0,1,0
4,455,455,30,30,0,1,0
7,487,487,29,29,0,1,0
12,494,494,1,1,0,1,0

8,218,218,47,47,0,1,0
9,236,236,17,13,4,2,1
5,303,303,47,47,0,1,0
1,326,326,13,2,11,4,3
10,336,336,1,1,0,1,0
7,356,356,68,68,0,1,0
4,415,415,21,21,0,1,0
2,428,428,73,58,15,2,1
0,450,450,38,35,3,2,1
11,466,466,57,23,34,3,2
3,478,478,49,49,0,1,0
6,483,483,2,2,0,1,0

12,133,133,11,3,8,2,1
3,140,140,13,13,0,1,0
5,162,162,3,3,0,1,0
11,179,179,6,6,0,1,0
0,213,213,36,31,5,2,1
10,255,255,78,56,22,3,2
9,260,260,5,1,4,2,1
8,265,265,5,5,0,1,0
14,292,292,35,2,33,4,3
7,331,331,10,5,5,2,1
1,337,337,9,9,0,1,0
2,358,358,1,1,0,1,0
6,370,370,19,6,13,2,1
13,402,402,20,9,11,4,3
4,442,442,85,85,0,1,0

7,122,122,13,13,0,1,0
5,135,135,4,1,3,2,1
4,232,232,4,4,0,1,0
6,244,244,63,63,0,1,0
8,257,257,28,28,0,1,0
9,314,314,10,10,0,1,0
0,379,379,21,6,15,3,2
3,387,387,24,24,0,1,0
2,405,405,135,80,55,3,2
1,437,437,59,14,45,4,3
10,473,473,36,36,0,1,0

5,153,153,15,15,0,1,0
0,158,158,18,18,0,1,0
1,175,175,43,43,0,1,0
6,250,250,55,55,0,1,0
11,258,258,20,1,19,3,2
2,286,286,2,2,0,1,0
4,304,304,41,13,28,2,1
9,363,363,17,17,0,1,0
3,435,435,1,1,0,1,0
8,455,455,6,1,5,2,1
7,485,485,22,22,0,1,0
10,498,498,102,12,90,3,2

9,131,131,3,3,0,1,0
3,185,185,3,3,0,1,0
6,205,205,15,11,4,2,1
12,240,240,26,26,0,1,0
10,241,241,55,13,42,3,2
11,253,253,52,52,0,1,0
0,267,267,104,104,0,1,0
7,309,309,8,8,0,1,0
2,326,326,16,12,4,2,1
4,359,359,8,8,0,1,0
8,403,403,7,7,0,1,0
5,468,468,4,4,0,1,0
1,481,481,22,12,10,2,1

17,111,111,6,6,0,1,0
11,115,115,2,2,0,1,0
4,118,118,1,1,0,1,0
1,149,149,16,11,5,2,1
5,168,168,18,10,8,2,1
16,189,189,61,61,0,1,0
15,192,192,7,7,0,1,0
14,203,203,4,4,0,1,0
9,242,242,15,3,12,2,1
2,254,254,1,1,0,1,0
3,270,270,27,21,6,2,1
8,290,290,5,5,0,1,0
6,293,293,21,13,8,3,2
0,325,325,10,10,0,1,0
10,347,347,17,17,0,1,0
13,355,355,14,14,0,1,0
7,372,372,11,11,0,1,0
12,442,442,63,24,39,2,1

5,109,109,14,14,0,1,0
0,126,126,6,6,0,1,0
3,231,231,92,75,17,2,1
9,305,305,25,25,0,1,0
1,356,356,39,21,18,4,3
2,373,373,18,18,0,1,0
4,404,404,26,10,16,3,2
6,419,419,59,59,0,1,0
8,436,436,29,2,27,4,3
7,441,441,57,57,0,1,0

3,109,109,14,14,0,1,0
7,143,143,9,9,0,1,0
6,144,144,23,23,0,1,0
0,162,162,23,23,0,1,0
10,210,210,5,2,3,2,1
1,272,272,28,12,16,3,2
8,311,311,41,41,0,1,0
5,319,319,56,56,0,1,0
4,370,370,18,1,17,3,2
2,412,412,74,29,45,4,3
9,456,456,26,26,0,1,0

10,123,123,6,6,0,1,0
2,166,166,1,1,0,1,0
3,176,176,1,1,0,1,0
7,193,193,8,8,0,1,0
6,310,310,9,9,0,1,0
9,310,310,28,28,0,1,0
5,334,334,91,64,27,4,3
8,335,335,49,34,15,2,1
12,395,395,27,22,5,2,1
1,444,444,55,40,15,4,3
0,457,457,50,45,5,2,1
11,480,480,103,56,47,4,3
4,490,490,27,27,0,1,0

6,147,147,10,6,4,2,1
2,237,237,24,6,18,2,1
5,262,262,29,29,0,1,0
0,273,273,49,49,0,1,0
10,275,275,15,15,0,1,0
1,288,288,9,9,0,1,0
4,326,326,38,38,0,1,0
9,367,367,20,5,15,2,1
7,390,390,42,42,0,1,0
8,397,397,86,86,0,1,0
3,470,470,81,81,0,1,0

7,157,157,14,14,0,1,0
5,185,185,50,50,0,1,0
0,204,204,1,1,0,1,0
8,205,205,34,10,24,3,2
4,216,216,41,11,30,2,1
11,238,238,8,8,0,1,0
2,316,316,2,2,0,1,0
10,349,349,52,52,0,1,0
9,363,363,56,56,0,1,0
1,386,386,38,38,0,1,0
6,428,428,7,7,0,1,0
3,466,466,15,15,0,1,0

11,122,122,3,3,0,1,0
15,125,125,4,1,3,2,1
3,132,132,1,1,0,1,0
0,151,151,3,3,0,1,0
13,153,153,56,56,0,1,0
10,171,171,9,9,0,1,0
1,173,173,8,8,0,1,0
9,173,173,2,2,0,1,0
7,197,197,9,9,0,1,0
4,216,216,11,3,8,3,2
12,216,216,28,28,0,1,0
8,242,242,21,21,0,1,0
18,265,265,1,1,0,1,0
16,331,331,3,3,0,1,0
17,356,356,36,36,0,1,0
6,361,361,17,8,9,4,3
14,445,445,46,46,0,1,0
5,449,449,11,11,0,1,0
2,472,472,27,27,0,1,0

0,176,176,12,7,5,2,1
6,207,207,33,21,12,3,2
8,271,271,48,48,0,1,0
9,282,282,26,26,0,1,0
5,299,299,5,5,0,1,0
2,388,388,164,72,92,4,3
1,394,394,39,9,30,3,2
3,416,416,5,5,0,1,0
7,434,434,22,22,0,1,0
4,437,437,50,44,6,2,1

12,114,114,41,41,0,1,0
3,154,154,3,3,0,1,0
13,167,167,11,6,5,2,1
2,171,171,18,3,15,4,3
14,214,214,6,6,0,1,0
0,215,215,16,16,0,1,0
7,266,266,14,7,7,2,1
10,295,295,30,10,20,2,1
1,317,317,16,6,10,3,2
5,319,319,6,6,0,1,0
11,367,367,1,1,0,1,0
6,375,375,16,16,0,1,0
15,403,403,22,22,0,1,0
8,433,433,27,6,21,2,1
9,434,434,55,55,0,1,0
4,454,454,22,22,0,1,0

2,112,112,9,2,7,2,1
0,123,123,16,16,0,1,0
9,130,130,6,6,0,1,0
5,147,147,2,2,0,1,0
10,166,166,2,2,0,1,0
13,188,188,51,51,0,1,0
8,308,308,13,9,4,2,1
15,331,331,46,46,0,1,0
11,337,337,1,1,0,1,0
12,343,343,46,18,28,3,2
1,357,357,24,16,8,3,2
14,389,389,14,14,0,1,0
6,413,413,3,3,0,1,0
4,416,416,13,8,5,2,1
16,485,485,13,8,5,2,1
7,489,489,62,18,44,3,2
3,500,500,24,21,3,2,1

13,110,110,19,19,0,1,0
6,181,181,19,19,0,1,0
11,284,284,36,36,0,1,0
10,298,298,29,17,12,4,3
9,300,300,26,22,4,2,1
0,322,322,1,1,0,1,0
14,322,322,28,17,11,2,1
7,333,333,5,2,3,2,1
2,338,338,56,56,0,1,0
5,338,338,31,10,21,2,1
15,390,390,4,4,0,1,0
8,412,412,12,12,0,1,0
12,440,440,51,40,11,2,1
1,456,456,25,25,0,1,0
3,464,464,14,14,0,1,0
4,491,491,10,10,0,1,0

5,120,120,3,3,0,1,0
10,139,139,10,10,0,1,0
4,143,143,23,7,16,3,2
1,164,164,20,6,14,3,2
0,171,171,29,12,17,2,1
7,225,225,43,7,36,4,3
2,304,304,6,6,0,1,0
8,385,385,36,31,5,2,1
9,392,392,63,63,0,1,0
6,412,412,30,15,15,2,1
3,452,452,58,58,0,1,0

11,107,107,3,3,0,1,0
1,253,253,23,3,20,2,1
5,255,255,12,12,0,1,0
6,255,255,30,30,0,1,0
4,289,289,19,4,15,3,2
8,320,320,49,11,38,2,1
10,330,330,50,38,12,3,2
7,357,357,13,7,6,2,1
3,382,382,1,1,0,1,0
0,411,411,37,37,0,1,0
9,453,453,58,28,30,3,2
2,499,499,153,133,20,4,3

14,138,138,2,2,0,1,0
8,209,209,17,2,15,2,1
3,221,221,12,12,0,1,0
9,249,249,92,92,0,1,0
0,253,253,28,28,0,1,0
13,271,271,9,9,0,1,0
10,320,320,42,8,34,2,1
7,348,348,22,22,0,1,0
11,372,372,7,3,4,2,1
6,400,400,21,21,0,1,0
1,411,411,30,30,0,1,0
12,444,444,19,1,18,4,3
2,445,445,29,16,13,2,1
4,487,487,23,9,14,3,2
5,493,493,26,14,12,4,3

9,182,182,47,13,34,3,2
0,194,194,1,1,0,1,0
4,194,194,5,5,0,1,0
8,206,206,11,11,0,1,0
13,293,293,7,7,0,1,0
3,311,311,23,23,0,1,0
7,313,313,67,57,10,2,1
5,334,334,15,15,0,1,0
6,346,346,45,45,0,1,0
1,374,374,18,18,0,1,0
11,384,384,16,1,15,4,3
10,445,445,14,14,0,1,0
2,463,463,27,3,24,4,3
12,484,484,98,23,75,4,3

4,110,110,1,1,0,1,0
11,167,167,5,1,4,2,1
13,182,182,4,4,0,1,0
12,205,205,47,47,0,1,0
5,226,226,14,14,0,1,0
7,256,256,1,1,0,1,0
6,293,293,18,12,6,3,2
3,312,312,20,11,9,2,1
14,324,324,37,37,0,1,0
8,334,334,18,9,9,4,3
1,379,379,28,28,0,1,0
2,399,399,17,17,0,1,0
10,420,420,50,50,0,1,0
0,456,456,105,105,0,1,0
9,469,469,46,16,30,2,1

5,105,105,2,2,0,1,0
2,159,159,11,11,0,1,0
0,201,201,3,3,0,1,0
10,234,234,50,50,0,1,0
6,305,305,18,2,16,2,1
1,316,316,25,15,10,3,2
15,342,342,92,92,0,1,0
14,358,358,1,1,0,1,0
7,385,385,4,4,0,1,0
12,407,407,16,10,6,3,2
9,419,419,44,44,0,1,0
11,420,420,34,10,24,2,1
13,448,448,1,1,0,1,0
8,451,451,45,1,44,3,2
4,464,464,50,28,22,2,1
3,491,491,18,2,16,2,1

5,169,169,16,16,0,1,0
7,230,230,23,23,0,1,0
9,249,249,3,3,0,1,0
8,260,260,13,2,11,2,1
6,276,276,18,18,0,1,0
4,301,301,1,1,0,1,0
10,326,326,32,19,13,2,1
14,361,361,41,41,0,1,0
2,383,383,56,7,49,3,2
1,395,395,4,4,0,1,0
11,410,410,127,99,28,3,2
13,416,416,11,11,0,1,0
3,447,447,29,4,25,3,2
0,488,488,32,32,0,1,0
12,498,498,22,10,12,2,1

3,101,101,11,11,0,1,0
6,159,159,13,5,8,2,1
9,166,166,4,4,0,1,0
13,194,194,33,24,9,4,3
12,195,195,7,7,0,1,0
11,208,208,6,2,4,2,1
1,215,215,12,12,0,1,0
7,236,236,12,2,10,2,1
5,297,297,15,15,0,1,0
8,325,325,66,8,58,3,2
0,328,328,3,3,0,1,0
2,331,331,13,3,10,3,2
14,346,346,4,4,0,1,0
10,387,387,131,31,100,3,2
4,413,413,1,1,0,1,0

7,118,118,6,6,0,1,0
5,132,132,32,14,18,4,3
9,158,158,6,6,0,1,0
13,207,207,11,11,0,1,0
6,307,307,27,27,0,1,0
3,318,318,17,7,10,3,2
11,337,337,86,24,62,4,3
8,354,354,2,2,0,1,0
0,363,363,14,3,11,2,1
10,370,370,8,8,0,1,0
2,411,411,6,2,4,2,1
14,411,411,65,17,48,4,3
15,453,453,34,2,32,3,2
12,456,456,21,21,0,1,0
4,458,458,1,1,0,1,0
1,482,482,35,16,19,2,1

14,100,100,20,20,0,1,0
8,106,106,9,1,8,2,1
12,109,109,9,9,0,1,0
9,135,135,3,3,0,1,0
17,149,149,18,3,15,2,1
5,159,159,4,4,0,1,0
18,197,197,2,2,0,1,0
7,224,224,13,13,0,1,0
1,228,228,1,1,0,1,0
13,308,308,31,31,0,1,0
2,322,322,16,5,11,2,1
3,399,399,36,14,22,2,1
16,405,405,59,44,15,4,3
10,411,411,17,17,0,1,0
11,426,426,47,36,11,2,1
15,466,466,17,2,15,4,3
0,477,477,13,13,0,1,0
6,485,485,4,1,3,2,1
4,488,488,1,1,0,1,0

12,101,101,27,3,24,3,2
10,133,133,7,7,0,1,0
9,143,143,5,5,0,1,0
13,185,185,7,7,0,1,0
6,210,210,10,10,0,1,0
0,277,277,7,7,0,1,0
8,315,315,36,36,0,1,0
1,331,331,1,1,0,1,0
3,333,333,12,12,0,1,0
7,364,364,62,62,0,1,0
5,413,413,68,68,0,1,0
4,421,421,36,36,0,1,0
2,424,424,29,29,0,1,0
11,485,485,55,33,22,2,1

6,108,108,36,26,10,2,1
7,140,140,11,1,10,3,2
1,154,154,89,74,15,2,1
5,157,157,3,3,0,1,0
2,264,264,4,4,0,1,0
0,281,281,2,2,0,1,0
8,350,350,8,8,0,1,0
4,369,369,47,1,46,2,1
3,490,490,15,2,13,2,1

2,128,128,2,2,0,1,0
1,157,157,22,22,0,1,0
3,216,216,6,6,0,1,0
0,225,225,41,16,25,2,1
5,312,312,1,1,0,1,0
7,325,325,14,8,6,2,1
6,369,369,4,4,0,1,0
8,456,456,36,9,27,2,1
9,496,496,45,45,0,1,0
4,497,497,117,51,66,3,2
10,497,497,188,38,150,4,3

2,137,137,1,1,0,1,0
0,158,158,4,4,0,1,0
6,161,161,37,37,0,1,0
8,182,182,12,12,0,1,0
12,201,201,19,19,0,1,0
4,316,316,9,9,0,1,0
13,324,324,34,25,9,2,1
9,345,345,1,1,0,1,0
5,393,393,44,44,0,1,0
3,419,419,18,8,10,3,2
10,453,453,110,76,34,3,2
7,456,456,37,37,0,1,0
11,459,459,46,46,0,1,0
1,490,490,36,2,34,3,2

0,146,146,10,10,0,1,0
10,158,158,27,17,10,3,2
7,178,178,20,20,0,1,0
3,223,223,2,2,0,1,0
5,228,228,70,66,4,2,1
11,300,300,4,4,0,1,0
1,303,303,24,6,18,4,3
2,326,326,10,3,7,2,1
6,326,326,41,41,0,1,0
8,407,407,68,68,0,1,0
9,426,426,12,9,3,2,1
4,460,460,49,15,34,2,1

15,102,102,5,5,0,1,0
0,122,122,5,5,0,1,0
9,142,142,5,5,0,1,0
5,150,150,12,8,4,2,1
7,167,167,9,9,0,1,0
8,181,181,1,1,0,1,0
13,189,189,1,1,0,1,0
14,268,268,109,44,65,4,3
2,273,273,9,9,0,1,0
10,289,289,7,7,0,1,0
3,292,292,61,61,0,1,0
11,310,310,26,17,9,2,1
12,312,312,16,16,0,1,0
6,339,339,8,8,0,1,0
1,431,431,30,7,23,2,1
4,438,438,11,7,4,2,1
16,449,449,10,3,7,2,1

3,138,138,33,33,0,1,0
7,156,156,5,5,0,1,0
1,164,164,12,12,0,1,0
2,183,183,9,9,0,1,0
10,184,184,12,12,0,1,0
11,191,191,5,2,3,2,1
9,199,199,22,22,0,1,0
4,287,287,34,14,20,2,1
0,357,357,16,16,0,1,0
8,370,370,124,58,66,3,2
5,395,395,30,10,20,3,2
6,481,481,22,22,0,1,0

17,137,137,7,7,0,1,0
14,153,153,4,4,0,1,0
7,206,206,4,4,0,1,0
8,209,209,3,3,0,1,0
5,211,211,4,4,0,1,0
1,223,223,11,1,10,3,2
6,260,260,18,18,0,1,0
9,263,263,2,2,0,1,0
2,274,274,33,33,0,1,0
4,278,278,21,7,14,3,2
0,306,306,10,4,6,3,2
11,366,366,24,14,10,3,2
3,403,403,10,1,9,4,3
10,408,408,42,18,24,4,3
13,450,450,36,4,32,3,2
12,452,452,4,1,3,2,1
15,463,463,4,4,0,1,0
16,487,487,213,205,8,2,1

1,155,155,25,25,0,1,0
6,176,176,30,30,0,1,0
2,239,239,78,78,0,1,0
3,255,255,24,24,0,1,0
7,273,273,3,3,0,1,0
0,277,277,32,20,12,4,3
4,473,473,76,67,9,2,1
8,497,497,14,14,0,1,0
5,500,500,75,27,48,2,1

11,105,105,11,11,0,1,0
9,108,108,13,13,0,1,0
10,114,114,9,1,8,3,2
14,151,151,43,5,38,2,1
1,155,155,3,3,0,1,0
6,241,241,20,2,18,2,1
0,247,247,37,23,14,2,1
4,354,354,1,1,0,1,0
7,384,384,48,48,0,1,0
8,390,390,14,5,9,2,1
5,421,421,21,21,0,1,0
3,455,455,57,57,0,1,0
2,466,466,5,1,4,2,1
12,475,475,12,12,0,1,0
13,489,489,1,1,0,1,0

4,119,119,3,3,0,1,0
17,153,153,25,11,14,4,3
8,224,224,17,13,4,2,1
5,303,303,8,8,0,1,0
2,304,304,29,5,24,2,1
1,325,325,12,12,0,1,0
9,326,326,4,4,0,1,0
12,332,332,28,28,0,1,0
15,340,340,8,8,0,1,0
6,350,350,29,23,6,3,2
16,373,373,58,46,12,2,1
11,381,381,52,34,18,2,1
7,382,382,2,2,0,1,0
14,395,395,27,27,0,1,0
0,417,417,16,16,0,1,0
3,426,426,27,27,0,1,0
13,438,438,50,50,0,1,0
10,494,494,1,1,0,1,0

5,101,101,27,27,0,1,0
7,110,110,4,4,0,1,0
0,111,111,1,1,0,1,0
12,200,200,2,2,0,1,0
2,206,206,17,2,15,4,3
1,291,291,41,29,12,4,3
11,292,292,43,13,30,4,3
10,391,391,111,106,5,2,1
6,396,396,8,8,0,1,0
8,400,400,39,39,0,1,0
4,421,421,5,5,0,1,0
9,485,485,14,4,10,3,2
3,489,489,34,34,0,1,0

2,116,116,19,19,0,1,0
1,144,144,1,1,0,1,0
10,144,144,24,24,0,1,0
13,157,157,21,21,0,1,0
5,208,208,22,16,6,2,1
11,222,222,3,3,0,1,0
6,336,336,44,26,18,3,2
0,360,360,8,8,0,1,0
4,372,372,28,28,0,1,0
12,377,377,44,18,26,2,1
3,381,381,6,6,0,1,0
9,391,391,41,5,36,4,3
7,459,459,37,10,27,2,1
8,491,491,40,34,6,3,2

11,115,115,7,1,6,3,2
3,123,123,1,1,0,1,0
2,173,173,32,32,0,1,0
9,180,180,44,4,40,4,3
1,194,194,9,9,0,1,0
7,233,233,22,14,8,2,1
6,247,247,27,9,18,4,3
8,258,258,10,4,6,3,2
0,262,262,18,18,0,1,0
10,277,277,20,20,0,1,0
5,362,362,45,45,0,1,0
4,465,465,79,53,26,2,1

10,124,124,10,10,0,1,0
8,174,174,49,40,9,4,3
3,237,237,18,18,0,1,0
1,323,323,17,17,0,1,0
5,334,334,6,6,0,1,0
9,347,347,15,15,0,1,0
2,350,350,131,84,47,2,1
4,381,381,27,16,11,2,1
0,423,423,12,3,9,3,2
6,446,446,9,1,8,3,2
7,471,471,78,78,0,1,0

8,133,133,1,1,0,1,0
10,182,182,12,5,7,2,1
4,188,188,18,18,0,1,0
5,220,220,5,5,0,1,0
3,242,242,32,32,0,1,0
9,363,363,29,29,0,1,0
1,373,373,119,119,0,1,0
2,408,408,12,7,5,2,1
6,428,428,11,11,0,1,0
11,452,452,117,86,31,2,1
7,474,474,84,54,30,4,3
0,487,487,2,2,0,1,0

10,130,130,3,3,0,1,0
3,172,172,2,2,0,1,0
5,195,195,8,2,6,2,1
8,212,212,4,1,3,2,1
0,359,359,86,3,83,4,3
1,362,362,51,27,24,3,2
4,367,367,53,7,46,3,2
7,369,369,34,16,18,4,3
6,416,416,63,63,0,1,0
2,420,420,27,27,0,1,0
9,459,459,131,131,0,1,0

8,117,117,3,3,0,1,0
3,178,178,13,13,0,1,0
1,184,184,29,17,12,2,1
0,211,211,1,1,0,1,0
12,212,212,7,7,0,1,0
2,219,219,23,23,0,1,0
9,225,225,56,29,27,2,1
6,267,267,7,4,3,2,1
10,364,364,11,3,8,3,2
11,375,375,69,23,46,4,3
4,417,417,80,80,0,1,0
7,417,417,36,30,6,2,1
5,444,444,19,7,12,4,3

5,110,110,4,1,3,2,1
9,132,132,18,18,0,1,0
0,158,158,12,4,8,2,1
6,208,208,5,5,0,1,0
12,244,244,61,40,21,2,1
3,258,258,25,16,9,2,1
1,262,262,9,9,0,1,0
8,392,392,23,15,8,2,1
10,468,468,14,14,0,1,0
2,475,475,113,73,40,2,1
4,480,480,2,2,0,1,0
7,481,481,16,10,6,2,1
14,481,481,15,9,6,3,2
11,482,482,69,51,18,4,3
13,491,491,11,11,0,1,0

1,130,130,9,3,6,2,1
6,182,182,11,1,10,3,2
2,190,190,6,6,0,1,0
8,197,197,2,2,0,1,0
9,227,227,35,19,16,2,1
12,272,272,17,9,8,2,1
3,277,277,6,6,0,1,0
4,297,297,22,22,0,1,0
5,334,334,16,7,9,4,3
7,351,351,43,15,28,2,1
10,423,423,65,44,21,4,3
14,438,438,10,10,0,1,0
11,441,441,102,102,0,1,0
15,446,446,10,7,3,2,1
0,472,472,4,4,0,1,0
13,489,489,55,32,23,2,1

0,110,110,8,8,0,1,0
8,140,140,22,22,0,1,0
3,211,211,55,55,0,1,0
1,221,221,37,15,22,2,1
9,328,328,2,2,0,1,0
7,353,353,65,65,0,1,0
4,360,360,34,34,0,1,0
6,405,405,51,51,0,1,0
5,473,473,20,20,0,1,0
2,500,500,50,10,40,2,1

2,113,113,1,1,0,1,0
6,119,119,2,2,0,1,0
10,128,128,1,1,0,1,0
5,148,148,26,26,0,1,0
3,180,180,19,19,0,1,0
9,196,196,18,6,12,2,1
13,296,296,4,4,0,1,0
4,326,326,1,1,0,1,0
0,369,369,57,20,37,2,1
8,384,384,12,6,6,3,2
1,432,432,47,7,40,3,2
7,456,456,13,13,0,1,0
12,484,484,211,167,44,3,2
11,496,496,15,9,6,2,1

10,115,115,5,5,0,1,0
5,117,117,24,3,21,2,1
0,130,130,12,12,0,1,0
7,151,151,15,12,3,2,1
11,161,161,31,17,14,3,2
4,210,210,4,1,3,2,1
12,259,259,15,1,14,2,1
3,340,340,16,16,0,1,0
8,346,346,42,42,0,1,0
1,366,366,16,16,0,1,0
6,391,391,75,75,0,1,0
9,427,427,43,3,40,3,2
2,472,472,1,1,0,1,0

8,151,151,15,15,0,1,0
5,206,206,19,19,0,1,0
2,227,227,9,9,0,1,0
0,292,292,77,77,0,1,0
4,332,332,9,9,0,1,0
3,417,417,55,46,9,4,3
7,485,485,76,10,66,4,3
6,486,486,52,52,0,1,0
1,491,491,146,88,58,3,2

6,192,192,8,8,0,1,0
0,229,229,58,58,0,1,0
4,234,234,13,13,0,1,0
2,237,237,6,6,0,1,0
9,317,317,67,40,27,4,3
5,341,341,22,12,10,3,2
8,371,371,79,51,28,2,1
3,379,379,91,91,0,1,0
1,445,445,37,7,30,4,3
7,471,471,12,7,5,2,1

0,100,100,1,1,0,1,0
1,186,186,20,7,13,3,2
2,234,234,14,9,5,2,1
7,251,251,16,8,8,3,2
4,293,293,11,11,0,1,0
9,294,294,62,28,34,2,1
6,331,331,5,5,0,1,0
8,337,337,5,1,4,2,1
5,455,455,122,19,103,4,3
3,473,473,200,83,117,4,3

0,132,132,12,2,10,2,1
5,195,195,24,7,17,2,1
10,230,230,16,16,0,1,0
8,304,304,29,29,0,1,0
4,306,306,11,2,9,4,3
2,328,328,5,5,0,1,0
9,333,333,5,5,0,1,0
7,354,354,89,53,36,2,1
6,427,427,23,23,0,1,0
3,453,453,38,38,0,1,0
1,498,498,187,174,13,2,1

6,117,117,32,7,25,4,3
3,123,123,1,1,0,1,0
5,144,144,5,5,0,1,0
10,151,151,6,6,0,1,0
4,178,178,45,3,42,2,1
7,239,239,1,1,0,1,0
0,242,242,42,42,0,1,0
2,267,267,44,44,0,1,0
9,373,373,3,3,0,1,0
8,454,454,115,89,26,3,2
1,490,490,1,1,0,1,0

7,144,144,14,14,0,1,0
6,207,207,30,6,24,3,2
9,329,329,26,26,0,1,0
0,363,363,127,84,43,4,3
1,391,391,34,34,0,1,0
5,411,411,8,8,0,1,0
8,423,423,76,76,0,1,0
3,445,445,65,14,51,4,3
2,455,455,8,2,6,3,2
4,485,485,43,15,28,3,2

10,111,111,8,4,4,2,1
2,208,208,13,13,0,1,0
4,208,208,36,3,33,4,3
0,251,251,25,4,21,2,1
6,273,273,35,14,21,2,1
1,322,322,35,11,24,2,1
5,352,352,54,54,0,1,0
11,371,371,6,6,0,1,0
8,400,400,35,10,25,2,1
9,433,433,2,2,0,1,0
7,442,442,135,112,23,4,3
3,445,445,2,2,0,1,0

11,110,110,40,10,30,3,2
5,117,117,6,6,0,1,0
4,168,168,5,5,0,1,0
15,208,208,6,6,0,1,0
12,248,248,7,7,0,1,0
3,313,313,19,19,0,1,0
14,333,333,18,8,10,2,1
0,334,334,1,1,0,1,0
1,340,340,26,26,0,1,0
9,401,401,34,34,0,1,0
8,408,408,9,9,0,1,0
2,438,438,29,29,0,1,0
7,440,440,10,2,8,2,1
13,446,446,34,30,4,2,1
6,467,467,76,24,52,3,2
10,468,468,10,10,0,1,0
16,497,497,32,32,0,1,0

8,117,117,1,1,0,1,0
7,153,153,8,8,0,1,0
2,174,174,3,3,0,1,0
10,195,195,41,41,0,1,0
5,223,223,7,7,0,1,0
3,317,317,34,34,0,1,0
9,394,394,63,24,39,4,3
4,398,398,2,2,0,1,0
11,420,420,52,14,38,3,2
1,437,437,105,105,0,1,0
12,452,452,29,29,0,1,0
6,458,458,37,1,36,4,3
0,467,467,56,56,0,1,0

11,122,122,19,19,0,1,0
7,196,196,4,4,0,1,0
3,236,236,39,13,26,3,2
1,247,247,6,6,0,1,0
9,251,251,32,2,30,2,1
8,303,303,30,30,0,1,0
4,319,319,10,10,0,1,0
2,360,360,15,15,0,1,0
10,360,360,44,44,0,1,0
0,361,361,44,15,29,2,1
6,379,379,20,20,0,1,0
13,385,385,37,37,0,1,0
5,414,414,60,60,0,1,0
12,454,454,8,2,6,3,2

3,108,108,3,3,0,1,0
6,123,123,13,13,0,1,0
0,136,136,5,2,3,2,1
9,145,145,6,6,0,1,0
1,168,168,56,56,0,1,0
8,182,182,9,5,4,2,1
10,214,214,27,27,0,1,0
4,216,216,16,4,12,4,3
7,328,328,45,13,32,2,1
5,451,451,69,42,27,3,2
2,499,499,65,42,23,2,1

9,136,136,24,6,18,3,2
2,203,203,73,73,0,1,0
5,228,228,4,4,0,1,0
1,266,266,31,3,28,3,2
6,324,324,1,1,0,1,0
4,362,362,66,66,0,1,0
3,438,438,6,6,0,1,0
0,478,478,53,53,0,1,0
8,486,486,87,39,48,2,1
7,493,493,26,2,24,4,3

0,155,155,1,1,0,1,0
7,192,192,3,3,0,1,0
9,212,212,4,4,0,1,0
12,251,251,9,9,0,1,0
3,282,282,7,4,3,2,1
5,293,293,36,36,0,1,0
4,317,317,36,16,20,4,3
10,325,325,101,81,20,3,2
2,350,350,20,20,0,1,0
6,395,395,88,50,38,3,2
11,486,486,94,43,51,3,2
1,488,488,26,7,19,2,1
8,490,490,18,6,12,2,1

3,120,120,15,1,14,3,2
1,126,126,28,14,14,4,3
2,134,134,8,5,3,2,1
0,182,182,21,12,9,4,3
6,220,220,10,10,0,1,0
9,330,330,4,4,0,1,0
11,398,398,44,41,3,2,1
7,419,419,149,95,54,4,3
5,427,427,31,9,22,2,1
4,430,430,3,3,0,1,0
8,442,442,13,2,11,2,1
10,465,465,26,17,9,2,1

5,116,116,3,3,0,1,0
3,120,120,7,2,5,2,1
16,121,121,7,3,4,2,1
12,152,152,7,2,5,2,1
8,157,157,21,6,15,2,1
17,198,198,14,14,0,1,0
10,222,222,22,12,10,2,1
18,248,248,85,14,71,4,3
9,276,276,6,1,5,2,1
15,282,282,8,3,5,2,1
11,285,285,16,8,8,3,2
4,360,360,13,13,0,1,0
1,362,362,15,15,0,1,0
2,371,371,8,8,0,1,0
14,385,385,10,10,0,1,0
13,431,431,2,2,0,1,0
19,437,437,38,35,3,2,1
7,484,484,3,3,0,1,0
0,489,489,17,17,0,1,0
6,495,495,8,8,0,1,0

4,139,139,17,17,0,1,0
11,156,156,13,6,7,2,1
2,187,187,2,2,0,1,0
5,219,219,28,28,0,1,0
13,225,225,18,18,0,1,0
0,245,245,40,14,26,2,1
1,256,256,1,1,0,1,0
12,257,257,6,6,0,1,0
10,279,279,51,51,0,1,0
7,332,332,4,4,0,1,0
6,341,341,16,16,0,1,0
8,389,389,12,12,0,1,0
3,446,446,51,19,32,3,2
9,446,446,95,95,0,1,0

7,157,157,38,23,15,4,3
1,172,172,2,2,0,1,0
9,176,176,10,10,0,1,0
5,223,223,1,1,0,1,0
11,228,228,77,77,0,1,0
15,250,250,22,13,9,2,1
0,272,272,25,16,9,4,3
6,292,292,2,2,0,1,0
3,294,294,38,13,25,3,2
8,362,362,8,8,0,1,0
4,391,391,7,7,0,1,0
2,406,406,7,7,0,1,0
13,423,423,23,7,16,2,1
10,464,464,23,23,0,1,0
12,479,479,12,12,0,1,0
14,481,481,25,12,13,2,1

2,146,146,32,32,0,1,0
0,156,156,14,14,0,1,0
3,210,210,23,20,3,2,1
9,246,246,42,42,0,1,0
10,266,266,16,8,8,3,2
11,280,280,59,15,44,4,3
7,295,295,20,20,0,1,0
5,365,365,16,4,12,4,3
8,399,399,38,38,0,1,0
6,427,427,7,7,0,1,0
4,438,438,22,13,9,2,1
12,443,443,2,2,0,1,0
1,463,463,34,4,30,4,3

9,127,127,21,13,8,2,1
7,130,130,17,7,10,3,2
8,143,143,26,15,11,2,1
5,161,161,7,7,0,1,0
1,269,269,41,16,25,4,3
10,270,270,6,6,0,1,0
4,321,321,42,15,27,4,3
3,382,382,1,1,0,1,0
6,395,395,30,22,8,2,1
0,460,460,11,11,0,1,0
2,469,469,137,95,42,4,3

6,118,118,7,7,0,1,0
15,131,131,13,1,12,4,3
8,153,153,6,6,0,1,0
10,190,190,40,35,5,2,1
12,200,200,18,18,0,1,0
11,222,222,37,8,29,2,1
5,224,224,1,1,0,1,0
14,260,260,1,1,0,1,0
2,307,307,12,12,0,1,0
1,319,319,39,20,19,2,1
13,325,325,13,13,0,1,0
3,327,327,19,19,0,1,0
4,386,386,5,1,4,2,1
16,392,392,84,84,0,1,0
0,393,393,1,1,0,1,0
7,430,430,8,8,0,1,0
9,486,486,17,3,14,3,2

3,105,105,14,14,0,1,0
0,108,108,3,3,0,1,0
2,112,112,19,13,6,3,2
6,131,131,4,4,0,1,0
5,203,203,10,10,0,1,0
1,302,302,84,2,82,4,3
8,339,339,2,2,0,1,0
4,346,346,20,4,16,3,2
7,367,367,27,11,16,2,1
9,468,468,186,186,0,1,0

3,121,121,37,37,0,1,0
5,185,185,4,4,0,1,0
2,210,210,3,3,0,1,0
6,210,210,24,24,0,1,0
9,238,238,21,21,0,1,0
4,241,241,3,3,0,1,0
10,283,283,50,5,45,2,1
1,300,300,80,50,30,3,2
0,307,307,1,1,0,1,0
7,320,320,42,9,33,4,3
8,326,326,26,26,0,1,0

4,140,140,12,1,11,3,2
5,147,147,3,3,0,1,0
9,151,151,7,7,0,1,0
3,154,154,10,10,0,1,0
1,178,178,1,1,0,1,0
15,243,243,1,1,0,1,0
11,249,249,27,27,0,1,0
8,278,278,1,1,0,1,0
7,286,286,41,41,0,1,0
13,310,310,76,49,27,2,1
17,349,349,43,28,15,4,3
0,351,351,24,12,12,3,2
12,396,396,3,3,0,1,0
6,400,400,2,2,0,1,0
18,406,406,50,38,12,4,3
16,421,421,14,14,0,1,0
2,445,445,12,12,0,1,0
10,447,447,7,7,0,1,0
14,496,496,41,41,0,1,0

17,108,108,4,1,3,2,1
2,127,127,18,4,14,3,2
12,129,129,15,15,0,1,0
3,251,251,9,4,5,2,1
13,253,253,43,8,35,2,1
0,279,279,7,7,0,1,0
10,283,283,14,14,0,1,0
8,291,291,1,1,0,1,0
16,295,295,22,17,5,2,1
18,317,317,42,8,34,2,1
15,319,319,37,5,32,2,1
4,344,344,1,1,0,1,0
1,360,360,9,4,5,2,1
5,380,380,31,31,0,1,0
11,389,389,19,19,0,1,0
6,390,390,12,4,8,2,1
9,442,442,12,12,0,1,0
14,458,458,39,39,0,1,0
7,463,463,6,2,4,2,1

1,123,123,2,2,0,1,0
3,171,171,7,7,0,1,0
9,231,231,3,3,0,1,0
8,232,232,41,29,12,3,2
10,306,306,13,7,6,3,2
12,346,346,48,8,40,3,2
0,361,361,61,61,0,1,0
6,391,391,29,29,0,1,0
5,444,444,76,76,0,1,0
11,452,452,75,75,0,1,0
13,471,471,36,36,0,1,0
7,476,476,11,1,10,2,1
2,487,487,51,51,0,1,0
4,492,492,1,1,0,1,0

5,102,102,6,1,5,2,1
3,123,123,2,2,0,1,0
8,126,126,19,19,0,1,0
7,150,150,16,1,15,4,3
12,197,197,38,23,15,4,3
0,232,232,9,9,0,1,0
11,238,238,5,5,0,1,0
1,258,258,24,24,0,1,0
9,324,324,34,5,29,2,1
4,398,398,11,3,8,2,1
6,411,411,140,140,0,1,0
2,467,467,12,12,0,1,0
10,497,497,17,17,0,1,0

8,131,131,18,2,16,4,3
5,198,198,26,26,0,1,0
11,209,209,8,8,0,1,0
0,244,244,1,1,0,1,0
2,260,260,29,19,10,3,2
12,291,291,6,6,0,1,0
3,297,297,31,31,0,1,0
6,309,309,29,15,14,2,1
7,326,326,28,4,24,3,2
9,382,382,92,92,0,1,0
4,389,389,16,16,0,1,0
1,393,393,12,6,6,3,2
10,445,445,16,13,3,2,1
13,477,477,65,13,52,3,2

12,111,111,16,11,5,2,1
0,145,145,15,15,0,1,0
4,223,223,1,1,0,1,0
7,268,268,22,14,8,3,2
3,308,308,6,3,3,2,1
9,326,326,16,1,15,4,3
13,330,330,59,59,0,1,0
11,346,346,9,2,7,2,1
1,364,364,14,8,6,3,2
2,409,409,49,34,15,4,3
8,418,418,29,29,0,1,0
5,453,453,68,68,0,1,0
10,461,461,67,34,33,4,3
6,486,486,40,40,0,1,0

3,130,130,25,22,3,2,1
4,171,171,5,5,0,1,0
7,204,204,6,6,0,1,0
9,217,217,7,7,0,1,0
2,237,237,40,7,33,4,3
10,302,302,33,17,16,2,1
6,351,351,46,46,0,1,0
8,393,393,90,90,0,1,0
12,403,403,60,60,0,1,0
5,408,408,2,2,0,1,0
1,413,413,3,3,0,1,0
11,419,419,25,9,16,2,1
0,498,498,34,34,0,1,0

9,209,209,14,4,10,2,1
12,215,215,7,7,0,1,0
8,232,232,33,13,20,4,3
3,314,314,24,3,21,4,3
5,316,316,13,1,12,3,2
6,322,322,49,49,0,1,0
7,325,325,14,14,0,1,0
2,345,345,35,23,12,4,3
4,346,346,18,18,0,1,0
11,354,354,58,58,0,1,0
1,360,360,4,1,3,2,1
0,443,443,74,55,19,2,1
10,474,474,76,60,16,3,2

1,132,132,1,1,0,1,0
9,151,151,5,5,0,1,0
2,159,159,2,2,0,1,0
8,209,209,10,10,0,1,0
10,257,257,37,16,21,4,3
11,332,332,4,4,0,1,0
4,362,362,29,29,0,1,0
0,391,391,41,8,33,4,3
6,421,421,86,86,0,1,0
7,421,421,72,52,20,2,1
5,422,422,137,98,39,4,3
3,423,423,30,15,15,2,1

10,209,209,31,3,28,2,1
2,285,285,53,5,48,3,2
11,286,286,79,13,66,3,2
9,289,289,22,1,21,2,1
7,290,290,6,6,0,1,0
4,354,354,3,3,0,1,0
1,360,360,34,10,24,2,1
3,362,362,7,7,0,1,0
0,441,441,103,103,0,1,0
6,469,469,10,10,0,1,0
5,473,473,28,19,9,2,1
8,485,485,32,6,26,2,1

5,143,143,15,15,0,1,0
7,173,173,1,1,0,1,0
0,188,188,12,12,0,1,0
3,209,209,4,4,0,1,0
4,237,237,43,43,0,1,0
1,261,261,34,18,16,2,1
10,283,283,27,19,8,3,2
2,285,285,11,11,0,1,0
13,310,310,57,57,0,1,0
12,375,375,37,37,0,1,0
11,418,418,62,62,0,1,0
6,449,449,26,6,20,4,3
8,478,478,3,3,0,1,0
9,495,495,37,37,0,1,0

11,178,178,2,2,0,1,0
1,188,188,40,14,26,3,2
13,203,203,69,43,26,4,3
9,208,208,3,3,0,1,0
0,248,248,40,40,0,1,0
12,361,361,7,7,0,1,0
5,382,382,12,12,0,1,0
2,426,426,3,3,0,1,0
7,437,437,16,6,10,3,2
8,444,444,96,96,0,1,0
6,464,464,38,38,0,1,0
4,472,472,12,3,9,4,3
3,481,481,22,11,11,2,1
10,499,499,7,1,6,3,2

8,110,110,1,1,0,1,0
17,161,161,5,5,0,1,0
3,183,183,2,2,0,1,0
7,198,198,22,22,0,1,0
12,211,211,1,1,0,1,0
13,228,228,60,60,0,1,0
9,247,247,14,2,12,4,3
2,257,257,15,15,0,1,0
1,259,259,13,7,6,3,2
14,280,280,76,76,0,1,0
10,327,327,20,1,19,2,1
16,358,358,10,10,0,1,0
0,385,385,11,11,0,1,0
15,399,399,7,7,0,1,0
5,410,410,16,11,5,2,1
6,415,415,5,5,0,1,0
11,444,444,10,10,0,1,0
4,467,467,66,66,0,1,0

2,101,101,50,50,0,1,0
5,154,154,7,7,0,1,0
0,159,159,9,5,4,2,1
7,233,233,8,8,0,1,0
9,247,247,7,7,0,1,0
1,343,343,2,2,0,1,0
8,357,357,71,53,18,4,3
4,404,404,57,57,0,1,0
6,442,442,72,34,38,2,1
3,496,496,22,22,0,1,0

15,154,154,7,7,0,1,0
12,197,197,18,18,0,1,0
9,199,199,7,1,6,2,1
14,243,243,30,10,20,3,2
11,290,290,75,9,66,4,3
7,302,302,37,22,15,4,3
6,309,309,15,9,6,3,2
3,310,310,50,8,42,3,2
1,419,419,22,16,6,3,2
8,423,423,17,17,0,1,0
5,441,441,46,10,36,3,2
0,443,443,4,1,3,2,1
2,445,445,7,7,0,1,0
4,451,451,5,5,0,1,0
13,476,476,7,7,0,1,0
10,499,499,39,12,27,2,1

4,132,132,8,8,0,1,0
7,149,149,5,2,3,2,1
6,244,244,59,27,32,3,2
0,259,259,105,18,87,4,3
2,269,269,48,17,31,2,1
8,340,340,9,9,0,1,0
3,401,401,85,47,38,3,2
5,412,412,16,16,0,1,0
1,446,446,8,8,0,1,0

2,104,104,1,1,0,1,0
6,104,104,1,1,0,1,0
5,125,125,8,2,6,2,1
17,125,125,10,10,0,1,0
18,139,139,13,5,8,3,2
8,148,148,2,2,0,1,0
11,187,187,14,1,13,3,2
4,192,192,3,3,0,1,0
3,235,235,68,44,24,4,3
7,242,242,1,1,0,1,0
1,271,271,9,9,0,1,0
13,311,311,2,2,0,1,0
14,355,355,18,18,0,1,0
9,374,374,6,6,0,1,0
16,377,377,62,29,33,4,3
15,379,379,83,34,49,2,1
0,413,413,8,8,0,1,0
12,487,487,16,4,12,2,1
10,500,500,9,3,6,3,2

5,105,105,4,4,0,1,0
9,111,111,28,12,16,3,2
3,166,166,26,16,10,3,2
10,173,173,32,32,0,1,0
12,204,204,3,3,0,1,0
4,215,215,4,4,0,1,0
11,215,215,28,28,0,1,0
1,216,216,7,1,6,2,1
2,353,353,19,19,0,1,0
8,358,358,6,6,0,1,0
6,385,385,2,2,0,1,0
0,415,415,100,22,78,4,3
7,427,427,24,21,3,2,1
13,442,442,8,8,0,1,0

4,138,138,22,11,11,2,1
8,199,199,1,1,0,1,0
13,219,219,7,7,0,1,0
9,270,270,5,5,0,1,0
3,308,308,20,14,6,3,2
12,325,325,70,12,58,3,2
7,327,327,11,11,0,1,0
2,334,334,22,12,10,3,2
6,349,349,2,2,0,1,0
5,352,352,34,9,25,2,1
14,357,357,21,5,16,2,1
11,364,364,23,23,0,1,0
10,394,394,9,3,6,2,1
0,416,416,24,19,5,2,1
15,433,433,96,96,0,1,0
1,449,449,42,42,0,1,0

6,162,162,5,1,4,2,1
10,251,251,10,10,0,1,0
11,251,251,12,3,9,3,2
9,334,334,10,10,0,1,0
2,367,367,24,1,23,3,2
3,370,370,59,35,24,3,2
7,374,374,159,149,10,3,2
4,375,375,17,11,6,3,2
0,398,398,5,5,0,1,0
1,398,398,82,82,0,1,0
8,429,429,15,9,6,2,1
5,445,445,50,50,0,1,0

3,125,125,20,20,0,1,0
1,375,375,96,96,0,1,0
5,378,378,56,33,23,2,1
4,379,379,45,19,26,2,1
2,380,380,1,1,0,1,0
8,422,422,1,1,0,1,0
10,431,431,46,46,0,1,0
6,439,439,35,27,8,3,2
7,482,482,108,108,0,1,0
9,482,482,22,22,0,1,0
0,487,487,31,1,30,4,3

3,103,103,11,1,10,3,2
4,124,124,16,16,0,1,0
1,154,154,52,20,32,3,2
9,317,317,51,51,0,1,0
6,327,327,42,42,0,1,0
8,367,367,2,2,0,1,0
2,434,434,22,4,18,3,2
0,440,440,50,4,46,2,1
7,447,447,82,82,0,1,0
5,476,476,1,1,0,1,0

10,105,105,7,7,0,1,0
12,126,126,59,20,39,4,3
5,151,151,2,2,0,1,0
7,187,187,11,11,0,1,0
6,254,254,11,5,6,2,1
11,275,275,1,1,0,1,0
8,297,297,6,2,4,2,1
0,303,303,34,34,0,1,0
13,310,310,12,3,9,4,3
1,349,349,111,105,6,3,2
4,366,366,4,4,0,1,0
9,404,404,7,7,0,1,0
2,417,417,13,6,7,2,1
3,479,479,7,7,0,1,0

3,104,104,4,4,0,1,0
2,110,110,10,10,0,1,0
4,117,117,31,31,0,1,0
9,123,123,5,5,0,1,0
6,169,169,10,10,0,1,0
0,188,188,10,10,0,1,0
7,242,242,52,52,0,1,0
10,313,313,35,29,6,3,2
1,340,340,38,38,0,1,0
8,348,348,57,35,22,2,1
11,350,350,8,8,0,1,0
5,395,395,17,3,14,2,1

10,102,102,5,1,4,2,1
1,118,118,2,2,0,1,0
7,146,146,24,24,0,1,0
8,158,158,27,3,24,3,2
6,183,183,7,7,0,1,0
3,255,255,124,1,123,4,3
9,290,290,11,7,4,2,1
0,347,347,15,3,12,2,1
2,413,413,14,14,0,1,0
5,430,430,71,23,48,3,2
4,497,497,10,10,0,1,0

8,109,109,2,2,0,1,0
12,137,137,47,35,12,2,1
13,161,161,13,13,0,1,0
10,258,258,3,3,0,1,0
5,261,261,19,19,0,1,0
9,269,269,25,9,16,2,1
2,292,292,1,1,0,1,0
6,302,302,2,2,0,1,0
4,320,320,25,25,0,1,0
1,338,338,13,7,6,2,1
11,350,350,26,26,0,1,0
3,375,375,6,6,0,1,0
0,457,457,119,75,44,2,1
7,463,463,58,45,13,2,1

5,146,146,16,1,15,2,1
0,279,279,78,32,46,3,2
8,288,288,13,2,11,2,1
4,303,303,40,40,0,1,0
1,323,323,96,12,84,4,3
3,373,373,43,7,36,2,1
7,401,401,79,31,48,2,1
6,405,405,6,6,0,1,0
2,488,488,12,5,7,2,1

3,103,103,26,18,8,2,1
0,107,107,4,4,0,1,0
11,182,182,8,1,7,2,1
9,258,258,3,3,0,1,0
4,288,288,8,1,7,2,1
1,301,301,14,7,7,2,1
5,301,301,29,22,7,2,1
10,304,304,88,40,48,2,1
7,316,316,40,40,0,1,0
2,395,395,42,42,0,1,0
8,427,427,49,49,0,1,0
6,435,435,15,15,0,1,0
12,456,456,9,1,8,3,2

4,120,120,2,2,0,1,0
11,125,125,20,20,0,1,0
6,129,129,6,3,3,2,1
0,132,132,3,3,0,1,0
10,138,138,15,15,0,1,0
9,201,201,15,15,0,1,0
8,212,212,32,32,0,1,0
5,248,248,41,41,0,1,0
2,364,364,99,99,0,1,0
7,366,366,30,30,0,1,0
3,377,377,36,32,4,2,1
1,477,477,14,14,0,1,0

11,185,185,9,3,6,3,2
5,210,210,26,26,0,1,0
12,225,225,46,46,0,1,0
4,252,252,61,61,0,1,0
13,252,252,12,4,8,2,1
6,331,331,2,2,0,1,0
1,339,339,9,9,0,1,0
10,351,351,13,13,0,1,0
3,366,366,4,1,3,2,1
8,374,374,2,2,0,1,0
0,421,421,26,26,0,1,0
2,487,487,9,9,0,1,0
9,496,496,131,7,124,4,3
7,497,497,55,55,0,1,0

12,108,108,3,3,0,1,0
8,121,121,18,4,14,4,3
10,152,152,11,11,0,1,0
6,173,173,8,8,0,1,0
3,264,264,14,14,0,1,0
7,325,325,27,27,0,1,0
9,333,333,41,26,15,2,1
1,365,365,17,8,9,2,1
5,372,372,14,14,0,1,0
11,401,401,65,59,6,3,2
4,420,420,25,25,0,1,0
2,445,445,136,19,117,4,3
0,460,460,24,24,0,1,0

9,103,103,2,2,0,1,0
12,130,130,23,23,0,1,0
1,141,141,16,16,0,1,0
5,177,177,2,2,0,1,0
0,224,224,33,9,24,2,1
2,247,247,40,10,30,2,1
10,287,287,53,44,9,4,3
13,290,290,53,53,0,1,0
7,293,293,21,15,6,2,1
6,298,298,4,4,0,1,0
3,403,403,24,24,0,1,0
8,416,416,6,6,0,1,0
11,437,437,18,18,0,1,0
4,452,452,11,11,0,1,0

7,124,124,5,5,0,1,0
13,154,154,31,31,0,1,0
11,156,156,6,6,0,1,0
6,172,172,12,2,10,3,2
3,199,199,12,4,8,2,1
9,207,207,2,2,0,1,0
2,241,241,17,17,0,1,0
10,250,250,10,5,5,2,1
8,272,272,56,46,10,2,1
12,367,367,45,21,24,3,2
4,388,388,15,3,12,4,3
1,399,399,62,2,60,3,2
5,436,436,60,44,16,3,2
0,444,444,13,13,0,1,0

7,117,117,13,1,12,4,3
11,125,125,1,1,0,1,0
3,126,126,7,7,0,1,0
8,239,239,1,1,0,1,0
10,335,335,138,138,0,1,0
4,341,341,20,3,17,2,1
1,352,352,13,13,0,1,0
2,352,352,77,11,66,4,3
0,360,360,16,16,0,1,0
9,368,368,28,7,21,2,1
12,396,396,1,1,0,1,0
6,423,423,27,2,25,2,1
5,458,458,56,21,35,2,1

3,143,143,37,25,12,4,3
9,204,204,28,14,14,2,1
2,271,271,10,3,7,3,2
11,308,308,15,15,0,1,0
5,311,311,16,13,3,2,1
0,356,356,58,58,0,1,0
10,358,358,55,22,33,4,3
7,360,360,91,91,0,1,0
1,406,406,20,2,18,3,2
12,438,438,2,2,0,1,0
6,448,448,13,13,0,1,0
4,459,459,6,6,0,1,0
8,482,482,8,4,4,2,1

6,135,135,19,19,0,1,0
0,208,208,66,19,47,2,1
5,219,219,43,15,28,2,1
3,282,282,3,3,0,1,0
4,324,324,51,47,4,2,1
2,331,331,28,28,0,1,0
1,348,348,99,99,0,1,0
7,409,409,7,7,0,1,0

1,133,133,11,1,10,3,2
3,177,177,10,10,0,1,0
10,188,188,7,3,4,2,1
0,192,192,10,4,6,2,1
9,203,203,5,1,4,2,1
13,218,218,4,4,0,1,0
2,281,281,9,5,4,2,1
14,289,289,4,4,0,1,0
7,321,321,78,78,0,1,0
8,336,336,1,1,0,1,0
6,359,359,6,6,0,1,0
11,375,375,5,5,0,1,0
5,430,430,22,17,5,2,1
4,487,487,32,32,0,1,0
12,497,497,249,227,22,2,1

4,102,102,19,19,0,1,0
11,169,169,29,29,0,1,0
5,186,186,4,4,0,1,0
7,246,246,3,3,0,1,0
2,261,261,12,12,0,1,0
3,263,263,30,8,22,4,3
9,295,295,55,10,45,2,1
10,309,309,9,9,0,1,0
1,334,334,17,17,0,1,0
0,362,362,51,15,36,2,1
12,420,420,47,47,0,1,0
8,434,434,42,9,33,2,1
6,480,480,20,14,6,2,1

2,180,180,19,7,12,2,1
9,227,227,2,2,0,1,0
7,259,259,25,9,16,3,2
4,267,267,2,2,0,1,0
3,308,308,41,41,0,1,0
8,315,315,97,97,0,1,0
11,370,370,4,4,0,1,0
6,395,395,70,19,51,4,3
1,400,400,17,13,4,2,1
10,414,414,4,4,0,1,0
5,434,434,23,23,0,1,0
0,449,449,117,9,108,4,3

1,143,143,2,2,0,1,0
10,179,179,39,30,9,2,1
6,190,190,10,10,0,1,0
0,212,212,47,10,37,3,2
5,256,256,1,1,0,1,0
9,286,286,37,10,27,2,1
2,302,302,13,5,8,2,1
13,304,304,14,8,6,3,2
11,379,379,17,17,0,1,0
7,398,398,51,25,26,2,1
8,406,406,13,8,5,2,1
12,434,434,61,34,27,4,3
3,451,451,27,10,17,2,1
4,479,479,37,29,8,3,2

3,110,110,1,1,0,1,0
4,208,208,6,6,0,1,0
8,212,212,1,1,0,1,0
1,247,247,18,18,0,1,0
11,261,261,128,111,17,2,1
0,272,272,100,25,75,4,3
7,304,304,12,1,11,2,1
5,369,369,38,4,34,2,1
10,374,374,4,4,0,1,0
9,379,379,19,3,16,2,1
6,466,466,9,9,0,1,0
2,487,487,10,3,7,2,1

13,112,112,7,7,0,1,0
3,235,235,32,32,0,1,0
14,262,262,2,2,0,1,0
7,282,282,18,9,9,2,1
6,326,326,25,13,12,4,3
5,363,363,34,22,12,2,1
11,366,366,106,106,0,1,0
2,398,398,47,47,0,1,0
9,422,422,11,11,0,1,0
4,448,448,24,2,22,3,2
10,449,449,54,2,52,3,2
12,460,460,49,15,34,3,2
0,484,484,3,3,0,1,0
8,487,487,25,13,12,2,1
1,493,493,1,1,0,1,0

10,193,193,27,27,0,1,0
4,215,215,67,13,54,4,3
6,231,231,12,12,0,1,0
0,234,234,35,10,25,2,1
1,237,237,6,6,0,1,0
5,304,304,19,19,0,1,0
8,385,385,14,8,6,3,2
2,388,388,1,1,0,1,0
9,397,397,24,24,0,1,0
7,439,439,112,84,28,2,1
3,464,464,52,49,3,2,1

2,136,136,3,3,0,1,0
9,169,169,37,23,14,3,2
5,218,218,7,2,5,2,1
0,261,261,31,31,0,1,0
1,285,285,1,1,0,1,0
4,347,347,32,20,12,4,3
3,359,359,164,86,78,3,2
7,409,409,31,5,26,2,1
8,473,473,2,2,0,1,0
6,497,497,93,27,66,4,3

3,102,102,13,13,0,1,0
12,105,105,12,2,10,2,1
10,160,160,36,24,12,4,3
8,200,200,19,9,10,3,2
2,259,259,5,1,4,2,1
1,260,260,65,17,48,4,3
0,329,329,2,2,0,1,0
5,352,352,38,38,0,1,0
7,355,355,4,4,0,1,0
6,376,376,23,23,0,1,0
4,382,382,11,11,0,1,0
11,413,413,48,10,38,3,2
9,432,432,27,27,0,1,0

8,114,114,7,2,5,2,1
3,143,143,1,1,0,1,0
13,169,169,31,31,0,1,0
1,234,234,21,21,0,1,0
12,239,239,49,39,10,2,1
2,282,282,6,1,5,2,1
6,286,286,15,15,0,1,0
9,317,317,14,14,0,1,0
5,319,319,21,2,19,2,1
7,330,330,24,24,0,1,0
10,366,366,25,2,23,2,1
4,373,373,26,17,9,2,1
0,396,396,66,66,0,1,0
14,413,413,24,14,10,3,2
11,426,426,23,15,8,3,2

6,164,164,18,18,0,1,0
2,171,171,2,2,0,1,0
5,199,199,3,3,0,1,0
11,202,202,15,5,10,3,2
8,203,203,4,4,0,1,0
9,219,219,2,2,0,1,0
13,221,221,29,29,0,1,0
12,245,245,58,19,39,4,3
3,276,276,40,40,0,1,0
4,364,364,1,1,0,1,0
10,394,394,55,44,11,2,1
0,397,397,22,2,20,3,2
7,420,420,72,29,43,2,1
1,445,445,40,40,0,1,0

7,119,119,20,20,0,1,0
8,151,151,4,4,0,1,0
10,167,167,5,1,4,2,1
5,215,215,32,5,27,2,1
4,219,219,47,11,36,4,3
2,220,220,22,3,19,2,1
1,305,305,48,17,31,3,2
9,318,318,32,32,0,1,0
0,323,323,19,3,16,2,1
3,330,330,24,16,8,3,2
6,333,333,49,3,46,3,2

9,193,193,19,5,14,3,2
10,196,196,6,2,4,2,1
8,220,220,37,11,26,4,3
13,223,223,19,19,0,1,0
4,239,239,6,6,0,1,0
6,278,278,9,9,0,1,0
1,305,305,5,1,4,2,1
0,335,335,31,21,10,3,2
5,375,375,20,20,0,1,0
15,377,377,63,10,53,3,2
14,385,385,6,2,4,2,1
7,394,394,19,19,0,1,0
2,432,432,10,1,9,4,3
3,455,455,21,7,14,3,2
11,460,460,106,106,0,1,0
12,496,496,38,38,0,1,0

12,120,120,1,1,0,1,0
3,137,137,18,18,0,1,0
4,188,188,3,3,0,1,0
6,192,192,52,10,42,2,1
8,220,220,15,3,12,2,1
9,227,227,5,1,4,2,1
5,242,242,1,1,0,1,0
2,321,321,17,17,0,1,0
7,338,338,7,1,6,3,2
15,354,354,28,28,0,1,0
1,378,378,1,1,0,1,0
13,388,388,2,2,0,1,0
11,397,397,122,112,10,3,2
0,418,418,5,5,0,1,0
10,445,445,21,21,0,1,0
14,497,497,82,82,0,1,0

0,138,138,17,7,10,2,1
1,140,140,25,13,12,4,3
7,220,220,59,37,22,3,2
12,255,255,20,12,8,3,2
10,265,265,31,31,0,1,0
9,291,291,15,4,11,3,2
3,315,315,2,2,0,1,0
5,319,319,24,24,0,1,0
2,338,338,8,5,3,2,1
6,350,350,5,5,0,1,0
8,384,384,7,7,0,1,0
11,428,428,33,9,24,2,1
4,476,476,86,78,8,3,2

4,101,101,1,1,0,1,0
5,101,101,3,3,0,1,0
11,129,129,25,17,8,2,1
7,139,139,5,5,0,1,0
1,162,162,44,26,18,4,3
3,217,217,12,12,0,1,0
0,261,261,28,5,23,4,3
9,267,267,36,15,21,4,3
6,298,298,8,4,4,2,1
2,328,328,43,5,38,2,1
8,362,362,6,6,0,1,0
10,431,431,90,90,0,1,0

0,122,122,69,69,0,1,0
2,129,129,2,2,0,1,0
1,172,172,4,4,0,1,0
7,189,189,8,8,0,1,0
3,199,199,60,13,47,2,1
4,360,360,30,10,20,3,2
8,406,406,7,7,0,1,0
5,411,411,46,2,44,3,2
6,499,499,28,28,0,1,0

7,105,105,4,4,0,1,0
4,159,159,10,10,0,1,0
0,168,168,7,3,4,2,1
9,173,173,3,3,0,1,0
14,181,181,42,42,0,1,0
13,253,253,15,15,0,1,0
11,324,324,18,6,12,4,3
6,405,405,3,3,0,1,0
2,413,413,26,26,0,1,0
1,421,421,11,11,0,1,0
3,432,432,29,29,0,1,0
8,435,435,3,3,0,1,0
12,448,448,68,68,0,1,0
5,452,452,130,83,47,3,2
10,497,497,48,18,30,2,1

13,113,113,20,20,0,1,0
11,147,147,13,13,0,1,0
12,163,163,2,2,0,1,0
2,170,170,12,12,0,1,0
8,178,178,39,39,0,1,0
0,205,205,1,1,0,1,0
4,232,232,24,24,0,1,0
3,243,243,12,8,4,2,1
1,288,288,7,1,6,2,1
10,346,346,11,11,0,1,0
5,355,355,11,11,0,1,0
6,377,377,24,12,12,4,3
9,444,444,125,125,0,1,0
7,459,459,17,17,0,1,0
14,498,498,14,2,12,2,1

6,195,195,1,1,0,1,0
4,226,226,7,3,4,2,1
7,230,230,29,5,24,4,3
11,268,268,6,1,5,2,1
12,339,339,11,11,0,1,0
0,360,360,25,25,0,1,0
8,405,405,60,32,28,3,2
3,437,437,18,18,0,1,0
1,444,444,123,53,70,4,3
9,447,447,6,6,0,1,0
2,455,455,6,6,0,1,0
5,480,480,80,80,0,1,0
10,490,490,131,119,12,4,3

3,110,110,14,14,0,1,0
5,233,233,1,1,0,1,0
4,305,305,83,37,46,3,2
0,350,350,20,20,0,1,0
2,371,371,173,26,147,4,3
8,375,375,25,25,0,1,0
1,412,412,32,12,20,2,1
7,426,426,25,25,0,1,0
6,475,475,42,42,0,1,0

12,104,104,4,4,0,1,0
0,140,140,14,14,0,1,0
10,144,144,6,6,0,1,0
4,188,188,1,1,0,1,0
8,208,208,7,7,0,1,0
7,216,216,1,1,0,1,0
9,230,230,36,12,24,2,1
5,234,234,15,2,13,2,1
1,253,253,3,3,0,1,0
2,264,264,75,7,68,3,2
13,332,332,3,3,0,1,0
3,368,368,18,6,12,4,3
14,402,402,50,41,9,2,1
6,411,411,20,20,0,1,0
11,453,453,111,82,29,2,1

13,152,152,14,6,8,2,1
12,179,179,37,37,0,1,0
9,198,198,12,12,0,1,0
6,226,226,10,10,0,1,0
10,265,265,25,25,0,1,0
1,317,317,17,17,0,1,0
14,317,317,46,46,0,1,0
3,325,325,27,27,0,1,0
2,361,361,47,47,0,1,0
5,367,367,17,17,0,1,0
8,392,392,32,3,29,2,1
11,420,420,5,5,0,1,0
0,475,475,44,31,13,2,1
4,476,476,16,4,12,3,2
7,485,485,17,17,0,1,0

10,106,106,1,1,0,1,0
8,112,112,11,11,0,1,0
2,119,119,5,2,3,2,1
11,143,143,31,3,28,3,2
6,155,155,1,1,0,1,0
12,167,167,7,7,0,1,0
7,216,216,22,10,12,4,3
13,243,243,14,6,8,2,1
5,267,267,10,10,0,1,0
3,279,279,22,19,3,2,1
0,382,382,24,21,3,2,1
4,393,393,84,84,0,1,0
1,396,396,24,16,8,3,2
9,458,458,91,33,58,3,2

3,122,122,2,2,0,1,0
8,139,139,8,2,6,3,2
6,259,259,4,4,0,1,0
5,274,274,39,12,27,2,1
7,276,276,69,44,25,2,1
4,326,326,43,43,0,1,0
12,339,339,20,2,18,4,3
9,368,368,37,37,0,1,0
10,370,370,29,15,14,2,1
11,421,421,30,15,15,2,1
0,461,461,101,101,0,1,0
2,462,462,5,5,0,1,0
1,494,494,33,22,11,2,1

0,204,204,13,5,8,2,1
5,207,207,53,38,15,4,3
6,214,214,10,10,0,1,0
1,215,215,13,1,12,2,1
10,235,235,14,14,0,1,0
9,257,257,9,4,5,2,1
8,422,422,30,16,14,3,2
4,450,450,38,12,26,4,3
2,476,476,91,82,9,4,3
3,482,482,97,47,50,2,1
7,483,483,69,69,0,1,0

8,110,110,3,3,0,1,0
5,133,133,1,1,0,1,0
14,163,163,31,3,28,2,1
3,171,171,8,8,0,1,0
9,178,178,41,41,0,1,0
2,206,206,11,4,7,2,1
11,207,207,13,1,12,3,2
7,214,214,24,24,0,1,0
4,221,221,26,26,0,1,0
12,288,288,9,9,0,1,0
1,298,298,56,56,0,1,0
13,434,434,21,21,0,1,0
10,459,459,25,25,0,1,0
0,469,469,12,4,8,3,2
6,475,475,14,14,0,1,0

7,122,122,4,4,0,1,0
8,140,140,12,12,0,1,0
4,188,188,37,37,0,1,0
5,212,212,31,22,9,4,3
1,284,284,35,35,0,1,0
10,286,286,4,1,3,2,1
0,310,310,4,4,0,1,0
9,391,391,38,38,0,1,0
6,398,398,36,14,22,3,2
3,421,421,22,22,0,1,0
11,466,466,137,65,72,4,3
2,468,468,33,33,0,1,0

7,136,136,13,4,9,4,3
9,170,170,60,60,0,1,0
8,181,181,3,3,0,1,0
1,226,226,12,9,3,2,1
2,248,248,31,11,20,2,1
6,259,259,7,7,0,1,0
10,312,312,7,7,0,1,0
0,351,351,37,8,29,2,1
3,435,435,39,25,14,3,2
5,459,459,44,29,15,2,1
4,461,461,105,105,0,1,0

0,135,135,50,50,0,1,0
4,174,174,27,27,0,1,0
3,194,194,3,3,0,1,0
5,270,270,6,6,0,1,0
6,310,310,40,31,9,4,3
2,321,321,30,30,0,1,0
1,436,436,101,85,16,3,2
7,455,455,88,88,0,1,0

12,153,153,8,8,0,1,0
0,176,176,1,1,0,1,0
7,191,191,7,7,0,1,0
13,196,196,17,17,0,1,0
2,208,208,20,3,17,4,3
3,262,262,3,3,0,1,0
8,270,270,17,2,15,4,3
9,282,282,61,9,52,3,2
6,366,366,51,22,29,2,1
5,386,386,17,17,0,1,0
11,403,403,49,49,0,1,0
1,420,420,94,22,72,4,3
4,457,457,21,11,10,2,1
10,487,487,37,37,0,1,0

2,108,108,7,7,0,1,0
1,127,127,19,4,15,2,1
11,178,178,17,17,0,1,0
7,179,179,7,2,5,2,1
5,222,222,46,40,6,2,1
0,238,238,5,2,3,2,1
3,343,343,26,17,9,4,3
9,392,392,12,4,8,2,1
13,398,398,10,10,0,1,0
12,430,430,15,7,8,3,2
4,434,434,11,11,0,1,0
6,452,452,10,10,0,1,0
8,456,456,68,2,66,3,2
10,493,493,135,27,108,4,3

10,118,118,16,16,0,1,0
9,147,147,1,1,0,1,0
3,164,164,30,15,15,4,3
5,224,224,33,7,26,3,2
0,241,241,33,9,24,2,1
1,276,276,29,29,0,1,0
2,285,285,10,10,0,1,0
8,326,326,77,25,52,4,3
7,373,373,5,2,3,2,1
6,406,406,32,4,28,2,1
4,472,472,67,45,22,2,1

8,131,131,10,4,6,2,1
9,138,138,17,17,0,1,0
11,139,139,14,8,6,2,1
4,149,149,11,2,9,4,3
1,191,191,7,4,3,2,1
10,233,233,5,2,3,2,1
5,248,248,65,3,62,4,3
7,333,333,93,69,24,3,2
2,336,336,10,10,0,1,0
3,358,358,27,27,0,1,0
6,423,423,14,2,12,4,3
0,429,429,39,9,30,4,3
12,449,449,5,5,0,1,0

2,112,112,13,1,12,4,3
9,125,125,1,1,0,1,0
5,190,190,50,50,0,1,0
0,271,271,24,7,17,4,3
8,272,272,38,29,9,4,3
6,289,289,53,53,0,1,0
7,352,352,2,2,0,1,0
1,374,374,44,14,30,2,1
4,374,374,19,1,18,3,2
3,385,385,88,39,49,4,3
10,499,499,4,4,0,1,0

3,101,101,7,7,0,1,0
11,102,102,5,5,0,1,0
4,105,105,6,3,3,2,1
2,117,117,5,5,0,1,0
6,147,147,3,3,0,1,0
1,182,182,12,6,6,3,2
0,195,195,58,58,0,1,0
8,275,275,15,12,3,2,1
9,331,331,44,6,38,3,2
7,353,353,76,76,0,1,0
12,367,367,6,6,0,1,0
10,378,378,55,49,6,2,1
5,485,485,26,11,15,2,1

1,230,230,6,6,0,1,0
0,232,232,6,6,0,1,0
5,251,251,5,5,0,1,0
12,265,265,3,3,0,1,0
14,307,307,5,5,0,1,0
3,312,312,34,34,0,1,0
4,314,314,5,5,0,1,0
8,315,315,19,5,14,3,2
7,319,319,36,5,31,2,1
13,346,346,35,35,0,1,0
10,365,365,163,163,0,1,0
15,372,372,9,9,0,1,0
11,375,375,3,3,0,1,0
9,408,408,26,5,21,2,1
6,417,417,17,7,10,3,2
2,421,421,53,43,10,2,1

6,114,114,2,2,0,1,0
3,129,129,1,1,0,1,0
7,141,141,14,14,0,1,0
10,152,152,9,9,0,1,0
5,186,186,17,11,6,3,2
0,223,223,53,53,0,1,0
4,267,267,12,12,0,1,0
8,273,273,23,23,0,1,0
12,274,274,20,2,18,4,3
9,365,365,136,99,37,2,1
1,388,388,31,27,4,2,1
11,388,388,1,1,0,1,0
2,477,477,13,6,7,2,1
13,488,488,9,9,0,1,0

15,159,159,11,5,6,2,1
12,177,177,44,20,24,4,3
9,180,180,29,6,23,2,1
13,208,208,8,8,0,1,0
7,210,210,14,14,0,1,0
1,271,271,10,10,0,1,0
5,306,306,20,2,18,4,3
4,334,334,3,3,0,1,0
0,391,391,6,6,0,1,0
6,430,430,21,21,0,1,0
11,451,451,46,12,34,2,1
3,460,460,6,6,0,1,0
14,467,467,67,67,0,1,0
8,482,482,72,29,43,2,1
10,484,484,1,1,0,1,0
2,499,499,18,18,0,1,0

5,169,169,4,4,0,1,0
18,177,177,7,2,5,2,1
7,178,178,1,1,0,1,0
0,234,234,25,14,11,2,1
11,235,235,2,2,0,1,0
8,241,241,1,1,0,1,0
13,244,244,11,11,0,1,0
9,279,279,13,13,0,1,0
14,337,337,48,48,0,1,0
10,352,352,3,3,0,1,0
2,379,379,65,65,0,1,0
16,397,397,49,49,0,1,0
1,411,411,9,3,6,3,2
3,426,426,5,5,0,1,0
17,429,429,51,44,7,2,1
4,434,434,41,37,4,2,1
12,451,451,4,1,3,2,1
6,485,485,43,19,24,4,3
15,500,500,70,40,30,3,2

1,104,104,10,10,0,1,0
9,163,163,39,30,9,2,1
5,206,206,9,1,8,3,2
14,227,227,21,21,0,1,0
4,253,253,26,9,17,2,1
13,280,280,15,12,3,2,1
8,310,310,43,43,0,1,0
7,313,313,58,30,28,2,1
0,340,340,2,2,0,1,0
10,362,362,15,15,0,1,0
12,380,380,61,61,0,1,0
2,430,430,1,1,0,1,0
3,444,444,1,1,0,1,0
6,461,461,11,5,6,2,1
11,497,497,12,12,0,1,0

6,139,139,5,5,0,1,0
12,198,198,15,2,13,2,1
7,277,277,37,4,33,2,1
2,309,309,39,39,0,1,0
8,315,315,23,5,18,2,1
0,385,385,1,1,0,1,0
11,417,417,2,2,0,1,0
3,433,433,12,12,0,1,0
9,444,444,122,114,8,2,1
4,463,463,42,8,34,3,2
10,464,464,23,23,0,1,0
5,472,472,70,63,7,2,1
1,487,487,83,83,0,1,0

11,151,151,44,14,30,4,3
1,205,205,40,16,24,4,3
9,205,205,29,14,15,3,2
6,214,214,6,1,5,2,1
4,224,224,3,3,0,1,0
0,240,240,25,9,16,3,2
10,251,251,8,8,0,1,0
8,253,253,6,6,0,1,0
3,325,325,25,25,0,1,0
5,368,368,47,47,0,1,0
13,411,411,32,32,0,1,0
12,448,448,20,12,8,3,2
7,462,462,9,2,7,2,1
2,482,482,17,17,0,1,0

0,153,153,1,1,0,1,0
2,159,159,35,23,12,2,1
12,160,160,12,12,0,1,0
7,169,169,12,12,0,1,0
6,195,195,6,6,0,1,0
3,199,199,34,34,0,1,0
10,217,217,27,15,12,4,3
9,332,332,21,21,0,1,0
8,345,345,18,18,0,1,0
11,357,357,82,8,74,4,3
4,415,415,6,3,3,2,1
13,435,435,26,26,0,1,0
1,478,478,18,4,14,3,2
5,482,482,26,26,0,1,0

3,101,101,1,1,0,1,0
8,135,135,56,41,15,2,1
7,258,258,19,1,18,3,2
4,267,267,8,2,6,3,2
5,292,292,24,24,0,1,0
6,330,330,15,15,0,1,0
11,330,330,3,3,0,1,0
9,388,388,23,11,12,2,1
2,396,396,71,71,0,1,0
1,413,413,52,4,48,4,3
10,421,421,1,1,0,1,0
0,492,492,86,86,0,1,0

5,129,129,1,1,0,1,0
6,140,140,28,28,0,1,0
10,171,171,24,24,0,1,0
1,179,179,20,20,0,1,0
12,200,200,15,7,8,3,2
3,249,249,57,10,47,3,2
9,282,282,81,51,30,2,1
4,327,327,1,1,0,1,0
11,355,355,6,6,0,1,0
2,381,381,16,6,10,2,1
8,388,388,10,10,0,1,0
7,403,403,27,27,0,1,0
0,462,462,4,1,3,2,1

3,173,173,34,34,0,1,0
4,199,199,19,19,0,1,0
1,244,244,34,21,13,2,1
2,284,284,23,23,0,1,0
5,285,285,9,9,0,1,0
9,288,288,42,13,29,4,3
7,299,299,36,11,25,2,1
6,308,308,12,12,0,1,0
0,320,320,18,18,0,1,0
10,330,330,39,39,0,1,0
8,401,401,55,20,35,2,1
11,445,445,22,3,19,2,1

2,103,103,12,2,10,2,1
8,148,148,9,9,0,1,0
13,180,180,2,2,0,1,0
10,183,183,61,45,16,3,2
12,201,201,1,1,0,1,0
4,205,205,11,11,0,1,0
0,243,243,15,15,0,1,0
11,269,269,35,35,0,1,0
1,292,292,20,20,0,1,0
9,342,342,5,5,0,1,0
14,360,360,42,42,0,1,0
6,401,401,24,14,10,3,2
3,474,474,3,3,0,1,0
7,476,476,5,1,4,2,1
5,488,488,82,82,0,1,0

10,114,114,5,5,0,1,0
0,210,210,3,3,0,1,0
2,224,224,12,5,7,2,1
4,227,227,6,6,0,1,0
7,227,227,52,38,14,3,2
11,241,241,16,10,6,2,1
9,244,244,25,1,24,3,2
8,253,253,11,11,0,1,0
1,336,336,3,3,0,1,0
5,366,366,60,60,0,1,0
13,384,384,29,3,26,3,2
3,405,405,4,1,3,2,1
6,422,422,40,40,0,1,0
12,484,484,136,47,89,4,3

6,115,115,1,1,0,1,0
13,160,160,17,1,16,3,2
10,173,173,5,5,0,1,0
7,178,178,46,46,0,1,0
3,188,188,3,3,0,1,0
12,207,207,32,2,30,3,2
5,236,236,10,10,0,1,0
0,258,258,19,1,18,4,3
4,295,295,29,29,0,1,0
2,317,317,33,30,3,2,1
11,355,355,3,3,0,1,0
9,413,413,29,29,0,1,0
1,415,415,1,1,0,1,0
8,496,496,119,64,55,3,2

10,130,130,9,9,0,1,0
6,144,144,1,1,0,1,0
4,161,161,18,4,14,2,1
7,168,168,42,11,31,3,2
0,220,220,1,1,0,1,0
5,232,232,4,4,0,1,0
3,259,259,21,21,0,1,0
9,260,260,23,5,18,2,1
12,309,309,60,39,21,2,1
2,359,359,2,2,0,1,0
1,403,403,7,3,4,2,1
13,424,424,67,13,54,4,3
11,426,426,44,44,0,1,0
8,433,433,9,5,4,2,1
15,450,450,16,4,12,3,2
14,451,451,22,4,18,4,3

9,173,173,2,2,0,1,0
5,188,188,15,15,0,1,0
1,191,191,18,18,0,1,0
0,195,195,1,1,0,1,0
3,219,219,8,8,0,1,0
15,234,234,42,42,0,1,0
13,257,257,60,34,26,2,1
12,301,301,2,2,0,1,0
4,329,329,28,28,0,1,0
2,372,372,45,10,35,2,1
6,373,373,51,51,0,1,0
7,396,396,12,12,0,1,0
11,396,396,56,56,0,1,0
14,417,417,1,1,0,1,0
10,447,447,21,10,11,2,1
8,499,499,2,2,0,1,0

8,159,159,15,15,0,1,0
1,221,221,24,24,0,1,0
10,249,249,61,13,48,4,3
13,274,274,35,35,0,1,0
3,290,290,42,22,20,3,2
7,296,296,5,5,0,1,0
11,310,310,3,3,0,1,0
9,324,324,29,8,21,2,1
6,375,375,61,61,0,1,0
12,388,388,15,15,0,1,0
4,417,417,6,6,0,1,0
0,438,438,40,40,0,1,0
2,465,465,26,8,18,3,2
5,491,491,4,1,3,2,1

12,108,108,9,9,0,1,0
6,206,206,18,13,5,2,1
11,214,214,4,4,0,1,0
0,253,253,32,32,0,1,0
5,299,299,22,5,17,2,1
7,323,323,15,9,6,2,1
8,336,336,19,19,0,1,0
1,365,365,44,44,0,1,0
3,374,374,11,11,0,1,0
13,399,399,65,65,0,1,0
9,409,409,42,24,18,3,2
10,419,419,79,1,78,3,2
4,437,437,16,16,0,1,0
2,498,498,41,32,9,2,1

6,223,223,10,10,0,1,0
9,281,281,39,16,23,2,1
5,303,303,11,11,0,1,0
4,304,304,79,51,28,3,2
7,349,349,12,7,5,2,1
2,382,382,53,34,19,2,1
3,451,451,3,3,0,1,0
8,477,477,46,46,0,1,0
1,489,489,215,176,39,4,3
0,490,490,8,8,0,1,0

5,136,136,16,9,7,2,1
11,189,189,59,59,0,1,0
2,201,201,47,20,27,2,1
1,241,241,14,14,0,1,0
3,260,260,2,2,0,1,0
7,276,276,19,19,0,1,0
4,312,312,52,52,0,1,0
8,341,341,2,2,0,1,0
10,353,353,44,19,25,2,1
6,360,360,31,31,0,1,0
9,360,360,5,2,3,2,1
0,429,429,7,4,3,2,1

9,107,107,10,10,0,1,0
6,150,150,38,8,30,4,3
11,157,157,26,21,5,2,1
3,161,161,4,4,0,1,0
10,172,172,4,4,0,1,0
2,212,212,1,1,0,1,0
4,259,259,41,41,0,1,0
13,260,260,13,13,0,1,0
8,279,279,40,20,20,3,2
7,299,299,4,1,3,2,1
0,300,300,26,26,0,1,0
5,322,322,16,16,0,1,0
1,340,340,4,4,0,1,0
12,354,354,50,32,18,2,1

4,161,161,10,4,6,3,2
11,187,187,5,5,0,1,0
9,202,202,2,2,0,1,0
0,215,215,2,2,0,1,0
3,217,217,11,11,0,1,0
13,222,222,38,1,37,2,1
2,241,241,33,6,27,2,1
8,299,299,73,26,47,2,1
1,376,376,24,10,14,3,2
10,382,382,44,41,3,2,1
6,418,418,47,47,0,1,0
5,419,419,68,11,57,3,2
12,461,461,21,21,0,1,0
7,498,498,2,2,0,1,0

5,140,140,4,4,0,1,0
9,146,146,11,3,8,2,1
0,184,184,3,3,0,1,0
3,234,234,21,7,14,3,2
11,288,288,48,15,33,4,3
8,321,321,16,7,9,2,1
4,387,387,32,32,0,1,0
1,393,393,67,67,0,1,0
12,395,395,76,76,0,1,0
6,404,404,58,58,0,1,0
7,422,422,30,30,0,1,0
2,431,431,30,22,8,2,1
10,471,471,24,2,22,2,1

6,154,154,24,9,15,2,1
0,163,163,28,28,0,1,0
11,188,188,25,25,0,1,0
4,247,247,23,1,22,4,3
8,256,256,1,1,0,1,0
10,256,256,43,43,0,1,0
3,354,354,54,4,50,4,3
2,406,406,14,14,0,1,0
1,425,425,47,47,0,1,0
5,439,439,17,17,0,1,0
9,444,444,30,2,28,2,1
7,471,471,40,14,26,4,3

9,111,111,7,7,0,1,0
0,218,218,37,7,30,4,3
5,287,287,38,5,33,4,3
6,307,307,49,43,6,3,2
1,346,346,28,8,20,3,2
4,358,358,15,10,5,2,1
3,366,366,22,4,18,3,2
10,391,391,33,10,23,2,1
7,397,397,8,8,0,1,0
8,465,465,70,70,0,1,0
2,496,496,123,36,87,4,3

4,136,136,29,29,0,1,0
0,158,158,24,14,10,2,1
1,181,181,34,3,31,3,2
9,189,189,12,12,0,1,0
6,201,201,11,11,0,1,0
2,307,307,27,23,4,2,1
7,341,341,26,3,23,2,1
8,369,369,53,53,0,1,0
5,441,441,26,4,22,2,1
3,452,452,78,41,37,2,1

5,114,114,6,6,0,1,0
1,181,181,5,5,0,1,0
10,232,232,37,26,11,2,1
2,286,286,52,35,17,2,1
4,321,321,5,5,0,1,0
0,336,336,16,16,0,1,0
8,382,382,8,8,0,1,0
7,418,418,29,29,0,1,0
9,449,449,80,80,0,1,0
3,455,455,150,54,96,4,3
6,480,480,62,62,0,1,0

2,126,126,4,4,0,1,0
5,126,126,1,1,0,1,0
12,154,154,25,11,14,2,1
8,180,180,19,19,0,1,0
9,228,228,52,14,38,3,2
10,233,233,23,23,0,1,0
3,256,256,27,9,18,4,3
4,291,291,1,1,0,1,0
11,334,334,1,1,0,1,0
0,336,336,101,101,0,1,0
7,361,361,5,5,0,1,0
1,385,385,45,3,42,3,2
13,404,404,5,2,3,2,1
6,406,406,9,9,0,1,0

1,141,141,72,6,66,4,3
7,142,142,2,2,0,1,0
5,145,145,24,24,0,1,0
8,182,182,12,12,0,1,0
6,213,213,24,24,0,1,0
3,247,247,13,1,12,3,2
2,281,281,13,5,8,2,1
4,288,288,58,2,56,3,2
0,294,294,13,13,0,1,0

5,104,104,30,30,0,1,0
1,117,117,4,1,3,2,1
6,120,120,8,8,0,1,0
4,127,127,6,6,0,1,0
2,172,172,92,36,56,4,3
0,239,239,8,8,0,1,0
7,286,286,25,20,5,2,1
8,344,344,19,19,0,1,0
3,410,410,31,20,11,2,1

10,107,107,11,11,0,1,0
3,156,156,5,5,0,1,0
5,212,212,27,15,12,4,3
7,212,212,38,38,0,1,0
6,219,219,11,11,0,1,0
4,233,233,24,9,15,4,3
12,255,255,68,14,54,4,3
2,292,292,72,63,9,2,1
8,302,302,6,6,0,1,0
0,331,331,12,6,6,3,2
9,348,348,13,6,7,2,1
1,431,431,3,3,0,1,0
11,449,449,4,4,0,1,0

8,107,107,17,17,0,1,0
0,135,135,5,5,0,1,0
1,164,164,24,24,0,1,0
7,181,181,15,6,9,2,1
3,275,275,52,42,10,3,2
4,297,297,24,24,0,1,0
5,300,300,27,20,7,2,1
6,373,373,60,6,54,4,3
10,419,419,52,45,7,2,1
11,444,444,19,2,17,2,1
2,446,446,26,5,21,4,3
9,471,471,18,18,0,1,0

5,128,128,12,12,0,1,0
8,173,173,11,11,0,1,0
6,285,285,5,5,0,1,0
3,288,288,3,3,0,1,0
0,323,323,8,8,0,1,0
11,330,330,26,6,20,4,3
7,402,402,3,3,0,1,0
2,428,428,77,77,0,1,0
4,446,446,108,24,84,4,3
1,456,456,23,23,0,1,0
9,482,482,115,99,16,3,2
10,489,489,98,66,32,3,2

6,125,125,5,5,0,1,0
13,129,129,25,25,0,1,0
5,147,147,5,5,0,1,0
1,165,165,24,24,0,1,0
12,203,203,29,29,0,1,0
2,253,253,17,1,16,3,2
7,308,308,40,26,14,4,3
4,331,331,22,2,20,3,2
0,426,426,43,19,24,3,2
8,440,440,60,12,48,4,3
10,441,441,26,26,0,1,0
9,453,453,18,5,13,2,1
11,469,469,18,18,0,1,0
3,479,479,9,5,4,2,1

0,175,175,37,8,29,2,1
5,177,177,21,3,18,4,3
4,193,193,1,1,0,1,0
10,199,199,10,10,0,1,0
11,207,207,16,16,0,1,0
9,217,217,1,1,0,1,0
12,225,225,15,3,12,4,3
1,249,249,1,1,0,1,0
3,311,311,10,1,9,4,3
8,365,365,64,37,27,4,3
6,398,398,9,9,0,1,0
14,431,431,29,7,22,3,2
7,467,467,6,6,0,1,0
15,477,477,9,3,6,2,1
13,478,478,156,156,0,1,0
2,484,484,8,8,0,1,0

5,155,155,4,4,0,1,0
8,160,160,33,33,0,1,0
4,216,216,4,4,0,1,0
1,230,230,15,7,8,2,1
6,288,288,18,1,17,3,2
11,290,290,24,24,0,1,0
2,330,330,79,37,42,4,3
7,344,344,21,21,0,1,0
0,437,437,7,1,6,2,1
9,455,455,12,12,0,1,0
10,470,470,80,52,28,3,2
3,487,487,115,115,0,1,0

8,112,112,43,10,33,2,1
3,132,132,7,7,0,1,0
2,177,177,45,45,0,1,0
1,197,197,32,32,0,1,0
9,220,220,4,4,0,1,0
7,292,292,1,1,0,1,0
6,294,294,4,4,0,1,0
4,299,299,2,2,0,1,0
5,310,310,23,8,15,4,3
0,335,335,42,14,28,2,1
10,419,419,50,50,0,1,0

6,100,100,11,6,5,2,1
8,146,146,13,5,8,3,2
9,149,149,3,3,0,1,0
5,176,176,30,30,0,1,0
1,232,232,7,7,0,1,0
0,250,250,6,6,0,1,0
3,322,322,57,6,51,3,2
2,369,369,29,29,0,1,0
7,371,371,41,27,14,2,1
11,386,386,69,69,0,1,0
10,462,462,53,53,0,1,0
4,465,465,56,56,0,1,0

0,109,109,1,1,0,1,0
2,155,155,6,6,0,1,0
7,172,172,8,3,5,2,1
5,178,178,61,10,51,4,3
10,205,205,6,6,0,1,0
11,216,216,17,17,0,1,0
1,238,238,28,28,0,1,0
8,254,254,69,19,50,4,3
9,292,292,27,27,0,1,0
6,334,334,32,8,24,4,3
3,343,343,12,6,6,2,1
4,419,419,26,18,8,2,1

18,122,122,1,1,0,1,0
13,163,163,16,10,6,3,2
4,196,196,5,5,0,1,0
15,214,214,31,15,16,2,1
0,223,223,20,20,0,1,0
6,261,261,4,4,0,1,0
3,275,275,28,5,23,2,1
8,276,276,5,5,0,1,0
5,277,277,29,29,0,1,0
9,288,288,14,14,0,1,0
16,296,296,50,1,49,2,1
17,316,316,53,53,0,1,0
12,326,326,7,7,0,1,0
2,373,373,1,1,0,1,0
14,388,388,11,11,0,1,0
7,398,398,1,1,0,1,0
11,408,408,3,3,0,1,0
10,444,444,29,29,0,1,0
1,476,476,47,47,0,1,0

1,126,126,10,7,3,2,1
0,148,148,1,1,0,1,0
2,194,194,10,10,0,1,0
12,202,202,6,6,0,1,0
11,220,220,51,26,25,2,1
6,231,231,4,1,3,2,1
8,234,234,55,37,18,2,1
7,247,247,10,10,0,1,0
4,249,249,3,3,0,1,0
10,275,275,18,10,8,2,1
14,327,327,15,10,5,2,1
13,344,344,58,19,39,2,1
5,444,444,59,59,0,1,0
3,462,462,11,11,0,1,0
9,465,465,1,1,0,1,0
15,470,470,34,34,0,1,0

6,138,138,13,4,9,2,1
9,204,204,4,4,0,1,0
10,246,246,5,5,0,1,0
1,305,305,12,12,0,1,0
11,313,313,19,8,11,2,1
4,328,328,16,16,0,1,0
2,364,364,34,4,30,2,1
8,393,393,24,4,20,3,2
0,417,417,30,30,0,1,0
7,422,422,135,96,39,4,3
5,430,430,67,11,56,4,3
3,448,448,44,44,0,1,0
12,450,450,57,54,3,2,1

8,106,106,5,5,0,1,0
1,107,107,2,2,0,1,0
16,109,109,10,10,0,1,0
10,133,133,1,1,0,1,0
9,252,252,27,27,0,1,0
4,261,261,1,1,0,1,0
14,288,288,12,12,0,1,0
0,304,304,39,39,0,1,0
6,305,305,4,4,0,1,0
3,316,316,28,28,0,1,0
12,389,389,3,3,0,1,0
17,394,394,100,33,67,4,3
11,417,417,12,12,0,1,0
7,449,449,13,5,8,2,1
5,465,465,18,8,10,3,2
13,487,487,90,12,78,4,3
15,491,491,15,4,11,2,1
2,493,493,44,15,29,4,3

6,182,182,3,3,0,1,0
14,190,190,48,35,13,2,1
11,242,242,4,4,0,1,0
12,264,264,34,14,20,3,2
4,272,272,5,5,0,1,0
5,285,285,2,2,0,1,0
0,307,307,1,1,0,1,0
8,355,355,17,2,15,2,1
10,393,393,12,12,0,1,0
13,428,428,9,5,4,2,1
7,483,483,16,16,0,1,0
2,486,486,36,36,0,1,0
3,488,488,138,61,77,4,3
9,491,491,77,67,10,2,1
1,494,494,58,58,0,1,0

13,156,156,15,15,0,1,0
2,176,176,27,9,18,3,2
12,195,195,25,9,16,2,1
0,233,233,1,1,0,1,0
6,275,275,8,4,4,2,1
1,281,281,4,1,3,2,1
5,299,299,18,18,0,1,0
11,315,315,38,19,19,3,2
8,316,316,16,16,0,1,0
4,370,370,10,10,0,1,0
7,377,377,58,38,20,3,2
3,427,427,68,47,21,2,1
9,449,449,45,6,39,4,3
10,454,454,55,40,15,2,1

6,105,105,8,8,0,1,0
8,158,158,51,51,0,1,0
2,218,218,27,17,10,2,1
1,224,224,1,1,0,1,0
7,288,288,4,4,0,1,0
4,303,303,32,26,6,2,1
9,331,331,19,10,9,4,3
12,345,345,38,4,34,4,3
0,420,420,85,85,0,1,0
11,432,432,37,37,0,1,0
10,471,471,11,1,10,2,1
5,482,482,17,17,0,1,0
3,489,489,27,17,10,3,2

7,154,154,16,16,0,1,0
8,182,182,6,6,0,1,0
9,193,193,32,8,24,4,3
6,204,204,3,3,0,1,0
5,209,209,9,3,6,2,1
0,223,223,6,6,0,1,0
3,246,246,49,49,0,1,0
2,302,302,38,38,0,1,0
4,327,327,13,1,12,4,3
1,362,362,76,56,20,2,1
10,480,480,122,29,93,4,3

6,110,110,9,1,8,3,2
3,163,163,5,5,0,1,0
9,218,218,15,15,0,1,0
5,227,227,46,46,0,1,0
7,299,299,20,9,11,2,1
0,324,324,65,5,60,3,2
1,335,335,78,40,38,3,2
2,409,409,57,57,0,1,0
4,431,431,60,28,32,3,2
8,442,442,22,10,12,2,1

5,151,151,12,12,0,1,0
7,185,185,41,38,3,2,1
2,201,201,40,4,36,4,3
11,215,215,10,10,0,1,0
1,219,219,1,1,0,1,0
10,224,224,2,2,0,1,0
8,230,230,27,27,0,1,0
6,271,271,24,24,0,1,0
12,294,294,39,21,18,4,3
4,336,336,12,7,5,2,1
3,407,407,15,15,0,1,0
9,427,427,38,38,0,1,0
0,442,442,69,18,51,4,3

3,104,104,9,9,0,1,0
12,159,159,6,3,3,2,1
8,176,176,3,3,0,1,0
7,221,221,27,27,0,1,0
4,285,285,3,3,0,1,0
1,287,287,1,1,0,1,0
11,296,296,7,7,0,1,0
0,297,297,84,62,22,2,1
9,313,313,91,53,38,3,2
10,364,364,42,42,0,1,0
6,370,370,45,2,43,2,1
2,373,373,28,28,0,1,0
5,431,431,9,3,6,3,2

8,123,123,6,2,4,2,1
5,230,230,32,32,0,1,0
9,230,230,93,36,57,4,3
0,240,240,26,26,0,1,0
10,257,257,13,1,12,2,1
11,290,290,8,8,0,1,0
7,295,295,13,13,0,1,0
1,359,359,20,20,0,1,0
4,388,388,104,65,39,2,1
2,401,401,1,1,0,1,0
6,472,472,17,10,7,2,1
3,477,477,13,9,4,2,1

11,146,146,6,2,4,2,1
8,181,181,8,5,3,2,1
2,194,194,16,2,14,3,2
10,218,218,87,18,69,4,3
6,348,348,20,20,0,1,0
4,351,351,97,27,70,3,2
1,372,372,50,50,0,1,0
0,423,423,20,20,0,1,0
9,433,433,22,22,0,1,0
5,442,442,3,3,0,1,0
7,473,473,9,9,0,1,0
3,480,480,26,26,0,1,0

7,120,120,35,5,30,3,2
4,179,179,56,56,0,1,0
2,219,219,1,1,0,1,0
1,231,231,39,39,0,1,0
8,246,246,15,1,14,2,1
0,253,253,12,9,3,2,1
11,321,321,45,23,22,2,1
10,366,366,5,5,0,1,0
3,447,447,21,21,0,1,0
9,447,447,33,24,9,2,1
6,455,455,14,5,9,2,1
5,465,465,9,9,0,1,0

3,110,110,10,10,0,1,0
13,116,116,9,3,6,2,1
8,125,125,8,8,0,1,0
6,241,241,2,2,0,1,0
5,287,287,30,4,26,2,1
7,298,298,1,1,0,1,0
9,310,310,7,1,6,3,2
2,339,339,44,36,8,3,2
10,370,370,68,8,60,4,3
12,377,377,5,5,0,1,0
1,414,414,23,1,22,2,1
0,449,449,9,9,0,1,0
11,458,458,116,24,92,3,2
14,491,491,27,24,3,2,1
4,500,500,65,65,0,1,0

5,101,101,6,6,0,1,0
11,112,112,4,4,0,1,0
7,209,209,16,16,0,1,0
1,219,219,41,21,20,3,2
10,256,256,55,43,12,2,1
6,279,279,52,43,9,2,1
0,341,341,71,50,21,4,3
9,401,401,21,21,0,1,0
3,415,415,25,6,19,2,1
2,464,464,41,19,22,4,3
4,471,471,3,3,0,1,0
8,472,472,23,13,10,3,2

15,136,136,9,9,0,1,0
5,140,140,1,1,0,1,0
9,157,157,6,6,0,1,0
14,186,186,4,1,3,2,1
4,206,206,10,7,3,2,1
10,238,238,15,3,12,4,3
13,253,253,54,32,22,2,1
8,267,267,29,29,0,1,0
0,277,277,11,11,0,1,0
3,308,308,27,9,18,4,3
6,317,317,26,26,0,1,0
16,324,324,24,24,0,1,0
1,325,325,12,12,0,1,0
2,328,328,18,18,0,1,0
7,352,352,13,5,8,3,2
11,363,363,9,5,4,2,1
12,473,473,101,56,45,4,3

2,106,106,6,6,0,1,0
4,182,182,5,5,0,1,0
10,206,206,8,5,3,2,1
5,216,216,86,69,17,2,1
11,250,250,37,4,33,2,1
3,291,291,9,9,0,1,0
0,353,353,12,12,0,1,0
6,364,364,53,4,49,2,1
8,396,396,46,46,0,1,0
9,416,416,30,30,0,1,0
1,453,453,24,24,0,1,0
7,500,500,45,18,27,2,1

3,153,153,16,2,14,3,2
8,194,194,60,60,0,1,0
2,195,195,27,27,0,1,0
7,231,231,30,30,0,1,0
0,331,331,103,93,10,3,2
5,333,333,20,11,9,4,3
1,409,409,20,20,0,1,0
6,446,446,20,11,9,2,1
4,460,460,15,15,0,1,0
9,481,481,17,17,0,1,0

2,118,118,9,9,0,1,0
1,153,153,40,40,0,1,0
4,225,225,4,4,0,1,0
7,306,306,47,21,26,2,1
6,323,323,16,16,0,1,0
3,405,405,13,13,0,1,0
5,422,422,8,3,5,2,1
8,422,422,124,72,52,3,2
9,466,466,35,6,29,2,1
0,474,474,110,63,47,2,1

6,131,131,25,15,10,2,1
11,134,134,2,2,0,1,0
8,192,192,52,52,0,1,0
10,206,206,2,2,0,1,0
1,232,232,6,6,0,1,0
7,377,377,19,6,13,2,1
3,405,405,3,3,0,1,0
0,411,411,25,25,0,1,0
9,445,445,37,37,0,1,0
2,451,451,98,77,21,4,3
4,452,452,74,26,48,2,1
5,484,484,61,61,0,1,0

10,101,101,10,10,0,1,0
0,141,141,2,2,0,1,0
11,162,162,7,7,0,1,0
12,220,220,3,3,0,1,0
1,243,243,4,4,0,1,0
3,274,274,16,6,10,3,2
8,283,283,51,51,0,1,0
9,300,300,50,32,18,3,2
7,348,348,6,2,4,2,1
5,352,352,68,68,0,1,0
13,444,444,50,50,0,1,0
2,487,487,65,14,51,4,3
4,488,488,74,74,0,1,0
6,494,494,8,8,0,1,0

1,111,111,5,5,0,1,0
0,170,170,9,9,0,1,0
3,200,200,29,3,26,2,1
15,214,214,13,4,9,4,3
2,268,268,26,26,0,1,0
14,272,272,1,1,0,1,0
11,281,281,56,9,47,2,1
6,299,299,28,28,0,1,0
9,326,326,6,6,0,1,0
4,418,418,15,4,11,2,1
5,457,457,5,5,0,1,0
12,464,464,27,27,0,1,0
10,475,475,109,87,22,3,2
8,487,487,34,5,29,2,1
7,490,490,16,16,0,1,0
13,498,498,31,31,0,1,0

2,163,163,14,2,12,2,1
1,190,190,6,6,0,1,0
9,234,234,25,4,21,4,3
4,238,238,5,2,3,2,1
3,292,292,12,3,9,2,1
0,322,322,3,3,0,1,0
5,322,322,42,24,18,4,3
8,369,369,36,36,0,1,0
10,382,382,12,12,0,1,0
7,386,386,77,55,22,3,2
12,390,390,37,3,34,2,1
6,407,407,115,83,32,4,3
11,468,468,35,5,30,4,3

12,119,119,1,1,0,1,0
8,180,180,22,22,0,1,0
10,180,180,13,13,0,1,0
1,191,191,1,1,0,1,0
7,219,219,18,5,13,2,1
4,232,232,64,64,0,1,0
0,233,233,4,4,0,1,0
5,249,249,1,1,0,1,0
3,290,290,7,7,0,1,0
9,353,353,54,54,0,1,0
11,408,408,71,71,0,1,0
6,420,420,89,11,78,3,2
2,494,494,31,31,0,1,0

4,149,149,13,13,0,1,0
5,166,166,1,1,0,1,0
7,176,176,12,12,0,1,0
6,187,187,14,14,0,1,0
0,203,203,37,37,0,1,0
8,230,230,7,4,3,2,1
3,247,247,41,41,0,1,0
9,297,297,24,4,20,3,2
2,320,320,14,14,0,1,0
11,329,329,80,72,8,2,1
1,342,342,14,14,0,1,0
12,374,374,69,69,0,1,0
10,445,445,2,2,0,1,0

10,102,102,6,1,5,2,1
12,210,210,6,2,4,2,1
14,215,215,40,40,0,1,0
0,226,226,1,1,0,1,0
15,250,250,52,27,25,2,1
1,269,269,40,9,31,2,1
8,269,269,8,2,6,2,1
13,278,278,4,4,0,1,0
4,329,329,24,15,9,2,1
2,346,346,20,20,0,1,0
9,355,355,11,11,0,1,0
6,360,360,6,6,0,1,0
5,371,371,32,32,0,1,0
11,417,417,51,51,0,1,0
3,425,425,20,15,5,2,1
7,436,436,46,1,45,2,1

13,136,136,12,12,0,1,0
14,159,159,45,4,41,4,3
7,181,181,32,26,6,3,2
3,186,186,1,1,0,1,0
2,187,187,3,3,0,1,0
10,206,206,1,1,0,1,0
0,269,269,6,6,0,1,0
12,289,289,48,48,0,1,0
4,309,309,40,11,29,2,1
6,320,320,3,3,0,1,0
11,354,354,23,23,0,1,0
9,373,373,5,5,0,1,0
5,387,387,1,1,0,1,0
1,468,468,106,106,0,1,0
8,477,477,6,6,0,1,0

12,102,102,10,10,0,1,0
7,118,118,20,12,8,3,2
11,125,125,15,12,3,2,1
8,143,143,30,30,0,1,0
13,146,146,24,1,23,2,1
2,206,206,4,4,0,1,0
6,221,221,16,16,0,1,0
5,236,236,9,9,0,1,0
10,254,254,5,2,3,2,1
4,255,255,25,7,18,3,2
0,321,321,16,16,0,1,0
1,390,390,22,15,7,2,1
3,401,401,39,39,0,1,0
9,453,453,5,5,0,1,0

5,194,194,5,5,0,1,0
0,198,198,67,67,0,1,0
9,210,210,58,58,0,1,0
3,305,305,3,3,0,1,0
8,309,309,60,60,0,1,0
2,321,321,14,5,9,2,1
4,359,359,2,2,0,1,0
6,376,376,9,9,0,1,0
1,402,402,84,24,60,4,3
7,460,460,38,14,24,3,2

1,144,144,10,10,0,1,0
10,152,152,4,4,0,1,0
4,184,184,53,7,46,2,1
8,188,188,22,22,0,1,0
11,200,200,9,9,0,1,0
7,218,218,17,17,0,1,0
5,223,223,30,1,29,4,3
9,230,230,22,22,0,1,0
6,301,301,75,75,0,1,0
2,318,318,6,6,0,1,0
3,320,320,13,10,3,2,1
0,408,408,20,20,0,1,0

2,110,110,15,15,0,1,0
9,118,118,5,5,0,1,0
10,132,132,3,3,0,1,0
3,206,206,10,7,3,2,1
12,220,220,47,47,0,1,0
13,247,247,6,6,0,1,0
14,260,260,3,3,0,1,0
17,262,262,46,12,34,2,1
16,291,291,35,35,0,1,0
1,300,300,8,8,0,1,0
15,337,337,21,13,8,3,2
4,350,350,44,44,0,1,0
7,392,392,3,3,0,1,0
0,432,432,13,1,12,3,2
8,442,442,46,46,0,1,0
11,448,448,4,4,0,1,0
6,490,490,19,16,3,2,1
5,492,492,4,4,0,1,0

1,117,117,33,7,26,3,2
4,164,164,7,7,0,1,0
5,177,177,21,21,0,1,0
10,184,184,18,18,0,1,0
7,200,200,33,33,0,1,0
9,226,226,38,38,0,1,0
8,230,230,39,4,35,2,1
0,266,266,7,7,0,1,0
3,385,385,9,9,0,1,0
12,393,393,3,3,0,1,0
11,422,422,3,3,0,1,0
2,431,431,22,13,9,2,1
6,484,484,28,28,0,1,0

8,129,129,4,4,0,1,0
6,130,130,9,4,5,2,1
10,138,138,19,19,0,1,0
13,150,150,32,6,26,2,1
12,161,161,6,6,0,1,0
4,173,173,12,12,0,1,0
1,189,189,31,31,0,1,0
5,208,208,4,4,0,1,0
14,232,232,6,6,0,1,0
3,278,278,26,6,20,2,1
11,289,289,28,17,11,2,1
9,340,340,34,34,0,1,0
2,431,431,33,33,0,1,0
7,442,442,2,2,0,1,0
0,467,467,34,16,18,3,2

11,105,105,12,4,8,3,2
0,185,185,7,3,4,2,1
2,187,187,10,1,9,2,1
6,217,217,3,3,0,1,0
9,286,286,66,41,25,2,1
4,288,288,26,26,0,1,0
10,300,300,6,3,3,2,1
3,359,359,84,79,5,2,1
5,366,366,3,3,0,1,0
13,367,367,34,25,9,4,3
7,370,370,21,21,0,1,0
12,409,409,59,59,0,1,0
1,417,417,45,4,41,2,1
8,471,471,6,3,3,2,1

8,125,125,3,3,0,1,0
1,173,173,5,5,0,1,0
9,184,184,11,11,0,1,0
3,247,247,34,34,0,1,0
13,275,275,25,15,10,2,1
5,297,297,5,5,0,1,0
2,298,298,32,5,27,2,1
14,312,312,11,11,0,1,0
4,340,340,50,36,14,3,2
7,342,342,16,5,11,2,1
6,392,392,5,5,0,1,0
10,429,429,97,77,20,2,1
12,442,442,14,14,0,1,0
11,457,457,94,94,0,1,0
0,473,473,11,1,10,3,2
15,493,493,10,10,0,1,0

8,148,148,3,3,0,1,0
2,149,149,45,45,0,1,0
5,163,163,15,10,5,2,1
1,172,172,41,16,25,2,1
6,264,264,4,4,0,1,0
9,297,297,35,7,28,3,2
0,318,318,15,5,10,2,1
4,384,384,75,75,0,1,0
3,480,480,6,6,0,1,0
7,489,489,84,26,58,4,3

11,103,103,3,3,0,1,0
7,135,135,6,6,0,1,0
3,154,154,2,2,0,1,0
10,229,229,58,50,8,2,1
9,244,244,28,6,22,2,1
8,288,288,14,14,0,1,0
2,293,293,71,19,52,3,2
0,298,298,14,1,13,2,1
4,314,314,29,5,24,4,3
6,321,321,41,41,0,1,0
5,341,341,42,42,0,1,0
1,350,350,29,17,12,4,3

0,131,131,2,2,0,1,0
7,189,189,2,2,0,1,0
13,216,216,22,22,0,1,0
9,238,238,42,3,39,3,2
4,241,241,10,10,0,1,0
2,244,244,38,11,27,2,1
5,244,244,22,22,0,1,0
3,253,253,57,41,16,3,2
6,293,293,7,7,0,1,0
1,323,323,13,13,0,1,0
10,371,371,10,10,0,1,0
11,449,449,60,42,18,3,2
8,464,464,40,27,13,2,1
12,498,498,43,1,42,4,3

5,130,130,18,18,0,1,0
6,155,155,3,3,0,1,0
3,198,198,9,9,0,1,0
4,209,209,30,30,0,1,0
7,212,212,4,4,0,1,0
11,216,216,13,5,8,3,2
8,221,221,28,19,9,2,1
9,241,241,36,24,12,4,3
0,322,322,2,2,0,1,0
1,389,389,73,73,0,1,0
10,468,468,113,113,0,1,0
2,477,477,40,40,0,1,0

1,107,107,10,10,0,1,0
5,143,143,5,1,4,2,1
3,149,149,2,2,0,1,0
6,194,194,81,20,61,3,2
7,203,203,20,20,0,1,0
4,250,250,9,1,8,3,2
2,259,259,37,37,0,1,0
8,277,277,4,4,0,1,0
0,488,488,179,119,60,4,3

10,144,144,37,37,0,1,0
0,204,204,17,5,12,3,2
11,230,230,21,16,5,2,1
9,232,232,9,9,0,1,0
4,329,329,10,10,0,1,0
1,334,334,10,10,0,1,0
12,355,355,8,8,0,1,0
8,368,368,3,3,0,1,0
5,411,411,58,30,28,2,1
6,422,422,60,18,42,2,1
3,458,458,48,48,0,1,0
7,462,462,90,18,72,4,3
2,490,490,34,8,26,2,1

13,124,124,1,1,0,1,0
8,143,143,4,4,0,1,0
5,146,146,1,1,0,1,0
11,209,209,54,54,0,1,0
3,243,243,11,5,6,3,2
2,244,244,19,2,17,2,1
1,256,256,25,25,0,1,0
9,278,278,9,1,8,3,2
4,329,329,9,9,0,1,0
7,394,394,59,21,38,2,1
14,408,408,23,5,18,2,1
12,418,418,34,34,0,1,0
0,459,459,32,17,15,2,1
10,491,491,87,6,81,4,3
6,500,500,49,40,9,4,3

7,129,129,10,4,6,3,2
1,151,151,55,51,4,2,1
0,211,211,45,45,0,1,0
6,234,234,14,14,0,1,0
3,322,322,98,47,51,4,3
8,326,326,20,2,18,3,2
2,335,335,8,8,0,1,0
4,396,396,38,38,0,1,0
5,491,491,3,3,0,1,0

3,123,123,16,7,9,4,3
12,149,149,3,3,0,1,0
14,149,149,42,42,0,1,0
13,152,152,27,27,0,1,0
4,180,180,28,5,23,2,1
9,207,207,18,2,16,3,2
1,224,224,6,6,0,1,0
5,257,257,20,8,12,3,2
8,271,271,7,7,0,1,0
6,285,285,14,1,13,3,2
11,337,337,1,1,0,1,0
7,397,397,39,27,12,2,1
2,405,405,7,7,0,1,0
10,414,414,19,6,13,4,3
0,492,492,10,10,0,1,0

8,134,134,1,1,0,1,0
0,155,155,5,5,0,1,0
13,211,211,3,3,0,1,0
14,229,229,24,4,20,3,2
11,293,293,8,8,0,1,0
9,324,324,65,55,10,2,1
1,332,332,31,16,15,2,1
10,333,333,80,6,74,3,2
3,338,338,2,2,0,1,0
6,365,365,20,20,0,1,0
2,396,396,103,103,0,1,0
12,428,428,9,6,3,2,1
4,447,447,11,1,10,2,1
7,489,489,35,35,0,1,0
5,491,491,25,25,0,1,0

1,111,111,12,12,0,1,0
6,166,166,17,3,14,2,1
2,225,225,53,53,0,1,0
4,312,312,32,19,13,2,1
5,339,339,102,81,21,4,3
0,345,345,49,30,19,2,1
9,366,366,51,7,44,2,1
8,385,385,12,3,9,4,3
7,399,399,9,9,0,1,0
10,479,479,8,2,6,3,2
3,481,481,7,1,6,3,2

0,102,102,9,9,0,1,0
7,183,183,8,3,5,2,1
8,189,189,4,1,3,2,1
5,216,216,14,14,0,1,0
3,247,247,3,3,0,1,0
2,259,259,9,3,6,2,1
1,295,295,28,9,19,2,1
4,392,392,121,31,90,4,3
6,394,394,49,49,0,1,0
10,419,419,51,51,0,1,0
11,468,468,80,7,73,4,3
9,485,485,62,36,26,3,2

7,102,102,1,1,0,1,0
1,123,123,11,7,4,2,1
9,152,152,7,7,0,1,0
8,172,172,5,5,0,1,0
11,211,211,3,3,0,1,0
10,241,241,35,35,0,1,0
15,247,247,27,27,0,1,0
0,252,252,72,14,58,4,3
14,269,269,58,43,15,4,3
6,346,346,16,11,5,2,1
5,387,387,9,3,6,3,2
3,416,416,5,5,0,1,0
2,458,458,13,1,12,4,3
13,474,474,30,2,28,2,1
4,479,479,15,15,0,1,0
12,493,493,30,12,18,2,1

12,120,120,37,17,20,2,1
6,124,124,3,3,0,1,0
0,156,156,12,3,9,2,1
5,159,159,11,7,4,2,1
3,201,201,15,15,0,1,0
9,232,232,6,6,0,1,0
10,252,252,25,4,21,4,3
2,265,265,9,9,0,1,0
11,291,291,7,7,0,1,0
1,341,341,23,3,20,3,2
7,361,361,59,59,0,1,0
8,375,375,10,5,5,2,1
4,416,416,38,38,0,1,0
13,435,435,56,22,34,2,1

5,100,100,17,7,10,2,1
4,138,138,17,8,9,4,3
3,221,221,18,3,15,4,3
8,272,272,43,1,42,3,2
2,290,290,8,8,0,1,0
6,362,362,18,18,0,1,0
10,365,365,40,40,0,1,0
7,366,366,19,4,15,4,3
1,410,410,140,26,114,4,3
0,427,427,14,2,12,4,3
9,462,462,35,35,0,1,0

15,142,142,14,14,0,1,0
4,163,163,24,9,15,4,3
9,187,187,1,1,0,1,0
13,202,202,20,17,3,2,1
12,244,244,13,13,0,1,0
2,287,287,3,3,0,1,0
6,287,287,6,6,0,1,0
8,295,295,8,8,0,1,0
11,300,300,18,3,15,2,1
5,315,315,8,2,6,2,1
14,340,340,51,51,0,1,0
0,350,350,20,14,6,3,2
7,355,355,17,9,8,2,1
16,360,360,9,9,0,1,0
3,361,361,51,15,36,4,3
17,388,388,71,13,58,3,2
10,427,427,12,2,10,3,2
1,439,439,13,13,0,1,0

9,101,101,6,6,0,1,0
4,127,127,24,15,9,2,1
10,159,159,10,10,0,1,0
8,177,177,37,22,15,4,3
1,229,229,4,4,0,1,0
7,264,264,38,38,0,1,0
2,291,291,39,21,18,3,2
0,326,326,12,12,0,1,0
5,345,345,29,21,8,3,2
3,420,420,95,95,0,1,0
6,420,420,24,10,14,4,3

3,102,102,1,1,0,1,0
11,127,127,24,1,23,2,1
10,151,151,12,12,0,1,0
14,157,157,6,1,5,2,1
12,164,164,23,5,18,3,2
9,200,200,6,6,0,1,0
6,302,302,9,5,4,2,1
13,302,302,18,6,12,2,1
0,329,329,8,2,6,3,2
15,332,332,36,36,0,1,0
1,347,347,36,36,0,1,0
4,388,388,25,25,0,1,0
5,390,390,21,15,6,3,2
7,411,411,27,27,0,1,0
2,469,469,95,95,0,1,0
8,488,488,9,9,0,1,0

0,129,129,4,4,0,1,0
4,160,160,27,3,24,4,3
11,174,174,23,23,0,1,0
3,212,212,29,29,0,1,0
2,216,216,34,22,12,3,2
9,275,275,91,22,69,4,3
8,312,312,20,2,18,4,3
1,319,319,1,1,0,1,0
5,323,323,4,4,0,1,0
13,336,336,1,1,0,1,0
7,358,358,4,4,0,1,0
6,364,364,29,23,6,2,1
10,417,417,7,7,0,1,0
12,423,423,26,26,0,1,0

6,130,130,6,6,0,1,0
8,192,192,50,26,24,2,1
10,298,298,30,30,0,1,0
7,313,313,8,2,6,3,2
4,318,318,76,61,15,4,3
3,337,337,6,6,0,1,0
9,339,339,12,12,0,1,0
0,353,353,32,32,0,1,0
5,406,406,59,59,0,1,0
1,411,411,71,5,66,4,3
2,486,486,39,1,38,3,2

5,173,173,17,3,14,3,2
6,179,179,14,14,0,1,0
9,209,209,27,27,0,1,0
8,210,210,4,4,0,1,0
2,325,325,130,118,12,3,2
1,347,347,6,6,0,1,0
7,400,400,7,7,0,1,0
3,433,433,30,1,29,4,3
4,440,440,117,117,0,1,0
0,477,477,55,55,0,1,0

7,113,113,1,1,0,1,0
5,117,117,10,1,9,2,1
12,126,126,11,3,8,3,2
13,154,154,6,3,3,2,1
0,190,190,7,1,6,3,2
2,212,212,6,3,3,2,1
8,243,243,28,14,14,3,2
9,280,280,34,25,9,2,1
4,298,298,25,13,12,4,3
10,299,299,54,54,0,1,0
15,312,312,70,70,0,1,0
1,326,326,18,6,12,2,1
11,366,366,27,27,0,1,0
6,407,407,10,10,0,1,0
3,443,443,18,6,12,2,1
14,471,471,3,3,0,1,0

4,117,117,11,11,0,1,0
9,121,121,9,9,0,1,0
10,257,257,16,13,3,2,1
7,313,313,59,59,0,1,0
2,371,371,67,9,58,3,2
8,380,380,49,37,12,4,3
5,444,444,59,18,41,4,3
6,456,456,12,12,0,1,0
0,470,470,147,110,37,3,2
1,475,475,4,4,0,1,0
3,483,483,3,3,0,1,0

8,104,104,15,6,9,3,2
7,134,134,1,1,0,1,0
0,185,185,4,4,0,1,0
6,196,196,50,50,0,1,0
2,258,258,9,6,3,2,1
12,298,298,57,9,48,2,1
3,344,344,14,14,0,1,0
5,348,348,73,43,30,4,3
9,364,364,16,2,14,3,2
1,433,433,9,2,7,2,1
11,456,456,104,81,23,2,1
4,468,468,9,4,5,2,1
10,472,472,2,2,0,1,0

10,142,142,22,22,0,1,0
9,152,152,12,12,0,1,0
5,160,160,1,1,0,1,0
8,212,212,12,4,8,2,1
15,238,238,22,8,14,2,1
2,286,286,2,2,0,1,0
3,292,292,5,5,0,1,0
7,306,306,1,1,0,1,0
1,325,325,1,1,0,1,0
6,399,399,14,14,0,1,0
13,401,401,12,12,0,1,0
14,401,401,65,20,45,2,1
0,407,407,31,31,0,1,0
4,462,462,149,149,0,1,0
11,471,471,18,18,0,1,0
12,471,471,62,29,33,2,1

9,114,114,47,23,24,3,2
5,126,126,4,4,0,1,0
4,145,145,3,3,0,1,0
7,279,279,28,23,5,2,1
1,301,301,49,5,44,2,1
2,330,330,49,3,46,2,1
10,339,339,12,12,0,1,0
3,368,368,16,4,12,4,3
8,386,386,6,6,0,1,0
6,462,462,7,7,0,1,0
11,467,467,16,8,8,3,2
0,484,484,95,49,46,4,3

0,118,118,1,1,0,1,0
12,150,150,13,13,0,1,0
9,174,174,18,18,0,1,0
1,180,180,9,9,0,1,0
14,181,181,20,20,0,1,0
6,187,187,14,14,0,1,0
16,201,201,17,3,14,2,1
13,226,226,3,3,0,1,0
5,240,240,4,4,0,1,0
2,253,253,9,9,0,1,0
8,327,327,7,7,0,1,0
15,344,344,39,39,0,1,0
7,354,354,1,1,0,1,0
3,387,387,2,2,0,1,0
11,398,398,64,3,61,4,3
4,434,434,30,19,11,2,1
17,485,485,100,100,0,1,0
10,487,487,26,4,22,3,2

7,127,127,31,1,30,2,1
8,152,152,3,3,0,1,0
3,178,178,9,9,0,1,0
2,203,203,15,15,0,1,0
10,219,219,3,3,0,1,0
11,249,249,31,31,0,1,0
9,253,253,10,5,5,2,1
0,277,277,41,41,0,1,0
5,333,333,25,17,8,3,2
4,351,351,8,8,0,1,0
1,391,391,90,6,84,4,3
6,421,421,74,55,19,2,1

6,124,124,7,7,0,1,0
11,137,137,1,1,0,1,0
10,162,162,3,3,0,1,0
1,203,203,31,31,0,1,0
5,255,255,18,1,17,2,1
3,275,275,41,41,0,1,0
8,298,298,25,25,0,1,0
4,339,339,44,20,24,3,2
7,394,394,104,64,40,2,1
0,437,437,30,30,0,1,0
2,457,457,15,8,7,2,1
9,490,490,91,43,48,4,3

3,156,156,1,1,0,1,0
5,156,156,1,1,0,1,0
6,160,160,3,3,0,1,0
4,237,237,56,31,25,2,1
9,244,244,24,2,22,3,2
13,250,250,43,43,0,1,0
1,260,260,12,9,3,2,1
0,302,302,10,10,0,1,0
11,319,319,83,83,0,1,0
8,330,330,14,5,9,4,3
7,355,355,28,28,0,1,0
2,364,364,13,13,0,1,0
14,408,408,14,14,0,1,0
10,415,415,7,7,0,1,0
15,419,419,2,2,0,1,0
12,437,437,54,54,0,1,0

3,117,117,6,6,0,1,0
12,134,134,25,11,14,2,1
8,151,151,13,13,0,1,0
13,151,151,1,1,0,1,0
7,183,183,19,13,6,3,2
0,204,204,6,2,4,2,1
9,204,204,3,3,0,1,0
5,268,268,68,29,39,2,1
11,327,327,32,25,7,2,1
1,364,364,35,19,16,3,2
6,390,390,6,6,0,1,0
4,413,413,22,1,21,4,3
2,418,418,1,1,0,1,0
10,467,467,104,52,52,4,3

8,110,110,23,5,18,4,3
5,128,128,8,8,0,1,0
4,137,137,2,2,0,1,0
10,221,221,37,37,0,1,0
9,236,236,38,38,0,1,0
1,313,313,5,5,0,1,0
0,315,315,24,24,0,1,0
11,336,336,10,10,0,1,0
6,401,401,4,4,0,1,0
3,478,478,141,141,0,1,0
7,488,488,18,3,15,2,1
2,491,491,69,69,0,1,0

10,220,220,16,3,13,2,1
0,237,237,16,12,4,2,1
11,303,303,21,21,0,1,0
5,314,314,6,6,0,1,0
3,319,319,41,41,0,1,0
2,339,339,50,11,39,2,1
7,358,358,38,17,21,4,3
4,359,359,16,16,0,1,0
9,421,421,27,27,0,1,0
1,447,447,87,21,66,3,2
8,471,471,117,117,0,1,0
6,497,497,23,23,0,1,0

10,129,129,10,2,8,2,1
7,251,251,9,3,6,2,1
9,265,265,25,1,24,2,1
2,280,280,1,1,0,1,0
6,311,311,5,5,0,1,0
3,326,326,18,18,0,1,0
13,343,343,56,56,0,1,0
11,361,361,81,33,48,3,2
5,400,400,15,15,0,1,0
8,404,404,61,61,0,1,0
14,412,412,15,6,9,2,1
4,427,427,59,59,0,1,0
1,474,474,73,44,29,2,1
0,475,475,5,5,0,1,0
12,497,497,8,8,0,1,0

10,115,115,1,1,0,1,0
4,142,142,25,1,24,2,1
14,146,146,2,2,0,1,0
5,165,165,6,6,0,1,0
17,189,189,8,2,6,2,1
16,232,232,2,2,0,1,0
2,258,258,24,3,21,4,3
13,276,276,12,8,4,2,1
12,298,298,81,16,65,4,3
0,303,303,15,15,0,1,0
1,318,318,9,3,6,3,2
8,341,341,6,6,0,1,0
15,391,391,92,25,67,4,3
9,400,400,13,13,0,1,0
11,410,410,10,1,9,4,3
6,443,443,4,4,0,1,0
3,488,488,7,7,0,1,0
7,500,500,56,18,38,2,1

11,135,135,37,19,18,3,2
0,136,136,2,2,0,1,0
10,153,153,4,4,0,1,0
9,165,165,7,1,6,2,1
7,173,173,10,10,0,1,0
2,187,187,13,13,0,1,0
1,227,227,11,11,0,1,0
15,227,227,20,20,0,1,0
4,250,250,6,6,0,1,0
5,325,325,10,10,0,1,0
6,394,394,19,19,0,1,0
3,404,404,105,48,57,4,3
13,417,417,19,9,10,3,2
8,438,438,3,3,0,1,0
14,485,485,60,60,0,1,0
12,493,493,29,3,26,2,1

2,150,150,21,21,0,1,0
3,151,151,14,14,0,1,0
6,189,189,34,23,11,4,3
7,226,226,43,43,0,1,0
5,292,292,2,2,0,1,0
8,331,331,41,41,0,1,0
0,364,364,46,7,39,4,3
1,425,425,143,22,121,4,3
4,425,425,10,10,0,1,0

0,132,132,19,19,0,1,0
3,149,149,8,1,7,2,1
2,174,174,9,1,8,2,1
10,181,181,8,2,6,3,2
7,200,200,23,9,14,2,1
4,291,291,102,71,31,2,1
9,354,354,112,51,61,4,3
5,383,383,14,14,0,1,0
8,428,428,16,16,0,1,0
1,441,441,1,1,0,1,0
6,448,448,27,27,0,1,0

9,234,234,30,21,9,4,3
4,252,252,2,2,0,1,0
10,322,322,45,13,32,3,2
0,326,326,11,11,0,1,0
6,345,345,42,42,0,1,0
7,377,377,34,12,22,3,2
8,389,389,27,27,0,1,0
1,406,406,49,49,0,1,0
5,428,428,106,97,9,4,3
2,444,444,83,83,0,1,0
11,481,481,27,13,14,3,2
3,493,493,2,2,0,1,0

11,104,104,16,16,0,1,0
7,105,105,3,3,0,1,0
5,114,114,3,3,0,1,0
10,150,150,28,23,5,2,1
4,155,155,1,1,0,1,0
0,245,245,9,9,0,1,0
2,300,300,34,10,24,2,1
1,304,304,2,2,0,1,0
8,381,381,31,17,14,3,2
9,397,397,52,19,33,4,3
12,449,449,16,10,6,2,1
6,464,464,143,143,0,1,0
3,479,479,50,38,12,4,3

1,166,166,14,8,6,3,2
15,170,170,6,6,0,1,0
8,188,188,24,10,14,3,2
10,196,196,26,2,24,2,1
3,271,271,2,2,0,1,0
0,296,296,19,6,13,2,1
5,302,302,1,1,0,1,0
14,304,304,21,21,0,1,0
16,321,321,22,5,17,4,3
4,325,325,5,2,3,2,1
12,351,351,53,53,0,1,0
13,352,352,24,24,0,1,0
6,357,357,9,9,0,1,0
11,383,383,85,30,55,4,3
2,401,401,8,8,0,1,0
7,459,459,22,13,9,2,1
9,460,460,35,35,0,1,0

12,106,106,7,4,3,2,1
8,116,116,7,2,5,2,1
4,229,229,1,1,0,1,0
0,244,244,1,1,0,1,0
6,246,246,11,11,0,1,0
14,273,273,5,5,0,1,0
3,331,331,10,3,7,2,1
2,332,332,51,51,0,1,0
7,353,353,80,80,0,1,0
10,364,364,45,37,8,2,1
5,423,423,23,7,16,2,1
1,448,448,12,12,0,1,0
9,455,455,97,50,47,4,3
11,468,468,74,74,0,1,0
13,499,499,15,10,5,2,1

1,111,111,10,10,0,1,0
6,175,175,14,2,12,2,1
8,217,217,10,10,0,1,0
10,234,234,23,23,0,1,0
2,255,255,10,6,4,2,1
9,292,292,74,5,69,4,3
4,301,301,79,79,0,1,0
0,360,360,45,45,0,1,0
5,441,441,31,31,0,1,0
3,453,453,6,6,0,1,0
7,487,487,41,12,29,2,1
11,492,492,24,4,20,2,1

5,119,119,1,1,0,1,0
17,140,140,9,9,0,1,0
7,145,145,1,1,0,1,0
10,183,183,2,2,0,1,0
15,221,221,17,17,0,1,0
8,222,222,9,2,7,2,1
4,338,338,33,33,0,1,0
16,338,338,12,6,6,3,2
12,339,339,4,4,0,1,0
0,340,340,43,16,27,3,2
2,361,361,4,4,0,1,0
13,391,391,43,22,21,4,3
3,417,417,29,26,3,2,1
9,417,417,12,12,0,1,0
11,444,444,49,44,5,2,1
14,444,444,139,117,22,2,1
6,450,450,36,9,27,4,3
1,487,487,5,5,0,1,0

3,104,104,5,5,0,1,0
6,157,157,31,7,24,2,1
2,160,160,45,45,0,1,0
4,219,219,25,14,11,2,1
7,222,222,10,4,6,2,1
0,247,247,31,4,27,2,1
10,261,261,20,20,0,1,0
1,348,348,11,11,0,1,0
8,406,406,3,3,0,1,0
5,474,474,48,48,0,1,0
9,495,495,91,25,66,3,2

11,191,191,5,5,0,1,0
5,230,230,23,5,18,2,1
3,265,265,13,1,12,3,2
4,277,277,31,22,9,2,1
1,298,298,80,80,0,1,0
9,314,314,13,13,0,1,0
2,349,349,22,5,17,2,1
7,379,379,42,42,0,1,0
0,393,393,4,1,3,2,1
6,421,421,91,87,4,2,1
8,437,437,20,5,15,4,3
10,442,442,76,58,18,4,3

7,136,136,5,1,4,2,1
13,143,143,26,26,0,1,0
4,186,186,9,9,0,1,0
10,187,187,7,7,0,1,0
6,213,213,56,56,0,1,0
12,230,230,73,28,45,4,3
0,292,292,11,11,0,1,0
5,304,304,2,2,0,1,0
3,315,315,44,44,0,1,0
8,374,374,6,6,0,1,0
1,376,376,4,4,0,1,0
11,430,430,18,12,6,3,2
9,444,444,8,2,6,3,2
2,469,469,29,29,0,1,0

13,133,133,2,2,0,1,0
5,136,136,5,5,0,1,0
10,141,141,6,6,0,1,0
3,159,159,7,1,6,3,2
6,160,160,10,10,0,1,0
9,190,190,11,5,6,3,2
8,208,208,2,2,0,1,0
7,222,222,24,24,0,1,0
11,245,245,4,4,0,1,0
0,256,256,11,11,0,1,0
14,266,266,30,30,0,1,0
15,306,306,47,47,0,1,0
12,308,308,30,30,0,1,0
18,350,350,76,76,0,1,0
17,389,389,25,22,3,2,1
1,411,411,4,4,0,1,0
16,420,420,23,23,0,1,0
2,465,465,18,9,9,4,3
4,484,484,17,17,0,1,0

17,116,116,2,2,0,1,0
0,118,118,3,3,0,1,0
14,126,126,32,28,4,2,1
8,155,155,4,4,0,1,0
10,179,179,3,3,0,1,0
15,216,216,16,3,13,2,1
6,240,240,13,13,0,1,0
16,257,257,27,27,0,1,0
18,264,264,6,6,0,1,0
5,334,334,4,4,0,1,0
12,367,367,11,11,0,1,0
4,369,369,9,9,0,1,0
2,374,374,56,12,44,2,1
7,387,387,1,1,0,1,0
1,403,403,35,35,0,1,0
9,411,411,6,6,0,1,0
13,434,434,63,63,0,1,0
3,490,490,51,51,0,1,0
11,499,499,28,28,0,1,0

12,117,117,10,10,0,1,0
9,303,303,19,19,0,1,0
3,308,308,10,10,0,1,0
5,324,324,51,45,6,2,1
13,364,364,7,2,5,2,1
8,390,390,21,21,0,1,0
7,391,391,17,17,0,1,0
4,395,395,43,25,18,2,1
11,417,417,140,100,40,3,2
6,425,425,29,20,9,4,3
2,453,453,35,35,0,1,0
10,460,460,5,5,0,1,0
14,462,462,46,23,23,4,3
1,466,466,25,3,22,2,1
0,477,477,3,3,0,1,0

2,109,109,8,8,0,1,0
6,110,110,47,47,0,1,0
10,141,141,1,1,0,1,0
12,273,273,8,5,3,2,1
1,345,345,5,5,0,1,0
5,357,357,5,5,0,1,0
4,358,358,11,11,0,1,0
9,360,360,28,24,4,2,1
3,365,365,1,1,0,1,0
7,421,421,146,146,0,1,0
0,427,427,19,6,13,2,1
8,446,446,35,5,30,3,2
11,456,456,35,35,0,1,0

12,149,149,44,19,25,2,1
6,161,161,7,7,0,1,0
9,234,234,35,35,0,1,0
16,268,268,8,1,7,2,1
8,290,290,3,3,0,1,0
3,338,338,21,21,0,1,0
11,343,343,60,21,39,4,3
0,366,366,11,11,0,1,0
2,371,371,2,2,0,1,0
4,371,371,28,7,21,3,2
10,372,372,35,2,33,4,3
1,397,397,1,1,0,1,0
7,402,402,29,17,12,2,1
14,407,407,14,4,10,2,1
5,456,456,26,17,9,4,3
15,474,474,33,21,12,4,3
13,491,491,3,3,0,1,0

0,278,278,33,7,26,3,2
9,283,283,49,49,0,1,0
4,285,285,9,5,4,2,1
6,302,302,24,15,9,2,1
1,409,409,33,33,0,1,0
2,458,458,88,71,17,2,1
8,459,459,50,50,0,1,0
7,468,468,26,26,0,1,0
3,478,478,100,22,78,3,2
5,493,493,79,79,0,1,0

5,139,139,25,5,20,2,1
8,165,165,28,6,22,2,1
0,176,176,7,7,0,1,0
6,214,214,15,15,0,1,0
2,230,230,23,23,0,1,0
10,384,384,78,78,0,1,0
11,387,387,29,7,22,2,1
7,398,398,30,30,0,1,0
1,419,419,6,6,0,1,0
4,433,433,38,38,0,1,0
3,451,451,82,39,43,4,3
9,458,458,6,6,0,1,0

0,132,132,14,3,11,2,1
13,136,136,14,8,6,3,2
11,146,146,65,42,23,2,1
8,184,184,8,8,0,1,0
3,202,202,7,7,0,1,0
1,218,218,7,7,0,1,0
14,242,242,2,2,0,1,0
12,341,341,12,5,7,2,1
7,345,345,61,61,0,1,0
4,366,366,22,22,0,1,0
6,404,404,1,1,0,1,0
5,407,407,24,15,9,4,3
9,440,440,8,8,0,1,0
10,462,462,2,2,0,1,0
2,486,486,42,24,18,4,3

7,129,129,20,5,15,4,3
10,199,199,37,23,14,2,1
12,274,274,16,16,0,1,0
2,301,301,1,1,0,1,0
6,354,354,13,13,0,1,0
14,382,382,35,35,0,1,0
8,384,384,30,30,0,1,0
13,384,384,23,23,0,1,0
4,385,385,17,3,14,2,1
1,397,397,30,30,0,1,0
9,402,402,50,35,15,4,3
0,406,406,36,36,0,1,0
5,407,407,46,46,0,1,0
3,411,411,3,3,0,1,0
11,480,480,45,24,21,4,3

0,108,108,24,3,21,4,3
8,123,123,2,2,0,1,0
5,188,188,28,28,0,1,0
2,194,194,29,3,26,2,1
3,385,385,42,6,36,4,3
1,414,414,50,50,0,1,0
4,415,415,51,51,0,1,0
7,427,427,109,13,96,3,2
6,432,432,6,3,3,2,1
9,483,483,25,22,3,2,1

9,118,118,7,7,0,1,0
1,124,124,12,7,5,2,1
0,213,213,19,11,8,2,1
3,236,236,2,2,0,1,0
6,238,238,68,58,10,3,2
5,279,279,13,13,0,1,0
11,297,297,5,5,0,1,0
10,347,347,49,42,7,2,1
4,365,365,69,69,0,1,0
8,456,456,33,11,22,3,2
2,459,459,79,45,34,3,2
7,478,478,16,16,0,1,0

9,143,143,1,1,0,1,0
12,178,178,3,3,0,1,0
16,240,240,12,3,9,4,3
13,240,240,3,3,0,1,0
5,254,254,8,8,0,1,0
7,278,278,10,10,0,1,0
14,288,288,30,30,0,1,0
2,306,306,1,1,0,1,0
4,309,309,33,33,0,1,0
18,314,314,23,8,15,4,3
6,339,339,2,2,0,1,0
1,346,346,1,1,0,1,0
3,386,386,49,49,0,1,0
8,405,405,45,45,0,1,0
15,406,406,137,16,121,4,3
10,422,422,20,20,0,1,0
0,435,435,7,7,0,1,0
17,459,459,14,2,12,3,2
11,462,462,43,43,0,1,0

3,115,115,4,1,3,2,1
5,131,131,11,11,0,1,0
13,142,142,27,9,18,4,3
18,152,152,30,30,0,1,0
12,155,155,1,1,0,1,0
7,166,166,1,1,0,1,0
16,256,256,9,9,0,1,0
17,264,264,12,12,0,1,0
2,284,284,21,9,12,2,1
10,287,287,6,6,0,1,0
1,294,294,11,1,10,3,2
4,383,383,1,1,0,1,0
11,414,414,43,43,0,1,0
8,416,416,18,3,15,2,1
9,432,432,4,4,0,1,0
15,458,458,22,22,0,1,0
6,464,464,79,74,5,2,1
0,478,478,6,3,3,2,1
14,496,496,48,48,0,1,0

8,103,103,2,2,0,1,0
0,138,138,25,25,0,1,0
9,194,194,86,11,75,4,3
4,221,221,19,11,8,2,1
2,265,265,24,12,12,4,3
1,272,272,6,6,0,1,0
7,325,325,3,3,0,1,0
6,428,428,21,12,9,4,3
3,455,455,140,140,0,1,0
5,485,485,2,2,0,1,0

6,125,125,1,1,0,1,0
12,168,168,54,54,0,1,0
4,179,179,4,1,3,2,1
9,224,224,4,1,3,2,1
1,226,226,12,12,0,1,0
3,264,264,10,7,3,2,1
13,275,275,15,15,0,1,0
8,286,286,36,13,23,2,1
14,300,300,23,1,22,2,1
11,308,308,1,1,0,1,0
0,329,329,16,2,14,2,1
15,375,375,14,14,0,1,0
2,380,380,43,21,22,3,2
5,409,409,70,28,42,3,2
7,483,483,1,1,0,1,0
10,494,494,61,46,15,2,1

4,102,102,25,11,14,2,1
8,126,126,31,31,0,1,0
7,146,146,27,27,0,1,0
12,255,255,6,6,0,1,0
1,257,257,28,28,0,1,0
5,302,302,23,23,0,1,0
0,381,381,43,43,0,1,0
11,384,384,50,50,0,1,0
10,421,421,8,2,6,2,1
9,422,422,3,3,0,1,0
2,450,450,11,11,0,1,0
3,454,454,9,3,6,3,2
6,491,491,7,1,6,3,2

4,155,155,13,5,8,3,2
0,160,160,15,15,0,1,0
1,204,204,4,4,0,1,0
8,212,212,15,6,9,4,3
13,217,217,3,3,0,1,0
6,272,272,23,23,0,1,0
11,277,277,9,9,0,1,0
7,295,295,8,2,6,2,1
12,298,298,75,75,0,1,0
2,301,301,55,22,33,2,1
10,334,334,53,18,35,2,1
5,429,429,7,2,5,2,1
9,453,453,37,37,0,1,0
3,496,496,47,4,43,4,3

1,122,122,10,4,6,3,2
8,130,130,1,1,0,1,0
2,134,134,2,2,0,1,0
0,190,190,39,21,18,4,3
3,223,223,1,1,0,1,0
11,275,275,3,3,0,1,0
7,285,285,45,45,0,1,0
9,345,345,77,77,0,1,0
4,413,413,7,1,6,2,1
6,434,434,52,30,22,2,1
12,443,443,1,1,0,1,0
13,479,479,83,83,0,1,0
5,491,491,1,1,0,1,0
10,496,496,97,52,45,4,3

0,108,108,8,5,3,2,1
12,114,114,30,17,13,2,1
6,142,142,8,8,0,1,0
14,166,166,2,2,0,1,0
8,191,191,8,8,0,1,0
15,194,194,15,15,0,1,0
7,195,195,1,1,0,1,0
13,215,215,18,18,0,1,0
4,229,229,11,4,7,2,1
10,229,229,7,7,0,1,0
2,298,298,2,2,0,1,0
5,324,324,2,2,0,1,0
16,340,340,47,23,24,4,3
9,440,440,41,25,16,2,1
11,445,445,18,2,16,2,1
1,479,479,44,44,0,1,0
3,497,497,74,34,40,3,2

5,111,111,5,5,0,1,0
6,134,134,3,3,0,1,0
8,197,197,6,2,4,2,1
2,250,250,10,10,0,1,0
9,250,250,19,11,8,2,1
1,275,275,75,66,9,2,1
7,346,346,53,53,0,1,0
3,364,364,18,3,15,4,3
4,388,388,37,37,0,1,0
0,420,420,44,28,16,3,2
11,447,447,98,61,37,2,1
10,494,494,54,27,27,2,1

3,119,119,25,25,0,1,0
1,120,120,1,1,0,1,0
4,130,130,8,8,0,1,0
5,217,217,26,26,0,1,0
9,227,227,1,1,0,1,0
8,282,282,26,11,15,2,1
2,413,413,28,28,0,1,0
0,418,418,57,30,27,4,3
11,425,425,11,11,0,1,0
6,435,435,51,15,36,4,3
10,482,482,85,85,0,1,0
7,499,499,97,71,26,2,1

10,116,116,12,6,6,3,2
1,198,198,1,1,0,1,0
11,234,234,25,5,20,2,1
9,250,250,31,5,26,2,1
13,305,305,23,17,6,2,1
12,367,367,12,12,0,1,0
5,397,397,9,9,0,1,0
4,413,413,4,4,0,1,0
3,425,425,3,3,0,1,0
2,436,436,42,12,30,3,2
7,454,454,103,79,24,2,1
6,496,496,69,69,0,1,0
8,497,497,88,88,0,1,0
0,500,500,47,18,29,2,1

2,119,119,36,36,0,1,0
8,132,132,10,4,6,2,1
3,148,148,5,2,3,2,1
6,167,167,4,4,0,1,0
4,194,194,3,3,0,1,0
5,215,215,97,20,77,4,3
0,394,394,102,102,0,1,0
7,475,475,10,4,6,3,2
1,490,490,23,3,20,3,2

6,109,109,10,10,0,1,0
3,114,114,9,9,0,1,0
8,148,148,9,3,6,3,2
10,212,212,6,6,0,1,0
11,233,233,27,27,0,1,0
0,243,243,6,3,3,2,1
12,247,247,13,13,0,1,0
1,344,344,17,7,10,2,1
13,363,363,24,24,0,1,0
5,385,385,23,11,12,2,1
14,418,418,10,10,0,1,0
9,430,430,138,106,32,3,2
2,447,447,15,2,13,3,2
4,484,484,86,65,21,2,1
7,491,491,13,13,0,1,0

13,163,163,5,5,0,1,0
11,184,184,60,4,56,3,2
5,200,200,9,9,0,1,0
12,213,213,1,1,0,1,0
0,220,220,17,17,0,1,0
7,258,258,35,1,34,2,1
2,262,262,11,3,8,3,2
10,267,267,29,19,10,3,2
3,287,287,62,62,0,1,0
6,310,310,3,3,0,1,0
4,334,334,25,25,0,1,0
8,385,385,44,44,0,1,0
1,404,404,1,1,0,1,0
9,419,419,12,12,0,1,0

5,123,123,19,19,0,1,0
12,141,141,8,8,0,1,0
2,150,150,15,1,14,3,2
4,163,163,15,6,9,4,3
3,184,184,1,1,0,1,0
9,203,203,3,3,0,1,0
6,214,214,20,20,0,1,0
1,235,235,17,17,0,1,0
10,343,343,46,24,22,3,2
7,344,344,13,13,0,1,0
13,403,403,59,59,0,1,0
0,424,424,19,19,0,1,0
8,461,461,109,91,18,2,1
11,483,483,11,11,0,1,0

0,140,140,3,3,0,1,0
5,181,181,15,15,0,1,0
2,208,208,61,61,0,1,0
1,237,237,30,3,27,4,3
9,277,277,25,1,24,2,1
7,292,292,9,1,8,3,2
6,323,323,1,1,0,1,0
4,334,334,21,21,0,1,0
8,336,336,84,84,0,1,0
10,425,425,65,65,0,1,0
3,469,469,45,9,36,4,3

6,111,111,25,25,0,1,0
9,127,127,33,27,6,3,2
8,163,163,21,21,0,1,0
0,187,187,1,1,0,1,0
3,241,241,12,12,0,1,0
10,322,322,52,52,0,1,0
12,343,343,27,5,22,3,2
13,359,359,6,1,5,2,1
5,372,372,13,13,0,1,0
11,375,375,17,5,12,4,3
14,381,381,18,14,4,2,1
1,400,400,37,37,0,1,0
2,401,401,7,7,0,1,0
4,488,488,1,1,0,1,0
7,493,493,24,24,0,1,0

11,176,176,27,27,0,1,0
13,190,190,30,30,0,1,0
0,250,250,14,10,4,2,1
8,298,298,20,20,0,1,0
5,366,366,26,9,17,2,1
3,377,377,27,4,23,2,1
7,409,409,3,3,0,1,0
6,431,431,32,4,28,3,2
9,432,432,8,8,0,1,0
10,444,444,10,10,0,1,0
4,448,448,74,47,27,4,3
14,461,461,74,74,0,1,0
1,466,466,5,5,0,1,0
12,475,475,13,7,6,2,1
16,482,482,38,38,0,1,0
2,485,485,18,10,8,2,1
15,492,492,15,15,0,1,0

4,115,115,9,9,0,1,0
10,212,212,31,2,29,3,2
11,242,242,13,13,0,1,0
8,258,258,7,7,0,1,0
6,260,260,6,6,0,1,0
13,282,282,1,1,0,1,0
3,339,339,9,9,0,1,0
0,342,342,82,82,0,1,0
9,387,387,82,61,21,4,3
7,400,400,8,2,6,2,1
1,421,421,65,32,33,2,1
5,431,431,20,12,8,2,1
2,446,446,6,6,0,1,0
12,475,475,80,8,72,4,3

6,151,151,6,6,0,1,0
2,192,192,38,22,16,3,2
8,203,203,16,16,0,1,0
7,235,235,9,9,0,1,0
0,277,277,72,72,0,1,0
5,313,313,35,14,21,4,3
3,386,386,104,4,100,3,2
4,497,497,38,16,22,3,2
1,498,498,71,22,49,2,1

5,114,114,22,22,0,1,0
9,191,191,7,7,0,1,0
7,199,199,6,6,0,1,0
0,200,200,8,8,0,1,0
11,212,212,20,20,0,1,0
8,230,230,58,58,0,1,0
10,294,294,55,9,46,3,2
2,296,296,1,1,0,1,0
6,370,370,6,6,0,1,0
3,381,381,47,24,23,2,1
4,382,382,72,22,50,3,2
1,469,469,26,17,9,4,3

9,112,112,4,4,0,1,0
6,223,223,18,9,9,2,1
0,262,262,103,87,16,3,2
5,269,269,3,3,0,1,0
7,394,394,65,65,0,1,0
1,426,426,48,4,44,2,1
2,464,464,15,9,6,2,1
3,474,474,30,30,0,1,0
4,479,479,20,10,10,2,1
8,499,499,136,109,27,2,1

3,174,174,6,6,0,1,0
9,236,236,12,8,4,2,1
7,237,237,11,11,0,1,0
8,266,266,29,29,0,1,0
4,302,302,9,4,5,2,1
10,336,336,67,53,14,2,1
5,344,344,7,7,0,1,0
0,388,388,121,91,30,3,2
6,391,391,73,73,0,1,0
2,413,413,26,26,0,1,0
1,490,490,80,80,0,1,0

1,141,141,18,5,13,2,1
6,178,178,10,1,9,2,1
11,178,178,44,12,32,3,2
12,179,179,12,12,0,1,0
3,209,209,6,1,5,2,1
10,212,212,5,5,0,1,0
5,238,238,5,5,0,1,0
7,297,297,8,8,0,1,0
9,328,328,18,18,0,1,0
4,346,346,51,51,0,1,0
2,360,360,60,49,11,2,1
8,364,364,71,71,0,1,0
0,378,378,10,3,7,2,1
13,396,396,11,1,10,2,1

7,104,104,5,2,3,2,1
8,109,109,4,4,0,1,0
9,120,120,3,3,0,1,0
1,134,134,1,1,0,1,0
3,340,340,5,1,4,2,1
2,347,347,80,22,58,3,2
5,394,394,13,13,0,1,0
6,404,404,179,101,78,4,3
4,414,414,15,15,0,1,0
0,440,440,153,132,21,2,1

11,156,156,33,33,0,1,0
2,212,212,14,14,0,1,0
6,216,216,18,8,10,3,2
1,253,253,23,18,5,2,1
12,282,282,22,22,0,1,0
8,350,350,2,2,0,1,0
10,366,366,7,7,0,1,0
4,372,372,31,31,0,1,0
5,394,394,38,38,0,1,0
3,440,440,7,2,5,2,1
0,454,454,75,75,0,1,0
7,482,482,103,67,36,4,3
9,482,482,39,21,18,4,3

3,109,109,2,2,0,1,0
1,121,121,22,22,0,1,0
8,131,131,5,5,0,1,0
5,200,200,15,6,9,2,1
7,257,257,7,7,0,1,0
0,314,314,79,54,25,2,1
2,351,351,26,26,0,1,0
9,395,395,40,40,0,1,0
10,414,414,141,102,39,2,1
4,416,416,31,31,0,1,0
6,443,443,12,12,0,1,0

0,150,150,1,1,0,1,0
3,181,181,12,12,0,1,0
13,198,198,19,19,0,1,0
15,263,263,6,6,0,1,0
5,264,264,3,3,0,1,0
14,271,271,16,16,0,1,0
8,284,284,37,37,0,1,0
11,307,307,3,3,0,1,0
16,323,323,101,5,96,4,3
4,335,335,18,18,0,1,0
9,341,341,9,6,3,2,1
10,421,421,52,52,0,1,0
12,423,423,48,48,0,1,0
2,443,443,4,4,0,1,0
7,465,465,26,13,13,2,1
6,479,479,34,7,27,2,1
1,496,496,23,5,18,2,1

0,178,178,5,1,4,2,1
1,187,187,6,6,0,1,0
4,222,222,12,2,10,3,2
5,233,233,7,7,0,1,0
3,268,268,41,21,20,3,2
6,354,354,3,3,0,1,0
2,395,395,154,154,0,1,0
9,421,421,64,64,0,1,0
7,464,464,9,3,6,2,1
8,479,479,165,91,74,4,3

11,153,153,58,26,32,3,2
1,169,169,13,13,0,1,0
6,172,172,29,29,0,1,0
8,172,172,1,1,0,1,0
5,189,189,1,1,0,1,0
12,197,197,8,8,0,1,0
9,267,267,8,8,0,1,0
2,291,291,3,3,0,1,0
7,301,301,51,51,0,1,0
10,371,371,56,56,0,1,0
3,395,395,6,6,0,1,0
4,416,416,48,16,32,2,1
13,472,472,1,1,0,1,0
0,479,479,20,20,0,1,0

5,172,172,25,19,6,3,2
4,177,177,8,8,0,1,0
7,282,282,39,39,0,1,0
8,285,285,42,23,19,2,1
6,312,312,15,15,0,1,0
3,319,319,22,12,10,3,2
9,328,328,28,2,26,3,2
0,353,353,130,22,108,4,3
1,409,409,37,37,0,1,0
2,438,438,33,7,26,2,1

5,167,167,24,24,0,1,0
11,197,197,8,1,7,2,1
9,216,216,19,19,0,1,0
1,218,218,43,13,30,2,1
10,284,284,82,82,0,1,0
12,320,320,36,14,22,2,1
4,362,362,53,53,0,1,0
3,373,373,4,4,0,1,0
0,385,385,10,10,0,1,0
2,411,411,24,24,0,1,0
8,424,424,24,24,0,1,0
6,432,432,8,1,7,2,1
7,472,472,10,10,0,1,0

13,111,111,14,7,7,2,1
1,140,140,20,9,11,2,1
14,163,163,13,13,0,1,0
7,164,164,22,11,11,2,1
4,193,193,3,3,0,1,0
10,214,214,4,4,0,1,0
12,240,240,82,27,55,3,2
6,242,242,3,3,0,1,0
8,259,259,35,7,28,3,2
0,309,309,6,6,0,1,0
2,346,346,19,7,12,4,3
3,371,371,14,14,0,1,0
11,371,371,13,4,9,4,3
5,405,405,20,20,0,1,0
9,433,433,4,4,0,1,0

5,107,107,1,1,0,1,0
9,129,129,6,3,3,2,1
7,225,225,2,2,0,1,0
2,235,235,3,3,0,1,0
1,237,237,5,5,0,1,0
4,261,261,16,2,14,3,2
6,266,266,14,8,6,2,1
0,340,340,44,44,0,1,0
11,372,372,53,43,10,3,2
3,395,395,125,110,15,4,3
8,409,409,55,7,48,3,2
10,424,424,57,57,0,1,0
12,445,445,64,64,0,1,0

5,137,137,6,6,0,1,0
1,142,142,38,10,28,3,2
11,157,157,25,14,11,2,1
3,203,203,16,16,0,1,0
7,229,229,11,3,8,3,2
2,260,260,14,3,11,2,1
4,274,274,42,42,0,1,0
0,349,349,1,1,0,1,0
9,363,363,25,12,13,2,1
8,374,374,85,85,0,1,0
6,420,420,9,9,0,1,0
10,475,475,38,21,17,2,1

4,103,103,18,9,9,4,3
10,121,121,24,21,3,2,1
3,129,129,1,1,0,1,0
14,170,170,24,24,0,1,0
8,174,174,24,2,22,3,2
12,178,178,17,4,13,2,1
11,254,254,17,8,9,2,1
7,271,271,9,9,0,1,0
5,284,284,6,6,0,1,0
9,368,368,1,1,0,1,0
1,376,376,29,29,0,1,0
13,391,391,45,45,0,1,0
2,397,397,30,30,0,1,0
6,417,417,5,5,0,1,0
0,484,484,30,30,0,1,0

1,124,124,15,15,0,1,0
10,131,131,14,14,0,1,0
5,147,147,1,1,0,1,0
9,172,172,28,28,0,1,0
6,189,189,27,15,12,2,1
4,204,204,4,4,0,1,0
11,212,212,45,21,24,4,3
12,220,220,4,1,3,2,1
14,233,233,14,14,0,1,0
8,242,242,17,10,7,2,1
3,311,311,22,22,0,1,0
13,336,336,20,20,0,1,0
2,354,354,22,22,0,1,0
0,404,404,38,13,25,2,1
7,480,480,7,7,0,1,0

9,103,103,34,6,28,3,2
8,115,115,2,2,0,1,0
2,199,199,4,1,3,2,1
10,199,199,8,8,0,1,0
6,229,229,11,8,3,2,1
7,257,257,37,37,0,1,0
1,306,306,14,14,0,1,0
3,344,344,78,43,35,2,1
4,355,355,40,40,0,1,0
5,381,381,36,4,32,2,1
12,383,383,25,25,0,1,0
0,390,390,22,10,12,3,2
11,429,429,10,10,0,1,0

10,102,102,2,2,0,1,0
8,107,107,10,3,7,2,1
11,150,150,16,16,0,1,0
6,218,218,40,40,0,1,0
4,235,235,6,6,0,1,0
0,256,256,44,10,34,3,2
12,264,264,26,8,18,4,3
2,287,287,1,1,0,1,0
3,312,312,15,15,0,1,0
5,319,319,8,2,6,3,2
1,335,335,48,21,27,4,3
7,351,351,95,32,63,4,3
9,416,416,13,4,9,2,1

4,160,160,6,6,0,1,0
7,241,241,75,63,12,2,1
0,245,245,53,16,37,2,1
1,256,256,46,8,38,3,2
6,344,344,9,9,0,1,0
8,350,350,24,24,0,1,0
9,385,385,56,56,0,1,0
3,468,468,91,91,0,1,0
2,477,477,5,5,0,1,0
5,500,500,8,2,6,3,2

2,153,153,2,2,0,1,0
13,195,195,28,28,0,1,0
3,212,212,29,8,21,4,3
0,219,219,4,4,0,1,0
4,230,230,58,58,0,1,0
11,235,235,30,30,0,1,0
5,257,257,15,15,0,1,0
8,278,278,11,1,10,2,1
10,304,304,71,71,0,1,0
1,309,309,12,6,6,2,1
6,324,324,5,2,3,2,1
9,332,332,13,8,5,2,1
7,338,338,23,23,0,1,0
12,489,489,15,15,0,1,0

13,110,110,11,5,6,2,1
3,151,151,1,1,0,1,0
11,186,186,4,1,3,2,1
8,209,209,19,19,0,1,0
2,246,246,6,2,4,2,1
5,260,260,58,58,0,1,0
7,284,284,37,9,28,2,1
12,295,295,106,106,0,1,0
1,298,298,4,4,0,1,0
6,377,377,10,2,8,3,2
14,392,392,10,1,9,2,1
9,424,424,40,12,28,2,1
4,425,425,37,1,36,4,3
0,453,453,1,1,0,1,0
10,471,471,5,5,0,1,0

4,115,115,1,1,0,1,0
15,129,129,21,21,0,1,0
13,144,144,26,26,0,1,0
1,160,160,1,1,0,1,0
10,172,172,14,14,0,1,0
2,188,188,1,1,0,1,0
14,193,193,23,10,13,2,1
7,243,243,25,25,0,1,0
9,245,245,9,9,0,1,0
12,249,249,13,13,0,1,0
0,315,315,29,14,15,2,1
11,360,360,7,7,0,1,0
8,394,394,14,2,12,4,3
3,411,411,77,15,62,3,2
5,445,445,29,19,10,3,2
6,467,467,29,29,0,1,0

13,104,104,5,5,0,1,0
12,114,114,19,3,16,3,2
6,145,145,10,10,0,1,0
7,157,157,3,3,0,1,0
10,161,161,9,1,8,3,2
14,173,173,29,16,13,3,2
8,188,188,27,4,23,2,1
9,212,212,24,24,0,1,0
2,288,288,7,7,0,1,0
1,308,308,6,6,0,1,0
0,314,314,33,5,28,3,2
3,330,330,24,24,0,1,0
4,389,389,35,35,0,1,0
11,392,392,28,28,0,1,0
5,408,408,25,25,0,1,0

6,162,162,3,3,0,1,0
2,165,165,49,49,0,1,0
1,196,196,11,5,6,3,2
5,213,213,1,1,0,1,0
7,272,272,10,10,0,1,0
9,306,306,18,18,0,1,0
3,315,315,17,13,4,2,1
0,365,365,48,48,0,1,0
10,411,411,50,5,45,4,3
8,415,415,153,105,48,4,3
4,447,447,28,28,0,1,0

7,112,112,10,10,0,1,0
12,136,136,16,6,10,3,2
5,148,148,38,38,0,1,0
10,161,161,10,2,8,3,2
0,182,182,27,21,6,2,1
2,192,192,5,5,0,1,0
13,196,196,67,67,0,1,0
3,244,244,10,10,0,1,0
4,265,265,1,1,0,1,0
1,318,318,2,2,0,1,0
6,336,336,11,11,0,1,0
9,378,378,13,10,3,2,1
8,462,462,11,5,6,3,2
11,489,489,15,1,14,3,2

3,111,111,8,8,0,1,0
4,185,185,27,27,0,1,0
13,260,260,24,24,0,1,0
1,299,299,11,11,0,1,0
11,304,304,113,11,102,4,3
5,311,311,6,6,0,1,0
0,364,364,90,9,81,4,3
8,382,382,24,24,0,1,0
2,384,384,6,6,0,1,0
12,387,387,2,2,0,1,0
7,411,411,25,25,0,1,0
6,418,418,1,1,0,1,0
9,418,418,29,21,8,2,1
10,435,435,3,3,0,1,0

1,136,136,19,1,18,4,3
9,225,225,62,62,0,1,0
5,250,250,13,13,0,1,0
8,321,321,2,2,0,1,0
2,356,356,5,5,0,1,0
7,373,373,39,31,8,3,2
3,409,409,64,64,0,1,0
0,412,412,120,120,0,1,0
4,455,455,56,45,11,2,1
6,495,495,21,21,0,1,0

4,198,198,13,13,0,1,0
1,271,271,33,18,15,2,1
9,273,273,58,31,27,4,3
0,279,279,8,1,7,2,1
6,315,315,11,4,7,2,1
8,317,317,61,42,19,2,1
7,323,323,23,23,0,1,0
2,362,362,95,55,40,3,2
3,377,377,71,71,0,1,0
5,484,484,15,15,0,1,0

13,133,133,21,9,12,2,1
10,137,137,5,5,0,1,0
9,201,201,9,1,8,2,1
1,219,219,26,2,24,4,3
2,263,263,15,4,11,2,1
4,266,266,22,18,4,2,1
0,270,270,23,14,9,2,1
8,295,295,64,19,45,2,1
7,313,313,1,1,0,1,0
14,344,344,23,23,0,1,0
6,383,383,6,6,0,1,0
11,409,409,105,12,93,4,3
5,469,469,3,3,0,1,0
3,471,471,8,8,0,1,0
12,482,482,24,24,0,1,0

3,103,103,1,1,0,1,0
0,150,150,5,5,0,1,0
7,224,224,24,24,0,1,0
6,276,276,9,1,8,2,1
11,306,306,7,7,0,1,0
10,357,357,136,84,52,3,2
1,372,372,37,19,18,4,3
9,390,390,3,3,0,1,0
5,394,394,134,14,120,4,3
2,410,410,1,1,0,1,0
8,421,421,25,2,23,2,1
4,432,432,50,7,43,2,1

6,122,122,3,3,0,1,0
8,158,158,3,3,0,1,0
5,203,203,30,30,0,1,0
1,224,224,18,18,0,1,0
9,237,237,10,10,0,1,0
0,336,336,44,2,42,4,3
3,366,366,44,1,43,2,1
10,374,374,39,39,0,1,0
4,384,384,55,25,30,4,3
2,394,394,50,50,0,1,0
7,484,484,135,42,93,4,3

7,104,104,4,4,0,1,0
13,152,152,35,9,26,3,2
4,174,174,1,1,0,1,0
3,258,258,3,3,0,1,0
8,264,264,25,5,20,2,1
5,266,266,21,18,3,2,1
12,311,311,34,17,17,2,1
10,328,328,35,25,10,3,2
0,334,334,1,1,0,1,0
9,354,354,1,1,0,1,0
11,406,406,29,29,0,1,0
6,443,443,113,113,0,1,0
2,451,451,78,40,38,3,2
1,498,498,20,4,16,3,2

3,166,166,8,8,0,1,0
7,235,235,3,3,0,1,0
2,244,244,17,6,11,2,1
4,292,292,114,17,97,4,3
9,313,313,26,26,0,1,0
0,395,395,93,89,4,2,1
6,439,439,9,9,0,1,0
1,440,440,109,88,21,4,3
8,441,441,40,21,19,2,1
5,488,488,6,3,3,2,1

0,127,127,11,6,5,2,1
6,140,140,7,7,0,1,0
10,160,160,2,2,0,1,0
3,167,167,19,19,0,1,0
8,211,211,54,54,0,1,0
2,218,218,1,1,0,1,0
9,300,300,47,10,37,2,1
4,359,359,18,18,0,1,0
1,378,378,131,61,70,3,2
7,418,418,41,3,38,2,1
5,447,447,16,16,0,1,0

3,112,112,15,4,11,2,1
9,244,244,48,3,45,2,1
8,258,258,58,58,0,1,0
11,258,258,23,17,6,3,2
0,304,304,18,10,8,2,1
5,343,343,53,44,9,4,3
10,402,402,5,5,0,1,0
6,404,404,29,17,12,2,1
7,420,420,6,2,4,2,1
2,438,438,33,15,18,2,1
4,445,445,7,7,0,1,0
1,478,478,78,60,18,4,3

3,138,138,23,7,16,3,2
7,139,139,13,13,0,1,0
8,144,144,14,2,12,3,2
9,161,161,20,10,10,2,1
4,198,198,32,17,15,2,1
5,223,223,53,53,0,1,0
1,265,265,12,12,0,1,0
6,278,278,4,1,3,2,1
10,331,331,15,9,6,2,1
0,353,353,60,56,4,2,1
2,402,402,24,24,0,1,0

0,233,233,35,13,22,3,2
13,235,235,6,3,3,2,1
4,236,236,8,8,0,1,0
12,279,279,2,2,0,1,0
2,290,290,2,2,0,1,0
8,307,307,6,6,0,1,0
11,315,315,160,142,18,3,2
1,340,340,19,5,14,2,1
9,341,341,3,3,0,1,0
6,360,360,21,21,0,1,0
7,402,402,9,9,0,1,0
3,431,431,48,33,15,2,1
10,440,440,18,18,0,1,0
5,497,497,81,25,56,4,3

0,100,100,18,18,0,1,0
5,229,229,31,23,8,3,2
7,236,236,6,6,0,1,0
1,240,240,14,9,5,2,1
9,292,292,36,24,12,4,3
10,308,308,6,3,3,2,1
6,310,310,87,87,0,1,0
2,313,313,3,3,0,1,0
3,336,336,84,17,67,4,3
4,392,392,41,10,31,2,1
8,422,422,11,11,0,1,0

0,100,100,15,15,0,1,0
1,148,148,14,7,7,2,1
8,150,150,29,20,9,4,3
5,154,154,6,6,0,1,0
9,284,284,24,2,22,2,1
2,354,354,17,17,0,1,0
10,354,354,28,28,0,1,0
6,358,358,32,2,30,4,3
11,364,364,4,4,0,1,0
7,381,381,41,24,17,2,1
12,433,433,58,28,30,2,1
4,475,475,59,59,0,1,0
3,489,489,28,28,0,1,0

4,109,109,15,15,0,1,0
3,120,120,1,1,0,1,0
9,122,122,22,9,13,2,1
1,148,148,9,9,0,1,0
13,165,165,7,7,0,1,0
0,172,172,7,7,0,1,0
11,222,222,19,3,16,3,2
2,236,236,30,30,0,1,0
5,236,236,8,1,7,2,1
7,258,258,44,44,0,1,0
8,304,304,26,26,0,1,0
6,449,449,10,10,0,1,0
10,462,462,67,67,0,1,0
12,473,473,33,6,27,2,1

8,126,126,3,3,0,1,0
0,146,146,16,13,3,2,1
6,215,215,7,7,0,1,0
3,227,227,7,2,5,2,1
9,249,249,55,45,10,2,1
5,318,318,1,1,0,1,0
7,385,385,36,36,0,1,0
4,393,393,28,28,0,1,0
1,436,436,149,122,27,2,1
10,472,472,110,98,12,3,2
2,476,476,23,23,0,1,0

9,148,148,8,8,0,1,0
6,175,175,24,12,12,3,2
3,182,182,8,8,0,1,0
11,221,221,15,15,0,1,0
7,314,314,20,20,0,1,0
8,367,367,84,34,50,2,1
10,369,369,22,6,16,2,1
5,372,372,33,15,18,4,3
4,390,390,30,2,28,3,2
0,419,419,10,10,0,1,0
2,460,460,130,130,0,1,0
1,488,488,41,41,0,1,0

1,121,121,6,6,0,1,0
4,132,132,1,1,0,1,0
5,134,134,11,11,0,1,0
11,155,155,21,21,0,1,0
7,259,259,7,3,4,2,1
0,334,334,17,17,0,1,0
8,344,344,49,24,25,2,1
10,391,391,18,18,0,1,0
3,437,437,9,3,6,2,1
2,444,444,173,173,0,1,0
6,458,458,84,18,66,4,3
9,468,468,33,33,0,1,0

8,117,117,25,25,0,1,0
0,129,129,7,4,3,2,1
11,133,133,3,3,0,1,0
3,160,160,23,9,14,3,2
7,198,198,1,1,0,1,0
13,198,198,51,51,0,1,0
9,205,205,8,8,0,1,0
4,210,210,5,5,0,1,0
1,238,238,17,17,0,1,0
6,249,249,1,1,0,1,0
2,319,319,2,2,0,1,0
12,407,407,42,42,0,1,0
10,448,448,10,3,7,2,1
14,480,480,83,13,70,3,2
5,488,488,39,39,0,1,0

15,151,151,15,15,0,1,0
3,159,159,8,8,0,1,0
12,164,164,3,3,0,1,0
9,243,243,24,24,0,1,0
11,267,267,49,49,0,1,0
6,270,270,21,2,19,2,1
14,284,284,5,5,0,1,0
1,290,290,1,1,0,1,0
10,293,293,16,16,0,1,0
5,349,349,17,17,0,1,0
8,358,358,31,11,20,2,1
7,379,379,5,5,0,1,0
0,406,406,20,20,0,1,0
13,425,425,72,27,45,2,1
2,431,431,46,12,34,2,1
16,434,434,53,3,50,3,2
4,470,470,5,5,0,1,0

0,126,126,7,7,0,1,0
3,135,135,31,13,18,3,2
4,157,157,2,2,0,1,0
6,263,263,8,8,0,1,0
10,302,302,16,16,0,1,0
5,332,332,17,17,0,1,0
1,334,334,10,10,0,1,0
12,337,337,44,44,0,1,0
13,349,349,3,3,0,1,0
16,388,388,28,28,0,1,0
14,428,428,84,56,28,2,1
2,445,445,14,14,0,1,0
11,458,458,70,70,0,1,0
15,464,464,22,22,0,1,0
8,466,466,41,5,36,2,1
7,488,488,8,4,4,2,1
9,494,494,1,1,0,1,0

13,140,140,28,28,0,1,0
12,150,150,2,2,0,1,0
5,165,165,1,1,0,1,0
0,200,200,7,4,3,2,1
11,260,260,14,5,9,2,1
3,264,264,10,7,3,2,1
8,313,313,103,28,75,4,3
6,325,325,26,2,24,4,3
4,330,330,42,39,3,2,1
9,377,377,7,7,0,1,0
1,391,391,24,13,11,2,1
2,398,398,46,46,0,1,0
10,427,427,2,2,0,1,0
7,453,453,62,47,15,4,3

3,133,133,2,2,0,1,0
5,165,165,6,1,5,2,1
12,185,185,8,5,3,2,1
6,187,187,4,4,0,1,0
10,188,188,1,1,0,1,0
1,193,193,7,1,6,3,2
11,203,203,27,21,6,2,1
13,238,238,8,3,5,2,1
9,291,291,7,4,3,2,1
14,293,293,28,11,17,4,3
17,312,312,35,20,15,4,3
8,368,368,76,13,63,3,2
7,368,368,1,1,0,1,0
0,378,378,24,1,23,2,1
15,378,378,68,41,27,2,1
2,404,404,22,22,0,1,0
4,431,431,1,1,0,1,0
16,493,493,72,72,0,1,0

0,111,111,1,1,0,1,0
2,130,130,3,3,0,1,0
9,131,131,43,43,0,1,0
10,156,156,19,7,12,4,3
13,178,178,5,5,0,1,0
4,182,182,11,11,0,1,0
8,224,224,21,6,15,2,1
1,248,248,29,8,21,2,1
11,279,279,7,7,0,1,0
5,312,312,65,20,45,2,1
6,327,327,20,4,16,2,1
7,344,344,36,36,0,1,0
12,406,406,6,6,0,1,0
3,434,434,8,8,0,1,0

14,113,113,13,13,0,1,0
6,166,166,12,3,9,2,1
10,178,178,39,2,37,2,1
7,236,236,9,9,0,1,0
3,260,260,4,4,0,1,0
12,274,274,11,11,0,1,0
5,297,297,38,10,28,2,1
4,303,303,22,9,13,2,1
2,305,305,7,3,4,2,1
13,339,339,68,19,49,2,1
1,399,399,28,28,0,1,0
8,458,458,11,3,8,3,2
11,462,462,9,1,8,2,1
9,479,479,5,2,3,2,1
0,480,480,76,76,0,1,0

0,220,220,2,2,0,1,0
8,244,244,57,28,29,2,1
2,250,250,8,8,0,1,0
3,266,266,5,5,0,1,0
12,292,292,50,50,0,1,0
10,314,314,18,18,0,1,0
6,362,362,38,4,34,3,2
11,367,367,21,5,16,3,2
5,381,381,32,3,29,4,3
1,415,415,137,65,72,3,2
4,419,419,9,3,6,3,2
7,431,431,34,34,0,1,0
9,433,433,4,4,0,1,0

6,187,187,26,26,0,1,0
10,210,210,25,21,4,2,1
4,216,216,31,31,0,1,0
3,247,247,44,4,40,4,3
2,282,282,41,4,37,3,2
1,294,294,21,21,0,1,0
5,296,296,7,1,6,3,2
8,300,300,51,2,49,2,1
9,377,377,29,3,26,4,3
7,402,402,35,19,16,2,1
0,500,500,31,4,27,4,3

8,128,128,12,12,0,1,0
4,227,227,38,38,0,1,0
2,280,280,66,30,36,4,3
0,293,293,18,18,0,1,0
5,294,294,3,3,0,1,0
1,322,322,9,1,8,3,2
10,341,341,23,15,8,2,1
9,358,358,45,6,39,4,3
3,376,376,42,42,0,1,0
6,452,452,66,66,0,1,0
7,464,464,78,20,58,4,3

5,116,116,9,9,0,1,0
6,124,124,4,4,0,1,0
2,126,126,1,1,0,1,0
11,170,170,7,7,0,1,0
0,210,210,26,26,0,1,0
9,264,264,5,5,0,1,0
10,286,286,2,2,0,1,0
3,297,297,41,41,0,1,0
8,358,358,10,10,0,1,0
4,401,401,85,85,0,1,0
7,410,410,117,102,15,4,3
12,444,444,103,74,29,2,1
1,468,468,4,4,0,1,0

11,104,104,4,4,0,1,0
4,132,132,18,18,0,1,0
13,152,152,23,23,0,1,0
3,156,156,5,5,0,1,0
9,225,225,43,37,6,2,1
8,228,228,4,4,0,1,0
5,383,383,106,106,0,1,0
1,388,388,1,1,0,1,0
12,410,410,82,18,64,3,2
7,429,429,28,28,0,1,0
0,434,434,21,21,0,1,0
2,441,441,1,1,0,1,0
10,450,450,7,3,4,2,1
6,460,460,17,17,0,1,0

1,113,113,7,3,4,2,1
3,135,135,2,2,0,1,0
0,143,143,19,19,0,1,0
5,210,210,26,8,18,4,3
7,304,304,96,70,26,3,2
9,346,346,12,12,0,1,0
8,357,357,22,22,0,1,0
6,438,438,23,6,17,2,1
4,441,441,114,108,6,2,1
10,472,472,10,2,8,2,1
2,500,500,67,42,25,2,1

5,146,146,10,10,0,1,0
16,168,168,16,7,9,2,1
0,173,173,1,1,0,1,0
14,208,208,31,15,16,2,1
3,239,239,44,32,12,3,2
9,254,254,6,6,0,1,0
1,275,275,4,4,0,1,0
12,305,305,27,9,18,4,3
15,328,328,3,3,0,1,0
17,334,334,12,12,0,1,0
4,335,335,4,4,0,1,0
8,352,352,3,3,0,1,0
11,397,397,9,9,0,1,0
10,401,401,56,32,24,4,3
7,406,406,11,11,0,1,0
2,416,416,17,3,14,3,2
13,440,440,103,103,0,1,0
6,498,498,27,11,16,4,3

1,210,210,2,2,0,1,0
5,217,217,9,1,8,3,2
11,224,224,16,16,0,1,0
2,225,225,2,2,0,1,0
7,259,259,11,11,0,1,0
6,312,312,2,2,0,1,0
3,315,315,9,9,0,1,0
9,340,340,136,12,124,4,3
10,350,350,24,14,10,2,1
0,355,355,81,81,0,1,0
12,368,368,13,8,5,2,1
13,407,407,1,1,0,1,0
4,413,413,97,75,22,2,1
8,476,476,14,14,0,1,0

1,109,109,20,3,17,2,1
3,111,111,19,19,0,1,0
8,114,114,5,5,0,1,0
2,188,188,11,11,0,1,0
9,197,197,45,45,0,1,0
7,302,302,6,6,0,1,0
11,351,351,31,7,24,3,2
10,391,391,85,8,77,4,3
0,398,398,4,4,0,1,0
12,431,431,5,5,0,1,0
5,443,443,52,19,33,4,3
6,468,468,27,3,24,3,2
4,484,484,1,1,0,1,0

13,106,106,2,2,0,1,0
11,146,146,23,6,17,2,1
4,159,159,13,1,12,2,1
1,166,166,2,2,0,1,0
14,216,216,7,7,0,1,0
8,256,256,15,7,8,2,1
2,260,260,25,1,24,2,1
9,273,273,15,15,0,1,0
0,298,298,25,25,0,1,0
12,318,318,70,58,12,3,2
7,351,351,7,7,0,1,0
5,365,365,66,24,42,2,1
3,417,417,18,10,8,2,1
6,451,451,12,6,6,2,1
10,500,500,64,64,0,1,0

12,113,113,5,5,0,1,0
13,125,125,8,4,4,2,1
11,134,134,1,1,0,1,0
10,146,146,22,22,0,1,0
2,175,175,6,6,0,1,0
4,228,228,22,22,0,1,0
6,255,255,37,37,0,1,0
14,291,291,58,25,33,4,3
0,311,311,9,4,5,2,1
3,372,372,4,4,0,1,0
8,388,388,58,37,21,2,1
15,401,401,62,16,46,2,1
9,427,427,35,21,14,2,1
5,446,446,10,10,0,1,0
1,476,476,1,1,0,1,0
7,476,476,14,7,7,2,1

6,208,208,26,4,22,3,2
3,240,240,50,23,27,4,3
1,249,249,62,50,12,3,2
7,255,255,7,3,4,2,1
2,261,261,57,57,0,1,0
4,314,314,18,18,0,1,0
0,337,337,45,27,18,3,2
8,365,365,20,20,0,1,0
5,492,492,70,70,0,1,0

11,119,119,6,6,0,1,0
5,132,132,9,9,0,1,0
12,134,134,21,15,6,2,1
6,141,141,2,2,0,1,0
14,144,144,20,3,17,4,3
8,145,145,2,2,0,1,0
13,183,183,26,3,23,3,2
4,190,190,26,11,15,2,1
9,210,210,14,5,9,4,3
7,245,245,20,20,0,1,0
3,264,264,6,6,0,1,0
1,315,315,18,18,0,1,0
2,341,341,38,14,24,4,3
10,364,364,23,23,0,1,0
0,386,386,37,37,0,1,0

11,119,119,9,4,5,2,1
10,128,128,2,2,0,1,0
0,152,152,11,11,0,1,0
5,171,171,7,4,3,2,1
6,345,345,41,41,0,1,0
4,355,355,1,1,0,1,0
9,360,360,54,54,0,1,0
2,370,370,98,32,66,3,2
7,381,381,27,12,15,2,1
12,386,386,48,40,8,3,2
1,387,387,18,18,0,1,0
8,404,404,69,2,67,4,3
3,492,492,27,27,0,1,0

5,116,116,2,2,0,1,0
15,123,123,17,5,12,4,3
7,131,131,22,22,0,1,0
0,169,169,10,1,9,2,1
1,177,177,3,3,0,1,0
9,200,200,1,1,0,1,0
13,228,228,49,49,0,1,0
4,234,234,4,4,0,1,0
11,299,299,14,14,0,1,0
17,314,314,2,2,0,1,0
16,321,321,28,28,0,1,0
6,355,355,18,9,9,2,1
8,396,396,1,1,0,1,0
14,397,397,58,58,0,1,0
12,420,420,8,2,6,3,2
3,428,428,27,27,0,1,0
10,432,432,46,46,0,1,0
2,481,481,23,23,0,1,0

2,204,204,14,8,6,3,2
0,244,244,26,13,13,2,1
3,308,308,1,1,0,1,0
6,342,342,14,14,0,1,0
8,369,369,57,25,32,4,3
5,391,391,10,10,0,1,0
4,418,418,7,7,0,1,0
10,430,430,17,17,0,1,0
7,431,431,54,54,0,1,0
1,465,465,189,173,16,2,1
9,473,473,106,64,42,2,1

