7,100,100,2,2,0,1,0
18,101,101,5,5,0,1,0
3,118,118,7,7,0,1,0
16,128,128,49,49,0,1,0
6,162,162,12,1,11,4,3
9,177,177,21,21,0,1,0
5,200,200,1,1,0,1,0
0,223,223,20,3,17,2,1
13,225,225,15,15,0,1,0
11,231,231,9,9,0,1,0
20,252,252,14,7,7,2,1
19,273,273,3,3,0,1,0
15,284,284,11,11,0,1,0
4,328,328,72,32,40,3,2
1,337,337,22,4,18,2,1
12,370,370,52,7,45,4,3
10,423,423,51,51,0,1,0
2,445,445,6,6,0,1,0
17,484,484,4,4,0,1,0
8,491,491,38,38,0,1,0
14,496,496,87,15,72,4,3

9,137,137,41,36,5,2,1
7,203,203,7,7,0,1,0
0,218,218,88,88,0,1,0
1,244,244,104,104,0,1,0
8,301,301,17,17,0,1,0
11,305,305,31,31,0,1,0
2,319,319,23,23,0,1,0
10,343,343,32,32,0,1,0
6,359,359,3,3,0,1,0
3,421,421,19,5,14,3,2
4,439,439,4,4,0,1,0
5,470,470,123,75,48,4,3

6,102,102,3,3,0,1,0
2,165,165,7,2,5,2,1
1,202,202,6,6,0,1,0
19,214,214,26,10,16,3,2
4,260,260,102,77,25,3,2
16,315,315,40,40,0,1,0
0,316,316,18,18,0,1,0
8,321,321,20,20,0,1,0
3,336,336,9,3,6,2,1
15,348,348,11,8,3,2,1
7,358,358,50,50,0,1,0
18,361,361,5,5,0,1,0
9,364,364,14,14,0,1,0
11,380,380,12,5,7,3,2
20,409,409,37,12,25,2,1
5,414,414,4,4,0,1,0
10,415,415,9,1,8,3,2
12,432,432,9,9,0,1,0
13,486,486,128,78,50,4,3
14,488,488,107,107,0,1,0
21,492,492,3,3,0,1,0
17,498,498,17,1,16,3,2

7,113,113,5,5,0,1,0
16,126,126,36,13,23,2,1
5,142,142,3,3,0,1,0
9,163,163,12,12,0,1,0
11,171,171,32,8,24,4,3
13,186,186,1,1,0,1,0
10,258,258,10,10,0,1,0
14,272,272,4,4,0,1,0
6,310,310,126,126,0,1,0
17,318,318,8,8,0,1,0
2,332,332,24,24,0,1,0
0,353,353,8,8,0,1,0
12,371,371,74,30,44,4,3
18,373,373,21,4,17,2,1
8,373,373,13,13,0,1,0
1,450,450,36,2,34,3,2
15,455,455,52,52,0,1,0
4,467,467,67,67,0,1,0
3,477,477,3,3,0,1,0

9,134,134,4,4,0,1,0
11,152,152,37,25,12,3,2
7,171,171,4,4,0,1,0
3,213,213,14,14,0,1,0
12,214,214,3,3,0,1,0
8,229,229,33,13,20,4,3
14,271,271,19,19,0,1,0
5,290,290,21,16,5,2,1
10,306,306,58,52,6,2,1
13,336,336,33,33,0,1,0
15,343,343,36,24,12,2,1
1,401,401,24,24,0,1,0
4,404,404,118,21,97,4,3
2,421,421,109,109,0,1,0
6,450,450,62,8,54,3,2
0,469,469,7,1,6,2,1

7,110,110,6,6,0,1,0
17,113,113,15,1,14,4,3
19,123,123,11,3,8,2,1
21,153,153,5,5,0,1,0
8,161,161,39,13,26,2,1
3,172,172,13,5,8,2,1
18,218,218,1,1,0,1,0
0,225,225,1,1,0,1,0
15,233,233,4,4,0,1,0
9,236,236,2,2,0,1,0
12,240,240,22,5,17,2,1
4,253,253,12,9,3,2,1
22,261,261,33,33,0,1,0
20,268,268,6,6,0,1,0
1,274,274,33,5,28,2,1
11,298,298,13,13,0,1,0
6,359,359,12,8,4,2,1
5,388,388,29,29,0,1,0
2,421,421,6,6,0,1,0
10,430,430,26,26,0,1,0
16,465,465,38,38,0,1,0
14,476,476,200,171,29,2,1
13,485,485,14,14,0,1,0

15,117,117,3,3,0,1,0
8,118,118,36,6,30,4,3
3,126,126,8,4,4,2,1
5,209,209,45,45,0,1,0
1,225,225,8,8,0,1,0
4,254,254,15,9,6,2,1
12,275,275,6,2,4,2,1
10,297,297,51,51,0,1,0
7,312,312,91,73,18,4,3
11,318,318,13,6,7,3,2
16,321,321,3,3,0,1,0
9,361,361,68,27,41,2,1
2,369,369,36,36,0,1,0
0,395,395,3,3,0,1,0
14,414,414,29,29,0,1,0
13,435,435,41,12,29,2,1
6,438,438,58,49,9,4,3

5,144,144,47,23,24,2,1
12,172,172,21,21,0,1,0
8,209,209,13,13,0,1,0
2,234,234,52,47,5,2,1
7,268,268,15,15,0,1,0
1,273,273,5,5,0,1,0
6,320,320,9,3,6,2,1
0,326,326,89,43,46,3,2
14,350,350,2,2,0,1,0
10,364,364,25,25,0,1,0
11,406,406,1,1,0,1,0
15,437,437,55,55,0,1,0
3,441,441,1,1,0,1,0
9,442,442,98,45,53,3,2
13,448,448,111,102,9,4,3
4,470,470,14,14,0,1,0

2,153,153,1,1,0,1,0
3,163,163,10,10,0,1,0
12,199,199,37,10,27,2,1
9,225,225,5,5,0,1,0
7,234,234,9,1,8,2,1
10,241,241,33,17,16,2,1
15,279,279,15,10,5,2,1
6,310,310,72,46,26,2,1
14,310,310,20,20,0,1,0
5,330,330,19,4,15,4,3
4,346,346,177,177,0,1,0
11,352,352,26,26,0,1,0
1,419,419,3,3,0,1,0
8,426,426,97,91,6,2,1
0,442,442,11,11,0,1,0
13,465,465,53,53,0,1,0

9,107,107,2,2,0,1,0
19,131,131,1,1,0,1,0
14,131,131,22,22,0,1,0
0,158,158,1,1,0,1,0
3,165,165,15,3,12,2,1
2,165,165,9,6,3,2,1
10,171,171,3,3,0,1,0
11,196,196,9,5,4,2,1
18,202,202,39,39,0,1,0
15,215,215,31,6,25,4,3
17,225,225,16,16,0,1,0
13,256,256,53,2,51,4,3
16,299,299,6,6,0,1,0
5,312,312,12,12,0,1,0
7,345,345,11,11,0,1,0
4,356,356,59,17,42,4,3
6,379,379,44,44,0,1,0
12,400,400,24,24,0,1,0
8,453,453,13,7,6,3,2
1,464,464,154,20,134,4,3

11,101,101,2,2,0,1,0
17,115,115,11,11,0,1,0
3,146,146,8,1,7,2,1
8,207,207,7,7,0,1,0
1,231,231,18,10,8,3,2
5,242,242,27,17,10,2,1
7,262,262,23,23,0,1,0
12,281,281,41,29,12,4,3
0,305,305,3,3,0,1,0
14,310,310,44,44,0,1,0
18,313,313,20,20,0,1,0
4,319,319,87,87,0,1,0
10,355,355,23,2,21,2,1
9,413,413,59,11,48,4,3
13,426,426,52,52,0,1,0
19,436,436,6,6,0,1,0
6,456,456,1,1,0,1,0
15,466,466,93,42,51,4,3
16,472,472,52,12,40,3,2
2,476,476,21,21,0,1,0

4,105,105,17,8,9,4,3
2,128,128,7,1,6,2,1
15,141,141,23,23,0,1,0
5,146,146,57,57,0,1,0
6,170,170,14,14,0,1,0
11,172,172,2,2,0,1,0
8,203,203,14,14,0,1,0
9,229,229,3,3,0,1,0
3,258,258,19,19,0,1,0
16,360,360,37,11,26,2,1
0,370,370,4,4,0,1,0
10,395,395,49,19,30,2,1
7,400,400,2,2,0,1,0
13,417,417,67,67,0,1,0
12,449,449,67,67,0,1,0
1,468,468,57,11,46,3,2
14,480,480,59,49,10,2,1

4,149,149,10,2,8,2,1
18,155,155,2,2,0,1,0
7,170,170,1,1,0,1,0
1,182,182,12,6,6,2,1
8,183,183,6,2,4,2,1
5,203,203,33,33,0,1,0
0,263,263,1,1,0,1,0
12,300,300,6,6,0,1,0
13,305,305,16,16,0,1,0
11,336,336,2,2,0,1,0
2,336,336,25,25,0,1,0
17,340,340,24,9,15,2,1
14,345,345,74,38,36,3,2
10,362,362,40,30,10,2,1
15,382,382,52,52,0,1,0
3,383,383,23,11,12,4,3
16,444,444,169,169,0,1,0
9,453,453,53,22,31,2,1
6,461,461,93,69,24,3,2
19,465,465,10,10,0,1,0

20,131,131,2,2,0,1,0
16,134,134,5,5,0,1,0
23,136,136,25,25,0,1,0
7,142,142,24,24,0,1,0
5,172,172,6,3,3,2,1
13,180,180,12,2,10,3,2
3,181,181,10,10,0,1,0
0,191,191,12,2,10,2,1
11,195,195,8,8,0,1,0
9,236,236,1,1,0,1,0
24,270,270,12,1,11,2,1
12,285,285,28,28,0,1,0
22,288,288,3,3,0,1,0
2,305,305,21,3,18,2,1
19,330,330,26,8,18,2,1
4,332,332,1,1,0,1,0
15,340,340,5,5,0,1,0
1,357,357,36,36,0,1,0
18,371,371,43,43,0,1,0
6,392,392,34,3,31,2,1
8,410,410,17,17,0,1,0
17,411,411,79,79,0,1,0
14,419,419,18,18,0,1,0
21,453,453,108,108,0,1,0
10,468,468,5,5,0,1,0

7,124,124,2,2,0,1,0
5,138,138,1,1,0,1,0
18,142,142,2,2,0,1,0
8,154,154,24,6,18,3,2
4,197,197,3,3,0,1,0
3,200,200,19,19,0,1,0
10,236,236,16,16,0,1,0
2,270,270,6,6,0,1,0
16,276,276,25,8,17,2,1
17,284,284,4,4,0,1,0
9,294,294,35,35,0,1,0
19,305,305,27,15,12,4,3
13,311,311,20,20,0,1,0
6,319,319,13,8,5,2,1
14,348,348,94,55,39,3,2
12,349,349,42,42,0,1,0
0,397,397,32,2,30,3,2
21,411,411,1,1,0,1,0
20,441,441,155,57,98,4,3
11,466,466,34,1,33,2,1
15,479,479,8,2,6,2,1
1,492,492,43,43,0,1,0

0,103,103,27,14,13,2,1
7,118,118,3,3,0,1,0
17,118,118,7,1,6,3,2
3,153,153,9,9,0,1,0
1,185,185,4,4,0,1,0
4,198,198,23,11,12,4,3
5,198,198,14,14,0,1,0
16,207,207,24,15,9,2,1
2,225,225,1,1,0,1,0
6,243,243,18,1,17,4,3
11,283,283,15,1,14,2,1
12,343,343,99,73,26,2,1
13,368,368,15,15,0,1,0
9,369,369,90,90,0,1,0
18,406,406,30,30,0,1,0
15,442,442,93,30,63,3,2
10,469,469,5,2,3,2,1
8,474,474,12,12,0,1,0
14,487,487,34,19,15,4,3

6,102,102,3,3,0,1,0
3,117,117,4,4,0,1,0
14,150,150,3,3,0,1,0
8,153,153,16,6,10,2,1
10,211,211,55,3,52,3,2
7,233,233,68,38,30,3,2
16,254,254,8,8,0,1,0
9,255,255,8,8,0,1,0
12,268,268,36,36,0,1,0
1,285,285,33,33,0,1,0
5,315,315,46,33,13,2,1
4,325,325,48,36,12,3,2
17,340,340,7,7,0,1,0
0,345,345,3,3,0,1,0
15,397,397,30,8,22,2,1
13,421,421,74,10,64,3,2
2,466,466,13,5,8,3,2
11,489,489,82,82,0,1,0

2,111,111,11,11,0,1,0
15,112,112,4,4,0,1,0
21,119,119,29,16,13,2,1
20,136,136,2,2,0,1,0
16,158,158,10,10,0,1,0
13,162,162,55,55,0,1,0
14,166,166,9,1,8,3,2
5,167,167,1,1,0,1,0
6,230,230,10,10,0,1,0
4,233,233,7,7,0,1,0
7,239,239,5,5,0,1,0
3,244,244,31,18,13,2,1
10,252,252,44,44,0,1,0
9,279,279,5,2,3,2,1
18,308,308,39,19,20,3,2
1,355,355,9,1,8,2,1
0,375,375,32,11,21,4,3
11,378,378,18,18,0,1,0
12,392,392,29,3,26,3,2
17,419,419,11,11,0,1,0
19,459,459,11,11,0,1,0
8,497,497,74,74,0,1,0

12,105,105,1,1,0,1,0
16,166,166,18,4,14,3,2
3,221,221,5,1,4,2,1
5,237,237,20,7,13,2,1
7,268,268,8,2,6,3,2
4,277,277,3,3,0,1,0
15,290,290,8,8,0,1,0
20,293,293,6,6,0,1,0
18,297,297,3,3,0,1,0
21,301,301,57,40,17,3,2
19,310,310,106,23,83,4,3
17,325,325,9,6,3,2,1
6,344,344,22,10,12,4,3
2,365,365,58,36,22,3,2
14,370,370,46,23,23,2,1
10,375,375,1,1,0,1,0
8,383,383,63,63,0,1,0
0,385,385,5,5,0,1,0
22,397,397,26,26,0,1,0
9,407,407,1,1,0,1,0
11,410,410,29,11,18,4,3
13,425,425,101,101,0,1,0
1,430,430,13,4,9,4,3

14,107,107,13,13,0,1,0
10,115,115,8,8,0,1,0
8,116,116,7,7,0,1,0
16,136,136,9,9,0,1,0
15,151,151,18,18,0,1,0
13,158,158,5,5,0,1,0
11,173,173,41,11,30,4,3
4,176,176,1,1,0,1,0
9,195,195,9,1,8,3,2
3,220,220,3,3,0,1,0
18,229,229,17,8,9,2,1
1,268,268,12,6,6,3,2
5,272,272,48,42,6,3,2
7,284,284,1,1,0,1,0
0,285,285,38,38,0,1,0
17,308,308,19,19,0,1,0
12,381,381,59,8,51,4,3
6,449,449,102,102,0,1,0
2,491,491,93,60,33,2,1

16,102,102,1,1,0,1,0
6,126,126,2,2,0,1,0
0,129,129,42,27,15,2,1
1,175,175,6,6,0,1,0
9,180,180,27,12,15,4,3
5,211,211,8,8,0,1,0
12,217,217,58,41,17,2,1
7,219,219,3,3,0,1,0
4,221,221,20,10,10,2,1
11,232,232,5,2,3,2,1
14,291,291,2,2,0,1,0
8,314,314,1,1,0,1,0
20,376,376,42,8,34,3,2
17,378,378,57,57,0,1,0
13,409,409,22,16,6,3,2
10,413,413,62,36,26,2,1
15,423,423,27,1,26,3,2
18,427,427,73,73,0,1,0
3,469,469,18,9,9,2,1
19,489,489,37,37,0,1,0
2,495,495,11,1,10,2,1

14,103,103,22,22,0,1,0
10,109,109,8,8,0,1,0
16,127,127,1,1,0,1,0
19,138,138,33,33,0,1,0
6,182,182,5,5,0,1,0
21,194,194,41,41,0,1,0
22,218,218,10,10,0,1,0
23,256,256,3,3,0,1,0
12,294,294,12,12,0,1,0
2,298,298,1,1,0,1,0
13,300,300,8,8,0,1,0
7,343,343,12,12,0,1,0
8,348,348,3,3,0,1,0
15,364,364,12,5,7,2,1
0,382,382,23,20,3,2,1
25,404,404,121,103,18,2,1
17,416,416,8,8,0,1,0
24,449,449,20,1,19,3,2
1,450,450,1,1,0,1,0
4,463,463,21,15,6,3,2
9,463,463,18,5,13,2,1
20,476,476,15,15,0,1,0
18,477,477,10,4,6,3,2
11,477,477,38,30,8,2,1
5,480,480,47,47,0,1,0
3,491,491,55,10,45,2,1

6,102,102,3,3,0,1,0
11,117,117,12,12,0,1,0
17,145,145,7,2,5,2,1
16,171,171,29,5,24,2,1
8,176,176,14,14,0,1,0
3,190,190,2,2,0,1,0
15,199,199,22,4,18,4,3
12,213,213,9,2,7,2,1
18,242,242,32,4,28,3,2
13,251,251,26,26,0,1,0
1,274,274,5,1,4,2,1
2,333,333,12,12,0,1,0
4,350,350,59,49,10,2,1
14,360,360,43,25,18,3,2
7,407,407,5,5,0,1,0
5,411,411,8,8,0,1,0
9,416,416,35,35,0,1,0
0,417,417,45,29,16,3,2
10,444,444,149,139,10,3,2
19,483,483,43,43,0,1,0

5,108,108,21,9,12,3,2
10,138,138,2,2,0,1,0
2,152,152,14,14,0,1,0
15,157,157,1,1,0,1,0
6,197,197,19,14,5,2,1
14,200,200,2,2,0,1,0
7,210,210,2,2,0,1,0
16,227,227,13,13,0,1,0
0,242,242,31,31,0,1,0
8,273,273,48,48,0,1,0
3,297,297,7,7,0,1,0
9,383,383,113,17,96,4,3
1,405,405,107,71,36,2,1
12,421,421,18,1,17,4,3
11,422,422,128,128,0,1,0
4,439,439,42,4,38,3,2
13,448,448,7,7,0,1,0

6,127,127,12,1,11,2,1
7,142,142,15,15,0,1,0
1,144,144,1,1,0,1,0
12,148,148,2,2,0,1,0
4,161,161,3,3,0,1,0
3,171,171,1,1,0,1,0
20,183,183,20,20,0,1,0
17,249,249,22,4,18,2,1
14,253,253,9,9,0,1,0
18,263,263,46,6,40,3,2
16,281,281,3,3,0,1,0
19,301,301,73,29,44,2,1
0,304,304,6,2,4,2,1
8,308,308,63,47,16,3,2
11,325,325,36,9,27,2,1
9,362,362,12,3,9,4,3
15,390,390,40,40,0,1,0
2,417,417,1,1,0,1,0
10,441,441,31,31,0,1,0
13,482,482,67,16,51,4,3
5,484,484,111,111,0,1,0

7,102,102,32,24,8,2,1
10,126,126,8,8,0,1,0
2,204,204,105,60,45,2,1
0,219,219,1,1,0,1,0
6,225,225,4,4,0,1,0
9,232,232,29,23,6,3,2
12,244,244,17,8,9,4,3
11,259,259,1,1,0,1,0
5,261,261,21,21,0,1,0
15,263,263,1,1,0,1,0
1,297,297,7,3,4,2,1
4,301,301,75,75,0,1,0
13,315,315,36,18,18,2,1
3,379,379,4,4,0,1,0
8,448,448,57,3,54,3,2
14,477,477,45,1,44,3,2

11,111,111,21,3,18,3,2
13,141,141,20,20,0,1,0
8,172,172,20,20,0,1,0
15,199,199,32,32,0,1,0
0,200,200,3,3,0,1,0
3,251,251,1,1,0,1,0
17,263,263,10,10,0,1,0
2,267,267,63,21,42,2,1
18,271,271,21,10,11,2,1
9,286,286,1,1,0,1,0
1,296,296,33,33,0,1,0
16,318,318,13,13,0,1,0
6,367,367,41,7,34,3,2
10,372,372,13,13,0,1,0
19,405,405,12,1,11,2,1
7,466,466,19,3,16,3,2
4,468,468,92,24,68,4,3
14,484,484,17,17,0,1,0
12,492,492,102,58,44,3,2
5,495,495,16,16,0,1,0

8,110,110,8,8,0,1,0
7,171,171,2,2,0,1,0
3,180,180,7,4,3,2,1
14,184,184,33,2,31,2,1
9,234,234,65,20,45,4,3
17,284,284,58,58,0,1,0
6,315,315,47,47,0,1,0
5,347,347,58,58,0,1,0
16,353,353,7,7,0,1,0
18,353,353,19,19,0,1,0
11,387,387,91,66,25,2,1
15,389,389,7,1,6,3,2
1,408,408,10,2,8,2,1
12,411,411,47,37,10,2,1
4,419,419,65,65,0,1,0
2,425,425,1,1,0,1,0
10,440,440,8,2,6,3,2
0,478,478,2,2,0,1,0
13,485,485,37,23,14,2,1

18,138,138,3,3,0,1,0
19,188,188,4,4,0,1,0
11,189,189,11,3,8,2,1
9,192,192,8,8,0,1,0
13,202,202,54,54,0,1,0
21,210,210,9,9,0,1,0
12,217,217,5,5,0,1,0
17,294,294,9,9,0,1,0
3,319,319,14,1,13,2,1
6,330,330,7,7,0,1,0
10,360,360,43,16,27,2,1
2,365,365,58,58,0,1,0
8,383,383,61,45,16,3,2
20,387,387,12,8,4,2,1
16,408,408,3,3,0,1,0
0,410,410,61,30,31,4,3
14,451,451,190,190,0,1,0
15,452,452,35,10,25,2,1
1,460,460,9,9,0,1,0
4,465,465,9,1,8,2,1
7,465,465,4,4,0,1,0
5,481,481,39,29,10,2,1

11,118,118,8,8,0,1,0
2,123,123,1,1,0,1,0
3,154,154,2,2,0,1,0
13,154,154,16,16,0,1,0
8,175,175,8,8,0,1,0
6,193,193,35,3,32,2,1
0,217,217,62,28,34,2,1
16,226,226,23,23,0,1,0
14,279,279,15,15,0,1,0
5,316,316,22,22,0,1,0
10,344,344,71,51,20,2,1
12,395,395,9,2,7,2,1
4,403,403,111,81,30,2,1
1,429,429,16,16,0,1,0
15,438,438,96,96,0,1,0
9,456,456,44,26,18,2,1
7,495,495,15,15,0,1,0

0,103,103,6,6,0,1,0
1,132,132,2,2,0,1,0
19,139,139,24,13,11,2,1
15,140,140,1,1,0,1,0
14,146,146,2,2,0,1,0
12,148,148,4,4,0,1,0
21,153,153,6,1,5,2,1
20,179,179,25,25,0,1,0
10,220,220,20,20,0,1,0
24,230,230,24,4,20,2,1
18,254,254,5,5,0,1,0
2,279,279,102,4,98,3,2
9,284,284,1,1,0,1,0
16,299,299,40,40,0,1,0
23,317,317,10,1,9,4,3
22,332,332,64,25,39,4,3
17,368,368,31,19,12,2,1
13,385,385,11,3,8,3,2
8,392,392,44,44,0,1,0
4,399,399,34,20,14,3,2
5,407,407,6,6,0,1,0
11,418,418,6,6,0,1,0
3,423,423,1,1,0,1,0
7,457,457,28,28,0,1,0
6,481,481,1,1,0,1,0

3,104,104,25,25,0,1,0
11,181,181,20,1,19,3,2
8,188,188,5,5,0,1,0
1,236,236,84,18,66,4,3
6,248,248,22,22,0,1,0
14,262,262,11,11,0,1,0
15,265,265,56,14,42,3,2
12,271,271,37,20,17,2,1
9,366,366,5,5,0,1,0
0,368,368,25,25,0,1,0
5,400,400,4,4,0,1,0
7,404,404,3,3,0,1,0
2,415,415,20,7,13,2,1
10,444,444,79,39,40,3,2
13,446,446,85,58,27,3,2
4,453,453,42,24,18,4,3

7,148,148,14,14,0,1,0
12,149,149,9,9,0,1,0
5,150,150,14,2,12,4,3
14,237,237,16,6,10,3,2
9,251,251,68,68,0,1,0
8,255,255,33,27,6,3,2
3,317,317,12,12,0,1,0
10,334,334,11,11,0,1,0
1,336,336,57,27,30,3,2
4,415,415,194,176,18,4,3
0,449,449,28,5,23,3,2
2,459,459,33,3,30,2,1
6,473,473,44,44,0,1,0
11,484,484,76,8,68,3,2
13,493,493,3,3,0,1,0

0,205,205,63,63,0,1,0
4,214,214,42,2,40,3,2
3,231,231,26,4,22,3,2
13,315,315,25,1,24,3,2
1,341,341,42,13,29,3,2
2,363,363,23,13,10,2,1
5,415,415,29,17,12,4,3
15,442,442,20,17,3,2,1
11,443,443,62,9,53,3,2
10,465,465,65,65,0,1,0
7,479,479,5,5,0,1,0
12,483,483,37,37,0,1,0
8,485,485,76,76,0,1,0
14,487,487,93,7,86,4,3
9,488,488,35,4,31,3,2
6,492,492,14,4,10,3,2

13,102,102,6,3,3,2,1
5,144,144,1,1,0,1,0
6,174,174,7,3,4,2,1
11,193,193,49,35,14,2,1
15,236,236,4,1,3,2,1
10,240,240,12,6,6,2,1
0,245,245,38,22,16,3,2
12,265,265,69,29,40,3,2
18,268,268,27,3,24,2,1
8,272,272,9,2,7,2,1
14,284,284,6,6,0,1,0
3,285,285,23,23,0,1,0
19,325,325,21,2,19,2,1
1,360,360,13,2,11,2,1
2,377,377,69,23,46,2,1
9,381,381,55,55,0,1,0
4,399,399,5,1,4,2,1
17,456,456,43,43,0,1,0
7,472,472,75,33,42,4,3
16,485,485,24,24,0,1,0

7,116,116,42,8,34,2,1
5,131,131,7,7,0,1,0
8,135,135,18,18,0,1,0
6,137,137,22,4,18,3,2
11,151,151,19,19,0,1,0
0,235,235,1,1,0,1,0
9,239,239,7,3,4,2,1
12,240,240,35,1,34,3,2
2,262,262,7,4,3,2,1
16,288,288,4,4,0,1,0
4,292,292,7,4,3,2,1
15,351,351,66,9,57,3,2
1,366,366,17,2,15,4,3
13,417,417,91,72,19,2,1
14,420,420,43,43,0,1,0
10,431,431,5,5,0,1,0
17,458,458,38,38,0,1,0
3,499,499,47,4,43,4,3

21,100,100,4,4,0,1,0
1,164,164,33,33,0,1,0
20,182,182,28,19,9,4,3
23,184,184,23,23,0,1,0
0,206,206,1,1,0,1,0
19,230,230,34,34,0,1,0
4,231,231,3,3,0,1,0
16,237,237,4,1,3,2,1
2,240,240,8,8,0,1,0
7,250,250,19,1,18,2,1
18,272,272,43,43,0,1,0
8,297,297,6,1,5,2,1
14,310,310,20,12,8,3,2
10,316,316,29,29,0,1,0
15,318,318,18,5,13,3,2
24,329,329,26,26,0,1,0
6,335,335,5,5,0,1,0
12,349,349,1,1,0,1,0
13,363,363,22,15,7,2,1
11,380,380,28,11,17,2,1
3,393,393,21,21,0,1,0
22,402,402,68,56,12,3,2
5,413,413,24,3,21,4,3
17,420,420,15,7,8,3,2
9,449,449,34,7,27,2,1

15,144,144,22,8,14,2,1
6,158,158,4,4,0,1,0
4,174,174,1,1,0,1,0
17,175,175,11,11,0,1,0
5,205,205,20,6,14,2,1
3,220,220,50,30,20,2,1
1,227,227,6,6,0,1,0
7,298,298,9,9,0,1,0
9,305,305,56,56,0,1,0
11,317,317,29,19,10,2,1
2,320,320,51,19,32,2,1
0,378,378,30,30,0,1,0
13,384,384,49,49,0,1,0
14,398,398,14,11,3,2,1
12,405,405,47,18,29,2,1
8,412,412,27,27,0,1,0
16,422,422,13,13,0,1,0
18,424,424,65,34,31,2,1
10,457,457,67,67,0,1,0

25,100,100,7,1,6,3,2
22,123,123,17,4,13,4,3
9,128,128,2,2,0,1,0
7,139,139,6,6,0,1,0
10,144,144,20,6,14,3,2
4,193,193,10,1,9,4,3
11,194,194,7,7,0,1,0
14,197,197,6,6,0,1,0
8,213,213,11,11,0,1,0
13,242,242,32,32,0,1,0
21,245,245,38,38,0,1,0
17,271,271,6,6,0,1,0
12,298,298,19,19,0,1,0
5,300,300,20,20,0,1,0
0,320,320,4,4,0,1,0
20,322,322,9,9,0,1,0
1,353,353,13,13,0,1,0
23,378,378,29,29,0,1,0
24,379,379,72,72,0,1,0
16,393,393,31,16,15,4,3
18,404,404,56,27,29,2,1
3,411,411,23,14,9,2,1
2,419,419,3,3,0,1,0
15,428,428,3,3,0,1,0
19,435,435,45,45,0,1,0
6,439,439,32,32,0,1,0

18,101,101,3,3,0,1,0
13,124,124,13,1,12,2,1
11,178,178,18,6,12,2,1
6,180,180,2,2,0,1,0
4,194,194,1,1,0,1,0
0,199,199,2,2,0,1,0
2,240,240,11,3,8,2,1
15,246,246,42,42,0,1,0
1,290,290,61,45,16,2,1
7,292,292,65,43,22,2,1
16,307,307,36,36,0,1,0
8,315,315,51,22,29,2,1
5,349,349,5,2,3,2,1
14,367,367,38,38,0,1,0
9,413,413,28,9,19,2,1
17,445,445,30,1,29,2,1
3,474,474,72,30,42,4,3
10,482,482,66,54,12,4,3
12,498,498,45,45,0,1,0

16,119,119,11,3,8,3,2
4,160,160,38,38,0,1,0
17,189,189,11,11,0,1,0
12,192,192,14,14,0,1,0
3,194,194,7,7,0,1,0
8,206,206,13,13,0,1,0
5,216,216,4,4,0,1,0
0,218,218,13,13,0,1,0
14,230,230,24,24,0,1,0
1,234,234,43,39,4,2,1
15,242,242,12,12,0,1,0
18,246,246,11,11,0,1,0
13,336,336,77,17,60,3,2
9,341,341,18,7,11,2,1
7,348,348,14,1,13,2,1
11,352,352,68,20,48,3,2
10,371,371,28,7,21,3,2
6,376,376,11,11,0,1,0
2,483,483,87,15,72,3,2

9,106,106,1,1,0,1,0
15,107,107,4,4,0,1,0
5,142,142,16,16,0,1,0
7,150,150,5,2,3,2,1
2,152,152,14,14,0,1,0
1,188,188,31,31,0,1,0
20,203,203,9,1,8,3,2
17,229,229,25,1,24,4,3
6,233,233,27,1,26,2,1
13,238,238,21,21,0,1,0
10,241,241,6,6,0,1,0
0,263,263,11,11,0,1,0
12,292,292,29,10,19,3,2
19,310,310,16,10,6,3,2
14,326,326,15,1,14,2,1
3,334,334,46,46,0,1,0
16,356,356,7,1,6,2,1
8,379,379,11,5,6,3,2
4,405,405,9,9,0,1,0
11,416,416,7,3,4,2,1
18,481,481,84,84,0,1,0
21,487,487,168,164,4,2,1

17,106,106,2,2,0,1,0
8,118,118,9,9,0,1,0
10,133,133,11,11,0,1,0
12,145,145,21,9,12,4,3
18,163,163,2,2,0,1,0
7,189,189,9,9,0,1,0
9,255,255,1,1,0,1,0
11,269,269,42,42,0,1,0
5,294,294,17,13,4,2,1
16,299,299,2,2,0,1,0
1,319,319,7,7,0,1,0
2,363,363,9,5,4,2,1
3,397,397,63,63,0,1,0
13,417,417,88,50,38,2,1
15,419,419,118,118,0,1,0
4,431,431,21,5,16,4,3
14,441,441,13,13,0,1,0
19,456,456,27,27,0,1,0
0,461,461,17,5,12,4,3
6,470,470,162,100,62,4,3

18,153,153,43,2,41,2,1
16,161,161,24,13,11,2,1
3,193,193,10,10,0,1,0
2,198,198,41,19,22,2,1
14,205,205,38,22,16,2,1
12,232,232,12,12,0,1,0
19,238,238,14,14,0,1,0
17,256,256,17,11,6,3,2
9,278,278,3,3,0,1,0
7,282,282,58,26,32,2,1
1,319,319,22,22,0,1,0
15,328,328,8,8,0,1,0
8,329,329,12,12,0,1,0
6,336,336,3,3,0,1,0
5,365,365,10,4,6,2,1
4,409,409,21,13,8,3,2
13,415,415,4,4,0,1,0
0,450,450,60,60,0,1,0
11,462,462,45,45,0,1,0
10,475,475,47,47,0,1,0

19,127,127,10,2,8,3,2
7,128,128,11,1,10,2,1
8,159,159,3,3,0,1,0
20,206,206,56,47,9,4,3
17,216,216,26,8,18,4,3
2,230,230,21,11,10,2,1
4,257,257,15,15,0,1,0
21,285,285,1,1,0,1,0
3,298,298,24,9,15,4,3
22,300,300,9,3,6,3,2
6,321,321,28,28,0,1,0
9,322,322,41,23,18,4,3
5,345,345,7,7,0,1,0
14,355,355,73,31,42,4,3
12,370,370,5,5,0,1,0
11,395,395,29,3,26,2,1
13,398,398,53,17,36,2,1
18,406,406,19,19,0,1,0
1,419,419,1,1,0,1,0
10,424,424,31,8,23,2,1
0,447,447,16,7,9,4,3
16,461,461,53,53,0,1,0
15,467,467,22,9,13,2,1

1,133,133,1,1,0,1,0
17,177,177,12,1,11,2,1
4,202,202,10,1,9,2,1
10,233,233,12,1,11,2,1
2,235,235,1,1,0,1,0
14,251,251,34,12,22,3,2
16,258,258,32,11,21,2,1
18,275,275,49,23,26,2,1
13,281,281,7,7,0,1,0
8,325,325,16,16,0,1,0
9,329,329,43,43,0,1,0
7,349,349,4,4,0,1,0
12,358,358,20,9,11,3,2
0,407,407,107,107,0,1,0
6,410,410,27,27,0,1,0
5,423,423,59,15,44,3,2
3,430,430,78,38,40,3,2
15,488,488,110,14,96,3,2
11,493,493,27,27,0,1,0

3,151,151,5,5,0,1,0
16,190,190,31,31,0,1,0
10,199,199,18,13,5,2,1
4,227,227,25,1,24,4,3
17,234,234,2,2,0,1,0
19,235,235,2,2,0,1,0
18,251,251,21,9,12,2,1
7,259,259,7,7,0,1,0
1,277,277,8,3,5,2,1
5,278,278,21,21,0,1,0
13,278,278,1,1,0,1,0
2,292,292,11,11,0,1,0
11,344,344,38,10,28,3,2
12,354,354,51,51,0,1,0
14,373,373,2,2,0,1,0
9,389,389,2,2,0,1,0
15,398,398,156,126,30,4,3
6,420,420,12,12,0,1,0
0,456,456,29,7,22,3,2
8,476,476,192,192,0,1,0

18,124,124,2,2,0,1,0
0,143,143,15,15,0,1,0
4,146,146,40,10,30,4,3
16,156,156,7,7,0,1,0
8,192,192,1,1,0,1,0
9,208,208,12,6,6,2,1
14,240,240,31,31,0,1,0
2,245,245,2,2,0,1,0
17,255,255,2,2,0,1,0
11,360,360,103,57,46,3,2
12,364,364,93,93,0,1,0
7,404,404,17,17,0,1,0
6,418,418,8,8,0,1,0
5,419,419,45,45,0,1,0
15,419,419,47,47,0,1,0
1,466,466,88,79,9,2,1
10,466,466,6,6,0,1,0
3,479,479,45,33,12,2,1
13,485,485,26,26,0,1,0

13,132,132,10,10,0,1,0
8,167,167,6,6,0,1,0
15,169,169,2,2,0,1,0
9,174,174,10,10,0,1,0
11,182,182,24,24,0,1,0
17,198,198,22,1,21,2,1
2,229,229,6,6,0,1,0
10,255,255,16,16,0,1,0
1,255,255,19,19,0,1,0
16,266,266,20,20,0,1,0
4,282,282,23,2,21,4,3
3,288,288,11,3,8,3,2
0,330,330,27,19,8,3,2
12,359,359,140,56,84,4,3
14,385,385,1,1,0,1,0
7,453,453,25,25,0,1,0
5,463,463,187,187,0,1,0
6,475,475,50,30,20,2,1

11,151,151,4,4,0,1,0
9,179,179,3,3,0,1,0
13,188,188,13,13,0,1,0
7,263,263,42,19,23,2,1
5,272,272,36,9,27,2,1
18,287,287,10,5,5,2,1
19,293,293,17,8,9,2,1
20,312,312,18,18,0,1,0
8,347,347,15,15,0,1,0
16,348,348,16,16,0,1,0
15,365,365,34,34,0,1,0
2,372,372,40,13,27,2,1
10,375,375,45,45,0,1,0
6,392,392,11,11,0,1,0
4,402,402,45,19,26,2,1
3,420,420,10,5,5,2,1
12,444,444,23,7,16,2,1
1,459,459,20,20,0,1,0
14,468,468,112,69,43,2,1
17,476,476,126,85,41,2,1
0,488,488,43,10,33,4,3

13,108,108,7,1,6,3,2
7,185,185,5,5,0,1,0
11,186,186,1,1,0,1,0
14,204,204,40,2,38,3,2
20,211,211,15,15,0,1,0
18,235,235,63,58,5,2,1
0,256,256,11,6,5,2,1
16,262,262,18,3,15,2,1
15,284,284,28,28,0,1,0
19,318,318,31,31,0,1,0
8,352,352,40,7,33,4,3
9,356,356,20,20,0,1,0
10,367,367,2,2,0,1,0
6,383,383,194,168,26,3,2
17,392,392,15,6,9,4,3
2,404,404,5,5,0,1,0
12,418,418,5,5,0,1,0
3,454,454,1,1,0,1,0
1,483,483,16,12,4,2,1
5,484,484,9,9,0,1,0
4,500,500,39,30,9,2,1

14,115,115,23,23,0,1,0
16,138,138,23,5,18,3,2
17,192,192,34,15,19,2,1
13,199,199,18,7,11,2,1
2,201,201,51,7,44,2,1
3,206,206,29,29,0,1,0
9,238,238,24,6,18,4,3
10,253,253,3,3,0,1,0
15,279,279,2,2,0,1,0
5,303,303,14,14,0,1,0
11,357,357,9,9,0,1,0
6,368,368,7,3,4,2,1
7,381,381,8,8,0,1,0
18,386,386,22,4,18,4,3
1,420,420,75,51,24,4,3
8,421,421,41,11,30,4,3
12,426,426,66,66,0,1,0
4,441,441,1,1,0,1,0
0,479,479,15,2,13,4,3
19,498,498,19,19,0,1,0

1,140,140,2,2,0,1,0
3,153,153,70,41,29,4,3
0,218,218,49,7,42,4,3
6,264,264,9,9,0,1,0
2,292,292,32,8,24,4,3
12,297,297,30,15,15,2,1
10,306,306,122,122,0,1,0
9,320,320,22,12,10,2,1
7,430,430,64,64,0,1,0
11,432,432,32,2,30,4,3
5,436,436,22,22,0,1,0
8,441,441,12,3,9,2,1
14,452,452,12,12,0,1,0
4,471,471,21,4,17,2,1
13,488,488,15,15,0,1,0

17,120,120,47,47,0,1,0
20,122,122,13,4,9,4,3
9,127,127,25,25,0,1,0
0,183,183,28,28,0,1,0
6,264,264,5,5,0,1,0
5,294,294,6,6,0,1,0
19,297,297,8,2,6,3,2
3,326,326,16,16,0,1,0
21,334,334,8,8,0,1,0
2,335,335,7,1,6,3,2
14,349,349,22,5,17,3,2
4,350,350,12,9,3,2,1
10,369,369,31,31,0,1,0
11,388,388,16,16,0,1,0
8,410,410,16,2,14,3,2
7,412,412,7,7,0,1,0
15,413,413,17,17,0,1,0
1,437,437,57,30,27,4,3
13,456,456,15,10,5,2,1
18,460,460,62,62,0,1,0
16,487,487,46,32,14,3,2
12,499,499,48,2,46,3,2

7,101,101,1,1,0,1,0
11,124,124,12,12,0,1,0
6,137,137,4,1,3,2,1
8,168,168,50,32,18,2,1
9,168,168,29,2,27,4,3
10,177,177,9,2,7,2,1
3,234,234,52,52,0,1,0
0,238,238,50,22,28,2,1
14,263,263,28,10,18,4,3
15,294,294,5,1,4,2,1
1,318,318,20,4,16,2,1
12,339,339,33,6,27,2,1
5,367,367,54,54,0,1,0
4,376,376,24,24,0,1,0
16,390,390,19,3,16,2,1
13,434,434,17,13,4,2,1
2,458,458,74,2,72,3,2

3,116,116,51,51,0,1,0
14,147,147,4,1,3,2,1
2,151,151,7,7,0,1,0
11,177,177,31,31,0,1,0
1,190,190,17,3,14,3,2
6,203,203,11,11,0,1,0
8,207,207,18,6,12,4,3
4,217,217,39,39,0,1,0
9,228,228,21,10,11,2,1
10,241,241,1,1,0,1,0
5,250,250,1,1,0,1,0
15,293,293,17,17,0,1,0
12,296,296,70,54,16,3,2
0,395,395,35,17,18,3,2
7,437,437,97,58,39,4,3
13,453,453,8,8,0,1,0

9,157,157,25,25,0,1,0
11,183,183,25,13,12,2,1
12,210,210,7,7,0,1,0
14,219,219,90,45,45,4,3
8,225,225,1,1,0,1,0
16,242,242,12,12,0,1,0
10,243,243,8,8,0,1,0
5,283,283,18,18,0,1,0
0,289,289,22,4,18,2,1
15,293,293,7,7,0,1,0
3,338,338,31,16,15,4,3
13,366,366,25,25,0,1,0
2,399,399,54,54,0,1,0
6,408,408,171,147,24,3,2
1,441,441,36,36,0,1,0
7,465,465,12,4,8,3,2
4,488,488,4,4,0,1,0

0,108,108,19,11,8,2,1
9,184,184,14,3,11,2,1
3,185,185,11,3,8,2,1
14,233,233,10,1,9,3,2
10,236,236,12,12,0,1,0
8,293,293,8,8,0,1,0
4,311,311,25,13,12,2,1
1,411,411,78,78,0,1,0
2,417,417,14,14,0,1,0
5,421,421,152,152,0,1,0
11,433,433,37,37,0,1,0
7,446,446,6,6,0,1,0
12,466,466,228,228,0,1,0
6,471,471,47,47,0,1,0
13,475,475,12,12,0,1,0

20,120,120,2,2,0,1,0
12,120,120,11,1,10,3,2
17,133,133,8,8,0,1,0
5,154,154,23,23,0,1,0
21,245,245,3,3,0,1,0
13,269,269,37,37,0,1,0
11,274,274,26,26,0,1,0
1,283,283,2,2,0,1,0
8,337,337,16,16,0,1,0
19,348,348,4,4,0,1,0
9,351,351,26,26,0,1,0
4,361,361,3,3,0,1,0
6,371,371,100,100,0,1,0
16,400,400,79,79,0,1,0
2,406,406,21,21,0,1,0
0,414,414,19,7,12,4,3
7,436,436,4,4,0,1,0
14,445,445,47,47,0,1,0
18,449,449,15,15,0,1,0
3,471,471,11,11,0,1,0
15,481,481,167,59,108,4,3
10,495,495,15,6,9,2,1

11,141,141,22,14,8,3,2
18,152,152,25,7,18,3,2
13,206,206,50,50,0,1,0
9,214,214,3,3,0,1,0
14,216,216,30,30,0,1,0
16,249,249,8,8,0,1,0
17,256,256,14,14,0,1,0
4,278,278,19,10,9,4,3
10,335,335,20,10,10,3,2
5,351,351,39,10,29,4,3
6,355,355,107,17,90,4,3
15,407,407,14,14,0,1,0
1,422,422,22,22,0,1,0
7,423,423,2,2,0,1,0
2,424,424,23,23,0,1,0
3,434,434,76,42,34,3,2
12,442,442,18,5,13,2,1
0,460,460,13,7,6,2,1
8,486,486,46,31,15,4,3

3,115,115,29,29,0,1,0
16,149,149,12,12,0,1,0
9,169,169,32,32,0,1,0
6,184,184,37,37,0,1,0
12,200,200,1,1,0,1,0
1,221,221,6,6,0,1,0
5,310,310,66,66,0,1,0
2,312,312,15,5,10,4,3
11,329,329,14,14,0,1,0
13,351,351,5,5,0,1,0
0,368,368,23,4,19,2,1
4,416,416,2,2,0,1,0
15,419,419,114,90,24,2,1
8,423,423,7,7,0,1,0
14,448,448,37,10,27,2,1
7,455,455,42,22,20,3,2
10,465,465,101,41,60,4,3

2,183,183,14,14,0,1,0
3,198,198,27,1,26,3,2
13,206,206,19,10,9,4,3
6,228,228,24,24,0,1,0
5,233,233,24,24,0,1,0
10,249,249,57,51,6,3,2
7,276,276,2,2,0,1,0
16,286,286,4,4,0,1,0
18,288,288,4,4,0,1,0
1,307,307,44,18,26,3,2
12,359,359,21,3,18,4,3
11,378,378,1,1,0,1,0
9,388,388,57,23,34,3,2
4,419,419,28,28,0,1,0
8,424,424,1,1,0,1,0
15,456,456,129,115,14,3,2
14,463,463,17,5,12,4,3
0,467,467,53,53,0,1,0
17,491,491,90,90,0,1,0

13,145,145,6,6,0,1,0
15,150,150,16,10,6,3,2
4,153,153,3,3,0,1,0
11,157,157,9,9,0,1,0
0,207,207,12,12,0,1,0
3,254,254,40,40,0,1,0
2,298,298,3,3,0,1,0
16,309,309,11,11,0,1,0
1,313,313,48,48,0,1,0
6,318,318,90,90,0,1,0
10,334,334,8,8,0,1,0
7,335,335,15,15,0,1,0
9,345,345,2,2,0,1,0
12,348,348,11,11,0,1,0
14,350,350,31,23,8,2,1
17,445,445,233,184,49,4,3
8,457,457,55,6,49,2,1
5,486,486,26,14,12,2,1

8,123,123,13,13,0,1,0
13,217,217,15,1,14,3,2
6,219,219,14,14,0,1,0
5,265,265,36,36,0,1,0
7,267,267,6,6,0,1,0
3,283,283,26,10,16,3,2
14,284,284,42,42,0,1,0
11,300,300,26,5,21,4,3
17,310,310,52,52,0,1,0
0,312,312,18,3,15,4,3
15,313,313,4,4,0,1,0
9,356,356,31,31,0,1,0
12,360,360,78,63,15,2,1
16,396,396,16,16,0,1,0
1,412,412,54,5,49,2,1
2,416,416,76,33,43,2,1
4,470,470,53,13,40,4,3
10,472,472,39,39,0,1,0

15,104,104,24,24,0,1,0
5,118,118,8,8,0,1,0
4,134,134,41,41,0,1,0
8,173,173,7,1,6,3,2
3,215,215,33,33,0,1,0
2,239,239,25,25,0,1,0
6,251,251,14,14,0,1,0
16,261,261,36,8,28,4,3
7,280,280,12,12,0,1,0
9,288,288,4,4,0,1,0
13,289,289,13,13,0,1,0
1,302,302,27,7,20,3,2
0,312,312,26,26,0,1,0
11,315,315,31,31,0,1,0
14,380,380,35,13,22,3,2
12,392,392,82,77,5,2,1
10,429,429,20,16,4,2,1

11,103,103,21,11,10,3,2
1,153,153,60,21,39,2,1
6,161,161,3,3,0,1,0
4,209,209,1,1,0,1,0
7,219,219,33,33,0,1,0
10,265,265,7,7,0,1,0
8,292,292,48,42,6,2,1
0,300,300,9,9,0,1,0
9,381,381,66,3,63,3,2
2,432,432,145,127,18,4,3
5,468,468,16,8,8,2,1
12,486,486,70,10,60,4,3
3,496,496,71,71,0,1,0

12,116,116,1,1,0,1,0
6,153,153,34,14,20,3,2
5,173,173,3,3,0,1,0
11,216,216,1,1,0,1,0
17,235,235,23,10,13,2,1
0,256,256,56,56,0,1,0
18,258,258,62,2,60,4,3
14,269,269,48,37,11,2,1
2,310,310,2,2,0,1,0
13,314,314,60,60,0,1,0
4,325,325,65,65,0,1,0
15,331,331,6,6,0,1,0
1,343,343,35,35,0,1,0
10,362,362,3,3,0,1,0
3,397,397,1,1,0,1,0
7,417,417,21,16,5,2,1
9,461,461,30,30,0,1,0
16,499,499,85,17,68,3,2
8,500,500,8,8,0,1,0

22,105,105,23,17,6,3,2
3,115,115,2,2,0,1,0
17,115,115,30,30,0,1,0
13,135,135,12,1,11,2,1
0,141,141,5,5,0,1,0
12,216,216,4,4,0,1,0
7,232,232,23,4,19,2,1
8,233,233,23,23,0,1,0
21,258,258,44,4,40,3,2
14,263,263,11,11,0,1,0
4,303,303,32,8,24,2,1
16,309,309,10,10,0,1,0
5,353,353,42,42,0,1,0
2,365,365,4,1,3,2,1
19,397,397,24,24,0,1,0
10,403,403,16,16,0,1,0
11,405,405,10,2,8,2,1
1,452,452,109,28,81,3,2
6,454,454,2,2,0,1,0
9,461,461,1,1,0,1,0
18,478,478,20,20,0,1,0
15,488,488,31,5,26,3,2
20,495,495,8,2,6,2,1

14,102,102,2,2,0,1,0
13,104,104,24,24,0,1,0
4,108,108,7,3,4,2,1
19,163,163,8,8,0,1,0
0,195,195,2,2,0,1,0
17,201,201,12,12,0,1,0
18,203,203,35,35,0,1,0
15,251,251,6,6,0,1,0
10,261,261,10,6,4,2,1
5,263,263,12,12,0,1,0
9,276,276,29,25,4,2,1
3,287,287,57,57,0,1,0
12,294,294,69,21,48,4,3
11,311,311,38,4,34,2,1
7,315,315,104,56,48,4,3
8,369,369,2,2,0,1,0
6,398,398,17,17,0,1,0
16,420,420,9,9,0,1,0
2,437,437,14,14,0,1,0
1,499,499,14,11,3,2,1

11,140,140,14,6,8,2,1
14,168,168,61,61,0,1,0
13,180,180,1,1,0,1,0
8,268,268,6,6,0,1,0
12,336,336,30,5,25,2,1
2,339,339,5,5,0,1,0
7,370,370,33,17,16,3,2
10,383,383,36,36,0,1,0
1,401,401,23,23,0,1,0
0,405,405,172,149,23,2,1
4,414,414,61,51,10,2,1
15,418,418,32,32,0,1,0
3,446,446,28,1,27,4,3
9,466,466,35,21,14,3,2
6,492,492,80,80,0,1,0
5,494,494,16,1,15,4,3

11,104,104,15,15,0,1,0
7,119,119,20,2,18,2,1
1,137,137,1,1,0,1,0
5,199,199,1,1,0,1,0
14,217,217,26,4,22,2,1
23,247,247,28,18,10,3,2
17,257,257,39,39,0,1,0
12,269,269,5,5,0,1,0
10,285,285,4,4,0,1,0
15,290,290,21,21,0,1,0
20,344,344,13,13,0,1,0
22,345,345,130,78,52,3,2
8,349,349,3,3,0,1,0
19,352,352,1,1,0,1,0
3,380,380,63,63,0,1,0
2,381,381,9,5,4,2,1
4,397,397,68,53,15,2,1
16,421,421,16,16,0,1,0
21,429,429,20,8,12,4,3
9,451,451,1,1,0,1,0
6,452,452,7,7,0,1,0
18,475,475,35,35,0,1,0
0,488,488,4,4,0,1,0
13,497,497,15,1,14,2,1

11,109,109,10,10,0,1,0
13,116,116,4,1,3,2,1
4,140,140,8,8,0,1,0
0,200,200,8,8,0,1,0
1,211,211,30,25,5,2,1
3,227,227,13,13,0,1,0
2,259,259,19,19,0,1,0
8,287,287,28,28,0,1,0
14,296,296,52,42,10,3,2
16,300,300,12,12,0,1,0
12,351,351,50,50,0,1,0
6,372,372,31,31,0,1,0
5,400,400,140,124,16,2,1
10,411,411,132,132,0,1,0
17,449,449,3,3,0,1,0
15,454,454,6,6,0,1,0
9,472,472,45,25,20,3,2
7,497,497,1,1,0,1,0

3,101,101,16,16,0,1,0
12,137,137,14,14,0,1,0
19,169,169,12,9,3,2,1
2,221,221,25,25,0,1,0
13,228,228,49,40,9,4,3
11,234,234,38,29,9,4,3
1,257,257,21,21,0,1,0
8,269,269,81,39,42,3,2
5,291,291,2,2,0,1,0
17,306,306,15,15,0,1,0
6,331,331,4,4,0,1,0
14,340,340,13,1,12,4,3
9,373,373,18,18,0,1,0
16,402,402,50,50,0,1,0
18,449,449,22,22,0,1,0
10,468,468,3,3,0,1,0
0,477,477,23,23,0,1,0
4,485,485,21,21,0,1,0
7,487,487,40,10,30,3,2
15,496,496,52,16,36,3,2

4,114,114,7,7,0,1,0
5,158,158,30,2,28,2,1
1,185,185,16,2,14,3,2
17,215,215,5,5,0,1,0
9,250,250,16,16,0,1,0
8,267,267,14,14,0,1,0
7,275,275,62,62,0,1,0
14,287,287,70,70,0,1,0
16,288,288,10,10,0,1,0
11,310,310,22,22,0,1,0
15,324,324,28,2,26,4,3
19,326,326,41,1,40,3,2
2,340,340,18,14,4,2,1
3,344,344,1,1,0,1,0
6,397,397,9,9,0,1,0
0,410,410,13,4,9,3,2
10,433,433,48,16,32,2,1
12,440,440,61,61,0,1,0
18,456,456,32,32,0,1,0
13,490,490,57,18,39,4,3

15,115,115,7,1,6,2,1
6,137,137,6,1,5,2,1
1,163,163,23,23,0,1,0
4,177,177,4,4,0,1,0
10,184,184,33,21,12,3,2
9,196,196,17,4,13,2,1
0,199,199,15,15,0,1,0
8,256,256,67,67,0,1,0
16,270,270,12,6,6,2,1
11,319,319,33,33,0,1,0
3,350,350,26,10,16,2,1
12,352,352,6,6,0,1,0
7,358,358,66,39,27,3,2
14,420,420,43,11,32,3,2
2,426,426,13,13,0,1,0
13,435,435,27,6,21,4,3
5,449,449,148,138,10,3,2

0,137,137,8,8,0,1,0
4,148,148,7,7,0,1,0
5,200,200,27,4,23,2,1
15,232,232,27,4,23,2,1
7,240,240,69,69,0,1,0
13,253,253,4,1,3,2,1
6,277,277,67,67,0,1,0
11,317,317,21,11,10,2,1
9,342,342,4,4,0,1,0
12,347,347,28,2,26,2,1
1,401,401,90,50,40,2,1
3,446,446,22,22,0,1,0
10,456,456,84,24,60,3,2
14,468,468,61,61,0,1,0
2,480,480,69,69,0,1,0
8,485,485,9,1,8,2,1

8,103,103,2,2,0,1,0
5,107,107,5,1,4,2,1
16,112,112,13,1,12,3,2
10,112,112,5,5,0,1,0
6,160,160,9,9,0,1,0
4,174,174,12,12,0,1,0
14,196,196,13,13,0,1,0
0,200,200,16,16,0,1,0
1,206,206,43,37,6,2,1
7,284,284,63,20,43,2,1
2,315,315,14,5,9,4,3
12,348,348,61,61,0,1,0
9,359,359,20,20,0,1,0
17,387,387,1,1,0,1,0
11,394,394,15,15,0,1,0
15,416,416,10,10,0,1,0
3,451,451,72,72,0,1,0
13,479,479,188,101,87,4,3

12,121,121,4,4,0,1,0
13,135,135,32,32,0,1,0
16,171,171,7,7,0,1,0
7,186,186,23,23,0,1,0
17,188,188,3,3,0,1,0
18,192,192,38,38,0,1,0
2,205,205,1,1,0,1,0
1,284,284,72,3,69,4,3
6,344,344,5,5,0,1,0
11,349,349,55,9,46,3,2
5,353,353,14,14,0,1,0
8,367,367,1,1,0,1,0
15,374,374,46,46,0,1,0
3,384,384,97,53,44,3,2
9,406,406,14,14,0,1,0
4,408,408,43,29,14,2,1
10,466,466,21,15,6,3,2
14,480,480,30,30,0,1,0
0,486,486,34,4,30,4,3

7,186,186,28,28,0,1,0
6,210,210,8,8,0,1,0
14,212,212,1,1,0,1,0
4,256,256,16,16,0,1,0
16,267,267,6,6,0,1,0
1,290,290,37,13,24,3,2
8,327,327,49,10,39,4,3
0,332,332,8,8,0,1,0
5,346,346,110,74,36,4,3
12,355,355,55,5,50,2,1
10,383,383,1,1,0,1,0
3,394,394,26,12,14,3,2
13,406,406,75,75,0,1,0
15,414,414,13,6,7,2,1
11,416,416,127,53,74,3,2
2,427,427,50,50,0,1,0
9,430,430,24,4,20,2,1

8,126,126,9,3,6,3,2
9,135,135,31,31,0,1,0
10,161,161,18,3,15,3,2
11,204,204,16,16,0,1,0
14,209,209,12,5,7,3,2
13,230,230,69,69,0,1,0
7,271,271,1,1,0,1,0
5,321,321,15,15,0,1,0
6,327,327,23,23,0,1,0
2,336,336,9,9,0,1,0
12,388,388,1,1,0,1,0
1,417,417,54,54,0,1,0
4,475,475,35,24,11,4,3
0,490,490,187,55,132,4,3
3,500,500,122,88,34,3,2

13,154,154,9,3,6,3,2
0,167,167,21,21,0,1,0
4,182,182,31,31,0,1,0
15,242,242,44,44,0,1,0
7,244,244,9,9,0,1,0
8,251,251,4,4,0,1,0
16,267,267,4,4,0,1,0
1,275,275,3,3,0,1,0
3,294,294,39,33,6,2,1
2,313,313,48,27,21,4,3
12,371,371,41,41,0,1,0
5,406,406,44,44,0,1,0
6,461,461,76,35,41,2,1
11,461,461,18,1,17,3,2
9,474,474,22,22,0,1,0
10,493,493,105,105,0,1,0
14,498,498,117,57,60,4,3

15,103,103,5,1,4,2,1
14,136,136,1,1,0,1,0
9,156,156,51,39,12,4,3
2,169,169,12,12,0,1,0
11,177,177,12,6,6,3,2
17,210,210,6,3,3,2,1
12,241,241,57,57,0,1,0
1,247,247,39,39,0,1,0
10,259,259,19,19,0,1,0
16,260,260,32,10,22,3,2
0,306,306,69,21,48,2,1
13,343,343,5,5,0,1,0
7,358,358,11,11,0,1,0
3,373,373,1,1,0,1,0
6,374,374,22,22,0,1,0
5,443,443,12,2,10,2,1
8,499,499,135,135,0,1,0
4,500,500,28,28,0,1,0

9,118,118,19,4,15,4,3
1,123,123,9,9,0,1,0
14,178,178,1,1,0,1,0
17,180,180,1,1,0,1,0
11,190,190,49,27,22,2,1
6,217,217,1,1,0,1,0
15,273,273,30,30,0,1,0
12,317,317,23,23,0,1,0
10,332,332,51,3,48,3,2
13,354,354,8,8,0,1,0
0,385,385,27,27,0,1,0
5,404,404,4,4,0,1,0
18,406,406,117,117,0,1,0
8,409,409,95,17,78,4,3
7,410,410,39,23,16,2,1
16,434,434,1,1,0,1,0
4,457,457,91,52,39,4,3
2,471,471,9,1,8,2,1
3,479,479,20,20,0,1,0

3,133,133,20,17,3,2,1
17,161,161,24,24,0,1,0
19,165,165,32,10,22,2,1
1,167,167,2,2,0,1,0
5,169,169,7,7,0,1,0
6,175,175,3,3,0,1,0
0,312,312,34,19,15,2,1
8,316,316,15,7,8,2,1
16,351,351,24,24,0,1,0
12,370,370,56,8,48,4,3
14,375,375,22,22,0,1,0
7,382,382,46,38,8,3,2
20,417,417,6,6,0,1,0
10,429,429,7,7,0,1,0
13,439,439,7,2,5,2,1
9,444,444,133,124,9,4,3
4,446,446,11,2,9,2,1
11,450,450,7,7,0,1,0
2,472,472,22,10,12,3,2
18,483,483,100,37,63,4,3
15,495,495,26,26,0,1,0

15,131,131,61,39,22,2,1
11,167,167,1,1,0,1,0
7,169,169,45,45,0,1,0
14,199,199,16,16,0,1,0
6,204,204,20,20,0,1,0
8,226,226,6,6,0,1,0
2,321,321,74,40,34,3,2
9,338,338,5,5,0,1,0
12,341,341,26,18,8,3,2
1,347,347,4,4,0,1,0
16,381,381,8,1,7,2,1
5,391,391,2,2,0,1,0
13,417,417,3,3,0,1,0
0,426,426,28,19,9,2,1
18,440,440,48,48,0,1,0
10,441,441,63,63,0,1,0
17,464,464,4,4,0,1,0
3,473,473,1,1,0,1,0
4,487,487,18,12,6,3,2
19,490,490,68,68,0,1,0

9,167,167,35,35,0,1,0
4,172,172,20,5,15,4,3
1,235,235,10,4,6,2,1
11,238,238,22,13,9,2,1
8,265,265,49,40,9,4,3
14,270,270,10,10,0,1,0
10,293,293,23,23,0,1,0
7,335,335,72,72,0,1,0
3,347,347,2,2,0,1,0
12,369,369,57,57,0,1,0
13,370,370,3,3,0,1,0
16,376,376,84,2,82,3,2
2,400,400,15,15,0,1,0
5,429,429,7,4,3,2,1
17,447,447,8,8,0,1,0
15,474,474,46,10,36,3,2
6,482,482,85,85,0,1,0
0,485,485,52,10,42,3,2

6,110,110,5,5,0,1,0
16,118,118,29,29,0,1,0
12,141,141,8,8,0,1,0
10,156,156,19,19,0,1,0
3,223,223,12,12,0,1,0
5,241,241,16,16,0,1,0
8,283,283,33,17,16,2,1
14,323,323,30,30,0,1,0
4,337,337,1,1,0,1,0
15,348,348,15,15,0,1,0
7,356,356,117,81,36,4,3
11,378,378,2,2,0,1,0
2,390,390,62,28,34,2,1
13,398,398,76,16,60,4,3
1,407,407,55,55,0,1,0
9,463,463,24,19,5,2,1
0,486,486,54,15,39,4,3

11,115,115,7,7,0,1,0
7,121,121,8,2,6,3,2
2,131,131,15,15,0,1,0
13,132,132,5,5,0,1,0
4,194,194,23,23,0,1,0
15,196,196,32,10,22,4,3
0,213,213,1,1,0,1,0
5,219,219,4,4,0,1,0
8,241,241,28,20,8,3,2
22,245,245,27,9,18,2,1
3,270,270,39,39,0,1,0
19,289,289,37,13,24,4,3
10,330,330,12,3,9,2,1
16,331,331,16,16,0,1,0
6,343,343,10,2,8,3,2
20,394,394,26,26,0,1,0
18,416,416,70,22,48,4,3
12,426,426,15,15,0,1,0
14,439,439,56,14,42,4,3
17,442,442,24,15,9,4,3
9,461,461,20,8,12,3,2
1,467,467,38,15,23,2,1
21,477,477,24,14,10,3,2

15,130,130,28,14,14,2,1
8,159,159,36,36,0,1,0
2,191,191,5,5,0,1,0
5,204,204,7,7,0,1,0
6,210,210,81,17,64,4,3
7,225,225,2,2,0,1,0
9,311,311,17,17,0,1,0
13,311,311,33,6,27,4,3
3,340,340,42,42,0,1,0
4,343,343,93,2,91,3,2
1,365,365,16,16,0,1,0
11,384,384,8,8,0,1,0
10,395,395,69,19,50,3,2
14,396,396,43,7,36,3,2
0,407,407,7,7,0,1,0
12,467,467,2,2,0,1,0

0,128,128,6,6,0,1,0
7,131,131,14,1,13,4,3
2,147,147,27,27,0,1,0
3,150,150,27,27,0,1,0
6,184,184,7,7,0,1,0
10,213,213,15,2,13,2,1
11,240,240,38,26,12,3,2
9,243,243,11,2,9,4,3
15,268,268,4,4,0,1,0
13,273,273,19,19,0,1,0
4,280,280,18,18,0,1,0
12,318,318,57,57,0,1,0
5,382,382,14,2,12,4,3
8,391,391,98,71,27,4,3
14,409,409,22,22,0,1,0
16,454,454,30,1,29,4,3
1,468,468,117,65,52,3,2

1,116,116,24,24,0,1,0
7,132,132,26,1,25,4,3
4,149,149,3,3,0,1,0
14,204,204,2,2,0,1,0
0,315,315,12,1,11,2,1
6,330,330,58,10,48,4,3
10,344,344,41,4,37,3,2
8,345,345,30,21,9,4,3
12,351,351,17,17,0,1,0
3,352,352,90,26,64,4,3
13,355,355,11,2,9,2,1
5,403,403,67,26,41,4,3
2,404,404,16,16,0,1,0
15,423,423,13,13,0,1,0
9,440,440,136,118,18,4,3
11,449,449,37,34,3,2,1

11,146,146,12,5,7,2,1
7,147,147,27,16,11,2,1
4,178,178,34,24,10,2,1
15,195,195,33,18,15,4,3
18,207,207,1,1,0,1,0
9,219,219,23,4,19,4,3
5,268,268,3,3,0,1,0
14,287,287,1,1,0,1,0
0,306,306,21,9,12,4,3
6,329,329,12,12,0,1,0
16,340,340,117,99,18,4,3
1,343,343,4,1,3,2,1
2,388,388,22,9,13,4,3
8,396,396,40,40,0,1,0
20,447,447,22,22,0,1,0
10,469,469,23,23,0,1,0
12,470,470,61,55,6,3,2
17,473,473,39,8,31,3,2
3,474,474,3,3,0,1,0
13,481,481,1,1,0,1,0
19,492,492,65,25,40,3,2

13,124,124,9,1,8,3,2
18,138,138,19,19,0,1,0
0,146,146,61,11,50,2,1
12,163,163,3,3,0,1,0
1,166,166,11,11,0,1,0
7,181,181,7,7,0,1,0
14,238,238,16,16,0,1,0
19,260,260,60,60,0,1,0
3,320,320,31,31,0,1,0
5,348,348,23,23,0,1,0
16,355,355,100,100,0,1,0
4,380,380,1,1,0,1,0
15,382,382,28,28,0,1,0
17,425,425,12,12,0,1,0
10,432,432,13,7,6,3,2
9,440,440,15,6,9,4,3
8,447,447,24,13,11,2,1
11,450,450,9,9,0,1,0
6,472,472,26,26,0,1,0
2,500,500,20,20,0,1,0

15,120,120,2,2,0,1,0
9,124,124,7,3,4,2,1
17,162,162,3,3,0,1,0
6,199,199,27,27,0,1,0
14,246,246,15,7,8,3,2
2,249,249,4,1,3,2,1
13,250,250,17,17,0,1,0
1,330,330,6,1,5,2,1
3,339,339,7,7,0,1,0
5,377,377,46,46,0,1,0
10,380,380,7,7,0,1,0
8,401,401,22,22,0,1,0
7,402,402,131,71,60,3,2
11,409,409,28,14,14,3,2
4,420,420,54,17,37,4,3
0,438,438,10,4,6,2,1
18,449,449,108,108,0,1,0
12,470,470,150,150,0,1,0
16,471,471,54,24,30,4,3

11,106,106,2,2,0,1,0
8,132,132,37,37,0,1,0
7,144,144,47,47,0,1,0
3,164,164,53,17,36,2,1
6,187,187,2,2,0,1,0
14,201,201,20,6,14,3,2
5,265,265,1,1,0,1,0
9,314,314,13,3,10,2,1
13,315,315,8,3,5,2,1
1,321,321,19,1,18,4,3
10,326,326,54,54,0,1,0
4,391,391,16,16,0,1,0
16,414,414,82,30,52,4,3
15,439,439,29,11,18,3,2
12,451,451,8,8,0,1,0
0,478,478,6,6,0,1,0
2,484,484,63,63,0,1,0

5,114,114,10,1,9,2,1
1,135,135,1,1,0,1,0
2,162,162,19,13,6,3,2
12,184,184,1,1,0,1,0
7,244,244,30,16,14,3,2
11,304,304,24,24,0,1,0
4,310,310,66,27,39,2,1
10,317,317,25,1,24,3,2
8,377,377,102,94,8,2,1
15,389,389,4,4,0,1,0
3,419,419,9,1,8,2,1
13,422,422,67,67,0,1,0
9,423,423,16,16,0,1,0
0,425,425,145,136,9,2,1
6,487,487,55,10,45,4,3
14,494,494,73,5,68,3,2

20,102,102,8,3,5,2,1
3,122,122,9,3,6,2,1
7,161,161,25,25,0,1,0
5,162,162,33,33,0,1,0
9,180,180,9,9,0,1,0
18,199,199,1,1,0,1,0
17,208,208,5,5,0,1,0
12,252,252,22,22,0,1,0
15,281,281,3,3,0,1,0
1,296,296,66,59,7,2,1
19,309,309,68,30,38,3,2
4,367,367,30,30,0,1,0
10,371,371,1,1,0,1,0
8,376,376,12,12,0,1,0
6,394,394,2,2,0,1,0
2,406,406,10,1,9,4,3
16,409,409,7,7,0,1,0
0,443,443,4,4,0,1,0
13,458,458,210,210,0,1,0
11,463,463,19,19,0,1,0
14,496,496,10,10,0,1,0

10,146,146,18,18,0,1,0
3,160,160,16,16,0,1,0
8,167,167,18,9,9,4,3
1,168,168,15,15,0,1,0
11,197,197,21,2,19,4,3
7,204,204,23,23,0,1,0
2,230,230,43,4,39,4,3
9,235,235,22,2,20,3,2
6,386,386,7,1,6,2,1
0,421,421,223,136,87,4,3
4,450,450,83,71,12,2,1
5,469,469,78,78,0,1,0
12,490,490,1,1,0,1,0

3,103,103,1,1,0,1,0
6,119,119,24,2,22,3,2
8,173,173,24,19,5,2,1
10,184,184,6,3,3,2,1
4,216,216,35,35,0,1,0
5,233,233,2,2,0,1,0
11,236,236,102,102,0,1,0
15,256,256,31,31,0,1,0
14,257,257,5,5,0,1,0
12,312,312,12,9,3,2,1
0,382,382,37,37,0,1,0
2,390,390,48,48,0,1,0
17,406,406,2,2,0,1,0
13,434,434,8,1,7,2,1
7,483,483,39,39,0,1,0
1,491,491,39,39,0,1,0
9,499,499,89,84,5,2,1
16,499,499,33,33,0,1,0

10,106,106,6,6,0,1,0
14,148,148,12,12,0,1,0
15,163,163,5,1,4,2,1
21,167,167,44,36,8,2,1
9,170,170,10,10,0,1,0
7,203,203,16,2,14,4,3
0,209,209,2,2,0,1,0
8,294,294,14,14,0,1,0
5,300,300,10,10,0,1,0
11,300,300,28,28,0,1,0
18,313,313,55,55,0,1,0
2,313,313,17,17,0,1,0
20,318,318,16,16,0,1,0
16,343,343,36,36,0,1,0
22,384,384,24,6,18,2,1
17,397,397,47,47,0,1,0
13,409,409,17,1,16,2,1
6,459,459,22,22,0,1,0
1,460,460,43,8,35,2,1
12,466,466,57,57,0,1,0
4,466,466,46,46,0,1,0
3,469,469,30,30,0,1,0
19,493,493,14,4,10,2,1

9,104,104,11,5,6,2,1
4,140,140,4,4,0,1,0
14,166,166,27,27,0,1,0
17,240,240,21,1,20,3,2
7,240,240,11,11,0,1,0
1,256,256,48,19,29,2,1
5,261,261,31,31,0,1,0
12,276,276,56,38,18,3,2
10,282,282,7,4,3,2,1
3,295,295,47,47,0,1,0
8,360,360,11,1,10,2,1
0,367,367,92,83,9,2,1
11,405,405,6,6,0,1,0
2,412,412,18,4,14,3,2
16,467,467,133,108,25,2,1
6,477,477,18,18,0,1,0
15,487,487,9,9,0,1,0
13,494,494,5,5,0,1,0

8,108,108,14,14,0,1,0
1,181,181,9,9,0,1,0
5,200,200,16,16,0,1,0
2,227,227,10,1,9,4,3
6,242,242,36,36,0,1,0
3,267,267,12,12,0,1,0
10,286,286,49,13,36,3,2
16,309,309,75,75,0,1,0
0,344,344,53,9,44,4,3
13,351,351,9,9,0,1,0
18,378,378,9,9,0,1,0
4,413,413,83,21,62,3,2
7,426,426,17,1,16,3,2
9,450,450,4,4,0,1,0
12,457,457,13,2,11,2,1
11,460,460,6,6,0,1,0
17,460,460,114,58,56,4,3
14,483,483,62,2,60,3,2
15,487,487,13,4,9,2,1

13,120,120,17,17,0,1,0
22,130,130,7,1,6,3,2
10,132,132,11,11,0,1,0
20,135,135,30,6,24,2,1
16,138,138,36,36,0,1,0
12,140,140,3,3,0,1,0
3,180,180,1,1,0,1,0
0,186,186,7,2,5,2,1
18,194,194,4,4,0,1,0
2,194,194,1,1,0,1,0
8,197,197,17,17,0,1,0
19,198,198,13,13,0,1,0
21,208,208,4,4,0,1,0
9,212,212,18,18,0,1,0
1,219,219,46,37,9,2,1
5,262,262,1,1,0,1,0
15,290,290,29,29,0,1,0
7,302,302,8,5,3,2,1
17,333,333,13,3,10,3,2
14,357,357,54,54,0,1,0
11,368,368,8,8,0,1,0
6,444,444,45,13,32,2,1
4,449,449,34,34,0,1,0

1,103,103,7,3,4,2,1
13,111,111,17,14,3,2,1
7,125,125,21,10,11,2,1
17,132,132,2,2,0,1,0
3,152,152,21,21,0,1,0
4,171,171,18,18,0,1,0
11,189,189,50,50,0,1,0
10,197,197,7,7,0,1,0
0,218,218,1,1,0,1,0
16,223,223,11,11,0,1,0
12,236,236,12,12,0,1,0
6,248,248,44,44,0,1,0
5,304,304,1,1,0,1,0
8,325,325,31,26,5,2,1
15,353,353,16,8,8,3,2
19,355,355,6,6,0,1,0
2,362,362,20,20,0,1,0
14,369,369,81,81,0,1,0
9,481,481,24,24,0,1,0
18,483,483,53,39,14,2,1

2,117,117,26,10,16,2,1
1,126,126,20,16,4,2,1
14,145,145,8,8,0,1,0
4,183,183,12,12,0,1,0
3,197,197,8,8,0,1,0
7,222,222,28,6,22,2,1
0,265,265,3,3,0,1,0
15,286,286,6,3,3,2,1
10,288,288,20,20,0,1,0
17,319,319,9,6,3,2,1
13,339,339,32,20,12,4,3
5,345,345,15,12,3,2,1
9,364,364,79,46,33,2,1
6,365,365,44,44,0,1,0
16,383,383,52,52,0,1,0
8,410,410,46,46,0,1,0
12,451,451,43,21,22,3,2
11,456,456,91,77,14,2,1

8,161,161,59,23,36,2,1
6,161,161,1,1,0,1,0
7,163,163,43,12,31,2,1
3,174,174,8,8,0,1,0
12,210,210,11,11,0,1,0
15,217,217,33,9,24,4,3
16,264,264,28,6,22,2,1
11,266,266,22,8,14,3,2
10,269,269,38,20,18,2,1
5,307,307,23,23,0,1,0
13,313,313,4,4,0,1,0
2,314,314,42,23,19,2,1
9,319,319,1,1,0,1,0
0,360,360,61,33,28,2,1
1,385,385,50,50,0,1,0
14,477,477,3,3,0,1,0
4,495,495,38,2,36,4,3

8,103,103,15,15,0,1,0
12,119,119,27,9,18,2,1
13,130,130,9,2,7,2,1
5,138,138,1,1,0,1,0
10,162,162,1,1,0,1,0
11,199,199,24,24,0,1,0
17,208,208,8,8,0,1,0
18,294,294,1,1,0,1,0
4,305,305,20,20,0,1,0
20,313,313,106,55,51,4,3
6,337,337,1,1,0,1,0
9,346,346,1,1,0,1,0
15,407,407,24,24,0,1,0
3,412,412,8,8,0,1,0
2,425,425,83,23,60,3,2
7,446,446,104,104,0,1,0
19,449,449,7,3,4,2,1
16,456,456,50,50,0,1,0
14,460,460,27,1,26,3,2
0,475,475,22,2,20,2,1
1,489,489,27,3,24,3,2

4,141,141,14,8,6,2,1
3,153,153,1,1,0,1,0
14,164,164,15,9,6,2,1
6,198,198,2,2,0,1,0
1,223,223,10,10,0,1,0
15,239,239,1,1,0,1,0
0,245,245,14,14,0,1,0
11,255,255,19,19,0,1,0
12,282,282,49,34,15,2,1
5,329,329,106,46,60,4,3
13,345,345,37,37,0,1,0
8,347,347,47,47,0,1,0
10,388,388,35,13,22,2,1
7,407,407,69,50,19,2,1
2,468,468,27,3,24,4,3
9,473,473,25,16,9,4,3
17,483,483,122,109,13,2,1
16,493,493,33,33,0,1,0

14,108,108,32,32,0,1,0
18,132,132,11,11,0,1,0
2,146,146,11,2,9,4,3
0,148,148,50,28,22,2,1
8,154,154,12,3,9,2,1
16,169,169,2,2,0,1,0
1,238,238,28,28,0,1,0
15,242,242,2,2,0,1,0
3,245,245,1,1,0,1,0
5,295,295,3,3,0,1,0
11,320,320,12,3,9,2,1
12,351,351,34,34,0,1,0
17,355,355,29,29,0,1,0
4,362,362,10,10,0,1,0
6,383,383,1,1,0,1,0
7,417,417,46,12,34,4,3
10,419,419,83,83,0,1,0
13,431,431,44,44,0,1,0
9,457,457,63,63,0,1,0

15,105,105,1,1,0,1,0
12,127,127,14,3,11,2,1
11,148,148,38,38,0,1,0
6,173,173,1,1,0,1,0
1,193,193,1,1,0,1,0
19,193,193,4,4,0,1,0
0,207,207,1,1,0,1,0
22,221,221,9,4,5,2,1
7,224,224,5,2,3,2,1
20,231,231,8,8,0,1,0
4,242,242,13,1,12,2,1
8,244,244,18,12,6,3,2
16,281,281,91,15,76,3,2
9,283,283,2,2,0,1,0
17,289,289,85,25,60,4,3
14,324,324,6,6,0,1,0
13,363,363,10,5,5,2,1
18,422,422,48,48,0,1,0
10,433,433,28,19,9,4,3
21,446,446,27,7,20,2,1
2,475,475,111,18,93,4,3
3,498,498,13,10,3,2,1
5,499,499,5,5,0,1,0

11,116,116,12,12,0,1,0
5,119,119,1,1,0,1,0
6,121,121,18,9,9,2,1
15,149,149,9,5,4,2,1
14,184,184,15,15,0,1,0
9,254,254,8,3,5,2,1
10,276,276,20,20,0,1,0
16,284,284,54,54,0,1,0
2,295,295,34,34,0,1,0
0,306,306,9,9,0,1,0
4,310,310,60,11,49,2,1
8,328,328,18,2,16,3,2
1,356,356,16,4,12,4,3
17,359,359,48,2,46,3,2
7,367,367,29,8,21,2,1
13,372,372,89,74,15,4,3
12,413,413,6,1,5,2,1
3,477,477,109,109,0,1,0

5,100,100,1,1,0,1,0
6,111,111,1,1,0,1,0
17,114,114,2,2,0,1,0
9,154,154,6,3,3,2,1
12,159,159,6,6,0,1,0
13,176,176,32,32,0,1,0
10,214,214,2,2,0,1,0
14,214,214,23,23,0,1,0
7,287,287,35,26,9,4,3
8,291,291,59,59,0,1,0
4,309,309,6,6,0,1,0
16,348,348,51,25,26,3,2
15,351,351,121,121,0,1,0
1,401,401,53,53,0,1,0
3,404,404,90,66,24,3,2
0,423,423,36,36,0,1,0
2,452,452,45,45,0,1,0
11,495,495,13,13,0,1,0

13,145,145,10,10,0,1,0
17,145,145,28,28,0,1,0
9,167,167,3,3,0,1,0
16,177,177,2,2,0,1,0
5,191,191,8,8,0,1,0
12,207,207,65,65,0,1,0
8,225,225,4,4,0,1,0
7,225,225,5,5,0,1,0
15,231,231,6,6,0,1,0
10,288,288,27,27,0,1,0
1,303,303,33,20,13,2,1
3,326,326,14,2,12,4,3
0,356,356,128,29,99,4,3
4,399,399,15,6,9,2,1
11,424,424,9,9,0,1,0
2,437,437,79,73,6,2,1
6,455,455,41,41,0,1,0
14,498,498,90,90,0,1,0

14,105,105,5,5,0,1,0
6,143,143,8,8,0,1,0
11,166,166,18,18,0,1,0
9,197,197,74,74,0,1,0
8,219,219,28,20,8,3,2
15,255,255,9,9,0,1,0
5,304,304,17,1,16,2,1
13,316,316,15,15,0,1,0
12,350,350,4,4,0,1,0
2,363,363,44,9,35,2,1
3,363,363,12,8,4,2,1
4,382,382,46,46,0,1,0
1,422,422,216,162,54,4,3
0,469,469,3,3,0,1,0
7,491,491,63,46,17,2,1
10,500,500,18,14,4,2,1

15,103,103,23,23,0,1,0
7,120,120,6,3,3,2,1
6,151,151,3,3,0,1,0
2,167,167,2,2,0,1,0
8,168,168,1,1,0,1,0
24,196,196,16,16,0,1,0
19,203,203,2,2,0,1,0
3,205,205,7,7,0,1,0
22,240,240,38,38,0,1,0
11,290,290,4,1,3,2,1
20,333,333,19,9,10,3,2
9,350,350,5,5,0,1,0
5,354,354,7,7,0,1,0
4,354,354,84,66,18,3,2
1,409,409,33,18,15,4,3
18,423,423,88,10,78,3,2
0,425,425,3,3,0,1,0
14,436,436,1,1,0,1,0
17,437,437,67,61,6,2,1
13,446,446,45,45,0,1,0
16,447,447,95,81,14,2,1
23,451,451,12,4,8,3,2
21,454,454,5,5,0,1,0
12,457,457,21,11,10,2,1
10,489,489,20,1,19,2,1

14,142,142,7,7,0,1,0
8,205,205,28,9,19,2,1
12,210,210,16,11,5,2,1
0,234,234,12,7,5,2,1
7,234,234,66,66,0,1,0
5,248,248,31,31,0,1,0
4,255,255,53,1,52,4,3
10,255,255,33,1,32,3,2
6,290,290,11,4,7,2,1
11,343,343,40,40,0,1,0
13,428,428,3,3,0,1,0
1,461,461,73,8,65,4,3
9,478,478,38,2,36,2,1
2,491,491,119,52,67,4,3
3,491,491,57,57,0,1,0

7,110,110,1,1,0,1,0
9,134,134,2,2,0,1,0
18,134,134,8,5,3,2,1
6,176,176,4,4,0,1,0
19,182,182,29,8,21,2,1
0,242,242,28,7,21,4,3
4,246,246,1,1,0,1,0
13,254,254,5,5,0,1,0
20,262,262,15,4,11,2,1
3,286,286,13,5,8,2,1
12,287,287,39,5,34,2,1
11,293,293,17,9,8,3,2
1,298,298,30,2,28,4,3
5,343,343,9,9,0,1,0
8,356,356,72,72,0,1,0
14,388,388,16,16,0,1,0
2,413,413,57,57,0,1,0
10,416,416,69,55,14,3,2
16,422,422,4,4,0,1,0
17,427,427,169,165,4,2,1
15,459,459,17,17,0,1,0

15,118,118,3,3,0,1,0
13,122,122,17,3,14,4,3
6,150,150,1,1,0,1,0
11,155,155,23,5,18,2,1
12,156,156,19,19,0,1,0
4,166,166,17,1,16,3,2
17,177,177,1,1,0,1,0
8,218,218,28,4,24,4,3
18,331,331,50,6,44,2,1
0,342,342,35,35,0,1,0
3,344,344,57,10,47,2,1
14,360,360,4,4,0,1,0
9,361,361,1,1,0,1,0
1,393,393,40,34,6,2,1
10,408,408,39,39,0,1,0
7,415,415,4,4,0,1,0
16,434,434,100,100,0,1,0
2,473,473,16,1,15,4,3
5,476,476,118,31,87,4,3

0,108,108,29,29,0,1,0
11,113,113,22,6,16,2,1
14,147,147,31,16,15,2,1
1,159,159,15,15,0,1,0
13,187,187,8,8,0,1,0
9,214,214,12,12,0,1,0
7,219,219,2,2,0,1,0
3,242,242,35,35,0,1,0
6,328,328,12,12,0,1,0
8,334,334,9,9,0,1,0
5,360,360,56,56,0,1,0
10,370,370,91,91,0,1,0
4,433,433,63,40,23,3,2
12,439,439,43,43,0,1,0
2,490,490,46,32,14,2,1

13,100,100,7,7,0,1,0
3,107,107,60,60,0,1,0
7,141,141,19,13,6,3,2
9,142,142,9,9,0,1,0
5,170,170,12,12,0,1,0
8,178,178,16,16,0,1,0
6,181,181,21,17,4,2,1
14,196,196,14,14,0,1,0
15,243,243,6,6,0,1,0
1,319,319,2,2,0,1,0
10,319,319,51,51,0,1,0
0,372,372,22,8,14,3,2
12,386,386,103,93,10,3,2
11,387,387,15,15,0,1,0
4,399,399,30,30,0,1,0
2,412,412,5,5,0,1,0

2,106,106,1,1,0,1,0
7,106,106,10,7,3,2,1
11,110,110,23,23,0,1,0
3,135,135,10,3,7,2,1
14,136,136,20,20,0,1,0
0,185,185,14,7,7,2,1
6,201,201,26,2,24,4,3
9,226,226,50,50,0,1,0
17,230,230,5,1,4,2,1
15,254,254,3,3,0,1,0
5,279,279,24,24,0,1,0
10,294,294,16,16,0,1,0
18,299,299,6,6,0,1,0
8,330,330,23,23,0,1,0
13,360,360,86,58,28,2,1
1,401,401,54,22,32,2,1
12,462,462,27,27,0,1,0
16,484,484,75,5,70,3,2
4,488,488,3,3,0,1,0

13,149,149,13,13,0,1,0
6,189,189,1,1,0,1,0
2,228,228,1,1,0,1,0
20,229,229,35,35,0,1,0
14,248,248,60,55,5,2,1
5,249,249,17,1,16,4,3
18,250,250,9,6,3,2,1
12,262,262,19,12,7,2,1
9,274,274,4,4,0,1,0
1,275,275,41,41,0,1,0
17,283,283,16,16,0,1,0
16,302,302,18,6,12,3,2
11,306,306,9,4,5,2,1
15,311,311,39,2,37,4,3
10,347,347,56,56,0,1,0
4,353,353,5,5,0,1,0
7,394,394,29,13,16,3,2
8,457,457,117,5,112,4,3
0,467,467,30,30,0,1,0
19,490,490,42,7,35,2,1
3,499,499,30,1,29,3,2

4,112,112,14,8,6,3,2
7,123,123,1,1,0,1,0
9,130,130,1,1,0,1,0
0,144,144,32,16,16,2,1
5,162,162,14,14,0,1,0
8,179,179,5,5,0,1,0
10,189,189,1,1,0,1,0
17,224,224,32,6,26,2,1
3,230,230,10,3,7,2,1
15,244,244,2,2,0,1,0
21,255,255,16,5,11,2,1
13,267,267,9,9,0,1,0
2,273,273,28,13,15,4,3
11,274,274,6,6,0,1,0
1,295,295,8,1,7,2,1
14,329,329,82,37,45,2,1
6,343,343,15,11,4,2,1
12,395,395,71,19,52,3,2
20,415,415,61,61,0,1,0
18,431,431,60,50,10,2,1
16,443,443,44,44,0,1,0
19,491,491,16,16,0,1,0

15,113,113,10,10,0,1,0
13,125,125,5,5,0,1,0
18,149,149,2,2,0,1,0
23,163,163,14,14,0,1,0
6,177,177,20,1,19,2,1
24,182,182,33,33,0,1,0
22,207,207,20,7,13,3,2
20,257,257,25,2,23,2,1
5,277,277,5,5,0,1,0
8,283,283,30,8,22,4,3
19,289,289,7,4,3,2,1
0,308,308,2,2,0,1,0
2,360,360,2,2,0,1,0
12,373,373,38,38,0,1,0
16,374,374,81,81,0,1,0
9,420,420,31,21,10,2,1
14,430,430,11,11,0,1,0
3,433,433,43,13,30,4,3
11,449,449,33,33,0,1,0
21,455,455,76,28,48,4,3
4,477,477,11,1,10,2,1
10,480,480,22,1,21,4,3
17,482,482,18,18,0,1,0
1,487,487,18,18,0,1,0
7,489,489,25,3,22,2,1

9,132,132,10,10,0,1,0
12,156,156,17,7,10,3,2
3,180,180,42,12,30,4,3
14,190,190,3,3,0,1,0
15,271,271,22,10,12,2,1
5,331,331,35,14,21,4,3
8,374,374,12,12,0,1,0
1,380,380,51,51,0,1,0
13,382,382,73,5,68,3,2
6,412,412,34,6,28,2,1
7,431,431,16,7,9,2,1
2,460,460,35,8,27,4,3
11,467,467,103,7,96,4,3
4,484,484,19,13,6,2,1
0,486,486,112,38,74,3,2
10,493,493,77,10,67,3,2

1,103,103,2,2,0,1,0
8,130,130,11,6,5,2,1
17,133,133,7,7,0,1,0
3,141,141,25,7,18,4,3
18,151,151,13,13,0,1,0
6,154,154,3,3,0,1,0
5,159,159,16,16,0,1,0
16,199,199,41,41,0,1,0
7,224,224,5,1,4,2,1
11,239,239,23,3,20,4,3
19,283,283,36,20,16,3,2
10,297,297,34,34,0,1,0
15,314,314,10,10,0,1,0
2,315,315,18,12,6,2,1
9,337,337,50,50,0,1,0
13,363,363,49,29,20,3,2
14,369,369,64,36,28,2,1
0,409,409,51,51,0,1,0
4,433,433,14,14,0,1,0
12,459,459,5,1,4,2,1

2,107,107,1,1,0,1,0
4,112,112,56,56,0,1,0
6,122,122,3,3,0,1,0
13,135,135,32,4,28,2,1
9,169,169,2,2,0,1,0
1,177,177,1,1,0,1,0
8,188,188,3,3,0,1,0
11,233,233,2,2,0,1,0
3,246,246,28,28,0,1,0
12,341,341,52,52,0,1,0
0,367,367,14,14,0,1,0
7,389,389,114,114,0,1,0
10,396,396,23,23,0,1,0
5,443,443,104,22,82,3,2
14,499,499,61,23,38,2,1

2,140,140,10,2,8,3,2
5,160,160,45,31,14,3,2
13,210,210,5,5,0,1,0
3,214,214,3,3,0,1,0
4,215,215,12,1,11,2,1
12,227,227,42,7,35,4,3
1,228,228,65,65,0,1,0
15,261,261,51,23,28,3,2
9,271,271,41,9,32,4,3
0,280,280,31,13,18,4,3
10,334,334,39,39,0,1,0
16,400,400,2,2,0,1,0
11,411,411,9,9,0,1,0
8,415,415,10,10,0,1,0
7,435,435,3,3,0,1,0
14,454,454,87,33,54,3,2
6,487,487,37,19,18,2,1

10,114,114,1,1,0,1,0
19,116,116,11,11,0,1,0
16,152,152,2,2,0,1,0
2,174,174,2,2,0,1,0
8,199,199,14,2,12,3,2
6,219,219,36,17,19,3,2
3,232,232,20,2,18,4,3
17,239,239,3,3,0,1,0
9,266,266,37,37,0,1,0
15,270,270,11,5,6,3,2
1,276,276,36,1,35,2,1
7,297,297,2,2,0,1,0
5,313,313,8,3,5,2,1
14,338,338,63,1,62,3,2
13,339,339,17,7,10,4,3
20,414,414,118,118,0,1,0
11,449,449,93,93,0,1,0
18,467,467,68,50,18,4,3
12,474,474,42,42,0,1,0
0,481,481,4,4,0,1,0
4,498,498,21,21,0,1,0

18,116,116,9,9,0,1,0
7,136,136,11,2,9,4,3
4,154,154,1,1,0,1,0
21,154,154,23,18,5,2,1
11,169,169,12,12,0,1,0
3,179,179,15,1,14,3,2
9,199,199,8,8,0,1,0
12,238,238,59,59,0,1,0
19,238,238,38,18,20,2,1
17,240,240,20,17,3,2,1
2,245,245,1,1,0,1,0
1,327,327,18,18,0,1,0
6,347,347,7,1,6,3,2
15,351,351,97,21,76,4,3
8,366,366,40,22,18,4,3
0,398,398,2,2,0,1,0
13,398,398,19,2,17,4,3
5,407,407,7,1,6,3,2
20,409,409,29,29,0,1,0
14,455,455,7,1,6,3,2
10,457,457,74,23,51,4,3
16,464,464,20,12,8,3,2

15,136,136,10,10,0,1,0
18,188,188,6,6,0,1,0
1,210,210,16,16,0,1,0
14,223,223,3,3,0,1,0
6,229,229,4,4,0,1,0
11,251,251,41,17,24,3,2
8,259,259,4,1,3,2,1
3,259,259,25,25,0,1,0
9,279,279,120,47,73,3,2
10,307,307,67,49,18,4,3
17,307,307,37,15,22,3,2
13,316,316,41,33,8,2,1
4,339,339,1,1,0,1,0
0,340,340,1,1,0,1,0
5,371,371,20,20,0,1,0
16,374,374,57,30,27,4,3
7,394,394,22,10,12,4,3
2,484,484,73,49,24,2,1
12,496,496,12,12,0,1,0

3,130,130,4,4,0,1,0
7,142,142,1,1,0,1,0
17,142,142,31,19,12,2,1
2,148,148,4,4,0,1,0
5,156,156,63,9,54,4,3
1,167,167,2,2,0,1,0
4,188,188,9,9,0,1,0
14,236,236,9,6,3,2,1
9,241,241,2,2,0,1,0
12,250,250,7,7,0,1,0
13,277,277,37,24,13,2,1
8,296,296,1,1,0,1,0
11,327,327,38,11,27,2,1
15,376,376,22,22,0,1,0
10,384,384,50,23,27,2,1
6,430,430,4,4,0,1,0
0,465,465,168,168,0,1,0
16,498,498,92,92,0,1,0

1,101,101,4,4,0,1,0
23,121,121,9,9,0,1,0
16,121,121,2,2,0,1,0
7,137,137,35,35,0,1,0
5,158,158,1,1,0,1,0
0,160,160,1,1,0,1,0
10,215,215,28,17,11,2,1
14,220,220,5,5,0,1,0
13,246,246,1,1,0,1,0
20,256,256,72,72,0,1,0
19,258,258,35,35,0,1,0
3,267,267,29,29,0,1,0
15,275,275,4,4,0,1,0
8,281,281,23,23,0,1,0
17,287,287,30,30,0,1,0
21,292,292,14,14,0,1,0
4,301,301,10,5,5,2,1
2,335,335,7,1,6,2,1
18,361,361,48,6,42,3,2
22,395,395,45,45,0,1,0
9,420,420,11,11,0,1,0
12,443,443,56,56,0,1,0
11,456,456,9,9,0,1,0
6,491,491,10,6,4,2,1

4,109,109,16,3,13,2,1
0,126,126,1,1,0,1,0
19,131,131,3,3,0,1,0
2,161,161,7,7,0,1,0
18,163,163,4,4,0,1,0
12,201,201,8,4,4,2,1
10,202,202,5,5,0,1,0
8,206,206,10,1,9,2,1
9,222,222,24,20,4,2,1
16,231,231,28,28,0,1,0
11,254,254,3,3,0,1,0
20,258,258,4,4,0,1,0
5,321,321,24,24,0,1,0
6,331,331,4,4,0,1,0
1,341,341,50,26,24,3,2
3,366,366,76,61,15,4,3
15,385,385,115,89,26,2,1
17,429,429,148,44,104,4,3
7,456,456,32,32,0,1,0
13,475,475,13,5,8,2,1
14,491,491,9,9,0,1,0

2,132,132,10,10,0,1,0
19,144,144,31,31,0,1,0
17,162,162,9,3,6,3,2
0,196,196,1,1,0,1,0
10,217,217,13,13,0,1,0
14,218,218,19,19,0,1,0
11,265,265,26,26,0,1,0
13,296,296,94,13,81,4,3
21,304,304,27,8,19,2,1
7,306,306,18,3,15,4,3
12,329,329,14,14,0,1,0
15,357,357,17,17,0,1,0
16,408,408,24,24,0,1,0
1,416,416,1,1,0,1,0
3,421,421,23,8,15,4,3
4,442,442,27,3,24,2,1
20,445,445,2,2,0,1,0
18,448,448,20,20,0,1,0
6,454,454,68,68,0,1,0
9,486,486,40,5,35,2,1
5,488,488,82,6,76,3,2
8,497,497,22,10,12,4,3

16,111,111,25,25,0,1,0
6,120,120,5,5,0,1,0
8,139,139,41,2,39,2,1
15,139,139,5,5,0,1,0
13,146,146,37,7,30,2,1
14,183,183,23,23,0,1,0
11,253,253,35,1,34,4,3
5,255,255,11,11,0,1,0
1,289,289,2,2,0,1,0
4,304,304,93,15,78,3,2
12,327,327,8,8,0,1,0
10,333,333,18,4,14,2,1
7,361,361,16,16,0,1,0
3,368,368,31,10,21,4,3
17,375,375,4,4,0,1,0
9,398,398,24,24,0,1,0
2,424,424,33,33,0,1,0
0,465,465,2,2,0,1,0

13,106,106,10,3,7,2,1
11,109,109,7,4,3,2,1
6,114,114,6,6,0,1,0
8,131,131,1,1,0,1,0
7,150,150,27,13,14,2,1
16,157,157,8,3,5,2,1
9,202,202,60,51,9,4,3
14,227,227,42,42,0,1,0
15,243,243,27,27,0,1,0
12,330,330,39,18,21,4,3
18,345,345,40,18,22,2,1
3,348,348,16,4,12,2,1
10,386,386,31,31,0,1,0
17,416,416,46,46,0,1,0
0,421,421,18,8,10,3,2
1,433,433,6,6,0,1,0
5,465,465,42,20,22,3,2
2,471,471,34,19,15,4,3
4,497,497,50,5,45,2,1

16,126,126,15,15,0,1,0
1,173,173,8,8,0,1,0
2,201,201,8,4,4,2,1
5,206,206,78,78,0,1,0
15,212,212,9,9,0,1,0
10,216,216,29,29,0,1,0
6,264,264,38,4,34,3,2
11,274,274,11,11,0,1,0
0,275,275,7,7,0,1,0
4,308,308,11,3,8,2,1
3,314,314,70,70,0,1,0
13,404,404,15,1,14,4,3
7,405,405,3,3,0,1,0
9,433,433,146,131,15,2,1
14,471,471,55,38,17,2,1
8,488,488,39,5,34,3,2
12,493,493,2,2,0,1,0

11,118,118,17,2,15,3,2
4,131,131,7,7,0,1,0
14,167,167,6,6,0,1,0
13,168,168,11,11,0,1,0
5,184,184,3,3,0,1,0
9,257,257,50,11,39,4,3
3,277,277,9,9,0,1,0
8,281,281,73,43,30,3,2
16,286,286,52,52,0,1,0
12,309,309,9,9,0,1,0
2,314,314,12,9,3,2,1
6,322,322,65,47,18,3,2
18,387,387,96,30,66,4,3
0,396,396,2,2,0,1,0
17,400,400,53,53,0,1,0
7,404,404,4,4,0,1,0
10,407,407,22,8,14,2,1
19,427,427,3,3,0,1,0
15,458,458,35,8,27,2,1
1,490,490,18,18,0,1,0

11,158,158,26,17,9,4,3
9,169,169,7,7,0,1,0
6,178,178,1,1,0,1,0
18,186,186,38,11,27,4,3
8,213,213,10,5,5,2,1
7,218,218,6,1,5,2,1
15,253,253,5,5,0,1,0
2,326,326,78,6,72,3,2
16,373,373,26,3,23,3,2
17,406,406,17,17,0,1,0
13,418,418,71,27,44,4,3
1,420,420,60,10,50,4,3
12,426,426,53,53,0,1,0
0,427,427,18,3,15,4,3
14,453,453,3,3,0,1,0
3,463,463,48,27,21,4,3
4,489,489,52,14,38,4,3
5,490,490,72,72,0,1,0
10,491,491,54,48,6,2,1

6,103,103,6,6,0,1,0
20,111,111,3,3,0,1,0
10,132,132,24,18,6,3,2
7,159,159,17,17,0,1,0
13,165,165,51,51,0,1,0
18,173,173,10,6,4,2,1
3,184,184,20,20,0,1,0
2,231,231,1,1,0,1,0
15,240,240,5,5,0,1,0
14,277,277,2,2,0,1,0
19,285,285,9,9,0,1,0
17,343,343,79,61,18,2,1
11,357,357,10,10,0,1,0
21,365,365,56,6,50,4,3
8,365,365,11,11,0,1,0
9,382,382,30,30,0,1,0
12,431,431,3,3,0,1,0
4,455,455,14,14,0,1,0
16,467,467,42,42,0,1,0
1,469,469,70,70,0,1,0
5,475,475,47,23,24,4,3
0,493,493,9,9,0,1,0

10,176,176,5,5,0,1,0
2,178,178,32,32,0,1,0
7,184,184,22,6,16,3,2
11,198,198,48,18,30,4,3
8,204,204,11,11,0,1,0
3,217,217,16,7,9,4,3
4,224,224,90,18,72,3,2
15,295,295,62,62,0,1,0
12,299,299,23,15,8,2,1
6,301,301,8,8,0,1,0
13,369,369,34,34,0,1,0
14,372,372,15,15,0,1,0
0,374,374,31,23,8,3,2
9,419,419,21,21,0,1,0
5,445,445,47,14,33,2,1
1,464,464,15,12,3,2,1

10,135,135,2,2,0,1,0
7,142,142,3,3,0,1,0
12,148,148,64,64,0,1,0
5,168,168,6,6,0,1,0
3,179,179,84,39,45,4,3
9,256,256,17,5,12,4,3
8,265,265,34,34,0,1,0
0,287,287,31,23,8,2,1
6,300,300,23,17,6,3,2
4,332,332,89,68,21,4,3
2,395,395,9,1,8,2,1
11,399,399,55,55,0,1,0
1,410,410,14,2,12,4,3
13,433,433,3,3,0,1,0

17,146,146,8,2,6,3,2
18,164,164,6,6,0,1,0
15,183,183,4,4,0,1,0
1,189,189,19,19,0,1,0
11,220,220,13,6,7,2,1
10,231,231,32,20,12,3,2
4,236,236,1,1,0,1,0
0,253,253,25,25,0,1,0
8,324,324,4,4,0,1,0
9,329,329,10,5,5,2,1
3,332,332,17,2,15,4,3
12,340,340,26,26,0,1,0
13,351,351,1,1,0,1,0
2,364,364,24,24,0,1,0
5,371,371,28,22,6,3,2
6,377,377,47,47,0,1,0
19,390,390,115,96,19,2,1
7,393,393,78,2,76,3,2
16,445,445,154,154,0,1,0
14,500,500,15,12,3,2,1

6,120,120,10,10,0,1,0
7,136,136,12,4,8,3,2
9,146,146,2,2,0,1,0
0,148,148,17,17,0,1,0
5,165,165,17,17,0,1,0
12,189,189,2,2,0,1,0
13,197,197,5,5,0,1,0
16,202,202,50,14,36,2,1
1,225,225,62,52,10,3,2
8,303,303,77,9,68,3,2
10,307,307,13,1,12,4,3
14,423,423,69,69,0,1,0
2,444,444,13,13,0,1,0
11,458,458,56,10,46,3,2
4,473,473,49,41,8,2,1
15,474,474,20,4,16,3,2
3,486,486,52,52,0,1,0

3,110,110,3,3,0,1,0
2,131,131,1,1,0,1,0
15,164,164,17,7,10,3,2
14,223,223,12,5,7,2,1
12,230,230,21,21,0,1,0
13,231,231,27,5,22,4,3
5,244,244,20,20,0,1,0
7,317,317,5,5,0,1,0
17,351,351,61,61,0,1,0
8,391,391,67,67,0,1,0
10,412,412,15,15,0,1,0
16,420,420,17,17,0,1,0
11,424,424,14,2,12,4,3
18,425,425,23,23,0,1,0
1,433,433,11,11,0,1,0
19,439,439,64,29,35,2,1
0,447,447,48,26,22,4,3
20,454,454,64,10,54,4,3
4,471,471,21,7,14,2,1
9,476,476,111,111,0,1,0
6,498,498,58,9,49,3,2

21,124,124,6,1,5,2,1
20,130,130,12,12,0,1,0
15,177,177,11,11,0,1,0
5,203,203,26,10,16,2,1
13,218,218,80,34,46,2,1
18,220,220,51,3,48,3,2
19,221,221,6,3,3,2,1
1,232,232,38,38,0,1,0
7,243,243,1,1,0,1,0
9,260,260,22,8,14,3,2
17,262,262,4,4,0,1,0
3,275,275,5,5,0,1,0
8,336,336,8,4,4,2,1
0,350,350,22,1,21,4,3
11,371,371,2,2,0,1,0
14,371,371,9,1,8,3,2
2,374,374,16,5,11,2,1
6,383,383,45,9,36,2,1
10,447,447,1,1,0,1,0
4,448,448,68,68,0,1,0
16,475,475,25,25,0,1,0
12,477,477,46,46,0,1,0

12,107,107,29,15,14,3,2
3,124,124,42,19,23,4,3
1,160,160,4,1,3,2,1
18,164,164,10,1,9,2,1
13,169,169,8,8,0,1,0
11,180,180,8,8,0,1,0
10,186,186,1,1,0,1,0
9,189,189,10,4,6,3,2
6,291,291,1,1,0,1,0
19,292,292,32,32,0,1,0
2,322,322,2,2,0,1,0
17,350,350,7,7,0,1,0
5,371,371,67,67,0,1,0
0,376,376,15,15,0,1,0
4,383,383,2,2,0,1,0
15,411,411,8,8,0,1,0
14,413,413,104,26,78,4,3
7,428,428,11,11,0,1,0
16,430,430,43,5,38,2,1
8,451,451,100,75,25,2,1

10,118,118,25,7,18,3,2
0,170,170,44,29,15,2,1
17,175,175,18,14,4,2,1
11,189,189,7,4,3,2,1
4,203,203,4,4,0,1,0
16,217,217,45,45,0,1,0
19,243,243,13,13,0,1,0
14,282,282,9,6,3,2,1
9,290,290,6,6,0,1,0
3,291,291,7,7,0,1,0
7,294,294,7,7,0,1,0
15,310,310,45,17,28,3,2
12,333,333,101,21,80,3,2
18,333,333,11,4,7,2,1
5,344,344,2,2,0,1,0
8,378,378,109,28,81,4,3
2,400,400,3,3,0,1,0
13,437,437,1,1,0,1,0
1,464,464,1,1,0,1,0
6,492,492,21,21,0,1,0

0,105,105,26,26,0,1,0
3,118,118,5,5,0,1,0
17,152,152,5,5,0,1,0
8,162,162,11,11,0,1,0
7,194,194,4,1,3,2,1
9,225,225,62,36,26,3,2
6,242,242,3,3,0,1,0
10,262,262,40,6,34,3,2
12,280,280,9,9,0,1,0
14,294,294,10,7,3,2,1
5,344,344,24,24,0,1,0
13,357,357,11,4,7,2,1
2,375,375,90,90,0,1,0
4,442,442,81,24,57,4,3
1,466,466,9,9,0,1,0
11,475,475,76,34,42,2,1
15,495,495,4,4,0,1,0
16,500,500,98,79,19,2,1

14,169,169,14,14,0,1,0
5,171,171,28,5,23,2,1
11,197,197,13,2,11,2,1
9,217,217,11,11,0,1,0
1,228,228,16,16,0,1,0
8,236,236,8,1,7,2,1
6,256,256,37,37,0,1,0
10,272,272,85,28,57,3,2
17,323,323,1,1,0,1,0
0,358,358,17,10,7,2,1
16,372,372,68,68,0,1,0
15,389,389,33,3,30,2,1
12,401,401,51,7,44,2,1
2,403,403,19,3,16,3,2
4,428,428,31,31,0,1,0
7,437,437,32,32,0,1,0
13,477,477,4,4,0,1,0
3,498,498,125,125,0,1,0

1,103,103,37,37,0,1,0
5,139,139,7,7,0,1,0
4,150,150,9,9,0,1,0
3,178,178,24,24,0,1,0
12,202,202,44,1,43,2,1
10,237,237,1,1,0,1,0
9,239,239,52,38,14,3,2
11,340,340,1,1,0,1,0
7,356,356,97,21,76,3,2
2,408,408,83,44,39,2,1
0,433,433,90,20,70,3,2
8,470,470,45,9,36,3,2
6,497,497,3,3,0,1,0

0,153,153,2,2,0,1,0
10,155,155,18,18,0,1,0
8,215,215,8,8,0,1,0
13,222,222,13,13,0,1,0
2,252,252,6,6,0,1,0
5,272,272,60,60,0,1,0
12,279,279,21,21,0,1,0
7,308,308,1,1,0,1,0
4,336,336,93,93,0,1,0
16,353,353,9,9,0,1,0
6,367,367,13,4,9,4,3
1,404,404,11,11,0,1,0
9,421,421,38,17,21,4,3
3,453,453,121,73,48,4,3
11,459,459,83,17,66,4,3
14,472,472,61,34,27,4,3
17,479,479,58,58,0,1,0
15,499,499,57,28,29,2,1

11,112,112,6,6,0,1,0
4,129,129,3,3,0,1,0
3,130,130,7,7,0,1,0
14,136,136,3,3,0,1,0
8,172,172,21,21,0,1,0
15,192,192,28,28,0,1,0
12,225,225,26,8,18,3,2
1,236,236,11,3,8,2,1
2,312,312,72,14,58,3,2
0,332,332,127,127,0,1,0
5,337,337,6,6,0,1,0
13,358,358,7,3,4,2,1
7,377,377,96,96,0,1,0
9,385,385,28,4,24,4,3
6,389,389,57,57,0,1,0
10,398,398,46,46,0,1,0

13,119,119,10,10,0,1,0
14,131,131,16,16,0,1,0
10,158,158,8,3,5,2,1
11,179,179,8,4,4,2,1
8,190,190,62,19,43,4,3
2,229,229,37,37,0,1,0
6,301,301,5,5,0,1,0
1,304,304,99,3,96,3,2
15,331,331,2,2,0,1,0
4,335,335,79,79,0,1,0
9,367,367,44,44,0,1,0
7,375,375,6,6,0,1,0
12,390,390,33,33,0,1,0
3,392,392,42,23,19,2,1
5,455,455,11,11,0,1,0
0,459,459,7,7,0,1,0
16,493,493,37,19,18,2,1

9,125,125,41,6,35,4,3
12,150,150,1,1,0,1,0
14,158,158,2,2,0,1,0
8,160,160,15,15,0,1,0
7,191,191,42,15,27,4,3
2,200,200,20,14,6,2,1
6,201,201,6,6,0,1,0
1,235,235,53,53,0,1,0
4,285,285,64,64,0,1,0
11,307,307,65,65,0,1,0
10,311,311,4,4,0,1,0
3,358,358,52,52,0,1,0
5,389,389,76,52,24,4,3
0,434,434,5,5,0,1,0
13,497,497,1,1,0,1,0

12,139,139,1,1,0,1,0
2,183,183,36,36,0,1,0
8,191,191,25,25,0,1,0
1,192,192,5,5,0,1,0
7,216,216,20,12,8,3,2
6,223,223,35,26,9,4,3
3,263,263,58,58,0,1,0
15,269,269,5,5,0,1,0
9,296,296,9,9,0,1,0
14,307,307,37,37,0,1,0
0,397,397,35,28,7,2,1
13,398,398,63,2,61,3,2
4,403,403,12,12,0,1,0
10,439,439,90,90,0,1,0
5,463,463,42,20,22,3,2
16,464,464,49,49,0,1,0
11,483,483,69,36,33,4,3

2,109,109,7,7,0,1,0
8,123,123,2,2,0,1,0
5,173,173,68,68,0,1,0
6,175,175,16,16,0,1,0
13,179,179,1,1,0,1,0
12,191,191,38,38,0,1,0
0,216,216,20,2,18,4,3
7,246,246,2,2,0,1,0
10,252,252,18,18,0,1,0
3,302,302,67,25,42,4,3
4,345,345,28,28,0,1,0
9,401,401,21,11,10,3,2
11,404,404,165,165,0,1,0
1,436,436,23,23,0,1,0
14,449,449,29,6,23,2,1

5,114,114,2,2,0,1,0
3,130,130,39,6,33,2,1
10,207,207,15,15,0,1,0
6,228,228,10,1,9,2,1
9,296,296,4,1,3,2,1
12,302,302,95,53,42,3,2
11,336,336,17,17,0,1,0
7,342,342,83,18,65,4,3
2,379,379,175,128,47,2,1
8,439,439,8,3,5,2,1
0,441,441,20,20,0,1,0
4,455,455,65,65,0,1,0
1,480,480,46,41,5,2,1

4,119,119,2,2,0,1,0
9,177,177,1,1,0,1,0
3,194,194,18,18,0,1,0
7,198,198,27,3,24,2,1
2,215,215,1,1,0,1,0
13,245,245,39,19,20,3,2
8,261,261,2,2,0,1,0
0,296,296,15,15,0,1,0
6,313,313,52,52,0,1,0
1,315,315,88,73,15,4,3
15,317,317,10,10,0,1,0
11,324,324,26,26,0,1,0
5,390,390,57,57,0,1,0
16,397,397,25,25,0,1,0
12,420,420,38,38,0,1,0
14,422,422,19,19,0,1,0
17,447,447,145,145,0,1,0
10,465,465,55,9,46,3,2

10,102,102,4,4,0,1,0
2,102,102,9,3,6,3,2
15,149,149,25,9,16,3,2
16,173,173,1,1,0,1,0
0,177,177,2,2,0,1,0
8,182,182,2,2,0,1,0
5,199,199,1,1,0,1,0
18,249,249,6,6,0,1,0
17,253,253,47,29,18,4,3
3,269,269,31,6,25,2,1
13,290,290,10,10,0,1,0
9,299,299,41,20,21,2,1
12,324,324,17,17,0,1,0
11,369,369,57,57,0,1,0
14,387,387,99,44,55,3,2
4,446,446,6,6,0,1,0
7,453,453,79,51,28,2,1
6,487,487,95,29,66,4,3
1,500,500,76,12,64,3,2

14,116,116,16,4,12,3,2
1,170,170,11,11,0,1,0
17,170,170,9,9,0,1,0
15,208,208,20,20,0,1,0
0,210,210,28,28,0,1,0
9,243,243,34,10,24,2,1
10,246,246,13,6,7,2,1
13,258,258,52,31,21,4,3
2,260,260,9,9,0,1,0
11,262,262,17,8,9,4,3
7,267,267,19,19,0,1,0
18,288,288,40,40,0,1,0
5,307,307,5,5,0,1,0
4,328,328,17,11,6,3,2
12,383,383,48,7,41,2,1
16,429,429,21,6,15,4,3
3,467,467,9,9,0,1,0
6,494,494,62,62,0,1,0
8,500,500,122,101,21,4,3

20,103,103,2,2,0,1,0
21,104,104,29,29,0,1,0
0,107,107,1,1,0,1,0
16,161,161,3,3,0,1,0
2,193,193,23,23,0,1,0
14,196,196,18,1,17,2,1
12,199,199,17,17,0,1,0
9,222,222,21,3,18,2,1
3,245,245,15,15,0,1,0
19,250,250,14,4,10,3,2
13,263,263,24,17,7,2,1
1,270,270,10,10,0,1,0
11,283,283,7,2,5,2,1
8,318,318,45,19,26,2,1
10,321,321,13,13,0,1,0
15,337,337,38,38,0,1,0
17,362,362,57,3,54,4,3
6,405,405,22,22,0,1,0
5,407,407,9,1,8,3,2
4,413,413,67,67,0,1,0
18,463,463,43,22,21,2,1
7,470,470,23,3,20,4,3

6,130,130,5,5,0,1,0
20,154,154,2,2,0,1,0
17,187,187,28,23,5,2,1
16,216,216,35,35,0,1,0
12,239,239,24,24,0,1,0
3,278,278,14,7,7,2,1
4,297,297,40,40,0,1,0
18,336,336,20,20,0,1,0
13,373,373,45,17,28,3,2
7,378,378,124,124,0,1,0
14,384,384,10,10,0,1,0
15,389,389,104,34,70,3,2
1,394,394,5,1,4,2,1
8,401,401,28,1,27,4,3
9,420,420,13,2,11,2,1
11,437,437,27,3,24,3,2
5,439,439,1,1,0,1,0
19,458,458,7,4,3,2,1
2,466,466,46,34,12,2,1
10,468,468,32,32,0,1,0
0,478,478,2,2,0,1,0

9,106,106,10,1,9,4,3
6,107,107,15,7,8,3,2
5,139,139,29,17,12,4,3
12,181,181,11,1,10,3,2
0,237,237,65,65,0,1,0
7,244,244,55,55,0,1,0
8,270,270,39,39,0,1,0
4,354,354,7,7,0,1,0
14,398,398,67,19,48,2,1
15,414,414,29,20,9,2,1
13,460,460,41,41,0,1,0
2,466,466,5,5,0,1,0
1,469,469,1,1,0,1,0
3,475,475,118,68,50,2,1
10,479,479,18,12,6,2,1
11,481,481,16,16,0,1,0

5,125,125,12,7,5,2,1
1,191,191,12,12,0,1,0
11,192,192,22,6,16,3,2
14,277,277,26,26,0,1,0
4,279,279,57,10,47,3,2
9,297,297,75,75,0,1,0
17,309,309,8,2,6,2,1
12,339,339,8,8,0,1,0
0,368,368,74,74,0,1,0
6,394,394,18,18,0,1,0
8,401,401,46,46,0,1,0
15,438,438,52,49,3,2,1
13,445,445,35,9,26,3,2
7,468,468,17,17,0,1,0
2,470,470,11,11,0,1,0
3,471,471,55,55,0,1,0
16,497,497,1,1,0,1,0
10,499,499,101,53,48,4,3

16,103,103,2,2,0,1,0
2,108,108,28,28,0,1,0
8,117,117,11,4,7,2,1
18,119,119,27,6,21,4,3
19,126,126,16,16,0,1,0
17,148,148,1,1,0,1,0
6,194,194,9,2,7,2,1
4,203,203,1,1,0,1,0
7,232,232,13,13,0,1,0
20,276,276,14,14,0,1,0
1,288,288,31,31,0,1,0
15,293,293,16,7,9,2,1
3,298,298,6,6,0,1,0
12,310,310,79,37,42,3,2
11,334,334,24,24,0,1,0
14,368,368,20,20,0,1,0
10,372,372,8,8,0,1,0
5,383,383,33,33,0,1,0
9,427,427,26,26,0,1,0
0,465,465,34,34,0,1,0
13,488,488,63,63,0,1,0

12,121,121,12,12,0,1,0
3,142,142,6,6,0,1,0
10,146,146,4,4,0,1,0
6,168,168,18,8,10,2,1
5,176,176,1,1,0,1,0
23,179,179,58,58,0,1,0
26,202,202,7,7,0,1,0
4,209,209,9,9,0,1,0
8,238,238,11,11,0,1,0
11,242,242,23,23,0,1,0
16,267,267,30,6,24,3,2
20,285,285,21,21,0,1,0
21,302,302,24,17,7,2,1
15,303,303,18,8,10,2,1
0,311,311,22,8,14,4,3
13,350,350,8,1,7,2,1
19,350,350,34,34,0,1,0
7,389,389,9,9,0,1,0
9,392,392,1,1,0,1,0
25,393,393,9,5,4,2,1
17,400,400,14,14,0,1,0
2,435,435,1,1,0,1,0
24,435,435,53,28,25,2,1
14,441,441,13,4,9,3,2
22,458,458,50,50,0,1,0
1,496,496,38,38,0,1,0
18,497,497,26,1,25,2,1

7,114,114,2,2,0,1,0
2,124,124,34,29,5,2,1
5,145,145,7,1,6,3,2
10,167,167,3,3,0,1,0
6,191,191,6,6,0,1,0
3,221,221,9,2,7,2,1
12,250,250,30,4,26,3,2
1,278,278,18,2,16,2,1
13,289,289,73,51,22,2,1
9,295,295,13,3,10,2,1
16,321,321,63,37,26,2,1
15,365,365,5,5,0,1,0
11,375,375,69,69,0,1,0
4,386,386,65,65,0,1,0
0,424,424,111,23,88,4,3
14,432,432,18,9,9,4,3
8,455,455,17,5,12,3,2

10,113,113,22,22,0,1,0
15,121,121,8,2,6,2,1
16,177,177,54,54,0,1,0
11,201,201,15,15,0,1,0
0,223,223,5,5,0,1,0
7,243,243,27,18,9,2,1
14,244,244,33,3,30,3,2
17,266,266,17,17,0,1,0
5,269,269,15,15,0,1,0
12,271,271,6,3,3,2,1
1,280,280,20,5,15,2,1
4,342,342,13,13,0,1,0
2,392,392,7,7,0,1,0
3,399,399,132,62,70,3,2
6,403,403,41,41,0,1,0
13,411,411,19,19,0,1,0
8,458,458,54,54,0,1,0
9,466,466,16,16,0,1,0
18,498,498,9,9,0,1,0

1,133,133,2,2,0,1,0
4,150,150,28,14,14,2,1
0,155,155,3,3,0,1,0
2,167,167,18,5,13,2,1
7,179,179,14,4,10,2,1
15,181,181,5,5,0,1,0
8,200,200,53,14,39,4,3
9,223,223,5,5,0,1,0
12,231,231,11,11,0,1,0
13,260,260,10,4,6,2,1
10,260,260,7,7,0,1,0
18,266,266,7,7,0,1,0
16,295,295,23,15,8,3,2
14,341,341,178,136,42,4,3
6,348,348,22,7,15,2,1
17,349,349,4,4,0,1,0
3,366,366,20,20,0,1,0
5,446,446,40,40,0,1,0
11,483,483,68,58,10,2,1

9,113,113,12,12,0,1,0
11,162,162,19,19,0,1,0
2,164,164,7,3,4,2,1
4,185,185,42,19,23,2,1
10,188,188,45,6,39,4,3
18,243,243,38,3,35,4,3
15,259,259,4,1,3,2,1
8,273,273,77,37,40,2,1
13,320,320,10,10,0,1,0
3,349,349,7,7,0,1,0
12,352,352,67,35,32,2,1
14,363,363,13,13,0,1,0
6,368,368,1,1,0,1,0
17,408,408,8,1,7,2,1
16,411,411,45,45,0,1,0
1,431,431,1,1,0,1,0
5,479,479,38,14,24,3,2
7,483,483,65,39,26,2,1
0,499,499,4,4,0,1,0

19,147,147,2,2,0,1,0
4,173,173,28,3,25,2,1
17,180,180,1,1,0,1,0
13,199,199,29,15,14,4,3
7,221,221,28,10,18,4,3
0,247,247,3,3,0,1,0
1,249,249,7,7,0,1,0
8,258,258,3,3,0,1,0
15,259,259,63,12,51,4,3
2,269,269,6,6,0,1,0
12,272,272,77,77,0,1,0
6,274,274,46,22,24,4,3
11,291,291,14,14,0,1,0
16,314,314,15,15,0,1,0
3,318,318,28,9,19,4,3
18,338,338,4,1,3,2,1
10,365,365,58,58,0,1,0
5,381,381,20,20,0,1,0
9,398,398,28,28,0,1,0
14,421,421,51,18,33,4,3

0,110,110,15,3,12,3,2
10,112,112,7,7,0,1,0
3,131,131,6,6,0,1,0
5,134,134,24,11,13,2,1
19,143,143,9,3,6,3,2
13,144,144,13,13,0,1,0
11,152,152,1,1,0,1,0
2,190,190,48,48,0,1,0
12,206,206,17,17,0,1,0
14,225,225,11,11,0,1,0
4,255,255,5,5,0,1,0
7,264,264,4,4,0,1,0
1,359,359,13,7,6,2,1
17,360,360,166,51,115,4,3
16,411,411,28,28,0,1,0
18,422,422,40,1,39,4,3
8,430,430,2,2,0,1,0
9,442,442,66,66,0,1,0
6,468,468,3,3,0,1,0
15,491,491,2,2,0,1,0

14,116,116,8,3,5,2,1
2,148,148,20,20,0,1,0
15,150,150,8,2,6,3,2
21,165,165,2,2,0,1,0
12,172,172,20,20,0,1,0
11,204,204,3,3,0,1,0
22,209,209,26,2,24,4,3
16,212,212,79,52,27,4,3
17,228,228,33,33,0,1,0
3,233,233,15,4,11,2,1
6,287,287,9,1,8,3,2
9,304,304,11,2,9,4,3
1,315,315,8,8,0,1,0
8,328,328,74,45,29,2,1
7,369,369,12,8,4,2,1
20,382,382,33,33,0,1,0
0,383,383,2,2,0,1,0
4,399,399,2,2,0,1,0
10,409,409,1,1,0,1,0
18,414,414,6,6,0,1,0
19,438,438,23,2,21,4,3
13,441,441,83,58,25,4,3
5,497,497,9,9,0,1,0

3,109,109,4,4,0,1,0
4,124,124,14,14,0,1,0
17,157,157,42,7,35,2,1
19,171,171,16,4,12,3,2
11,175,175,19,19,0,1,0
10,184,184,1,1,0,1,0
0,205,205,12,7,5,2,1
1,213,213,18,18,0,1,0
6,214,214,26,26,0,1,0
5,218,218,23,3,20,3,2
8,248,248,16,16,0,1,0
14,264,264,7,7,0,1,0
2,290,290,22,4,18,3,2
16,298,298,12,5,7,2,1
7,327,327,57,41,16,2,1
12,349,349,4,4,0,1,0
18,389,389,89,89,0,1,0
15,398,398,19,8,11,2,1
13,445,445,43,21,22,3,2
9,475,475,29,20,9,2,1

3,122,122,6,6,0,1,0
14,153,153,24,9,15,2,1
18,158,158,4,4,0,1,0
7,189,189,9,1,8,3,2
13,211,211,13,13,0,1,0
6,217,217,4,4,0,1,0
20,221,221,60,57,3,2,1
10,221,221,38,20,18,4,3
0,231,231,24,24,0,1,0
1,240,240,17,17,0,1,0
2,330,330,14,11,3,2,1
11,336,336,36,36,0,1,0
16,346,346,13,13,0,1,0
5,348,348,12,5,7,2,1
15,352,352,22,22,0,1,0
9,353,353,26,14,12,2,1
4,360,360,52,3,49,2,1
19,393,393,87,47,40,3,2
8,442,442,16,16,0,1,0
17,468,468,10,5,5,2,1
12,500,500,29,6,23,4,3

22,116,116,4,4,0,1,0
1,150,150,1,1,0,1,0
6,151,151,3,3,0,1,0
2,152,152,9,9,0,1,0
0,190,190,5,5,0,1,0
8,270,270,30,30,0,1,0
7,293,293,20,5,15,4,3
13,298,298,46,46,0,1,0
15,306,306,27,27,0,1,0
9,315,315,2,2,0,1,0
3,316,316,1,1,0,1,0
18,392,392,46,46,0,1,0
17,397,397,32,2,30,3,2
11,403,403,6,6,0,1,0
5,404,404,128,43,85,3,2
14,417,417,78,24,54,3,2
4,418,418,23,12,11,2,1
20,418,418,76,76,0,1,0
16,422,422,39,39,0,1,0
19,435,435,29,29,0,1,0
10,455,455,4,1,3,2,1
21,482,482,36,36,0,1,0
12,484,484,24,9,15,4,3

19,124,124,3,3,0,1,0
17,133,133,22,11,11,4,3
12,140,140,12,12,0,1,0
20,143,143,41,15,26,2,1
1,154,154,8,8,0,1,0
0,181,181,2,2,0,1,0
2,185,185,5,5,0,1,0
8,195,195,32,22,10,3,2
21,238,238,6,1,5,2,1
6,245,245,23,23,0,1,0
14,277,277,21,6,15,3,2
7,280,280,7,7,0,1,0
4,282,282,20,20,0,1,0
9,306,306,12,12,0,1,0
11,309,309,14,1,13,2,1
16,311,311,6,6,0,1,0
18,374,374,75,33,42,4,3
15,376,376,39,39,0,1,0
5,399,399,3,3,0,1,0
10,415,415,30,19,11,2,1
22,472,472,6,6,0,1,0
13,482,482,58,58,0,1,0
3,499,499,43,43,0,1,0

14,110,110,18,13,5,2,1
2,134,134,7,2,5,2,1
17,154,154,1,1,0,1,0
5,155,155,1,1,0,1,0
18,158,158,30,26,4,2,1
0,160,160,18,18,0,1,0
10,167,167,7,7,0,1,0
20,199,199,6,6,0,1,0
8,226,226,14,14,0,1,0
4,250,250,45,24,21,4,3
11,274,274,11,11,0,1,0
13,283,283,13,13,0,1,0
12,315,315,1,1,0,1,0
7,340,340,27,27,0,1,0
21,348,348,75,28,47,2,1
19,379,379,76,41,35,2,1
6,407,407,5,5,0,1,0
15,435,435,10,5,5,2,1
9,452,452,94,94,0,1,0
3,460,460,23,23,0,1,0
1,481,481,26,2,24,2,1
16,483,483,23,14,9,4,3

20,124,124,10,1,9,3,2
2,151,151,6,6,0,1,0
12,201,201,2,2,0,1,0
16,257,257,34,34,0,1,0
15,269,269,9,9,0,1,0
6,284,284,21,12,9,4,3
8,288,288,17,1,16,2,1
23,291,291,4,4,0,1,0
22,307,307,52,2,50,2,1
4,326,326,6,1,5,2,1
3,367,367,1,1,0,1,0
14,369,369,49,49,0,1,0
11,377,377,13,13,0,1,0
13,386,386,71,21,50,3,2
1,434,434,53,46,7,2,1
10,435,435,1,1,0,1,0
9,450,450,57,39,18,2,1
0,456,456,6,6,0,1,0
19,465,465,76,76,0,1,0
21,476,476,47,47,0,1,0
5,480,480,36,36,0,1,0
7,480,480,4,4,0,1,0
17,487,487,63,2,61,4,3
18,489,489,44,2,42,2,1

14,119,119,41,12,29,3,2
0,123,123,2,2,0,1,0
3,137,137,20,20,0,1,0
1,149,149,12,3,9,4,3
10,151,151,43,7,36,3,2
2,202,202,8,8,0,1,0
18,204,204,1,1,0,1,0
5,218,218,21,21,0,1,0
19,243,243,17,8,9,4,3
20,254,254,26,18,8,3,2
7,257,257,7,7,0,1,0
11,379,379,4,4,0,1,0
13,392,392,5,5,0,1,0
6,423,423,21,16,5,2,1
17,431,431,28,28,0,1,0
12,432,432,10,4,6,3,2
15,436,436,28,9,19,3,2
16,438,438,104,29,75,4,3
9,470,470,2,2,0,1,0
4,477,477,19,6,13,2,1
8,482,482,51,2,49,2,1

16,140,140,43,43,0,1,0
8,159,159,44,2,42,3,2
15,178,178,28,28,0,1,0
0,200,200,3,3,0,1,0
5,234,234,25,14,11,2,1
3,237,237,67,31,36,3,2
12,243,243,1,1,0,1,0
17,256,256,2,2,0,1,0
10,284,284,27,23,4,2,1
6,288,288,6,6,0,1,0
18,289,289,16,4,12,4,3
4,325,325,12,12,0,1,0
1,339,339,25,25,0,1,0
11,355,355,46,46,0,1,0
7,365,365,7,4,3,2,1
9,383,383,1,1,0,1,0
14,415,415,19,1,18,3,2
2,486,486,33,33,0,1,0
13,498,498,59,13,46,2,1

16,116,116,24,24,0,1,0
6,121,121,7,4,3,2,1
3,122,122,8,4,4,2,1
15,134,134,34,34,0,1,0
18,145,145,13,7,6,2,1
5,151,151,9,1,8,2,1
14,157,157,24,24,0,1,0
4,165,165,8,8,0,1,0
11,178,178,4,4,0,1,0
12,246,246,18,18,0,1,0
17,246,246,3,3,0,1,0
9,259,259,5,2,3,2,1
0,286,286,32,32,0,1,0
13,309,309,4,4,0,1,0
2,317,317,76,76,0,1,0
10,340,340,42,42,0,1,0
19,372,372,36,4,32,2,1
8,374,374,21,13,8,2,1
1,384,384,16,10,6,2,1
7,395,395,31,17,14,3,2

4,105,105,8,8,0,1,0
9,118,118,15,15,0,1,0
15,173,173,3,3,0,1,0
3,176,176,14,14,0,1,0
16,190,190,33,28,5,2,1
20,217,217,9,9,0,1,0
0,220,220,11,5,6,3,2
8,243,243,55,55,0,1,0
17,255,255,66,66,0,1,0
2,271,271,33,33,0,1,0
14,316,316,4,4,0,1,0
6,317,317,22,8,14,3,2
13,322,322,3,3,0,1,0
1,345,345,11,4,7,3,2
18,348,348,107,29,78,3,2
10,398,398,16,1,15,3,2
11,415,415,6,6,0,1,0
12,418,418,15,9,6,3,2
7,426,426,8,8,0,1,0
21,446,446,38,38,0,1,0
5,453,453,4,1,3,2,1
19,468,468,5,5,0,1,0

7,130,130,16,16,0,1,0
8,136,136,14,14,0,1,0
5,165,165,12,12,0,1,0
4,170,170,4,4,0,1,0
1,171,171,8,8,0,1,0
18,189,189,4,1,3,2,1
15,191,191,73,25,48,3,2
6,244,244,1,1,0,1,0
12,251,251,70,70,0,1,0
11,255,255,41,15,26,4,3
19,260,260,4,4,0,1,0
0,327,327,60,60,0,1,0
17,362,362,39,17,22,2,1
20,377,377,14,1,13,2,1
14,382,382,23,23,0,1,0
10,383,383,2,2,0,1,0
3,392,392,32,26,6,3,2
9,413,413,16,2,14,2,1
2,436,436,25,25,0,1,0
13,452,452,4,1,3,2,1
16,463,463,2,2,0,1,0

17,103,103,37,37,0,1,0
6,103,103,4,4,0,1,0
8,114,114,16,4,12,4,3
5,147,147,8,8,0,1,0
18,182,182,1,1,0,1,0
4,194,194,24,24,0,1,0
1,241,241,13,6,7,2,1
12,253,253,21,1,20,4,3
0,276,276,30,8,22,2,1
2,307,307,22,22,0,1,0
7,309,309,28,18,10,3,2
19,353,353,1,1,0,1,0
14,380,380,35,32,3,2,1
10,389,389,40,10,30,3,2
16,405,405,40,40,0,1,0
11,419,419,36,3,33,3,2
13,467,467,47,47,0,1,0
15,474,474,44,4,40,2,1
9,484,484,46,25,21,4,3
3,494,494,10,10,0,1,0

13,108,108,8,2,6,3,2
6,167,167,15,15,0,1,0
4,292,292,8,8,0,1,0
7,317,317,27,2,25,2,1
15,318,318,6,6,0,1,0
1,334,334,17,5,12,4,3
12,335,335,1,1,0,1,0
11,344,344,26,1,25,2,1
14,398,398,6,6,0,1,0
3,421,421,186,186,0,1,0
2,422,422,63,23,40,4,3
9,425,425,56,40,16,2,1
5,430,430,22,22,0,1,0
0,441,441,2,2,0,1,0
16,462,462,107,38,69,4,3
10,487,487,107,101,6,2,1
8,499,499,72,72,0,1,0

10,127,127,6,6,0,1,0
1,148,148,47,25,22,2,1
5,211,211,4,4,0,1,0
7,289,289,13,1,12,3,2
11,322,322,39,32,7,2,1
2,324,324,43,43,0,1,0
8,359,359,48,17,31,2,1
0,387,387,46,42,4,2,1
6,395,395,29,29,0,1,0
4,416,416,109,98,11,2,1
12,441,441,154,147,7,2,1
13,462,462,14,2,12,3,2
3,465,465,33,8,25,2,1
9,470,470,45,45,0,1,0

1,144,144,6,6,0,1,0
6,148,148,2,2,0,1,0
15,154,154,6,6,0,1,0
4,174,174,8,8,0,1,0
7,184,184,15,15,0,1,0
8,214,214,17,1,16,3,2
19,227,227,23,15,8,2,1
14,238,238,47,47,0,1,0
11,244,244,3,3,0,1,0
12,251,251,38,38,0,1,0
3,266,266,14,5,9,2,1
10,271,271,46,46,0,1,0
17,316,316,40,24,16,2,1
2,330,330,66,66,0,1,0
18,365,365,12,2,10,2,1
16,382,382,50,40,10,3,2
0,395,395,69,11,58,4,3
9,409,409,8,8,0,1,0
5,466,466,10,2,8,2,1
13,470,470,59,59,0,1,0

4,119,119,3,3,0,1,0
15,197,197,24,24,0,1,0
16,219,219,41,38,3,2,1
8,225,225,43,15,28,3,2
18,239,239,2,2,0,1,0
10,243,243,26,2,24,3,2
7,244,244,4,4,0,1,0
6,272,272,89,72,17,2,1
12,273,273,21,16,5,2,1
17,285,285,29,15,14,2,1
1,301,301,12,7,5,2,1
11,354,354,1,1,0,1,0
3,359,359,21,1,20,3,2
13,365,365,10,10,0,1,0
5,406,406,1,1,0,1,0
14,416,416,15,15,0,1,0
0,435,435,25,25,0,1,0
19,477,477,170,147,23,2,1
2,490,490,6,6,0,1,0
9,496,496,32,32,0,1,0

13,142,142,18,2,16,3,2
21,146,146,1,1,0,1,0
20,148,148,19,13,6,3,2
16,152,152,8,8,0,1,0
3,165,165,4,4,0,1,0
8,170,170,17,17,0,1,0
17,189,189,5,5,0,1,0
2,193,193,1,1,0,1,0
12,217,217,29,5,24,3,2
4,251,251,8,8,0,1,0
10,253,253,48,48,0,1,0
7,263,263,15,3,12,3,2
15,297,297,6,6,0,1,0
6,325,325,17,13,4,2,1
11,367,367,7,7,0,1,0
19,371,371,40,7,33,4,3
9,384,384,26,17,9,4,3
14,449,449,198,111,87,4,3
0,461,461,18,5,13,2,1
18,475,475,7,4,3,2,1
1,485,485,78,78,0,1,0
5,493,493,11,1,10,3,2

11,101,101,1,1,0,1,0
3,174,174,21,8,13,2,1
12,183,183,34,34,0,1,0
7,217,217,9,9,0,1,0
13,221,221,6,6,0,1,0
0,290,290,23,23,0,1,0
6,320,320,96,96,0,1,0
9,364,364,1,1,0,1,0
1,374,374,83,59,24,4,3
4,406,406,27,27,0,1,0
5,413,413,3,3,0,1,0
14,427,427,111,74,37,2,1
2,436,436,46,6,40,3,2
10,455,455,18,4,14,2,1
8,481,481,67,56,11,2,1
15,496,496,102,88,14,4,3

12,123,123,6,6,0,1,0
9,135,135,5,5,0,1,0
10,149,149,9,6,3,2,1
1,230,230,17,17,0,1,0
20,231,231,69,40,29,2,1
3,252,252,71,33,38,3,2
13,303,303,16,2,14,2,1
2,306,306,32,15,17,2,1
21,308,308,16,3,13,2,1
7,309,309,36,36,0,1,0
4,309,309,1,1,0,1,0
16,311,311,40,40,0,1,0
14,314,314,3,3,0,1,0
17,316,316,28,24,4,2,1
8,317,317,5,5,0,1,0
6,329,329,7,1,6,2,1
0,333,333,20,2,18,3,2
18,432,432,61,61,0,1,0
5,434,434,14,14,0,1,0
15,453,453,24,24,0,1,0
19,469,469,39,39,0,1,0
11,472,472,21,21,0,1,0

10,129,129,19,19,0,1,0
1,136,136,1,1,0,1,0
20,192,192,7,7,0,1,0
4,269,269,13,13,0,1,0
12,291,291,16,1,15,4,3
2,328,328,13,13,0,1,0
7,347,347,13,13,0,1,0
18,347,347,28,28,0,1,0
0,348,348,7,7,0,1,0
21,353,353,15,8,7,2,1
3,382,382,10,10,0,1,0
13,386,386,19,4,15,2,1
6,386,386,27,5,22,3,2
11,393,393,17,17,0,1,0
9,394,394,63,63,0,1,0
17,409,409,9,9,0,1,0
19,410,410,16,2,14,2,1
15,433,433,60,2,58,3,2
5,463,463,23,1,22,2,1
16,467,467,146,128,18,2,1
8,483,483,96,96,0,1,0
14,498,498,93,87,6,2,1

0,132,132,2,2,0,1,0
1,134,134,3,3,0,1,0
5,141,141,17,6,11,2,1
20,185,185,25,2,23,2,1
7,187,187,5,5,0,1,0
14,206,206,3,3,0,1,0
17,220,220,16,16,0,1,0
10,236,236,60,51,9,2,1
11,245,245,13,13,0,1,0
12,259,259,49,4,45,3,2
4,271,271,37,7,30,2,1
15,296,296,42,12,30,2,1
18,296,296,34,34,0,1,0
19,317,317,42,30,12,4,3
3,328,328,2,2,0,1,0
8,336,336,16,9,7,2,1
6,389,389,47,5,42,2,1
9,411,411,27,16,11,3,2
2,446,446,15,15,0,1,0
16,454,454,24,24,0,1,0
13,468,468,29,10,19,2,1

0,101,101,2,2,0,1,0
1,102,102,4,4,0,1,0
3,109,109,2,2,0,1,0
8,110,110,3,3,0,1,0
10,171,171,15,4,11,2,1
20,175,175,23,8,15,4,3
6,199,199,53,33,20,2,1
18,210,210,7,7,0,1,0
7,219,219,9,9,0,1,0
16,246,246,1,1,0,1,0
15,274,274,22,4,18,4,3
17,279,279,90,90,0,1,0
2,281,281,1,1,0,1,0
14,299,299,34,22,12,2,1
4,301,301,1,1,0,1,0
13,320,320,13,13,0,1,0
11,324,324,43,18,25,2,1
5,368,368,10,10,0,1,0
9,419,419,37,6,31,2,1
22,439,439,34,7,27,3,2
21,469,469,34,19,15,4,3
19,476,476,40,31,9,4,3
12,481,481,51,39,12,4,3

7,109,109,7,7,0,1,0
1,115,115,6,3,3,2,1
20,118,118,6,3,3,2,1
13,147,147,18,18,0,1,0
17,158,158,37,37,0,1,0
14,167,167,16,16,0,1,0
9,245,245,5,2,3,2,1
15,290,290,22,22,0,1,0
2,297,297,45,25,20,2,1
19,304,304,15,10,5,2,1
18,347,347,49,36,13,2,1
11,411,411,12,1,11,3,2
6,419,419,43,43,0,1,0
3,458,458,1,1,0,1,0
8,463,463,19,19,0,1,0
12,467,467,63,63,0,1,0
0,475,475,21,21,0,1,0
10,478,478,35,27,8,3,2
4,482,482,57,19,38,3,2
16,492,492,8,8,0,1,0
5,493,493,100,100,0,1,0

11,100,100,6,6,0,1,0
2,109,109,4,4,0,1,0
12,131,131,11,6,5,2,1
18,142,142,9,9,0,1,0
0,191,191,8,8,0,1,0
19,204,204,27,27,0,1,0
16,213,213,37,37,0,1,0
5,214,214,35,35,0,1,0
10,252,252,44,26,18,3,2
4,323,323,17,8,9,4,3
7,373,373,21,21,0,1,0
1,374,374,12,12,0,1,0
15,374,374,37,27,10,3,2
14,391,391,3,3,0,1,0
9,403,403,44,44,0,1,0
8,407,407,10,6,4,2,1
13,410,410,138,62,76,4,3
6,430,430,4,4,0,1,0
3,432,432,26,26,0,1,0
21,452,452,14,14,0,1,0
17,464,464,27,4,23,2,1
20,475,475,6,6,0,1,0

16,105,105,18,18,0,1,0
8,134,134,29,29,0,1,0
7,166,166,29,29,0,1,0
4,201,201,10,4,6,2,1
11,203,203,59,47,12,3,2
1,220,220,3,3,0,1,0
14,231,231,17,11,6,2,1
13,262,262,19,3,16,2,1
10,297,297,3,3,0,1,0
6,303,303,3,3,0,1,0
15,336,336,3,3,0,1,0
12,346,346,91,63,28,3,2
0,366,366,61,35,26,2,1
3,386,386,68,20,48,4,3
5,426,426,11,11,0,1,0
18,428,428,10,10,0,1,0
2,455,455,27,27,0,1,0
9,463,463,4,1,3,2,1
17,496,496,4,4,0,1,0

7,105,105,2,2,0,1,0
0,112,112,2,2,0,1,0
17,113,113,37,37,0,1,0
16,125,125,1,1,0,1,0
15,208,208,33,33,0,1,0
10,230,230,18,8,10,2,1
4,238,238,1,1,0,1,0
2,245,245,2,2,0,1,0
13,262,262,7,2,5,2,1
12,262,262,2,2,0,1,0
5,299,299,162,162,0,1,0
11,300,300,5,5,0,1,0
1,301,301,42,42,0,1,0
14,340,340,78,32,46,2,1
3,392,392,23,5,18,4,3
6,448,448,1,1,0,1,0
8,467,467,51,43,8,2,1
9,474,474,32,32,0,1,0

6,109,109,4,4,0,1,0
7,133,133,40,2,38,2,1
16,147,147,27,7,20,2,1
8,148,148,4,4,0,1,0
9,156,156,17,12,5,2,1
12,159,159,8,8,0,1,0
5,173,173,28,24,4,2,1
15,195,195,3,3,0,1,0
1,196,196,11,11,0,1,0
4,235,235,27,13,14,3,2
3,308,308,16,16,0,1,0
2,358,358,54,4,50,3,2
10,411,411,43,43,0,1,0
13,427,427,44,44,0,1,0
0,467,467,2,2,0,1,0
17,483,483,34,34,0,1,0
14,490,490,118,78,40,3,2
11,498,498,20,20,0,1,0

0,109,109,9,9,0,1,0
4,113,113,5,1,4,2,1
20,130,130,1,1,0,1,0
6,151,151,5,1,4,2,1
1,174,174,4,4,0,1,0
12,190,190,12,12,0,1,0
8,237,237,69,43,26,2,1
15,238,238,6,3,3,2,1
13,277,277,13,13,0,1,0
9,304,304,1,1,0,1,0
22,315,315,41,41,0,1,0
10,322,322,38,38,0,1,0
16,334,334,18,18,0,1,0
21,380,380,8,3,5,2,1
18,391,391,90,9,81,4,3
17,400,400,115,75,40,3,2
7,402,402,2,2,0,1,0
2,405,405,7,7,0,1,0
14,415,415,27,27,0,1,0
5,423,423,3,3,0,1,0
11,435,435,51,51,0,1,0
19,464,464,43,43,0,1,0
3,485,485,24,24,0,1,0

14,140,140,10,4,6,3,2
7,153,153,12,7,5,2,1
3,178,178,29,15,14,2,1
12,194,194,26,8,18,2,1
13,288,288,64,64,0,1,0
9,295,295,78,6,72,4,3
6,351,351,22,22,0,1,0
2,353,353,111,111,0,1,0
8,354,354,1,1,0,1,0
5,360,360,35,35,0,1,0
10,374,374,15,10,5,2,1
1,381,381,51,25,26,2,1
4,406,406,5,1,4,2,1
15,470,470,21,21,0,1,0
0,477,477,56,38,18,3,2
11,490,490,26,26,0,1,0

5,100,100,2,2,0,1,0
13,132,132,1,1,0,1,0
16,134,134,9,3,6,2,1
2,170,170,11,11,0,1,0
4,170,170,31,31,0,1,0
14,228,228,14,14,0,1,0
7,264,264,16,16,0,1,0
12,275,275,3,3,0,1,0
8,366,366,29,14,15,4,3
6,391,391,107,8,99,4,3
3,401,401,33,8,25,2,1
11,412,412,196,92,104,4,3
10,444,444,20,4,16,3,2
9,486,486,3,3,0,1,0
0,487,487,64,15,49,2,1
1,487,487,43,17,26,2,1
15,489,489,81,53,28,3,2

2,117,117,9,3,6,2,1
6,130,130,26,26,0,1,0
8,136,136,11,1,10,3,2
5,149,149,8,8,0,1,0
10,165,165,18,5,13,2,1
1,229,229,2,2,0,1,0
12,235,235,33,3,30,4,3
16,263,263,49,49,0,1,0
4,273,273,15,15,0,1,0
17,304,304,25,10,15,4,3
9,310,310,52,6,46,2,1
13,345,345,19,2,17,2,1
3,391,391,39,5,34,3,2
14,394,394,27,15,12,2,1
7,394,394,118,118,0,1,0
11,443,443,14,14,0,1,0
15,488,488,37,37,0,1,0
0,492,492,16,6,10,3,2

19,158,158,23,1,22,2,1
14,168,168,10,10,0,1,0
3,170,170,2,2,0,1,0
10,195,195,46,46,0,1,0
1,223,223,7,7,0,1,0
12,229,229,19,1,18,3,2
5,233,233,14,14,0,1,0
4,256,256,4,4,0,1,0
16,313,313,26,26,0,1,0
13,370,370,12,12,0,1,0
20,370,370,35,35,0,1,0
6,392,392,57,37,20,2,1
7,407,407,92,63,29,4,3
11,411,411,13,13,0,1,0
9,420,420,2,2,0,1,0
0,424,424,12,12,0,1,0
2,439,439,48,3,45,2,1
15,451,451,49,49,0,1,0
8,458,458,1,1,0,1,0
18,459,459,45,45,0,1,0
17,479,479,103,77,26,2,1

15,102,102,3,3,0,1,0
22,115,115,9,2,7,2,1
2,116,116,3,3,0,1,0
0,132,132,11,7,4,2,1
17,134,134,2,2,0,1,0
4,139,139,1,1,0,1,0
3,210,210,14,5,9,4,3
11,219,219,9,9,0,1,0
19,225,225,10,5,5,2,1
1,226,226,5,5,0,1,0
7,246,246,31,1,30,3,2
12,259,259,8,8,0,1,0
10,323,323,2,2,0,1,0
5,333,333,1,1,0,1,0
20,349,349,69,51,18,3,2
21,362,362,9,9,0,1,0
8,377,377,61,35,26,3,2
9,398,398,59,59,0,1,0
6,417,417,36,32,4,2,1
18,433,433,96,52,44,3,2
16,477,477,104,62,42,4,3
13,492,492,45,1,44,4,3
14,496,496,43,19,24,3,2

0,148,148,13,5,8,3,2
3,150,150,7,7,0,1,0
11,182,182,13,13,0,1,0
7,197,197,12,4,8,3,2
16,199,199,10,10,0,1,0
12,199,199,12,2,10,3,2
6,239,239,53,16,37,2,1
13,295,295,54,54,0,1,0
8,298,298,11,7,4,2,1
9,307,307,14,14,0,1,0
5,313,313,11,5,6,3,2
19,325,325,25,9,16,2,1
10,335,335,41,41,0,1,0
14,365,365,30,12,18,2,1
4,387,387,21,21,0,1,0
17,402,402,96,53,43,3,2
18,419,419,49,49,0,1,0
15,421,421,15,3,12,2,1
1,440,440,73,37,36,4,3
2,442,442,11,11,0,1,0

5,114,114,2,2,0,1,0
12,133,133,34,26,8,2,1
18,145,145,18,18,0,1,0
11,154,154,4,4,0,1,0
8,169,169,24,24,0,1,0
13,182,182,4,4,0,1,0
2,194,194,5,5,0,1,0
9,225,225,12,5,7,2,1
16,233,233,40,13,27,2,1
0,264,264,4,4,0,1,0
1,271,271,34,34,0,1,0
7,290,290,12,12,0,1,0
6,303,303,50,50,0,1,0
15,313,313,82,42,40,2,1
4,339,339,26,15,11,2,1
3,345,345,56,11,45,2,1
14,421,421,18,18,0,1,0
17,441,441,3,3,0,1,0
19,443,443,1,1,0,1,0
10,491,491,37,37,0,1,0

4,134,134,17,17,0,1,0
12,149,149,12,12,0,1,0
9,153,153,25,5,20,3,2
14,155,155,7,7,0,1,0
11,237,237,10,10,0,1,0
16,297,297,37,37,0,1,0
0,324,324,6,6,0,1,0
15,337,337,20,20,0,1,0
6,352,352,1,1,0,1,0
8,367,367,46,46,0,1,0
3,385,385,8,8,0,1,0
2,398,398,88,10,78,4,3
5,428,428,35,20,15,4,3
10,430,430,30,20,10,2,1
1,443,443,46,46,0,1,0
13,477,477,100,46,54,4,3
7,496,496,161,65,96,4,3

13,171,171,10,6,4,2,1
9,185,185,16,16,0,1,0
14,209,209,37,37,0,1,0
1,236,236,106,91,15,4,3
7,265,265,31,22,9,2,1
12,300,300,22,22,0,1,0
5,338,338,70,70,0,1,0
10,350,350,68,6,62,3,2
2,356,356,3,3,0,1,0
11,381,381,35,17,18,4,3
4,385,385,6,6,0,1,0
8,393,393,11,2,9,4,3
15,439,439,40,7,33,4,3
3,461,461,1,1,0,1,0
6,468,468,92,62,30,4,3
0,479,479,11,11,0,1,0

1,115,115,11,4,7,2,1
15,116,116,24,24,0,1,0
6,120,120,8,8,0,1,0
10,159,159,12,12,0,1,0
8,184,184,4,4,0,1,0
7,185,185,3,3,0,1,0
2,213,213,1,1,0,1,0
5,216,216,45,10,35,2,1
11,228,228,7,7,0,1,0
3,241,241,32,8,24,4,3
4,243,243,47,23,24,4,3
20,253,253,12,12,0,1,0
12,255,255,7,4,3,2,1
9,299,299,8,8,0,1,0
18,321,321,42,6,36,4,3
13,328,328,7,1,6,2,1
19,332,332,4,4,0,1,0
14,372,372,58,58,0,1,0
17,390,390,109,109,0,1,0
16,475,475,18,2,16,3,2
0,489,489,15,15,0,1,0

8,124,124,9,9,0,1,0
6,180,180,28,28,0,1,0
13,181,181,6,6,0,1,0
11,192,192,46,25,21,2,1
10,249,249,35,6,29,2,1
9,260,260,1,1,0,1,0
17,325,325,30,30,0,1,0
14,329,329,12,12,0,1,0
1,357,357,82,82,0,1,0
4,359,359,37,27,10,2,1
15,388,388,28,8,20,2,1
5,403,403,17,17,0,1,0
3,432,432,77,31,46,3,2
16,439,439,82,28,54,4,3
7,464,464,9,9,0,1,0
12,469,469,52,52,0,1,0
0,486,486,23,13,10,2,1
2,500,500,30,30,0,1,0

1,145,145,30,23,7,2,1
10,146,146,33,33,0,1,0
5,152,152,27,15,12,4,3
13,212,212,2,2,0,1,0
6,241,241,15,15,0,1,0
7,286,286,27,5,22,2,1
12,287,287,27,1,26,3,2
3,319,319,20,12,8,2,1
14,349,349,7,3,4,2,1
11,351,351,37,37,0,1,0
0,389,389,35,35,0,1,0
2,458,458,111,111,0,1,0
4,467,467,58,46,12,4,3
9,479,479,105,73,32,4,3
8,480,480,40,40,0,1,0

19,111,111,1,1,0,1,0
14,136,136,17,8,9,4,3
18,142,142,9,3,6,3,2
16,148,148,36,36,0,1,0
3,165,165,3,3,0,1,0
13,186,186,1,1,0,1,0
4,216,216,20,20,0,1,0
7,225,225,6,6,0,1,0
5,233,233,67,37,30,4,3
17,237,237,14,4,10,4,3
15,251,251,23,23,0,1,0
6,261,261,11,3,8,3,2
11,264,264,19,19,0,1,0
1,332,332,2,2,0,1,0
2,353,353,44,16,28,4,3
10,384,384,58,34,24,2,1
9,391,391,47,13,34,2,1
0,395,395,1,1,0,1,0
8,411,411,12,7,5,2,1
12,490,490,125,91,34,3,2

12,102,102,13,13,0,1,0
4,153,153,23,2,21,4,3
5,185,185,3,3,0,1,0
10,187,187,12,2,10,3,2
11,188,188,36,36,0,1,0
8,206,206,10,1,9,3,2
0,245,245,51,51,0,1,0
7,255,255,23,11,12,4,3
1,276,276,73,73,0,1,0
3,358,358,87,3,84,3,2
2,359,359,67,42,25,3,2
6,369,369,64,38,26,2,1
9,402,402,26,26,0,1,0

9,111,111,17,6,11,2,1
12,154,154,1,1,0,1,0
17,170,170,20,5,15,2,1
2,216,216,30,30,0,1,0
15,219,219,13,4,9,2,1
21,255,255,16,9,7,2,1
19,265,265,28,28,0,1,0
13,274,274,6,6,0,1,0
1,276,276,84,42,42,2,1
6,295,295,2,2,0,1,0
3,331,331,4,4,0,1,0
5,365,365,11,11,0,1,0
7,370,370,36,36,0,1,0
14,389,389,104,30,74,4,3
18,402,402,4,4,0,1,0
8,411,411,3,3,0,1,0
0,421,421,23,23,0,1,0
20,432,432,42,42,0,1,0
10,444,444,11,11,0,1,0
4,452,452,5,5,0,1,0
16,455,455,78,28,50,3,2
11,477,477,28,6,22,3,2

11,110,110,16,5,11,2,1
12,126,126,2,2,0,1,0
8,143,143,6,6,0,1,0
4,145,145,11,6,5,2,1
15,151,151,2,2,0,1,0
1,181,181,23,23,0,1,0
6,190,190,33,33,0,1,0
13,198,198,4,4,0,1,0
14,277,277,49,27,22,3,2
5,307,307,1,1,0,1,0
7,330,330,71,27,44,3,2
17,337,337,15,15,0,1,0
16,340,340,25,25,0,1,0
0,340,340,12,12,0,1,0
3,392,392,45,45,0,1,0
9,441,441,73,73,0,1,0
2,447,447,51,5,46,2,1
10,472,472,124,74,50,2,1

2,162,162,6,6,0,1,0
8,177,177,48,2,46,4,3
5,188,188,22,10,12,4,3
15,191,191,2,2,0,1,0
11,237,237,9,9,0,1,0
17,263,263,13,13,0,1,0
0,290,290,7,4,3,2,1
9,307,307,30,1,29,2,1
10,336,336,81,81,0,1,0
1,368,368,16,16,0,1,0
16,374,374,4,4,0,1,0
13,382,382,76,10,66,4,3
12,410,410,20,20,0,1,0
4,433,433,5,5,0,1,0
3,445,445,157,47,110,4,3
7,459,459,13,13,0,1,0
6,480,480,8,1,7,2,1
14,486,486,105,105,0,1,0

20,131,131,2,2,0,1,0
2,144,144,1,1,0,1,0
16,145,145,20,20,0,1,0
18,149,149,8,8,0,1,0
13,158,158,15,3,12,3,2
23,160,160,1,1,0,1,0
12,169,169,11,11,0,1,0
17,191,191,23,13,10,2,1
25,197,197,4,4,0,1,0
4,201,201,5,5,0,1,0
0,221,221,7,1,6,3,2
6,232,232,11,1,10,2,1
9,250,250,24,9,15,4,3
21,250,250,32,32,0,1,0
1,252,252,6,1,5,2,1
5,264,264,5,5,0,1,0
24,269,269,126,85,41,2,1
8,300,300,1,1,0,1,0
19,324,324,28,28,0,1,0
11,332,332,37,21,16,3,2
3,344,344,2,2,0,1,0
15,346,346,8,2,6,3,2
7,383,383,34,34,0,1,0
14,384,384,46,12,34,2,1
22,404,404,11,2,9,2,1
10,419,419,1,1,0,1,0

13,110,110,16,8,8,3,2
1,169,169,43,24,19,2,1
17,177,177,7,3,4,2,1
9,183,183,9,9,0,1,0
16,199,199,1,1,0,1,0
10,209,209,22,10,12,4,3
7,212,212,9,9,0,1,0
0,228,228,7,7,0,1,0
12,245,245,14,5,9,2,1
4,252,252,6,6,0,1,0
15,253,253,6,6,0,1,0
11,255,255,57,1,56,3,2
5,280,280,23,8,15,2,1
14,312,312,85,27,58,4,3
2,317,317,1,1,0,1,0
3,349,349,36,19,17,2,1
6,393,393,66,8,58,4,3
18,484,484,25,25,0,1,0
8,489,489,71,71,0,1,0

9,130,130,7,7,0,1,0
5,132,132,26,26,0,1,0
2,153,153,1,1,0,1,0
11,153,153,6,2,4,2,1
3,167,167,18,12,6,3,2
0,173,173,22,22,0,1,0
12,178,178,14,14,0,1,0
7,192,192,29,17,12,4,3
6,238,238,32,32,0,1,0
13,240,240,13,1,12,2,1
10,297,297,5,5,0,1,0
17,303,303,62,62,0,1,0
1,351,351,45,45,0,1,0
4,369,369,2,2,0,1,0
8,417,417,18,10,8,2,1
16,444,444,125,56,69,4,3
14,445,445,7,7,0,1,0
15,467,467,83,83,0,1,0

15,115,115,4,4,0,1,0
18,139,139,16,7,9,4,3
11,180,180,6,6,0,1,0
13,184,184,34,18,16,3,2
9,186,186,5,5,0,1,0
19,211,211,1,1,0,1,0
20,220,220,13,1,12,2,1
16,261,261,11,11,0,1,0
0,276,276,4,4,0,1,0
2,287,287,11,11,0,1,0
21,297,297,21,21,0,1,0
8,304,304,9,9,0,1,0
6,317,317,46,1,45,4,3
5,330,330,41,41,0,1,0
4,361,361,3,3,0,1,0
1,370,370,118,64,54,4,3
14,387,387,56,2,54,4,3
3,400,400,3,3,0,1,0
12,423,423,40,20,20,3,2
10,469,469,26,4,22,2,1
7,481,481,2,2,0,1,0
17,494,494,133,93,40,3,2

3,109,109,7,7,0,1,0
12,119,119,23,9,14,3,2
13,135,135,24,16,8,2,1
2,145,145,11,2,9,4,3
15,146,146,23,23,0,1,0
14,176,176,2,2,0,1,0
7,187,187,22,22,0,1,0
10,209,209,4,1,3,2,1
11,254,254,37,22,15,2,1
5,274,274,20,15,5,2,1
8,390,390,8,8,0,1,0
1,428,428,14,14,0,1,0
6,453,453,108,46,62,3,2
4,459,459,168,105,63,4,3
0,467,467,24,24,0,1,0
9,479,479,40,28,12,3,2

7,113,113,4,4,0,1,0
13,134,134,26,1,25,2,1
2,139,139,10,10,0,1,0
10,139,139,1,1,0,1,0
19,150,150,9,9,0,1,0
9,156,156,44,44,0,1,0
17,176,176,29,29,0,1,0
11,181,181,3,3,0,1,0
4,216,216,4,4,0,1,0
14,292,292,26,26,0,1,0
5,324,324,20,5,15,2,1
6,340,340,23,23,0,1,0
18,342,342,3,3,0,1,0
3,425,425,4,4,0,1,0
16,434,434,8,2,6,3,2
8,442,442,17,5,12,4,3
20,447,447,46,46,0,1,0
0,455,455,33,33,0,1,0
1,470,470,105,15,90,4,3
12,473,473,37,37,0,1,0
15,497,497,102,33,69,4,3

17,100,100,6,6,0,1,0
14,106,106,9,9,0,1,0
9,110,110,1,1,0,1,0
11,190,190,1,1,0,1,0
16,196,196,29,9,20,2,1
1,205,205,2,2,0,1,0
5,239,239,4,1,3,2,1
20,268,268,30,21,9,4,3
10,289,289,1,1,0,1,0
8,291,291,1,1,0,1,0
13,303,303,19,4,15,4,3
18,304,304,59,59,0,1,0
23,321,321,46,27,19,4,3
7,327,327,17,17,0,1,0
19,332,332,63,1,62,3,2
2,339,339,66,66,0,1,0
6,360,360,65,15,50,4,3
3,362,362,21,9,12,2,1
22,383,383,7,3,4,2,1
0,398,398,12,12,0,1,0
15,405,405,2,2,0,1,0
4,405,405,39,39,0,1,0
24,411,411,21,21,0,1,0
21,446,446,1,1,0,1,0
12,475,475,42,21,21,4,3

0,101,101,1,1,0,1,0
19,108,108,27,27,0,1,0
4,114,114,6,2,4,2,1
10,139,139,12,12,0,1,0
3,189,189,8,4,4,2,1
17,228,228,2,2,0,1,0
5,230,230,27,9,18,4,3
12,263,263,15,1,14,2,1
21,296,296,1,1,0,1,0
2,320,320,38,4,34,2,1
20,326,326,9,3,6,2,1
16,334,334,62,8,54,4,3
1,338,338,23,23,0,1,0
7,341,341,9,2,7,2,1
14,396,396,31,31,0,1,0
6,402,402,8,8,0,1,0
8,408,408,60,30,30,3,2
22,410,410,50,38,12,2,1
13,416,416,40,10,30,2,1
11,416,416,8,2,6,2,1
18,417,417,14,14,0,1,0
9,458,458,18,6,12,3,2
15,475,475,99,31,68,3,2

17,102,102,14,14,0,1,0
2,132,132,3,3,0,1,0
15,209,209,13,13,0,1,0
10,211,211,7,4,3,2,1
6,218,218,47,47,0,1,0
14,244,244,16,16,0,1,0
7,288,288,23,23,0,1,0
18,306,306,9,9,0,1,0
19,316,316,43,43,0,1,0
3,317,317,13,5,8,2,1
8,331,331,22,15,7,2,1
4,332,332,3,3,0,1,0
16,341,341,8,8,0,1,0
12,370,370,69,69,0,1,0
1,389,389,92,8,84,4,3
11,393,393,86,12,74,3,2
9,416,416,48,44,4,2,1
13,447,447,26,26,0,1,0
0,474,474,15,5,10,3,2
5,477,477,24,6,18,3,2

13,132,132,4,4,0,1,0
11,147,147,18,9,9,4,3
12,164,164,9,2,7,2,1
3,178,178,1,1,0,1,0
0,193,193,4,4,0,1,0
8,196,196,13,13,0,1,0
7,287,287,30,15,15,4,3
2,290,290,69,69,0,1,0
4,294,294,2,2,0,1,0
15,312,312,74,74,0,1,0
6,368,368,17,17,0,1,0
16,381,381,92,92,0,1,0
5,407,407,121,121,0,1,0
9,426,426,55,5,50,2,1
10,430,430,2,2,0,1,0
14,460,460,16,16,0,1,0
1,485,485,88,18,70,4,3

8,107,107,8,8,0,1,0
16,118,118,25,8,17,2,1
2,141,141,5,2,3,2,1
12,166,166,2,2,0,1,0
4,189,189,67,67,0,1,0
5,238,238,6,6,0,1,0
6,241,241,11,11,0,1,0
3,242,242,24,24,0,1,0
13,249,249,22,10,12,4,3
18,286,286,28,4,24,3,2
9,292,292,17,17,0,1,0
14,323,323,58,37,21,4,3
1,329,329,21,15,6,3,2
17,353,353,21,21,0,1,0
7,388,388,50,50,0,1,0
0,394,394,6,1,5,2,1
10,415,415,3,3,0,1,0
11,480,480,116,44,72,4,3
15,498,498,6,2,4,2,1

5,111,111,1,1,0,1,0
7,113,113,16,16,0,1,0
8,118,118,1,1,0,1,0
10,133,133,27,18,9,4,3
14,155,155,10,10,0,1,0
12,192,192,18,18,0,1,0
4,242,242,13,13,0,1,0
21,261,261,7,7,0,1,0
0,273,273,20,11,9,4,3
13,273,273,15,8,7,3,2
6,305,305,37,37,0,1,0
22,331,331,2,2,0,1,0
11,346,346,6,6,0,1,0
18,347,347,50,50,0,1,0
17,352,352,34,11,23,2,1
20,371,371,30,30,0,1,0
9,406,406,8,8,0,1,0
16,444,444,47,17,30,4,3
1,445,445,4,4,0,1,0
2,452,452,1,1,0,1,0
3,452,452,43,3,40,3,2
15,470,470,68,68,0,1,0
19,470,470,116,82,34,3,2

12,113,113,4,4,0,1,0
5,121,121,7,7,0,1,0
6,133,133,1,1,0,1,0
10,143,143,2,2,0,1,0
14,158,158,3,3,0,1,0
0,185,185,52,52,0,1,0
13,243,243,28,28,0,1,0
1,281,281,70,24,46,3,2
4,284,284,46,38,8,2,1
9,294,294,108,67,41,4,3
8,304,304,31,7,24,4,3
2,321,321,1,1,0,1,0
15,359,359,8,5,3,2,1
11,431,431,79,79,0,1,0
7,435,435,29,29,0,1,0
3,490,490,70,52,18,3,2

8,105,105,17,8,9,4,3
12,138,138,13,13,0,1,0
18,163,163,3,3,0,1,0
4,170,170,4,4,0,1,0
19,174,174,9,3,6,3,2
11,201,201,40,13,27,3,2
16,208,208,10,1,9,2,1
10,214,214,16,16,0,1,0
3,238,238,9,6,3,2,1
1,248,248,14,14,0,1,0
17,282,282,76,34,42,4,3
13,306,306,39,27,12,4,3
15,307,307,25,25,0,1,0
14,335,335,11,11,0,1,0
5,349,349,18,4,14,3,2
2,373,373,38,6,32,2,1
0,376,376,33,3,30,4,3
6,400,400,33,24,9,4,3
9,436,436,84,74,10,2,1
7,457,457,14,2,12,3,2

18,154,154,23,23,0,1,0
10,191,191,1,1,0,1,0
13,194,194,30,9,21,3,2
14,218,218,4,4,0,1,0
6,237,237,6,6,0,1,0
4,242,242,12,12,0,1,0
12,254,254,12,12,0,1,0
8,277,277,1,1,0,1,0
2,292,292,53,30,23,2,1
0,299,299,39,39,0,1,0
1,318,318,22,9,13,2,1
5,325,325,32,32,0,1,0
11,344,344,71,22,49,2,1
15,403,403,98,98,0,1,0
3,415,415,81,75,6,2,1
9,441,441,36,4,32,2,1
16,442,442,17,5,12,3,2
7,494,494,33,33,0,1,0
17,499,499,26,16,10,2,1

5,127,127,5,1,4,2,1
9,143,143,2,2,0,1,0
1,179,179,3,3,0,1,0
6,202,202,7,7,0,1,0
7,213,213,17,3,14,2,1
2,224,224,33,33,0,1,0
15,229,229,54,6,48,3,2
3,238,238,30,2,28,4,3
13,244,244,2,2,0,1,0
8,278,278,94,48,46,2,1
20,278,278,6,6,0,1,0
4,319,319,10,10,0,1,0
0,321,321,2,2,0,1,0
10,333,333,3,3,0,1,0
17,333,333,7,4,3,2,1
19,362,362,39,39,0,1,0
11,381,381,8,8,0,1,0
12,393,393,15,9,6,2,1
18,395,395,123,9,114,4,3
16,413,413,29,29,0,1,0
21,423,423,10,10,0,1,0
14,467,467,53,26,27,4,3

11,116,116,28,16,12,4,3
12,122,122,11,11,0,1,0
8,145,145,2,2,0,1,0
5,330,330,88,38,50,3,2
2,344,344,15,3,12,2,1
10,348,348,52,16,36,4,3
7,362,362,2,2,0,1,0
0,363,363,63,63,0,1,0
9,384,384,57,39,18,2,1
6,408,408,37,37,0,1,0
4,437,437,35,15,20,3,2
3,440,440,117,117,0,1,0
14,444,444,23,13,10,2,1
1,463,463,33,21,12,3,2
13,476,476,59,59,0,1,0

4,122,122,7,7,0,1,0
5,126,126,3,3,0,1,0
11,132,132,12,6,6,3,2
15,143,143,8,4,4,2,1
12,162,162,14,14,0,1,0
14,176,176,23,23,0,1,0
17,239,239,37,37,0,1,0
0,249,249,32,32,0,1,0
3,272,272,12,2,10,3,2
8,277,277,29,9,20,2,1
10,338,338,47,11,36,4,3
6,361,361,75,75,0,1,0
16,362,362,16,16,0,1,0
9,370,370,28,16,12,4,3
7,416,416,44,44,0,1,0
2,420,420,6,2,4,2,1
1,422,422,59,59,0,1,0
18,432,432,30,22,8,2,1
13,495,495,73,73,0,1,0

5,117,117,1,1,0,1,0
9,130,130,19,6,13,4,3
14,142,142,8,8,0,1,0
1,145,145,29,29,0,1,0
17,163,163,6,6,0,1,0
10,195,195,39,39,0,1,0
2,197,197,15,15,0,1,0
3,272,272,6,6,0,1,0
4,289,289,58,43,15,2,1
6,323,323,16,13,3,2,1
11,341,341,25,11,14,2,1
18,351,351,34,34,0,1,0
13,375,375,90,90,0,1,0
16,417,417,43,16,27,4,3
8,419,419,34,15,19,2,1
12,422,422,7,7,0,1,0
7,436,436,23,23,0,1,0
0,446,446,31,20,11,2,1
15,462,462,39,35,4,2,1

0,142,142,16,6,10,3,2
17,147,147,11,3,8,2,1
10,186,186,12,12,0,1,0
7,206,206,28,16,12,3,2
11,251,251,4,4,0,1,0
5,299,299,5,5,0,1,0
8,303,303,49,49,0,1,0
12,322,322,1,1,0,1,0
3,332,332,133,133,0,1,0
1,339,339,4,1,3,2,1
13,350,350,14,1,13,4,3
9,365,365,40,2,38,3,2
16,411,411,197,185,12,3,2
15,417,417,6,2,4,2,1
2,477,477,6,6,0,1,0
4,483,483,1,1,0,1,0
6,484,484,23,23,0,1,0
14,497,497,56,32,24,3,2

20,138,138,3,3,0,1,0
4,142,142,3,3,0,1,0
1,193,193,9,9,0,1,0
14,198,198,33,7,26,2,1
9,226,226,9,9,0,1,0
5,229,229,35,6,29,2,1
11,278,278,44,8,36,3,2
2,284,284,1,1,0,1,0
17,293,293,22,22,0,1,0
16,309,309,88,88,0,1,0
0,319,319,1,1,0,1,0
6,355,355,34,34,0,1,0
10,363,363,8,2,6,3,2
15,431,431,16,7,9,4,3
13,439,439,40,40,0,1,0
3,441,441,2,2,0,1,0
7,458,458,22,11,11,2,1
8,466,466,143,143,0,1,0
12,469,469,28,28,0,1,0
19,469,469,40,4,36,2,1
18,495,495,47,20,27,4,3

11,124,124,2,2,0,1,0
3,150,150,12,6,6,2,1
15,182,182,38,14,24,3,2
14,189,189,21,21,0,1,0
2,246,246,84,84,0,1,0
12,269,269,2,2,0,1,0
16,275,275,29,29,0,1,0
8,284,284,69,21,48,4,3
6,298,298,1,1,0,1,0
5,300,300,30,10,20,3,2
9,305,305,42,42,0,1,0
0,334,334,78,18,60,3,2
10,356,356,11,11,0,1,0
7,377,377,3,3,0,1,0
4,403,403,47,1,46,3,2
1,462,462,9,9,0,1,0
13,478,478,27,27,0,1,0

9,189,189,49,49,0,1,0
14,202,202,27,27,0,1,0
7,204,204,12,12,0,1,0
6,280,280,21,7,14,2,1
15,282,282,50,50,0,1,0
8,288,288,38,38,0,1,0
16,300,300,26,8,18,4,3
5,325,325,25,25,0,1,0
11,327,327,12,12,0,1,0
17,342,342,7,7,0,1,0
2,379,379,40,28,12,2,1
4,379,379,119,119,0,1,0
12,411,411,35,35,0,1,0
3,412,412,49,49,0,1,0
0,427,427,8,8,0,1,0
10,428,428,6,6,0,1,0
13,491,491,48,44,4,2,1
1,499,499,1,1,0,1,0

1,107,107,4,4,0,1,0
14,120,120,4,4,0,1,0
6,126,126,42,18,24,4,3
15,146,146,6,1,5,2,1
11,166,166,22,7,15,4,3
13,177,177,34,34,0,1,0
20,216,216,27,10,17,2,1
7,232,232,1,1,0,1,0
19,259,259,19,19,0,1,0
8,286,286,3,3,0,1,0
16,290,290,107,97,10,2,1
4,293,293,24,24,0,1,0
3,311,311,8,1,7,3,2
5,316,316,11,3,8,3,2
18,319,319,1,1,0,1,0
10,331,331,23,1,22,3,2
9,368,368,24,24,0,1,0
17,422,422,1,1,0,1,0
2,454,454,15,15,0,1,0
0,462,462,35,35,0,1,0
12,489,489,39,39,0,1,0

13,109,109,1,1,0,1,0
15,115,115,19,19,0,1,0
2,131,131,6,6,0,1,0
0,157,157,28,28,0,1,0
5,159,159,3,3,0,1,0
10,202,202,4,4,0,1,0
4,214,214,48,48,0,1,0
3,216,216,32,32,0,1,0
12,231,231,6,6,0,1,0
7,244,244,5,1,4,2,1
8,279,279,34,1,33,2,1
6,282,282,28,1,27,4,3
16,286,286,63,33,30,2,1
19,292,292,16,16,0,1,0
14,294,294,12,12,0,1,0
18,301,301,63,63,0,1,0
17,358,358,55,27,28,2,1
9,444,444,3,3,0,1,0
11,472,472,22,19,3,2,1
1,487,487,10,2,8,3,2

17,101,101,1,1,0,1,0
0,125,125,1,1,0,1,0
9,136,136,25,25,0,1,0
3,147,147,4,4,0,1,0
14,209,209,27,27,0,1,0
2,214,214,24,24,0,1,0
6,220,220,1,1,0,1,0
13,238,238,18,6,12,3,2
1,255,255,12,4,8,2,1
4,278,278,52,52,0,1,0
7,280,280,101,101,0,1,0
11,324,324,9,9,0,1,0
15,395,395,45,27,18,3,2
10,405,405,24,24,0,1,0
16,426,426,96,48,48,4,3
5,442,442,37,23,14,3,2
12,462,462,42,4,38,2,1
8,470,470,33,33,0,1,0

9,141,141,13,1,12,4,3
6,143,143,14,8,6,3,2
12,170,170,8,8,0,1,0
5,225,225,6,1,5,2,1
4,238,238,33,33,0,1,0
14,271,271,6,6,0,1,0
13,288,288,61,22,39,3,2
11,293,293,12,4,8,3,2
1,295,295,47,47,0,1,0
7,300,300,86,67,19,2,1
8,315,315,27,15,12,3,2
2,359,359,11,11,0,1,0
0,362,362,71,21,50,3,2
15,434,434,44,44,0,1,0
10,476,476,16,16,0,1,0
3,481,481,121,72,49,4,3

4,103,103,1,1,0,1,0
9,117,117,25,7,18,3,2
5,145,145,11,11,0,1,0
15,181,181,10,6,4,2,1
14,237,237,26,6,20,2,1
1,249,249,23,13,10,3,2
6,335,335,41,41,0,1,0
10,335,335,14,14,0,1,0
13,346,346,35,8,27,2,1
11,372,372,31,31,0,1,0
16,372,372,17,4,13,2,1
0,378,378,10,4,6,3,2
17,410,410,21,1,20,2,1
3,412,412,145,145,0,1,0
2,422,422,43,43,0,1,0
7,432,432,28,28,0,1,0
8,478,478,27,27,0,1,0
12,481,481,105,105,0,1,0

4,119,119,1,1,0,1,0
6,179,179,20,20,0,1,0
1,207,207,29,18,11,2,1
0,210,210,36,36,0,1,0
9,252,252,18,18,0,1,0
12,265,265,8,8,0,1,0
2,311,311,99,92,7,2,1
15,339,339,62,62,0,1,0
7,355,355,10,10,0,1,0
3,365,365,41,1,40,2,1
10,419,419,73,7,66,4,3
8,427,427,19,4,15,2,1
5,443,443,17,3,14,3,2
11,453,453,40,40,0,1,0
13,491,491,64,13,51,3,2
14,494,494,79,79,0,1,0

6,133,133,7,7,0,1,0
5,138,138,16,2,14,2,1
7,141,141,1,1,0,1,0
4,154,154,35,35,0,1,0
15,157,157,13,13,0,1,0
1,160,160,33,33,0,1,0
8,171,171,53,1,52,3,2
0,251,251,24,8,16,3,2
11,283,283,47,47,0,1,0
14,289,289,46,3,43,4,3
9,301,301,23,23,0,1,0
10,340,340,10,1,9,4,3
2,355,355,66,20,46,3,2
13,385,385,18,18,0,1,0
12,391,391,17,8,9,4,3
3,432,432,8,8,0,1,0

2,105,105,13,13,0,1,0
10,132,132,7,7,0,1,0
13,173,173,59,15,44,3,2
5,191,191,41,20,21,2,1
15,207,207,24,18,6,3,2
11,215,215,4,4,0,1,0
8,235,235,9,9,0,1,0
1,237,237,72,2,70,4,3
12,241,241,40,22,18,2,1
6,297,297,13,13,0,1,0
3,302,302,47,29,18,2,1
0,308,308,6,2,4,2,1
9,350,350,25,2,23,2,1
14,397,397,28,4,24,4,3
4,411,411,16,5,11,4,3
7,470,470,18,18,0,1,0

2,128,128,8,8,0,1,0
20,137,137,3,3,0,1,0
8,189,189,26,8,18,4,3
0,193,193,9,2,7,2,1
18,199,199,18,6,12,2,1
3,203,203,8,8,0,1,0
5,207,207,14,14,0,1,0
9,222,222,22,7,15,3,2
15,243,243,89,59,30,4,3
14,257,257,17,9,8,3,2
10,263,263,23,11,12,4,3
16,299,299,80,49,31,2,1
6,306,306,19,19,0,1,0
7,326,326,30,16,14,3,2
12,337,337,8,8,0,1,0
11,338,338,10,1,9,4,3
17,386,386,2,2,0,1,0
1,396,396,12,12,0,1,0
21,404,404,6,1,5,2,1
13,433,433,26,26,0,1,0
19,445,445,9,4,5,2,1
4,466,466,57,57,0,1,0

16,171,171,9,9,0,1,0
17,184,184,16,16,0,1,0
12,206,206,5,5,0,1,0
2,222,222,7,1,6,2,1
1,256,256,18,14,4,2,1
6,262,262,2,2,0,1,0
15,273,273,11,11,0,1,0
5,287,287,15,15,0,1,0
11,309,309,35,35,0,1,0
14,359,359,62,24,38,3,2
0,378,378,6,1,5,2,1
9,395,395,55,55,0,1,0
7,407,407,22,22,0,1,0
10,423,423,58,16,42,2,1
13,426,426,63,63,0,1,0
4,468,468,21,13,8,3,2
8,473,473,194,179,15,4,3
3,486,486,104,61,43,4,3

1,122,122,1,1,0,1,0
9,136,136,6,6,0,1,0
8,144,144,2,2,0,1,0
11,165,165,14,14,0,1,0
0,166,166,4,4,0,1,0
20,174,174,17,17,0,1,0
17,178,178,1,1,0,1,0
15,222,222,13,13,0,1,0
10,248,248,8,8,0,1,0
6,308,308,59,59,0,1,0
2,312,312,49,49,0,1,0
14,332,332,126,126,0,1,0
18,344,344,14,14,0,1,0
13,355,355,8,3,5,2,1
12,357,357,54,54,0,1,0
16,386,386,33,33,0,1,0
4,393,393,62,43,19,2,1
5,408,408,11,6,5,2,1
19,422,422,33,3,30,2,1
7,475,475,71,8,63,3,2
3,487,487,5,5,0,1,0

14,105,105,8,4,4,2,1
15,123,123,10,1,9,2,1
8,133,133,15,15,0,1,0
20,139,139,7,7,0,1,0
22,142,142,11,7,4,2,1
9,188,188,24,15,9,4,3
17,195,195,10,10,0,1,0
5,215,215,2,2,0,1,0
0,220,220,13,1,12,2,1
6,245,245,30,23,7,2,1
11,262,262,1,1,0,1,0
10,265,265,1,1,0,1,0
18,266,266,12,4,8,2,1
3,273,273,3,3,0,1,0
19,293,293,67,67,0,1,0
2,297,297,2,2,0,1,0
4,357,357,7,2,5,2,1
7,375,375,52,16,36,3,2
12,376,376,5,2,3,2,1
16,392,392,26,26,0,1,0
23,404,404,36,1,35,2,1
21,417,417,101,97,4,2,1
1,446,446,67,10,57,4,3
13,483,483,25,25,0,1,0

6,102,102,27,27,0,1,0
10,206,206,14,10,4,2,1
11,224,224,63,63,0,1,0
1,237,237,37,16,21,2,1
5,280,280,8,8,0,1,0
8,316,316,21,21,0,1,0
0,329,329,7,7,0,1,0
12,354,354,67,21,46,2,1
14,369,369,5,5,0,1,0
7,370,370,54,54,0,1,0
16,384,384,46,46,0,1,0
9,390,390,6,6,0,1,0
3,395,395,58,58,0,1,0
13,401,401,30,4,26,4,3
4,407,407,54,30,24,2,1
15,424,424,37,37,0,1,0
2,456,456,2,2,0,1,0

17,161,161,14,14,0,1,0
9,163,163,3,3,0,1,0
11,163,163,12,12,0,1,0
0,196,196,6,1,5,2,1
7,200,200,4,4,0,1,0
1,219,219,4,1,3,2,1
2,263,263,28,18,10,3,2
4,298,298,27,15,12,4,3
3,299,299,82,43,39,2,1
16,310,310,2,2,0,1,0
15,319,319,50,50,0,1,0
13,336,336,20,20,0,1,0
6,339,339,7,7,0,1,0
18,346,346,62,62,0,1,0
10,362,362,5,2,3,2,1
5,370,370,90,75,15,4,3
14,394,394,70,70,0,1,0
8,432,432,35,4,31,3,2
12,498,498,79,4,75,4,3

2,107,107,20,20,0,1,0
10,110,110,3,3,0,1,0
18,114,114,13,1,12,2,1
0,160,160,6,2,4,2,1
11,181,181,9,9,0,1,0
19,196,196,33,33,0,1,0
17,204,204,29,29,0,1,0
6,224,224,56,56,0,1,0
16,227,227,29,29,0,1,0
1,238,238,17,14,3,2,1
8,273,273,4,4,0,1,0
7,303,303,1,1,0,1,0
13,346,346,11,11,0,1,0
3,383,383,64,64,0,1,0
4,393,393,22,17,5,2,1
15,459,459,53,53,0,1,0
5,461,461,4,4,0,1,0
9,467,467,38,22,16,3,2
14,482,482,49,9,40,3,2
12,485,485,34,34,0,1,0

4,138,138,4,1,3,2,1
7,162,162,6,6,0,1,0
15,173,173,8,8,0,1,0
5,175,175,1,1,0,1,0
9,210,210,13,9,4,2,1
3,229,229,3,3,0,1,0
12,234,234,7,7,0,1,0
11,267,267,33,19,14,2,1
16,337,337,81,81,0,1,0
0,346,346,24,24,0,1,0
8,351,351,15,15,0,1,0
10,355,355,43,43,0,1,0
14,355,355,64,45,19,2,1
6,396,396,103,103,0,1,0
13,399,399,42,42,0,1,0
17,402,402,3,3,0,1,0
2,409,409,81,51,30,3,2
1,448,448,110,44,66,4,3

10,100,100,2,2,0,1,0
6,107,107,3,3,0,1,0
19,119,119,1,1,0,1,0
14,209,209,10,10,0,1,0
9,215,215,14,14,0,1,0
8,223,223,22,22,0,1,0
1,252,252,20,20,0,1,0
15,263,263,38,6,32,3,2
21,283,283,12,12,0,1,0
18,291,291,12,7,5,2,1
4,296,296,1,1,0,1,0
0,305,305,39,19,20,3,2
3,324,324,10,1,9,4,3
22,329,329,44,5,39,4,3
23,337,337,72,22,50,2,1
5,339,339,29,29,0,1,0
12,348,348,5,5,0,1,0
16,385,385,12,12,0,1,0
17,393,393,12,12,0,1,0
13,414,414,23,3,20,2,1
7,414,414,12,12,0,1,0
2,418,418,25,3,22,2,1
20,475,475,129,115,14,2,1
11,477,477,76,76,0,1,0

12,129,129,4,1,3,2,1
5,138,138,7,7,0,1,0
15,165,165,56,56,0,1,0
7,179,179,1,1,0,1,0
9,198,198,2,2,0,1,0
19,200,200,16,16,0,1,0
14,230,230,9,9,0,1,0
20,239,239,8,1,7,2,1
11,246,246,5,5,0,1,0
21,248,248,22,13,9,4,3
4,276,276,32,28,4,2,1
0,283,283,30,12,18,4,3
10,287,287,51,21,30,3,2
17,299,299,78,78,0,1,0
1,316,316,28,28,0,1,0
13,386,386,1,1,0,1,0
16,418,418,9,9,0,1,0
18,421,421,21,15,6,2,1
8,444,444,29,11,18,3,2
2,457,457,46,27,19,2,1
6,460,460,22,16,6,2,1
3,487,487,40,9,31,3,2

15,127,127,23,3,20,3,2
17,144,144,8,8,0,1,0
16,152,152,18,2,16,2,1
18,166,166,36,36,0,1,0
3,168,168,3,3,0,1,0
10,182,182,28,28,0,1,0
5,199,199,6,6,0,1,0
6,252,252,2,2,0,1,0
14,255,255,9,9,0,1,0
7,263,263,28,1,27,3,2
1,286,286,52,52,0,1,0
9,298,298,13,2,11,2,1
13,338,338,21,21,0,1,0
8,394,394,3,3,0,1,0
11,410,410,16,16,0,1,0
4,411,411,1,1,0,1,0
0,425,425,47,47,0,1,0
2,465,465,183,147,36,2,1
12,470,470,27,27,0,1,0

4,122,122,24,2,22,2,1
11,176,176,3,3,0,1,0
3,201,201,7,1,6,3,2
0,280,280,69,69,0,1,0
8,286,286,15,15,0,1,0
6,318,318,78,6,72,3,2
12,344,344,94,82,12,3,2
14,345,345,63,30,33,4,3
10,348,348,6,6,0,1,0
7,367,367,12,12,0,1,0
15,383,383,40,40,0,1,0
5,384,384,45,6,39,2,1
13,421,421,17,8,9,4,3
16,435,435,60,55,5,2,1
2,443,443,11,11,0,1,0
1,475,475,1,1,0,1,0
9,496,496,44,44,0,1,0

16,115,115,20,20,0,1,0
22,115,115,6,6,0,1,0
3,133,133,18,8,10,2,1
8,146,146,1,1,0,1,0
11,146,146,1,1,0,1,0
14,162,162,3,3,0,1,0
20,186,186,24,24,0,1,0
12,209,209,6,6,0,1,0
10,209,209,7,7,0,1,0
15,211,211,29,25,4,2,1
19,240,240,12,4,8,2,1
18,267,267,15,15,0,1,0
17,289,289,82,56,26,3,2
4,324,324,6,6,0,1,0
21,371,371,8,8,0,1,0
6,373,373,1,1,0,1,0
7,394,394,81,39,42,2,1
2,396,396,15,3,12,3,2
0,406,406,3,3,0,1,0
13,454,454,118,60,58,4,3
1,460,460,30,4,26,4,3
9,476,476,5,5,0,1,0
5,499,499,41,3,38,3,2

7,149,149,3,3,0,1,0
1,162,162,11,11,0,1,0
4,180,180,14,14,0,1,0
2,207,207,23,17,6,2,1
9,218,218,7,7,0,1,0
19,229,229,24,9,15,2,1
5,251,251,11,4,7,2,1
8,252,252,43,43,0,1,0
6,255,255,31,31,0,1,0
11,272,272,62,62,0,1,0
3,281,281,27,27,0,1,0
14,283,283,8,8,0,1,0
15,310,310,26,26,0,1,0
18,336,336,12,12,0,1,0
17,363,363,89,33,56,4,3
13,381,381,1,1,0,1,0
12,405,405,43,22,21,4,3
16,445,445,36,7,29,2,1
0,452,452,17,3,14,3,2
10,490,490,60,44,16,4,3

10,100,100,8,2,6,3,2
3,136,136,12,12,0,1,0
4,139,139,16,4,12,4,3
2,141,141,9,9,0,1,0
8,173,173,6,6,0,1,0
9,173,173,5,5,0,1,0
7,174,174,22,22,0,1,0
15,193,193,3,3,0,1,0
12,229,229,8,8,0,1,0
6,274,274,82,20,62,3,2
16,302,302,64,64,0,1,0
0,304,304,1,1,0,1,0
1,348,348,5,2,3,2,1
17,360,360,53,3,50,3,2
18,367,367,64,64,0,1,0
13,384,384,13,8,5,2,1
11,457,457,19,19,0,1,0
5,465,465,61,13,48,2,1
14,490,490,83,83,0,1,0

16,134,134,9,3,6,2,1
9,148,148,9,4,5,2,1
12,156,156,9,9,0,1,0
8,161,161,2,2,0,1,0
7,162,162,9,9,0,1,0
10,180,180,19,3,16,2,1
0,183,183,6,6,0,1,0
17,198,198,15,3,12,2,1
4,202,202,8,8,0,1,0
11,228,228,34,6,28,2,1
5,250,250,24,24,0,1,0
6,343,343,166,166,0,1,0
3,368,368,27,19,8,3,2
1,374,374,5,5,0,1,0
2,379,379,37,14,23,4,3
14,423,423,7,7,0,1,0
15,432,432,131,125,6,2,1
13,490,490,48,39,9,2,1

18,102,102,27,24,3,2,1
16,120,120,3,3,0,1,0
6,146,146,4,1,3,2,1
12,178,178,6,6,0,1,0
22,189,189,15,15,0,1,0
20,192,192,30,8,22,4,3
1,251,251,5,5,0,1,0
11,274,274,17,17,0,1,0
4,280,280,54,54,0,1,0
10,287,287,17,2,15,4,3
0,291,291,6,6,0,1,0
14,307,307,40,40,0,1,0
17,307,307,17,17,0,1,0
5,349,349,15,15,0,1,0
9,367,367,40,4,36,3,2
15,368,368,17,5,12,4,3
2,412,412,12,12,0,1,0
7,418,418,45,45,0,1,0
3,431,431,1,1,0,1,0
21,461,461,57,27,30,4,3
19,473,473,17,13,4,2,1
13,480,480,71,31,40,2,1
8,483,483,22,15,7,2,1

17,105,105,4,4,0,1,0
19,122,122,9,1,8,3,2
1,134,134,5,5,0,1,0
12,140,140,26,2,24,4,3
3,165,165,6,2,4,2,1
18,188,188,17,17,0,1,0
8,192,192,19,13,6,2,1
4,243,243,18,18,0,1,0
14,262,262,22,9,13,2,1
16,275,275,22,12,10,2,1
13,307,307,11,11,0,1,0
6,311,311,1,1,0,1,0
7,321,321,11,11,0,1,0
10,329,329,8,8,0,1,0
5,349,349,40,40,0,1,0
9,370,370,7,2,5,2,1
0,398,398,43,43,0,1,0
11,402,402,92,92,0,1,0
2,434,434,53,38,15,2,1
20,448,448,64,10,54,3,2
15,453,453,86,86,0,1,0

9,140,140,1,1,0,1,0
18,150,150,10,10,0,1,0
11,223,223,62,30,32,4,3
10,223,223,4,4,0,1,0
17,249,249,3,3,0,1,0
1,253,253,25,16,9,4,3
4,282,282,5,5,0,1,0
0,287,287,9,9,0,1,0
14,296,296,6,2,4,2,1
6,332,332,93,77,16,3,2
15,342,342,6,6,0,1,0
2,355,355,21,4,17,2,1
7,356,356,28,14,14,3,2
12,356,356,79,79,0,1,0
16,359,359,31,5,26,3,2
5,389,389,9,9,0,1,0
8,402,402,70,17,53,3,2
3,453,453,61,43,18,3,2
13,466,466,90,72,18,2,1

7,117,117,5,2,3,2,1
8,118,118,2,2,0,1,0
5,143,143,7,7,0,1,0
3,152,152,1,1,0,1,0
9,186,186,2,2,0,1,0
12,197,197,94,53,41,4,3
4,220,220,73,24,49,2,1
13,245,245,15,11,4,2,1
6,272,272,26,26,0,1,0
10,272,272,62,62,0,1,0
2,299,299,54,37,17,4,3
0,308,308,28,28,0,1,0
1,342,342,51,21,30,3,2
15,401,401,4,1,3,2,1
11,416,416,9,6,3,2,1
14,500,500,26,26,0,1,0

6,135,135,15,1,14,3,2
0,139,139,37,37,0,1,0
8,176,176,5,1,4,2,1
4,188,188,1,1,0,1,0
1,223,223,23,23,0,1,0
2,236,236,16,16,0,1,0
10,258,258,77,77,0,1,0
14,265,265,47,7,40,3,2
5,299,299,49,15,34,3,2
7,305,305,70,33,37,2,1
15,328,328,31,4,27,4,3
12,333,333,4,4,0,1,0
13,369,369,3,3,0,1,0
11,431,431,9,9,0,1,0
9,435,435,20,14,6,2,1
3,480,480,88,88,0,1,0

3,145,145,16,4,12,2,1
9,150,150,19,19,0,1,0
11,162,162,27,4,23,2,1
10,174,174,47,47,0,1,0
13,177,177,13,13,0,1,0
2,182,182,1,1,0,1,0
12,202,202,3,3,0,1,0
0,224,224,49,49,0,1,0
14,250,250,9,1,8,3,2
7,258,258,11,2,9,4,3
8,303,303,11,7,4,2,1
1,356,356,79,11,68,3,2
6,416,416,6,6,0,1,0
4,465,465,102,13,89,4,3
5,494,494,55,5,50,2,1
15,497,497,76,64,12,4,3

10,109,109,39,39,0,1,0
0,148,148,5,5,0,1,0
7,165,165,22,22,0,1,0
13,203,203,4,4,0,1,0
3,245,245,29,22,7,2,1
14,251,251,3,3,0,1,0
5,302,302,36,36,0,1,0
6,303,303,48,39,9,2,1
9,329,329,21,21,0,1,0
1,355,355,27,27,0,1,0
8,362,362,39,39,0,1,0
11,391,391,6,6,0,1,0
2,392,392,185,115,70,4,3
4,471,471,38,24,14,2,1
12,487,487,20,14,6,3,2

0,131,131,19,6,13,2,1
1,213,213,23,10,13,2,1
12,239,239,33,33,0,1,0
10,331,331,23,23,0,1,0
5,345,345,75,75,0,1,0
8,357,357,13,13,0,1,0
11,378,378,56,56,0,1,0
7,423,423,7,1,6,2,1
6,424,424,42,42,0,1,0
2,428,428,12,12,0,1,0
9,432,432,9,9,0,1,0
4,450,450,77,35,42,2,1
3,473,473,293,293,0,1,0

8,106,106,2,2,0,1,0
14,110,110,4,4,0,1,0
6,162,162,36,3,33,4,3
7,175,175,11,11,0,1,0
5,201,201,5,5,0,1,0
15,202,202,16,16,0,1,0
17,238,238,51,5,46,2,1
1,262,262,44,44,0,1,0
0,268,268,3,3,0,1,0
2,289,289,6,6,0,1,0
9,293,293,12,12,0,1,0
16,314,314,6,6,0,1,0
13,330,330,60,21,39,4,3
3,333,333,85,80,5,2,1
11,347,347,84,84,0,1,0
4,378,378,46,46,0,1,0
10,390,390,16,7,9,2,1
12,451,451,25,25,0,1,0

15,115,115,10,4,6,2,1
1,118,118,16,16,0,1,0
3,140,140,5,5,0,1,0
12,141,141,5,5,0,1,0
9,154,154,7,4,3,2,1
7,167,167,38,20,18,4,3
8,186,186,41,9,32,2,1
13,195,195,47,35,12,3,2
11,217,217,29,29,0,1,0
0,233,233,3,3,0,1,0
14,236,236,68,68,0,1,0
6,269,269,16,9,7,2,1
18,332,332,26,26,0,1,0
17,346,346,1,1,0,1,0
5,371,371,54,36,18,2,1
10,378,378,13,13,0,1,0
2,404,404,6,6,0,1,0
16,435,435,6,6,0,1,0
4,440,440,3,3,0,1,0

3,102,102,1,1,0,1,0
10,113,113,3,3,0,1,0
12,146,146,15,15,0,1,0
7,159,159,5,5,0,1,0
11,214,214,2,2,0,1,0
2,272,272,31,19,12,4,3
1,285,285,14,14,0,1,0
15,296,296,55,10,45,4,3
9,319,319,122,80,42,4,3
5,325,325,72,72,0,1,0
6,335,335,49,49,0,1,0
14,345,345,27,6,21,4,3
8,347,347,31,31,0,1,0
0,409,409,132,132,0,1,0
13,443,443,9,9,0,1,0
4,488,488,18,5,13,3,2

3,114,114,2,2,0,1,0
5,117,117,14,10,4,2,1
6,134,134,1,1,0,1,0
15,135,135,25,25,0,1,0
18,155,155,21,9,12,2,1
13,267,267,59,59,0,1,0
11,273,273,1,1,0,1,0
12,282,282,4,1,3,2,1
7,285,285,43,43,0,1,0
17,304,304,8,3,5,2,1
4,350,350,53,35,18,4,3
20,359,359,37,12,25,4,3
16,359,359,25,17,8,2,1
10,374,374,89,44,45,4,3
19,379,379,42,42,0,1,0
0,423,423,7,7,0,1,0
9,431,431,9,6,3,2,1
8,447,447,39,21,18,3,2
14,471,471,25,7,18,4,3
1,474,474,30,30,0,1,0
2,493,493,12,12,0,1,0

3,107,107,20,20,0,1,0
11,121,121,5,2,3,2,1
8,122,122,6,6,0,1,0
14,128,128,19,9,10,3,2
0,140,140,39,19,20,2,1
10,215,215,24,15,9,4,3
5,235,235,1,1,0,1,0
13,241,241,60,43,17,2,1
1,281,281,9,9,0,1,0
18,302,302,37,12,25,2,1
17,305,305,4,4,0,1,0
16,306,306,15,10,5,2,1
7,321,321,11,11,0,1,0
12,324,324,9,9,0,1,0
15,328,328,51,13,38,2,1
9,385,385,7,4,3,2,1
4,433,433,73,73,0,1,0
6,449,449,26,16,10,3,2
2,468,468,33,3,30,4,3

2,124,124,14,14,0,1,0
5,156,156,9,1,8,2,1
1,158,158,12,2,10,2,1
15,158,158,5,5,0,1,0
7,214,214,43,13,30,2,1
9,230,230,19,12,7,2,1
4,255,255,36,7,29,3,2
6,277,277,32,32,0,1,0
16,310,310,74,26,48,4,3
12,311,311,11,11,0,1,0
0,313,313,17,7,10,2,1
8,370,370,13,1,12,4,3
13,370,370,88,45,43,2,1
10,400,400,17,17,0,1,0
3,428,428,61,61,0,1,0
11,439,439,84,73,11,2,1
14,439,439,8,8,0,1,0

6,114,114,30,30,0,1,0
3,132,132,2,2,0,1,0
10,138,138,18,1,17,2,1
1,155,155,10,3,7,2,1
15,200,200,21,21,0,1,0
7,264,264,31,31,0,1,0
12,268,268,11,5,6,2,1
0,295,295,8,4,4,2,1
4,312,312,72,72,0,1,0
9,317,317,25,25,0,1,0
2,322,322,58,30,28,3,2
13,377,377,57,7,50,3,2
5,384,384,1,1,0,1,0
16,400,400,20,20,0,1,0
11,405,405,31,31,0,1,0
14,407,407,65,65,0,1,0
8,409,409,50,6,44,2,1

5,108,108,37,23,14,2,1
4,117,117,1,1,0,1,0
13,148,148,53,53,0,1,0
0,149,149,16,16,0,1,0
12,157,157,4,4,0,1,0
14,203,203,7,1,6,3,2
8,270,270,32,32,0,1,0
9,281,281,23,23,0,1,0
11,282,282,3,3,0,1,0
10,329,329,23,23,0,1,0
2,350,350,63,28,35,4,3
1,355,355,55,30,25,2,1
3,358,358,40,40,0,1,0
7,396,396,81,81,0,1,0
6,477,477,5,5,0,1,0

0,102,102,10,4,6,3,2
4,113,113,15,7,8,3,2
2,149,149,7,2,5,2,1
21,197,197,8,8,0,1,0
9,200,200,14,14,0,1,0
10,201,201,5,5,0,1,0
7,241,241,9,6,3,2,1
15,245,245,46,46,0,1,0
20,276,276,19,19,0,1,0
18,277,277,7,2,5,2,1
13,286,286,17,6,11,2,1
23,298,298,43,43,0,1,0
17,326,326,34,17,17,4,3
1,379,379,47,31,16,2,1
11,382,382,23,23,0,1,0
6,385,385,6,6,0,1,0
5,385,385,6,1,5,2,1
14,402,402,2,2,0,1,0
12,410,410,14,4,10,3,2
8,431,431,68,32,36,3,2
19,435,435,22,22,0,1,0
3,437,437,9,2,7,2,1
16,459,459,129,16,113,4,3
22,466,466,7,7,0,1,0

11,106,106,8,2,6,3,2
6,151,151,1,1,0,1,0
9,191,191,33,3,30,2,1
14,195,195,13,13,0,1,0
3,199,199,23,4,19,2,1
1,221,221,8,8,0,1,0
17,225,225,5,2,3,2,1
13,265,265,34,34,0,1,0
18,274,274,59,47,12,3,2
2,274,274,9,9,0,1,0
4,300,300,30,25,5,2,1
16,332,332,14,8,6,3,2
5,369,369,39,39,0,1,0
8,382,382,31,31,0,1,0
0,423,423,63,24,39,2,1
7,426,426,32,32,0,1,0
12,438,438,8,8,0,1,0
15,446,446,90,76,14,3,2
10,457,457,12,2,10,2,1
19,470,470,67,67,0,1,0

11,103,103,28,28,0,1,0
14,118,118,7,7,0,1,0
0,125,125,19,4,15,2,1
6,128,128,26,26,0,1,0
8,203,203,30,5,25,2,1
13,232,232,11,11,0,1,0
16,246,246,15,8,7,2,1
3,338,338,6,3,3,2,1
7,346,346,85,85,0,1,0
15,348,348,42,42,0,1,0
10,379,379,17,17,0,1,0
12,381,381,45,45,0,1,0
1,386,386,18,18,0,1,0
4,415,415,36,36,0,1,0
9,433,433,24,24,0,1,0
5,444,444,64,64,0,1,0
2,493,493,3,3,0,1,0

11,108,108,5,5,0,1,0
6,128,128,1,1,0,1,0
19,145,145,8,8,0,1,0
7,161,161,21,21,0,1,0
5,167,167,23,23,0,1,0
15,168,168,31,31,0,1,0
12,180,180,3,3,0,1,0
9,222,222,1,1,0,1,0
10,245,245,27,27,0,1,0
13,252,252,35,29,6,2,1
3,318,318,13,13,0,1,0
1,347,347,17,17,0,1,0
17,366,366,26,26,0,1,0
14,384,384,29,21,8,3,2
16,414,414,113,113,0,1,0
4,419,419,50,23,27,4,3
18,430,430,25,14,11,3,2
0,433,433,61,46,15,2,1
2,433,433,28,6,22,3,2
8,458,458,44,44,0,1,0

17,101,101,4,1,3,2,1
4,143,143,6,6,0,1,0
7,169,169,1,1,0,1,0
3,211,211,2,2,0,1,0
14,246,246,21,21,0,1,0
12,265,265,57,39,18,4,3
11,269,269,22,15,7,2,1
6,270,270,11,8,3,2,1
0,291,291,35,3,32,3,2
15,298,298,4,4,0,1,0
9,320,320,67,43,24,4,3
8,365,365,59,59,0,1,0
10,387,387,13,13,0,1,0
2,409,409,45,30,15,3,2
5,432,432,40,40,0,1,0
1,434,434,138,109,29,3,2
13,468,468,16,3,13,4,3
16,492,492,98,50,48,3,2

12,125,125,26,22,4,2,1
8,160,160,17,17,0,1,0
7,166,166,30,3,27,4,3
5,172,172,7,3,4,2,1
10,193,193,4,4,0,1,0
9,203,203,4,4,0,1,0
1,218,218,37,21,16,2,1
18,226,226,9,6,3,2,1
16,227,227,17,17,0,1,0
13,262,262,37,37,0,1,0
17,263,263,12,4,8,3,2
14,278,278,2,2,0,1,0
0,297,297,1,1,0,1,0
2,305,305,31,7,24,4,3
3,338,338,30,30,0,1,0
19,352,352,35,35,0,1,0
15,358,358,17,17,0,1,0
11,397,397,21,21,0,1,0
6,436,436,33,7,26,3,2
4,467,467,19,19,0,1,0
20,495,495,124,124,0,1,0

11,102,102,17,3,14,2,1
17,151,151,9,9,0,1,0
10,164,164,8,8,0,1,0
13,165,165,13,4,9,4,3
4,171,171,15,15,0,1,0
14,186,186,3,3,0,1,0
18,256,256,1,1,0,1,0
19,262,262,34,34,0,1,0
3,269,269,5,5,0,1,0
20,281,281,88,88,0,1,0
8,360,360,28,14,14,2,1
7,361,361,16,3,13,2,1
9,387,387,20,2,18,2,1
1,410,410,11,2,9,2,1
16,417,417,90,33,57,4,3
0,421,421,23,8,15,4,3
2,441,441,67,67,0,1,0
5,470,470,61,4,57,4,3
12,474,474,16,1,15,2,1
15,480,480,30,23,7,2,1
6,481,481,22,19,3,2,1

6,102,102,15,1,14,2,1
8,139,139,34,10,24,3,2
0,143,143,50,38,12,2,1
11,144,144,14,14,0,1,0
15,223,223,5,1,4,2,1
4,240,240,3,3,0,1,0
2,241,241,12,12,0,1,0
1,243,243,28,28,0,1,0
5,245,245,53,26,27,4,3
7,261,261,43,5,38,3,2
12,287,287,5,5,0,1,0
3,330,330,6,6,0,1,0
9,356,356,18,18,0,1,0
13,445,445,22,4,18,4,3
14,474,474,102,102,0,1,0
10,489,489,26,11,15,4,3

1,109,109,1,1,0,1,0
12,152,152,26,16,10,3,2
3,162,162,13,8,5,2,1
5,201,201,38,38,0,1,0
8,203,203,2,2,0,1,0
14,214,214,4,4,0,1,0
18,262,262,38,29,9,2,1
17,271,271,44,27,17,3,2
16,280,280,6,3,3,2,1
6,315,315,20,1,19,2,1
4,318,318,4,4,0,1,0
15,320,320,11,11,0,1,0
13,328,328,61,61,0,1,0
11,335,335,34,34,0,1,0
2,352,352,11,4,7,3,2
10,367,367,30,30,0,1,0
7,391,391,86,12,74,3,2
0,411,411,81,81,0,1,0
9,468,468,41,23,18,4,3

1,155,155,12,1,11,2,1
4,162,162,19,19,0,1,0
2,172,172,17,17,0,1,0
11,192,192,4,4,0,1,0
7,202,202,34,22,12,3,2
9,216,216,12,12,0,1,0
16,218,218,76,56,20,2,1
0,234,234,10,1,9,2,1
10,270,270,5,5,0,1,0
14,275,275,40,40,0,1,0
6,294,294,101,101,0,1,0
12,295,295,33,33,0,1,0
3,333,333,9,9,0,1,0
5,352,352,10,7,3,2,1
8,375,375,19,19,0,1,0
13,448,448,63,13,50,3,2
15,460,460,12,6,6,2,1

18,105,105,11,11,0,1,0
13,137,137,7,7,0,1,0
2,151,151,5,5,0,1,0
23,168,168,14,6,8,2,1
7,183,183,22,22,0,1,0
5,188,188,14,14,0,1,0
17,229,229,67,67,0,1,0
3,234,234,30,2,28,3,2
14,277,277,17,17,0,1,0
19,288,288,28,10,18,2,1
9,292,292,37,27,10,2,1
11,294,294,2,2,0,1,0
15,295,295,6,6,0,1,0
20,317,317,5,1,4,2,1
10,318,318,2,2,0,1,0
6,320,320,18,18,0,1,0
16,326,326,40,2,38,3,2
12,349,349,20,20,0,1,0
8,365,365,25,25,0,1,0
21,368,368,26,26,0,1,0
22,372,372,4,4,0,1,0
1,394,394,2,2,0,1,0
24,481,481,58,34,24,3,2
0,482,482,41,41,0,1,0
4,483,483,1,1,0,1,0

17,104,104,14,8,6,2,1
21,142,142,45,45,0,1,0
13,189,189,6,6,0,1,0
20,222,222,8,2,6,3,2
2,232,232,19,3,16,3,2
5,291,291,19,19,0,1,0
24,294,294,14,7,7,2,1
14,294,294,44,27,17,2,1
15,294,294,19,19,0,1,0
11,330,330,24,24,0,1,0
4,379,379,23,23,0,1,0
3,379,379,55,55,0,1,0
0,402,402,8,8,0,1,0
12,416,416,13,13,0,1,0
9,422,422,18,18,0,1,0
1,422,422,1,1,0,1,0
16,428,428,3,3,0,1,0
18,433,433,33,3,30,4,3
10,437,437,6,6,0,1,0
22,449,449,4,4,0,1,0
6,456,456,10,10,0,1,0
19,481,481,8,8,0,1,0
23,489,489,135,98,37,2,1
7,493,493,8,4,4,2,1
8,497,497,40,40,0,1,0

7,103,103,8,8,0,1,0
10,105,105,1,1,0,1,0
8,123,123,5,2,3,2,1
1,136,136,57,4,53,3,2
9,139,139,6,6,0,1,0
4,155,155,22,22,0,1,0
3,158,158,42,42,0,1,0
11,188,188,43,43,0,1,0
5,198,198,1,1,0,1,0
0,352,352,66,66,0,1,0
6,401,401,45,45,0,1,0
2,454,454,134,94,40,3,2

17,100,100,3,3,0,1,0
0,106,106,2,2,0,1,0
11,111,111,30,12,18,2,1
7,132,132,3,3,0,1,0
19,141,141,13,7,6,2,1
1,156,156,11,5,6,3,2
3,176,176,18,6,12,3,2
4,195,195,44,14,30,3,2
10,206,206,28,28,0,1,0
8,321,321,1,1,0,1,0
6,332,332,32,32,0,1,0
9,340,340,56,9,47,3,2
13,347,347,60,24,36,3,2
18,402,402,90,64,26,2,1
12,421,421,20,20,0,1,0
2,422,422,17,12,5,2,1
16,426,426,23,23,0,1,0
5,443,443,10,5,5,2,1
14,448,448,3,3,0,1,0
15,451,451,9,3,6,2,1

11,136,136,18,18,0,1,0
8,154,154,1,1,0,1,0
6,155,155,5,5,0,1,0
15,220,220,30,21,9,2,1
12,223,223,42,42,0,1,0
0,231,231,26,7,19,2,1
14,257,257,6,6,0,1,0
7,287,287,37,19,18,3,2
5,321,321,44,44,0,1,0
4,324,324,102,75,27,2,1
13,328,328,18,18,0,1,0
16,338,338,1,1,0,1,0
1,347,347,26,18,8,2,1
10,361,361,71,71,0,1,0
9,426,426,6,6,0,1,0
3,427,427,3,3,0,1,0
18,431,431,8,8,0,1,0
2,433,433,32,11,21,2,1
17,470,470,78,51,27,4,3

1,102,102,8,2,6,3,2
2,109,109,25,25,0,1,0
3,121,121,13,13,0,1,0
4,164,164,1,1,0,1,0
14,180,180,11,4,7,2,1
19,193,193,7,7,0,1,0
0,199,199,17,2,15,2,1
10,202,202,17,7,10,2,1
11,221,221,36,36,0,1,0
8,224,224,10,10,0,1,0
13,280,280,77,9,68,3,2
12,341,341,15,9,6,2,1
16,347,347,70,70,0,1,0
7,349,349,21,9,12,4,3
17,379,379,4,4,0,1,0
6,415,415,28,28,0,1,0
9,420,420,20,20,0,1,0
15,435,435,11,11,0,1,0
18,446,446,43,43,0,1,0
5,459,459,42,21,21,2,1

1,114,114,8,8,0,1,0
4,125,125,8,2,6,2,1
14,151,151,6,1,5,2,1
2,155,155,9,9,0,1,0
0,222,222,47,17,30,3,2
16,274,274,1,1,0,1,0
7,287,287,74,74,0,1,0
5,297,297,54,54,0,1,0
11,327,327,7,2,5,2,1
13,333,333,12,12,0,1,0
3,337,337,9,9,0,1,0
6,352,352,11,8,3,2,1
10,367,367,23,17,6,3,2
8,375,375,37,20,17,2,1
15,403,403,61,31,30,4,3
9,435,435,126,126,0,1,0
12,500,500,106,106,0,1,0

4,133,133,1,1,0,1,0
8,152,152,9,9,0,1,0
7,159,159,15,10,5,2,1
14,181,181,25,22,3,2,1
20,199,199,44,32,12,4,3
11,207,207,14,14,0,1,0
6,234,234,7,7,0,1,0
21,258,258,28,10,18,2,1
0,271,271,16,8,8,3,2
12,275,275,7,7,0,1,0
2,287,287,16,2,14,3,2
13,291,291,11,11,0,1,0
16,328,328,13,13,0,1,0
19,345,345,80,80,0,1,0
3,358,358,11,7,4,2,1
10,398,398,45,45,0,1,0
17,439,439,49,49,0,1,0
15,443,443,9,1,8,2,1
9,457,457,32,21,11,2,1
18,476,476,2,2,0,1,0
5,483,483,70,33,37,4,3
1,486,486,70,58,12,4,3

6,115,115,19,19,0,1,0
4,131,131,7,1,6,3,2
1,132,132,55,32,23,4,3
8,212,212,7,2,5,2,1
5,220,220,24,24,0,1,0
3,259,259,2,2,0,1,0
0,265,265,16,16,0,1,0
15,319,319,64,64,0,1,0
16,336,336,64,64,0,1,0
2,363,363,19,19,0,1,0
9,388,388,21,21,0,1,0
12,396,396,39,39,0,1,0
11,415,415,38,38,0,1,0
7,462,462,17,17,0,1,0
10,464,464,5,5,0,1,0
14,474,474,12,2,10,3,2
13,479,479,100,54,46,3,2

20,105,105,7,7,0,1,0
5,106,106,1,1,0,1,0
11,144,144,2,2,0,1,0
6,147,147,3,3,0,1,0
19,158,158,7,7,0,1,0
10,175,175,42,42,0,1,0
14,198,198,21,21,0,1,0
18,241,241,57,42,15,2,1
8,254,254,36,18,18,3,2
9,256,256,34,25,9,4,3
0,258,258,17,1,16,2,1
13,261,261,27,27,0,1,0
17,287,287,18,1,17,2,1
16,298,298,32,11,21,4,3
15,330,330,20,20,0,1,0
4,388,388,3,3,0,1,0
3,416,416,11,11,0,1,0
2,424,424,10,10,0,1,0
7,448,448,75,47,28,2,1
1,461,461,24,24,0,1,0
12,487,487,69,69,0,1,0

14,111,111,9,9,0,1,0
9,153,153,14,2,12,4,3
4,159,159,29,29,0,1,0
2,166,166,1,1,0,1,0
5,233,233,29,5,24,4,3
12,282,282,1,1,0,1,0
7,293,293,62,4,58,3,2
10,293,293,9,9,0,1,0
6,301,301,72,34,38,2,1
15,355,355,21,3,18,3,2
3,366,366,11,11,0,1,0
1,371,371,7,7,0,1,0
11,377,377,55,55,0,1,0
0,431,431,38,12,26,3,2
13,443,443,154,46,108,4,3
16,484,484,67,67,0,1,0
8,489,489,12,12,0,1,0

15,113,113,2,2,0,1,0
14,158,158,19,19,0,1,0
5,190,190,24,15,9,2,1
3,215,215,54,6,48,4,3
0,228,228,4,4,0,1,0
10,274,274,23,23,0,1,0
9,304,304,20,20,0,1,0
12,321,321,106,80,26,2,1
11,321,321,30,30,0,1,0
2,328,328,15,15,0,1,0
1,331,331,21,21,0,1,0
7,332,332,84,84,0,1,0
4,335,335,25,16,9,2,1
13,335,335,32,10,22,2,1
8,375,375,9,9,0,1,0
16,451,451,37,28,9,4,3
6,477,477,33,13,20,3,2

5,128,128,1,1,0,1,0
2,160,160,13,13,0,1,0
9,169,169,25,25,0,1,0
16,199,199,18,7,11,2,1
6,219,219,21,21,0,1,0
17,273,273,10,2,8,2,1
3,278,278,35,12,23,2,1
11,316,316,60,60,0,1,0
15,352,352,1,1,0,1,0
10,358,358,91,31,60,3,2
8,361,361,25,12,13,4,3
12,374,374,45,4,41,4,3
1,387,387,78,48,30,3,2
4,395,395,9,9,0,1,0
0,424,424,25,19,6,2,1
7,446,446,40,21,19,2,1
13,464,464,3,3,0,1,0
18,464,464,47,30,17,2,1
14,486,486,57,40,17,2,1

1,108,108,13,1,12,2,1
7,112,112,5,5,0,1,0
4,130,130,7,2,5,2,1
14,132,132,6,6,0,1,0
2,134,134,11,3,8,3,2
8,169,169,17,17,0,1,0
19,170,170,22,6,16,2,1
12,180,180,20,20,0,1,0
0,205,205,20,10,10,3,2
11,224,224,9,2,7,2,1
5,240,240,8,4,4,2,1
18,251,251,3,3,0,1,0
13,271,271,13,13,0,1,0
20,282,282,47,47,0,1,0
9,293,293,8,8,0,1,0
22,314,314,32,32,0,1,0
16,323,323,45,32,13,2,1
23,335,335,25,25,0,1,0
3,336,336,20,20,0,1,0
6,362,362,2,2,0,1,0
15,367,367,38,38,0,1,0
17,387,387,1,1,0,1,0
21,486,486,90,78,12,4,3
10,491,491,16,16,0,1,0

0,122,122,28,3,25,2,1
7,142,142,1,1,0,1,0
8,156,156,25,25,0,1,0
3,158,158,1,1,0,1,0
10,217,217,7,7,0,1,0
6,254,254,57,57,0,1,0
15,256,256,20,10,10,2,1
12,284,284,4,4,0,1,0
11,293,293,30,10,20,2,1
13,296,296,25,25,0,1,0
9,309,309,88,39,49,2,1
1,310,310,48,1,47,2,1
4,326,326,42,9,33,4,3
5,409,409,26,9,17,2,1
14,430,430,32,19,13,2,1
2,480,480,43,43,0,1,0
16,492,492,45,45,0,1,0

9,139,139,20,14,6,2,1
10,145,145,31,27,4,2,1
7,147,147,14,14,0,1,0
11,153,153,3,3,0,1,0
12,164,164,19,19,0,1,0
0,184,184,33,6,27,2,1
5,220,220,7,1,6,2,1
13,238,238,26,17,9,4,3
15,263,263,1,1,0,1,0
1,283,283,26,26,0,1,0
8,286,286,22,22,0,1,0
16,303,303,28,10,18,4,3
17,356,356,5,5,0,1,0
14,406,406,86,86,0,1,0
2,411,411,52,12,40,3,2
6,430,430,82,53,29,2,1
3,443,443,28,8,20,2,1
4,480,480,22,8,14,2,1

12,134,134,8,8,0,1,0
9,145,145,8,5,3,2,1
2,150,150,21,15,6,2,1
3,205,205,14,11,3,2,1
1,206,206,11,11,0,1,0
13,208,208,30,3,27,2,1
8,240,240,5,2,3,2,1
4,268,268,6,6,0,1,0
0,322,322,34,24,10,3,2
15,343,343,10,10,0,1,0
11,367,367,10,10,0,1,0
6,403,403,43,13,30,2,1
10,404,404,16,3,13,2,1
7,448,448,215,215,0,1,0
5,457,457,185,170,15,2,1
14,458,458,30,22,8,2,1

13,100,100,22,13,9,2,1
7,112,112,8,3,5,2,1
0,123,123,1,1,0,1,0
12,138,138,19,19,0,1,0
14,142,142,5,5,0,1,0
1,167,167,46,46,0,1,0
4,209,209,1,1,0,1,0
2,275,275,9,9,0,1,0
15,319,319,91,46,45,4,3
8,334,334,11,11,0,1,0
9,378,378,30,6,24,4,3
6,385,385,136,52,84,4,3
5,415,415,76,34,42,4,3
11,419,419,11,11,0,1,0
10,421,421,14,14,0,1,0
3,491,491,22,18,4,2,1

11,105,105,8,5,3,2,1
4,119,119,1,1,0,1,0
3,125,125,7,7,0,1,0
1,145,145,20,20,0,1,0
5,146,146,18,4,14,3,2
18,148,148,1,1,0,1,0
10,153,153,39,39,0,1,0
6,155,155,23,17,6,2,1
16,159,159,15,15,0,1,0
12,206,206,4,4,0,1,0
15,218,218,1,1,0,1,0
9,302,302,52,4,48,4,3
7,307,307,8,5,3,2,1
14,329,329,75,42,33,2,1
0,353,353,13,13,0,1,0
13,412,412,80,63,17,2,1
2,440,440,36,36,0,1,0
8,445,445,49,49,0,1,0
17,481,481,18,8,10,3,2

15,127,127,2,2,0,1,0
22,129,129,1,1,0,1,0
12,131,131,1,1,0,1,0
3,135,135,17,17,0,1,0
18,148,148,43,43,0,1,0
19,164,164,15,15,0,1,0
1,173,173,20,20,0,1,0
0,174,174,9,9,0,1,0
4,178,178,1,1,0,1,0
23,209,209,41,5,36,3,2
21,273,273,4,1,3,2,1
2,292,292,4,1,3,2,1
13,315,315,11,11,0,1,0
11,322,322,4,4,0,1,0
9,370,370,2,2,0,1,0
7,370,370,8,8,0,1,0
17,405,405,63,24,39,4,3
5,412,412,63,27,36,4,3
14,418,418,72,53,19,2,1
8,427,427,9,9,0,1,0
6,428,428,52,35,17,3,2
16,433,433,23,12,11,2,1
10,486,486,19,19,0,1,0
20,486,486,46,46,0,1,0

18,124,124,10,10,0,1,0
5,178,178,1,1,0,1,0
3,181,181,32,32,0,1,0
8,182,182,31,19,12,2,1
1,193,193,12,12,0,1,0
6,212,212,3,3,0,1,0
10,217,217,4,4,0,1,0
9,230,230,43,43,0,1,0
20,231,231,16,10,6,3,2
4,317,317,1,1,0,1,0
19,319,319,30,2,28,3,2
14,356,356,11,5,6,2,1
15,364,364,90,90,0,1,0
13,396,396,62,13,49,2,1
7,420,420,7,7,0,1,0
16,437,437,43,43,0,1,0
21,444,444,11,11,0,1,0
17,459,459,52,52,0,1,0
0,463,463,93,93,0,1,0
11,478,478,12,3,9,2,1
2,483,483,6,1,5,2,1
12,484,484,4,4,0,1,0

15,133,133,16,11,5,2,1
3,138,138,4,4,0,1,0
1,148,148,2,2,0,1,0
6,186,186,11,11,0,1,0
10,261,261,36,36,0,1,0
18,265,265,1,1,0,1,0
17,277,277,6,6,0,1,0
4,290,290,11,11,0,1,0
11,304,304,47,47,0,1,0
2,318,318,22,22,0,1,0
12,339,339,23,23,0,1,0
16,377,377,174,93,81,4,3
9,380,380,105,75,30,4,3
8,385,385,51,31,20,3,2
19,420,420,10,10,0,1,0
5,426,426,29,3,26,3,2
7,436,436,29,5,24,4,3
14,455,455,4,4,0,1,0
13,465,465,23,14,9,2,1
0,472,472,5,5,0,1,0

11,101,101,3,3,0,1,0
15,125,125,13,7,6,2,1
4,138,138,19,2,17,2,1
1,138,138,16,4,12,4,3
8,177,177,38,38,0,1,0
16,196,196,21,21,0,1,0
13,198,198,54,10,44,2,1
6,227,227,2,2,0,1,0
10,250,250,5,5,0,1,0
5,268,268,23,13,10,3,2
0,292,292,4,4,0,1,0
9,310,310,82,82,0,1,0
14,331,331,23,10,13,3,2
12,382,382,21,13,8,2,1
3,387,387,22,22,0,1,0
7,398,398,69,69,0,1,0
17,427,427,1,1,0,1,0
2,456,456,44,23,21,4,3

10,129,129,6,6,0,1,0
9,134,134,22,22,0,1,0
0,180,180,5,1,4,2,1
11,197,197,57,40,17,4,3
16,199,199,41,25,16,2,1
5,207,207,17,17,0,1,0
17,219,219,32,32,0,1,0
1,244,244,8,8,0,1,0
2,250,250,24,24,0,1,0
13,269,269,6,6,0,1,0
14,285,285,6,3,3,2,1
7,288,288,32,27,5,2,1
3,293,293,90,21,69,3,2
12,301,301,2,2,0,1,0
6,336,336,17,17,0,1,0
15,367,367,8,8,0,1,0
4,441,441,81,81,0,1,0
8,473,473,5,5,0,1,0

11,114,114,9,9,0,1,0
6,116,116,18,6,12,3,2
7,174,174,21,21,0,1,0
10,201,201,37,37,0,1,0
5,205,205,3,3,0,1,0
8,209,209,9,9,0,1,0
9,219,219,7,7,0,1,0
0,228,228,4,1,3,2,1
4,292,292,44,29,15,4,3
12,322,322,12,5,7,2,1
2,371,371,180,142,38,2,1
13,371,371,95,7,88,3,2
1,405,405,1,1,0,1,0
3,417,417,103,60,43,2,1

6,120,120,4,1,3,2,1
14,132,132,38,14,24,4,3
0,183,183,1,1,0,1,0
9,190,190,1,1,0,1,0
2,208,208,1,1,0,1,0
10,247,247,20,20,0,1,0
5,304,304,17,17,0,1,0
3,314,314,85,48,37,2,1
15,321,321,2,2,0,1,0
16,340,340,12,12,0,1,0
1,349,349,26,26,0,1,0
17,371,371,13,6,7,2,1
11,382,382,52,10,42,2,1
13,407,407,80,34,46,3,2
7,419,419,141,60,81,4,3
4,428,428,28,28,0,1,0
12,475,475,64,2,62,3,2
8,492,492,27,9,18,4,3

4,112,112,13,5,8,3,2
9,118,118,16,16,0,1,0
7,144,144,33,33,0,1,0
13,148,148,37,23,14,3,2
3,221,221,50,50,0,1,0
2,246,246,3,3,0,1,0
5,249,249,31,19,12,3,2
1,256,256,19,19,0,1,0
11,272,272,18,18,0,1,0
15,292,292,47,11,36,4,3
12,373,373,2,2,0,1,0
14,392,392,89,17,72,3,2
16,405,405,7,2,5,2,1
10,413,413,9,9,0,1,0
6,416,416,3,3,0,1,0
0,453,453,25,15,10,3,2
17,470,470,14,14,0,1,0
8,471,471,27,27,0,1,0

18,103,103,17,1,16,3,2
8,118,118,1,1,0,1,0
15,121,121,27,6,21,4,3
19,164,164,5,5,0,1,0
0,173,173,1,1,0,1,0
10,191,191,39,13,26,3,2
11,208,208,17,2,15,4,3
21,237,237,46,46,0,1,0
1,244,244,6,6,0,1,0
4,257,257,21,21,0,1,0
13,264,264,1,1,0,1,0
20,266,266,19,19,0,1,0
22,320,320,19,12,7,2,1
17,379,379,40,27,13,2,1
14,391,391,7,4,3,2,1
12,397,397,20,20,0,1,0
23,415,415,36,28,8,2,1
7,418,418,6,6,0,1,0
16,418,418,45,25,20,3,2
6,419,419,3,3,0,1,0
2,423,423,45,45,0,1,0
24,431,431,40,22,18,2,1
5,446,446,25,5,20,2,1
9,483,483,3,3,0,1,0
3,484,484,5,1,4,2,1

8,151,151,6,6,0,1,0
17,173,173,29,1,28,3,2
10,196,196,7,7,0,1,0
15,273,273,45,2,43,2,1
0,303,303,100,7,93,4,3
7,347,347,7,1,6,3,2
2,348,348,52,14,38,3,2
11,360,360,40,40,0,1,0
14,365,365,42,42,0,1,0
16,375,375,1,1,0,1,0
9,380,380,1,1,0,1,0
4,386,386,61,61,0,1,0
13,400,400,100,97,3,2,1
5,406,406,17,5,12,3,2
12,452,452,30,17,13,2,1
6,467,467,12,12,0,1,0
1,495,495,28,16,12,3,2
3,495,495,41,41,0,1,0

3,122,122,14,3,11,2,1
14,150,150,44,29,15,4,3
5,155,155,2,2,0,1,0
9,157,157,3,3,0,1,0
12,185,185,4,4,0,1,0
22,189,189,4,4,0,1,0
16,231,231,38,6,32,2,1
7,274,274,26,22,4,2,1
20,278,278,5,1,4,2,1
0,283,283,16,2,14,3,2
21,298,298,13,13,0,1,0
1,304,304,66,66,0,1,0
15,309,309,21,1,20,3,2
4,309,309,4,4,0,1,0
6,317,317,22,22,0,1,0
8,324,324,12,1,11,4,3
19,325,325,22,4,18,4,3
11,351,351,51,12,39,2,1
17,402,402,53,38,15,2,1
2,431,431,7,7,0,1,0
18,448,448,49,1,48,2,1
10,484,484,10,1,9,2,1
13,499,499,31,11,20,2,1

9,104,104,32,32,0,1,0
11,105,105,16,16,0,1,0
2,193,193,55,34,21,2,1
6,214,214,12,3,9,4,3
4,230,230,48,48,0,1,0
7,264,264,15,15,0,1,0
12,271,271,3,3,0,1,0
1,291,291,64,20,44,3,2
5,314,314,35,35,0,1,0
0,350,350,8,8,0,1,0
10,375,375,41,13,28,2,1
8,398,398,43,25,18,3,2
13,408,408,27,27,0,1,0
3,477,477,26,9,17,2,1
14,493,493,30,30,0,1,0

1,111,111,1,1,0,1,0
4,134,134,11,11,0,1,0
11,148,148,83,79,4,2,1
7,169,169,3,3,0,1,0
5,270,270,66,24,42,4,3
14,301,301,1,1,0,1,0
9,307,307,23,7,16,3,2
0,309,309,30,30,0,1,0
3,316,316,123,41,82,4,3
6,356,356,18,18,0,1,0
13,378,378,2,2,0,1,0
2,396,396,11,11,0,1,0
12,428,428,5,5,0,1,0
8,451,451,7,2,5,2,1
10,452,452,35,35,0,1,0
15,473,473,72,72,0,1,0

9,102,102,2,2,0,1,0
8,162,162,7,7,0,1,0
14,183,183,29,29,0,1,0
2,204,204,47,47,0,1,0
13,209,209,60,38,22,3,2
4,222,222,53,53,0,1,0
5,312,312,38,38,0,1,0
11,329,329,7,7,0,1,0
10,351,351,15,8,7,2,1
7,372,372,16,12,4,2,1
0,375,375,33,21,12,4,3
12,376,376,93,9,84,4,3
3,424,424,9,1,8,3,2
1,443,443,89,35,54,4,3
6,457,457,24,7,17,3,2

9,105,105,18,18,0,1,0
15,161,161,9,4,5,2,1
11,199,199,33,33,0,1,0
3,222,222,3,3,0,1,0
1,288,288,2,2,0,1,0
6,294,294,4,4,0,1,0
5,333,333,143,65,78,4,3
12,358,358,26,7,19,2,1
0,389,389,15,6,9,4,3
10,389,389,8,5,3,2,1
2,390,390,140,128,12,4,3
13,395,395,76,52,24,4,3
8,397,397,4,1,3,2,1
14,397,397,59,44,15,4,3
7,440,440,35,35,0,1,0
4,496,496,20,20,0,1,0

4,132,132,7,7,0,1,0
20,141,141,3,3,0,1,0
15,154,154,56,56,0,1,0
6,159,159,12,12,0,1,0
10,193,193,9,9,0,1,0
2,202,202,4,4,0,1,0
16,220,220,27,17,10,3,2
13,243,243,18,18,0,1,0
11,247,247,11,8,3,2,1
17,252,252,2,2,0,1,0
7,261,261,14,5,9,4,3
14,264,264,51,51,0,1,0
0,272,272,51,42,9,4,3
9,276,276,3,3,0,1,0
8,283,283,13,1,12,3,2
5,311,311,3,3,0,1,0
1,382,382,53,53,0,1,0
3,391,391,84,26,58,4,3
12,422,422,2,2,0,1,0
19,422,422,39,39,0,1,0
18,463,463,18,18,0,1,0

19,111,111,13,13,0,1,0
10,122,122,1,1,0,1,0
12,141,141,13,13,0,1,0
3,160,160,14,8,6,2,1
9,161,161,28,18,10,2,1
2,208,208,20,20,0,1,0
5,224,224,10,10,0,1,0
7,254,254,7,7,0,1,0
17,264,264,25,9,16,3,2
6,265,265,19,19,0,1,0
8,270,270,3,3,0,1,0
16,297,297,24,11,13,2,1
0,320,320,62,62,0,1,0
11,326,326,106,16,90,3,2
18,344,344,26,26,0,1,0
1,357,357,55,12,43,2,1
4,362,362,13,13,0,1,0
14,435,435,23,15,8,2,1
13,438,438,23,9,14,2,1
15,443,443,12,3,9,4,3

6,112,112,14,7,7,2,1
13,131,131,24,7,17,4,3
7,159,159,13,13,0,1,0
2,168,168,15,15,0,1,0
0,189,189,66,12,54,4,3
10,205,205,19,3,16,3,2
14,214,214,7,7,0,1,0
1,219,219,14,14,0,1,0
8,265,265,18,18,0,1,0
5,292,292,72,40,32,4,3
4,307,307,21,15,6,3,2
12,350,350,22,22,0,1,0
11,369,369,99,60,39,4,3
9,457,457,1,1,0,1,0
3,499,499,42,42,0,1,0

12,117,117,25,25,0,1,0
9,196,196,10,10,0,1,0
5,235,235,12,12,0,1,0
0,238,238,10,10,0,1,0
1,238,238,3,3,0,1,0
11,238,238,5,5,0,1,0
4,246,246,1,1,0,1,0
8,261,261,10,5,5,2,1
10,282,282,10,10,0,1,0
7,286,286,77,77,0,1,0
2,321,321,15,15,0,1,0
14,401,401,46,19,27,4,3
13,408,408,54,54,0,1,0
15,472,472,21,21,0,1,0
6,485,485,329,294,35,2,1
3,497,497,33,9,24,4,3

4,104,104,6,6,0,1,0
16,128,128,2,2,0,1,0
10,131,131,11,11,0,1,0
0,147,147,22,4,18,2,1
1,191,191,6,6,0,1,0
3,194,194,8,8,0,1,0
7,202,202,18,11,7,2,1
11,211,211,1,1,0,1,0
13,233,233,1,1,0,1,0
6,245,245,77,3,74,4,3
9,245,245,1,1,0,1,0
18,280,280,83,83,0,1,0
15,305,305,119,71,48,4,3
5,346,346,5,5,0,1,0
8,370,370,33,33,0,1,0
14,379,379,24,12,12,4,3
17,425,425,8,8,0,1,0
2,459,459,51,40,11,2,1
12,474,474,15,15,0,1,0

12,123,123,21,14,7,2,1
16,204,204,3,3,0,1,0
7,208,208,22,14,8,3,2
2,238,238,16,1,15,4,3
6,239,239,11,11,0,1,0
8,251,251,44,17,27,3,2
15,281,281,2,2,0,1,0
4,291,291,17,1,16,3,2
13,312,312,14,14,0,1,0
11,341,341,73,73,0,1,0
10,345,345,1,1,0,1,0
3,371,371,65,65,0,1,0
5,371,371,15,15,0,1,0
14,403,403,16,8,8,2,1
9,422,422,106,41,65,4,3
0,450,450,93,61,32,2,1
1,465,465,94,31,63,4,3

7,111,111,17,9,8,2,1
1,121,121,37,27,10,2,1
13,132,132,24,9,15,2,1
4,133,133,4,4,0,1,0
6,159,159,10,1,9,4,3
11,167,167,27,12,15,3,2
12,173,173,72,3,69,4,3
16,189,189,1,1,0,1,0
15,207,207,16,10,6,3,2
3,239,239,13,5,8,2,1
14,245,245,3,3,0,1,0
17,255,255,7,4,3,2,1
0,272,272,20,20,0,1,0
8,283,283,16,4,12,3,2
10,345,345,12,12,0,1,0
5,363,363,18,6,12,3,2
9,376,376,3,3,0,1,0
2,380,380,44,44,0,1,0

0,109,109,36,36,0,1,0
9,111,111,8,4,4,2,1
8,122,122,3,3,0,1,0
6,128,128,4,4,0,1,0
3,140,140,1,1,0,1,0
16,154,154,7,2,5,2,1
7,195,195,16,16,0,1,0
12,281,281,38,6,32,3,2
2,307,307,37,1,36,2,1
17,312,312,34,25,9,2,1
5,314,314,64,64,0,1,0
18,328,328,53,19,34,3,2
13,330,330,23,23,0,1,0
11,349,349,37,12,25,2,1
15,358,358,8,8,0,1,0
4,358,358,10,10,0,1,0
1,366,366,2,2,0,1,0
14,372,372,43,43,0,1,0
10,425,425,65,65,0,1,0

24,103,103,11,11,0,1,0
8,107,107,3,3,0,1,0
15,181,181,1,1,0,1,0
2,198,198,1,1,0,1,0
1,201,201,25,25,0,1,0
0,233,233,6,6,0,1,0
12,233,233,1,1,0,1,0
23,278,278,4,4,0,1,0
4,283,283,10,10,0,1,0
18,296,296,14,3,11,2,1
3,302,302,23,23,0,1,0
11,313,313,53,53,0,1,0
5,321,321,23,23,0,1,0
17,325,325,5,5,0,1,0
26,350,350,17,17,0,1,0
22,361,361,52,52,0,1,0
7,365,365,1,1,0,1,0
13,377,377,13,5,8,2,1
6,392,392,9,9,0,1,0
16,429,429,8,8,0,1,0
21,429,429,29,24,5,2,1
25,442,442,91,91,0,1,0
20,464,464,34,34,0,1,0
10,465,465,1,1,0,1,0
14,473,473,103,7,96,3,2
9,474,474,20,20,0,1,0
19,478,478,97,59,38,4,3

14,160,160,3,3,0,1,0
1,163,163,13,4,9,2,1
8,219,219,33,33,0,1,0
9,258,258,19,19,0,1,0
0,264,264,20,5,15,2,1
7,268,268,5,5,0,1,0
4,302,302,1,1,0,1,0
16,320,320,59,51,8,3,2
11,341,341,23,1,22,3,2
10,344,344,37,37,0,1,0
2,350,350,106,106,0,1,0
3,404,404,3,3,0,1,0
15,424,424,64,64,0,1,0
12,449,449,31,31,0,1,0
5,487,487,125,75,50,2,1
13,494,494,47,47,0,1,0
6,498,498,79,79,0,1,0

1,106,106,6,1,5,2,1
15,119,119,4,1,3,2,1
10,139,139,1,1,0,1,0
4,153,153,10,10,0,1,0
16,200,200,4,4,0,1,0
11,203,203,20,3,17,2,1
2,204,204,1,1,0,1,0
17,239,239,61,61,0,1,0
18,252,252,6,3,3,2,1
9,256,256,2,2,0,1,0
6,261,261,1,1,0,1,0
14,322,322,36,13,23,2,1
13,322,322,30,30,0,1,0
5,328,328,30,19,11,4,3
12,333,333,83,28,55,3,2
3,342,342,17,5,12,4,3
19,423,423,147,84,63,3,2
20,425,425,3,3,0,1,0
22,434,434,47,13,34,3,2
0,468,468,23,3,20,2,1
21,469,469,8,8,0,1,0
8,485,485,33,33,0,1,0
7,490,490,28,16,12,2,1

2,110,110,9,9,0,1,0
5,229,229,7,7,0,1,0
7,230,230,15,15,0,1,0
10,266,266,3,3,0,1,0
3,312,312,89,68,21,4,3
8,333,333,33,11,22,2,1
12,340,340,8,8,0,1,0
1,382,382,22,22,0,1,0
0,389,389,83,83,0,1,0
11,394,394,96,90,6,3,2
13,401,401,27,27,0,1,0
6,427,427,94,46,48,4,3
4,436,436,115,115,0,1,0
9,486,486,74,74,0,1,0

7,100,100,3,3,0,1,0
13,100,100,7,7,0,1,0
8,138,138,1,1,0,1,0
18,247,247,8,8,0,1,0
14,259,259,8,8,0,1,0
12,266,266,6,6,0,1,0
16,277,277,18,6,12,2,1
20,299,299,23,13,10,2,1
9,301,301,24,24,0,1,0
5,312,312,4,4,0,1,0
3,323,323,31,3,28,3,2
23,324,324,120,120,0,1,0
17,348,348,78,78,0,1,0
15,356,356,24,18,6,3,2
0,376,376,61,61,0,1,0
6,426,426,1,1,0,1,0
19,433,433,16,16,0,1,0
22,439,439,7,7,0,1,0
10,444,444,57,57,0,1,0
1,446,446,5,5,0,1,0
2,447,447,99,43,56,3,2
21,485,485,11,5,6,3,2
11,492,492,11,3,8,2,1
4,495,495,3,3,0,1,0

2,115,115,8,8,0,1,0
17,117,117,7,1,6,3,2
6,122,122,2,2,0,1,0
11,129,129,18,6,12,3,2
19,156,156,5,5,0,1,0
3,173,173,2,2,0,1,0
10,286,286,13,7,6,3,2
4,298,298,13,13,0,1,0
12,311,311,29,17,12,4,3
16,316,316,22,14,8,3,2
15,319,319,44,18,26,3,2
0,350,350,62,62,0,1,0
13,397,397,76,76,0,1,0
7,399,399,15,15,0,1,0
14,402,402,63,11,52,4,3
1,415,415,50,9,41,3,2
9,416,416,25,3,22,2,1
8,448,448,54,48,6,2,1
18,453,453,17,7,10,2,1
5,487,487,97,40,57,4,3

1,115,115,1,1,0,1,0
6,135,135,33,33,0,1,0
5,142,142,47,47,0,1,0
8,161,161,3,3,0,1,0
14,201,201,16,16,0,1,0
7,225,225,64,56,8,3,2
12,272,272,34,34,0,1,0
15,292,292,3,3,0,1,0
0,326,326,68,17,51,4,3
4,345,345,19,13,6,2,1
9,378,378,4,4,0,1,0
3,415,415,16,16,0,1,0
11,423,423,94,94,0,1,0
13,456,456,52,25,27,4,3
2,476,476,9,9,0,1,0
10,480,480,23,11,12,2,1

3,102,102,24,24,0,1,0
5,154,154,25,25,0,1,0
15,154,154,15,15,0,1,0
4,162,162,5,5,0,1,0
0,167,167,26,26,0,1,0
10,198,198,7,7,0,1,0
13,241,241,3,3,0,1,0
6,250,250,53,24,29,4,3
7,262,262,19,19,0,1,0
8,313,313,29,6,23,2,1
2,356,356,14,14,0,1,0
11,360,360,37,10,27,4,3
14,424,424,185,185,0,1,0
1,436,436,29,29,0,1,0
12,454,454,5,5,0,1,0
9,473,473,27,21,6,3,2

4,116,116,41,41,0,1,0
9,120,120,4,1,3,2,1
6,176,176,14,14,0,1,0
0,268,268,2,2,0,1,0
3,276,276,28,28,0,1,0
7,276,276,24,2,22,2,1
10,279,279,13,13,0,1,0
8,289,289,24,24,0,1,0
11,312,312,57,42,15,2,1
13,352,352,49,49,0,1,0
5,356,356,48,24,24,4,3
12,394,394,33,6,27,4,3
1,421,421,26,2,24,3,2
14,436,436,1,1,0,1,0
2,447,447,74,26,48,4,3
15,486,486,124,77,47,2,1

9,103,103,8,8,0,1,0
10,139,139,5,5,0,1,0
20,140,140,38,38,0,1,0
13,156,156,1,1,0,1,0
2,176,176,1,1,0,1,0
8,177,177,2,2,0,1,0
14,184,184,18,10,8,3,2
19,207,207,23,23,0,1,0
6,221,221,5,5,0,1,0
16,233,233,25,21,4,2,1
25,239,239,11,11,0,1,0
7,246,246,1,1,0,1,0
3,259,259,30,30,0,1,0
5,293,293,22,22,0,1,0
1,300,300,42,1,41,3,2
11,316,316,1,1,0,1,0
18,332,332,12,2,10,3,2
21,398,398,25,12,13,2,1
23,414,414,26,26,0,1,0
4,418,418,43,3,40,3,2
12,439,439,8,8,0,1,0
0,443,443,14,2,12,2,1
22,448,448,59,50,9,4,3
24,465,465,57,57,0,1,0
17,478,478,32,8,24,2,1
15,494,494,23,23,0,1,0

17,108,108,1,1,0,1,0
19,115,115,9,9,0,1,0
0,146,146,12,2,10,3,2
1,150,150,6,6,0,1,0
20,150,150,12,12,0,1,0
15,151,151,6,6,0,1,0
10,163,163,3,3,0,1,0
12,173,173,22,6,16,2,1
6,218,218,7,7,0,1,0
7,253,253,32,18,14,2,1
2,255,255,59,59,0,1,0
13,315,315,101,101,0,1,0
3,329,329,88,88,0,1,0
8,353,353,9,9,0,1,0
14,365,365,20,8,12,4,3
9,413,413,9,9,0,1,0
5,424,424,1,1,0,1,0
18,444,444,56,7,49,3,2
11,480,480,18,6,12,2,1
4,483,483,8,8,0,1,0
16,500,500,45,45,0,1,0

11,108,108,2,2,0,1,0
12,142,142,29,29,0,1,0
8,169,169,20,20,0,1,0
1,191,191,1,1,0,1,0
19,193,193,10,10,0,1,0
17,228,228,13,4,9,2,1
20,249,249,16,16,0,1,0
18,296,296,10,2,8,3,2
4,300,300,1,1,0,1,0
2,313,313,6,6,0,1,0
10,324,324,88,32,56,3,2
15,352,352,24,1,23,2,1
7,359,359,2,2,0,1,0
16,367,367,99,66,33,4,3
6,379,379,26,3,23,3,2
9,409,409,15,15,0,1,0
5,417,417,46,33,13,2,1
0,450,450,1,1,0,1,0
14,453,453,126,96,30,4,3
13,471,471,14,14,0,1,0
21,483,483,29,12,17,2,1
3,496,496,18,18,0,1,0

8,114,114,11,11,0,1,0
14,129,129,28,3,25,2,1
7,130,130,30,3,27,4,3
1,193,193,32,21,11,2,1
13,207,207,19,19,0,1,0
15,227,227,35,35,0,1,0
2,242,242,28,10,18,4,3
10,308,308,1,1,0,1,0
5,313,313,15,15,0,1,0
16,393,393,47,41,6,2,1
11,413,413,20,20,0,1,0
6,419,419,93,73,20,2,1
0,429,429,12,8,4,2,1
9,455,455,22,4,18,3,2
12,461,461,62,62,0,1,0
3,465,465,42,42,0,1,0
4,469,469,1,1,0,1,0

13,115,115,4,4,0,1,0
4,122,122,3,3,0,1,0
7,125,125,1,1,0,1,0
16,142,142,9,9,0,1,0
11,148,148,20,9,11,2,1
12,182,182,10,10,0,1,0
0,221,221,19,19,0,1,0
6,264,264,81,81,0,1,0
14,269,269,83,47,36,4,3
1,284,284,36,36,0,1,0
2,295,295,22,22,0,1,0
3,308,308,68,62,6,3,2
5,341,341,5,5,0,1,0
10,351,351,25,25,0,1,0
9,359,359,4,4,0,1,0
8,383,383,11,11,0,1,0
15,409,409,67,67,0,1,0
17,429,429,19,6,13,2,1
18,484,484,23,14,9,2,1

13,138,138,11,11,0,1,0
14,166,166,49,19,30,4,3
7,172,172,2,2,0,1,0
4,172,172,82,65,17,4,3
16,207,207,2,2,0,1,0
3,270,270,37,37,0,1,0
5,274,274,26,13,13,2,1
0,274,274,16,16,0,1,0
6,286,286,27,27,0,1,0
8,336,336,41,38,3,2,1
2,339,339,9,9,0,1,0
10,351,351,24,6,18,4,3
15,392,392,54,54,0,1,0
11,403,403,31,31,0,1,0
9,424,424,38,12,26,3,2
1,458,458,1,1,0,1,0
12,462,462,17,17,0,1,0

0,107,107,12,7,5,2,1
16,120,120,33,21,12,4,3
3,169,169,14,14,0,1,0
11,187,187,9,9,0,1,0
10,255,255,7,7,0,1,0
6,268,268,30,22,8,3,2
14,295,295,8,3,5,2,1
17,321,321,27,1,26,3,2
1,331,331,85,85,0,1,0
15,349,349,62,16,46,3,2
9,350,350,51,34,17,2,1
13,355,355,39,25,14,2,1
12,363,363,52,52,0,1,0
2,389,389,17,17,0,1,0
8,395,395,11,11,0,1,0
18,396,396,9,9,0,1,0
4,438,438,14,6,8,2,1
7,448,448,36,3,33,4,3
5,484,484,4,4,0,1,0

11,114,114,23,2,21,4,3
2,115,115,7,7,0,1,0
6,144,144,1,1,0,1,0
0,185,185,1,1,0,1,0
4,211,211,24,8,16,3,2
3,213,213,1,1,0,1,0
7,246,246,14,9,5,2,1
21,253,253,12,12,0,1,0
14,262,262,11,1,10,3,2
8,262,262,1,1,0,1,0
10,297,297,2,2,0,1,0
1,311,311,72,72,0,1,0
16,331,331,17,17,0,1,0
17,349,349,4,4,0,1,0
13,354,354,24,24,0,1,0
15,358,358,22,22,0,1,0
18,404,404,82,13,69,4,3
19,418,418,81,29,52,4,3
9,429,429,23,15,8,3,2
5,453,453,52,32,20,3,2
12,468,468,19,3,16,4,3
20,476,476,113,65,48,2,1

4,133,133,9,1,8,2,1
0,142,142,15,15,0,1,0
18,192,192,1,1,0,1,0
14,193,193,11,11,0,1,0
3,198,198,3,3,0,1,0
11,216,216,7,4,3,2,1
19,247,247,56,56,0,1,0
2,265,265,25,6,19,2,1
5,283,283,13,8,5,2,1
1,351,351,17,17,0,1,0
13,366,366,52,12,40,3,2
7,372,372,56,30,26,3,2
17,419,419,1,1,0,1,0
8,429,429,13,4,9,2,1
15,439,439,95,67,28,3,2
9,461,461,79,61,18,3,2
12,466,466,4,4,0,1,0
16,466,466,105,105,0,1,0
6,483,483,58,1,57,4,3
10,486,486,25,19,6,3,2

0,104,104,9,9,0,1,0
4,105,105,3,3,0,1,0
7,144,144,17,5,12,2,1
15,158,158,24,24,0,1,0
18,160,160,21,1,20,2,1
16,170,170,23,23,0,1,0
22,179,179,1,1,0,1,0
1,180,180,13,8,5,2,1
6,198,198,5,2,3,2,1
10,220,220,3,3,0,1,0
13,229,229,38,24,14,3,2
20,247,247,4,4,0,1,0
8,259,259,21,3,18,4,3
12,275,275,4,4,0,1,0
11,320,320,17,17,0,1,0
5,349,349,28,20,8,3,2
2,358,358,2,2,0,1,0
17,389,389,19,1,18,3,2
9,394,394,46,21,25,2,1
19,423,423,50,50,0,1,0
21,475,475,82,67,15,4,3
14,480,480,64,64,0,1,0
3,492,492,21,21,0,1,0

6,137,137,5,5,0,1,0
3,143,143,13,3,10,2,1
1,223,223,18,12,6,3,2
0,225,225,93,15,78,3,2
5,256,256,56,56,0,1,0
12,274,274,3,3,0,1,0
14,301,301,30,9,21,4,3
2,306,306,3,3,0,1,0
13,309,309,110,77,33,4,3
9,310,310,7,7,0,1,0
15,318,318,60,44,16,2,1
8,332,332,9,9,0,1,0
10,346,346,4,4,0,1,0
11,385,385,26,26,0,1,0
7,401,401,51,51,0,1,0
4,427,427,24,24,0,1,0

16,133,133,6,6,0,1,0
14,135,135,6,6,0,1,0
0,159,159,32,9,23,2,1
9,177,177,57,29,28,4,3
10,211,211,8,8,0,1,0
6,270,270,53,5,48,2,1
7,325,325,30,24,6,3,2
1,342,342,31,31,0,1,0
12,346,346,20,20,0,1,0
11,370,370,60,3,57,3,2
15,375,375,48,48,0,1,0
13,379,379,33,21,12,3,2
4,400,400,42,42,0,1,0
2,404,404,21,21,0,1,0
8,424,424,35,20,15,2,1
3,444,444,30,24,6,3,2
17,470,470,14,11,3,2,1
5,481,481,7,7,0,1,0

13,112,112,13,13,0,1,0
5,120,120,17,17,0,1,0
7,171,171,9,6,3,2,1
1,240,240,77,77,0,1,0
3,241,241,1,1,0,1,0
8,257,257,6,6,0,1,0
11,257,257,2,2,0,1,0
6,263,263,28,2,26,3,2
9,324,324,29,15,14,3,2
0,363,363,33,33,0,1,0
12,451,451,95,95,0,1,0
4,456,456,117,73,44,3,2
10,476,476,80,37,43,4,3
2,497,497,114,80,34,3,2

1,124,124,4,4,0,1,0
15,160,160,14,11,3,2,1
11,230,230,1,1,0,1,0
6,245,245,1,1,0,1,0
12,252,252,30,11,19,4,3
10,265,265,13,13,0,1,0
14,303,303,90,48,42,4,3
5,316,316,53,39,14,2,1
7,317,317,1,1,0,1,0
0,319,319,45,45,0,1,0
9,323,323,95,17,78,4,3
20,328,328,54,54,0,1,0
8,378,378,22,18,4,2,1
3,385,385,47,14,33,2,1
2,391,391,6,6,0,1,0
4,427,427,4,1,3,2,1
13,443,443,1,1,0,1,0
17,449,449,14,14,0,1,0
18,462,462,31,4,27,2,1
19,465,465,51,5,46,3,2
16,471,471,19,19,0,1,0

4,108,108,14,4,10,3,2
8,135,135,6,6,0,1,0
5,143,143,14,11,3,2,1
0,162,162,11,1,10,3,2
6,212,212,19,19,0,1,0
13,273,273,15,15,0,1,0
1,282,282,73,70,3,2,1
3,294,294,54,8,46,3,2
12,295,295,64,29,35,2,1
9,301,301,5,5,0,1,0
10,363,363,26,26,0,1,0
11,383,383,42,22,20,2,1
7,420,420,33,33,0,1,0
2,426,426,32,5,27,2,1
15,481,481,65,65,0,1,0
14,486,486,89,19,70,3,2

3,100,100,5,5,0,1,0
17,113,113,5,5,0,1,0
18,159,159,38,19,19,2,1
9,198,198,8,8,0,1,0
5,214,214,1,1,0,1,0
13,233,233,21,21,0,1,0
8,241,241,12,6,6,3,2
6,268,268,11,4,7,2,1
12,278,278,3,3,0,1,0
15,284,284,28,6,22,2,1
10,324,324,61,61,0,1,0
0,338,338,62,62,0,1,0
11,345,345,24,15,9,2,1
4,348,348,4,1,3,2,1
14,353,353,34,34,0,1,0
1,383,383,88,88,0,1,0
2,394,394,8,8,0,1,0
7,403,403,110,68,42,2,1
16,424,424,32,6,26,4,3

0,123,123,39,39,0,1,0
5,157,157,16,16,0,1,0
6,160,160,15,2,13,2,1
7,174,174,23,23,0,1,0
3,175,175,9,1,8,3,2
4,186,186,10,7,3,2,1
11,190,190,19,9,10,2,1
8,202,202,23,19,4,2,1
2,210,210,35,23,12,4,3
14,375,375,36,36,0,1,0
1,382,382,80,80,0,1,0
12,390,390,41,41,0,1,0
13,415,415,2,2,0,1,0
10,447,447,65,48,17,2,1
9,488,488,62,14,48,4,3

2,150,150,7,7,0,1,0
0,153,153,1,1,0,1,0
20,172,172,29,14,15,4,3
7,182,182,16,1,15,4,3
3,188,188,13,1,12,4,3
14,199,199,30,18,12,2,1
17,217,217,23,13,10,2,1
18,258,258,5,5,0,1,0
21,260,260,14,14,0,1,0
13,266,266,52,52,0,1,0
10,313,313,17,17,0,1,0
19,314,314,41,19,22,3,2
9,320,320,36,15,21,4,3
5,340,340,13,13,0,1,0
8,375,375,49,49,0,1,0
11,419,419,6,1,5,2,1
4,441,441,4,4,0,1,0
15,458,458,2,2,0,1,0
1,478,478,25,9,16,3,2
16,486,486,83,47,36,2,1
6,490,490,37,37,0,1,0
12,493,493,5,5,0,1,0
22,500,500,58,10,48,2,1

10,131,131,16,2,14,2,1
7,163,163,5,5,0,1,0
8,180,180,10,3,7,3,2
11,212,212,70,70,0,1,0
0,224,224,27,7,20,3,2
3,225,225,35,35,0,1,0
12,234,234,1,1,0,1,0
13,254,254,12,6,6,2,1
4,261,261,12,12,0,1,0
1,342,342,151,131,20,2,1
6,347,347,66,66,0,1,0
2,370,370,28,28,0,1,0
5,383,383,24,19,5,2,1
14,383,383,34,3,31,4,3
9,496,496,25,25,0,1,0

10,128,128,10,10,0,1,0
8,150,150,3,3,0,1,0
2,156,156,4,1,3,2,1
1,157,157,1,1,0,1,0
0,209,209,6,6,0,1,0
17,220,220,18,7,11,2,1
15,241,241,37,9,28,2,1
4,256,256,54,30,24,4,3
7,307,307,21,9,12,2,1
11,390,390,6,6,0,1,0
13,407,407,44,20,24,4,3
12,430,430,55,42,13,2,1
5,458,458,61,43,18,3,2
9,467,467,14,1,13,2,1
3,473,473,50,13,37,2,1
18,486,486,13,1,12,3,2
6,494,494,134,134,0,1,0
16,495,495,35,35,0,1,0
14,495,495,125,31,94,3,2

5,103,103,3,3,0,1,0
3,108,108,14,14,0,1,0
4,130,130,4,4,0,1,0
15,148,148,13,13,0,1,0
7,176,176,3,3,0,1,0
0,226,226,15,15,0,1,0
1,258,258,63,63,0,1,0
10,271,271,22,22,0,1,0
8,272,272,14,14,0,1,0
14,298,298,96,49,47,4,3
11,312,312,1,1,0,1,0
9,323,323,89,89,0,1,0
2,361,361,9,9,0,1,0
12,380,380,25,7,18,3,2
6,416,416,156,51,105,4,3
13,438,438,7,7,0,1,0

14,107,107,13,10,3,2,1
11,153,153,8,8,0,1,0
5,180,180,2,2,0,1,0
3,184,184,6,6,0,1,0
12,190,190,27,27,0,1,0
16,220,220,26,26,0,1,0
8,235,235,35,35,0,1,0
7,241,241,76,7,69,4,3
13,241,241,13,13,0,1,0
19,243,243,10,10,0,1,0
9,255,255,14,14,0,1,0
20,257,257,21,14,7,2,1
18,320,320,34,34,0,1,0
0,325,325,13,1,12,2,1
1,332,332,35,35,0,1,0
10,358,358,11,3,8,2,1
17,359,359,78,78,0,1,0
2,469,469,35,27,8,2,1
4,472,472,7,7,0,1,0
15,483,483,18,18,0,1,0
6,496,496,12,12,0,1,0

13,100,100,4,4,0,1,0
15,102,102,21,18,3,2,1
21,117,117,6,6,0,1,0
2,139,139,12,12,0,1,0
7,150,150,3,3,0,1,0
22,152,152,26,20,6,3,2
19,154,154,11,2,9,2,1
18,174,174,2,2,0,1,0
3,180,180,2,2,0,1,0
1,210,210,1,1,0,1,0
6,214,214,18,4,14,4,3
20,229,229,15,15,0,1,0
11,230,230,3,3,0,1,0
16,278,278,42,12,30,4,3
14,319,319,7,7,0,1,0
0,331,331,29,20,9,4,3
5,348,348,49,49,0,1,0
12,364,364,21,21,0,1,0
8,378,378,60,60,0,1,0
9,397,397,65,21,44,2,1
17,434,434,78,78,0,1,0
10,458,458,9,9,0,1,0
4,486,486,9,9,0,1,0

11,108,108,2,2,0,1,0
15,111,111,5,2,3,2,1
16,122,122,1,1,0,1,0
8,150,150,36,21,15,4,3
5,160,160,1,1,0,1,0
6,163,163,8,8,0,1,0
14,181,181,14,4,10,3,2
12,191,191,6,3,3,2,1
17,230,230,84,6,78,4,3
3,235,235,19,19,0,1,0
9,246,246,45,30,15,2,1
7,279,279,17,17,0,1,0
2,306,306,1,1,0,1,0
1,319,319,19,11,8,2,1
0,399,399,3,3,0,1,0
13,407,407,41,41,0,1,0
4,430,430,169,88,81,4,3
10,471,471,45,23,22,3,2

3,118,118,7,7,0,1,0
15,140,140,5,5,0,1,0
1,145,145,18,18,0,1,0
8,174,174,5,1,4,2,1
0,179,179,14,2,12,2,1
2,246,246,56,56,0,1,0
16,266,266,85,85,0,1,0
10,292,292,17,1,16,3,2
13,296,296,12,12,0,1,0
14,298,298,84,37,47,3,2
9,303,303,6,2,4,2,1
6,328,328,10,2,8,3,2
12,337,337,34,3,31,2,1
11,344,344,14,2,12,3,2
5,410,410,26,26,0,1,0
4,442,442,1,1,0,1,0
7,486,486,153,107,46,2,1

14,101,101,33,30,3,2,1
5,109,109,26,18,8,3,2
6,154,154,8,8,0,1,0
7,158,158,24,3,21,4,3
9,160,160,20,9,11,2,1
1,196,196,16,11,5,2,1
3,250,250,39,31,8,3,2
0,263,263,53,31,22,3,2
2,305,305,1,1,0,1,0
4,318,318,70,32,38,2,1
11,320,320,63,63,0,1,0
8,322,322,10,10,0,1,0
12,403,403,5,5,0,1,0
10,424,424,8,4,4,2,1
13,495,495,3,3,0,1,0

4,100,100,8,2,6,2,1
14,106,106,2,2,0,1,0
0,164,164,2,2,0,1,0
12,181,181,2,2,0,1,0
5,193,193,25,4,21,3,2
7,253,253,3,3,0,1,0
2,260,260,40,2,38,2,1
1,269,269,52,52,0,1,0
18,289,289,3,3,0,1,0
19,316,316,38,38,0,1,0
9,317,317,6,2,4,2,1
10,321,321,3,3,0,1,0
3,323,323,29,1,28,2,1
20,343,343,44,34,10,3,2
6,359,359,5,5,0,1,0
17,372,372,11,7,4,2,1
13,378,378,106,68,38,2,1
11,379,379,45,45,0,1,0
8,405,405,28,28,0,1,0
16,431,431,54,54,0,1,0
15,488,488,94,55,39,4,3

11,111,111,12,9,3,2,1
19,154,154,12,12,0,1,0
7,193,193,9,1,8,2,1
18,214,214,3,3,0,1,0
4,230,230,14,14,0,1,0
15,302,302,26,23,3,2,1
0,323,323,16,16,0,1,0
12,327,327,5,5,0,1,0
10,333,333,31,23,8,2,1
14,335,335,13,13,0,1,0
5,352,352,16,1,15,4,3
9,360,360,34,24,10,2,1
2,362,362,35,35,0,1,0
20,363,363,62,62,0,1,0
3,390,390,74,30,44,3,2
8,400,400,27,27,0,1,0
16,400,400,79,67,12,2,1
1,404,404,6,6,0,1,0
21,437,437,24,13,11,2,1
17,468,468,67,67,0,1,0
22,470,470,62,50,12,2,1
13,488,488,1,1,0,1,0
6,493,493,8,8,0,1,0

8,106,106,2,2,0,1,0
9,145,145,1,1,0,1,0
18,189,189,9,9,0,1,0
22,191,191,43,1,42,2,1
17,274,274,43,15,28,3,2
0,315,315,28,28,0,1,0
11,333,333,26,4,22,3,2
5,340,340,11,11,0,1,0
13,344,344,46,46,0,1,0
12,349,349,3,3,0,1,0
20,353,353,15,1,14,3,2
16,359,359,25,25,0,1,0
21,390,390,18,4,14,3,2
15,392,392,24,24,0,1,0
10,404,404,3,3,0,1,0
2,404,404,41,41,0,1,0
7,414,414,1,1,0,1,0
14,437,437,61,61,0,1,0
1,446,446,78,29,49,4,3
19,451,451,57,14,43,2,1
3,453,453,11,11,0,1,0
6,456,456,1,1,0,1,0
4,492,492,109,7,102,4,3

6,167,167,21,21,0,1,0
5,211,211,6,6,0,1,0
13,216,216,27,20,7,2,1
4,233,233,42,30,12,4,3
9,237,237,5,5,0,1,0
0,243,243,4,4,0,1,0
20,251,251,37,37,0,1,0
10,275,275,1,1,0,1,0
8,288,288,31,31,0,1,0
1,314,314,26,11,15,2,1
16,323,323,37,11,26,4,3
11,340,340,12,12,0,1,0
15,351,351,9,9,0,1,0
19,353,353,42,42,0,1,0
14,393,393,45,19,26,2,1
12,416,416,47,35,12,2,1
17,426,426,21,3,18,2,1
2,439,439,73,19,54,4,3
18,451,451,47,47,0,1,0
7,468,468,52,1,51,4,3
3,484,484,11,1,10,2,1

13,143,143,18,18,0,1,0
1,149,149,56,20,36,2,1
14,153,153,8,5,3,2,1
2,193,193,7,7,0,1,0
8,220,220,24,19,5,2,1
4,223,223,21,21,0,1,0
11,290,290,37,11,26,2,1
15,296,296,3,3,0,1,0
3,313,313,17,7,10,3,2
6,333,333,18,2,16,4,3
5,362,362,22,14,8,3,2
9,386,386,9,1,8,3,2
0,389,389,88,88,0,1,0
7,398,398,92,65,27,4,3
10,439,439,89,4,85,4,3
12,465,465,15,3,12,2,1

11,106,106,10,10,0,1,0
6,132,132,15,15,0,1,0
9,141,141,15,15,0,1,0
0,205,205,9,9,0,1,0
5,217,217,15,5,10,2,1
4,234,234,24,19,5,2,1
12,262,262,32,32,0,1,0
1,265,265,13,13,0,1,0
8,296,296,45,45,0,1,0
3,314,314,1,1,0,1,0
10,349,349,91,46,45,4,3
15,361,361,15,4,11,2,1
2,404,404,211,175,36,2,1
13,429,429,36,14,22,3,2
14,440,440,21,12,9,4,3
7,482,482,6,6,0,1,0

1,101,101,2,2,0,1,0
16,103,103,12,12,0,1,0
12,140,140,2,2,0,1,0
6,147,147,47,47,0,1,0
7,158,158,4,4,0,1,0
5,160,160,6,6,0,1,0
8,161,161,12,5,7,2,1
14,273,273,9,9,0,1,0
13,303,303,41,41,0,1,0
2,315,315,60,60,0,1,0
0,337,337,24,24,0,1,0
17,346,346,93,93,0,1,0
11,347,347,29,14,15,2,1
15,348,348,17,8,9,4,3
10,355,355,29,29,0,1,0
3,396,396,3,3,0,1,0
9,412,412,31,31,0,1,0
4,474,474,38,38,0,1,0
18,480,480,63,30,33,2,1

7,109,109,8,8,0,1,0
9,143,143,23,23,0,1,0
4,174,174,8,8,0,1,0
12,251,251,3,3,0,1,0
2,255,255,20,20,0,1,0
10,307,307,6,6,0,1,0
11,335,335,82,82,0,1,0
6,341,341,10,10,0,1,0
1,353,353,219,180,39,4,3
8,357,357,3,3,0,1,0
13,358,358,9,9,0,1,0
0,425,425,51,13,38,3,2
5,425,425,148,44,104,4,3
3,436,436,16,11,5,2,1

21,130,130,19,14,5,2,1
7,142,142,8,8,0,1,0
1,144,144,5,5,0,1,0
3,147,147,5,5,0,1,0
6,155,155,7,2,5,2,1
11,168,168,11,5,6,3,2
19,183,183,21,21,0,1,0
4,206,206,6,6,0,1,0
15,245,245,22,22,0,1,0
2,255,255,4,4,0,1,0
17,266,266,95,29,66,3,2
9,277,277,1,1,0,1,0
13,287,287,13,13,0,1,0
22,289,289,3,3,0,1,0
16,335,335,4,4,0,1,0
0,365,365,28,28,0,1,0
8,372,372,31,16,15,4,3
14,409,409,33,30,3,2,1
12,412,412,91,91,0,1,0
20,448,448,4,4,0,1,0
18,450,450,44,44,0,1,0
10,480,480,15,7,8,2,1
5,480,480,77,44,33,4,3

13,101,101,32,32,0,1,0
2,165,165,6,6,0,1,0
11,168,168,3,3,0,1,0
8,172,172,5,5,0,1,0
18,180,180,19,19,0,1,0
15,195,195,15,3,12,3,2
0,215,215,43,43,0,1,0
19,249,249,29,20,9,4,3
10,300,300,4,4,0,1,0
9,327,327,35,35,0,1,0
16,341,341,15,10,5,2,1
7,379,379,6,6,0,1,0
17,381,381,61,22,39,2,1
5,384,384,14,14,0,1,0
3,398,398,68,34,34,2,1
6,405,405,38,24,14,2,1
12,408,408,11,3,8,2,1
4,430,430,24,24,0,1,0
1,443,443,43,1,42,3,2
21,444,444,4,4,0,1,0
20,478,478,13,5,8,2,1
14,484,484,27,27,0,1,0

0,104,104,6,6,0,1,0
8,119,119,13,13,0,1,0
1,129,129,5,1,4,2,1
16,157,157,6,6,0,1,0
12,183,183,7,3,4,2,1
6,201,201,34,34,0,1,0
9,231,231,5,5,0,1,0
3,243,243,22,22,0,1,0
13,250,250,53,53,0,1,0
7,257,257,21,9,12,3,2
4,268,268,57,57,0,1,0
10,284,284,56,56,0,1,0
2,307,307,2,2,0,1,0
14,327,327,3,3,0,1,0
15,385,385,111,63,48,3,2
5,408,408,56,56,0,1,0
11,420,420,10,10,0,1,0
17,500,500,45,45,0,1,0

1,112,112,28,28,0,1,0
13,141,141,10,4,6,2,1
0,168,168,24,14,10,3,2
5,181,181,86,24,62,3,2
9,185,185,56,56,0,1,0
2,194,194,1,1,0,1,0
4,252,252,5,5,0,1,0
12,300,300,4,4,0,1,0
10,312,312,11,11,0,1,0
3,332,332,3,3,0,1,0
7,376,376,51,51,0,1,0
6,389,389,6,1,5,2,1
11,404,404,73,73,0,1,0
8,458,458,34,34,0,1,0
14,496,496,43,37,6,2,1

10,135,135,1,1,0,1,0
6,144,144,8,8,0,1,0
14,150,150,1,1,0,1,0
20,164,164,5,1,4,2,1
19,169,169,28,3,25,2,1
0,219,219,12,12,0,1,0
15,225,225,13,1,12,2,1
8,244,244,2,2,0,1,0
9,246,246,30,30,0,1,0
22,258,258,38,2,36,4,3
18,287,287,24,10,14,2,1
2,287,287,1,1,0,1,0
1,318,318,12,1,11,2,1
13,333,333,22,7,15,2,1
7,335,335,56,35,21,4,3
12,337,337,17,2,15,2,1
24,337,337,16,6,10,2,1
25,354,354,32,12,20,2,1
21,372,372,11,11,0,1,0
23,382,382,87,75,12,4,3
5,408,408,3,3,0,1,0
11,434,434,39,2,37,2,1
16,453,453,54,27,27,2,1
4,471,471,3,3,0,1,0
17,484,484,46,30,16,2,1
3,493,493,20,5,15,4,3

10,106,106,21,1,20,2,1
6,107,107,6,6,0,1,0
7,134,134,3,3,0,1,0
3,167,167,8,5,3,2,1
1,219,219,2,2,0,1,0
14,228,228,19,19,0,1,0
0,231,231,53,7,46,3,2
4,333,333,25,25,0,1,0
5,336,336,60,60,0,1,0
9,337,337,31,31,0,1,0
12,367,367,42,42,0,1,0
8,370,370,96,28,68,3,2
15,390,390,60,60,0,1,0
13,394,394,4,4,0,1,0
16,436,436,7,7,0,1,0
17,476,476,67,9,58,3,2
11,483,483,49,45,4,2,1
2,487,487,11,11,0,1,0

4,124,124,7,7,0,1,0
12,126,126,6,6,0,1,0
19,128,128,7,7,0,1,0
14,134,134,28,23,5,2,1
6,157,157,42,42,0,1,0
2,158,158,2,2,0,1,0
15,158,158,45,6,39,4,3
9,160,160,13,3,10,3,2
20,178,178,8,2,6,2,1
18,205,205,14,4,10,4,3
1,229,229,21,3,18,3,2
5,233,233,9,9,0,1,0
0,236,236,1,1,0,1,0
8,277,277,1,1,0,1,0
7,301,301,37,13,24,4,3
13,324,324,45,30,15,2,1
16,358,358,18,18,0,1,0
10,394,394,43,25,18,3,2
3,405,405,19,10,9,2,1
21,410,410,8,2,6,2,1
11,491,491,10,10,0,1,0
17,500,500,23,23,0,1,0

9,119,119,2,2,0,1,0
8,162,162,2,2,0,1,0
19,169,169,30,30,0,1,0
5,178,178,48,10,38,2,1
3,201,201,6,2,4,2,1
0,248,248,1,1,0,1,0
17,255,255,53,53,0,1,0
18,265,265,42,37,5,2,1
7,276,276,32,32,0,1,0
2,346,346,1,1,0,1,0
13,347,347,5,5,0,1,0
6,358,358,134,124,10,3,2
15,378,378,3,3,0,1,0
12,403,403,12,5,7,2,1
4,406,406,6,6,0,1,0
11,432,432,47,47,0,1,0
10,465,465,21,21,0,1,0
14,478,478,23,2,21,2,1
16,480,480,77,20,57,4,3
1,495,495,8,8,0,1,0

10,106,106,1,1,0,1,0
5,128,128,1,1,0,1,0
19,144,144,26,26,0,1,0
7,148,148,14,5,9,4,3
15,174,174,9,9,0,1,0
2,183,183,26,2,24,3,2
3,187,187,16,16,0,1,0
17,204,204,11,7,4,2,1
11,231,231,19,19,0,1,0
16,284,284,17,4,13,4,3
14,289,289,1,1,0,1,0
4,293,293,9,9,0,1,0
8,294,294,5,5,0,1,0
23,297,297,3,3,0,1,0
1,303,303,1,1,0,1,0
9,329,329,9,9,0,1,0
13,332,332,17,17,0,1,0
0,341,341,32,32,0,1,0
22,353,353,51,8,43,2,1
6,442,442,47,47,0,1,0
18,444,444,80,59,21,4,3
21,481,481,79,79,0,1,0
12,485,485,71,33,38,3,2
20,490,490,36,28,8,3,2

6,100,100,19,19,0,1,0
3,119,119,16,7,9,2,1
7,119,119,8,8,0,1,0
2,164,164,17,17,0,1,0
10,192,192,23,23,0,1,0
1,204,204,51,51,0,1,0
13,233,233,11,11,0,1,0
0,278,278,57,57,0,1,0
4,341,341,61,61,0,1,0
14,347,347,22,22,0,1,0
5,378,378,11,5,6,2,1
9,420,420,20,20,0,1,0
8,463,463,127,43,84,3,2
11,474,474,40,40,0,1,0
12,479,479,12,12,0,1,0

3,129,129,7,7,0,1,0
12,164,164,4,4,0,1,0
7,179,179,10,7,3,2,1
5,228,228,103,88,15,4,3
11,280,280,70,70,0,1,0
16,356,356,38,38,0,1,0
2,369,369,60,28,32,3,2
8,373,373,15,3,12,3,2
1,395,395,50,7,43,4,3
10,415,415,134,134,0,1,0
13,416,416,11,5,6,3,2
6,427,427,2,2,0,1,0
15,430,430,27,27,0,1,0
9,432,432,29,29,0,1,0
0,462,462,1,1,0,1,0
14,476,476,10,10,0,1,0
4,485,485,21,9,12,4,3

15,103,103,3,3,0,1,0
6,112,112,2,2,0,1,0
13,121,121,2,2,0,1,0
12,126,126,33,2,31,3,2
8,151,151,1,1,0,1,0
9,164,164,31,31,0,1,0
19,195,195,36,3,33,2,1
1,221,221,21,21,0,1,0
5,248,248,40,40,0,1,0
18,256,256,5,2,3,2,1
16,280,280,22,15,7,2,1
7,298,298,22,22,0,1,0
20,299,299,43,43,0,1,0
17,336,336,5,5,0,1,0
3,339,339,63,63,0,1,0
2,344,344,7,7,0,1,0
10,350,350,4,4,0,1,0
11,386,386,13,5,8,3,2
4,411,411,43,43,0,1,0
14,437,437,76,76,0,1,0
0,455,455,1,1,0,1,0

8,106,106,1,1,0,1,0
14,143,143,10,10,0,1,0
7,167,167,10,1,9,2,1
1,171,171,33,33,0,1,0
6,211,211,4,4,0,1,0
12,281,281,18,18,0,1,0
16,286,286,6,6,0,1,0
17,296,296,25,25,0,1,0
13,308,308,59,59,0,1,0
10,326,326,64,48,16,2,1
0,333,333,39,1,38,3,2
15,334,334,5,5,0,1,0
2,387,387,61,61,0,1,0
18,398,398,50,31,19,2,1
4,417,417,67,67,0,1,0
9,445,445,48,38,10,3,2
3,455,455,1,1,0,1,0
11,472,472,70,29,41,2,1
5,479,479,36,10,26,2,1

13,128,128,4,4,0,1,0
10,141,141,25,16,9,2,1
12,148,148,30,19,11,2,1
4,220,220,29,29,0,1,0
11,266,266,6,2,4,2,1
14,287,287,37,37,0,1,0
5,306,306,16,4,12,3,2
7,326,326,9,9,0,1,0
6,326,326,10,7,3,2,1
16,343,343,32,32,0,1,0
17,367,367,30,30,0,1,0
9,378,378,37,37,0,1,0
0,378,378,16,5,11,2,1
2,380,380,3,3,0,1,0
3,411,411,14,14,0,1,0
15,419,419,38,38,0,1,0
8,461,461,175,61,114,4,3
18,463,463,41,35,6,2,1
1,483,483,47,47,0,1,0

1,118,118,2,2,0,1,0
13,126,126,3,3,0,1,0
14,133,133,1,1,0,1,0
22,136,136,7,1,6,2,1
18,178,178,16,7,9,2,1
24,190,190,9,3,6,2,1
0,203,203,1,1,0,1,0
7,207,207,13,4,9,4,3
21,217,217,55,14,41,2,1
8,243,243,2,2,0,1,0
15,245,245,26,26,0,1,0
3,254,254,1,1,0,1,0
9,263,263,6,1,5,2,1
20,307,307,8,8,0,1,0
16,317,317,59,59,0,1,0
19,332,332,48,48,0,1,0
4,343,343,87,87,0,1,0
17,349,349,33,33,0,1,0
12,352,352,28,11,17,2,1
23,360,360,77,31,46,2,1
25,395,395,3,3,0,1,0
11,409,409,19,19,0,1,0
6,438,438,15,6,9,2,1
2,451,451,3,3,0,1,0
10,468,468,1,1,0,1,0
5,493,493,18,18,0,1,0

0,112,112,14,14,0,1,0
10,152,152,15,15,0,1,0
17,152,152,16,8,8,3,2
19,156,156,7,7,0,1,0
20,158,158,6,6,0,1,0
5,169,169,4,1,3,2,1
8,188,188,7,7,0,1,0
13,232,232,22,22,0,1,0
16,238,238,13,5,8,3,2
23,284,284,41,41,0,1,0
4,296,296,18,6,12,4,3
15,343,343,48,22,26,3,2
2,344,344,17,2,15,2,1
6,346,346,8,5,3,2,1
22,366,366,41,4,37,2,1
11,405,405,5,5,0,1,0
12,441,441,6,6,0,1,0
14,467,467,45,13,32,3,2
1,473,473,49,13,36,4,3
9,473,473,10,6,4,2,1
21,473,473,48,33,15,4,3
7,481,481,64,64,0,1,0
18,483,483,86,86,0,1,0
3,500,500,4,4,0,1,0

20,117,117,23,23,0,1,0
7,136,136,2,2,0,1,0
5,141,141,1,1,0,1,0
13,152,152,4,4,0,1,0
24,167,167,29,29,0,1,0
3,171,171,10,10,0,1,0
6,179,179,10,10,0,1,0
10,182,182,35,3,32,3,2
16,187,187,12,4,8,3,2
8,203,203,1,1,0,1,0
2,223,223,2,2,0,1,0
21,257,257,29,15,14,3,2
23,313,313,53,22,31,3,2
14,336,336,12,5,7,2,1
19,348,348,31,13,18,4,3
18,360,360,1,1,0,1,0
12,382,382,3,3,0,1,0
17,401,401,13,1,12,4,3
0,422,422,17,17,0,1,0
4,457,457,14,14,0,1,0
9,459,459,74,30,44,4,3
15,478,478,95,56,39,4,3
11,483,483,19,19,0,1,0
22,490,490,41,28,13,2,1
1,491,491,9,3,6,2,1

18,104,104,23,23,0,1,0
16,115,115,20,4,16,4,3
9,121,121,1,1,0,1,0
1,142,142,1,1,0,1,0
4,146,146,15,15,0,1,0
12,181,181,22,22,0,1,0
6,182,182,25,2,23,2,1
13,188,188,8,8,0,1,0
19,196,196,16,11,5,2,1
2,228,228,12,2,10,2,1
7,229,229,28,28,0,1,0
14,249,249,35,19,16,2,1
3,250,250,8,8,0,1,0
0,273,273,52,12,40,4,3
15,401,401,14,14,0,1,0
17,421,421,1,1,0,1,0
11,433,433,46,8,38,3,2
10,470,470,57,15,42,4,3
8,470,470,17,5,12,2,1
5,500,500,45,45,0,1,0

14,104,104,5,5,0,1,0
21,147,147,2,2,0,1,0
15,147,147,13,3,10,3,2
12,151,151,3,3,0,1,0
7,163,163,20,20,0,1,0
0,176,176,9,9,0,1,0
19,204,204,22,22,0,1,0
5,215,215,13,13,0,1,0
16,260,260,29,16,13,2,1
20,330,330,120,27,93,4,3
18,362,362,12,12,0,1,0
8,363,363,39,39,0,1,0
11,371,371,4,1,3,2,1
6,383,383,35,35,0,1,0
17,405,405,10,3,7,2,1
10,409,409,7,7,0,1,0
1,420,420,18,2,16,3,2
9,426,426,67,67,0,1,0
3,432,432,53,21,32,3,2
2,455,455,19,7,12,4,3
4,456,456,25,25,0,1,0
13,487,487,67,67,0,1,0

16,103,103,4,4,0,1,0
12,107,107,10,2,8,2,1
19,131,131,4,4,0,1,0
11,147,147,1,1,0,1,0
3,173,173,12,12,0,1,0
5,176,176,9,3,6,3,2
8,208,208,4,1,3,2,1
7,218,218,5,5,0,1,0
4,281,281,6,6,0,1,0
2,297,297,8,8,0,1,0
14,323,323,88,55,33,4,3
0,366,366,11,3,8,2,1
10,389,389,21,21,0,1,0
6,398,398,118,76,42,4,3
13,400,400,8,2,6,2,1
1,426,426,44,44,0,1,0
17,432,432,29,1,28,3,2
15,436,436,74,26,48,4,3
21,440,440,38,7,31,4,3
20,443,443,63,63,0,1,0
18,470,470,40,15,25,2,1
9,493,493,56,6,50,2,1

17,218,218,26,6,20,2,1
12,254,254,46,29,17,2,1
2,262,262,20,13,7,2,1
15,294,294,2,2,0,1,0
1,308,308,81,23,58,3,2
9,315,315,15,15,0,1,0
6,319,319,53,3,50,2,1
5,365,365,15,5,10,3,2
14,373,373,10,5,5,2,1
7,380,380,50,44,6,2,1
4,397,397,20,20,0,1,0
0,416,416,37,1,36,4,3
11,437,437,46,13,33,4,3
13,453,453,4,4,0,1,0
16,460,460,184,40,144,4,3
8,483,483,19,19,0,1,0
10,489,489,7,7,0,1,0
3,500,500,22,22,0,1,0

1,105,105,7,4,3,2,1
11,110,110,3,3,0,1,0
2,117,117,6,6,0,1,0
4,163,163,7,7,0,1,0
6,212,212,23,23,0,1,0
14,225,225,34,34,0,1,0
8,234,234,15,15,0,1,0
15,239,239,53,53,0,1,0
9,315,315,11,11,0,1,0
17,319,319,63,42,21,4,3
12,324,324,5,5,0,1,0
21,328,328,42,31,11,2,1
22,330,330,24,14,10,2,1
0,330,330,29,29,0,1,0
18,383,383,11,11,0,1,0
16,385,385,15,7,8,2,1
7,388,388,55,55,0,1,0
3,391,391,28,8,20,3,2
19,395,395,13,13,0,1,0
13,402,402,28,15,13,2,1
10,475,475,34,28,6,2,1
20,476,476,20,20,0,1,0
5,495,495,24,18,6,2,1

1,105,105,2,2,0,1,0
3,106,106,7,7,0,1,0
12,111,111,6,6,0,1,0
9,129,129,32,5,27,2,1
15,193,193,15,15,0,1,0
10,220,220,32,10,22,3,2
14,230,230,38,4,34,2,1
0,247,247,90,78,12,2,1
5,283,283,1,1,0,1,0
2,341,341,35,24,11,2,1
6,356,356,6,6,0,1,0
4,406,406,134,134,0,1,0
11,408,408,18,18,0,1,0
13,408,408,11,11,0,1,0
7,445,445,3,3,0,1,0
8,490,490,72,39,33,4,3

18,104,104,10,2,8,3,2
11,115,115,14,4,10,3,2
16,118,118,14,10,4,2,1
2,172,172,37,4,33,2,1
8,198,198,27,27,0,1,0
7,209,209,1,1,0,1,0
21,211,211,15,4,11,2,1
15,215,215,15,15,0,1,0
14,219,219,71,34,37,2,1
6,227,227,2,2,0,1,0
12,227,227,18,18,0,1,0
4,238,238,19,19,0,1,0
13,254,254,27,10,17,4,3
3,267,267,1,1,0,1,0
19,271,271,1,1,0,1,0
0,289,289,2,2,0,1,0
10,306,306,14,6,8,3,2
20,353,353,3,3,0,1,0
5,358,358,1,1,0,1,0
1,396,396,6,6,0,1,0
22,421,421,44,8,36,3,2
17,443,443,56,12,44,3,2
9,462,462,34,10,24,3,2

16,112,112,2,2,0,1,0
13,139,139,11,11,0,1,0
0,140,140,3,3,0,1,0
11,143,143,12,12,0,1,0
1,180,180,56,56,0,1,0
12,237,237,14,14,0,1,0
2,251,251,1,1,0,1,0
7,254,254,41,3,38,2,1
6,308,308,23,17,6,2,1
3,330,330,1,1,0,1,0
9,339,339,36,1,35,2,1
14,358,358,53,53,0,1,0
15,381,381,52,45,7,2,1
10,410,410,84,68,16,2,1
8,424,424,34,34,0,1,0
4,478,478,49,16,33,2,1
5,492,492,111,44,67,4,3

1,140,140,10,1,9,4,3
11,153,153,15,11,4,2,1
7,170,170,2,2,0,1,0
12,188,188,2,2,0,1,0
16,236,236,21,18,3,2,1
0,265,265,32,4,28,2,1
10,270,270,16,6,10,2,1
15,305,305,4,4,0,1,0
3,316,316,29,3,26,2,1
9,327,327,65,8,57,4,3
13,336,336,77,63,14,2,1
2,357,357,40,22,18,2,1
8,358,358,22,22,0,1,0
6,364,364,122,15,107,4,3
5,440,440,65,65,0,1,0
14,472,472,75,17,58,3,2
4,482,482,5,5,0,1,0

14,107,107,9,9,0,1,0
12,112,112,54,34,20,2,1
6,116,116,56,22,34,3,2
5,143,143,5,2,3,2,1
8,158,158,6,6,0,1,0
3,159,159,7,7,0,1,0
1,165,165,14,5,9,4,3
16,179,179,11,3,8,3,2
18,217,217,5,5,0,1,0
9,258,258,10,2,8,2,1
0,264,264,3,3,0,1,0
2,299,299,2,2,0,1,0
13,313,313,2,2,0,1,0
4,332,332,44,44,0,1,0
15,421,421,13,1,12,3,2
11,460,460,27,27,0,1,0
10,475,475,7,7,0,1,0
17,478,478,77,33,44,4,3
7,482,482,14,14,0,1,0

3,112,112,11,11,0,1,0
14,177,177,3,3,0,1,0
13,196,196,31,1,30,4,3
15,204,204,19,19,0,1,0
16,233,233,1,1,0,1,0
1,263,263,8,8,0,1,0
8,295,295,26,2,24,3,2
2,305,305,74,74,0,1,0
9,314,314,7,7,0,1,0
4,333,333,49,33,16,3,2
0,348,348,43,23,20,3,2
12,359,359,3,3,0,1,0
5,362,362,78,56,22,3,2
7,382,382,11,11,0,1,0
10,416,416,165,165,0,1,0
11,465,465,60,30,30,4,3
6,494,494,8,4,4,2,1

16,162,162,22,22,0,1,0
23,169,169,30,4,26,4,3
7,175,175,2,2,0,1,0
20,185,185,42,42,0,1,0
19,189,189,8,8,0,1,0
3,222,222,4,1,3,2,1
4,237,237,12,6,6,3,2
14,242,242,18,5,13,2,1
13,279,279,63,33,30,3,2
21,288,288,20,8,12,3,2
0,295,295,16,7,9,2,1
1,304,304,6,6,0,1,0
12,305,305,19,19,0,1,0
8,308,308,1,1,0,1,0
5,331,331,26,18,8,3,2
9,345,345,37,37,0,1,0
15,346,346,14,6,8,3,2
10,364,364,1,1,0,1,0
18,365,365,47,47,0,1,0
6,410,410,14,6,8,2,1
17,411,411,49,34,15,4,3
22,446,446,4,4,0,1,0
24,453,453,5,5,0,1,0
11,467,467,12,7,5,2,1
2,487,487,45,27,18,4,3

24,137,137,30,30,0,1,0
15,149,149,1,1,0,1,0
14,160,160,4,1,3,2,1
22,160,160,38,20,18,4,3
17,161,161,21,21,0,1,0
0,175,175,3,3,0,1,0
16,184,184,5,5,0,1,0
8,187,187,9,9,0,1,0
9,206,206,7,7,0,1,0
27,222,222,15,1,14,2,1
25,225,225,11,11,0,1,0
2,245,245,7,4,3,2,1
26,247,247,48,36,12,4,3
4,254,254,13,13,0,1,0
12,256,256,3,3,0,1,0
20,260,260,29,29,0,1,0
23,270,270,4,4,0,1,0
28,292,292,1,1,0,1,0
10,302,302,2,2,0,1,0
11,336,336,1,1,0,1,0
21,340,340,8,8,0,1,0
6,347,347,81,81,0,1,0
1,352,352,1,1,0,1,0
7,359,359,10,2,8,3,2
3,381,381,1,1,0,1,0
19,382,382,7,7,0,1,0
5,396,396,15,15,0,1,0
13,439,439,48,48,0,1,0
18,448,448,35,35,0,1,0

7,117,117,16,1,15,2,1
1,167,167,13,1,12,2,1
11,194,194,1,1,0,1,0
14,207,207,6,6,0,1,0
9,219,219,8,8,0,1,0
10,245,245,38,38,0,1,0
8,263,263,86,86,0,1,0
15,271,271,40,30,10,3,2
2,281,281,162,108,54,4,3
12,295,295,8,1,7,3,2
3,307,307,1,1,0,1,0
13,327,327,20,20,0,1,0
5,365,365,6,6,0,1,0
0,376,376,24,18,6,3,2
4,376,376,35,5,30,2,1
6,391,391,27,27,0,1,0

10,136,136,21,2,19,2,1
12,250,250,71,9,62,4,3
6,255,255,12,12,0,1,0
13,294,294,26,26,0,1,0
2,311,311,90,16,74,3,2
11,313,313,24,24,0,1,0
4,318,318,27,5,22,3,2
7,348,348,32,32,0,1,0
1,352,352,104,104,0,1,0
9,383,383,41,41,0,1,0
8,427,427,16,3,13,2,1
0,434,434,89,38,51,4,3
3,459,459,12,6,6,3,2
5,471,471,16,16,0,1,0

8,107,107,9,5,4,2,1
9,114,114,2,2,0,1,0
6,139,139,6,1,5,2,1
4,151,151,14,14,0,1,0
5,190,190,23,16,7,2,1
14,202,202,39,39,0,1,0
19,207,207,11,7,4,2,1
2,240,240,51,51,0,1,0
16,242,242,58,6,52,3,2
18,247,247,3,3,0,1,0
7,247,247,24,4,20,3,2
17,266,266,12,12,0,1,0
10,273,273,6,6,0,1,0
11,288,288,61,16,45,4,3
3,304,304,21,9,12,4,3
12,381,381,14,5,9,4,3
0,431,431,27,5,22,3,2
15,452,452,32,10,22,2,1
1,464,464,37,26,11,2,1
13,479,479,26,26,0,1,0

4,121,121,14,2,12,3,2
10,121,121,35,21,14,3,2
17,153,153,18,3,15,2,1
6,173,173,3,3,0,1,0
5,207,207,3,3,0,1,0
3,222,222,22,8,14,2,1
14,249,249,4,1,3,2,1
8,252,252,38,10,28,3,2
15,253,253,6,6,0,1,0
13,281,281,60,13,47,2,1
0,344,344,20,20,0,1,0
12,348,348,30,30,0,1,0
9,362,362,28,28,0,1,0
2,374,374,15,15,0,1,0
16,402,402,1,1,0,1,0
1,405,405,1,1,0,1,0
7,416,416,18,8,10,2,1
11,424,424,89,43,46,2,1
18,489,489,75,75,0,1,0
19,497,497,44,4,40,2,1

13,109,109,4,1,3,2,1
6,109,109,11,11,0,1,0
16,119,119,10,10,0,1,0
1,122,122,20,15,5,2,1
3,130,130,6,6,0,1,0
14,130,130,14,5,9,2,1
2,139,139,1,1,0,1,0
5,167,167,1,1,0,1,0
7,213,213,45,6,39,2,1
12,225,225,12,12,0,1,0
18,294,294,127,114,13,2,1
8,309,309,1,1,0,1,0
15,311,311,42,16,26,3,2
0,341,341,11,1,10,2,1
19,351,351,8,2,6,3,2
9,364,364,4,4,0,1,0
17,372,372,2,2,0,1,0
4,405,405,5,5,0,1,0
11,468,468,20,20,0,1,0
10,470,470,144,6,138,4,3

0,140,140,9,9,0,1,0
15,163,163,55,23,32,2,1
8,168,168,11,2,9,2,1
10,264,264,16,13,3,2,1
11,277,277,5,5,0,1,0
9,284,284,1,1,0,1,0
7,285,285,19,11,8,3,2
2,325,325,125,86,39,4,3
1,346,346,8,2,6,3,2
3,371,371,3,3,0,1,0
14,384,384,7,7,0,1,0
13,405,405,21,21,0,1,0
12,427,427,124,46,78,4,3
6,450,450,35,35,0,1,0
4,466,466,157,136,21,4,3
5,490,490,3,3,0,1,0

15,115,115,6,6,0,1,0
4,118,118,13,4,9,2,1
9,134,134,1,1,0,1,0
12,161,161,24,24,0,1,0
1,206,206,1,1,0,1,0
11,224,224,39,1,38,3,2
13,268,268,51,11,40,2,1
10,297,297,40,40,0,1,0
3,303,303,8,1,7,2,1
14,320,320,32,32,0,1,0
7,324,324,33,12,21,4,3
5,376,376,126,44,82,4,3
6,391,391,28,28,0,1,0
2,408,408,61,61,0,1,0
8,421,421,9,9,0,1,0
0,425,425,43,43,0,1,0
16,428,428,39,1,38,4,3

7,116,116,3,3,0,1,0
12,192,192,3,3,0,1,0
6,207,207,4,1,3,2,1
10,239,239,9,9,0,1,0
13,256,256,18,18,0,1,0
2,305,305,14,14,0,1,0
17,320,320,12,12,0,1,0
4,321,321,60,12,48,4,3
16,363,363,84,84,0,1,0
8,379,379,22,3,19,2,1
1,380,380,64,17,47,2,1
3,392,392,15,15,0,1,0
14,404,404,93,2,91,4,3
11,414,414,14,14,0,1,0
15,419,419,92,20,72,4,3
5,431,431,90,90,0,1,0
9,473,473,18,18,0,1,0
0,477,477,72,3,69,4,3

9,159,159,7,7,0,1,0
5,173,173,5,5,0,1,0
2,207,207,24,9,15,4,3
15,215,215,52,18,34,2,1
4,234,234,66,27,39,4,3
14,266,266,32,8,24,2,1
17,270,270,37,37,0,1,0
13,278,278,64,14,50,3,2
11,281,281,11,8,3,2,1
10,292,292,21,6,15,2,1
16,299,299,1,1,0,1,0
8,311,311,6,6,0,1,0
7,343,343,58,40,18,4,3
1,421,421,11,8,3,2,1
0,424,424,3,3,0,1,0
3,438,438,68,68,0,1,0
12,452,452,14,1,13,2,1
6,495,495,49,49,0,1,0

11,117,117,7,1,6,2,1
18,124,124,15,15,0,1,0
17,229,229,3,3,0,1,0
8,251,251,80,24,56,4,3
2,270,270,14,14,0,1,0
16,291,291,109,109,0,1,0
14,326,326,36,9,27,2,1
15,332,332,52,52,0,1,0
3,332,332,57,57,0,1,0
1,353,353,14,14,0,1,0
0,356,356,38,38,0,1,0
9,375,375,3,3,0,1,0
7,378,378,8,4,4,2,1
4,404,404,40,40,0,1,0
6,411,411,5,5,0,1,0
10,458,458,32,26,6,2,1
13,463,463,2,2,0,1,0
5,490,490,36,9,27,3,2
12,497,497,5,2,3,2,1

13,106,106,7,4,3,2,1
5,109,109,4,1,3,2,1
3,126,126,4,1,3,2,1
12,132,132,22,22,0,1,0
2,148,148,17,5,12,2,1
17,158,158,27,12,15,2,1
14,205,205,24,18,6,2,1
11,271,271,38,6,32,3,2
8,323,323,15,15,0,1,0
7,324,324,13,9,4,2,1
16,340,340,42,33,9,4,3
1,353,353,16,16,0,1,0
4,456,456,78,78,0,1,0
15,467,467,10,10,0,1,0
10,469,469,37,37,0,1,0
0,481,481,108,82,26,2,1
6,486,486,92,22,70,3,2
9,499,499,15,15,0,1,0

13,107,107,5,5,0,1,0
11,135,135,15,15,0,1,0
9,145,145,2,2,0,1,0
12,150,150,24,24,0,1,0
10,164,164,6,6,0,1,0
1,169,169,21,8,13,2,1
2,176,176,40,40,0,1,0
5,193,193,4,4,0,1,0
0,218,218,19,19,0,1,0
14,250,250,82,82,0,1,0
7,274,274,13,6,7,2,1
3,291,291,32,32,0,1,0
8,316,316,39,12,27,4,3
4,416,416,138,72,66,4,3
6,494,494,25,25,0,1,0

9,124,124,29,25,4,2,1
4,136,136,9,4,5,2,1
14,199,199,23,2,21,4,3
20,201,201,1,1,0,1,0
6,215,215,12,8,4,2,1
2,226,226,3,3,0,1,0
5,231,231,1,1,0,1,0
7,249,249,31,31,0,1,0
1,251,251,38,6,32,2,1
0,262,262,30,16,14,2,1
18,302,302,27,10,17,2,1
12,310,310,16,3,13,2,1
10,319,319,15,11,4,2,1
17,324,324,4,4,0,1,0
11,357,357,1,1,0,1,0
8,366,366,9,3,6,2,1
19,420,420,67,34,33,4,3
3,471,471,5,5,0,1,0
13,483,483,71,71,0,1,0
15,484,484,68,68,0,1,0
16,489,489,103,84,19,2,1
21,491,491,18,18,0,1,0

15,100,100,6,2,4,2,1
6,107,107,1,1,0,1,0
0,113,113,1,1,0,1,0
14,122,122,25,25,0,1,0
18,198,198,7,7,0,1,0
4,255,255,21,13,8,2,1
12,261,261,25,19,6,2,1
7,263,263,8,2,6,3,2
16,325,325,56,56,0,1,0
5,337,337,17,17,0,1,0
17,348,348,5,1,4,2,1
2,353,353,26,4,22,3,2
19,362,362,26,26,0,1,0
11,365,365,54,54,0,1,0
20,382,382,19,7,12,4,3
8,385,385,71,71,0,1,0
13,392,392,87,87,0,1,0
9,414,414,5,5,0,1,0
1,419,419,53,26,27,2,1
3,467,467,41,41,0,1,0
10,492,492,43,22,21,2,1

20,110,110,21,14,7,2,1
2,118,118,8,8,0,1,0
10,125,125,2,2,0,1,0
7,136,136,9,4,5,2,1
16,164,164,6,6,0,1,0
3,172,172,20,8,12,4,3
14,173,173,4,1,3,2,1
17,261,261,5,5,0,1,0
0,285,285,11,5,6,2,1
1,297,297,7,1,6,2,1
18,319,319,26,26,0,1,0
5,330,330,70,36,34,2,1
9,332,332,17,17,0,1,0
12,341,341,117,99,18,4,3
15,378,378,42,42,0,1,0
13,390,390,16,9,7,2,1
4,403,403,11,11,0,1,0
8,406,406,64,64,0,1,0
6,422,422,21,21,0,1,0
11,431,431,32,6,26,3,2
19,462,462,36,36,0,1,0

11,106,106,1,1,0,1,0
20,167,167,14,14,0,1,0
10,175,175,10,2,8,2,1
17,176,176,22,22,0,1,0
19,184,184,47,47,0,1,0
14,196,196,16,16,0,1,0
5,209,209,4,4,0,1,0
13,212,212,13,1,12,3,2
18,235,235,4,4,0,1,0
21,241,241,35,10,25,2,1
22,242,242,4,4,0,1,0
15,244,244,12,8,4,2,1
0,263,263,17,2,15,2,1
3,294,294,13,10,3,2,1
16,311,311,47,33,14,3,2
4,328,328,1,1,0,1,0
9,387,387,1,1,0,1,0
12,418,418,35,35,0,1,0
1,429,429,55,55,0,1,0
8,438,438,13,13,0,1,0
2,458,458,4,1,3,2,1
6,475,475,6,1,5,2,1
7,484,484,182,94,88,4,3

3,106,106,6,6,0,1,0
1,114,114,24,2,22,2,1
5,121,121,9,9,0,1,0
7,186,186,8,8,0,1,0
2,199,199,31,5,26,3,2
13,229,229,43,43,0,1,0
16,252,252,20,20,0,1,0
4,262,262,40,40,0,1,0
10,318,318,14,14,0,1,0
15,319,319,83,83,0,1,0
6,346,346,19,2,17,4,3
14,356,356,13,1,12,4,3
12,372,372,47,47,0,1,0
11,383,383,34,34,0,1,0
9,405,405,2,2,0,1,0
0,429,429,66,66,0,1,0
8,431,431,37,37,0,1,0

6,120,120,3,3,0,1,0
0,133,133,3,3,0,1,0
14,154,154,26,26,0,1,0
10,170,170,10,1,9,4,3
1,226,226,42,42,0,1,0
9,232,232,33,6,27,2,1
3,241,241,1,1,0,1,0
8,258,258,22,22,0,1,0
17,280,280,23,7,16,4,3
7,342,342,36,8,28,4,3
4,349,349,42,12,30,2,1
15,365,365,67,40,27,2,1
2,379,379,52,52,0,1,0
12,416,416,23,13,10,2,1
11,433,433,80,54,26,3,2
16,439,439,13,13,0,1,0
13,470,470,3,3,0,1,0
5,497,497,108,108,0,1,0

10,129,129,17,17,0,1,0
4,133,133,12,5,7,2,1
14,152,152,41,14,27,4,3
5,185,185,48,48,0,1,0
13,187,187,3,3,0,1,0
2,198,198,18,2,16,2,1
6,209,209,12,12,0,1,0
12,239,239,21,21,0,1,0
7,252,252,6,3,3,2,1
15,266,266,6,1,5,2,1
3,334,334,9,9,0,1,0
0,337,337,55,32,23,2,1
16,344,344,23,23,0,1,0
1,407,407,78,32,46,4,3
9,420,420,48,16,32,3,2
8,450,450,57,21,36,4,3
11,488,488,43,22,21,2,1

5,106,106,25,7,18,3,2
8,106,106,3,3,0,1,0
9,145,145,2,2,0,1,0
1,151,151,14,4,10,2,1
0,196,196,10,6,4,2,1
16,262,262,5,5,0,1,0
18,279,279,19,4,15,4,3
19,293,293,132,132,0,1,0
12,300,300,10,10,0,1,0
4,322,322,21,21,0,1,0
14,331,331,31,31,0,1,0
15,343,343,13,4,9,4,3
6,363,363,18,18,0,1,0
2,421,421,35,17,18,4,3
13,425,425,50,28,22,2,1
3,453,453,13,7,6,2,1
10,453,453,85,85,0,1,0
17,453,453,37,28,9,2,1
20,468,468,5,5,0,1,0
7,468,468,13,1,12,4,3
11,477,477,18,11,7,2,1

2,106,106,4,4,0,1,0
8,112,112,3,3,0,1,0
16,141,141,8,8,0,1,0
4,163,163,3,3,0,1,0
13,163,163,13,13,0,1,0
14,163,163,25,15,10,2,1
9,201,201,13,13,0,1,0
22,225,225,11,2,9,4,3
3,229,229,36,18,18,4,3
18,239,239,78,28,50,2,1
6,241,241,10,4,6,3,2
0,244,244,2,2,0,1,0
12,261,261,8,8,0,1,0
1,266,266,5,5,0,1,0
21,291,291,6,1,5,2,1
19,301,301,23,5,18,4,3
10,306,306,20,20,0,1,0
15,346,346,19,19,0,1,0
20,368,368,81,66,15,4,3
23,396,396,25,25,0,1,0
5,415,415,36,12,24,2,1
11,429,429,16,16,0,1,0
17,441,441,24,1,23,2,1
7,500,500,38,38,0,1,0

5,114,114,17,9,8,2,1
16,122,122,26,20,6,2,1
12,146,146,11,11,0,1,0
19,149,149,9,9,0,1,0
17,155,155,3,3,0,1,0
1,171,171,7,7,0,1,0
9,183,183,1,1,0,1,0
7,208,208,10,4,6,2,1
13,214,214,20,5,15,4,3
10,288,288,34,34,0,1,0
15,306,306,34,7,27,2,1
18,330,330,14,14,0,1,0
4,368,368,73,73,0,1,0
0,390,390,5,2,3,2,1
2,433,433,48,48,0,1,0
8,437,437,88,88,0,1,0
6,441,441,6,6,0,1,0
3,459,459,1,1,0,1,0
14,474,474,5,5,0,1,0
11,482,482,142,10,132,4,3

2,130,130,8,1,7,2,1
5,161,161,68,58,10,2,1
9,167,167,21,3,18,3,2
6,171,171,23,23,0,1,0
10,201,201,14,14,0,1,0
3,210,210,1,1,0,1,0
14,232,232,20,20,0,1,0
12,264,264,1,1,0,1,0
11,284,284,9,9,0,1,0
4,330,330,15,5,10,3,2
1,430,430,117,17,100,3,2
7,444,444,35,30,5,2,1
8,448,448,135,135,0,1,0
0,452,452,43,4,39,3,2
13,466,466,39,20,19,3,2

15,104,104,29,29,0,1,0
8,153,153,10,10,0,1,0
7,183,183,52,5,47,4,3
11,192,192,18,18,0,1,0
1,262,262,3,3,0,1,0
6,270,270,9,5,4,2,1
2,274,274,126,71,55,3,2
14,276,276,15,15,0,1,0
9,287,287,7,7,0,1,0
10,303,303,7,7,0,1,0
13,375,375,12,12,0,1,0
0,430,430,72,72,0,1,0
4,438,438,3,3,0,1,0
12,440,440,28,23,5,2,1
3,489,489,18,18,0,1,0
5,495,495,93,93,0,1,0

13,120,120,30,30,0,1,0
6,129,129,54,26,28,3,2
8,161,161,5,5,0,1,0
12,180,180,7,7,0,1,0
0,226,226,23,23,0,1,0
4,249,249,55,17,38,3,2
7,265,265,19,19,0,1,0
1,293,293,46,46,0,1,0
9,314,314,13,13,0,1,0
3,358,358,80,42,38,2,1
5,387,387,25,3,22,3,2
2,412,412,55,55,0,1,0
14,428,428,14,2,12,4,3
10,432,432,9,9,0,1,0
11,497,497,7,2,5,2,1

3,102,102,53,20,33,2,1
12,146,146,8,4,4,2,1
5,183,183,20,20,0,1,0
11,191,191,1,1,0,1,0
2,196,196,42,42,0,1,0
6,248,248,18,6,12,2,1
0,318,318,36,36,0,1,0
1,333,333,18,18,0,1,0
9,396,396,12,9,3,2,1
8,417,417,215,215,0,1,0
10,435,435,35,26,9,2,1
4,446,446,10,1,9,2,1
7,459,459,11,1,10,3,2

16,138,138,2,2,0,1,0
5,142,142,13,13,0,1,0
4,175,175,2,2,0,1,0
9,212,212,47,47,0,1,0
14,243,243,32,19,13,2,1
0,249,249,14,14,0,1,0
8,273,273,1,1,0,1,0
15,318,318,51,23,28,2,1
7,344,344,36,19,17,2,1
6,352,352,86,86,0,1,0
1,375,375,3,3,0,1,0
3,398,398,95,4,91,4,3
10,409,409,12,12,0,1,0
13,421,421,73,46,27,2,1
12,427,427,42,42,0,1,0
11,434,434,35,35,0,1,0
2,485,485,71,71,0,1,0

15,113,113,10,10,0,1,0
13,119,119,24,18,6,2,1
0,159,159,22,22,0,1,0
16,161,161,8,8,0,1,0
17,168,168,11,3,8,2,1
8,180,180,24,24,0,1,0
6,226,226,13,4,9,4,3
18,230,230,17,17,0,1,0
4,258,258,30,2,28,3,2
7,265,265,5,2,3,2,1
10,280,280,74,74,0,1,0
1,300,300,26,26,0,1,0
5,318,318,38,10,28,3,2
9,326,326,13,8,5,2,1
14,429,429,54,54,0,1,0
11,441,441,8,1,7,3,2
3,460,460,1,1,0,1,0
12,464,464,16,16,0,1,0
2,493,493,93,93,0,1,0

9,117,117,21,4,17,2,1
3,122,122,13,13,0,1,0
6,157,157,9,9,0,1,0
15,158,158,4,1,3,2,1
17,178,178,10,4,6,3,2
18,216,216,37,29,8,2,1
4,219,219,33,33,0,1,0
2,248,248,41,41,0,1,0
14,251,251,38,38,0,1,0
8,261,261,25,25,0,1,0
11,284,284,1,1,0,1,0
1,292,292,13,13,0,1,0
0,296,296,5,5,0,1,0
7,297,297,22,8,14,3,2
5,349,349,4,4,0,1,0
12,374,374,57,39,18,2,1
10,427,427,88,88,0,1,0
16,430,430,64,64,0,1,0
13,467,467,3,3,0,1,0

13,111,111,11,2,9,4,3
9,120,120,13,13,0,1,0
0,167,167,23,23,0,1,0
19,177,177,13,1,12,2,1
8,179,179,7,1,6,2,1
14,194,194,30,3,27,4,3
15,241,241,4,4,0,1,0
18,256,256,26,26,0,1,0
17,293,293,19,4,15,2,1
1,299,299,44,20,24,4,3
3,333,333,1,1,0,1,0
12,356,356,38,38,0,1,0
16,378,378,22,14,8,3,2
10,403,403,10,10,0,1,0
2,415,415,35,5,30,2,1
4,422,422,36,36,0,1,0
7,468,468,66,32,34,3,2
6,471,471,58,58,0,1,0
11,476,476,118,82,36,3,2
5,480,480,4,4,0,1,0

10,105,105,11,4,7,2,1
9,158,158,6,2,4,2,1
13,167,167,63,18,45,2,1
6,174,174,11,1,10,2,1
15,199,199,15,9,6,2,1
12,229,229,4,1,3,2,1
2,236,236,50,50,0,1,0
11,251,251,36,36,0,1,0
7,294,294,8,4,4,2,1
4,324,324,29,5,24,2,1
1,351,351,9,9,0,1,0
14,424,424,44,44,0,1,0
0,427,427,168,143,25,2,1
8,450,450,14,14,0,1,0
5,454,454,15,12,3,2,1
3,494,494,42,42,0,1,0

16,110,110,5,5,0,1,0
9,111,111,20,20,0,1,0
5,119,119,6,2,4,2,1
8,177,177,7,7,0,1,0
12,211,211,45,35,10,2,1
10,234,234,6,6,0,1,0
0,267,267,4,4,0,1,0
7,267,267,1,1,0,1,0
1,297,297,45,36,9,2,1
11,349,349,46,22,24,4,3
18,363,363,24,24,0,1,0
6,374,374,40,40,0,1,0
3,424,424,112,112,0,1,0
4,437,437,2,2,0,1,0
2,437,437,40,40,0,1,0
17,446,446,110,66,44,4,3
14,447,447,30,30,0,1,0
13,451,451,23,23,0,1,0
15,488,488,35,17,18,3,2

16,190,190,8,8,0,1,0
13,210,210,13,8,5,2,1
5,286,286,69,59,10,3,2
1,303,303,8,8,0,1,0
14,314,314,24,24,0,1,0
12,332,332,37,37,0,1,0
0,348,348,47,47,0,1,0
15,374,374,29,9,20,3,2
6,379,379,6,6,0,1,0
4,393,393,24,3,21,2,1
11,413,413,131,59,72,4,3
8,417,417,11,11,0,1,0
3,426,426,34,34,0,1,0
7,437,437,38,16,22,2,1
9,438,438,63,1,62,3,2
2,476,476,121,31,90,4,3
10,476,476,28,28,0,1,0

6,128,128,10,10,0,1,0
0,131,131,6,6,0,1,0
2,136,136,11,11,0,1,0
5,144,144,22,16,6,2,1
4,213,213,29,5,24,3,2
15,231,231,26,26,0,1,0
3,253,253,13,8,5,2,1
16,267,267,81,7,74,3,2
11,307,307,2,2,0,1,0
9,307,307,58,58,0,1,0
12,327,327,36,18,18,4,3
10,361,361,10,10,0,1,0
1,366,366,22,5,17,4,3
18,386,386,24,5,19,4,3
17,454,454,43,43,0,1,0
7,477,477,14,14,0,1,0
13,479,479,66,2,64,3,2
8,481,481,38,8,30,4,3
14,487,487,30,8,22,3,2

4,127,127,8,8,0,1,0
0,140,140,12,3,9,4,3
8,152,152,6,6,0,1,0
6,180,180,26,26,0,1,0
3,183,183,20,11,9,4,3
5,233,233,14,1,13,2,1
10,235,235,18,18,0,1,0
14,251,251,32,16,16,2,1
1,253,253,49,11,38,3,2
7,259,259,31,10,21,4,3
16,324,324,92,80,12,2,1
2,331,331,30,24,6,3,2
9,347,347,38,38,0,1,0
17,361,361,11,4,7,2,1
13,364,364,2,2,0,1,0
15,403,403,62,2,60,3,2
12,408,408,13,3,10,2,1
11,459,459,44,20,24,3,2

7,130,130,3,3,0,1,0
13,132,132,51,18,33,4,3
10,143,143,1,1,0,1,0
12,164,164,2,2,0,1,0
19,183,183,37,37,0,1,0
14,188,188,18,8,10,2,1
6,212,212,3,3,0,1,0
5,220,220,10,1,9,2,1
2,223,223,49,16,33,2,1
11,238,238,2,2,0,1,0
3,247,247,25,9,16,4,3
9,262,262,36,24,12,2,1
1,328,328,24,24,0,1,0
17,384,384,2,2,0,1,0
4,406,406,23,11,12,2,1
0,419,419,6,6,0,1,0
15,423,423,4,4,0,1,0
20,440,440,31,31,0,1,0
18,449,449,2,2,0,1,0
8,459,459,92,29,63,4,3
16,470,470,61,61,0,1,0

21,100,100,56,56,0,1,0
14,132,132,3,3,0,1,0
23,209,209,1,1,0,1,0
18,212,212,29,29,0,1,0
4,216,216,2,2,0,1,0
2,222,222,15,15,0,1,0
7,230,230,8,8,0,1,0
8,237,237,6,6,0,1,0
11,238,238,53,7,46,3,2
22,270,270,17,10,7,2,1
0,297,297,18,12,6,2,1
17,297,297,2,2,0,1,0
9,304,304,10,10,0,1,0
3,304,304,25,14,11,2,1
15,315,315,10,10,0,1,0
16,325,325,42,14,28,3,2
13,326,326,17,11,6,3,2
10,369,369,4,1,3,2,1
6,374,374,2,2,0,1,0
1,380,380,21,7,14,2,1
25,398,398,12,8,4,2,1
12,412,412,7,7,0,1,0
5,417,417,18,18,0,1,0
20,422,422,8,8,0,1,0
24,474,474,15,15,0,1,0
19,476,476,32,32,0,1,0

19,105,105,3,3,0,1,0
16,107,107,42,42,0,1,0
18,147,147,6,6,0,1,0
14,148,148,10,3,7,2,1
6,159,159,28,2,26,3,2
3,161,161,6,3,3,2,1
0,169,169,1,1,0,1,0
10,182,182,17,11,6,3,2
7,184,184,13,13,0,1,0
17,209,209,8,8,0,1,0
12,256,256,22,12,10,2,1
15,288,288,64,31,33,2,1
9,328,328,51,12,39,4,3
2,365,365,54,34,20,3,2
11,369,369,11,11,0,1,0
4,384,384,51,51,0,1,0
13,410,410,10,10,0,1,0
1,461,461,29,6,23,2,1
5,478,478,4,4,0,1,0
8,495,495,7,1,6,2,1

6,111,111,10,10,0,1,0
16,140,140,12,12,0,1,0
5,147,147,1,1,0,1,0
4,226,226,46,12,34,2,1
3,233,233,1,1,0,1,0
12,236,236,10,4,6,3,2
1,241,241,16,16,0,1,0
9,276,276,8,8,0,1,0
10,283,283,20,20,0,1,0
13,326,326,22,22,0,1,0
14,344,344,71,41,30,4,3
7,396,396,91,91,0,1,0
8,399,399,66,22,44,3,2
11,404,404,12,8,4,2,1
15,418,418,91,73,18,3,2
2,423,423,17,5,12,2,1
0,487,487,127,31,96,3,2

10,102,102,17,17,0,1,0
1,110,110,12,12,0,1,0
8,184,184,24,24,0,1,0
3,202,202,14,2,12,2,1
0,207,207,40,40,0,1,0
13,225,225,23,23,0,1,0
11,236,236,29,24,5,2,1
15,265,265,15,12,3,2,1
4,266,266,59,49,10,2,1
14,280,280,20,20,0,1,0
12,289,289,8,4,4,2,1
9,290,290,50,50,0,1,0
16,326,326,25,25,0,1,0
2,376,376,30,18,12,2,1
6,407,407,29,29,0,1,0
7,414,414,46,46,0,1,0
5,444,444,20,10,10,2,1

17,113,113,32,12,20,3,2
7,114,114,15,15,0,1,0
18,114,114,7,7,0,1,0
3,128,128,6,6,0,1,0
1,136,136,8,4,4,2,1
4,164,164,20,20,0,1,0
24,172,172,8,2,6,3,2
6,186,186,6,6,0,1,0
20,188,188,2,2,0,1,0
22,190,190,3,3,0,1,0
23,231,231,3,3,0,1,0
19,253,253,44,44,0,1,0
11,300,300,2,2,0,1,0
16,303,303,21,21,0,1,0
21,317,317,79,42,37,2,1
2,344,344,9,9,0,1,0
12,362,362,7,7,0,1,0
10,364,364,1,1,0,1,0
15,368,368,7,7,0,1,0
8,376,376,9,6,3,2,1
5,445,445,53,53,0,1,0
0,471,471,19,19,0,1,0
9,472,472,9,9,0,1,0
14,482,482,56,56,0,1,0
13,493,493,58,58,0,1,0

1,134,134,11,11,0,1,0
15,154,154,2,2,0,1,0
9,161,161,2,2,0,1,0
6,174,174,1,1,0,1,0
12,267,267,27,27,0,1,0
4,275,275,35,35,0,1,0
11,299,299,97,79,18,3,2
7,305,305,37,37,0,1,0
0,317,317,9,3,6,2,1
17,330,330,76,76,0,1,0
2,339,339,28,14,14,2,1
10,346,346,32,32,0,1,0
14,350,350,22,3,19,2,1
18,370,370,1,1,0,1,0
16,372,372,35,15,20,2,1
3,380,380,46,20,26,2,1
13,399,399,29,3,26,2,1
5,431,431,17,4,13,2,1
19,467,467,4,4,0,1,0
8,495,495,94,14,80,4,3

5,107,107,18,9,9,4,3
10,130,130,34,2,32,3,2
2,134,134,42,42,0,1,0
15,164,164,3,3,0,1,0
7,211,211,23,8,15,2,1
1,312,312,7,7,0,1,0
4,342,342,56,22,34,3,2
14,393,393,23,23,0,1,0
6,417,417,92,69,23,2,1
0,426,426,1,1,0,1,0
8,429,429,62,56,6,3,2
12,430,430,4,4,0,1,0
13,447,447,56,17,39,4,3
3,449,449,5,2,3,2,1
9,481,481,54,13,41,2,1
11,492,492,38,22,16,3,2

1,112,112,13,13,0,1,0
16,123,123,11,2,9,4,3
8,124,124,7,7,0,1,0
9,154,154,1,1,0,1,0
13,167,167,3,3,0,1,0
3,173,173,17,17,0,1,0
19,179,179,40,1,39,4,3
2,192,192,3,3,0,1,0
10,195,195,17,10,7,2,1
15,201,201,34,34,0,1,0
11,273,273,56,56,0,1,0
14,274,274,2,2,0,1,0
12,327,327,14,6,8,2,1
18,362,362,14,14,0,1,0
0,371,371,28,28,0,1,0
6,384,384,13,13,0,1,0
17,387,387,49,49,0,1,0
5,411,411,1,1,0,1,0
4,448,448,108,93,15,4,3
7,477,477,81,1,80,3,2

4,140,140,3,3,0,1,0
3,167,167,8,1,7,2,1
7,179,179,1,1,0,1,0
18,194,194,40,7,33,2,1
11,209,209,20,20,0,1,0
12,237,237,10,10,0,1,0
9,248,248,36,36,0,1,0
15,263,263,77,77,0,1,0
0,275,275,28,8,20,2,1
14,278,278,18,18,0,1,0
5,289,289,4,4,0,1,0
13,292,292,17,9,8,3,2
6,296,296,6,6,0,1,0
2,330,330,16,16,0,1,0
10,346,346,3,3,0,1,0
17,353,353,21,21,0,1,0
19,354,354,7,7,0,1,0
16,429,429,36,4,32,2,1
8,453,453,41,41,0,1,0
1,465,465,185,146,39,3,2

1,156,156,8,8,0,1,0
6,167,167,4,1,3,2,1
3,181,181,10,10,0,1,0
12,181,181,15,1,14,2,1
5,209,209,11,11,0,1,0
13,214,214,10,10,0,1,0
7,225,225,3,3,0,1,0
0,244,244,73,73,0,1,0
2,259,259,2,2,0,1,0
11,296,296,28,18,10,3,2
4,309,309,128,81,47,3,2
9,320,320,112,14,98,3,2
10,326,326,15,15,0,1,0
14,372,372,37,37,0,1,0
15,379,379,52,52,0,1,0
8,476,476,21,21,0,1,0

10,162,162,2,2,0,1,0
12,202,202,11,11,0,1,0
7,210,210,3,3,0,1,0
5,227,227,77,43,34,3,2
8,235,235,4,4,0,1,0
2,240,240,9,6,3,2,1
11,272,272,2,2,0,1,0
4,348,348,104,104,0,1,0
9,358,358,3,3,0,1,0
3,372,372,13,13,0,1,0
0,383,383,17,11,6,2,1
6,384,384,128,39,89,3,2
1,419,419,61,33,28,2,1
13,472,472,174,169,5,2,1
14,483,483,50,50,0,1,0

5,108,108,2,2,0,1,0
15,160,160,14,2,12,2,1
10,198,198,5,5,0,1,0
1,215,215,13,13,0,1,0
11,251,251,15,15,0,1,0
12,258,258,44,44,0,1,0
3,272,272,80,54,26,3,2
0,296,296,12,12,0,1,0
9,310,310,58,20,38,2,1
16,327,327,76,64,12,3,2
8,331,331,83,79,4,2,1
7,336,336,41,15,26,3,2
13,353,353,36,27,9,4,3
2,360,360,20,9,11,2,1
4,394,394,12,3,9,2,1
6,439,439,13,10,3,2,1
14,459,459,10,5,5,2,1
17,479,479,15,15,0,1,0

9,106,106,9,9,0,1,0
2,258,258,28,4,24,4,3
8,270,270,3,3,0,1,0
5,291,291,28,4,24,3,2
3,320,320,3,3,0,1,0
7,346,346,55,55,0,1,0
0,381,381,15,1,14,2,1
6,403,403,20,7,13,2,1
12,432,432,13,13,0,1,0
1,451,451,336,336,0,1,0
11,462,462,94,29,65,4,3
4,468,468,57,57,0,1,0
10,495,495,77,77,0,1,0

1,130,130,8,2,6,2,1
16,152,152,4,1,3,2,1
13,175,175,8,4,4,2,1
5,187,187,13,13,0,1,0
15,227,227,39,18,21,4,3
8,243,243,18,13,5,2,1
2,251,251,86,27,59,3,2
9,279,279,17,11,6,2,1
4,286,286,9,1,8,3,2
17,325,325,135,119,16,2,1
6,327,327,47,47,0,1,0
0,349,349,41,13,28,2,1
14,411,411,25,8,17,2,1
10,426,426,29,8,21,4,3
3,436,436,13,13,0,1,0
11,445,445,22,22,0,1,0
12,493,493,7,3,4,2,1
7,499,499,16,16,0,1,0

18,118,118,4,4,0,1,0
12,134,134,4,1,3,2,1
15,142,142,31,31,0,1,0
16,168,168,5,5,0,1,0
11,189,189,35,35,0,1,0
4,200,200,27,27,0,1,0
17,204,204,12,12,0,1,0
0,205,205,14,7,7,2,1
8,211,211,19,19,0,1,0
14,226,226,36,36,0,1,0
2,299,299,85,1,84,4,3
1,322,322,12,12,0,1,0
3,360,360,26,20,6,2,1
5,361,361,41,41,0,1,0
7,382,382,5,5,0,1,0
13,382,382,76,32,44,2,1
9,399,399,26,26,0,1,0
6,458,458,10,3,7,2,1
10,465,465,5,5,0,1,0

5,109,109,53,26,27,2,1
0,110,110,2,2,0,1,0
1,119,119,2,2,0,1,0
13,127,127,18,10,8,2,1
4,157,157,12,12,0,1,0
8,176,176,6,6,0,1,0
15,182,182,30,5,25,2,1
9,245,245,32,20,12,4,3
3,295,295,16,16,0,1,0
10,298,298,37,37,0,1,0
2,325,325,7,7,0,1,0
6,333,333,76,76,0,1,0
7,349,349,26,26,0,1,0
14,404,404,29,29,0,1,0
11,453,453,22,22,0,1,0
12,458,458,61,61,0,1,0

11,114,114,2,2,0,1,0
15,114,114,4,4,0,1,0
1,126,126,4,1,3,2,1
5,152,152,2,2,0,1,0
14,173,173,1,1,0,1,0
4,178,178,1,1,0,1,0
22,223,223,29,29,0,1,0
9,224,224,13,10,3,2,1
7,225,225,1,1,0,1,0
20,259,259,41,41,0,1,0
17,295,295,21,21,0,1,0
16,307,307,41,41,0,1,0
6,336,336,51,11,40,3,2
24,341,341,35,7,28,3,2
21,367,367,1,1,0,1,0
10,387,387,37,15,22,3,2
19,400,400,36,27,9,4,3
3,408,408,19,13,6,2,1
0,412,412,24,2,22,3,2
23,427,427,17,3,14,2,1
18,450,450,82,38,44,2,1
2,474,474,57,6,51,4,3
13,481,481,98,82,16,3,2
8,484,484,26,26,0,1,0
12,491,491,1,1,0,1,0

2,129,129,17,7,10,2,1
3,143,143,3,3,0,1,0
6,185,185,18,12,6,2,1
14,208,208,26,26,0,1,0
8,261,261,15,1,14,3,2
0,263,263,95,86,9,4,3
5,274,274,18,9,9,4,3
10,295,295,109,31,78,3,2
9,309,309,9,9,0,1,0
1,320,320,54,54,0,1,0
7,363,363,8,8,0,1,0
13,380,380,29,25,4,2,1
12,412,412,22,22,0,1,0
4,433,433,24,8,16,3,2
11,458,458,46,46,0,1,0
15,466,466,37,37,0,1,0

2,106,106,5,5,0,1,0
10,117,117,2,2,0,1,0
7,182,182,21,15,6,2,1
5,215,215,69,51,18,4,3
12,230,230,28,28,0,1,0
13,242,242,6,6,0,1,0
0,250,250,22,2,20,2,1
14,261,261,15,12,3,2,1
8,312,312,43,43,0,1,0
3,355,355,79,72,7,2,1
9,362,362,31,31,0,1,0
1,366,366,48,48,0,1,0
6,424,424,143,57,86,3,2
4,429,429,39,21,18,4,3
11,456,456,9,9,0,1,0

5,105,105,23,5,18,3,2
12,148,148,16,16,0,1,0
1,165,165,8,8,0,1,0
11,321,321,6,3,3,2,1
9,358,358,37,2,35,2,1
4,403,403,56,56,0,1,0
7,403,403,74,42,32,3,2
0,408,408,102,33,69,4,3
6,437,437,15,15,0,1,0
3,442,442,1,1,0,1,0
14,444,444,25,22,3,2,1
2,473,473,116,91,25,4,3
13,474,474,47,47,0,1,0
10,490,490,34,34,0,1,0
8,495,495,120,21,99,4,3

1,114,114,16,16,0,1,0
7,130,130,28,15,13,2,1
6,138,138,29,29,0,1,0
8,175,175,14,6,8,3,2
2,176,176,30,30,0,1,0
12,178,178,17,17,0,1,0
9,310,310,17,2,15,4,3
5,370,370,2,2,0,1,0
3,404,404,208,166,42,4,3
11,436,436,49,49,0,1,0
0,459,459,35,35,0,1,0
10,465,465,38,38,0,1,0
4,499,499,30,30,0,1,0

14,108,108,10,6,4,2,1
9,112,112,8,8,0,1,0
1,113,113,41,15,26,3,2
8,131,131,1,1,0,1,0
0,134,134,7,7,0,1,0
5,166,166,10,10,0,1,0
16,203,203,26,26,0,1,0
15,209,209,25,25,0,1,0
2,216,216,3,3,0,1,0
7,272,272,48,40,8,2,1
11,295,295,2,2,0,1,0
3,304,304,12,12,0,1,0
13,305,305,64,28,36,4,3
12,353,353,74,28,46,2,1
4,423,423,20,20,0,1,0
6,426,426,64,64,0,1,0
10,467,467,35,35,0,1,0

15,106,106,24,4,20,2,1
0,123,123,26,26,0,1,0
6,168,168,32,32,0,1,0
7,171,171,13,1,12,2,1
8,185,185,26,26,0,1,0
13,189,189,9,9,0,1,0
1,196,196,1,1,0,1,0
5,203,203,3,3,0,1,0
4,204,204,10,10,0,1,0
2,231,231,91,3,88,4,3
14,246,246,41,41,0,1,0
10,266,266,11,11,0,1,0
3,267,267,10,10,0,1,0
12,297,297,6,1,5,2,1
9,300,300,8,8,0,1,0
11,450,450,80,50,30,2,1

3,135,135,12,1,11,2,1
1,144,144,12,12,0,1,0
11,154,154,1,1,0,1,0
0,179,179,11,1,10,3,2
15,195,195,7,4,3,2,1
4,206,206,2,2,0,1,0
17,222,222,50,41,9,2,1
12,232,232,22,22,0,1,0
8,239,239,32,32,0,1,0
7,250,250,33,21,12,4,3
13,289,289,20,8,12,4,3
18,297,297,3,3,0,1,0
19,316,316,19,11,8,2,1
2,343,343,38,9,29,2,1
14,355,355,82,48,34,2,1
6,356,356,1,1,0,1,0
9,384,384,59,8,51,4,3
10,428,428,29,29,0,1,0
5,470,470,27,3,24,4,3
16,470,470,87,59,28,2,1

6,126,126,22,22,0,1,0
9,129,129,33,33,0,1,0
13,155,155,9,9,0,1,0
10,168,168,9,9,0,1,0
3,194,194,12,3,9,4,3
7,197,197,50,12,38,3,2
0,254,254,9,4,5,2,1
1,305,305,63,63,0,1,0
15,311,311,1,1,0,1,0
12,323,323,2,2,0,1,0
4,349,349,45,10,35,2,1
8,387,387,80,80,0,1,0
2,396,396,95,49,46,2,1
11,431,431,13,13,0,1,0
14,441,441,23,23,0,1,0
5,486,486,26,26,0,1,0

2,105,105,50,50,0,1,0
12,128,128,25,1,24,2,1
1,145,145,30,5,25,2,1
6,163,163,6,6,0,1,0
4,191,191,23,23,0,1,0
10,261,261,14,14,0,1,0
0,265,265,49,33,16,3,2
9,276,276,17,2,15,2,1
11,303,303,1,1,0,1,0
3,335,335,11,11,0,1,0
7,365,365,71,59,12,4,3
5,383,383,11,5,6,2,1
8,413,413,94,94,0,1,0

1,116,116,15,4,11,2,1
11,120,120,13,13,0,1,0
9,132,132,8,2,6,2,1
8,142,142,20,20,0,1,0
12,146,146,12,8,4,2,1
2,156,156,8,8,0,1,0
13,231,231,13,7,6,2,1
7,238,238,8,2,6,3,2
0,295,295,53,53,0,1,0
10,306,306,31,12,19,2,1
14,332,332,67,42,25,2,1
15,341,341,47,47,0,1,0
6,342,342,40,16,24,3,2
4,353,353,10,10,0,1,0
5,355,355,1,1,0,1,0
3,410,410,161,143,18,4,3

2,111,111,21,21,0,1,0
11,111,111,6,3,3,2,1
14,152,152,9,9,0,1,0
4,167,167,7,2,5,2,1
15,181,181,44,4,40,3,2
17,191,191,47,47,0,1,0
7,235,235,11,11,0,1,0
20,272,272,12,1,11,3,2
9,300,300,18,18,0,1,0
0,317,317,66,48,18,3,2
8,333,333,1,1,0,1,0
12,364,364,31,1,30,4,3
19,378,378,31,31,0,1,0
13,418,418,9,9,0,1,0
3,449,449,9,9,0,1,0
18,450,450,30,30,0,1,0
16,465,465,32,32,0,1,0
1,474,474,39,3,36,3,2
5,485,485,24,14,10,3,2
10,486,486,49,49,0,1,0
6,492,492,26,26,0,1,0

18,149,149,29,29,0,1,0
9,158,158,17,17,0,1,0
12,165,165,25,13,12,4,3
11,175,175,5,5,0,1,0
2,183,183,1,1,0,1,0
8,193,193,6,2,4,2,1
1,194,194,7,7,0,1,0
3,211,211,37,9,28,2,1
17,221,221,2,2,0,1,0
13,233,233,16,3,13,2,1
15,312,312,58,58,0,1,0
14,351,351,35,8,27,2,1
7,372,372,139,139,0,1,0
0,397,397,4,4,0,1,0
6,429,429,24,24,0,1,0
19,446,446,73,55,18,4,3
5,447,447,9,9,0,1,0
10,465,465,11,4,7,2,1
16,474,474,7,7,0,1,0
4,492,492,30,30,0,1,0

6,114,114,20,20,0,1,0
10,138,138,5,1,4,2,1
8,146,146,10,3,7,2,1
16,160,160,29,20,9,2,1
3,219,219,3,3,0,1,0
13,231,231,34,4,30,2,1
15,258,258,37,37,0,1,0
0,266,266,41,41,0,1,0
14,287,287,8,8,0,1,0
9,311,311,15,11,4,2,1
11,324,324,4,4,0,1,0
7,360,360,79,79,0,1,0
5,369,369,20,20,0,1,0
4,428,428,8,5,3,2,1
18,480,480,145,46,99,4,3
12,481,481,26,14,12,4,3
17,481,481,7,4,3,2,1
1,483,483,14,14,0,1,0
2,490,490,59,41,18,3,2

15,152,152,46,46,0,1,0
11,195,195,13,1,12,4,3
3,197,197,1,1,0,1,0
2,266,266,11,8,3,2,1
9,276,276,58,58,0,1,0
0,276,276,21,21,0,1,0
5,295,295,7,1,6,3,2
10,298,298,11,11,0,1,0
1,302,302,30,5,25,2,1
12,348,348,14,14,0,1,0
6,362,362,40,22,18,3,2
17,363,363,50,50,0,1,0
8,401,401,19,19,0,1,0
14,423,423,1,1,0,1,0
7,453,453,195,149,46,3,2
16,466,466,26,14,12,2,1
13,473,473,30,22,8,2,1
4,493,493,33,1,32,2,1

21,114,114,3,3,0,1,0
3,119,119,11,11,0,1,0
16,132,132,20,20,0,1,0
17,145,145,17,17,0,1,0
8,147,147,4,4,0,1,0
7,154,154,2,2,0,1,0
5,170,170,1,1,0,1,0
15,175,175,4,4,0,1,0
0,181,181,17,17,0,1,0
2,199,199,4,4,0,1,0
23,227,227,34,20,14,2,1
18,227,227,8,5,3,2,1
11,271,271,84,34,50,3,2
4,274,274,33,33,0,1,0
6,313,313,14,14,0,1,0
9,382,382,16,8,8,2,1
12,416,416,5,5,0,1,0
19,422,422,17,1,16,2,1
10,428,428,11,1,10,3,2
13,467,467,5,5,0,1,0
1,488,488,5,5,0,1,0
20,489,489,169,61,108,4,3
22,490,490,13,3,10,3,2
14,495,495,36,19,17,4,3

1,126,126,2,2,0,1,0
13,156,156,21,4,17,2,1
8,156,156,32,32,0,1,0
4,164,164,8,8,0,1,0
10,209,209,28,28,0,1,0
5,216,216,2,2,0,1,0
0,217,217,1,1,0,1,0
12,224,224,22,22,0,1,0
3,224,224,38,5,33,4,3
11,230,230,50,50,0,1,0
7,236,236,89,89,0,1,0
9,363,363,16,4,12,2,1
15,381,381,21,21,0,1,0
2,390,390,85,55,30,3,2
14,430,430,7,7,0,1,0
6,463,463,27,27,0,1,0
16,471,471,7,7,0,1,0

7,113,113,10,3,7,2,1
1,144,144,4,1,3,2,1
17,171,171,58,58,0,1,0
2,195,195,5,5,0,1,0
15,222,222,25,10,15,4,3
19,235,235,28,4,24,3,2
13,241,241,20,7,13,2,1
16,269,269,22,22,0,1,0
18,272,272,2,2,0,1,0
4,276,276,17,5,12,3,2
9,327,327,7,1,6,3,2
11,330,330,11,2,9,4,3
3,383,383,14,7,7,2,1
5,407,407,13,10,3,2,1
14,411,411,19,19,0,1,0
0,422,422,108,108,0,1,0
20,440,440,44,20,24,2,1
6,450,450,84,60,24,2,1
8,453,453,1,1,0,1,0
10,472,472,61,49,12,4,3
12,473,473,13,13,0,1,0

13,143,143,26,17,9,2,1
15,159,159,28,28,0,1,0
5,174,174,18,5,13,2,1
12,198,198,13,1,12,4,3
8,208,208,3,3,0,1,0
6,213,213,17,17,0,1,0
9,229,229,1,1,0,1,0
7,265,265,37,37,0,1,0
10,327,327,9,9,0,1,0
0,333,333,37,37,0,1,0
14,339,339,27,7,20,2,1
11,348,348,80,14,66,3,2
2,358,358,11,2,9,2,1
4,405,405,145,124,21,4,3
3,443,443,35,6,29,3,2
1,468,468,65,65,0,1,0

10,131,131,1,1,0,1,0
13,131,131,10,6,4,2,1
12,153,153,5,5,0,1,0
0,200,200,1,1,0,1,0
11,200,200,23,7,16,3,2
8,236,236,67,35,32,2,1
4,271,271,19,19,0,1,0
3,297,297,5,5,0,1,0
6,298,298,14,14,0,1,0
18,302,302,80,80,0,1,0
2,339,339,58,5,53,4,3
15,348,348,21,21,0,1,0
16,348,348,77,77,0,1,0
9,367,367,4,4,0,1,0
1,376,376,3,3,0,1,0
7,387,387,85,18,67,4,3
14,404,404,38,8,30,3,2
17,433,433,22,22,0,1,0
5,481,481,33,15,18,2,1

6,118,118,2,2,0,1,0
18,132,132,32,32,0,1,0
20,150,150,8,8,0,1,0
13,219,219,26,26,0,1,0
1,229,229,15,15,0,1,0
17,263,263,41,41,0,1,0
14,273,273,18,7,11,2,1
9,293,293,18,18,0,1,0
11,314,314,5,5,0,1,0
7,365,365,1,1,0,1,0
21,379,379,16,16,0,1,0
16,384,384,21,4,17,2,1
10,385,385,88,31,57,4,3
15,399,399,57,28,29,2,1
19,424,424,17,17,0,1,0
8,451,451,29,29,0,1,0
2,455,455,75,3,72,4,3
0,455,455,16,16,0,1,0
12,464,464,37,18,19,2,1
5,466,466,26,26,0,1,0
4,469,469,8,8,0,1,0
3,485,485,45,31,14,3,2

11,103,103,2,2,0,1,0
8,109,109,12,12,0,1,0
12,113,113,37,24,13,2,1
9,137,137,3,3,0,1,0
0,145,145,14,14,0,1,0
5,149,149,1,1,0,1,0
4,181,181,46,46,0,1,0
7,304,304,59,26,33,4,3
13,344,344,73,39,34,2,1
10,365,365,20,4,16,3,2
1,393,393,10,4,6,3,2
16,394,394,6,6,0,1,0
14,404,404,39,39,0,1,0
15,412,412,69,11,58,3,2
17,422,422,1,1,0,1,0
3,428,428,20,14,6,2,1
6,458,458,6,6,0,1,0
2,494,494,80,67,13,2,1

10,101,101,2,2,0,1,0
2,201,201,1,1,0,1,0
11,267,267,24,4,20,3,2
14,271,271,6,6,0,1,0
3,302,302,108,51,57,4,3
1,325,325,13,8,5,2,1
12,352,352,55,55,0,1,0
17,363,363,19,2,17,2,1
16,374,374,45,18,27,2,1
4,386,386,85,12,73,4,3
7,388,388,1,1,0,1,0
13,391,391,17,11,6,3,2
6,404,404,20,20,0,1,0
9,437,437,177,138,39,4,3
0,453,453,63,63,0,1,0
5,471,471,19,19,0,1,0
15,477,477,4,4,0,1,0
8,491,491,23,23,0,1,0

13,104,104,19,19,0,1,0
7,106,106,1,1,0,1,0
19,114,114,9,9,0,1,0
16,120,120,21,21,0,1,0
4,142,142,19,4,15,4,3
2,187,187,9,3,6,3,2
20,188,188,33,33,0,1,0
21,219,219,16,9,7,2,1
3,221,221,30,30,0,1,0
9,223,223,2,2,0,1,0
10,237,237,2,2,0,1,0
11,240,240,33,33,0,1,0
18,255,255,1,1,0,1,0
22,317,317,23,11,12,4,3
8,320,320,36,12,24,4,3
5,358,358,2,2,0,1,0
14,366,366,84,39,45,2,1
0,370,370,2,2,0,1,0
15,382,382,31,1,30,4,3
6,430,430,2,2,0,1,0
12,453,453,22,12,10,3,2
17,459,459,17,17,0,1,0
1,490,490,29,26,3,2,1

15,107,107,6,2,4,2,1
3,170,170,16,16,0,1,0
10,182,182,7,4,3,2,1
16,185,185,13,13,0,1,0
14,185,185,32,32,0,1,0
17,257,257,1,1,0,1,0
1,296,296,5,2,3,2,1
9,330,330,10,10,0,1,0
8,346,346,134,128,6,2,1
7,353,353,56,56,0,1,0
6,391,391,6,1,5,2,1
12,393,393,3,3,0,1,0
5,426,426,14,8,6,2,1
2,436,436,4,4,0,1,0
11,454,454,60,60,0,1,0
0,461,461,45,45,0,1,0
4,474,474,42,39,3,2,1
13,493,493,203,173,30,4,3

12,201,201,22,16,6,2,1
4,205,205,2,2,0,1,0
14,290,290,5,5,0,1,0
1,304,304,47,32,15,2,1
2,382,382,53,6,47,3,2
3,382,382,11,11,0,1,0
13,384,384,68,8,60,4,3
7,389,389,50,33,17,2,1
9,414,414,85,17,68,4,3
11,416,416,63,63,0,1,0
5,419,419,129,129,0,1,0
6,449,449,4,4,0,1,0
10,458,458,17,17,0,1,0
0,479,479,125,40,85,4,3
8,500,500,39,9,30,3,2

19,103,103,17,17,0,1,0
22,113,113,3,3,0,1,0
12,129,129,7,7,0,1,0
21,154,154,9,9,0,1,0
3,158,158,1,1,0,1,0
23,165,165,21,21,0,1,0
6,206,206,1,1,0,1,0
1,220,220,10,10,0,1,0
10,221,221,44,22,22,2,1
18,248,248,10,2,8,2,1
11,268,268,2,2,0,1,0
0,281,281,17,7,10,3,2
2,281,281,16,16,0,1,0
20,289,289,75,33,42,3,2
5,307,307,17,3,14,3,2
14,315,315,13,3,10,2,1
4,332,332,19,19,0,1,0
15,360,360,7,1,6,2,1
17,417,417,49,49,0,1,0
13,423,423,30,30,0,1,0
7,461,461,100,100,0,1,0
16,461,461,50,1,49,2,1
9,463,463,10,10,0,1,0
8,488,488,2,2,0,1,0

18,111,111,22,15,7,2,1
17,112,112,22,10,12,2,1
13,119,119,31,22,9,4,3
7,158,158,15,3,12,3,2
0,158,158,3,3,0,1,0
12,176,176,2,2,0,1,0
11,182,182,11,5,6,3,2
19,189,189,10,1,9,4,3
8,245,245,33,14,19,2,1
10,258,258,17,5,12,3,2
6,274,274,45,8,37,2,1
20,297,297,3,3,0,1,0
9,354,354,8,5,3,2,1
3,356,356,32,18,14,2,1
21,368,368,4,4,0,1,0
5,370,370,47,47,0,1,0
15,381,381,31,23,8,2,1
16,403,403,13,13,0,1,0
1,453,453,25,17,8,2,1
2,459,459,5,1,4,2,1
4,468,468,21,1,20,2,1
14,475,475,37,37,0,1,0

11,103,103,13,13,0,1,0
0,116,116,13,13,0,1,0
21,138,138,56,9,47,2,1
5,139,139,6,6,0,1,0
7,170,170,19,7,12,3,2
17,171,171,13,13,0,1,0
13,195,195,8,8,0,1,0
19,219,219,5,1,4,2,1
6,232,232,1,1,0,1,0
2,236,236,28,28,0,1,0
12,248,248,59,59,0,1,0
10,277,277,5,1,4,2,1
9,320,320,4,1,3,2,1
15,324,324,50,26,24,4,3
3,350,350,10,7,3,2,1
14,360,360,26,9,17,2,1
16,368,368,8,8,0,1,0
1,402,402,9,9,0,1,0
8,407,407,11,11,0,1,0
4,426,426,17,17,0,1,0
18,436,436,19,19,0,1,0
20,491,491,39,35,4,2,1

12,125,125,51,1,50,3,2
13,145,145,1,1,0,1,0
7,152,152,1,1,0,1,0
19,154,154,6,6,0,1,0
10,234,234,23,19,4,2,1
8,247,247,8,8,0,1,0
6,251,251,33,7,26,2,1
16,254,254,35,35,0,1,0
1,272,272,35,35,0,1,0
0,282,282,30,7,23,2,1
4,290,290,80,30,50,3,2
18,334,334,19,19,0,1,0
20,369,369,10,10,0,1,0
17,388,388,8,8,0,1,0
14,413,413,62,44,18,4,3
9,414,414,3,3,0,1,0
11,421,421,23,23,0,1,0
5,422,422,8,8,0,1,0
3,422,422,6,6,0,1,0
15,437,437,35,4,31,2,1
2,498,498,13,13,0,1,0

1,180,180,4,1,3,2,1
16,191,191,38,38,0,1,0
2,201,201,6,6,0,1,0
11,210,210,13,13,0,1,0
12,222,222,15,7,8,3,2
5,232,232,49,49,0,1,0
3,258,258,37,3,34,2,1
9,319,319,60,60,0,1,0
6,365,365,7,4,3,2,1
4,390,390,66,27,39,4,3
8,412,412,73,67,6,2,1
0,429,429,1,1,0,1,0
7,435,435,55,55,0,1,0
14,445,445,96,36,60,4,3
10,461,461,38,38,0,1,0
13,478,478,22,22,0,1,0
15,480,480,11,11,0,1,0
17,489,489,14,2,12,3,2

21,118,118,3,3,0,1,0
14,138,138,27,24,3,2,1
24,150,150,2,2,0,1,0
11,153,153,6,3,3,2,1
20,166,166,50,18,32,2,1
6,194,194,1,1,0,1,0
8,205,205,2,2,0,1,0
3,215,215,5,5,0,1,0
13,218,218,4,4,0,1,0
5,223,223,25,18,7,2,1
22,227,227,13,13,0,1,0
15,228,228,1,1,0,1,0
9,245,245,13,13,0,1,0
4,277,277,18,18,0,1,0
7,287,287,21,7,14,2,1
19,293,293,10,10,0,1,0
10,300,300,12,12,0,1,0
23,331,331,8,8,0,1,0
0,341,341,6,6,0,1,0
16,349,349,81,81,0,1,0
17,409,409,20,20,0,1,0
1,413,413,19,11,8,2,1
2,433,433,35,35,0,1,0
12,441,441,52,52,0,1,0
18,446,446,82,31,51,4,3

2,102,102,9,9,0,1,0
11,114,114,4,4,0,1,0
18,122,122,2,2,0,1,0
23,168,168,7,7,0,1,0
21,178,178,15,2,13,2,1
6,239,239,20,20,0,1,0
24,240,240,7,1,6,3,2
4,253,253,36,36,0,1,0
9,255,255,4,4,0,1,0
19,267,267,90,9,81,4,3
22,283,283,12,12,0,1,0
3,320,320,10,3,7,2,1
14,325,325,20,20,0,1,0
1,348,348,9,9,0,1,0
13,349,349,11,2,9,4,3
10,353,353,6,6,0,1,0
5,362,362,24,3,21,2,1
17,367,367,27,27,0,1,0
12,382,382,20,20,0,1,0
15,413,413,70,30,40,3,2
20,425,425,90,27,63,4,3
0,451,451,19,9,10,2,1
8,467,467,4,4,0,1,0
16,469,469,37,23,14,2,1
7,471,471,14,14,0,1,0

6,104,104,3,3,0,1,0
9,126,126,4,4,0,1,0
15,127,127,10,10,0,1,0
14,130,130,6,6,0,1,0
12,173,173,5,5,0,1,0
16,184,184,3,3,0,1,0
0,193,193,30,30,0,1,0
1,201,201,5,5,0,1,0
11,249,249,45,45,0,1,0
4,279,279,46,46,0,1,0
5,298,298,7,7,0,1,0
19,312,312,1,1,0,1,0
20,315,315,74,42,32,2,1
18,322,322,1,1,0,1,0
10,336,336,3,3,0,1,0
21,371,371,62,15,47,4,3
13,400,400,66,66,0,1,0
3,408,408,2,2,0,1,0
8,446,446,94,54,40,3,2
7,461,461,7,4,3,2,1
2,467,467,11,11,0,1,0
17,485,485,97,11,86,4,3

12,124,124,18,3,15,4,3
4,130,130,20,8,12,4,3
9,181,181,13,13,0,1,0
2,189,189,37,25,12,3,2
1,207,207,1,1,0,1,0
3,211,211,22,22,0,1,0
16,251,251,45,28,17,4,3
17,271,271,48,48,0,1,0
6,289,289,9,9,0,1,0
10,318,318,29,29,0,1,0
5,351,351,65,65,0,1,0
15,404,404,57,57,0,1,0
14,426,426,4,1,3,2,1
11,430,430,41,41,0,1,0
0,436,436,20,20,0,1,0
8,447,447,20,4,16,2,1
7,453,453,61,61,0,1,0
13,494,494,1,1,0,1,0

12,138,138,25,25,0,1,0
18,151,151,33,20,13,4,3
8,156,156,17,8,9,4,3
15,186,186,1,1,0,1,0
13,199,199,13,13,0,1,0
19,222,222,10,2,8,3,2
14,228,228,11,11,0,1,0
6,242,242,36,30,6,2,1
7,265,265,5,1,4,2,1
16,312,312,20,11,9,4,3
20,323,323,85,27,58,3,2
9,331,331,12,12,0,1,0
17,346,346,10,10,0,1,0
3,354,354,4,4,0,1,0
1,374,374,21,1,20,4,3
2,411,411,13,13,0,1,0
0,414,414,2,2,0,1,0
10,425,425,79,79,0,1,0
11,439,439,3,3,0,1,0
4,442,442,89,5,84,3,2
5,445,445,40,40,0,1,0

6,110,110,2,2,0,1,0
9,121,121,16,16,0,1,0
10,148,148,3,3,0,1,0
13,158,158,15,3,12,4,3
4,175,175,12,12,0,1,0
14,175,175,19,3,16,2,1
5,194,194,17,5,12,2,1
7,195,195,2,2,0,1,0
11,209,209,65,47,18,3,2
2,233,233,2,2,0,1,0
16,238,238,11,11,0,1,0
0,245,245,33,11,22,2,1
15,252,252,14,14,0,1,0
17,254,254,30,30,0,1,0
3,309,309,121,111,10,3,2
8,358,358,12,12,0,1,0
12,394,394,18,5,13,2,1
1,415,415,61,61,0,1,0

14,102,102,11,11,0,1,0
15,118,118,10,4,6,3,2
10,126,126,1,1,0,1,0
16,147,147,8,5,3,2,1
3,151,151,4,4,0,1,0
18,158,158,15,15,0,1,0
19,216,216,38,1,37,2,1
5,248,248,14,14,0,1,0
7,264,264,13,1,12,2,1
0,268,268,8,8,0,1,0
17,274,274,42,42,0,1,0
4,279,279,119,78,41,2,1
6,293,293,25,25,0,1,0
11,310,310,28,28,0,1,0
13,337,337,45,45,0,1,0
2,348,348,5,5,0,1,0
12,396,396,13,1,12,2,1
8,417,417,34,22,12,2,1
9,437,437,28,2,26,4,3
1,493,493,29,22,7,3,2

0,105,105,10,4,6,2,1
3,108,108,2,2,0,1,0
9,140,140,4,4,0,1,0
21,165,165,13,13,0,1,0
1,170,170,2,2,0,1,0
13,196,196,4,4,0,1,0
22,219,219,21,21,0,1,0
7,239,239,44,14,30,3,2
6,239,239,6,6,0,1,0
8,254,254,3,3,0,1,0
15,255,255,7,3,4,2,1
14,269,269,19,19,0,1,0
16,298,298,21,13,8,2,1
10,344,344,23,23,0,1,0
11,363,363,3,3,0,1,0
19,386,386,19,19,0,1,0
17,390,390,28,9,19,2,1
2,391,391,18,18,0,1,0
4,423,423,98,22,76,3,2
5,426,426,26,19,7,2,1
20,445,445,91,17,74,3,2
18,457,457,114,45,69,4,3
12,482,482,46,24,22,3,2

16,102,102,3,3,0,1,0
8,179,179,45,39,6,2,1
17,201,201,3,3,0,1,0
1,203,203,24,24,0,1,0
18,261,261,71,71,0,1,0
7,261,261,1,1,0,1,0
5,279,279,20,8,12,2,1
6,299,299,23,23,0,1,0
14,301,301,5,5,0,1,0
9,311,311,20,20,0,1,0
11,311,311,81,76,5,2,1
4,330,330,56,56,0,1,0
3,335,335,20,4,16,3,2
0,359,359,9,6,3,2,1
12,361,361,85,40,45,2,1
10,371,371,19,7,12,3,2
15,423,423,10,10,0,1,0
2,449,449,28,28,0,1,0
13,483,483,9,3,6,3,2

1,134,134,1,1,0,1,0
16,141,141,3,3,0,1,0
18,152,152,4,1,3,2,1
4,183,183,13,13,0,1,0
12,201,201,11,11,0,1,0
2,253,253,66,66,0,1,0
8,278,278,10,7,3,2,1
6,297,297,7,7,0,1,0
3,305,305,32,3,29,2,1
17,321,321,12,5,7,2,1
7,336,336,44,21,23,2,1
0,348,348,37,37,0,1,0
5,379,379,12,12,0,1,0
15,398,398,137,137,0,1,0
13,414,414,13,13,0,1,0
9,439,439,56,56,0,1,0
11,442,442,40,40,0,1,0
14,468,468,96,64,32,3,2
10,478,478,50,9,41,2,1

14,136,136,30,12,18,3,2
5,197,197,78,25,53,4,3
6,202,202,29,29,0,1,0
2,208,208,64,19,45,4,3
10,249,249,10,10,0,1,0
12,264,264,22,8,14,3,2
0,281,281,21,21,0,1,0
8,301,301,11,6,5,2,1
3,314,314,3,3,0,1,0
11,328,328,40,4,36,3,2
1,373,373,39,39,0,1,0
9,391,391,67,67,0,1,0
13,391,391,18,18,0,1,0
7,399,399,20,20,0,1,0
4,401,401,4,4,0,1,0

6,144,144,5,5,0,1,0
19,157,157,14,3,11,2,1
17,157,157,5,5,0,1,0
7,175,175,26,7,19,4,3
1,195,195,3,3,0,1,0
2,229,229,20,4,16,2,1
14,233,233,12,12,0,1,0
18,288,288,7,7,0,1,0
15,293,293,20,20,0,1,0
11,310,310,12,12,0,1,0
12,313,313,69,69,0,1,0
10,327,327,33,18,15,4,3
16,327,327,54,26,28,2,1
8,366,366,48,30,18,3,2
3,372,372,42,42,0,1,0
13,426,426,98,35,63,4,3
5,437,437,42,42,0,1,0
4,464,464,54,17,37,2,1
9,474,474,7,7,0,1,0
0,491,491,22,22,0,1,0

12,118,118,8,3,5,2,1
13,137,137,21,1,20,2,1
9,140,140,3,3,0,1,0
1,149,149,8,8,0,1,0
4,188,188,15,3,12,2,1
10,220,220,28,28,0,1,0
0,233,233,33,33,0,1,0
11,279,279,9,9,0,1,0
15,298,298,27,24,3,2,1
8,323,323,24,4,20,2,1
2,329,329,13,10,3,2,1
3,347,347,42,27,15,2,1
19,361,361,6,6,0,1,0
16,361,361,21,5,16,2,1
17,403,403,16,16,0,1,0
18,408,408,157,124,33,4,3
5,439,439,14,6,8,3,2
6,450,450,47,2,45,3,2
7,467,467,50,35,15,4,3
14,473,473,36,9,27,4,3

13,102,102,20,20,0,1,0
2,108,108,24,24,0,1,0
1,119,119,16,16,0,1,0
14,143,143,32,8,24,3,2
6,155,155,18,3,15,3,2
12,174,174,10,10,0,1,0
10,192,192,1,1,0,1,0
8,221,221,25,6,19,2,1
17,243,243,46,28,18,3,2
15,258,258,11,8,3,2,1
7,263,263,1,1,0,1,0
11,293,293,8,1,7,2,1
5,424,424,12,12,0,1,0
4,431,431,89,89,0,1,0
3,440,440,11,11,0,1,0
16,443,443,11,2,9,2,1
0,456,456,25,5,20,2,1
9,467,467,70,70,0,1,0

3,101,101,1,1,0,1,0
10,123,123,24,2,22,3,2
16,134,134,9,5,4,2,1
1,140,140,11,11,0,1,0
15,148,148,8,8,0,1,0
0,151,151,6,3,3,2,1
11,163,163,20,20,0,1,0
20,196,196,12,12,0,1,0
13,258,258,35,29,6,2,1
9,264,264,12,3,9,2,1
5,268,268,39,34,5,2,1
12,298,298,10,10,0,1,0
18,302,302,2,2,0,1,0
2,304,304,5,5,0,1,0
14,345,345,42,19,23,4,3
7,356,356,17,3,14,3,2
4,377,377,38,29,9,4,3
8,385,385,12,2,10,2,1
19,387,387,61,61,0,1,0
6,450,450,31,31,0,1,0
17,483,483,133,7,126,4,3

20,130,130,28,12,16,3,2
13,148,148,9,9,0,1,0
5,151,151,1,1,0,1,0
15,182,182,8,8,0,1,0
7,203,203,42,42,0,1,0
16,204,204,51,21,30,2,1
9,227,227,38,23,15,4,3
10,252,252,11,4,7,2,1
3,263,263,19,9,10,3,2
19,277,277,43,37,6,2,1
8,279,279,4,4,0,1,0
1,306,306,2,2,0,1,0
17,317,317,7,1,6,2,1
14,329,329,22,10,12,4,3
11,330,330,36,36,0,1,0
2,354,354,14,7,7,2,1
18,433,433,11,11,0,1,0
6,445,445,6,6,0,1,0
21,451,451,36,36,0,1,0
12,453,453,26,26,0,1,0
0,471,471,68,42,26,4,3
4,488,488,9,3,6,3,2

0,116,116,6,6,0,1,0
6,155,155,20,7,13,2,1
8,161,161,54,54,0,1,0
16,257,257,8,8,0,1,0
5,290,290,32,20,12,2,1
7,299,299,35,35,0,1,0
13,302,302,67,16,51,3,2
14,326,326,62,2,60,4,3
17,328,328,39,24,15,4,3
10,341,341,44,44,0,1,0
4,362,362,18,18,0,1,0
3,372,372,1,1,0,1,0
2,380,380,11,2,9,2,1
12,386,386,38,9,29,2,1
9,408,408,24,24,0,1,0
1,419,419,32,18,14,3,2
11,420,420,22,7,15,4,3
15,427,427,6,3,3,2,1

17,106,106,1,1,0,1,0
2,141,141,6,1,5,2,1
0,160,160,2,2,0,1,0
9,178,178,12,12,0,1,0
15,185,185,34,34,0,1,0
3,264,264,7,7,0,1,0
12,302,302,34,10,24,3,2
19,311,311,27,27,0,1,0
18,319,319,3,3,0,1,0
13,360,360,16,8,8,2,1
10,375,375,45,36,9,4,3
11,383,383,118,118,0,1,0
6,390,390,18,5,13,2,1
16,399,399,52,27,25,2,1
4,421,421,37,17,20,2,1
14,423,423,15,11,4,2,1
7,466,466,21,4,17,2,1
5,479,479,37,16,21,2,1
1,481,481,148,25,123,4,3
8,484,484,33,33,0,1,0

0,122,122,1,1,0,1,0
14,160,160,3,3,0,1,0
15,166,166,11,1,10,3,2
13,178,178,41,31,10,3,2
1,185,185,4,4,0,1,0
5,194,194,2,2,0,1,0
17,200,200,3,3,0,1,0
22,241,241,38,38,0,1,0
6,254,254,5,2,3,2,1
3,329,329,13,13,0,1,0
19,335,335,3,3,0,1,0
2,339,339,79,43,36,2,1
4,391,391,9,1,8,2,1
8,405,405,13,8,5,2,1
7,429,429,33,33,0,1,0
18,442,442,52,5,47,2,1
11,446,446,60,20,40,2,1
9,455,455,23,2,21,4,3
10,456,456,1,1,0,1,0
23,464,464,19,16,3,2,1
21,465,465,49,49,0,1,0
16,466,466,34,34,0,1,0
20,477,477,155,57,98,4,3
12,484,484,2,2,0,1,0

18,108,108,10,4,6,3,2
14,125,125,26,26,0,1,0
17,130,130,40,5,35,2,1
3,161,161,7,1,6,2,1
0,187,187,2,2,0,1,0
1,206,206,16,8,8,3,2
7,241,241,55,55,0,1,0
13,255,255,22,2,20,2,1
12,284,284,13,13,0,1,0
11,297,297,13,3,10,2,1
4,300,300,12,12,0,1,0
16,308,308,11,5,6,2,1
10,315,315,19,5,14,3,2
6,327,327,78,78,0,1,0
2,368,368,29,29,0,1,0
19,382,382,28,19,9,2,1
9,386,386,34,34,0,1,0
15,414,414,13,13,0,1,0
5,477,477,3,3,0,1,0
8,500,500,15,3,12,2,1

3,111,111,11,11,0,1,0
2,126,126,5,5,0,1,0
8,169,169,31,31,0,1,0
15,170,170,7,7,0,1,0
12,191,191,15,7,8,3,2
6,194,194,1,1,0,1,0
14,214,214,48,48,0,1,0
10,240,240,14,2,12,2,1
16,266,266,44,26,18,2,1
9,267,267,15,6,9,2,1
7,277,277,1,1,0,1,0
0,281,281,1,1,0,1,0
1,298,298,18,11,7,3,2
13,307,307,12,12,0,1,0
11,331,331,73,41,32,2,1
19,376,376,24,24,0,1,0
21,392,392,23,23,0,1,0
20,400,400,119,49,70,4,3
18,411,411,4,1,3,2,1
4,446,446,1,1,0,1,0
17,475,475,7,1,6,3,2
5,476,476,43,43,0,1,0

3,109,109,10,6,4,2,1
7,158,158,11,11,0,1,0
2,211,211,4,4,0,1,0
8,214,214,23,1,22,2,1
4,215,215,6,1,5,2,1
9,260,260,31,31,0,1,0
11,285,285,42,42,0,1,0
1,317,317,225,225,0,1,0
12,341,341,17,8,9,4,3
6,372,372,19,5,14,2,1
5,424,424,49,49,0,1,0
0,437,437,36,10,26,2,1
10,492,492,112,42,70,3,2

9,117,117,4,4,0,1,0
13,147,147,13,13,0,1,0
4,162,162,3,3,0,1,0
21,163,163,13,5,8,3,2
20,169,169,19,3,16,2,1
2,199,199,21,2,19,4,3
11,212,212,3,3,0,1,0
22,212,212,53,47,6,3,2
19,252,252,3,3,0,1,0
15,255,255,1,1,0,1,0
10,285,285,4,1,3,2,1
8,299,299,3,3,0,1,0
17,307,307,4,4,0,1,0
24,318,318,52,52,0,1,0
3,318,318,13,13,0,1,0
23,323,323,9,9,0,1,0
0,324,324,1,1,0,1,0
14,355,355,23,23,0,1,0
12,363,363,13,13,0,1,0
5,372,372,2,2,0,1,0
6,373,373,66,50,16,2,1
7,412,412,47,47,0,1,0
18,428,428,95,68,27,4,3
16,460,460,18,18,0,1,0
1,472,472,81,53,28,2,1

11,106,106,4,4,0,1,0
4,142,142,6,2,4,2,1
12,165,165,16,16,0,1,0
10,180,180,19,16,3,2,1
1,256,256,83,47,36,3,2
13,265,265,14,2,12,2,1
8,268,268,24,24,0,1,0
2,279,279,6,6,0,1,0
7,307,307,70,70,0,1,0
6,355,355,3,3,0,1,0
9,396,396,16,16,0,1,0
15,409,409,53,53,0,1,0
5,423,423,20,12,8,2,1
3,432,432,87,42,45,4,3
0,443,443,114,87,27,2,1
14,460,460,65,9,56,3,2

10,121,121,6,6,0,1,0
16,135,135,12,3,9,2,1
6,142,142,5,5,0,1,0
13,173,173,63,23,40,4,3
0,190,190,12,12,0,1,0
18,213,213,9,6,3,2,1
21,225,225,2,2,0,1,0
5,238,238,1,1,0,1,0
14,251,251,23,1,22,4,3
11,259,259,77,77,0,1,0
4,262,262,4,4,0,1,0
1,270,270,15,15,0,1,0
2,290,290,25,2,23,2,1
12,324,324,7,7,0,1,0
9,331,331,2,2,0,1,0
17,332,332,26,5,21,4,3
19,377,377,4,1,3,2,1
15,388,388,79,55,24,4,3
3,390,390,10,10,0,1,0
8,407,407,71,71,0,1,0
20,489,489,17,11,6,3,2
7,500,500,34,34,0,1,0

16,116,116,28,1,27,2,1
7,129,129,3,3,0,1,0
18,142,142,12,12,0,1,0
14,166,166,21,21,0,1,0
13,231,231,17,17,0,1,0
10,237,237,7,7,0,1,0
17,247,247,5,5,0,1,0
11,291,291,37,20,17,2,1
5,294,294,1,1,0,1,0
2,312,312,38,38,0,1,0
12,353,353,42,26,16,3,2
4,369,369,2,2,0,1,0
15,398,398,33,24,9,2,1
19,410,410,20,11,9,2,1
8,418,418,21,9,12,3,2
0,431,431,15,6,9,2,1
6,433,433,118,118,0,1,0
9,482,482,7,2,5,2,1
3,488,488,48,48,0,1,0
1,498,498,123,12,111,4,3

12,112,112,14,5,9,2,1
14,115,115,15,15,0,1,0
7,118,118,6,6,0,1,0
0,143,143,14,14,0,1,0
13,146,146,9,1,8,2,1
2,206,206,18,18,0,1,0
9,251,251,13,13,0,1,0
1,260,260,140,65,75,4,3
10,261,261,14,6,8,2,1
11,283,283,70,70,0,1,0
3,307,307,15,3,12,2,1
4,371,371,34,28,6,3,2
6,430,430,73,73,0,1,0
5,459,459,17,2,15,2,1
8,482,482,11,11,0,1,0

0,108,108,7,7,0,1,0
8,123,123,4,4,0,1,0
5,141,141,19,3,16,3,2
15,155,155,16,16,0,1,0
12,170,170,7,7,0,1,0
1,209,209,19,5,14,2,1
10,226,226,5,2,3,2,1
14,239,239,29,17,12,4,3
6,240,240,33,14,19,2,1
11,243,243,50,29,21,2,1
7,248,248,8,8,0,1,0
3,290,290,17,9,8,2,1
9,347,347,2,2,0,1,0
2,349,349,4,4,0,1,0
16,356,356,37,5,32,2,1
13,357,357,105,105,0,1,0
4,455,455,155,47,108,4,3
17,470,470,8,8,0,1,0

8,121,121,8,8,0,1,0
3,159,159,4,1,3,2,1
11,162,162,3,3,0,1,0
13,169,169,65,65,0,1,0
14,209,209,40,40,0,1,0
15,214,214,30,4,26,3,2
4,239,239,50,50,0,1,0
16,304,304,2,2,0,1,0
2,342,342,42,13,29,3,2
1,386,386,53,41,12,3,2
6,396,396,91,70,21,2,1
9,406,406,14,14,0,1,0
10,406,406,19,19,0,1,0
5,432,432,6,6,0,1,0
0,457,457,28,5,23,2,1
12,472,472,15,2,13,2,1
7,500,500,51,51,0,1,0

8,116,116,22,8,14,3,2
11,131,131,2,2,0,1,0
6,138,138,15,7,8,2,1
4,208,208,16,4,12,2,1
0,229,229,76,21,55,3,2
14,240,240,28,18,10,3,2
2,316,316,6,6,0,1,0
10,320,320,26,26,0,1,0
13,348,348,29,29,0,1,0
15,357,357,60,26,34,2,1
1,397,397,43,7,36,4,3
12,412,412,44,13,31,4,3
7,438,438,67,67,0,1,0
9,448,448,1,1,0,1,0
5,455,455,85,38,47,4,3
3,456,456,33,33,0,1,0

0,160,160,15,15,0,1,0
2,164,164,21,21,0,1,0
13,175,175,30,25,5,2,1
14,201,201,13,5,8,2,1
3,202,202,8,8,0,1,0
17,218,218,2,2,0,1,0
18,220,220,42,33,9,4,3
7,251,251,17,3,14,2,1
6,254,254,27,27,0,1,0
8,266,266,2,2,0,1,0
11,343,343,39,39,0,1,0
12,355,355,11,11,0,1,0
10,363,363,58,58,0,1,0
9,384,384,66,42,24,3,2
15,388,388,59,59,0,1,0
5,397,397,57,52,5,2,1
16,401,401,10,1,9,2,1
4,424,424,5,2,3,2,1
1,477,477,62,62,0,1,0

10,134,134,4,4,0,1,0
3,141,141,2,2,0,1,0
16,154,154,1,1,0,1,0
13,155,155,25,25,0,1,0
11,185,185,21,21,0,1,0
6,188,188,6,6,0,1,0
12,199,199,15,5,10,3,2
14,277,277,1,1,0,1,0
4,290,290,29,21,8,2,1
2,310,310,107,98,9,4,3
7,368,368,68,68,0,1,0
8,420,420,100,100,0,1,0
15,423,423,104,92,12,4,3
5,425,425,28,28,0,1,0
1,434,434,12,12,0,1,0
9,468,468,20,13,7,2,1
0,479,479,63,30,33,2,1

0,121,121,16,16,0,1,0
6,190,190,3,3,0,1,0
10,254,254,24,11,13,2,1
11,280,280,9,9,0,1,0
16,286,286,14,14,0,1,0
12,291,291,31,31,0,1,0
1,310,310,49,14,35,2,1
8,370,370,117,117,0,1,0
7,405,405,68,68,0,1,0
3,410,410,16,16,0,1,0
14,410,410,15,15,0,1,0
13,449,449,1,1,0,1,0
4,457,457,30,15,15,4,3
15,490,490,72,72,0,1,0
5,492,492,77,77,0,1,0
9,493,493,65,34,31,2,1
2,497,497,82,82,0,1,0

13,143,143,17,17,0,1,0
14,144,144,1,1,0,1,0
3,173,173,35,35,0,1,0
6,200,200,21,21,0,1,0
8,206,206,4,4,0,1,0
15,233,233,8,8,0,1,0
0,282,282,12,12,0,1,0
4,304,304,28,17,11,2,1
5,326,326,22,17,5,2,1
2,345,345,61,61,0,1,0
16,384,384,59,27,32,3,2
1,387,387,57,36,21,4,3
9,398,398,9,2,7,3,2
17,435,435,83,83,0,1,0
12,436,436,91,76,15,4,3
10,447,447,74,26,48,4,3
7,480,480,24,24,0,1,0
11,495,495,10,10,0,1,0

3,100,100,1,1,0,1,0
15,107,107,3,3,0,1,0
1,111,111,3,3,0,1,0
17,133,133,14,11,3,2,1
8,146,146,1,1,0,1,0
11,147,147,22,1,21,2,1
0,216,216,35,4,31,4,3
6,251,251,8,8,0,1,0
16,279,279,17,17,0,1,0
5,282,282,14,6,8,3,2
9,282,282,15,15,0,1,0
12,311,311,29,29,0,1,0
4,333,333,54,4,50,2,1
10,334,334,6,6,0,1,0
13,377,377,17,4,13,2,1
2,378,378,30,27,3,2,1
14,392,392,107,97,10,3,2
18,455,455,65,65,0,1,0
7,470,470,150,106,44,2,1

5,100,100,19,16,3,2,1
17,162,162,6,6,0,1,0
8,212,212,20,20,0,1,0
12,216,216,32,32,0,1,0
7,217,217,5,5,0,1,0
3,232,232,8,8,0,1,0
19,232,232,11,5,6,2,1
18,233,233,19,19,0,1,0
1,241,241,15,15,0,1,0
10,280,280,31,17,14,3,2
0,296,296,11,11,0,1,0
2,313,313,10,10,0,1,0
11,356,356,43,43,0,1,0
9,361,361,9,9,0,1,0
16,396,396,20,8,12,3,2
4,407,407,29,6,23,2,1
20,409,409,29,29,0,1,0
14,419,419,132,46,86,3,2
15,441,441,69,25,44,3,2
6,480,480,48,48,0,1,0
13,494,494,4,1,3,2,1

8,146,146,1,1,0,1,0
6,171,171,1,1,0,1,0
7,192,192,28,28,0,1,0
2,203,203,51,51,0,1,0
12,205,205,21,21,0,1,0
15,215,215,61,25,36,3,2
10,217,217,27,27,0,1,0
9,232,232,10,10,0,1,0
5,247,247,73,39,34,3,2
16,279,279,20,2,18,2,1
14,324,324,56,25,31,2,1
11,372,372,24,24,0,1,0
0,375,375,9,9,0,1,0
13,396,396,18,9,9,4,3
3,435,435,20,20,0,1,0
1,474,474,14,14,0,1,0
4,480,480,49,21,28,3,2

11,119,119,19,19,0,1,0
14,130,130,9,3,6,3,2
13,142,142,6,6,0,1,0
16,143,143,53,23,30,2,1
4,168,168,10,10,0,1,0
1,170,170,28,10,18,2,1
8,200,200,30,7,23,2,1
5,221,221,5,5,0,1,0
15,235,235,35,1,34,3,2
2,258,258,1,1,0,1,0
9,282,282,3,3,0,1,0
7,294,294,7,7,0,1,0
6,366,366,9,9,0,1,0
3,392,392,109,109,0,1,0
12,404,404,6,6,0,1,0
17,412,412,24,24,0,1,0
10,413,413,23,5,18,3,2
0,423,423,74,8,66,4,3

11,128,128,8,8,0,1,0
2,146,146,16,1,15,4,3
14,148,148,38,38,0,1,0
17,165,165,2,2,0,1,0
3,169,169,1,1,0,1,0
4,183,183,2,2,0,1,0
16,197,197,16,3,13,2,1
18,207,207,9,9,0,1,0
7,229,229,30,10,20,2,1
6,278,278,1,1,0,1,0
15,285,285,52,13,39,4,3
8,318,318,8,4,4,2,1
0,337,337,88,88,0,1,0
10,380,380,44,24,20,2,1
12,380,380,38,38,0,1,0
5,429,429,29,13,16,4,3
20,440,440,10,5,5,2,1
9,443,443,32,32,0,1,0
19,454,454,63,63,0,1,0
1,484,484,19,19,0,1,0
13,488,488,36,36,0,1,0

10,100,100,2,2,0,1,0
5,129,129,27,27,0,1,0
11,148,148,17,2,15,2,1
13,257,257,45,22,23,2,1
6,263,263,37,8,29,3,2
15,265,265,11,11,0,1,0
1,280,280,27,27,0,1,0
8,355,355,126,25,101,4,3
2,383,383,47,47,0,1,0
12,398,398,27,20,7,2,1
4,403,403,70,6,64,3,2
7,419,419,9,1,8,2,1
9,443,443,17,6,11,2,1
0,479,479,13,3,10,2,1
3,494,494,65,28,37,4,3
14,495,495,44,44,0,1,0

8,117,117,1,1,0,1,0
6,159,159,15,1,14,3,2
13,179,179,22,7,15,4,3
16,199,199,5,1,4,2,1
3,209,209,16,16,0,1,0
9,224,224,6,6,0,1,0
15,285,285,6,6,0,1,0
10,293,293,6,6,0,1,0
17,323,323,83,43,40,2,1
22,342,342,12,12,0,1,0
12,356,356,22,22,0,1,0
14,360,360,32,3,29,3,2
19,395,395,25,13,12,4,3
1,398,398,6,1,5,2,1
5,437,437,3,3,0,1,0
21,445,445,14,4,10,2,1
11,446,446,64,64,0,1,0
20,461,461,122,118,4,2,1
18,467,467,58,18,40,3,2
2,476,476,45,45,0,1,0
0,488,488,33,23,10,3,2
7,492,492,52,6,46,2,1
4,495,495,28,28,0,1,0

5,104,104,11,11,0,1,0
7,117,117,21,21,0,1,0
0,132,132,11,11,0,1,0
1,185,185,19,19,0,1,0
11,212,212,1,1,0,1,0
3,245,245,31,31,0,1,0
4,277,277,116,71,45,3,2
10,291,291,78,60,18,2,1
2,309,309,12,12,0,1,0
12,349,349,1,1,0,1,0
14,370,370,41,3,38,4,3
6,372,372,9,9,0,1,0
8,393,393,14,8,6,2,1
13,409,409,109,29,80,3,2
15,458,458,12,9,3,2,1
9,478,478,11,3,8,3,2

6,100,100,3,3,0,1,0
3,113,113,7,7,0,1,0
4,114,114,22,4,18,3,2
13,128,128,6,3,3,2,1
17,148,148,19,7,12,2,1
7,229,229,1,1,0,1,0
1,244,244,119,112,7,2,1
19,286,286,21,1,20,3,2
9,303,303,2,2,0,1,0
0,327,327,24,24,0,1,0
5,347,347,7,3,4,2,1
2,368,368,1,1,0,1,0
16,375,375,89,69,20,2,1
10,387,387,7,7,0,1,0
18,402,402,22,22,0,1,0
15,450,450,12,4,8,2,1
8,453,453,2,2,0,1,0
14,462,462,17,17,0,1,0
12,475,475,85,49,36,3,2
11,497,497,67,16,51,3,2

12,141,141,3,3,0,1,0
2,172,172,14,1,13,2,1
1,218,218,15,3,12,4,3
10,225,225,20,20,0,1,0
7,238,238,6,6,0,1,0
16,260,260,4,4,0,1,0
5,289,289,40,18,22,3,2
0,297,297,72,45,27,4,3
9,307,307,7,4,3,2,1
14,312,312,155,72,83,4,3
15,320,320,57,45,12,3,2
6,357,357,103,103,0,1,0
11,371,371,7,7,0,1,0
8,384,384,19,19,0,1,0
13,430,430,12,12,0,1,0
4,435,435,11,11,0,1,0
3,437,437,14,14,0,1,0

9,101,101,16,9,7,2,1
1,112,112,1,1,0,1,0
7,116,116,1,1,0,1,0
10,142,142,5,5,0,1,0
12,156,156,42,19,23,2,1
13,203,203,19,6,13,2,1
18,205,205,18,9,9,2,1
8,206,206,15,15,0,1,0
16,231,231,22,7,15,2,1
17,266,266,14,14,0,1,0
4,271,271,96,81,15,2,1
6,282,282,31,6,25,2,1
14,292,292,8,8,0,1,0
15,306,306,74,20,54,4,3
5,340,340,7,7,0,1,0
0,376,376,18,18,0,1,0
11,409,409,8,8,0,1,0
3,485,485,60,51,9,2,1
2,496,496,1,1,0,1,0

22,106,106,17,17,0,1,0
15,131,131,27,5,22,3,2
19,161,161,11,11,0,1,0
5,181,181,3,3,0,1,0
1,183,183,1,1,0,1,0
2,202,202,3,3,0,1,0
6,219,219,4,4,0,1,0
12,234,234,13,3,10,2,1
20,242,242,4,4,0,1,0
0,260,260,8,8,0,1,0
9,269,269,12,3,9,2,1
10,305,305,9,3,6,2,1
16,330,330,57,15,42,2,1
8,371,371,152,152,0,1,0
4,372,372,7,2,5,2,1
3,378,378,6,6,0,1,0
11,380,380,59,2,57,4,3
17,387,387,49,33,16,2,1
18,395,395,39,12,27,4,3
13,396,396,7,1,6,3,2
14,435,435,2,2,0,1,0
7,476,476,32,32,0,1,0
21,484,484,31,31,0,1,0

11,101,101,12,2,10,3,2
19,104,104,19,19,0,1,0
7,125,125,3,3,0,1,0
5,134,134,1,1,0,1,0
12,135,135,6,6,0,1,0
22,139,139,19,19,0,1,0
13,146,146,6,6,0,1,0
23,151,151,15,15,0,1,0
20,156,156,1,1,0,1,0
8,170,170,1,1,0,1,0
17,182,182,21,8,13,2,1
10,187,187,1,1,0,1,0
1,227,227,22,22,0,1,0
21,265,265,43,3,40,3,2
6,355,355,18,18,0,1,0
14,366,366,44,44,0,1,0
18,388,388,10,10,0,1,0
0,408,408,12,12,0,1,0
2,436,436,51,51,0,1,0
4,448,448,12,3,9,4,3
15,459,459,61,27,34,3,2
3,460,460,89,41,48,4,3
9,486,486,9,1,8,2,1
16,496,496,31,31,0,1,0

6,119,119,63,17,46,2,1
2,129,129,3,3,0,1,0
8,171,171,22,8,14,3,2
10,185,185,8,8,0,1,0
4,192,192,1,1,0,1,0
7,226,226,44,30,14,2,1
9,274,274,3,3,0,1,0
15,281,281,39,39,0,1,0
12,300,300,20,20,0,1,0
0,338,338,12,12,0,1,0
13,338,338,5,1,4,2,1
14,350,350,85,85,0,1,0
3,356,356,33,18,15,2,1
1,415,415,50,44,6,2,1
5,439,439,42,24,18,2,1
11,482,482,40,3,37,2,1

10,113,113,20,20,0,1,0
14,138,138,10,10,0,1,0
3,164,164,14,14,0,1,0
13,164,164,6,6,0,1,0
12,182,182,15,15,0,1,0
17,258,258,17,9,8,2,1
0,280,280,36,14,22,2,1
18,293,293,25,4,21,2,1
7,337,337,67,42,25,2,1
1,352,352,49,29,20,2,1
6,379,379,20,20,0,1,0
4,416,416,34,24,10,3,2
8,447,447,21,21,0,1,0
2,449,449,22,4,18,2,1
9,450,450,31,7,24,2,1
16,472,472,67,67,0,1,0
5,488,488,24,24,0,1,0
11,497,497,83,26,57,3,2
15,499,499,42,42,0,1,0

8,130,130,14,2,12,4,3
17,153,153,21,21,0,1,0
2,161,161,5,5,0,1,0
10,161,161,1,1,0,1,0
15,168,168,4,4,0,1,0
4,175,175,7,7,0,1,0
18,191,191,5,5,0,1,0
7,196,196,8,3,5,2,1
11,249,249,82,35,47,3,2
12,254,254,27,27,0,1,0
6,259,259,10,2,8,3,2
1,290,290,88,81,7,2,1
14,337,337,1,1,0,1,0
9,351,351,2,2,0,1,0
3,394,394,1,1,0,1,0
5,424,424,127,127,0,1,0
16,453,453,55,55,0,1,0
13,461,461,75,69,6,3,2
0,487,487,16,2,14,3,2

14,104,104,4,4,0,1,0
5,116,116,12,12,0,1,0
10,126,126,6,2,4,2,1
11,145,145,10,3,7,2,1
9,174,174,59,41,18,2,1
15,194,194,10,10,0,1,0
18,194,194,4,4,0,1,0
2,217,217,2,2,0,1,0
1,218,218,10,10,0,1,0
0,251,251,19,7,12,4,3
16,259,259,33,33,0,1,0
7,299,299,27,27,0,1,0
12,309,309,64,7,57,4,3
13,344,344,48,5,43,2,1
3,344,344,5,5,0,1,0
8,387,387,48,8,40,4,3
19,425,425,2,2,0,1,0
4,438,438,9,3,6,2,1
6,461,461,16,16,0,1,0
17,471,471,122,122,0,1,0

14,100,100,24,18,6,3,2
4,111,111,1,1,0,1,0
2,118,118,8,8,0,1,0
7,159,159,31,25,6,3,2
8,211,211,18,18,0,1,0
17,220,220,3,3,0,1,0
1,277,277,54,54,0,1,0
15,279,279,39,39,0,1,0
5,298,298,11,4,7,2,1
6,301,301,14,14,0,1,0
13,311,311,2,2,0,1,0
12,340,340,21,17,4,2,1
19,360,360,46,46,0,1,0
18,384,384,35,23,12,4,3
11,386,386,5,2,3,2,1
3,391,391,18,18,0,1,0
16,412,412,92,92,0,1,0
10,435,435,48,48,0,1,0
9,459,459,25,7,18,2,1
0,484,484,26,11,15,4,3

2,106,106,2,2,0,1,0
12,144,144,13,3,10,2,1
5,150,150,4,4,0,1,0
14,153,153,15,15,0,1,0
7,224,224,18,18,0,1,0
10,267,267,17,8,9,4,3
8,291,291,6,6,0,1,0
13,355,355,6,2,4,2,1
1,370,370,18,4,14,2,1
9,372,372,36,36,0,1,0
17,375,375,17,7,10,3,2
11,384,384,12,7,5,2,1
4,404,404,15,10,5,2,1
6,418,418,68,8,60,4,3
15,474,474,44,44,0,1,0
3,478,478,165,165,0,1,0
16,490,490,184,184,0,1,0
0,493,493,79,55,24,4,3

3,100,100,9,1,8,2,1
2,122,122,5,5,0,1,0
18,170,170,11,2,9,4,3
5,179,179,1,1,0,1,0
8,190,190,29,29,0,1,0
19,206,206,6,6,0,1,0
10,230,230,5,5,0,1,0
0,239,239,37,10,27,2,1
9,267,267,30,30,0,1,0
7,310,310,4,4,0,1,0
13,326,326,8,8,0,1,0
12,336,336,28,28,0,1,0
14,347,347,68,23,45,4,3
16,373,373,21,12,9,4,3
11,401,401,59,59,0,1,0
6,426,426,102,2,100,3,2
15,434,434,35,35,0,1,0
17,445,445,103,19,84,3,2
4,451,451,28,22,6,3,2
1,470,470,4,4,0,1,0

4,120,120,10,10,0,1,0
9,137,137,21,21,0,1,0
6,163,163,2,2,0,1,0
0,218,218,1,1,0,1,0
18,222,222,80,54,26,2,1
14,227,227,7,7,0,1,0
11,228,228,2,2,0,1,0
5,260,260,7,1,6,3,2
16,303,303,18,6,12,4,3
13,335,335,16,6,10,2,1
17,337,337,22,22,0,1,0
7,347,347,29,2,27,4,3
12,371,371,10,10,0,1,0
1,404,404,61,19,42,2,1
3,418,418,25,10,15,4,3
2,436,436,143,134,9,2,1
15,448,448,106,40,66,3,2
10,467,467,39,16,23,2,1
8,500,500,1,1,0,1,0

2,150,150,5,5,0,1,0
14,188,188,30,30,0,1,0
13,197,197,16,1,15,2,1
19,205,205,1,1,0,1,0
0,212,212,22,14,8,2,1
1,222,222,52,52,0,1,0
10,282,282,5,5,0,1,0
15,295,295,33,33,0,1,0
16,324,324,53,53,0,1,0
17,329,329,22,10,12,2,1
5,366,366,19,3,16,4,3
3,384,384,2,2,0,1,0
7,385,385,30,30,0,1,0
11,385,385,29,29,0,1,0
12,414,414,64,18,46,3,2
6,417,417,17,2,15,4,3
18,417,417,39,39,0,1,0
8,445,445,77,14,63,4,3
9,449,449,57,39,18,3,2
4,452,452,17,11,6,2,1

6,153,153,22,14,8,3,2
9,161,161,10,10,0,1,0
7,166,166,39,39,0,1,0
14,211,211,24,4,20,3,2
13,213,213,1,1,0,1,0
12,213,213,29,9,20,2,1
11,233,233,25,25,0,1,0
1,234,234,3,3,0,1,0
15,260,260,28,12,16,3,2
5,273,273,3,3,0,1,0
18,305,305,66,66,0,1,0
0,371,371,23,11,12,2,1
3,377,377,89,59,30,2,1
10,398,398,43,43,0,1,0
4,403,403,22,22,0,1,0
17,408,408,15,15,0,1,0
8,411,411,7,7,0,1,0
16,439,439,37,19,18,2,1
2,463,463,33,33,0,1,0

10,152,152,11,8,3,2,1
14,152,152,4,4,0,1,0
4,186,186,18,8,10,2,1
5,191,191,27,27,0,1,0
2,244,244,2,2,0,1,0
12,268,268,53,21,32,2,1
8,298,298,12,12,0,1,0
9,359,359,47,3,44,2,1
15,369,369,114,35,79,3,2
0,380,380,83,83,0,1,0
11,389,389,4,4,0,1,0
6,396,396,38,32,6,3,2
3,406,406,134,97,37,2,1
13,412,412,37,2,35,2,1
7,435,435,17,5,12,4,3
1,495,495,5,5,0,1,0

6,121,121,8,4,4,2,1
7,122,122,32,32,0,1,0
9,194,194,16,2,14,3,2
8,264,264,13,9,4,2,1
15,273,273,12,3,9,4,3
13,284,284,15,15,0,1,0
3,302,302,17,4,13,2,1
1,308,308,82,46,36,3,2
5,373,373,134,115,19,2,1
14,387,387,61,61,0,1,0
2,399,399,33,29,4,2,1
0,419,419,20,20,0,1,0
10,433,433,70,39,31,4,3
4,446,446,10,10,0,1,0
11,462,462,44,29,15,2,1
12,485,485,4,4,0,1,0

15,101,101,16,3,13,4,3
17,103,103,4,1,3,2,1
3,111,111,1,1,0,1,0
6,128,128,15,5,10,3,2
1,191,191,8,3,5,2,1
0,213,213,2,2,0,1,0
14,236,236,5,5,0,1,0
13,272,272,5,5,0,1,0
12,402,402,42,35,7,2,1
11,413,413,26,17,9,2,1
4,440,440,14,9,5,2,1
16,464,464,112,100,12,2,1
8,465,465,166,51,115,4,3
10,472,472,112,76,36,4,3
7,473,473,76,10,66,3,2
5,480,480,74,74,0,1,0
2,488,488,10,3,7,2,1
9,490,490,13,13,0,1,0

5,103,103,4,4,0,1,0
15,111,111,5,5,0,1,0
6,115,115,11,1,10,3,2
13,120,120,11,8,3,2,1
1,130,130,17,2,15,2,1
8,175,175,25,25,0,1,0
14,194,194,30,19,11,2,1
4,257,257,32,32,0,1,0
11,261,261,8,4,4,2,1
2,265,265,58,19,39,2,1
7,282,282,36,36,0,1,0
3,290,290,28,7,21,4,3
16,369,369,65,33,32,3,2
10,372,372,41,41,0,1,0
0,421,421,29,29,0,1,0
9,458,458,46,46,0,1,0
12,475,475,30,2,28,2,1

12,130,130,9,4,5,2,1
18,134,134,16,16,0,1,0
1,149,149,11,11,0,1,0
5,157,157,22,22,0,1,0
7,160,160,15,15,0,1,0
10,188,188,1,1,0,1,0
6,188,188,1,1,0,1,0
11,265,265,56,56,0,1,0
17,277,277,5,5,0,1,0
3,285,285,38,38,0,1,0
9,287,287,9,9,0,1,0
16,340,340,48,48,0,1,0
2,358,358,13,2,11,2,1
13,398,398,14,9,5,2,1
8,399,399,123,107,16,2,1
15,405,405,2,2,0,1,0
4,432,432,23,12,11,2,1
14,432,432,134,43,91,4,3
0,434,434,11,11,0,1,0

4,151,151,24,24,0,1,0
11,212,212,45,45,0,1,0
1,251,251,106,58,48,2,1
8,264,264,21,21,0,1,0
3,281,281,56,56,0,1,0
12,303,303,10,4,6,3,2
9,325,325,15,15,0,1,0
10,333,333,34,11,23,2,1
6,345,345,36,12,24,4,3
2,373,373,54,54,0,1,0
7,426,426,30,12,18,2,1
5,441,441,49,40,9,4,3
0,452,452,62,21,41,4,3

10,109,109,10,10,0,1,0
21,110,110,9,9,0,1,0
24,115,115,14,5,9,4,3
18,118,118,6,6,0,1,0
14,153,153,3,3,0,1,0
11,158,158,1,1,0,1,0
27,161,161,29,7,22,3,2
29,183,183,8,2,6,3,2
3,208,208,1,1,0,1,0
12,209,209,9,1,8,3,2
5,218,218,1,1,0,1,0
28,246,246,21,21,0,1,0
13,249,249,2,2,0,1,0
0,260,260,10,2,8,3,2
1,274,274,1,1,0,1,0
9,277,277,10,10,0,1,0
6,283,283,20,11,9,2,1
31,305,305,8,8,0,1,0
7,320,320,12,12,0,1,0
23,331,331,26,3,23,2,1
17,335,335,1,1,0,1,0
16,341,341,24,14,10,3,2
15,346,346,4,4,0,1,0
26,359,359,37,37,0,1,0
2,387,387,29,29,0,1,0
25,418,418,93,79,14,3,2
30,436,436,26,1,25,2,1
19,455,455,1,1,0,1,0
4,465,465,23,23,0,1,0
22,475,475,13,10,3,2,1
8,480,480,13,13,0,1,0
20,491,491,68,50,18,4,3

10,130,130,3,3,0,1,0
11,173,173,15,15,0,1,0
9,184,184,12,12,0,1,0
6,201,201,21,11,10,3,2
3,261,261,10,10,0,1,0
12,262,262,40,24,16,3,2
15,350,350,159,123,36,4,3
5,354,354,100,20,80,3,2
14,374,374,2,2,0,1,0
4,407,407,20,16,4,2,1
13,416,416,19,4,15,2,1
16,426,426,12,12,0,1,0
7,434,434,48,48,0,1,0
8,460,460,22,9,13,2,1
2,460,460,70,46,24,4,3
1,475,475,47,47,0,1,0
0,494,494,32,9,23,2,1

10,103,103,21,15,6,2,1
8,130,130,3,3,0,1,0
14,163,163,19,19,0,1,0
1,167,167,1,1,0,1,0
13,194,194,17,17,0,1,0
6,211,211,31,31,0,1,0
17,230,230,46,46,0,1,0
0,238,238,9,3,6,3,2
16,298,298,25,7,18,4,3
9,324,324,60,60,0,1,0
12,357,357,14,14,0,1,0
11,364,364,11,11,0,1,0
7,394,394,82,53,29,2,1
5,421,421,33,33,0,1,0
15,424,424,55,55,0,1,0
18,432,432,10,10,0,1,0
19,467,467,97,33,64,4,3
2,467,467,3,3,0,1,0
4,476,476,2,2,0,1,0
3,476,476,4,4,0,1,0

10,110,110,1,1,0,1,0
12,124,124,12,6,6,3,2
8,270,270,45,33,12,4,3
11,272,272,1,1,0,1,0
6,290,290,7,7,0,1,0
13,316,316,46,46,0,1,0
5,324,324,13,13,0,1,0
9,375,375,154,112,42,3,2
7,386,386,11,11,0,1,0
2,408,408,16,6,10,2,1
0,421,421,67,67,0,1,0
3,437,437,76,30,46,3,2
1,490,490,22,11,11,2,1
4,493,493,239,95,144,4,3

2,112,112,1,1,0,1,0
14,136,136,28,14,14,2,1
7,144,144,66,66,0,1,0
8,146,146,7,1,6,3,2
11,148,148,9,9,0,1,0
9,155,155,13,13,0,1,0
22,158,158,14,14,0,1,0
3,161,161,1,1,0,1,0
10,219,219,2,2,0,1,0
17,277,277,65,65,0,1,0
16,282,282,28,28,0,1,0
21,293,293,5,2,3,2,1
18,300,300,23,23,0,1,0
6,350,350,18,2,16,2,1
12,355,355,4,1,3,2,1
4,379,379,28,28,0,1,0
5,381,381,1,1,0,1,0
19,433,433,1,1,0,1,0
20,440,440,14,14,0,1,0
0,454,454,10,10,0,1,0
15,463,463,72,72,0,1,0
13,464,464,14,14,0,1,0
1,490,490,17,17,0,1,0

12,112,112,3,3,0,1,0
9,121,121,18,8,10,2,1
6,128,128,2,2,0,1,0
8,129,129,30,3,27,4,3
15,178,178,13,1,12,3,2
2,187,187,1,1,0,1,0
10,191,191,28,28,0,1,0
11,194,194,8,8,0,1,0
20,229,229,28,28,0,1,0
3,237,237,14,6,8,3,2
14,267,267,27,6,21,2,1
16,273,273,67,60,7,2,1
5,277,277,12,7,5,2,1
7,282,282,17,17,0,1,0
0,287,287,7,7,0,1,0
1,344,344,26,26,0,1,0
18,382,382,10,10,0,1,0
19,391,391,61,7,54,3,2
4,404,404,20,20,0,1,0
13,453,453,49,49,0,1,0
17,483,483,31,22,9,2,1

9,124,124,6,6,0,1,0
0,145,145,7,7,0,1,0
1,200,200,10,10,0,1,0
12,200,200,63,32,31,2,1
10,204,204,6,6,0,1,0
15,204,204,1,1,0,1,0
6,243,243,17,17,0,1,0
3,281,281,21,21,0,1,0
11,314,314,32,32,0,1,0
5,319,319,48,15,33,4,3
14,331,331,21,21,0,1,0
2,343,343,67,2,65,4,3
13,374,374,81,81,0,1,0
17,378,378,53,53,0,1,0
7,389,389,29,10,19,2,1
16,408,408,1,1,0,1,0
8,438,438,75,37,38,3,2
4,449,449,30,30,0,1,0

7,149,149,7,1,6,2,1
6,188,188,4,4,0,1,0
10,191,191,11,11,0,1,0
11,235,235,21,16,5,2,1
5,322,322,27,27,0,1,0
1,335,335,43,35,8,2,1
12,335,335,12,3,9,2,1
16,337,337,13,2,11,2,1
17,375,375,57,20,37,2,1
15,376,376,64,2,62,3,2
14,387,387,76,51,25,2,1
0,418,418,76,76,0,1,0
3,432,432,23,23,0,1,0
4,439,439,65,65,0,1,0
8,440,440,7,7,0,1,0
13,475,475,4,4,0,1,0
9,480,480,81,42,39,4,3
2,486,486,108,78,30,4,3

17,132,132,12,12,0,1,0
8,134,134,16,4,12,3,2
2,135,135,1,1,0,1,0
15,136,136,9,9,0,1,0
4,191,191,14,14,0,1,0
1,296,296,30,20,10,2,1
14,304,304,31,31,0,1,0
10,309,309,48,22,26,3,2
6,320,320,59,5,54,3,2
9,334,334,14,5,9,2,1
18,353,353,1,1,0,1,0
11,383,383,18,9,9,2,1
13,394,394,84,49,35,2,1
12,396,396,91,28,63,4,3
3,402,402,41,20,21,4,3
5,412,412,45,45,0,1,0
0,421,421,53,20,33,4,3
7,476,476,17,17,0,1,0
16,498,498,1,1,0,1,0

9,115,115,36,33,3,2,1
0,125,125,4,4,0,1,0
6,141,141,20,20,0,1,0
2,145,145,1,1,0,1,0
3,151,151,33,9,24,4,3
8,218,218,7,4,3,2,1
4,277,277,59,48,11,2,1
11,278,278,75,75,0,1,0
13,297,297,3,3,0,1,0
7,353,353,47,47,0,1,0
1,366,366,31,11,20,2,1
12,368,368,7,7,0,1,0
5,417,417,86,86,0,1,0
15,441,441,11,11,0,1,0
10,450,450,50,4,46,4,3
14,461,461,2,2,0,1,0

7,154,154,1,1,0,1,0
13,176,176,10,7,3,2,1
1,177,177,1,1,0,1,0
2,199,199,16,16,0,1,0
3,216,216,67,67,0,1,0
10,250,250,25,3,22,3,2
0,368,368,90,39,51,3,2
11,376,376,56,56,0,1,0
12,383,383,23,23,0,1,0
9,405,405,34,34,0,1,0
5,406,406,49,43,6,2,1
14,409,409,39,9,30,3,2
4,475,475,66,66,0,1,0
8,494,494,103,97,6,3,2
6,496,496,76,61,15,4,3

9,138,138,27,19,8,2,1
3,143,143,22,22,0,1,0
11,150,150,29,29,0,1,0
4,167,167,41,6,35,2,1
7,168,168,3,3,0,1,0
12,178,178,23,1,22,3,2
1,232,232,47,19,28,3,2
13,267,267,28,10,18,4,3
5,291,291,9,9,0,1,0
8,334,334,4,4,0,1,0
14,341,341,43,27,16,3,2
0,367,367,40,40,0,1,0
15,386,386,43,19,24,2,1
10,408,408,13,1,12,2,1
2,418,418,46,46,0,1,0
6,495,495,24,3,21,4,3

11,103,103,9,6,3,2,1
5,115,115,5,2,3,2,1
9,118,118,4,4,0,1,0
1,148,148,8,8,0,1,0
6,163,163,2,2,0,1,0
13,169,169,26,6,20,3,2
14,189,189,50,26,24,4,3
7,194,194,33,25,8,2,1
3,205,205,65,45,20,3,2
15,212,212,30,30,0,1,0
0,252,252,12,9,3,2,1
16,276,276,31,13,18,4,3
10,315,315,19,19,0,1,0
4,324,324,2,2,0,1,0
17,354,354,3,3,0,1,0
12,391,391,25,2,23,2,1
2,422,422,4,4,0,1,0
8,450,450,108,75,33,4,3

3,120,120,10,4,6,3,2
9,135,135,15,15,0,1,0
7,172,172,35,35,0,1,0
8,177,177,7,7,0,1,0
4,187,187,10,10,0,1,0
6,211,211,16,7,9,4,3
0,234,234,77,77,0,1,0
2,409,409,71,71,0,1,0
1,422,422,2,2,0,1,0
5,422,422,108,63,45,2,1
12,436,436,26,26,0,1,0
11,463,463,9,5,4,2,1
13,486,486,24,24,0,1,0
14,492,492,112,102,10,2,1
10,493,493,68,2,66,3,2

17,110,110,27,27,0,1,0
5,183,183,4,4,0,1,0
4,197,197,31,21,10,2,1
11,220,220,46,46,0,1,0
18,221,221,19,2,17,3,2
2,231,231,5,5,0,1,0
7,234,234,5,1,4,2,1
13,254,254,62,43,19,3,2
21,276,276,11,6,5,2,1
19,281,281,12,2,10,3,2
20,283,283,10,10,0,1,0
10,296,296,24,24,0,1,0
1,302,302,12,12,0,1,0
14,339,339,6,6,0,1,0
3,385,385,23,17,6,2,1
15,400,400,56,56,0,1,0
0,409,409,14,14,0,1,0
12,420,420,47,17,30,2,1
9,425,425,27,14,13,2,1
6,449,449,10,10,0,1,0
16,492,492,32,32,0,1,0
8,496,496,29,16,13,2,1

7,103,103,1,1,0,1,0
14,123,123,14,14,0,1,0
15,136,136,2,2,0,1,0
16,138,138,41,38,3,2,1
3,144,144,28,28,0,1,0
9,154,154,10,10,0,1,0
0,197,197,1,1,0,1,0
13,198,198,23,23,0,1,0
5,207,207,53,49,4,2,1
10,208,208,23,23,0,1,0
6,285,285,43,16,27,2,1
4,299,299,1,1,0,1,0
8,316,316,37,37,0,1,0
2,427,427,22,4,18,3,2
11,428,428,3,3,0,1,0
17,449,449,79,31,48,3,2
12,467,467,10,6,4,2,1
1,491,491,55,55,0,1,0

11,153,153,35,35,0,1,0
13,173,173,37,37,0,1,0
3,208,208,2,2,0,1,0
18,213,213,17,13,4,2,1
9,232,232,19,6,13,4,3
17,257,257,64,64,0,1,0
10,268,268,15,15,0,1,0
2,342,342,4,4,0,1,0
5,343,343,33,33,0,1,0
6,377,377,1,1,0,1,0
16,380,380,9,2,7,2,1
7,384,384,9,1,8,3,2
1,404,404,44,22,22,3,2
0,408,408,11,11,0,1,0
14,413,413,11,11,0,1,0
8,420,420,194,98,96,3,2
4,444,444,10,10,0,1,0
15,459,459,4,4,0,1,0
19,463,463,30,30,0,1,0
12,475,475,10,6,4,2,1

24,126,126,4,4,0,1,0
13,139,139,1,1,0,1,0
6,188,188,4,4,0,1,0
0,207,207,10,10,0,1,0
17,219,219,7,7,0,1,0
8,224,224,25,25,0,1,0
1,245,245,9,9,0,1,0
20,247,247,73,73,0,1,0
9,277,277,6,6,0,1,0
16,277,277,2,2,0,1,0
3,279,279,9,9,0,1,0
21,290,290,3,3,0,1,0
22,305,305,10,1,9,2,1
2,316,316,12,12,0,1,0
5,331,331,4,4,0,1,0
19,344,344,101,23,78,3,2
7,347,347,6,6,0,1,0
10,351,351,2,2,0,1,0
14,368,368,111,111,0,1,0
15,380,380,10,10,0,1,0
23,393,393,35,3,32,3,2
18,431,431,25,14,11,2,1
25,449,449,33,9,24,4,3
12,455,455,57,45,12,4,3
4,482,482,6,6,0,1,0
11,490,490,38,38,0,1,0

6,119,119,4,4,0,1,0
9,121,121,5,5,0,1,0
16,122,122,2,2,0,1,0
3,128,128,6,6,0,1,0
5,188,188,3,3,0,1,0
8,205,205,54,54,0,1,0
19,206,206,61,36,25,2,1
14,214,214,12,7,5,2,1
18,261,261,19,7,12,4,3
7,265,265,4,4,0,1,0
10,272,272,7,7,0,1,0
11,287,287,29,20,9,2,1
13,318,318,23,16,7,2,1
23,362,362,64,27,37,2,1
24,363,363,6,6,0,1,0
0,379,379,8,8,0,1,0
15,386,386,35,35,0,1,0
2,399,399,1,1,0,1,0
1,402,402,4,4,0,1,0
12,431,431,1,1,0,1,0
17,436,436,50,27,23,2,1
21,437,437,23,2,21,4,3
4,439,439,45,6,39,3,2
22,459,459,57,57,0,1,0
20,474,474,21,10,11,2,1

16,114,114,4,4,0,1,0
0,152,152,19,19,0,1,0
7,162,162,24,13,11,2,1
15,165,165,69,69,0,1,0
17,167,167,3,3,0,1,0
6,172,172,17,17,0,1,0
1,180,180,5,5,0,1,0
12,188,188,9,1,8,2,1
5,208,208,27,1,26,3,2
4,287,287,2,2,0,1,0
19,294,294,68,26,42,4,3
3,309,309,39,24,15,2,1
14,315,315,16,16,0,1,0
11,341,341,16,16,0,1,0
10,372,372,34,29,5,2,1
8,429,429,30,3,27,4,3
2,437,437,13,13,0,1,0
13,440,440,3,3,0,1,0
18,448,448,31,6,25,2,1
9,472,472,23,19,4,2,1

5,109,109,3,3,0,1,0
3,115,115,10,2,8,2,1
11,117,117,29,29,0,1,0
18,126,126,22,22,0,1,0
9,149,149,4,4,0,1,0
8,159,159,29,29,0,1,0
0,175,175,4,4,0,1,0
4,230,230,34,34,0,1,0
14,293,293,4,4,0,1,0
7,307,307,29,3,26,3,2
10,316,316,6,1,5,2,1
17,334,334,4,4,0,1,0
6,347,347,41,41,0,1,0
1,371,371,59,59,0,1,0
12,419,419,121,117,4,2,1
2,452,452,16,3,13,2,1
16,461,461,5,5,0,1,0
13,497,497,20,20,0,1,0
15,499,499,54,5,49,2,1

2,106,106,2,2,0,1,0
11,116,116,7,7,0,1,0
0,126,126,8,8,0,1,0
9,149,149,13,5,8,2,1
21,153,153,30,30,0,1,0
12,202,202,10,10,0,1,0
6,235,235,1,1,0,1,0
3,237,237,12,4,8,3,2
10,246,246,15,4,11,2,1
15,253,253,17,5,12,2,1
13,259,259,14,3,11,2,1
20,269,269,23,23,0,1,0
7,291,291,12,12,0,1,0
5,294,294,12,12,0,1,0
1,308,308,31,31,0,1,0
16,315,315,5,5,0,1,0
17,316,316,46,36,10,2,1
8,365,365,36,36,0,1,0
18,393,393,94,32,62,3,2
19,493,493,1,1,0,1,0
4,500,500,113,87,26,3,2
14,500,500,54,54,0,1,0

2,105,105,2,2,0,1,0
19,107,107,7,7,0,1,0
0,109,109,5,5,0,1,0
4,135,135,18,10,8,2,1
17,166,166,2,2,0,1,0
1,174,174,1,1,0,1,0
10,175,175,3,3,0,1,0
7,185,185,19,19,0,1,0
11,216,216,1,1,0,1,0
8,218,218,3,3,0,1,0
9,219,219,67,49,18,2,1
12,228,228,15,1,14,3,2
18,228,228,6,6,0,1,0
21,266,266,34,34,0,1,0
14,286,286,70,24,46,2,1
13,321,321,59,21,38,2,1
5,332,332,44,44,0,1,0
20,357,357,39,39,0,1,0
16,386,386,20,2,18,4,3
6,417,417,4,4,0,1,0
15,442,442,43,3,40,4,3
3,499,499,24,24,0,1,0

1,211,211,1,1,0,1,0
4,216,216,77,1,76,3,2
6,260,260,44,44,0,1,0
13,315,315,12,4,8,3,2
15,331,331,13,9,4,2,1
2,399,399,65,62,3,2,1
9,409,409,47,47,0,1,0
12,410,410,64,64,0,1,0
10,426,426,16,13,3,2,1
11,437,437,150,90,60,4,3
14,473,473,8,8,0,1,0
5,477,477,2,2,0,1,0
0,480,480,40,16,24,2,1
8,480,480,37,14,23,4,3
3,497,497,60,60,0,1,0
7,497,497,45,45,0,1,0

8,139,139,9,3,6,2,1
0,224,224,18,3,15,4,3
5,235,235,13,6,7,2,1
13,235,235,21,21,0,1,0
3,274,274,12,1,11,2,1
7,323,323,7,7,0,1,0
1,329,329,103,71,32,3,2
2,334,334,54,54,0,1,0
15,349,349,167,139,28,2,1
9,360,360,2,2,0,1,0
11,424,424,40,40,0,1,0
12,427,427,14,6,8,3,2
4,436,436,63,63,0,1,0
14,457,457,42,42,0,1,0
6,485,485,50,50,0,1,0
10,499,499,18,1,17,2,1

20,116,116,10,1,9,2,1
3,119,119,11,11,0,1,0
2,148,148,1,1,0,1,0
16,159,159,26,26,0,1,0
13,170,170,48,21,27,2,1
4,178,178,8,2,6,3,2
5,185,185,9,4,5,2,1
14,226,226,10,10,0,1,0
10,230,230,10,10,0,1,0
7,290,290,50,50,0,1,0
11,297,297,19,19,0,1,0
0,307,307,4,4,0,1,0
12,321,321,24,13,11,2,1
6,339,339,55,55,0,1,0
15,347,347,6,6,0,1,0
1,378,378,46,37,9,4,3
19,385,385,1,1,0,1,0
9,403,403,49,11,38,3,2
8,414,414,5,5,0,1,0
17,428,428,79,41,38,3,2
18,498,498,29,14,15,4,3

21,127,127,18,14,4,2,1
10,145,145,1,1,0,1,0
5,165,165,1,1,0,1,0
6,186,186,18,2,16,2,1
20,188,188,28,6,22,2,1
11,190,190,13,7,6,3,2
9,192,192,3,3,0,1,0
16,206,206,21,21,0,1,0
7,208,208,35,11,24,2,1
23,256,256,2,2,0,1,0
19,268,268,60,60,0,1,0
1,279,279,35,35,0,1,0
18,296,296,49,49,0,1,0
17,308,308,13,13,0,1,0
2,336,336,4,4,0,1,0
13,358,358,45,45,0,1,0
0,383,383,2,2,0,1,0
15,403,403,22,10,12,2,1
4,404,404,3,3,0,1,0
12,408,408,2,2,0,1,0
14,449,449,4,4,0,1,0
22,451,451,15,15,0,1,0
3,482,482,49,49,0,1,0
8,487,487,72,72,0,1,0

2,130,130,2,2,0,1,0
13,151,151,2,2,0,1,0
5,162,162,17,17,0,1,0
10,183,183,35,35,0,1,0
11,183,183,11,11,0,1,0
7,213,213,3,3,0,1,0
16,238,238,19,9,10,2,1
20,255,255,81,4,77,4,3
6,293,293,7,1,6,2,1
0,306,306,50,5,45,2,1
17,310,310,15,15,0,1,0
9,332,332,32,32,0,1,0
8,334,334,37,37,0,1,0
15,375,375,13,13,0,1,0
4,388,388,36,6,30,2,1
18,404,404,10,10,0,1,0
14,420,420,85,53,32,3,2
1,422,422,11,11,0,1,0
3,478,478,1,1,0,1,0
12,494,494,52,47,5,2,1
19,495,495,44,25,19,2,1

9,122,122,15,1,14,3,2
13,125,125,5,5,0,1,0
0,133,133,1,1,0,1,0
1,138,138,22,4,18,2,1
7,152,152,63,63,0,1,0
12,179,179,65,65,0,1,0
15,184,184,15,15,0,1,0
16,224,224,32,32,0,1,0
3,233,233,37,27,10,2,1
10,238,238,2,2,0,1,0
6,242,242,13,13,0,1,0
8,270,270,1,1,0,1,0
5,298,298,10,4,6,2,1
2,399,399,28,28,0,1,0
11,422,422,54,38,16,2,1
4,441,441,1,1,0,1,0
14,459,459,4,4,0,1,0
17,482,482,13,5,8,3,2

2,129,129,2,2,0,1,0
0,156,156,8,8,0,1,0
15,157,157,4,4,0,1,0
5,226,226,26,8,18,3,2
6,274,274,3,3,0,1,0
14,274,274,18,18,0,1,0
4,314,314,30,10,20,3,2
8,316,316,35,35,0,1,0
11,322,322,74,2,72,4,3
10,330,330,1,1,0,1,0
13,332,332,14,14,0,1,0
12,341,341,4,1,3,2,1
16,364,364,106,74,32,3,2
1,378,378,40,40,0,1,0
9,388,388,51,51,0,1,0
3,402,402,38,11,27,2,1
7,485,485,200,200,0,1,0

18,147,147,36,36,0,1,0
16,161,161,4,4,0,1,0
17,182,182,20,2,18,3,2
5,186,186,15,15,0,1,0
12,196,196,33,33,0,1,0
7,231,231,15,15,0,1,0
11,271,271,16,16,0,1,0
2,273,273,71,63,8,2,1
6,282,282,32,8,24,2,1
3,291,291,5,5,0,1,0
10,308,308,45,45,0,1,0
19,357,357,6,6,0,1,0
0,360,360,17,6,11,2,1
9,368,368,14,14,0,1,0
13,381,381,91,49,42,4,3
1,385,385,22,22,0,1,0
8,386,386,2,2,0,1,0
14,396,396,6,6,0,1,0
4,426,426,31,13,18,2,1
15,500,500,21,21,0,1,0

1,106,106,16,2,14,3,2
9,136,136,24,4,20,3,2
11,228,228,6,6,0,1,0
8,266,266,30,7,23,2,1
4,273,273,44,44,0,1,0
6,274,274,29,1,28,3,2
2,375,375,29,14,15,2,1
10,424,424,1,1,0,1,0
0,437,437,235,118,117,4,3
12,447,447,49,49,0,1,0
7,452,452,4,4,0,1,0
5,454,454,96,96,0,1,0
3,499,499,67,67,0,1,0

12,101,101,1,1,0,1,0
13,113,113,10,5,5,2,1
3,121,121,6,1,5,2,1
11,125,125,38,18,20,3,2
4,177,177,7,3,4,2,1
1,206,206,3,3,0,1,0
6,208,208,14,14,0,1,0
10,220,220,16,7,9,4,3
18,265,265,23,23,0,1,0
0,312,312,62,21,41,4,3
15,352,352,65,65,0,1,0
7,359,359,74,14,60,4,3
17,364,364,8,8,0,1,0
9,392,392,3,3,0,1,0
14,405,405,43,21,22,3,2
8,434,434,43,22,21,2,1
2,476,476,35,35,0,1,0
16,495,495,26,13,13,2,1
5,500,500,73,13,60,4,3

4,102,102,4,4,0,1,0
5,109,109,5,5,0,1,0
1,149,149,8,8,0,1,0
14,172,172,3,3,0,1,0
6,179,179,85,85,0,1,0
11,190,190,27,27,0,1,0
13,200,200,31,31,0,1,0
7,274,274,2,2,0,1,0
19,303,303,29,17,12,4,3
10,328,328,11,11,0,1,0
12,352,352,47,47,0,1,0
17,353,353,25,25,0,1,0
15,361,361,23,9,14,3,2
16,363,363,58,26,32,2,1
3,382,382,10,10,0,1,0
18,397,397,30,11,19,2,1
2,404,404,65,65,0,1,0
0,406,406,15,10,5,2,1
8,438,438,8,2,6,3,2
9,443,443,2,2,0,1,0

8,135,135,3,3,0,1,0
2,271,271,2,2,0,1,0
4,272,272,11,11,0,1,0
9,274,274,20,20,0,1,0
1,278,278,20,20,0,1,0
5,291,291,98,98,0,1,0
0,294,294,67,4,63,4,3
7,316,316,41,41,0,1,0
6,339,339,66,45,21,4,3
10,354,354,19,11,8,2,1
14,378,378,45,45,0,1,0
13,484,484,41,41,0,1,0
11,485,485,68,68,0,1,0
12,485,485,48,48,0,1,0
3,495,495,108,42,66,3,2

9,110,110,1,1,0,1,0
8,118,118,22,7,15,2,1
15,133,133,16,8,8,2,1
7,165,165,11,11,0,1,0
3,171,171,4,1,3,2,1
2,173,173,8,5,3,2,1
16,227,227,8,8,0,1,0
0,289,289,30,30,0,1,0
14,302,302,63,63,0,1,0
1,318,318,5,1,4,2,1
4,319,319,33,14,19,2,1
11,328,328,55,55,0,1,0
5,330,330,150,103,47,2,1
12,372,372,9,3,6,3,2
10,392,392,24,24,0,1,0
13,398,398,45,16,29,2,1
6,423,423,39,39,0,1,0

7,152,152,25,25,0,1,0
15,155,155,5,5,0,1,0
14,156,156,8,8,0,1,0
10,164,164,3,3,0,1,0
3,213,213,47,27,20,2,1
0,258,258,28,28,0,1,0
5,269,269,21,6,15,4,3
8,290,290,22,22,0,1,0
17,322,322,45,45,0,1,0
9,325,325,2,2,0,1,0
13,367,367,12,3,9,4,3
6,372,372,2,2,0,1,0
4,373,373,25,25,0,1,0
2,393,393,44,28,16,2,1
1,404,404,4,1,3,2,1
18,423,423,24,9,15,4,3
12,431,431,72,72,0,1,0
11,437,437,15,15,0,1,0
19,470,470,30,12,18,4,3
20,474,474,174,138,36,4,3
16,477,477,2,2,0,1,0

9,103,103,3,3,0,1,0
2,111,111,36,21,15,4,3
10,141,141,33,33,0,1,0
1,150,150,3,3,0,1,0
16,170,170,19,10,9,2,1
5,253,253,76,4,72,3,2
3,267,267,7,7,0,1,0
8,279,279,12,8,4,2,1
0,303,303,2,2,0,1,0
7,304,304,14,14,0,1,0
14,359,359,46,6,40,3,2
11,420,420,64,64,0,1,0
6,435,435,29,17,12,2,1
12,462,462,70,23,47,2,1
13,463,463,25,7,18,2,1
4,470,470,53,27,26,3,2
15,482,482,9,6,3,2,1

0,112,112,1,1,0,1,0
15,117,117,3,3,0,1,0
16,120,120,15,15,0,1,0
17,127,127,3,3,0,1,0
21,160,160,19,12,7,2,1
12,169,169,25,25,0,1,0
23,170,170,11,11,0,1,0
2,188,188,15,15,0,1,0
5,188,188,61,61,0,1,0
7,245,245,20,14,6,3,2
22,258,258,41,7,34,2,1
18,284,284,14,11,3,2,1
3,291,291,5,2,3,2,1
24,305,305,30,2,28,3,2
10,309,309,8,2,6,3,2
11,347,347,27,27,0,1,0
13,350,350,1,1,0,1,0
4,365,365,15,15,0,1,0
20,385,385,70,28,42,4,3
6,397,397,12,4,8,3,2
9,406,406,3,3,0,1,0
19,423,423,45,19,26,3,2
8,463,463,1,1,0,1,0
1,494,494,7,7,0,1,0
14,500,500,10,10,0,1,0

4,102,102,1,1,0,1,0
12,109,109,12,12,0,1,0
14,125,125,4,4,0,1,0
8,176,176,1,1,0,1,0
21,197,197,16,4,12,3,2
19,243,243,28,17,11,2,1
11,247,247,6,6,0,1,0
5,264,264,9,6,3,2,1
17,273,273,41,41,0,1,0
13,281,281,8,8,0,1,0
1,288,288,19,3,16,3,2
6,307,307,65,39,26,3,2
15,322,322,19,19,0,1,0
16,359,359,43,22,21,4,3
18,367,367,27,10,17,4,3
0,369,369,8,8,0,1,0
7,372,372,3,3,0,1,0
3,394,394,26,26,0,1,0
10,413,413,130,112,18,3,2
9,427,427,8,8,0,1,0
2,435,435,5,5,0,1,0
20,492,492,127,127,0,1,0

21,106,106,14,14,0,1,0
19,116,116,4,1,3,2,1
7,126,126,18,18,0,1,0
13,138,138,17,17,0,1,0
4,139,139,10,10,0,1,0
15,143,143,1,1,0,1,0
20,159,159,21,3,18,4,3
0,186,186,3,3,0,1,0
2,231,231,61,61,0,1,0
9,240,240,1,1,0,1,0
18,243,243,98,32,66,4,3
11,286,286,4,4,0,1,0
10,290,290,17,13,4,2,1
6,323,323,1,1,0,1,0
1,384,384,66,6,60,3,2
16,398,398,24,24,0,1,0
5,462,462,22,22,0,1,0
3,478,478,13,13,0,1,0
17,478,478,1,1,0,1,0
12,479,479,3,3,0,1,0
14,497,497,15,15,0,1,0
8,500,500,37,24,13,2,1

18,122,122,10,4,6,3,2
11,139,139,13,2,11,2,1
1,173,173,1,1,0,1,0
6,201,201,15,2,13,3,2
20,205,205,15,15,0,1,0
13,316,316,19,19,0,1,0
14,341,341,1,1,0,1,0
21,345,345,7,1,6,3,2
12,356,356,22,14,8,2,1
9,358,358,14,2,12,4,3
3,359,359,20,5,15,4,3
23,364,364,32,32,0,1,0
17,370,370,147,105,42,4,3
22,382,382,17,14,3,2,1
15,398,398,52,20,32,4,3
16,410,410,32,18,14,2,1
7,410,410,40,40,0,1,0
19,420,420,2,2,0,1,0
8,428,428,9,9,0,1,0
0,442,442,104,94,10,2,1
2,448,448,17,17,0,1,0
4,461,461,3,3,0,1,0
5,470,470,1,1,0,1,0
10,497,497,53,53,0,1,0

1,139,139,24,20,4,2,1
8,151,151,1,1,0,1,0
9,168,168,12,3,9,4,3
7,184,184,52,6,46,4,3
5,185,185,1,1,0,1,0
15,195,195,51,51,0,1,0
10,206,206,3,3,0,1,0
16,228,228,71,60,11,2,1
0,231,231,17,9,8,2,1
14,262,262,2,2,0,1,0
6,308,308,7,7,0,1,0
3,376,376,38,30,8,2,1
4,420,420,40,32,8,2,1
11,431,431,46,46,0,1,0
13,448,448,55,47,8,3,2
2,485,485,72,36,36,4,3
12,495,495,10,10,0,1,0

4,138,138,12,2,10,2,1
14,146,146,15,15,0,1,0
12,178,178,9,1,8,2,1
3,200,200,12,3,9,4,3
6,223,223,7,7,0,1,0
0,230,230,1,1,0,1,0
8,255,255,44,14,30,4,3
7,292,292,9,9,0,1,0
5,316,316,4,1,3,2,1
1,344,344,245,107,138,4,3
10,354,354,56,20,36,3,2
2,417,417,11,11,0,1,0
13,427,427,82,82,0,1,0
9,450,450,58,34,24,4,3
11,454,454,22,4,18,3,2

4,132,132,16,1,15,2,1
10,133,133,3,3,0,1,0
12,168,168,43,43,0,1,0
0,183,183,15,9,6,2,1
15,190,190,10,10,0,1,0
5,217,217,19,19,0,1,0
11,253,253,19,4,15,4,3
9,264,264,3,3,0,1,0
16,266,266,94,84,10,2,1
13,305,305,16,10,6,3,2
8,323,323,23,23,0,1,0
14,366,366,9,3,6,3,2
2,369,369,36,30,6,2,1
7,413,413,107,62,45,2,1
1,414,414,24,6,18,4,3
3,415,415,67,55,12,2,1
6,435,435,15,15,0,1,0

11,109,109,3,3,0,1,0
21,116,116,15,3,12,2,1
20,117,117,12,12,0,1,0
13,209,209,20,20,0,1,0
18,212,212,16,8,8,3,2
1,246,246,3,3,0,1,0
0,258,258,1,1,0,1,0
3,288,288,35,14,21,3,2
19,290,290,14,2,12,4,3
10,307,307,54,4,50,3,2
8,311,311,1,1,0,1,0
2,319,319,37,12,25,3,2
12,354,354,5,5,0,1,0
15,367,367,18,18,0,1,0
22,368,368,71,71,0,1,0
5,382,382,38,4,34,2,1
17,383,383,33,33,0,1,0
4,396,396,3,3,0,1,0
6,400,400,24,2,22,3,2
16,421,421,27,21,6,3,2
14,438,438,75,12,63,4,3
9,438,438,61,17,44,3,2
7,465,465,11,11,0,1,0

11,115,115,8,8,0,1,0
15,125,125,14,2,12,3,2
9,150,150,17,17,0,1,0
1,162,162,30,30,0,1,0
14,164,164,2,2,0,1,0
8,183,183,8,8,0,1,0
0,209,209,1,1,0,1,0
10,259,259,55,55,0,1,0
12,263,263,41,32,9,2,1
13,264,264,16,16,0,1,0
2,271,271,7,4,3,2,1
16,277,277,41,41,0,1,0
7,300,300,10,10,0,1,0
3,449,449,47,47,0,1,0
4,454,454,153,64,89,4,3
5,472,472,30,12,18,2,1
6,478,478,70,70,0,1,0

0,120,120,3,3,0,1,0
11,129,129,10,1,9,2,1
2,136,136,7,7,0,1,0
1,151,151,122,102,20,3,2
6,179,179,37,7,30,2,1
10,179,179,39,39,0,1,0
7,230,230,16,8,8,3,2
3,301,301,5,5,0,1,0
4,306,306,6,6,0,1,0
8,342,342,41,21,20,2,1
9,397,397,7,3,4,2,1
5,407,407,21,9,12,2,1
12,437,437,60,60,0,1,0

1,190,190,14,4,10,3,2
6,191,191,9,9,0,1,0
9,197,197,18,18,0,1,0
11,201,201,16,9,7,2,1
14,207,207,37,37,0,1,0
15,239,239,13,7,6,2,1
0,249,249,19,19,0,1,0
8,269,269,1,1,0,1,0
2,279,279,12,12,0,1,0
17,287,287,77,77,0,1,0
12,304,304,12,12,0,1,0
16,306,306,18,18,0,1,0
5,328,328,45,45,0,1,0
18,336,336,26,26,0,1,0
7,375,375,43,43,0,1,0
3,381,381,7,2,5,2,1
10,421,421,44,44,0,1,0
19,441,441,1,1,0,1,0
13,449,449,68,41,27,4,3
4,464,464,89,89,0,1,0

10,102,102,11,11,0,1,0
11,126,126,27,27,0,1,0
7,137,137,3,3,0,1,0
3,146,146,11,11,0,1,0
18,180,180,31,31,0,1,0
16,198,198,10,7,3,2,1
14,217,217,30,30,0,1,0
1,222,222,41,41,0,1,0
5,227,227,19,9,10,3,2
4,237,237,19,2,17,2,1
15,239,239,25,4,21,2,1
8,262,262,2,2,0,1,0
12,284,284,25,1,24,2,1
0,378,378,59,20,39,2,1
19,387,387,9,9,0,1,0
13,417,417,34,34,0,1,0
2,447,447,26,12,14,3,2
17,452,452,23,11,12,3,2
9,459,459,20,20,0,1,0
6,468,468,40,40,0,1,0

12,113,113,2,2,0,1,0
17,118,118,24,4,20,3,2
2,141,141,23,13,10,4,3
7,150,150,30,30,0,1,0
5,191,191,36,14,22,2,1
8,195,195,18,18,0,1,0
0,211,211,16,10,6,3,2
15,248,248,20,11,9,4,3
13,260,260,9,3,6,2,1
6,298,298,29,29,0,1,0
11,327,327,23,23,0,1,0
10,335,335,17,17,0,1,0
3,373,373,9,9,0,1,0
16,386,386,3,3,0,1,0
4,392,392,1,1,0,1,0
9,392,392,67,1,66,3,2
1,395,395,23,23,0,1,0
14,432,432,121,91,30,3,2

12,146,146,3,3,0,1,0
16,158,158,17,17,0,1,0
3,164,164,1,1,0,1,0
6,168,168,39,13,26,3,2
17,176,176,9,6,3,2,1
10,182,182,49,13,36,3,2
2,198,198,11,4,7,2,1
9,206,206,1,1,0,1,0
0,219,219,23,23,0,1,0
4,282,282,114,114,0,1,0
1,355,355,20,20,0,1,0
5,369,369,4,4,0,1,0
18,406,406,83,83,0,1,0
11,409,409,15,15,0,1,0
8,429,429,8,1,7,2,1
7,434,434,3,3,0,1,0
13,460,460,67,54,13,2,1
15,460,460,33,33,0,1,0
14,461,461,7,7,0,1,0

0,187,187,3,3,0,1,0
4,199,199,19,19,0,1,0
3,294,294,12,12,0,1,0
16,304,304,34,34,0,1,0
13,304,304,15,15,0,1,0
17,306,306,49,49,0,1,0
10,317,317,29,29,0,1,0
15,317,317,1,1,0,1,0
12,321,321,4,4,0,1,0
6,348,348,30,30,0,1,0
1,365,365,36,36,0,1,0
5,383,383,33,33,0,1,0
11,386,386,136,40,96,4,3
7,397,397,65,42,23,2,1
18,411,411,27,17,10,2,1
8,420,420,10,1,9,2,1
9,433,433,22,22,0,1,0
14,481,481,32,32,0,1,0
2,495,495,118,81,37,2,1

3,106,106,13,6,7,2,1
12,111,111,7,7,0,1,0
8,116,116,7,7,0,1,0
18,192,192,13,3,10,3,2
10,218,218,17,17,0,1,0
15,266,266,31,14,17,2,1
1,282,282,14,14,0,1,0
11,288,288,1,1,0,1,0
19,293,293,31,31,0,1,0
6,297,297,19,9,10,2,1
2,340,340,95,95,0,1,0
9,345,345,24,8,16,2,1
7,351,351,6,6,0,1,0
0,374,374,5,5,0,1,0
17,377,377,53,53,0,1,0
16,393,393,23,11,12,2,1
13,406,406,8,8,0,1,0
5,475,475,63,47,16,2,1
20,483,483,14,14,0,1,0
14,490,490,154,154,0,1,0
4,496,496,5,1,4,2,1

8,117,117,8,8,0,1,0
10,127,127,2,2,0,1,0
0,217,217,1,1,0,1,0
11,234,234,36,14,22,2,1
3,248,248,78,40,38,3,2
2,249,249,12,12,0,1,0
6,253,253,17,7,10,4,3
16,256,256,2,2,0,1,0
4,271,271,14,2,12,3,2
1,332,332,19,8,11,2,1
13,332,332,12,6,6,3,2
9,339,339,7,7,0,1,0
12,368,368,60,60,0,1,0
15,390,390,37,37,0,1,0
7,421,421,3,3,0,1,0
5,442,442,128,98,30,4,3
14,465,465,59,59,0,1,0
17,477,477,144,120,24,4,3

13,111,111,1,1,0,1,0
10,120,120,16,7,9,4,3
2,172,172,13,4,9,4,3
18,218,218,32,6,26,2,1
3,248,248,5,5,0,1,0
8,298,298,1,1,0,1,0
6,310,310,25,13,12,2,1
1,313,313,15,2,13,2,1
15,341,341,11,11,0,1,0
0,368,368,14,14,0,1,0
5,381,381,25,25,0,1,0
4,402,402,35,35,0,1,0
9,419,419,27,27,0,1,0
11,419,419,28,28,0,1,0
16,443,443,18,18,0,1,0
14,467,467,13,13,0,1,0
17,472,472,109,44,65,4,3
7,475,475,199,156,43,2,1
12,483,483,113,113,0,1,0

4,125,125,12,3,9,3,2
20,138,138,33,33,0,1,0
15,149,149,8,8,0,1,0
11,175,175,1,1,0,1,0
17,198,198,12,5,7,2,1
10,207,207,5,5,0,1,0
18,234,234,4,1,3,2,1
6,238,238,1,1,0,1,0
13,239,239,48,6,42,4,3
12,259,259,23,11,12,3,2
16,267,267,21,10,11,2,1
19,279,279,21,21,0,1,0
8,286,286,5,5,0,1,0
5,304,304,26,12,14,3,2
2,343,343,28,28,0,1,0
14,402,402,45,45,0,1,0
9,420,420,34,18,16,3,2
1,433,433,74,74,0,1,0
7,454,454,86,86,0,1,0
0,461,461,47,10,37,2,1
3,484,484,22,22,0,1,0

14,170,170,3,3,0,1,0
9,180,180,5,5,0,1,0
2,240,240,2,2,0,1,0
13,244,244,72,72,0,1,0
8,259,259,19,19,0,1,0
7,268,268,42,8,34,2,1
6,279,279,13,13,0,1,0
0,331,331,14,14,0,1,0
4,339,339,51,18,33,4,3
15,341,341,14,2,12,2,1
16,348,348,63,7,56,3,2
10,349,349,21,6,15,4,3
11,363,363,93,71,22,2,1
3,397,397,8,8,0,1,0
5,421,421,52,5,47,3,2
17,430,430,7,2,5,2,1
12,451,451,8,8,0,1,0
1,463,463,129,4,125,4,3

0,106,106,14,14,0,1,0
4,106,106,8,8,0,1,0
1,164,164,2,2,0,1,0
16,165,165,1,1,0,1,0
5,190,190,3,3,0,1,0
9,262,262,13,3,10,2,1
12,263,263,65,52,13,2,1
10,285,285,22,22,0,1,0
6,313,313,68,33,35,2,1
13,317,317,9,9,0,1,0
3,325,325,62,19,43,2,1
17,333,333,121,121,0,1,0
8,341,341,44,44,0,1,0
14,347,347,17,8,9,4,3
11,372,372,34,14,20,2,1
15,435,435,4,4,0,1,0
7,452,452,10,10,0,1,0
2,464,464,50,12,38,2,1

6,114,114,10,10,0,1,0
17,136,136,25,1,24,4,3
2,151,151,21,21,0,1,0
18,152,152,43,3,40,2,1
19,160,160,2,2,0,1,0
10,190,190,11,3,8,3,2
11,225,225,6,6,0,1,0
3,229,229,12,12,0,1,0
4,241,241,1,1,0,1,0
16,312,312,19,19,0,1,0
7,329,329,28,28,0,1,0
14,333,333,6,2,4,2,1
0,363,363,48,13,35,2,1
8,382,382,72,28,44,3,2
5,440,440,1,1,0,1,0
1,448,448,54,36,18,4,3
13,449,449,58,8,50,2,1
9,462,462,15,1,14,2,1
12,464,464,9,9,0,1,0
15,469,469,87,63,24,3,2

5,105,105,1,1,0,1,0
3,137,137,5,5,0,1,0
13,153,153,3,3,0,1,0
8,174,174,1,1,0,1,0
10,225,225,24,16,8,2,1
19,284,284,19,19,0,1,0
16,292,292,2,2,0,1,0
14,319,319,140,38,102,4,3
4,326,326,7,7,0,1,0
9,350,350,35,20,15,2,1
6,365,365,29,29,0,1,0
7,399,399,8,5,3,2,1
1,408,408,2,2,0,1,0
0,409,409,67,67,0,1,0
17,409,409,42,42,0,1,0
15,422,422,5,5,0,1,0
2,429,429,87,30,57,4,3
20,481,481,57,17,40,2,1
18,490,490,31,31,0,1,0
11,496,496,74,41,33,4,3
12,499,499,44,12,32,3,2

14,114,114,9,1,8,3,2
4,142,142,19,19,0,1,0
11,145,145,8,8,0,1,0
6,152,152,21,21,0,1,0
13,215,215,3,3,0,1,0
15,242,242,11,11,0,1,0
10,250,250,14,14,0,1,0
2,298,298,6,6,0,1,0
17,306,306,35,35,0,1,0
3,320,320,28,1,27,4,3
0,344,344,4,4,0,1,0
8,360,360,53,46,7,3,2
9,371,371,166,127,39,2,1
5,419,419,6,2,4,2,1
7,433,433,141,57,84,4,3
1,433,433,10,10,0,1,0
16,440,440,14,5,9,2,1
12,442,442,32,4,28,4,3

13,116,116,7,1,6,2,1
4,120,120,44,44,0,1,0
2,139,139,14,14,0,1,0
8,180,180,16,9,7,2,1
9,181,181,5,2,3,2,1
10,245,245,20,20,0,1,0
1,266,266,88,43,45,2,1
11,354,354,69,38,31,2,1
12,357,357,86,8,78,4,3
6,388,388,5,1,4,2,1
0,414,414,39,5,34,3,2
7,425,425,78,63,15,4,3
3,437,437,6,6,0,1,0
5,496,496,15,15,0,1,0

11,141,141,1,1,0,1,0
4,145,145,20,6,14,2,1
10,157,157,24,4,20,3,2
16,166,166,29,29,0,1,0
18,170,170,1,1,0,1,0
2,173,173,1,1,0,1,0
6,176,176,11,6,5,2,1
9,199,199,1,1,0,1,0
3,245,245,23,2,21,2,1
13,276,276,27,20,7,2,1
1,296,296,11,1,10,3,2
19,298,298,80,80,0,1,0
7,309,309,42,42,0,1,0
8,330,330,1,1,0,1,0
0,348,348,25,3,22,3,2
20,349,349,23,23,0,1,0
12,385,385,61,61,0,1,0
17,392,392,15,6,9,4,3
21,399,399,57,21,36,4,3
5,409,409,12,12,0,1,0
15,458,458,47,47,0,1,0
14,468,468,9,9,0,1,0

5,154,154,35,14,21,2,1
17,200,200,10,2,8,3,2
12,201,201,24,3,21,4,3
9,216,216,67,9,58,3,2
8,238,238,9,9,0,1,0
18,240,240,38,38,0,1,0
6,269,269,5,2,3,2,1
1,288,288,2,2,0,1,0
15,320,320,33,33,0,1,0
11,347,347,78,27,51,4,3
7,359,359,22,22,0,1,0
0,368,368,14,14,0,1,0
3,398,398,39,9,30,3,2
10,415,415,24,6,18,3,2
4,422,422,42,42,0,1,0
16,428,428,15,15,0,1,0
13,469,469,36,36,0,1,0
2,471,471,3,3,0,1,0
14,487,487,47,47,0,1,0

4,139,139,1,1,0,1,0
16,152,152,22,22,0,1,0
2,170,170,13,7,6,3,2
13,174,174,12,2,10,2,1
1,199,199,11,11,0,1,0
21,211,211,7,7,0,1,0
5,219,219,1,1,0,1,0
12,222,222,18,18,0,1,0
7,250,250,10,10,0,1,0
0,267,267,15,1,14,2,1
15,301,301,13,7,6,2,1
20,334,334,50,8,42,2,1
18,347,347,15,15,0,1,0
6,359,359,31,31,0,1,0
8,384,384,2,2,0,1,0
22,401,401,14,2,12,4,3
3,403,403,34,14,20,2,1
24,404,404,43,43,0,1,0
9,420,420,15,6,9,4,3
14,426,426,19,5,14,2,1
17,440,440,195,84,111,4,3
25,440,440,2,2,0,1,0
23,452,452,11,6,5,2,1
11,472,472,25,25,0,1,0
19,478,478,37,13,24,4,3
10,495,495,8,8,0,1,0

8,122,122,3,3,0,1,0
19,123,123,17,5,12,3,2
16,124,124,21,21,0,1,0
1,137,137,13,13,0,1,0
18,169,169,13,13,0,1,0
0,171,171,5,5,0,1,0
17,174,174,34,23,11,2,1
11,176,176,32,32,0,1,0
6,187,187,8,2,6,3,2
3,214,214,25,13,12,4,3
2,314,314,5,5,0,1,0
13,319,319,16,4,12,4,3
5,320,320,52,52,0,1,0
14,325,325,7,7,0,1,0
10,333,333,67,1,66,4,3
7,373,373,32,32,0,1,0
9,373,373,43,29,14,3,2
12,396,396,6,6,0,1,0
15,405,405,29,19,10,2,1
4,486,486,6,6,0,1,0

1,186,186,10,10,0,1,0
11,232,232,32,32,0,1,0
7,233,233,8,8,0,1,0
2,292,292,15,15,0,1,0
12,304,304,3,3,0,1,0
6,305,305,64,64,0,1,0
14,348,348,28,17,11,3,2
13,378,378,41,21,20,2,1
3,383,383,89,24,65,4,3
10,403,403,54,54,0,1,0
0,422,422,48,4,44,2,1
5,432,432,30,12,18,2,1
4,448,448,170,170,0,1,0
8,465,465,13,3,10,2,1
9,497,497,85,55,30,3,2

16,110,110,17,6,11,4,3
3,133,133,1,1,0,1,0
9,225,225,24,12,12,4,3
10,241,241,10,1,9,4,3
5,257,257,29,29,0,1,0
6,290,290,19,14,5,2,1
1,304,304,60,44,16,3,2
15,310,310,9,9,0,1,0
2,311,311,70,58,12,2,1
13,320,320,23,23,0,1,0
4,343,343,14,14,0,1,0
11,344,344,52,34,18,4,3
0,375,375,88,24,64,3,2
8,395,395,115,115,0,1,0
7,414,414,7,7,0,1,0
12,488,488,26,26,0,1,0
14,488,488,9,9,0,1,0

14,106,106,12,9,3,2,1
3,119,119,1,1,0,1,0
15,156,156,2,2,0,1,0
1,168,168,5,5,0,1,0
5,195,195,27,27,0,1,0
4,215,215,90,90,0,1,0
2,230,230,25,7,18,2,1
13,241,241,12,1,11,2,1
6,242,242,5,1,4,2,1
0,279,279,3,3,0,1,0
16,280,280,127,127,0,1,0
8,381,381,50,20,30,2,1
11,412,412,7,7,0,1,0
18,437,437,14,14,0,1,0
7,439,439,8,8,0,1,0
12,472,472,21,21,0,1,0
9,481,481,8,8,0,1,0
10,492,492,40,4,36,4,3
17,497,497,57,9,48,4,3

14,150,150,21,15,6,3,2
0,184,184,26,5,21,2,1
1,185,185,16,10,6,3,2
11,190,190,7,4,3,2,1
2,199,199,7,7,0,1,0
18,244,244,18,18,0,1,0
8,300,300,3,3,0,1,0
12,310,310,5,5,0,1,0
13,313,313,47,47,0,1,0
10,339,339,41,10,31,4,3
6,362,362,3,3,0,1,0
7,384,384,29,29,0,1,0
9,409,409,52,24,28,2,1
16,431,431,54,35,19,4,3
17,462,462,76,36,40,2,1
5,471,471,31,31,0,1,0
15,472,472,44,2,42,4,3
4,489,489,140,97,43,4,3
3,497,497,33,33,0,1,0

10,145,145,1,1,0,1,0
12,174,174,24,2,22,2,1
5,182,182,55,26,29,4,3
16,206,206,4,1,3,2,1
2,220,220,4,4,0,1,0
9,223,223,47,29,18,3,2
0,228,228,1,1,0,1,0
14,240,240,19,13,6,2,1
4,253,253,73,73,0,1,0
13,277,277,26,26,0,1,0
11,332,332,28,28,0,1,0
7,365,365,21,21,0,1,0
6,381,381,24,24,0,1,0
8,398,398,11,11,0,1,0
15,434,434,109,101,8,3,2
1,452,452,20,12,8,2,1
3,472,472,58,58,0,1,0

0,114,114,12,12,0,1,0
12,146,146,1,1,0,1,0
17,157,157,18,18,0,1,0
5,158,158,11,11,0,1,0
13,181,181,24,12,12,4,3
18,182,182,11,11,0,1,0
7,255,255,19,19,0,1,0
2,277,277,15,15,0,1,0
3,305,305,2,2,0,1,0
11,342,342,41,41,0,1,0
6,347,347,16,16,0,1,0
9,354,354,55,31,24,2,1
14,379,379,34,34,0,1,0
10,388,388,57,57,0,1,0
16,391,391,39,39,0,1,0
4,410,410,6,1,5,2,1
8,464,464,82,33,49,3,2
19,477,477,28,19,9,4,3
15,487,487,114,114,0,1,0
1,495,495,25,16,9,4,3

10,126,126,36,12,24,3,2
11,170,170,1,1,0,1,0
5,193,193,11,3,8,3,2
0,227,227,36,36,0,1,0
7,238,238,26,26,0,1,0
14,244,244,10,10,0,1,0
4,261,261,53,32,21,2,1
8,303,303,4,4,0,1,0
15,315,315,89,6,83,4,3
6,332,332,54,38,16,3,2
13,398,398,2,2,0,1,0
1,401,401,7,7,0,1,0
3,441,441,45,14,31,2,1
2,470,470,94,94,0,1,0
12,472,472,24,1,23,4,3
9,495,495,60,6,54,4,3

14,121,121,19,19,0,1,0
15,193,193,32,3,29,4,3
7,197,197,1,1,0,1,0
0,205,205,6,3,3,2,1
4,210,210,4,4,0,1,0
12,238,238,3,3,0,1,0
17,266,266,8,8,0,1,0
8,278,278,1,1,0,1,0
16,330,330,60,34,26,2,1
3,336,336,92,41,51,4,3
1,368,368,68,12,56,4,3
9,370,370,14,14,0,1,0
5,391,391,11,11,0,1,0
6,403,403,18,18,0,1,0
13,404,404,16,2,14,2,1
19,405,405,67,25,42,4,3
11,412,412,28,28,0,1,0
10,437,437,79,79,0,1,0
18,448,448,42,9,33,2,1
2,498,498,47,23,24,2,1

8,124,124,8,8,0,1,0
18,154,154,20,10,10,3,2
9,167,167,62,62,0,1,0
5,189,189,39,39,0,1,0
19,208,208,8,8,0,1,0
15,244,244,16,1,15,4,3
17,252,252,16,8,8,3,2
1,288,288,1,1,0,1,0
2,293,293,9,1,8,3,2
4,303,303,25,12,13,2,1
0,308,308,11,11,0,1,0
16,316,316,32,32,0,1,0
10,325,325,10,10,0,1,0
12,357,357,2,2,0,1,0
6,377,377,10,10,0,1,0
7,406,406,2,2,0,1,0
13,417,417,58,43,15,4,3
14,440,440,75,75,0,1,0
3,464,464,21,21,0,1,0
11,468,468,96,8,88,4,3

4,114,114,23,23,0,1,0
17,134,134,1,1,0,1,0
0,173,173,8,8,0,1,0
12,173,173,14,14,0,1,0
1,206,206,6,6,0,1,0
6,243,243,13,4,9,2,1
3,262,262,6,6,0,1,0
20,276,276,43,7,36,3,2
8,294,294,43,28,15,4,3
5,299,299,61,18,43,4,3
11,303,303,14,8,6,3,2
16,342,342,30,11,19,2,1
9,343,343,34,34,0,1,0
19,348,348,8,5,3,2,1
7,349,349,2,2,0,1,0
18,362,362,5,5,0,1,0
15,368,368,120,94,26,4,3
10,384,384,11,11,0,1,0
2,400,400,7,7,0,1,0
13,461,461,87,17,70,3,2
14,480,480,17,17,0,1,0

17,136,136,15,5,10,3,2
16,167,167,7,7,0,1,0
5,191,191,15,1,14,3,2
3,202,202,4,1,3,2,1
0,216,216,6,6,0,1,0
8,244,244,42,16,26,3,2
9,249,249,12,6,6,3,2
2,258,258,2,2,0,1,0
15,274,274,45,38,7,2,1
7,275,275,34,34,0,1,0
13,294,294,2,2,0,1,0
18,333,333,133,133,0,1,0
12,370,370,17,3,14,4,3
1,371,371,17,5,12,2,1
14,414,414,39,29,10,2,1
6,437,437,26,26,0,1,0
10,448,448,13,7,6,2,1
4,461,461,147,69,78,3,2
11,478,478,12,12,0,1,0

13,130,130,10,10,0,1,0
7,134,134,17,17,0,1,0
11,135,135,2,2,0,1,0
16,207,207,51,24,27,4,3
15,227,227,8,8,0,1,0
0,236,236,41,41,0,1,0
3,286,286,25,11,14,3,2
6,294,294,27,27,0,1,0
10,295,295,35,10,25,2,1
12,299,299,56,18,38,4,3
9,315,315,53,1,52,3,2
14,333,333,3,3,0,1,0
1,337,337,2,2,0,1,0
2,353,353,79,73,6,2,1
4,414,414,28,28,0,1,0
8,415,415,24,24,0,1,0
5,424,424,55,55,0,1,0

17,100,100,6,1,5,2,1
5,115,115,2,2,0,1,0
13,153,153,7,1,6,2,1
7,167,167,16,16,0,1,0
6,171,171,19,8,11,2,1
3,175,175,17,17,0,1,0
10,208,208,44,44,0,1,0
12,229,229,51,51,0,1,0
0,232,232,15,15,0,1,0
8,239,239,70,70,0,1,0
1,248,248,17,12,5,2,1
11,268,268,2,2,0,1,0
15,287,287,16,16,0,1,0
4,357,357,4,1,3,2,1
16,378,378,97,97,0,1,0
2,392,392,56,35,21,4,3
9,418,418,6,6,0,1,0
14,432,432,20,11,9,2,1

4,123,123,16,5,11,2,1
3,139,139,10,10,0,1,0
17,140,140,7,7,0,1,0
0,148,148,8,8,0,1,0
15,218,218,15,15,0,1,0
9,229,229,25,22,3,2,1
10,234,234,11,3,8,3,2
16,256,256,6,6,0,1,0
12,265,265,128,117,11,2,1
13,269,269,17,9,8,3,2
8,291,291,28,28,0,1,0
1,325,325,65,65,0,1,0
5,345,345,33,12,21,3,2
14,381,381,15,5,10,3,2
18,391,391,45,45,0,1,0
2,403,403,43,43,0,1,0
11,433,433,12,12,0,1,0
7,433,433,14,5,9,4,3
6,442,442,3,3,0,1,0

1,100,100,7,7,0,1,0
2,101,101,1,1,0,1,0
15,107,107,3,3,0,1,0
6,121,121,4,4,0,1,0
4,149,149,8,8,0,1,0
10,166,166,2,2,0,1,0
3,200,200,9,9,0,1,0
13,217,217,1,1,0,1,0
20,246,246,4,4,0,1,0
7,289,289,10,10,0,1,0
14,290,290,140,40,100,4,3
8,297,297,41,41,0,1,0
18,304,304,8,8,0,1,0
9,310,310,110,16,94,4,3
12,316,316,20,2,18,4,3
0,334,334,7,7,0,1,0
5,370,370,5,5,0,1,0
11,438,438,51,23,28,3,2
19,468,468,81,6,75,4,3
17,480,480,45,11,34,2,1
16,497,497,12,12,0,1,0

4,160,160,25,5,20,2,1
11,164,164,17,17,0,1,0
12,174,174,11,5,6,2,1
8,208,208,1,1,0,1,0
10,222,222,57,57,0,1,0
14,239,239,43,36,7,2,1
3,253,253,1,1,0,1,0
2,278,278,16,11,5,2,1
9,413,413,6,3,3,2,1
0,427,427,112,79,33,4,3
1,431,431,50,50,0,1,0
6,441,441,33,3,30,4,3
7,446,446,10,4,6,2,1
5,492,492,150,71,79,4,3
13,497,497,101,81,20,3,2

10,102,102,6,6,0,1,0
14,116,116,34,24,10,3,2
1,146,146,11,2,9,2,1
9,150,150,45,15,30,2,1
11,169,169,4,4,0,1,0
0,178,178,37,37,0,1,0
3,209,209,14,14,0,1,0
13,239,239,14,3,11,2,1
4,296,296,28,22,6,2,1
2,322,322,3,3,0,1,0
5,331,331,16,9,7,2,1
16,333,333,42,24,18,4,3
15,336,336,7,7,0,1,0
6,347,347,31,9,22,2,1
8,348,348,27,27,0,1,0
12,410,410,11,11,0,1,0
7,481,481,111,39,72,4,3
17,487,487,8,1,7,2,1

0,107,107,11,11,0,1,0
12,115,115,16,1,15,4,3
16,140,140,28,1,27,4,3
11,176,176,4,4,0,1,0
15,208,208,5,5,0,1,0
9,216,216,1,1,0,1,0
4,232,232,13,8,5,2,1
10,290,290,43,21,22,2,1
8,322,322,8,1,7,2,1
3,378,378,59,11,48,4,3
7,387,387,55,55,0,1,0
2,449,449,84,66,18,4,3
6,455,455,16,16,0,1,0
14,456,456,135,3,132,4,3
1,464,464,89,33,56,3,2
5,480,480,15,6,9,4,3
13,480,480,32,2,30,2,1

7,132,132,13,13,0,1,0
1,156,156,15,1,14,3,2
6,157,157,21,10,11,2,1
15,164,164,20,2,18,2,1
2,186,186,18,18,0,1,0
8,223,223,20,8,12,4,3
13,239,239,31,31,0,1,0
0,271,271,34,24,10,2,1
11,273,273,9,3,6,3,2
5,276,276,17,4,13,2,1
9,304,304,22,11,11,2,1
3,318,318,17,4,13,2,1
10,365,365,36,36,0,1,0
14,464,464,22,22,0,1,0
4,486,486,162,153,9,2,1
12,497,497,112,8,104,4,3

12,120,120,23,1,22,4,3
10,149,149,10,2,8,3,2
5,186,186,58,10,48,3,2
1,250,250,15,15,0,1,0
4,281,281,17,17,0,1,0
11,356,356,6,6,0,1,0
8,359,359,33,33,0,1,0
0,366,366,239,239,0,1,0
3,393,393,58,19,39,4,3
9,397,397,30,5,25,2,1
6,398,398,8,8,0,1,0
7,431,431,39,9,30,2,1
2,452,452,18,7,11,2,1

0,101,101,2,2,0,1,0
12,101,101,26,26,0,1,0
4,148,148,1,1,0,1,0
3,151,151,31,31,0,1,0
1,159,159,49,13,36,2,1
7,198,198,45,33,12,4,3
13,243,243,14,14,0,1,0
2,244,244,18,6,12,4,3
5,273,273,36,36,0,1,0
10,304,304,10,10,0,1,0
15,344,344,9,9,0,1,0
8,388,388,4,4,0,1,0
14,397,397,96,6,90,3,2
9,401,401,15,15,0,1,0
6,433,433,67,67,0,1,0
11,459,459,13,10,3,2,1

6,126,126,12,12,0,1,0
10,138,138,2,2,0,1,0
7,149,149,1,1,0,1,0
9,157,157,12,5,7,3,2
0,161,161,30,30,0,1,0
2,171,171,53,47,6,3,2
3,171,171,26,26,0,1,0
13,198,198,36,29,7,2,1
4,203,203,15,8,7,2,1
12,243,243,18,12,6,2,1
14,279,279,45,45,0,1,0
5,287,287,1,1,0,1,0
8,304,304,56,56,0,1,0
15,346,346,16,16,0,1,0
11,471,471,82,82,0,1,0
1,476,476,41,27,14,3,2

20,114,114,25,1,24,3,2
18,117,117,8,8,0,1,0
14,137,137,3,3,0,1,0
9,168,168,17,7,10,2,1
13,218,218,2,2,0,1,0
4,246,246,21,3,18,3,2
3,262,262,36,36,0,1,0
19,301,301,45,45,0,1,0
10,308,308,1,1,0,1,0
21,319,319,9,6,3,2,1
6,325,325,22,22,0,1,0
15,351,351,121,121,0,1,0
1,372,372,3,3,0,1,0
2,421,421,15,15,0,1,0
7,431,431,4,4,0,1,0
16,432,432,28,28,0,1,0
5,454,454,7,7,0,1,0
11,470,470,84,78,6,2,1
17,472,472,7,7,0,1,0
8,476,476,109,28,81,4,3
0,491,491,1,1,0,1,0
12,498,498,14,14,0,1,0

14,155,155,44,44,0,1,0
2,209,209,18,18,0,1,0
13,249,249,16,2,14,2,1
8,287,287,12,12,0,1,0
3,289,289,51,51,0,1,0
1,343,343,105,75,30,2,1
4,343,343,15,15,0,1,0
7,349,349,33,13,20,3,2
0,364,364,61,61,0,1,0
9,379,379,5,5,0,1,0
5,431,431,52,52,0,1,0
6,435,435,103,98,5,2,1
10,446,446,19,4,15,4,3
11,449,449,28,18,10,2,1
12,498,498,38,20,18,3,2

11,107,107,9,9,0,1,0
1,138,138,37,37,0,1,0
6,193,193,1,1,0,1,0
0,261,261,43,10,33,4,3
9,297,297,24,9,15,2,1
7,313,313,20,20,0,1,0
8,322,322,87,68,19,2,1
2,384,384,30,30,0,1,0
5,411,411,18,6,12,3,2
12,451,451,46,4,42,4,3
4,456,456,10,2,8,3,2
3,471,471,173,126,47,3,2
10,498,498,66,28,38,4,3
13,499,499,63,63,0,1,0

1,113,113,1,1,0,1,0
13,115,115,15,15,0,1,0
21,132,132,23,8,15,3,2
3,134,134,2,2,0,1,0
11,141,141,8,8,0,1,0
0,148,148,12,12,0,1,0
16,158,158,6,6,0,1,0
8,170,170,2,2,0,1,0
22,211,211,17,4,13,2,1
17,219,219,9,9,0,1,0
12,240,240,4,4,0,1,0
18,246,246,42,16,26,4,3
25,269,269,9,9,0,1,0
23,276,276,54,54,0,1,0
15,279,279,1,1,0,1,0
24,289,289,11,11,0,1,0
9,294,294,13,13,0,1,0
7,340,340,19,1,18,3,2
2,357,357,6,6,0,1,0
20,368,368,3,3,0,1,0
10,376,376,46,32,14,3,2
19,404,404,70,70,0,1,0
6,407,407,19,1,18,4,3
5,425,425,1,1,0,1,0
14,474,474,61,12,49,2,1
4,480,480,39,39,0,1,0
26,485,485,21,6,15,2,1

4,142,142,3,3,0,1,0
10,164,164,26,12,14,2,1
7,174,174,19,19,0,1,0
12,178,178,27,27,0,1,0
2,181,181,8,8,0,1,0
11,183,183,3,3,0,1,0
14,192,192,1,1,0,1,0
15,197,197,2,2,0,1,0
9,222,222,17,17,0,1,0
5,228,228,26,4,22,3,2
0,256,256,9,3,6,2,1
8,284,284,21,2,19,2,1
16,306,306,57,13,44,2,1
6,357,357,16,16,0,1,0
17,422,422,74,74,0,1,0
13,430,430,56,37,19,3,2
1,440,440,157,127,30,2,1
3,465,465,47,47,0,1,0

1,110,110,49,49,0,1,0
0,127,127,29,29,0,1,0
5,129,129,2,2,0,1,0
3,148,148,8,3,5,2,1
4,174,174,26,8,18,4,3
9,185,185,11,5,6,3,2
13,195,195,20,5,15,2,1
2,197,197,2,2,0,1,0
6,220,220,56,22,34,3,2
7,225,225,4,4,0,1,0
14,340,340,4,1,3,2,1
8,346,346,25,5,20,2,1
10,352,352,25,7,18,4,3
12,372,372,42,29,13,4,3
11,468,468,101,101,0,1,0

7,103,103,4,1,3,2,1
9,111,111,7,7,0,1,0
8,131,131,3,3,0,1,0
2,137,137,11,11,0,1,0
6,139,139,2,2,0,1,0
17,142,142,1,1,0,1,0
0,153,153,2,2,0,1,0
3,192,192,4,4,0,1,0
4,232,232,47,47,0,1,0
19,240,240,7,1,6,2,1
12,264,264,30,30,0,1,0
14,311,311,12,12,0,1,0
13,332,332,26,26,0,1,0
18,352,352,58,58,0,1,0
15,352,352,91,91,0,1,0
5,353,353,26,19,7,2,1
16,384,384,2,2,0,1,0
1,411,411,69,69,0,1,0
20,412,412,92,92,0,1,0
11,431,431,79,79,0,1,0
10,477,477,10,4,6,3,2

15,131,131,4,4,0,1,0
0,139,139,13,4,9,2,1
1,182,182,64,64,0,1,0
8,187,187,52,52,0,1,0
13,211,211,7,3,4,2,1
7,232,232,13,13,0,1,0
4,252,252,30,27,3,2,1
14,254,254,27,27,0,1,0
5,328,328,9,1,8,2,1
16,350,350,27,3,24,3,2
10,356,356,38,11,27,4,3
9,380,380,6,6,0,1,0
3,431,431,31,31,0,1,0
11,443,443,98,69,29,3,2
6,454,454,81,55,26,2,1
12,466,466,23,6,17,2,1
2,495,495,2,2,0,1,0

12,121,121,17,17,0,1,0
16,137,137,50,38,12,2,1
13,163,163,6,6,0,1,0
5,167,167,26,26,0,1,0
9,194,194,36,21,15,2,1
0,246,246,23,23,0,1,0
18,252,252,16,16,0,1,0
2,282,282,1,1,0,1,0
19,320,320,1,1,0,1,0
3,321,321,10,10,0,1,0
6,334,334,2,2,0,1,0
14,352,352,8,1,7,3,2
4,369,369,25,18,7,2,1
10,396,396,6,6,0,1,0
8,411,411,48,36,12,4,3
7,429,429,63,3,60,3,2
17,460,460,90,12,78,4,3
1,467,467,37,37,0,1,0
11,470,470,42,42,0,1,0
15,472,472,1,1,0,1,0

23,107,107,13,13,0,1,0
8,116,116,7,3,4,2,1
20,117,117,4,4,0,1,0
18,130,130,20,2,18,4,3
1,146,146,3,3,0,1,0
15,177,177,7,7,0,1,0
6,238,238,9,9,0,1,0
22,265,265,14,11,3,2,1
5,301,301,7,7,0,1,0
14,303,303,24,17,7,2,1
17,316,316,136,40,96,4,3
7,328,328,30,21,9,2,1
9,337,337,21,21,0,1,0
0,361,361,82,75,7,2,1
21,365,365,17,1,16,3,2
4,377,377,34,34,0,1,0
16,386,386,7,2,5,2,1
2,445,445,3,3,0,1,0
19,459,459,9,9,0,1,0
10,463,463,36,31,5,2,1
13,464,464,14,9,5,2,1
11,466,466,15,15,0,1,0
3,473,473,12,12,0,1,0
12,490,490,18,18,0,1,0

6,118,118,4,4,0,1,0
14,145,145,43,43,0,1,0
0,149,149,1,1,0,1,0
2,151,151,5,5,0,1,0
4,156,156,19,19,0,1,0
9,179,179,10,10,0,1,0
21,190,190,8,8,0,1,0
8,242,242,1,1,0,1,0
17,258,258,20,20,0,1,0
1,287,287,33,18,15,2,1
3,310,310,39,16,23,4,3
11,355,355,42,42,0,1,0
20,355,355,12,12,0,1,0
18,374,374,68,68,0,1,0
5,375,375,57,38,19,2,1
15,380,380,54,17,37,2,1
16,385,385,11,11,0,1,0
19,433,433,45,9,36,4,3
10,484,484,1,1,0,1,0
7,488,488,14,14,0,1,0
12,488,488,51,51,0,1,0
13,497,497,3,3,0,1,0

10,112,112,7,1,6,3,2
7,223,223,49,49,0,1,0
5,228,228,58,55,3,2,1
12,244,244,38,31,7,2,1
6,253,253,51,51,0,1,0
15,261,261,29,2,27,2,1
13,289,289,2,2,0,1,0
3,296,296,10,10,0,1,0
9,303,303,13,13,0,1,0
14,308,308,17,3,14,2,1
2,346,346,10,1,9,4,3
8,400,400,101,101,0,1,0
11,416,416,6,6,0,1,0
0,425,425,50,50,0,1,0
1,459,459,101,63,38,3,2
4,490,490,23,23,0,1,0

5,102,102,3,3,0,1,0
15,103,103,1,1,0,1,0
14,114,114,8,8,0,1,0
13,132,132,53,26,27,4,3
8,164,164,83,83,0,1,0
3,189,189,1,1,0,1,0
7,193,193,28,28,0,1,0
4,207,207,7,3,4,2,1
17,213,213,41,38,3,2,1
9,292,292,6,1,5,2,1
1,295,295,1,1,0,1,0
2,390,390,35,35,0,1,0
11,399,399,31,4,27,4,3
0,406,406,17,17,0,1,0
16,420,420,30,30,0,1,0
12,441,441,3,3,0,1,0
10,472,472,30,30,0,1,0
6,479,479,23,14,9,2,1

13,137,137,2,2,0,1,0
3,151,151,1,1,0,1,0
11,205,205,16,8,8,3,2
6,213,213,8,8,0,1,0
2,244,244,23,2,21,4,3
14,264,264,9,9,0,1,0
8,274,274,4,4,0,1,0
5,297,297,26,1,25,2,1
15,302,302,9,9,0,1,0
4,315,315,12,4,8,3,2
0,323,323,39,35,4,2,1
12,400,400,3,3,0,1,0
7,411,411,91,74,17,2,1
16,411,411,14,14,0,1,0
17,419,419,146,23,123,4,3
1,431,431,121,64,57,3,2
10,436,436,117,117,0,1,0
9,453,453,48,48,0,1,0

15,134,134,5,1,4,2,1
12,170,170,8,4,4,2,1
13,184,184,7,7,0,1,0
18,191,191,44,26,18,3,2
16,220,220,29,20,9,2,1
8,226,226,30,1,29,2,1
4,296,296,15,15,0,1,0
2,297,297,30,30,0,1,0
3,311,311,23,23,0,1,0
10,311,311,9,5,4,2,1
7,355,355,9,9,0,1,0
6,355,355,28,13,15,4,3
17,369,369,29,29,0,1,0
11,371,371,12,12,0,1,0
0,382,382,14,14,0,1,0
1,388,388,13,1,12,4,3
9,392,392,107,73,34,3,2
5,460,460,44,44,0,1,0
14,460,460,138,138,0,1,0

17,141,141,1,1,0,1,0
4,166,166,20,20,0,1,0
0,225,225,11,11,0,1,0
1,249,249,18,1,17,4,3
18,258,258,70,30,40,2,1
10,263,263,9,9,0,1,0
13,270,270,6,1,5,2,1
14,296,296,40,40,0,1,0
15,334,334,63,35,28,3,2
19,369,369,19,19,0,1,0
11,388,388,52,47,5,2,1
8,424,424,7,1,6,3,2
7,425,425,52,18,34,3,2
9,429,429,137,123,14,3,2
5,433,433,11,2,9,2,1
6,447,447,25,25,0,1,0
2,450,450,1,1,0,1,0
16,461,461,36,36,0,1,0
12,479,479,15,15,0,1,0
3,495,495,41,10,31,2,1

13,101,101,25,9,16,2,1
17,149,149,6,6,0,1,0
10,169,169,24,19,5,2,1
11,188,188,3,3,0,1,0
14,201,201,11,2,9,2,1
9,219,219,5,5,0,1,0
12,272,272,88,55,33,4,3
6,280,280,33,33,0,1,0
16,290,290,13,2,11,2,1
15,294,294,6,6,0,1,0
7,385,385,8,8,0,1,0
0,386,386,152,76,76,4,3
4,405,405,14,14,0,1,0
5,418,418,83,83,0,1,0
2,434,434,1,1,0,1,0
8,460,460,4,4,0,1,0
3,464,464,32,18,14,3,2
1,473,473,26,1,25,2,1

4,122,122,41,41,0,1,0
15,161,161,10,10,0,1,0
8,165,165,24,24,0,1,0
1,249,249,9,5,4,2,1
0,256,256,38,19,19,4,3
17,258,258,47,47,0,1,0
7,285,285,4,4,0,1,0
3,307,307,27,27,0,1,0
13,353,353,48,15,33,4,3
6,355,355,18,6,12,4,3
16,363,363,3,3,0,1,0
9,390,390,13,1,12,4,3
18,402,402,29,8,21,4,3
12,410,410,56,56,0,1,0
2,420,420,12,12,0,1,0
11,433,433,42,42,0,1,0
14,444,444,18,3,15,2,1
5,490,490,10,7,3,2,1
10,493,493,86,86,0,1,0

2,102,102,19,19,0,1,0
12,164,164,6,6,0,1,0
15,166,166,14,11,3,2,1
14,184,184,12,12,0,1,0
3,214,214,18,18,0,1,0
5,251,251,46,46,0,1,0
7,255,255,29,20,9,4,3
13,256,256,16,4,12,2,1
8,265,265,26,26,0,1,0
10,277,277,14,2,12,4,3
18,282,282,29,29,0,1,0
4,325,325,1,1,0,1,0
6,328,328,1,1,0,1,0
1,377,377,6,6,0,1,0
11,413,413,143,111,32,3,2
9,429,429,67,20,47,4,3
0,453,453,26,26,0,1,0
16,480,480,67,20,47,2,1
17,486,486,15,15,0,1,0

12,110,110,10,10,0,1,0
17,117,117,5,5,0,1,0
7,123,123,4,4,0,1,0
11,126,126,3,3,0,1,0
2,170,170,19,6,13,2,1
8,187,187,23,23,0,1,0
14,226,226,62,41,21,4,3
18,229,229,20,20,0,1,0
13,245,245,57,13,44,2,1
19,246,246,7,1,6,2,1
6,287,287,8,8,0,1,0
3,302,302,9,5,4,2,1
10,324,324,29,14,15,2,1
9,331,331,38,7,31,2,1
5,338,338,61,52,9,4,3
16,341,341,31,31,0,1,0
0,413,413,26,17,9,4,3
1,460,460,32,32,0,1,0
15,467,467,24,15,9,2,1
4,500,500,30,3,27,4,3

13,153,153,16,4,12,2,1
11,158,158,21,9,12,2,1
1,165,165,19,7,12,2,1
8,170,170,17,17,0,1,0
18,215,215,32,32,0,1,0
16,222,222,9,9,0,1,0
17,234,234,3,3,0,1,0
0,284,284,62,14,48,4,3
4,296,296,9,4,5,2,1
14,333,333,38,38,0,1,0
12,373,373,110,14,96,4,3
3,426,426,1,1,0,1,0
2,432,432,154,118,36,4,3
10,436,436,11,11,0,1,0
9,441,441,5,5,0,1,0
5,447,447,4,1,3,2,1
6,459,459,26,26,0,1,0
7,460,460,1,1,0,1,0
15,492,492,20,20,0,1,0

6,103,103,9,1,8,2,1
5,124,124,5,5,0,1,0
9,165,165,3,3,0,1,0
12,176,176,59,41,18,3,2
4,190,190,35,35,0,1,0
18,199,199,19,11,8,2,1
13,213,213,3,3,0,1,0
16,247,247,32,32,0,1,0
8,249,249,34,20,14,3,2
10,271,271,27,5,22,2,1
7,321,321,8,8,0,1,0
15,323,323,43,35,8,3,2
17,355,355,9,1,8,2,1
11,356,356,2,2,0,1,0
2,374,374,34,34,0,1,0
3,415,415,34,34,0,1,0
1,423,423,35,35,0,1,0
0,449,449,71,43,28,2,1
14,498,498,40,40,0,1,0

5,104,104,9,9,0,1,0
3,110,110,8,8,0,1,0
16,181,181,5,5,0,1,0
9,183,183,4,4,0,1,0
7,200,200,8,3,5,2,1
19,206,206,86,86,0,1,0
2,208,208,24,7,17,3,2
17,225,225,1,1,0,1,0
11,234,234,62,18,44,3,2
4,259,259,13,4,9,4,3
6,312,312,20,11,9,2,1
10,312,312,68,68,0,1,0
8,329,329,30,30,0,1,0
0,345,345,36,36,0,1,0
13,348,348,31,31,0,1,0
14,368,368,7,7,0,1,0
15,393,393,2,2,0,1,0
12,446,446,6,2,4,2,1
18,451,451,33,28,5,2,1
1,494,494,19,19,0,1,0

10,148,148,6,6,0,1,0
8,154,154,10,10,0,1,0
6,160,160,5,5,0,1,0
5,201,201,10,4,6,3,2
1,211,211,22,6,16,3,2
12,274,274,15,6,9,4,3
14,282,282,34,19,15,4,3
3,289,289,90,47,43,4,3
0,307,307,35,31,4,2,1
2,309,309,27,27,0,1,0
13,348,348,29,29,0,1,0
11,361,361,135,85,50,3,2
7,371,371,4,4,0,1,0
4,460,460,108,88,20,2,1
9,484,484,67,59,8,2,1

1,166,166,10,1,9,4,3
14,170,170,4,4,0,1,0
0,191,191,27,27,0,1,0
4,201,201,7,4,3,2,1
15,216,216,63,63,0,1,0
10,227,227,33,33,0,1,0
6,242,242,30,30,0,1,0
7,271,271,35,6,29,2,1
2,280,280,39,39,0,1,0
13,289,289,7,7,0,1,0
9,291,291,3,3,0,1,0
8,295,295,18,15,3,2,1
11,309,309,4,4,0,1,0
17,312,312,11,11,0,1,0
12,327,327,100,94,6,3,2
3,362,362,2,2,0,1,0
5,454,454,93,43,50,2,1
16,494,494,30,4,26,3,2

3,100,100,1,1,0,1,0
17,128,128,19,6,13,2,1
15,140,140,24,21,3,2,1
8,164,164,7,7,0,1,0
0,209,209,70,32,38,4,3
10,214,214,3,3,0,1,0
13,214,214,21,21,0,1,0
18,226,226,25,11,14,3,2
9,285,285,14,14,0,1,0
6,287,287,37,37,0,1,0
11,299,299,32,32,0,1,0
7,304,304,11,3,8,3,2
16,309,309,17,17,0,1,0
1,362,362,36,23,13,2,1
19,372,372,25,25,0,1,0
2,385,385,32,9,23,2,1
4,420,420,35,35,0,1,0
14,450,450,52,46,6,2,1
5,468,468,10,2,8,2,1
12,472,472,28,28,0,1,0

16,100,100,12,3,9,4,3
17,106,106,2,2,0,1,0
22,137,137,4,4,0,1,0
6,142,142,2,2,0,1,0
19,222,222,39,39,0,1,0
0,231,231,18,18,0,1,0
11,238,238,18,4,14,2,1
12,247,247,4,4,0,1,0
20,249,249,26,26,0,1,0
13,278,278,60,60,0,1,0
1,279,279,13,13,0,1,0
3,284,284,23,2,21,2,1
18,285,285,83,83,0,1,0
7,341,341,10,2,8,3,2
14,360,360,31,11,20,2,1
2,361,361,38,14,24,4,3
8,363,363,13,13,0,1,0
10,371,371,13,1,12,4,3
21,383,383,24,3,21,2,1
4,390,390,26,26,0,1,0
9,474,474,43,43,0,1,0
15,481,481,17,6,11,2,1
5,481,481,5,5,0,1,0

17,130,130,4,4,0,1,0
13,133,133,45,15,30,4,3
5,135,135,4,4,0,1,0
8,144,144,42,20,22,3,2
12,161,161,9,9,0,1,0
10,199,199,11,3,8,3,2
9,220,220,46,46,0,1,0
15,220,220,4,4,0,1,0
11,229,229,2,2,0,1,0
1,237,237,4,4,0,1,0
14,260,260,19,3,16,2,1
4,286,286,38,4,34,2,1
7,365,365,24,24,0,1,0
0,371,371,6,6,0,1,0
3,388,388,8,8,0,1,0
6,398,398,51,43,8,3,2
16,423,423,56,5,51,4,3
2,491,491,98,98,0,1,0

9,150,150,3,3,0,1,0
6,172,172,11,3,8,3,2
2,181,181,120,89,31,2,1
10,243,243,4,4,0,1,0
12,252,252,56,56,0,1,0
0,255,255,7,2,5,2,1
5,291,291,69,33,36,4,3
8,308,308,5,5,0,1,0
1,337,337,15,15,0,1,0
11,357,357,10,1,9,2,1
7,380,380,67,49,18,4,3
3,420,420,70,44,26,2,1
4,490,490,71,29,42,2,1

10,148,148,6,3,3,2,1
0,152,152,7,7,0,1,0
16,153,153,14,14,0,1,0
5,177,177,17,17,0,1,0
2,186,186,21,21,0,1,0
1,190,190,3,3,0,1,0
7,193,193,3,3,0,1,0
11,200,200,27,10,17,2,1
8,213,213,16,16,0,1,0
6,223,223,30,3,27,2,1
20,228,228,72,72,0,1,0
19,231,231,7,7,0,1,0
17,233,233,32,13,19,2,1
13,271,271,31,11,20,2,1
15,271,271,5,5,0,1,0
18,273,273,13,8,5,2,1
9,295,295,30,3,27,2,1
4,360,360,4,4,0,1,0
12,391,391,8,8,0,1,0
14,404,404,58,50,8,3,2
3,454,454,54,54,0,1,0

13,100,100,8,3,5,2,1
7,115,115,31,15,16,3,2
1,133,133,13,7,6,3,2
20,133,133,21,21,0,1,0
16,174,174,4,4,0,1,0
4,181,181,13,1,12,2,1
9,182,182,5,5,0,1,0
2,185,185,19,19,0,1,0
15,191,191,5,5,0,1,0
8,197,197,10,10,0,1,0
3,208,208,5,5,0,1,0
21,229,229,5,5,0,1,0
10,269,269,13,13,0,1,0
0,271,271,4,4,0,1,0
19,284,284,25,11,14,2,1
6,326,326,3,3,0,1,0
11,378,378,28,28,0,1,0
14,383,383,90,48,42,3,2
18,417,417,66,66,0,1,0
12,461,461,10,1,9,2,1
5,474,474,42,3,39,2,1
17,474,474,63,63,0,1,0

10,109,109,11,11,0,1,0
14,150,150,15,15,0,1,0
9,151,151,27,11,16,4,3
5,166,166,25,25,0,1,0
13,176,176,14,3,11,2,1
16,210,210,18,18,0,1,0
0,219,219,3,3,0,1,0
1,236,236,3,3,0,1,0
11,287,287,11,2,9,4,3
12,295,295,50,35,15,4,3
4,323,323,29,29,0,1,0
7,367,367,69,39,30,3,2
2,367,367,67,67,0,1,0
17,412,412,57,57,0,1,0
3,441,441,95,2,93,4,3
6,486,486,13,13,0,1,0
8,486,486,10,10,0,1,0
15,494,494,18,10,8,3,2

20,104,104,10,10,0,1,0
18,153,153,11,11,0,1,0
14,167,167,38,38,0,1,0
15,181,181,14,5,9,2,1
12,214,214,7,3,4,2,1
7,215,215,7,7,0,1,0
1,244,244,18,11,7,2,1
4,266,266,42,6,36,2,1
8,293,293,7,1,6,3,2
11,324,324,59,8,51,4,3
2,334,334,28,1,27,4,3
3,361,361,55,20,35,4,3
13,387,387,30,18,12,4,3
16,398,398,69,69,0,1,0
17,413,413,22,9,13,4,3
5,430,430,11,5,6,3,2
6,454,454,35,2,33,2,1
0,455,455,1,1,0,1,0
19,466,466,55,19,36,4,3
9,475,475,2,2,0,1,0
10,485,485,42,19,23,4,3

12,110,110,4,4,0,1,0
4,172,172,28,5,23,2,1
11,200,200,1,1,0,1,0
1,245,245,13,13,0,1,0
15,246,246,23,16,7,2,1
3,262,262,1,1,0,1,0
5,277,277,17,13,4,2,1
9,299,299,47,34,13,2,1
17,309,309,8,8,0,1,0
13,351,351,27,27,0,1,0
10,364,364,17,12,5,2,1
7,371,371,30,30,0,1,0
18,388,388,39,30,9,4,3
2,447,447,51,13,38,3,2
0,457,457,105,105,0,1,0
6,479,479,15,10,5,2,1
8,486,486,4,4,0,1,0
14,493,493,196,196,0,1,0
16,495,495,64,16,48,4,3

14,103,103,8,8,0,1,0
3,107,107,28,28,0,1,0
10,111,111,8,8,0,1,0
7,147,147,11,11,0,1,0
5,157,157,25,25,0,1,0
0,182,182,31,23,8,3,2
11,197,197,13,3,10,2,1
12,310,310,16,2,14,3,2
15,336,336,43,43,0,1,0
6,338,338,17,8,9,2,1
4,360,360,38,2,36,4,3
8,369,369,37,37,0,1,0
9,417,417,79,27,52,3,2
2,434,434,42,42,0,1,0
13,454,454,77,53,24,2,1
1,470,470,27,27,0,1,0

8,121,121,2,2,0,1,0
12,184,184,13,13,0,1,0
13,196,196,27,27,0,1,0
2,209,209,68,19,49,2,1
1,228,228,21,21,0,1,0
7,248,248,7,7,0,1,0
0,266,266,9,6,3,2,1
14,279,279,5,5,0,1,0
5,321,321,13,7,6,2,1
6,331,331,6,6,0,1,0
10,333,333,47,47,0,1,0
9,347,347,54,32,22,3,2
15,383,383,78,78,0,1,0
4,384,384,8,3,5,2,1
3,389,389,129,45,84,4,3
16,404,404,56,56,0,1,0
17,406,406,19,11,8,3,2
11,409,409,2,2,0,1,0

0,100,100,21,4,17,4,3
16,103,103,38,32,6,2,1
8,108,108,5,5,0,1,0
12,120,120,3,3,0,1,0
14,146,146,8,8,0,1,0
9,200,200,3,3,0,1,0
11,218,218,15,8,7,2,1
13,241,241,25,14,11,2,1
10,242,242,48,48,0,1,0
2,269,269,38,16,22,2,1
1,270,270,20,2,18,3,2
7,287,287,22,9,13,2,1
6,326,326,3,3,0,1,0
5,359,359,82,61,21,4,3
3,372,372,35,5,30,3,2
15,407,407,10,1,9,2,1
17,475,475,31,11,20,2,1
4,477,477,11,5,6,2,1

2,107,107,18,7,11,2,1
13,156,156,8,8,0,1,0
8,159,159,15,15,0,1,0
9,172,172,13,3,10,2,1
16,186,186,3,3,0,1,0
14,217,217,88,88,0,1,0
1,245,245,5,5,0,1,0
5,246,246,31,31,0,1,0
4,259,259,2,2,0,1,0
10,290,290,18,7,11,2,1
12,332,332,53,6,47,3,2
0,417,417,108,44,64,3,2
15,420,420,19,8,11,2,1
3,432,432,7,7,0,1,0
11,448,448,5,5,0,1,0
6,458,458,101,38,63,3,2
7,482,482,40,33,7,2,1

14,104,104,5,5,0,1,0
9,121,121,16,16,0,1,0
19,129,129,16,16,0,1,0
5,143,143,10,10,0,1,0
20,167,167,15,5,10,2,1
8,175,175,1,1,0,1,0
4,176,176,4,4,0,1,0
15,177,177,8,8,0,1,0
18,201,201,14,14,0,1,0
10,204,204,9,1,8,3,2
7,218,218,9,9,0,1,0
6,252,252,8,4,4,2,1
1,274,274,19,5,14,3,2
16,285,285,33,11,22,3,2
3,295,295,48,48,0,1,0
11,331,331,11,11,0,1,0
12,377,377,6,6,0,1,0
2,414,414,76,76,0,1,0
17,416,416,13,1,12,4,3
21,422,422,152,103,49,4,3
13,456,456,13,1,12,3,2
0,477,477,42,5,37,2,1

5,171,171,30,14,16,3,2
6,191,191,37,37,0,1,0
12,206,206,33,1,32,2,1
15,299,299,41,41,0,1,0
2,307,307,26,26,0,1,0
10,340,340,4,4,0,1,0
0,351,351,16,16,0,1,0
1,366,366,46,1,45,4,3
4,379,379,68,50,18,3,2
7,397,397,7,7,0,1,0
3,399,399,39,39,0,1,0
8,410,410,9,9,0,1,0
11,441,441,164,145,19,2,1
9,462,462,21,8,13,2,1
14,472,472,68,68,0,1,0
13,475,475,1,1,0,1,0

11,102,102,3,3,0,1,0
1,173,173,35,15,20,2,1
7,177,177,13,13,0,1,0
8,216,216,46,19,27,4,3
0,284,284,32,16,16,3,2
3,286,286,21,18,3,2,1
10,302,302,83,11,72,3,2
5,325,325,59,37,22,3,2
2,340,340,4,4,0,1,0
14,369,369,7,7,0,1,0
6,385,385,82,26,56,3,2
12,392,392,86,50,36,4,3
15,411,411,7,7,0,1,0
13,438,438,4,4,0,1,0
4,493,493,52,52,0,1,0
9,499,499,29,29,0,1,0

0,102,102,6,6,0,1,0
7,151,151,15,10,5,2,1
13,155,155,13,13,0,1,0
11,173,173,3,3,0,1,0
8,175,175,30,30,0,1,0
9,176,176,32,32,0,1,0
10,204,204,5,2,3,2,1
2,212,212,74,74,0,1,0
1,216,216,58,21,37,2,1
5,248,248,12,12,0,1,0
15,255,255,63,36,27,4,3
6,277,277,11,11,0,1,0
14,280,280,9,1,8,3,2
4,330,330,9,3,6,2,1
3,391,391,43,2,41,2,1
12,458,458,33,33,0,1,0

4,117,117,4,4,0,1,0
7,123,123,16,10,6,3,2
8,134,134,8,8,0,1,0
1,170,170,35,35,0,1,0
12,181,181,5,1,4,2,1
11,242,242,63,63,0,1,0
2,244,244,13,2,11,2,1
3,254,254,1,1,0,1,0
14,255,255,48,48,0,1,0
15,304,304,29,3,26,3,2
13,307,307,11,3,8,2,1
5,310,310,45,45,0,1,0
16,326,326,47,47,0,1,0
9,451,451,37,37,0,1,0
0,454,454,91,5,86,4,3
10,461,461,11,11,0,1,0
6,493,493,64,27,37,4,3

4,146,146,1,1,0,1,0
1,157,157,36,36,0,1,0
10,167,167,14,14,0,1,0
8,182,182,28,13,15,2,1
9,210,210,31,31,0,1,0
5,307,307,74,74,0,1,0
12,399,399,18,13,5,2,1
6,420,420,48,48,0,1,0
0,423,423,58,44,14,3,2
2,430,430,29,9,20,3,2
14,444,444,115,115,0,1,0
3,473,473,104,104,0,1,0
13,477,477,3,3,0,1,0
7,487,487,12,12,0,1,0
11,493,493,40,13,27,4,3

21,112,112,5,5,0,1,0
2,139,139,3,3,0,1,0
6,147,147,13,3,10,3,2
9,155,155,10,1,9,2,1
7,158,158,15,15,0,1,0
16,179,179,22,22,0,1,0
12,186,186,1,1,0,1,0
0,196,196,1,1,0,1,0
10,201,201,13,13,0,1,0
18,205,205,73,1,72,4,3
4,215,215,41,35,6,3,2
15,242,242,23,23,0,1,0
13,268,268,4,1,3,2,1
11,273,273,32,2,30,2,1
5,286,286,8,5,3,2,1
8,295,295,22,15,7,2,1
23,297,297,12,12,0,1,0
22,298,298,14,2,12,3,2
17,308,308,6,6,0,1,0
3,358,358,27,27,0,1,0
1,372,372,20,10,10,4,3
20,406,406,63,57,6,3,2
19,469,469,18,18,0,1,0
14,486,486,1,1,0,1,0

3,119,119,18,7,11,2,1
14,144,144,3,3,0,1,0
12,145,145,7,7,0,1,0
9,206,206,24,24,0,1,0
4,248,248,16,13,3,2,1
0,276,276,11,11,0,1,0
2,292,292,68,58,10,3,2
5,333,333,39,36,3,2,1
8,387,387,69,41,28,2,1
11,417,417,38,38,0,1,0
7,422,422,28,7,21,4,3
10,422,422,77,77,0,1,0
1,431,431,127,127,0,1,0
6,460,460,61,30,31,3,2
13,464,464,36,36,0,1,0

11,100,100,10,10,0,1,0
5,141,141,29,29,0,1,0
8,167,167,18,18,0,1,0
15,182,182,1,1,0,1,0
9,187,187,16,16,0,1,0
0,233,233,32,32,0,1,0
19,240,240,13,7,6,3,2
6,256,256,30,30,0,1,0
1,262,262,3,3,0,1,0
10,271,271,7,7,0,1,0
14,312,312,94,94,0,1,0
7,347,347,10,2,8,3,2
12,362,362,94,79,15,2,1
16,391,391,22,22,0,1,0
3,467,467,3,3,0,1,0
4,467,467,70,70,0,1,0
17,479,479,3,3,0,1,0
2,483,483,13,7,6,3,2
18,488,488,44,12,32,3,2
13,495,495,25,12,13,2,1

10,135,135,8,8,0,1,0
16,137,137,12,12,0,1,0
14,151,151,41,14,27,4,3
2,163,163,5,2,3,2,1
8,237,237,53,44,9,4,3
11,238,238,9,9,0,1,0
0,290,290,48,48,0,1,0
13,295,295,34,34,0,1,0
3,341,341,23,23,0,1,0
9,344,344,1,1,0,1,0
1,387,387,18,4,14,2,1
15,432,432,35,35,0,1,0
7,450,450,46,46,0,1,0
6,470,470,78,27,51,4,3
5,471,471,13,8,5,2,1
4,485,485,143,31,112,4,3
12,492,492,17,17,0,1,0

7,106,106,10,10,0,1,0
11,131,131,5,5,0,1,0
3,136,136,8,8,0,1,0
19,143,143,14,14,0,1,0
5,160,160,18,18,0,1,0
13,180,180,4,4,0,1,0
17,193,193,3,3,0,1,0
14,230,230,8,8,0,1,0
12,230,230,20,20,0,1,0
20,262,262,53,48,5,2,1
9,330,330,51,33,18,4,3
1,331,331,11,11,0,1,0
8,347,347,37,22,15,2,1
4,348,348,2,2,0,1,0
0,369,369,20,2,18,3,2
15,373,373,70,40,30,2,1
18,391,391,31,31,0,1,0
10,456,456,20,12,8,2,1
2,466,466,24,4,20,3,2
6,471,471,70,70,0,1,0
16,500,500,96,16,80,4,3

0,153,153,1,1,0,1,0
16,195,195,22,22,0,1,0
18,204,204,14,14,0,1,0
1,218,218,19,13,6,3,2
10,235,235,42,28,14,3,2
12,246,246,10,10,0,1,0
7,336,336,83,83,0,1,0
3,341,341,9,3,6,2,1
6,371,371,8,8,0,1,0
19,388,388,30,30,0,1,0
15,393,393,67,31,36,2,1
4,412,412,35,31,4,2,1
8,424,424,63,63,0,1,0
17,431,431,29,21,8,2,1
5,433,433,8,8,0,1,0
11,452,452,14,14,0,1,0
13,454,454,80,56,24,3,2
2,462,462,37,37,0,1,0
9,483,483,2,2,0,1,0
14,497,497,86,14,72,4,3

10,105,105,1,1,0,1,0
15,117,117,7,7,0,1,0
0,136,136,19,11,8,2,1
2,138,138,11,3,8,2,1
7,140,140,1,1,0,1,0
17,140,140,47,27,20,2,1
6,145,145,1,1,0,1,0
8,194,194,2,2,0,1,0
13,235,235,45,42,3,2,1
5,262,262,10,2,8,3,2
11,336,336,18,8,10,2,1
19,342,342,25,20,5,2,1
16,347,347,23,13,10,2,1
9,350,350,92,64,28,2,1
18,387,387,18,5,13,2,1
1,413,413,37,29,8,3,2
14,438,438,24,10,14,3,2
12,444,444,28,8,20,2,1
3,465,465,2,2,0,1,0
20,476,476,14,14,0,1,0
4,494,494,98,26,72,3,2

8,103,103,35,35,0,1,0
9,113,113,8,8,0,1,0
0,135,135,28,28,0,1,0
6,163,163,16,16,0,1,0
13,203,203,26,5,21,4,3
3,223,223,26,2,24,2,1
5,227,227,33,15,18,2,1
14,238,238,4,4,0,1,0
4,251,251,28,14,14,3,2
11,279,279,32,3,29,3,2
2,299,299,4,4,0,1,0
16,307,307,54,54,0,1,0
10,362,362,23,17,6,2,1
1,384,384,40,25,15,4,3
12,428,428,4,4,0,1,0
15,497,497,2,2,0,1,0
7,498,498,52,52,0,1,0

16,114,114,5,2,3,2,1
7,231,231,36,27,9,2,1
5,234,234,1,1,0,1,0
10,267,267,17,17,0,1,0
14,272,272,13,9,4,2,1
0,287,287,32,24,8,2,1
3,305,305,46,46,0,1,0
6,328,328,7,7,0,1,0
13,334,334,10,10,0,1,0
9,358,358,15,7,8,3,2
12,361,361,24,5,19,2,1
11,363,363,118,74,44,4,3
4,409,409,97,34,63,4,3
8,430,430,91,87,4,2,1
2,432,432,74,8,66,3,2
1,447,447,22,22,0,1,0
15,487,487,41,19,22,2,1

12,110,110,2,2,0,1,0
8,145,145,28,28,0,1,0
1,153,153,3,3,0,1,0
13,170,170,43,43,0,1,0
15,180,180,3,3,0,1,0
14,221,221,61,45,16,2,1
7,226,226,11,5,6,2,1
2,243,243,20,20,0,1,0
10,247,247,3,3,0,1,0
5,295,295,71,25,46,3,2
17,299,299,24,24,0,1,0
4,313,313,1,1,0,1,0
0,352,352,30,17,13,2,1
6,380,380,59,59,0,1,0
16,396,396,8,8,0,1,0
9,426,426,9,9,0,1,0
3,457,457,33,33,0,1,0
11,483,483,106,61,45,2,1

20,144,144,37,25,12,2,1
1,184,184,15,1,14,3,2
15,188,188,1,1,0,1,0
8,218,218,9,9,0,1,0
14,237,237,27,27,0,1,0
13,241,241,68,68,0,1,0
7,245,245,1,1,0,1,0
5,252,252,2,2,0,1,0
9,278,278,16,5,11,2,1
11,284,284,21,13,8,3,2
16,286,286,12,3,9,4,3
3,288,288,25,5,20,3,2
21,295,295,1,1,0,1,0
10,340,340,39,17,22,3,2
6,340,340,9,6,3,2,1
12,347,347,25,5,20,3,2
19,362,362,21,5,16,3,2
0,420,420,19,19,0,1,0
18,421,421,2,2,0,1,0
4,428,428,107,107,0,1,0
17,445,445,66,66,0,1,0
2,495,495,20,20,0,1,0

10,129,129,19,19,0,1,0
5,134,134,32,32,0,1,0
1,139,139,25,25,0,1,0
6,202,202,6,6,0,1,0
7,232,232,11,5,6,3,2
14,265,265,9,3,6,2,1
12,278,278,16,5,11,3,2
3,288,288,39,26,13,4,3
9,296,296,119,86,33,4,3
13,339,339,18,10,8,3,2
0,352,352,79,32,47,2,1
11,355,355,27,27,0,1,0
8,380,380,12,3,9,2,1
4,391,391,15,4,11,2,1
2,440,440,25,25,0,1,0
15,486,486,32,32,0,1,0

8,104,104,2,2,0,1,0
12,199,199,9,3,6,3,2
6,208,208,1,1,0,1,0
11,243,243,18,18,0,1,0
9,262,262,17,5,12,4,3
1,264,264,26,16,10,3,2
10,284,284,3,3,0,1,0
5,304,304,24,2,22,4,3
3,308,308,54,54,0,1,0
7,318,318,7,2,5,2,1
0,337,337,21,21,0,1,0
16,394,394,176,167,9,2,1
4,395,395,117,27,90,4,3
13,447,447,24,3,21,4,3
14,449,449,29,13,16,3,2
2,470,470,77,77,0,1,0
15,498,498,69,43,26,2,1

2,100,100,1,1,0,1,0
14,107,107,11,3,8,3,2
11,140,140,5,5,0,1,0
10,209,209,1,1,0,1,0
8,224,224,16,6,10,3,2
9,236,236,13,7,6,3,2
7,245,245,16,2,14,2,1
3,311,311,10,10,0,1,0
15,337,337,53,1,52,4,3
13,347,347,14,2,12,4,3
5,352,352,31,21,10,3,2
4,398,398,12,6,6,2,1
18,409,409,127,89,38,2,1
16,413,413,92,51,41,2,1
17,416,416,6,6,0,1,0
12,434,434,12,12,0,1,0
0,475,475,220,220,0,1,0
6,490,490,6,1,5,2,1
1,492,492,36,36,0,1,0

1,152,152,6,6,0,1,0
12,204,204,16,16,0,1,0
14,219,219,18,1,17,2,1
13,232,232,49,49,0,1,0
0,255,255,28,28,0,1,0
3,296,296,9,9,0,1,0
10,300,300,7,1,6,2,1
7,302,302,13,13,0,1,0
8,304,304,29,19,10,3,2
2,305,305,4,4,0,1,0
6,313,313,106,10,96,3,2
17,355,355,23,10,13,2,1
18,370,370,49,31,18,3,2
16,376,376,24,3,21,4,3
11,377,377,66,27,39,4,3
4,392,392,49,17,32,3,2
15,401,401,21,21,0,1,0
19,405,405,21,21,0,1,0
5,412,412,33,33,0,1,0
9,482,482,1,1,0,1,0

5,107,107,4,4,0,1,0
18,137,137,8,8,0,1,0
13,144,144,2,2,0,1,0
1,148,148,1,1,0,1,0
4,158,158,1,1,0,1,0
6,180,180,21,9,12,2,1
2,240,240,42,42,0,1,0
12,263,263,15,15,0,1,0
3,266,266,29,1,28,4,3
19,279,279,17,17,0,1,0
21,283,283,101,28,73,4,3
14,314,314,21,15,6,2,1
7,325,325,14,14,0,1,0
0,345,345,26,26,0,1,0
8,358,358,38,19,19,3,2
11,370,370,7,4,3,2,1
17,380,380,42,42,0,1,0
20,385,385,39,39,0,1,0
16,392,392,42,22,20,2,1
15,398,398,18,5,13,2,1
9,436,436,10,6,4,2,1
10,489,489,63,28,35,2,1

9,124,124,12,3,9,4,3
5,203,203,37,31,6,2,1
4,224,224,21,21,0,1,0
6,235,235,3,3,0,1,0
14,258,258,28,28,0,1,0
15,279,279,45,45,0,1,0
7,287,287,33,33,0,1,0
2,324,324,147,138,9,2,1
12,329,329,3,3,0,1,0
8,351,351,2,2,0,1,0
11,428,428,39,39,0,1,0
10,440,440,87,11,76,3,2
3,446,446,1,1,0,1,0
0,447,447,14,6,8,2,1
1,448,448,57,57,0,1,0
13,491,491,63,63,0,1,0

2,145,145,32,26,6,2,1
9,162,162,11,3,8,2,1
0,199,199,39,39,0,1,0
3,215,215,75,75,0,1,0
5,229,229,12,9,3,2,1
11,239,239,19,1,18,3,2
1,311,311,43,31,12,2,1
4,337,337,64,1,63,4,3
10,349,349,60,41,19,2,1
8,357,357,42,7,35,3,2
6,386,386,18,18,0,1,0
12,386,386,21,21,0,1,0
7,499,499,67,17,50,2,1

2,111,111,1,1,0,1,0
19,191,191,4,4,0,1,0
10,192,192,2,2,0,1,0
0,214,214,26,26,0,1,0
7,214,214,30,3,27,2,1
11,230,230,5,2,3,2,1
12,244,244,3,3,0,1,0
3,275,275,9,9,0,1,0
6,286,286,86,35,51,4,3
9,287,287,25,25,0,1,0
17,294,294,37,20,17,2,1
13,299,299,45,9,36,4,3
14,327,327,51,36,15,4,3
18,329,329,123,51,72,4,3
4,340,340,2,2,0,1,0
8,343,343,17,1,16,3,2
16,343,343,14,14,0,1,0
15,361,361,4,4,0,1,0
5,390,390,30,30,0,1,0
1,391,391,27,27,0,1,0

5,135,135,8,8,0,1,0
14,145,145,8,8,0,1,0
3,153,153,15,15,0,1,0
12,153,153,1,1,0,1,0
23,182,182,61,61,0,1,0
16,205,205,2,2,0,1,0
21,207,207,16,1,15,4,3
7,236,236,2,2,0,1,0
13,264,264,58,58,0,1,0
19,264,264,61,61,0,1,0
6,267,267,12,12,0,1,0
4,278,278,11,11,0,1,0
8,290,290,6,6,0,1,0
18,343,343,3,3,0,1,0
9,380,380,62,34,28,3,2
2,389,389,3,3,0,1,0
17,391,391,6,2,4,2,1
1,415,415,13,13,0,1,0
11,426,426,15,15,0,1,0
15,433,433,44,44,0,1,0
0,445,445,18,12,6,2,1
22,461,461,52,40,12,4,3
20,467,467,9,9,0,1,0
10,485,485,34,17,17,2,1

4,129,129,1,1,0,1,0
6,134,134,1,1,0,1,0
2,166,166,7,7,0,1,0
7,168,168,18,11,7,2,1
16,206,206,11,5,6,3,2
5,233,233,26,26,0,1,0
3,247,247,105,81,24,2,1
14,286,286,25,25,0,1,0
9,326,326,55,55,0,1,0
11,330,330,8,2,6,2,1
8,332,332,25,10,15,4,3
0,395,395,39,39,0,1,0
1,404,404,10,10,0,1,0
15,424,424,1,1,0,1,0
10,449,449,133,25,108,4,3
17,451,451,68,20,48,2,1
12,478,478,9,9,0,1,0
13,487,487,51,51,0,1,0

8,100,100,12,12,0,1,0
14,129,129,11,5,6,2,1
5,160,160,18,10,8,2,1
4,168,168,3,3,0,1,0
10,177,177,5,5,0,1,0
15,211,211,3,3,0,1,0
9,233,233,94,94,0,1,0
3,236,236,6,6,0,1,0
17,242,242,44,44,0,1,0
7,256,256,16,6,10,2,1
16,343,343,33,24,9,2,1
6,348,348,56,56,0,1,0
13,364,364,22,10,12,2,1
12,402,402,19,19,0,1,0
0,411,411,71,30,41,2,1
1,412,412,94,76,18,3,2
11,412,412,1,1,0,1,0
2,474,474,1,1,0,1,0

7,153,153,5,5,0,1,0
13,180,180,6,6,0,1,0
0,238,238,28,28,0,1,0
12,264,264,42,32,10,2,1
16,288,288,9,9,0,1,0
19,290,290,11,11,0,1,0
21,329,329,2,2,0,1,0
11,349,349,21,21,0,1,0
10,362,362,7,7,0,1,0
20,371,371,2,2,0,1,0
18,397,397,162,69,93,4,3
14,424,424,101,65,36,4,3
17,424,424,25,12,13,2,1
3,436,436,13,5,8,3,2
8,440,440,10,2,8,3,2
2,442,442,55,55,0,1,0
22,447,447,36,28,8,3,2
5,455,455,4,4,0,1,0
4,460,460,37,9,28,2,1
1,465,465,44,14,30,4,3
15,492,492,24,24,0,1,0
9,493,493,35,17,18,2,1
6,500,500,25,25,0,1,0

10,101,101,6,6,0,1,0
17,108,108,3,3,0,1,0
14,117,117,25,25,0,1,0
19,129,129,9,9,0,1,0
24,148,148,2,2,0,1,0
13,171,171,7,7,0,1,0
12,184,184,19,6,13,4,3
8,219,219,7,7,0,1,0
5,227,227,3,3,0,1,0
11,248,248,1,1,0,1,0
3,255,255,5,5,0,1,0
1,277,277,1,1,0,1,0
7,290,290,20,17,3,2,1
6,298,298,1,1,0,1,0
18,299,299,11,11,0,1,0
21,316,316,3,3,0,1,0
23,333,333,103,103,0,1,0
25,339,339,25,4,21,4,3
2,363,363,15,15,0,1,0
20,371,371,52,52,0,1,0
9,375,375,6,6,0,1,0
0,385,385,1,1,0,1,0
22,420,420,100,100,0,1,0
15,460,460,84,66,18,4,3
16,471,471,6,6,0,1,0
4,482,482,40,40,0,1,0

12,132,132,17,17,0,1,0
8,135,135,3,3,0,1,0
0,176,176,32,32,0,1,0
16,188,188,13,13,0,1,0
19,197,197,14,14,0,1,0
3,201,201,11,11,0,1,0
10,248,248,6,1,5,2,1
9,256,256,10,10,0,1,0
4,308,308,1,1,0,1,0
11,311,311,30,30,0,1,0
18,314,314,8,2,6,2,1
1,326,326,33,33,0,1,0
5,327,327,4,4,0,1,0
14,340,340,6,1,5,2,1
2,346,346,8,8,0,1,0
6,355,355,155,155,0,1,0
15,363,363,53,47,6,2,1
13,380,380,47,21,26,4,3
7,442,442,2,2,0,1,0
17,450,450,109,75,34,3,2

26,121,121,24,24,0,1,0
10,126,126,1,1,0,1,0
5,146,146,6,6,0,1,0
25,151,151,22,1,21,2,1
0,156,156,1,1,0,1,0
24,161,161,9,1,8,3,2
2,166,166,1,1,0,1,0
3,173,173,5,5,0,1,0
8,178,178,7,7,0,1,0
21,219,219,21,4,17,2,1
7,244,244,14,1,13,2,1
11,261,261,17,5,12,3,2
15,281,281,40,10,30,4,3
6,292,292,3,3,0,1,0
23,293,293,28,6,22,3,2
13,303,303,28,28,0,1,0
19,312,312,2,2,0,1,0
20,337,337,54,48,6,3,2
16,357,357,13,13,0,1,0
1,358,358,2,2,0,1,0
14,374,374,28,16,12,2,1
18,405,405,3,3,0,1,0
4,409,409,8,8,0,1,0
12,471,471,52,52,0,1,0
22,483,483,79,30,49,2,1
17,494,494,75,39,36,2,1
9,497,497,3,3,0,1,0

1,146,146,1,1,0,1,0
9,181,181,5,5,0,1,0
7,185,185,20,20,0,1,0
11,187,187,11,3,8,2,1
4,227,227,39,25,14,3,2
5,228,228,24,24,0,1,0
10,263,263,33,33,0,1,0
14,267,267,11,3,8,2,1
3,312,312,27,11,16,3,2
2,313,313,156,122,34,3,2
0,343,343,12,8,4,2,1
12,427,427,138,42,96,3,2
8,430,430,27,27,0,1,0
6,460,460,16,2,14,3,2
13,463,463,61,61,0,1,0

7,141,141,8,8,0,1,0
18,150,150,65,12,53,3,2
17,157,157,6,6,0,1,0
8,163,163,17,14,3,2,1
10,193,193,2,2,0,1,0
14,196,196,1,1,0,1,0
0,199,199,2,2,0,1,0
13,207,207,13,7,6,3,2
21,241,241,30,30,0,1,0
22,342,342,2,2,0,1,0
6,346,346,33,33,0,1,0
12,355,355,7,7,0,1,0
3,355,355,3,3,0,1,0
15,367,367,1,1,0,1,0
11,381,381,21,21,0,1,0
4,387,387,30,30,0,1,0
9,393,393,57,20,37,2,1
1,402,402,52,19,33,4,3
19,403,403,33,3,30,2,1
5,409,409,38,2,36,4,3
20,411,411,12,12,0,1,0
16,420,420,83,83,0,1,0
2,466,466,16,16,0,1,0

2,111,111,1,1,0,1,0
12,150,150,4,4,0,1,0
7,167,167,17,17,0,1,0
15,206,206,29,29,0,1,0
4,214,214,107,61,46,2,1
1,229,229,32,2,30,3,2
11,229,229,22,19,3,2,1
10,232,232,10,7,3,2,1
5,265,265,11,11,0,1,0
0,350,350,48,48,0,1,0
13,370,370,15,15,0,1,0
8,426,426,72,7,65,4,3
9,456,456,54,6,48,4,3
3,464,464,31,31,0,1,0
6,495,495,3,3,0,1,0
14,500,500,90,2,88,3,2

12,106,106,39,5,34,2,1
4,128,128,18,11,7,2,1
0,142,142,1,1,0,1,0
11,142,142,6,6,0,1,0
15,171,171,5,2,3,2,1
18,205,205,18,11,7,2,1
7,344,344,34,16,18,4,3
5,358,358,24,24,0,1,0
10,362,362,32,32,0,1,0
9,400,400,35,35,0,1,0
8,400,400,56,47,9,2,1
14,411,411,52,40,12,3,2
6,418,418,3,3,0,1,0
13,429,429,9,9,0,1,0
1,466,466,48,18,30,4,3
16,467,467,66,39,27,4,3
2,470,470,31,22,9,2,1
3,483,483,89,3,86,3,2
17,498,498,6,6,0,1,0

13,103,103,3,3,0,1,0
4,160,160,57,57,0,1,0
10,178,178,22,22,0,1,0
9,180,180,22,12,10,3,2
15,194,194,44,28,16,2,1
5,236,236,31,21,10,2,1
11,236,236,7,1,6,3,2
7,252,252,11,11,0,1,0
2,307,307,12,12,0,1,0
8,335,335,42,22,20,2,1
6,432,432,14,14,0,1,0
12,458,458,36,36,0,1,0
1,458,458,3,3,0,1,0
0,477,477,94,94,0,1,0
16,479,479,1,1,0,1,0
14,480,480,86,68,18,4,3
3,488,488,47,21,26,3,2

13,126,126,3,3,0,1,0
15,129,129,4,4,0,1,0
11,136,136,2,2,0,1,0
14,153,153,33,33,0,1,0
9,156,156,7,4,3,2,1
7,161,161,6,3,3,2,1
17,164,164,15,15,0,1,0
8,192,192,10,4,6,3,2
6,196,196,6,6,0,1,0
1,201,201,40,1,39,4,3
16,202,202,40,40,0,1,0
18,226,226,25,25,0,1,0
12,321,321,38,14,24,3,2
19,330,330,41,41,0,1,0
3,350,350,5,5,0,1,0
5,370,370,84,46,38,3,2
10,421,421,16,16,0,1,0
4,476,476,19,19,0,1,0
0,477,477,67,67,0,1,0
2,482,482,38,15,23,3,2

0,161,161,1,1,0,1,0
9,174,174,36,36,0,1,0
18,197,197,89,67,22,2,1
16,222,222,6,2,4,2,1
7,234,234,2,2,0,1,0
4,244,244,26,8,18,3,2
10,244,244,23,11,12,4,3
13,252,252,2,2,0,1,0
12,253,253,2,2,0,1,0
19,284,284,37,1,36,4,3
5,299,299,7,7,0,1,0
14,316,316,39,39,0,1,0
17,340,340,7,1,6,3,2
3,355,355,5,5,0,1,0
6,369,369,20,20,0,1,0
8,394,394,39,9,30,4,3
1,463,463,78,78,0,1,0
15,464,464,46,46,0,1,0
2,484,484,58,26,32,3,2
11,488,488,22,22,0,1,0

17,100,100,5,2,3,2,1
7,110,110,1,1,0,1,0
1,136,136,21,21,0,1,0
5,169,169,1,1,0,1,0
9,183,183,41,41,0,1,0
4,201,201,12,7,5,2,1
15,280,280,44,13,31,4,3
13,292,292,19,19,0,1,0
14,296,296,24,24,0,1,0
8,298,298,31,13,18,4,3
16,316,316,8,8,0,1,0
18,319,319,36,4,32,2,1
6,336,336,20,20,0,1,0
3,378,378,40,40,0,1,0
10,384,384,13,13,0,1,0
12,400,400,77,13,64,3,2
2,442,442,52,8,44,2,1
11,493,493,96,96,0,1,0
0,496,496,30,21,9,4,3

11,142,142,24,10,14,4,3
6,151,151,18,4,14,2,1
15,162,162,2,2,0,1,0
7,210,210,5,5,0,1,0
9,252,252,11,11,0,1,0
14,253,253,39,39,0,1,0
2,268,268,29,26,3,2,1
3,290,290,115,13,102,4,3
4,351,351,14,14,0,1,0
5,367,367,43,43,0,1,0
8,429,429,3,3,0,1,0
13,434,434,75,57,18,4,3
12,461,461,125,125,0,1,0
0,464,464,27,27,0,1,0
10,469,469,28,12,16,3,2
1,489,489,32,32,0,1,0

11,116,116,2,2,0,1,0
15,127,127,11,2,9,3,2
7,133,133,2,2,0,1,0
8,138,138,1,1,0,1,0
6,145,145,10,10,0,1,0
20,165,165,7,7,0,1,0
5,178,178,25,15,10,3,2
14,206,206,13,13,0,1,0
2,238,238,22,22,0,1,0
1,259,259,18,18,0,1,0
16,275,275,39,39,0,1,0
17,299,299,32,24,8,2,1
18,329,329,11,11,0,1,0
0,332,332,20,20,0,1,0
12,335,335,93,93,0,1,0
13,356,356,57,23,34,2,1
3,374,374,13,13,0,1,0
19,384,384,2,2,0,1,0
10,394,394,78,44,34,3,2
9,464,464,16,16,0,1,0
4,469,469,76,76,0,1,0

6,135,135,54,13,41,2,1
15,147,147,17,5,12,2,1
13,178,178,2,2,0,1,0
8,200,200,55,55,0,1,0
2,296,296,48,2,46,2,1
7,308,308,37,9,28,2,1
4,312,312,1,1,0,1,0
10,314,314,7,7,0,1,0
5,346,346,63,63,0,1,0
3,369,369,37,37,0,1,0
14,408,408,86,86,0,1,0
0,421,421,1,1,0,1,0
11,427,427,6,6,0,1,0
1,457,457,24,24,0,1,0
12,466,466,40,40,0,1,0
9,491,491,29,29,0,1,0

1,110,110,7,1,6,3,2
3,122,122,46,7,39,2,1
17,153,153,6,6,0,1,0
18,175,175,10,1,9,2,1
12,182,182,22,22,0,1,0
9,209,209,19,9,10,3,2
14,216,216,22,22,0,1,0
8,218,218,3,3,0,1,0
6,222,222,8,2,6,2,1
15,234,234,63,63,0,1,0
5,249,249,11,2,9,4,3
2,255,255,10,10,0,1,0
13,281,281,5,5,0,1,0
4,304,304,31,31,0,1,0
16,362,362,16,10,6,2,1
7,369,369,13,13,0,1,0
0,388,388,39,39,0,1,0
10,460,460,48,15,33,2,1
11,484,484,80,46,34,2,1

11,100,100,12,12,0,1,0
15,108,108,5,5,0,1,0
10,203,203,15,15,0,1,0
13,206,206,14,7,7,2,1
2,252,252,1,1,0,1,0
5,271,271,18,4,14,3,2
6,308,308,38,24,14,2,1
17,326,326,33,33,0,1,0
12,331,331,55,50,5,2,1
3,334,334,74,74,0,1,0
1,369,369,23,7,16,4,3
14,392,392,44,1,43,2,1
9,406,406,84,84,0,1,0
0,412,412,5,1,4,2,1
4,442,442,125,86,39,4,3
16,467,467,14,14,0,1,0
8,476,476,57,9,48,3,2
7,489,489,4,1,3,2,1

7,104,104,23,5,18,4,3
16,122,122,3,3,0,1,0
19,122,122,28,12,16,3,2
17,141,141,24,24,0,1,0
14,146,146,33,33,0,1,0
0,157,157,3,3,0,1,0
15,169,169,5,5,0,1,0
3,190,190,25,25,0,1,0
2,190,190,3,3,0,1,0
4,221,221,1,1,0,1,0
9,232,232,12,4,8,3,2
1,234,234,45,45,0,1,0
13,250,250,36,36,0,1,0
5,265,265,2,2,0,1,0
10,291,291,7,7,0,1,0
18,312,312,6,6,0,1,0
12,328,328,17,7,10,3,2
11,349,349,1,1,0,1,0
8,381,381,13,9,4,2,1
6,397,397,1,1,0,1,0
21,418,418,56,4,52,3,2
22,467,467,45,45,0,1,0
20,499,499,1,1,0,1,0

13,104,104,7,7,0,1,0
1,109,109,1,1,0,1,0
14,123,123,40,40,0,1,0
8,179,179,37,5,32,2,1
0,186,186,27,27,0,1,0
3,259,259,13,13,0,1,0
9,270,270,4,1,3,2,1
5,271,271,33,33,0,1,0
4,289,289,45,45,0,1,0
10,303,303,92,59,33,2,1
7,330,330,3,3,0,1,0
12,331,331,6,6,0,1,0
6,337,337,30,30,0,1,0
11,379,379,15,15,0,1,0
16,412,412,22,13,9,4,3
17,435,435,8,8,0,1,0
15,457,457,33,4,29,3,2
2,486,486,56,18,38,2,1

5,110,110,53,21,32,3,2
13,121,121,5,5,0,1,0
2,190,190,18,8,10,3,2
7,221,221,16,10,6,3,2
14,273,273,24,24,0,1,0
9,316,316,20,11,9,2,1
11,316,316,37,15,22,3,2
1,323,323,47,47,0,1,0
6,325,325,40,4,36,4,3
4,366,366,18,18,0,1,0
10,421,421,142,62,80,4,3
3,439,439,33,24,9,2,1
8,439,439,7,7,0,1,0
12,463,463,28,28,0,1,0
0,489,489,27,10,17,2,1

17,101,101,9,9,0,1,0
9,106,106,15,15,0,1,0
0,144,144,11,11,0,1,0
6,175,175,25,1,24,4,3
8,247,247,3,3,0,1,0
16,254,254,21,13,8,3,2
15,269,269,30,10,20,4,3
11,300,300,61,61,0,1,0
5,337,337,27,27,0,1,0
12,340,340,4,4,0,1,0
7,355,355,50,50,0,1,0
1,360,360,4,4,0,1,0
2,370,370,9,5,4,2,1
4,374,374,79,79,0,1,0
10,397,397,114,87,27,4,3
13,434,434,10,2,8,3,2
3,448,448,29,1,28,3,2
14,469,469,28,14,14,2,1
18,469,469,26,17,9,4,3

3,113,113,28,28,0,1,0
11,179,179,6,6,0,1,0
4,181,181,23,9,14,2,1
14,193,193,41,41,0,1,0
10,237,237,67,67,0,1,0
5,262,262,10,2,8,2,1
8,284,284,3,3,0,1,0
16,332,332,17,17,0,1,0
17,359,359,46,46,0,1,0
9,378,378,43,39,4,2,1
1,397,397,6,3,3,2,1
12,402,402,21,21,0,1,0
0,419,419,22,22,0,1,0
2,421,421,74,74,0,1,0
13,426,426,3,3,0,1,0
6,443,443,44,5,39,2,1
7,467,467,64,64,0,1,0
15,497,497,17,8,9,2,1

16,165,165,44,44,0,1,0
14,198,198,13,13,0,1,0
3,203,203,12,12,0,1,0
13,216,216,9,9,0,1,0
17,239,239,9,9,0,1,0
18,252,252,36,36,0,1,0
15,287,287,2,2,0,1,0
11,319,319,17,4,13,2,1
10,320,320,20,6,14,2,1
7,323,323,3,3,0,1,0
12,348,348,28,10,18,3,2
2,372,372,57,31,26,3,2
19,396,396,87,46,41,2,1
6,397,397,9,9,0,1,0
1,453,453,70,70,0,1,0
5,454,454,34,21,13,2,1
8,474,474,24,4,20,3,2
4,481,481,14,2,12,3,2
0,481,481,106,27,79,4,3
9,485,485,31,31,0,1,0

9,126,126,21,21,0,1,0
17,130,130,11,11,0,1,0
15,163,163,8,8,0,1,0
1,205,205,10,10,0,1,0
11,216,216,5,2,3,2,1
0,218,218,58,58,0,1,0
16,226,226,18,18,0,1,0
7,268,268,12,12,0,1,0
6,272,272,39,9,30,3,2
13,278,278,59,39,20,2,1
10,300,300,43,23,20,2,1
14,300,300,6,6,0,1,0
3,310,310,64,64,0,1,0
12,348,348,50,18,32,2,1
2,373,373,7,3,4,2,1
8,378,378,30,2,28,2,1
4,383,383,3,3,0,1,0
5,420,420,36,36,0,1,0

2,125,125,12,12,0,1,0
0,141,141,9,9,0,1,0
6,147,147,26,26,0,1,0
15,154,154,25,25,0,1,0
4,157,157,17,2,15,3,2
5,202,202,4,1,3,2,1
3,225,225,15,15,0,1,0
12,227,227,64,64,0,1,0
7,242,242,77,15,62,3,2
8,269,269,8,8,0,1,0
1,310,310,16,16,0,1,0
11,339,339,39,39,0,1,0
9,406,406,28,28,0,1,0
14,424,424,9,9,0,1,0
13,452,452,52,25,27,4,3
16,464,464,47,47,0,1,0
10,488,488,7,7,0,1,0

14,107,107,15,15,0,1,0
9,141,141,1,1,0,1,0
1,166,166,12,12,0,1,0
21,193,193,11,11,0,1,0
18,193,193,8,2,6,3,2
19,216,216,3,3,0,1,0
10,222,222,48,34,14,3,2
17,241,241,31,4,27,4,3
5,243,243,41,23,18,4,3
16,252,252,80,68,12,3,2
4,274,274,57,23,34,3,2
13,385,385,8,8,0,1,0
20,404,404,38,24,14,2,1
8,411,411,5,5,0,1,0
11,417,417,4,1,3,2,1
3,429,429,15,15,0,1,0
15,436,436,49,19,30,4,3
12,439,439,5,5,0,1,0
0,468,468,16,1,15,4,3
7,469,469,10,10,0,1,0
2,474,474,10,10,0,1,0
6,476,476,40,1,39,4,3

15,112,112,13,13,0,1,0
1,139,139,42,42,0,1,0
4,143,143,5,5,0,1,0
16,158,158,4,4,0,1,0
8,187,187,4,4,0,1,0
13,198,198,4,4,0,1,0
6,205,205,11,11,0,1,0
9,231,231,39,39,0,1,0
17,252,252,53,36,17,2,1
14,268,268,54,30,24,4,3
7,357,357,3,3,0,1,0
10,362,362,10,10,0,1,0
3,374,374,87,87,0,1,0
0,382,382,28,28,0,1,0
11,394,394,57,57,0,1,0
2,437,437,1,1,0,1,0
12,437,437,4,4,0,1,0
5,455,455,79,45,34,3,2

0,120,120,1,1,0,1,0
12,156,156,14,14,0,1,0
11,182,182,13,13,0,1,0
10,184,184,11,11,0,1,0
9,209,209,31,31,0,1,0
13,236,236,49,49,0,1,0
8,257,257,21,21,0,1,0
7,265,265,55,55,0,1,0
5,278,278,16,16,0,1,0
14,278,278,7,7,0,1,0
3,310,310,19,19,0,1,0
2,319,319,21,3,18,3,2
15,325,325,13,4,9,2,1
4,407,407,85,66,19,2,1
6,430,430,165,119,46,3,2
1,488,488,56,28,28,3,2

19,113,113,7,3,4,2,1
9,138,138,28,28,0,1,0
11,141,141,14,6,8,2,1
3,147,147,3,3,0,1,0
14,151,151,44,44,0,1,0
6,165,165,5,2,3,2,1
16,170,170,13,13,0,1,0
18,176,176,13,7,6,2,1
5,196,196,1,1,0,1,0
17,261,261,37,37,0,1,0
2,272,272,38,15,23,2,1
13,296,296,31,31,0,1,0
8,303,303,36,36,0,1,0
0,338,338,8,8,0,1,0
12,362,362,17,17,0,1,0
4,381,381,10,4,6,3,2
1,387,387,53,53,0,1,0
15,392,392,8,8,0,1,0
10,397,397,39,8,31,2,1
7,486,486,48,28,20,3,2

5,116,116,26,10,16,2,1
10,129,129,3,3,0,1,0
0,187,187,1,1,0,1,0
15,218,218,2,2,0,1,0
13,219,219,10,10,0,1,0
2,240,240,36,14,22,2,1
3,251,251,12,12,0,1,0
8,346,346,56,11,45,2,1
12,361,361,22,22,0,1,0
11,367,367,59,59,0,1,0
14,370,370,10,7,3,2,1
1,436,436,56,18,38,2,1
6,445,445,145,98,47,3,2
4,467,467,9,9,0,1,0
9,469,469,146,4,142,4,3
7,492,492,61,1,60,4,3

1,104,104,3,3,0,1,0
10,127,127,11,3,8,3,2
8,139,139,15,6,9,4,3
2,161,161,10,4,6,2,1
19,174,174,45,45,0,1,0
15,206,206,52,20,32,3,2
6,221,221,4,1,3,2,1
14,280,280,9,3,6,2,1
13,316,316,43,19,24,2,1
17,318,318,6,2,4,2,1
0,334,334,22,8,14,3,2
7,355,355,16,16,0,1,0
3,359,359,4,1,3,2,1
18,369,369,17,7,10,3,2
11,386,386,10,2,8,2,1
12,395,395,78,14,64,3,2
21,420,420,14,14,0,1,0
5,427,427,50,6,44,3,2
9,430,430,19,7,12,4,3
20,444,444,26,26,0,1,0
4,465,465,42,42,0,1,0
16,496,496,41,41,0,1,0

15,106,106,6,6,0,1,0
16,107,107,3,3,0,1,0
6,112,112,1,1,0,1,0
9,137,137,24,24,0,1,0
8,220,220,2,2,0,1,0
14,241,241,9,9,0,1,0
5,247,247,25,25,0,1,0
10,250,250,53,53,0,1,0
7,272,272,5,5,0,1,0
19,332,332,43,43,0,1,0
13,335,335,30,2,28,3,2
4,352,352,30,21,9,4,3
20,365,365,60,60,0,1,0
0,369,369,47,47,0,1,0
12,392,392,16,16,0,1,0
1,398,398,1,1,0,1,0
3,401,401,11,1,10,3,2
18,413,413,38,38,0,1,0
11,447,447,57,57,0,1,0
17,456,456,130,37,93,4,3
2,485,485,3,3,0,1,0

8,100,100,4,1,3,2,1
6,113,113,13,3,10,2,1
18,126,126,20,20,0,1,0
5,136,136,7,4,3,2,1
9,159,159,29,29,0,1,0
16,166,166,30,30,0,1,0
0,223,223,8,8,0,1,0
15,235,235,17,17,0,1,0
4,242,242,15,15,0,1,0
12,244,244,6,6,0,1,0
14,313,313,12,2,10,3,2
2,333,333,5,5,0,1,0
10,366,366,36,36,0,1,0
19,381,381,16,1,15,4,3
1,392,392,28,1,27,4,3
3,447,447,102,39,63,4,3
11,480,480,64,15,49,4,3
17,482,482,129,83,46,2,1
13,487,487,1,1,0,1,0
7,490,490,1,1,0,1,0

14,111,111,2,2,0,1,0
2,111,111,13,13,0,1,0
21,113,113,5,5,0,1,0
6,145,145,20,20,0,1,0
4,148,148,1,1,0,1,0
1,158,158,6,6,0,1,0
12,179,179,18,14,4,2,1
13,183,183,2,2,0,1,0
9,213,213,67,33,34,2,1
20,226,226,35,1,34,3,2
11,231,231,1,1,0,1,0
16,236,236,3,3,0,1,0
3,248,248,5,5,0,1,0
15,251,251,64,34,30,2,1
19,263,263,22,22,0,1,0
18,268,268,34,34,0,1,0
5,301,301,4,4,0,1,0
7,377,377,16,8,8,3,2
8,380,380,29,29,0,1,0
10,440,440,1,1,0,1,0
0,474,474,15,15,0,1,0
17,485,485,109,109,0,1,0

3,120,120,11,2,9,4,3
20,126,126,42,42,0,1,0
0,142,142,25,8,17,2,1
5,172,172,20,15,5,2,1
7,174,174,24,5,19,2,1
8,193,193,6,6,0,1,0
2,225,225,1,1,0,1,0
12,239,239,17,7,10,2,1
16,301,301,15,15,0,1,0
1,312,312,2,2,0,1,0
15,330,330,25,25,0,1,0
4,342,342,4,4,0,1,0
14,362,362,86,50,36,2,1
18,372,372,20,20,0,1,0
11,391,391,16,16,0,1,0
21,421,421,32,32,0,1,0
17,423,423,24,7,17,2,1
6,443,443,47,4,43,2,1
19,445,445,2,2,0,1,0
10,452,452,19,1,18,3,2
9,465,465,30,1,29,4,3
13,494,494,14,4,10,2,1

5,122,122,4,1,3,2,1
21,139,139,13,10,3,2,1
8,187,187,15,15,0,1,0
16,210,210,19,19,0,1,0
20,233,233,9,6,3,2,1
15,275,275,33,33,0,1,0
19,299,299,23,5,18,2,1
22,310,310,18,2,16,3,2
12,310,310,18,2,16,2,1
2,318,318,57,33,24,2,1
1,340,340,12,12,0,1,0
4,343,343,13,7,6,2,1
14,344,344,59,27,32,3,2
10,362,362,12,12,0,1,0
18,365,365,81,57,24,2,1
0,372,372,4,4,0,1,0
3,388,388,16,16,0,1,0
7,410,410,85,85,0,1,0
9,434,434,27,27,0,1,0
6,462,462,12,12,0,1,0
13,471,471,40,12,28,2,1
11,478,478,6,6,0,1,0
17,497,497,23,2,21,2,1

3,104,104,28,28,0,1,0
14,138,138,35,35,0,1,0
9,234,234,16,10,6,2,1
10,255,255,12,12,0,1,0
1,271,271,36,36,0,1,0
13,293,293,8,8,0,1,0
8,298,298,83,40,43,2,1
7,326,326,14,14,0,1,0
6,423,423,5,5,0,1,0
2,437,437,10,5,5,2,1
0,455,455,135,135,0,1,0
5,466,466,37,9,28,3,2
4,475,475,47,8,39,4,3
12,486,486,13,13,0,1,0
11,489,489,80,64,16,4,3

3,113,113,18,18,0,1,0
5,148,148,36,36,0,1,0
9,186,186,10,10,0,1,0
10,198,198,22,4,18,3,2
15,210,210,1,1,0,1,0
11,220,220,17,17,0,1,0
1,278,278,38,11,27,4,3
7,302,302,37,9,28,3,2
4,304,304,10,1,9,4,3
18,334,334,49,41,8,2,1
6,369,369,13,13,0,1,0
13,371,371,35,35,0,1,0
17,416,416,131,68,63,4,3
0,419,419,14,14,0,1,0
2,434,434,28,28,0,1,0
14,440,440,13,3,10,2,1
16,442,442,45,45,0,1,0
8,490,490,11,11,0,1,0
12,490,490,17,9,8,2,1

10,126,126,5,5,0,1,0
3,128,128,4,4,0,1,0
8,158,158,9,9,0,1,0
13,159,159,49,49,0,1,0
15,167,167,3,3,0,1,0
2,203,203,84,45,39,3,2
7,211,211,5,5,0,1,0
0,226,226,31,25,6,2,1
6,243,243,1,1,0,1,0
11,286,286,34,6,28,3,2
1,291,291,4,4,0,1,0
9,298,298,35,20,15,2,1
5,329,329,28,28,0,1,0
4,394,394,54,40,14,3,2
17,420,420,20,20,0,1,0
16,450,450,9,9,0,1,0
12,480,480,26,4,22,2,1
14,492,492,96,20,76,4,3

4,104,104,9,1,8,2,1
0,126,126,47,47,0,1,0
1,182,182,23,23,0,1,0
15,188,188,13,5,8,3,2
6,194,194,1,1,0,1,0
3,210,210,8,8,0,1,0
7,223,223,8,1,7,2,1
8,227,227,25,25,0,1,0
12,262,262,3,3,0,1,0
11,275,275,2,2,0,1,0
14,310,310,35,17,18,2,1
5,311,311,14,14,0,1,0
9,323,323,53,20,33,4,3
13,382,382,91,83,8,3,2
17,396,396,7,7,0,1,0
10,404,404,5,5,0,1,0
2,439,439,36,36,0,1,0
16,494,494,140,68,72,4,3

12,125,125,28,17,11,2,1
4,170,170,1,1,0,1,0
17,173,173,8,3,5,2,1
0,199,199,57,57,0,1,0
2,215,215,15,6,9,2,1
16,218,218,12,12,0,1,0
8,220,220,12,12,0,1,0
11,220,220,22,1,21,4,3
1,263,263,11,11,0,1,0
6,274,274,14,4,10,2,1
5,297,297,28,28,0,1,0
9,313,313,38,38,0,1,0
18,327,327,39,27,12,4,3
3,351,351,50,12,38,2,1
15,421,421,5,5,0,1,0
14,451,451,68,24,44,4,3
7,451,451,16,2,14,3,2
10,487,487,62,26,36,4,3
13,489,489,43,15,28,2,1

1,105,105,13,13,0,1,0
10,128,128,9,9,0,1,0
17,134,134,7,7,0,1,0
16,152,152,84,6,78,4,3
13,152,152,12,3,9,2,1
15,172,172,3,3,0,1,0
5,183,183,4,4,0,1,0
3,208,208,29,29,0,1,0
11,225,225,6,1,5,2,1
2,268,268,21,15,6,2,1
9,314,314,6,6,0,1,0
12,325,325,25,25,0,1,0
4,351,351,46,22,24,3,2
8,370,370,11,11,0,1,0
0,449,449,66,5,61,4,3
14,461,461,17,8,9,4,3
6,484,484,46,19,27,2,1
7,499,499,68,29,39,4,3

11,120,120,29,29,0,1,0
6,142,142,4,4,0,1,0
8,159,159,16,13,3,2,1
7,163,163,28,3,25,2,1
12,176,176,2,2,0,1,0
1,196,196,18,18,0,1,0
13,204,204,39,22,17,2,1
4,207,207,3,3,0,1,0
9,239,239,17,17,0,1,0
10,251,251,20,20,0,1,0
14,255,255,4,4,0,1,0
2,298,298,32,4,28,3,2
15,380,380,12,12,0,1,0
0,415,415,88,88,0,1,0
3,445,445,61,61,0,1,0
5,457,457,142,84,58,4,3

14,112,112,6,6,0,1,0
9,130,130,1,1,0,1,0
12,143,143,9,3,6,2,1
10,162,162,12,7,5,2,1
2,202,202,20,20,0,1,0
15,241,241,61,19,42,3,2
13,245,245,25,1,24,4,3
1,253,253,6,6,0,1,0
6,279,279,71,16,55,4,3
4,311,311,55,55,0,1,0
17,324,324,3,3,0,1,0
18,334,334,15,15,0,1,0
3,339,339,58,58,0,1,0
5,363,363,18,18,0,1,0
11,442,442,15,7,8,2,1
0,453,453,1,1,0,1,0
7,474,474,44,26,18,3,2
16,484,484,140,53,87,4,3
8,500,500,14,1,13,2,1

11,116,116,8,8,0,1,0
10,129,129,29,29,0,1,0
12,138,138,28,28,0,1,0
6,140,140,10,10,0,1,0
8,187,187,9,2,7,2,1
9,196,196,28,18,10,2,1
7,247,247,9,1,8,2,1
4,355,355,8,8,0,1,0
1,363,363,152,61,91,4,3
0,376,376,74,61,13,2,1
2,376,376,79,75,4,2,1
5,380,380,50,50,0,1,0
13,440,440,1,1,0,1,0
3,490,490,26,26,0,1,0

7,100,100,2,2,0,1,0
4,110,110,23,2,21,2,1
13,137,137,64,14,50,3,2
17,139,139,3,3,0,1,0
6,152,152,9,9,0,1,0
3,163,163,1,1,0,1,0
11,199,199,11,11,0,1,0
8,207,207,34,26,8,2,1
5,211,211,28,28,0,1,0
0,257,257,20,20,0,1,0
9,329,329,44,14,30,4,3
18,330,330,6,6,0,1,0
1,382,382,15,9,6,2,1
14,406,406,7,7,0,1,0
2,412,412,24,9,15,4,3
12,446,446,28,28,0,1,0
16,457,457,65,65,0,1,0
15,476,476,23,23,0,1,0
10,487,487,43,43,0,1,0

18,106,106,3,3,0,1,0
1,119,119,5,5,0,1,0
5,126,126,1,1,0,1,0
13,156,156,1,1,0,1,0
8,157,157,1,1,0,1,0
6,160,160,11,11,0,1,0
7,169,169,1,1,0,1,0
20,185,185,15,6,9,2,1
11,197,197,9,9,0,1,0
19,226,226,65,14,51,4,3
9,291,291,13,13,0,1,0
0,293,293,23,2,21,2,1
12,297,297,38,38,0,1,0
23,311,311,18,18,0,1,0
16,328,328,17,17,0,1,0
4,333,333,42,42,0,1,0
10,353,353,5,5,0,1,0
17,373,373,19,19,0,1,0
14,394,394,39,39,0,1,0
15,413,413,49,49,0,1,0
3,437,437,60,14,46,3,2
2,446,446,40,2,38,4,3
21,455,455,101,41,60,3,2
22,494,494,10,10,0,1,0

7,122,122,21,6,15,2,1
11,175,175,26,17,9,2,1
2,196,196,14,14,0,1,0
13,197,197,19,19,0,1,0
15,222,222,30,30,0,1,0
6,246,246,4,1,3,2,1
10,279,279,46,36,10,3,2
5,320,320,67,10,57,4,3
9,321,321,4,4,0,1,0
4,409,409,1,1,0,1,0
3,411,411,5,5,0,1,0
0,418,418,102,83,19,2,1
14,443,443,2,2,0,1,0
12,463,463,8,5,3,2,1
1,492,492,85,44,41,2,1
8,493,493,65,65,0,1,0
16,497,497,104,40,64,4,3

3,136,136,3,3,0,1,0
15,166,166,3,3,0,1,0
18,182,182,3,3,0,1,0
9,205,205,2,2,0,1,0
14,210,210,20,5,15,2,1
13,225,225,29,2,27,2,1
16,244,244,19,19,0,1,0
10,279,279,26,7,19,2,1
2,287,287,9,1,8,2,1
12,305,305,45,45,0,1,0
6,321,321,25,1,24,3,2
7,325,325,7,7,0,1,0
17,355,355,41,41,0,1,0
0,367,367,42,32,10,3,2
19,375,375,61,4,57,4,3
4,375,375,51,51,0,1,0
8,380,380,77,77,0,1,0
11,399,399,63,63,0,1,0
1,453,453,6,6,0,1,0
5,471,471,84,27,57,4,3

0,109,109,1,1,0,1,0
10,129,129,12,6,6,3,2
12,150,150,34,22,12,3,2
11,221,221,2,2,0,1,0
7,246,246,35,2,33,4,3
8,250,250,15,6,9,4,3
2,253,253,30,30,0,1,0
4,272,272,63,28,35,2,1
14,279,279,108,84,24,3,2
13,323,323,3,3,0,1,0
18,366,366,21,4,17,2,1
5,368,368,1,1,0,1,0
9,428,428,15,15,0,1,0
1,439,439,60,8,52,3,2
6,449,449,52,52,0,1,0
17,461,461,1,1,0,1,0
3,466,466,23,7,16,2,1
16,485,485,49,49,0,1,0
15,494,494,16,8,8,3,2

10,104,104,12,12,0,1,0
15,124,124,11,11,0,1,0
14,186,186,16,7,9,2,1
13,219,219,19,19,0,1,0
11,241,241,18,18,0,1,0
8,251,251,17,17,0,1,0
3,256,256,44,44,0,1,0
5,257,257,48,48,0,1,0
17,260,260,4,4,0,1,0
0,275,275,20,20,0,1,0
2,289,289,40,27,13,2,1
9,295,295,9,2,7,2,1
16,334,334,9,9,0,1,0
4,349,349,10,10,0,1,0
1,353,353,1,1,0,1,0
6,376,376,49,49,0,1,0
7,382,382,28,28,0,1,0
12,425,425,23,23,0,1,0
18,497,497,185,145,40,2,1

12,107,107,6,6,0,1,0
1,112,112,50,16,34,3,2
7,125,125,30,30,0,1,0
18,142,142,37,33,4,2,1
5,146,146,3,3,0,1,0
2,148,148,1,1,0,1,0
8,166,166,4,1,3,2,1
11,203,203,12,12,0,1,0
6,217,217,14,14,0,1,0
17,222,222,38,38,0,1,0
16,229,229,21,21,0,1,0
0,242,242,1,1,0,1,0
9,280,280,9,5,4,2,1
4,302,302,9,9,0,1,0
14,338,338,9,9,0,1,0
15,343,343,35,2,33,4,3
10,431,431,33,21,12,4,3
3,440,440,14,11,3,2,1
13,465,465,36,36,0,1,0

13,110,110,10,10,0,1,0
16,119,119,6,1,5,2,1
5,180,180,14,10,4,2,1
1,182,182,11,11,0,1,0
4,190,190,1,1,0,1,0
0,202,202,13,13,0,1,0
6,245,245,45,45,0,1,0
17,246,246,16,2,14,3,2
18,247,247,72,72,0,1,0
3,257,257,87,55,32,3,2
11,322,322,23,23,0,1,0
7,326,326,2,2,0,1,0
2,330,330,18,11,7,2,1
19,371,371,21,1,20,3,2
14,373,373,47,17,30,4,3
12,397,397,8,5,3,2,1
10,436,436,8,8,0,1,0
8,448,448,29,29,0,1,0
9,472,472,13,7,6,3,2
15,476,476,70,70,0,1,0

10,123,123,5,5,0,1,0
8,139,139,40,12,28,3,2
12,179,179,1,1,0,1,0
2,196,196,17,14,3,2,1
0,201,201,34,30,4,2,1
6,240,240,43,43,0,1,0
3,305,305,10,3,7,2,1
1,380,380,233,193,40,4,3
4,386,386,2,2,0,1,0
5,429,429,9,9,0,1,0
11,490,490,83,25,58,3,2
7,499,499,98,1,97,4,3
9,499,499,5,5,0,1,0

4,109,109,45,19,26,3,2
0,115,115,1,1,0,1,0
16,116,116,8,4,4,2,1
2,134,134,18,12,6,2,1
3,142,142,18,15,3,2,1
10,162,162,25,13,12,2,1
11,187,187,2,2,0,1,0
5,192,192,15,2,13,2,1
17,246,246,4,4,0,1,0
18,313,313,97,71,26,2,1
7,322,322,16,1,15,4,3
15,343,343,5,5,0,1,0
1,350,350,14,2,12,3,2
14,352,352,30,17,13,3,2
12,408,408,52,52,0,1,0
13,423,423,57,57,0,1,0
9,430,430,11,4,7,3,2
8,486,486,4,4,0,1,0
6,489,489,8,1,7,2,1

15,104,104,1,1,0,1,0
10,114,114,10,10,0,1,0
6,132,132,1,1,0,1,0
17,153,153,24,24,0,1,0
19,174,174,37,37,0,1,0
16,189,189,3,3,0,1,0
4,213,213,4,4,0,1,0
11,242,242,45,45,0,1,0
14,276,276,29,15,14,2,1
8,283,283,42,16,26,2,1
5,288,288,22,2,20,2,1
13,294,294,94,36,58,3,2
0,303,303,17,17,0,1,0
20,312,312,10,10,0,1,0
18,319,319,15,15,0,1,0
3,346,346,17,17,0,1,0
2,352,352,31,31,0,1,0
9,429,429,3,3,0,1,0
7,451,451,9,9,0,1,0
12,466,466,10,4,6,2,1
1,494,494,78,78,0,1,0

7,101,101,2,2,0,1,0
10,113,113,21,21,0,1,0
8,188,188,31,31,0,1,0
11,191,191,25,25,0,1,0
15,191,191,27,13,14,3,2
3,236,236,34,34,0,1,0
4,247,247,25,19,6,2,1
5,256,256,37,1,36,4,3
14,258,258,15,15,0,1,0
2,278,278,20,4,16,2,1
13,354,354,3,3,0,1,0
12,368,368,30,3,27,4,3
0,384,384,36,36,0,1,0
1,396,396,46,46,0,1,0
6,440,440,101,45,56,4,3
9,497,497,64,31,33,4,3

13,114,114,19,6,13,2,1
10,123,123,7,7,0,1,0
3,160,160,12,1,11,2,1
16,176,176,6,6,0,1,0
17,183,183,12,12,0,1,0
9,208,208,27,23,4,2,1
8,212,212,6,1,5,2,1
5,212,212,7,3,4,2,1
12,259,259,62,6,56,3,2
0,270,270,25,16,9,4,3
1,271,271,49,17,32,3,2
14,307,307,47,17,30,3,2
7,309,309,66,66,0,1,0
15,371,371,7,7,0,1,0
2,377,377,36,36,0,1,0
6,382,382,41,23,18,2,1
11,390,390,21,1,20,4,3
4,468,468,36,17,19,2,1

11,104,104,2,2,0,1,0
13,124,124,1,1,0,1,0
1,156,156,12,2,10,2,1
22,164,164,10,4,6,2,1
5,191,191,5,2,3,2,1
8,220,220,1,1,0,1,0
18,229,229,22,22,0,1,0
19,250,250,20,20,0,1,0
21,251,251,53,53,0,1,0
15,260,260,19,19,0,1,0
2,284,284,14,4,10,2,1
12,286,286,17,6,11,2,1
7,321,321,7,1,6,3,2
23,323,323,44,3,41,2,1
3,342,342,20,20,0,1,0
9,370,370,1,1,0,1,0
4,376,376,61,61,0,1,0
20,385,385,33,33,0,1,0
24,394,394,3,3,0,1,0
25,405,405,71,27,44,2,1
17,427,427,28,28,0,1,0
0,446,446,11,2,9,4,3
6,463,463,13,13,0,1,0
10,469,469,19,11,8,3,2
16,476,476,89,89,0,1,0
14,492,492,29,29,0,1,0

5,122,122,3,3,0,1,0
9,125,125,5,5,0,1,0
2,128,128,14,5,9,2,1
7,139,139,2,2,0,1,0
13,142,142,26,17,9,4,3
3,150,150,32,32,0,1,0
1,233,233,6,3,3,2,1
17,243,243,36,32,4,2,1
8,246,246,20,20,0,1,0
14,265,265,1,1,0,1,0
10,283,283,26,26,0,1,0
11,372,372,137,83,54,4,3
12,375,375,5,2,3,2,1
6,379,379,64,37,27,4,3
4,395,395,22,22,0,1,0
16,423,423,2,2,0,1,0
15,448,448,29,21,8,2,1
0,494,494,103,103,0,1,0

9,100,100,1,1,0,1,0
0,162,162,6,2,4,2,1
6,170,170,4,4,0,1,0
7,198,198,2,2,0,1,0
5,211,211,36,36,0,1,0
15,254,254,81,69,12,4,3
14,272,272,3,3,0,1,0
8,317,317,30,17,13,2,1
10,349,349,9,2,7,2,1
3,354,354,179,139,40,3,2
11,374,374,22,22,0,1,0
2,395,395,40,40,0,1,0
13,413,413,14,5,9,2,1
12,465,465,168,108,60,4,3
1,471,471,20,20,0,1,0
4,484,484,11,2,9,4,3

0,105,105,4,1,3,2,1
10,183,183,30,12,18,4,3
13,192,192,73,73,0,1,0
7,199,199,42,9,33,4,3
17,220,220,19,4,15,2,1
2,258,258,7,7,0,1,0
12,266,266,7,7,0,1,0
5,281,281,3,3,0,1,0
15,288,288,4,4,0,1,0
4,315,315,24,24,0,1,0
3,317,317,104,104,0,1,0
9,376,376,10,2,8,3,2
8,392,392,19,9,10,3,2
18,394,394,44,44,0,1,0
11,424,424,27,5,22,2,1
6,427,427,52,46,6,3,2
1,452,452,6,1,5,2,1
16,474,474,15,11,4,2,1
14,478,478,19,19,0,1,0

22,108,108,7,7,0,1,0
24,125,125,24,24,0,1,0
11,127,127,1,1,0,1,0
16,135,135,4,4,0,1,0
23,139,139,40,3,37,4,3
3,148,148,5,5,0,1,0
2,167,167,15,11,4,2,1
25,196,196,24,24,0,1,0
7,196,196,2,2,0,1,0
13,197,197,3,3,0,1,0
0,249,249,8,2,6,2,1
17,261,261,7,7,0,1,0
1,292,292,24,1,23,2,1
19,322,322,10,2,8,3,2
18,334,334,55,55,0,1,0
5,362,362,38,38,0,1,0
12,370,370,47,47,0,1,0
10,373,373,13,5,8,3,2
9,383,383,28,5,23,2,1
15,422,422,27,7,20,3,2
20,445,445,13,13,0,1,0
6,448,448,27,1,26,2,1
14,449,449,2,2,0,1,0
8,485,485,47,47,0,1,0
4,485,485,18,3,15,2,1
21,498,498,2,2,0,1,0

12,104,104,6,6,0,1,0
9,112,112,6,6,0,1,0
17,125,125,15,3,12,3,2
7,143,143,1,1,0,1,0
4,149,149,26,10,16,2,1
8,165,165,8,8,0,1,0
19,166,166,7,7,0,1,0
0,168,168,17,17,0,1,0
3,222,222,5,5,0,1,0
24,287,287,31,16,15,4,3
5,299,299,8,8,0,1,0
2,313,313,12,2,10,2,1
11,316,316,3,3,0,1,0
20,362,362,1,1,0,1,0
1,377,377,20,20,0,1,0
23,378,378,46,46,0,1,0
10,381,381,45,24,21,2,1
14,409,409,9,9,0,1,0
18,415,415,32,6,26,4,3
16,432,432,8,3,5,2,1
22,438,438,44,44,0,1,0
13,442,442,1,1,0,1,0
21,445,445,74,74,0,1,0
25,479,479,87,43,44,2,1
15,491,491,59,11,48,4,3
6,496,496,14,8,6,3,2

0,133,133,5,5,0,1,0
2,178,178,21,18,3,2,1
7,242,242,46,2,44,3,2
14,254,254,10,10,0,1,0
3,283,283,50,50,0,1,0
5,289,289,11,11,0,1,0
15,352,352,9,9,0,1,0
12,356,356,17,17,0,1,0
4,379,379,46,22,24,4,3
6,379,379,38,38,0,1,0
11,384,384,106,94,12,2,1
9,400,400,141,141,0,1,0
16,404,404,2,2,0,1,0
10,405,405,10,1,9,3,2
1,425,425,51,51,0,1,0
13,443,443,56,56,0,1,0
8,485,485,7,2,5,2,1

10,102,102,29,11,18,2,1
17,117,117,4,4,0,1,0
1,127,127,13,1,12,3,2
11,136,136,14,14,0,1,0
13,158,158,11,2,9,2,1
5,169,169,22,22,0,1,0
0,212,212,3,3,0,1,0
2,229,229,6,6,0,1,0
6,271,271,26,26,0,1,0
9,289,289,79,60,19,4,3
16,353,353,6,3,3,2,1
4,383,383,5,5,0,1,0
15,416,416,32,32,0,1,0
3,430,430,48,48,0,1,0
8,434,434,63,11,52,3,2
7,437,437,115,115,0,1,0
14,469,469,9,9,0,1,0
12,470,470,16,11,5,2,1

8,136,136,5,5,0,1,0
1,142,142,54,19,35,2,1
3,155,155,5,5,0,1,0
12,178,178,37,37,0,1,0
2,194,194,19,4,15,4,3
7,211,211,17,3,14,3,2
16,232,232,3,3,0,1,0
13,240,240,9,9,0,1,0
9,255,255,25,25,0,1,0
10,274,274,54,54,0,1,0
15,313,313,1,1,0,1,0
11,384,384,42,24,18,3,2
6,391,391,30,30,0,1,0
14,404,404,88,73,15,2,1
5,413,413,3,3,0,1,0
4,427,427,65,53,12,4,3
0,436,436,33,33,0,1,0

7,122,122,2,2,0,1,0
12,126,126,11,11,0,1,0
19,206,206,29,29,0,1,0
3,236,236,57,17,40,3,2
18,259,259,50,16,34,4,3
6,262,262,47,33,14,3,2
15,266,266,9,6,3,2,1
8,280,280,13,13,0,1,0
13,287,287,2,2,0,1,0
11,294,294,14,2,12,3,2
2,294,294,16,16,0,1,0
0,324,324,52,52,0,1,0
5,350,350,15,3,12,3,2
17,393,393,39,39,0,1,0
10,405,405,42,14,28,2,1
9,446,446,1,1,0,1,0
14,469,469,57,7,50,2,1
4,477,477,16,16,0,1,0
1,481,481,10,4,6,3,2
16,499,499,94,19,75,4,3

3,105,105,4,4,0,1,0
0,107,107,5,5,0,1,0
10,111,111,1,1,0,1,0
19,148,148,2,2,0,1,0
2,174,174,3,3,0,1,0
8,179,179,7,7,0,1,0
16,179,179,24,1,23,2,1
9,232,232,33,33,0,1,0
14,262,262,8,8,0,1,0
6,274,274,53,13,40,2,1
1,295,295,18,4,14,2,1
4,297,297,32,25,7,2,1
11,346,346,45,22,23,2,1
12,356,356,26,5,21,2,1
20,382,382,111,101,10,2,1
18,408,408,101,7,94,3,2
7,425,425,1,1,0,1,0
15,430,430,8,8,0,1,0
17,451,451,24,24,0,1,0
13,470,470,23,23,0,1,0
5,472,472,54,6,48,4,3

3,107,107,31,15,16,3,2
11,125,125,3,3,0,1,0
1,161,161,84,20,64,4,3
12,175,175,14,2,12,2,1
9,187,187,24,24,0,1,0
6,244,244,23,23,0,1,0
4,326,326,4,4,0,1,0
10,363,363,5,5,0,1,0
7,371,371,20,20,0,1,0
5,377,377,35,29,6,3,2
0,417,417,23,23,0,1,0
2,479,479,11,11,0,1,0
13,480,480,51,35,16,3,2
8,482,482,157,59,98,4,3

3,107,107,8,8,0,1,0
15,110,110,30,30,0,1,0
12,138,138,6,6,0,1,0
8,143,143,2,2,0,1,0
17,207,207,1,1,0,1,0
4,224,224,1,1,0,1,0
11,239,239,23,23,0,1,0
2,271,271,44,8,36,3,2
19,274,274,26,10,16,2,1
21,275,275,1,1,0,1,0
5,305,305,12,12,0,1,0
6,318,318,10,10,0,1,0
16,322,322,71,41,30,4,3
18,344,344,2,2,0,1,0
1,351,351,33,9,24,3,2
20,364,364,1,1,0,1,0
13,457,457,7,1,6,3,2
14,477,477,142,142,0,1,0
7,478,478,106,106,0,1,0
9,480,480,8,3,5,2,1
0,493,493,11,11,0,1,0
10,498,498,41,31,10,3,2

14,113,113,1,1,0,1,0
3,136,136,33,14,19,2,1
2,174,174,11,11,0,1,0
15,229,229,20,4,16,2,1
4,236,236,25,25,0,1,0
1,258,258,15,15,0,1,0
5,264,264,33,33,0,1,0
9,265,265,46,8,38,3,2
11,276,276,24,11,13,4,3
16,278,278,38,14,24,4,3
0,331,331,62,7,55,4,3
10,396,396,18,6,12,3,2
6,413,413,43,43,0,1,0
13,424,424,29,25,4,2,1
12,427,427,75,17,58,3,2
7,437,437,6,6,0,1,0
8,461,461,63,63,0,1,0

14,110,110,13,5,8,2,1
10,137,137,15,1,14,2,1
8,139,139,35,6,29,3,2
13,146,146,2,2,0,1,0
2,154,154,14,5,9,4,3
6,176,176,13,4,9,4,3
15,202,202,39,39,0,1,0
9,228,228,2,2,0,1,0
4,244,244,13,6,7,2,1
3,287,287,95,83,12,3,2
11,295,295,17,2,15,3,2
0,329,329,3,3,0,1,0
12,339,339,12,12,0,1,0
7,342,342,13,3,10,2,1
5,459,459,19,7,12,4,3
1,469,469,5,5,0,1,0
16,473,473,170,134,36,3,2
17,497,497,15,15,0,1,0

9,118,118,18,9,9,4,3
8,131,131,16,3,13,2,1
7,152,152,45,34,11,2,1
12,242,242,15,6,9,4,3
15,248,248,8,8,0,1,0
5,277,277,36,36,0,1,0
14,284,284,7,7,0,1,0
16,299,299,8,2,6,3,2
10,299,299,52,52,0,1,0
3,328,328,31,31,0,1,0
2,371,371,65,8,57,4,3
13,372,372,24,8,16,3,2
6,405,405,76,58,18,4,3
0,421,421,2,2,0,1,0
1,443,443,3,3,0,1,0
11,475,475,129,43,86,4,3
4,487,487,4,4,0,1,0

3,117,117,1,1,0,1,0
15,123,123,11,11,0,1,0
12,137,137,13,13,0,1,0
6,149,149,1,1,0,1,0
2,158,158,33,33,0,1,0
11,158,158,21,12,9,4,3
1,163,163,4,4,0,1,0
8,199,199,42,6,36,4,3
9,209,209,16,16,0,1,0
0,213,213,8,8,0,1,0
20,243,243,13,1,12,3,2
14,278,278,19,10,9,4,3
5,342,342,12,8,4,2,1
10,351,351,2,2,0,1,0
4,376,376,43,1,42,2,1
16,389,389,86,86,0,1,0
18,413,413,10,10,0,1,0
7,416,416,18,18,0,1,0
17,421,421,59,46,13,2,1
13,458,458,42,42,0,1,0
19,477,477,65,40,25,2,1

6,108,108,1,1,0,1,0
9,162,162,22,12,10,3,2
14,173,173,17,17,0,1,0
5,197,197,24,10,14,3,2
4,211,211,1,1,0,1,0
11,277,277,37,13,24,3,2
10,301,301,8,8,0,1,0
12,321,321,131,91,40,3,2
2,332,332,5,5,0,1,0
13,396,396,11,11,0,1,0
0,399,399,114,87,27,4,3
1,413,413,106,13,93,4,3
7,459,459,17,17,0,1,0
3,460,460,101,8,93,4,3
8,472,472,20,11,9,2,1

9,108,108,16,13,3,2,1
0,139,139,38,38,0,1,0
2,141,141,13,9,4,2,1
10,173,173,5,5,0,1,0
8,207,207,4,4,0,1,0
5,234,234,29,7,22,3,2
13,239,239,31,31,0,1,0
14,257,257,46,46,0,1,0
18,261,261,2,2,0,1,0
12,287,287,28,4,24,3,2
16,300,300,59,59,0,1,0
4,308,308,20,5,15,2,1
1,317,317,15,15,0,1,0
11,332,332,14,4,10,3,2
7,340,340,40,11,29,2,1
15,423,423,43,16,27,2,1
3,425,425,5,5,0,1,0
17,440,440,60,60,0,1,0
6,449,449,1,1,0,1,0

13,109,109,10,10,0,1,0
2,111,111,10,10,0,1,0
12,115,115,47,47,0,1,0
7,151,151,32,32,0,1,0
16,185,185,8,3,5,2,1
6,209,209,6,6,0,1,0
15,224,224,15,3,12,4,3
10,253,253,5,1,4,2,1
1,278,278,39,29,10,3,2
18,286,286,2,2,0,1,0
11,296,296,8,2,6,3,2
3,307,307,3,3,0,1,0
20,334,334,5,5,0,1,0
0,360,360,62,41,21,4,3
4,368,368,20,20,0,1,0
8,396,396,31,31,0,1,0
9,419,419,13,13,0,1,0
19,429,429,30,30,0,1,0
5,439,439,17,2,15,3,2
17,467,467,63,32,31,2,1
14,500,500,40,40,0,1,0

16,122,122,12,8,4,2,1
15,128,128,4,4,0,1,0
6,128,128,8,8,0,1,0
9,214,214,10,10,0,1,0
0,281,281,14,14,0,1,0
12,306,306,5,5,0,1,0
14,317,317,32,32,0,1,0
10,330,330,114,114,0,1,0
17,352,352,2,2,0,1,0
11,380,380,20,9,11,2,1
2,398,398,61,33,28,2,1
5,400,400,31,31,0,1,0
3,432,432,81,59,22,3,2
13,434,434,29,29,0,1,0
4,437,437,28,28,0,1,0
1,447,447,101,87,14,2,1
8,448,448,8,1,7,2,1
7,459,459,8,3,5,2,1
18,486,486,96,40,56,3,2

14,103,103,5,5,0,1,0
10,123,123,10,1,9,2,1
12,135,135,6,6,0,1,0
18,169,169,4,4,0,1,0
6,206,206,30,30,0,1,0
15,210,210,36,36,0,1,0
8,212,212,25,25,0,1,0
2,221,221,1,1,0,1,0
3,230,230,31,21,10,3,2
4,270,270,5,5,0,1,0
7,285,285,12,12,0,1,0
17,296,296,68,45,23,2,1
9,332,332,39,39,0,1,0
16,365,365,13,13,0,1,0
11,367,367,127,91,36,2,1
19,372,372,8,8,0,1,0
0,388,388,45,24,21,4,3
5,425,425,19,4,15,4,3
13,443,443,1,1,0,1,0
1,450,450,36,36,0,1,0

7,105,105,1,1,0,1,0
11,116,116,11,3,8,3,2
8,125,125,45,45,0,1,0
6,159,159,3,3,0,1,0
10,185,185,6,2,4,2,1
14,206,206,22,6,16,2,1
4,219,219,17,10,7,2,1
3,227,227,30,17,13,2,1
15,232,232,26,26,0,1,0
2,243,243,19,4,15,4,3
12,269,269,22,22,0,1,0
9,343,343,38,34,4,2,1
13,356,356,8,8,0,1,0
0,365,365,75,75,0,1,0
5,381,381,32,8,24,4,3
1,472,472,145,115,30,2,1

21,108,108,8,8,0,1,0
24,129,129,11,11,0,1,0
7,134,134,2,2,0,1,0
5,153,153,3,3,0,1,0
2,166,166,1,1,0,1,0
0,193,193,1,1,0,1,0
11,203,203,2,2,0,1,0
4,230,230,5,5,0,1,0
18,230,230,18,18,0,1,0
1,242,242,31,25,6,2,1
17,287,287,30,19,11,2,1
9,313,313,53,53,0,1,0
25,322,322,88,88,0,1,0
14,328,328,6,6,0,1,0
12,356,356,8,1,7,2,1
3,373,373,26,12,14,2,1
16,386,386,4,4,0,1,0
13,391,391,72,7,65,4,3
8,410,410,42,42,0,1,0
22,411,411,89,2,87,4,3
20,416,416,1,1,0,1,0
10,447,447,27,27,0,1,0
19,482,482,29,7,22,2,1
6,485,485,21,15,6,3,2
23,486,486,9,9,0,1,0
15,489,489,7,7,0,1,0

11,108,108,10,10,0,1,0
8,108,108,26,12,14,3,2
10,155,155,18,18,0,1,0
17,164,164,9,9,0,1,0
12,186,186,10,10,0,1,0
2,196,196,15,9,6,3,2
4,196,196,1,1,0,1,0
9,204,204,38,22,16,3,2
13,260,260,10,10,0,1,0
14,266,266,13,13,0,1,0
6,301,301,3,3,0,1,0
0,351,351,11,1,10,2,1
7,386,386,77,1,76,3,2
3,393,393,26,2,24,3,2
15,421,421,23,2,21,4,3
16,433,433,121,46,75,4,3
1,447,447,71,61,10,2,1
5,473,473,55,55,0,1,0

0,147,147,10,10,0,1,0
3,169,169,16,16,0,1,0
8,229,229,1,1,0,1,0
16,230,230,17,17,0,1,0
14,239,239,19,12,7,2,1
9,276,276,1,1,0,1,0
22,283,283,6,6,0,1,0
18,286,286,13,4,9,2,1
6,287,287,20,1,19,2,1
1,295,295,1,1,0,1,0
5,346,346,37,7,30,2,1
12,351,351,20,8,12,2,1
10,376,376,9,9,0,1,0
15,383,383,12,3,9,2,1
20,389,389,15,15,0,1,0
17,395,395,86,62,24,4,3
21,425,425,167,161,6,3,2
11,447,447,15,15,0,1,0
19,449,449,7,2,5,2,1
23,459,459,37,37,0,1,0
4,462,462,49,43,6,2,1
7,474,474,38,38,0,1,0
2,474,474,64,37,27,4,3
13,491,491,18,3,15,4,3

17,125,125,14,14,0,1,0
1,147,147,1,1,0,1,0
3,158,158,39,39,0,1,0
6,171,171,15,1,14,2,1
18,193,193,17,17,0,1,0
8,207,207,10,10,0,1,0
7,219,219,19,19,0,1,0
11,245,245,3,3,0,1,0
13,246,246,25,2,23,2,1
15,261,261,50,18,32,3,2
19,261,261,2,2,0,1,0
12,278,278,22,22,0,1,0
14,291,291,6,6,0,1,0
5,312,312,4,1,3,2,1
20,322,322,98,75,23,2,1
10,337,337,25,25,0,1,0
0,376,376,49,32,17,2,1
2,391,391,46,33,13,3,2
9,405,405,17,17,0,1,0
16,428,428,6,6,0,1,0
4,455,455,17,17,0,1,0

0,105,105,6,6,0,1,0
6,131,131,14,8,6,2,1
11,139,139,38,13,25,2,1
19,150,150,22,1,21,4,3
17,163,163,19,13,6,3,2
10,209,209,11,1,10,3,2
15,237,237,53,4,49,2,1
20,248,248,10,1,9,2,1
4,291,291,5,5,0,1,0
13,294,294,8,4,4,2,1
8,299,299,9,9,0,1,0
14,308,308,1,1,0,1,0
7,361,361,9,1,8,2,1
18,393,393,66,45,21,2,1
12,397,397,49,19,30,4,3
16,403,403,27,6,21,4,3
3,412,412,62,62,0,1,0
9,422,422,34,34,0,1,0
5,454,454,15,15,0,1,0
2,464,464,30,30,0,1,0
1,484,484,7,7,0,1,0

12,112,112,2,2,0,1,0
6,135,135,6,6,0,1,0
4,137,137,10,3,7,2,1
8,161,161,26,16,10,2,1
15,172,172,82,79,3,2,1
2,204,204,18,18,0,1,0
14,230,230,7,7,0,1,0
5,241,241,1,1,0,1,0
0,248,248,1,1,0,1,0
11,257,257,3,3,0,1,0
10,261,261,12,2,10,2,1
1,307,307,21,6,15,2,1
3,349,349,218,109,109,4,3
9,387,387,7,7,0,1,0
7,446,446,48,19,29,3,2
13,492,492,25,7,18,4,3

24,123,123,18,18,0,1,0
2,125,125,10,10,0,1,0
21,143,143,3,3,0,1,0
5,145,145,5,5,0,1,0
20,158,158,5,2,3,2,1
8,170,170,2,2,0,1,0
13,180,180,8,2,6,3,2
1,195,195,17,17,0,1,0
6,203,203,3,3,0,1,0
16,212,212,1,1,0,1,0
9,247,247,1,1,0,1,0
12,255,255,6,6,0,1,0
18,278,278,20,20,0,1,0
23,298,298,155,155,0,1,0
22,315,315,2,2,0,1,0
4,330,330,12,12,0,1,0
11,346,346,30,6,24,2,1
15,378,378,111,33,78,3,2
25,384,384,20,20,0,1,0
14,394,394,30,30,0,1,0
10,419,419,2,2,0,1,0
19,457,457,12,8,4,2,1
17,457,457,21,7,14,3,2
7,481,481,24,24,0,1,0
3,484,484,1,1,0,1,0
0,494,494,24,24,0,1,0

2,110,110,14,8,6,3,2
8,169,169,9,3,6,2,1
9,241,241,1,1,0,1,0
7,246,246,11,11,0,1,0
6,261,261,40,32,8,3,2
5,280,280,49,18,31,2,1
12,293,293,85,85,0,1,0
0,315,315,78,12,66,4,3
11,352,352,10,10,0,1,0
3,369,369,74,74,0,1,0
1,424,424,24,4,20,3,2
13,446,446,16,16,0,1,0
10,462,462,59,25,34,3,2
4,475,475,128,120,8,2,1

17,139,139,24,7,17,4,3
7,141,141,37,37,0,1,0
9,142,142,8,8,0,1,0
0,144,144,17,17,0,1,0
10,185,185,14,14,0,1,0
8,215,215,19,10,9,4,3
4,219,219,27,23,4,2,1
3,256,256,17,17,0,1,0
13,260,260,21,21,0,1,0
1,318,318,5,5,0,1,0
15,368,368,54,32,22,3,2
5,396,396,39,13,26,2,1
11,434,434,7,2,5,2,1
14,443,443,130,118,12,3,2
12,455,455,23,17,6,2,1
16,459,459,10,10,0,1,0
6,476,476,15,3,12,3,2
2,499,499,49,49,0,1,0

9,133,133,14,2,12,3,2
2,203,203,122,122,0,1,0
0,242,242,22,22,0,1,0
5,266,266,15,1,14,3,2
10,271,271,44,3,41,2,1
8,316,316,15,15,0,1,0
1,328,328,69,69,0,1,0
4,384,384,56,56,0,1,0
6,414,414,37,37,0,1,0
3,462,462,44,10,34,3,2
7,471,471,14,14,0,1,0
11,487,487,88,64,24,4,3

1,153,153,9,9,0,1,0
6,169,169,7,2,5,2,1
2,177,177,18,18,0,1,0
5,203,203,44,44,0,1,0
0,207,207,13,13,0,1,0
13,214,214,27,9,18,3,2
12,268,268,11,4,7,2,1
4,301,301,110,82,28,3,2
9,305,305,27,11,16,2,1
10,335,335,7,3,4,2,1
14,418,418,9,9,0,1,0
8,421,421,97,73,24,4,3
3,422,422,40,40,0,1,0
7,471,471,97,97,0,1,0
11,478,478,63,36,27,4,3

16,102,102,14,14,0,1,0
1,110,110,6,6,0,1,0
13,131,131,5,1,4,2,1
14,146,146,9,9,0,1,0
9,154,154,1,1,0,1,0
12,176,176,15,15,0,1,0
3,181,181,9,9,0,1,0
8,183,183,10,10,0,1,0
10,251,251,47,19,28,2,1
11,258,258,53,5,48,4,3
15,258,258,33,33,0,1,0
0,261,261,42,24,18,4,3
4,275,275,31,28,3,2,1
7,283,283,12,12,0,1,0
2,324,324,85,24,61,4,3
6,448,448,16,16,0,1,0
17,495,495,39,39,0,1,0
5,498,498,65,3,62,4,3

0,123,123,17,6,11,2,1
14,151,151,4,4,0,1,0
4,157,157,18,6,12,4,3
9,213,213,9,9,0,1,0
6,218,218,7,7,0,1,0
1,240,240,4,1,3,2,1
7,294,294,11,11,0,1,0
8,300,300,18,8,10,3,2
11,303,303,14,5,9,4,3
13,337,337,57,46,11,2,1
15,349,349,65,5,60,4,3
10,357,357,5,5,0,1,0
17,386,386,100,61,39,3,2
3,389,389,101,101,0,1,0
16,391,391,1,1,0,1,0
12,439,439,75,62,13,3,2
5,481,481,55,55,0,1,0
2,487,487,63,23,40,3,2

13,120,120,13,13,0,1,0
11,129,129,11,3,8,3,2
10,139,139,13,1,12,3,2
18,160,160,16,16,0,1,0
9,188,188,21,21,0,1,0
5,203,203,33,11,22,2,1
15,229,229,53,53,0,1,0
8,348,348,40,1,39,4,3
16,350,350,40,40,0,1,0
2,366,366,54,54,0,1,0
0,366,366,29,29,0,1,0
17,384,384,5,2,3,2,1
1,385,385,18,13,5,2,1
14,398,398,15,3,12,3,2
12,426,426,59,42,17,2,1
7,460,460,29,29,0,1,0
6,467,467,1,1,0,1,0
3,470,470,42,2,40,3,2
4,493,493,43,17,26,3,2

9,122,122,2,2,0,1,0
0,124,124,7,3,4,2,1
11,140,140,30,18,12,4,3
17,172,172,20,9,11,4,3
16,174,174,35,35,0,1,0
14,178,178,5,2,3,2,1
2,184,184,1,1,0,1,0
7,204,204,16,16,0,1,0
5,252,252,55,44,11,2,1
6,285,285,6,6,0,1,0
13,291,291,12,12,0,1,0
12,292,292,6,6,0,1,0
1,304,304,32,10,22,3,2
4,305,305,17,17,0,1,0
3,372,372,12,2,10,3,2
10,394,394,9,9,0,1,0
8,411,411,130,130,0,1,0
15,430,430,95,35,60,4,3
18,491,491,27,27,0,1,0

8,100,100,5,2,3,2,1
7,169,169,19,8,11,2,1
6,171,171,19,19,0,1,0
11,187,187,13,3,10,2,1
12,187,187,29,6,23,2,1
5,196,196,72,49,23,2,1
9,296,296,26,26,0,1,0
4,304,304,17,14,3,2,1
13,332,332,32,9,23,2,1
1,346,346,39,15,24,3,2
14,352,352,3,3,0,1,0
2,408,408,45,45,0,1,0
16,408,408,92,92,0,1,0
0,413,413,9,3,6,2,1
15,436,436,90,90,0,1,0
10,440,440,5,5,0,1,0
3,460,460,5,5,0,1,0

2,163,163,30,30,0,1,0
8,168,168,33,1,32,3,2
10,179,179,15,4,11,2,1
5,300,300,47,47,0,1,0
11,303,303,10,10,0,1,0
6,337,337,29,13,16,3,2
9,390,390,89,73,16,4,3
7,398,398,29,29,0,1,0
13,409,409,46,13,33,4,3
15,419,419,74,5,69,4,3
14,446,446,17,5,12,4,3
4,470,470,19,19,0,1,0
12,471,471,18,8,10,3,2
1,478,478,68,26,42,3,2
0,481,481,97,40,57,4,3
3,482,482,8,8,0,1,0
16,496,496,3,3,0,1,0

16,115,115,1,1,0,1,0
18,118,118,11,11,0,1,0
1,126,126,5,1,4,2,1
11,179,179,5,5,0,1,0
15,183,183,22,22,0,1,0
22,189,189,42,26,16,3,2
17,198,198,14,14,0,1,0
8,211,211,2,2,0,1,0
19,230,230,19,9,10,2,1
7,234,234,23,11,12,3,2
12,235,235,45,35,10,2,1
20,238,238,38,38,0,1,0
5,246,246,21,21,0,1,0
2,268,268,16,12,4,2,1
13,327,327,10,6,4,2,1
10,355,355,22,22,0,1,0
6,367,367,60,10,50,3,2
14,373,373,30,8,22,2,1
21,411,411,34,34,0,1,0
4,417,417,4,4,0,1,0
3,432,432,25,25,0,1,0
9,433,433,28,28,0,1,0
0,491,491,1,1,0,1,0

6,102,102,43,43,0,1,0
11,116,116,2,2,0,1,0
1,134,134,8,2,6,3,2
2,136,136,2,2,0,1,0
7,144,144,11,6,5,2,1
5,184,184,27,8,19,2,1
16,189,189,35,35,0,1,0
8,194,194,32,12,20,3,2
9,202,202,18,11,7,2,1
13,224,224,54,27,27,4,3
4,236,236,25,19,6,2,1
10,271,271,18,18,0,1,0
14,282,282,11,11,0,1,0
15,364,364,26,3,23,2,1
12,476,476,23,23,0,1,0
3,477,477,5,5,0,1,0
0,480,480,31,31,0,1,0

9,114,114,13,13,0,1,0
4,131,131,4,4,0,1,0
5,146,146,14,14,0,1,0
15,154,154,20,3,17,2,1
12,195,195,11,11,0,1,0
3,216,216,35,35,0,1,0
7,218,218,13,1,12,3,2
11,261,261,13,6,7,2,1
6,272,272,3,3,0,1,0
1,296,296,131,128,3,2,1
0,309,309,34,34,0,1,0
2,310,310,15,11,4,2,1
8,320,320,4,4,0,1,0
13,342,342,50,50,0,1,0
10,449,449,95,19,76,3,2
14,458,458,63,47,16,3,2

14,204,204,5,5,0,1,0
7,204,204,7,1,6,2,1
8,211,211,15,12,3,2,1
2,213,213,5,5,0,1,0
16,226,226,30,30,0,1,0
21,240,240,54,54,0,1,0
13,242,242,8,8,0,1,0
5,250,250,27,27,0,1,0
12,262,262,16,5,11,3,2
6,265,265,36,36,0,1,0
3,275,275,7,7,0,1,0
19,280,280,12,12,0,1,0
4,320,320,34,34,0,1,0
11,326,326,12,1,11,4,3
9,336,336,17,17,0,1,0
10,352,352,69,24,45,4,3
0,363,363,8,8,0,1,0
20,392,392,59,21,38,4,3
1,396,396,13,13,0,1,0
15,409,409,76,55,21,4,3
18,487,487,38,38,0,1,0
17,493,493,21,21,0,1,0

3,132,132,15,6,9,4,3
9,139,139,7,2,5,2,1
7,149,149,1,1,0,1,0
10,184,184,28,28,0,1,0
6,191,191,60,60,0,1,0
11,198,198,37,37,0,1,0
4,220,220,14,4,10,2,1
12,225,225,6,3,3,2,1
2,240,240,4,4,0,1,0
14,262,262,44,44,0,1,0
17,273,273,1,1,0,1,0
5,312,312,19,10,9,2,1
8,314,314,28,7,21,4,3
0,341,341,50,20,30,3,2
1,388,388,35,35,0,1,0
13,390,390,79,79,0,1,0
15,399,399,48,48,0,1,0
16,466,466,4,4,0,1,0

15,134,134,14,14,0,1,0
11,136,136,49,8,41,2,1
8,157,157,2,2,0,1,0
18,157,157,13,6,7,2,1
12,165,165,18,18,0,1,0
10,178,178,19,3,16,2,1
7,179,179,1,1,0,1,0
2,216,216,10,10,0,1,0
1,233,233,42,9,33,4,3
4,246,246,24,24,0,1,0
5,249,249,1,1,0,1,0
13,277,277,2,2,0,1,0
0,287,287,12,3,9,4,3
17,311,311,24,24,0,1,0
16,349,349,15,15,0,1,0
14,421,421,17,8,9,4,3
3,434,434,124,48,76,3,2
6,438,438,56,25,31,3,2
9,484,484,48,48,0,1,0

0,125,125,23,23,0,1,0
3,180,180,3,3,0,1,0
9,204,204,14,14,0,1,0
13,212,212,3,3,0,1,0
11,225,225,83,32,51,4,3
1,244,244,128,35,93,4,3
8,341,341,68,4,64,4,3
7,358,358,34,14,20,3,2
6,362,362,42,30,12,4,3
2,375,375,5,5,0,1,0
4,389,389,63,17,46,3,2
10,392,392,3,3,0,1,0
5,485,485,6,2,4,2,1
12,496,496,16,16,0,1,0

19,114,114,4,4,0,1,0
6,117,117,14,5,9,4,3
10,141,141,7,4,3,2,1
13,168,168,47,15,32,2,1
5,174,174,10,4,6,2,1
8,187,187,4,4,0,1,0
11,188,188,5,5,0,1,0
9,198,198,2,2,0,1,0
3,206,206,1,1,0,1,0
16,224,224,57,57,0,1,0
14,233,233,15,15,0,1,0
17,237,237,10,4,6,2,1
7,271,271,17,17,0,1,0
18,346,346,4,4,0,1,0
0,445,445,116,23,93,4,3
12,452,452,50,50,0,1,0
2,457,457,2,2,0,1,0
1,467,467,61,61,0,1,0
4,473,473,73,25,48,2,1
20,474,474,21,21,0,1,0
15,478,478,37,37,0,1,0

4,118,118,6,6,0,1,0
5,127,127,6,6,0,1,0
17,165,165,29,21,8,2,1
11,231,231,34,34,0,1,0
6,244,244,8,8,0,1,0
0,249,249,2,2,0,1,0
16,288,288,9,3,6,3,2
7,300,300,22,22,0,1,0
3,315,315,44,25,19,2,1
2,327,327,4,4,0,1,0
8,334,334,88,81,7,2,1
9,351,351,38,38,0,1,0
14,355,355,28,28,0,1,0
15,387,387,16,16,0,1,0
13,408,408,42,20,22,3,2
10,453,453,42,12,30,4,3
19,464,464,75,48,27,4,3
1,471,471,34,4,30,3,2
12,486,486,70,52,18,2,1
18,488,488,13,13,0,1,0

15,113,113,7,2,5,2,1
9,115,115,8,8,0,1,0
5,187,187,2,2,0,1,0
12,191,191,9,9,0,1,0
13,203,203,43,32,11,2,1
17,214,214,24,24,0,1,0
3,234,234,14,11,3,2,1
7,253,253,14,14,0,1,0
8,273,273,31,19,12,4,3
2,283,283,81,36,45,4,3
18,301,301,10,10,0,1,0
4,309,309,2,2,0,1,0
0,315,315,74,74,0,1,0
14,333,333,15,2,13,4,3
10,354,354,26,26,0,1,0
1,419,419,18,6,12,4,3
6,428,428,11,5,6,2,1
11,467,467,66,66,0,1,0
16,472,472,90,6,84,4,3

15,113,113,11,11,0,1,0
16,163,163,34,34,0,1,0
9,175,175,4,4,0,1,0
1,251,251,27,27,0,1,0
4,273,273,2,2,0,1,0
5,286,286,44,44,0,1,0
7,289,289,32,32,0,1,0
8,321,321,11,11,0,1,0
0,342,342,33,33,0,1,0
10,343,343,104,90,14,3,2
12,396,396,6,6,0,1,0
2,415,415,105,95,10,2,1
6,457,457,59,12,47,2,1
14,463,463,104,24,80,3,2
11,475,475,7,7,0,1,0
13,476,476,2,2,0,1,0
3,478,478,21,21,0,1,0

7,106,106,3,3,0,1,0
8,125,125,24,5,19,2,1
3,135,135,16,16,0,1,0
4,148,148,7,7,0,1,0
11,172,172,6,6,0,1,0
2,188,188,9,2,7,2,1
12,228,228,25,25,0,1,0
6,295,295,49,31,18,4,3
1,368,368,66,12,54,3,2
9,395,395,51,51,0,1,0
10,403,403,85,18,67,4,3
0,484,484,270,238,32,2,1
5,494,494,5,5,0,1,0

9,107,107,10,10,0,1,0
11,108,108,1,1,0,1,0
6,130,130,8,8,0,1,0
16,145,145,1,1,0,1,0
12,188,188,71,29,42,4,3
17,233,233,6,6,0,1,0
5,240,240,27,11,16,3,2
7,277,277,23,2,21,4,3
4,280,280,72,72,0,1,0
14,310,310,58,41,17,2,1
2,387,387,7,1,6,3,2
15,395,395,33,33,0,1,0
13,408,408,60,27,33,2,1
1,422,422,37,18,19,2,1
8,427,427,76,76,0,1,0
10,437,437,1,1,0,1,0
3,447,447,28,28,0,1,0
0,461,461,19,19,0,1,0

3,114,114,12,7,5,2,1
11,121,121,1,1,0,1,0
12,175,175,6,3,3,2,1
13,183,183,5,5,0,1,0
19,200,200,5,1,4,2,1
14,227,227,18,18,0,1,0
2,244,244,10,3,7,2,1
9,253,253,6,6,0,1,0
15,298,298,14,14,0,1,0
10,342,342,13,1,12,3,2
8,343,343,37,31,6,2,1
20,346,346,44,25,19,2,1
16,357,357,99,24,75,4,3
5,368,368,18,3,15,4,3
0,378,378,39,27,12,3,2
1,380,380,29,5,24,4,3
7,381,381,86,75,11,2,1
18,385,385,19,6,13,4,3
4,399,399,50,50,0,1,0
17,462,462,114,68,46,3,2
6,472,472,1,1,0,1,0

14,107,107,1,1,0,1,0
13,114,114,25,25,0,1,0
0,120,120,14,14,0,1,0
9,135,135,8,1,7,2,1
10,188,188,8,8,0,1,0
5,209,209,20,16,4,2,1
1,224,224,10,10,0,1,0
2,233,233,17,17,0,1,0
17,236,236,27,27,0,1,0
3,264,264,22,22,0,1,0
4,269,269,36,21,15,4,3
18,292,292,50,50,0,1,0
16,293,293,14,14,0,1,0
15,304,304,92,23,69,4,3
8,323,323,5,5,0,1,0
12,334,334,3,3,0,1,0
11,388,388,2,2,0,1,0
7,446,446,95,8,87,4,3
6,447,447,30,30,0,1,0

9,125,125,9,9,0,1,0
14,129,129,3,3,0,1,0
12,139,139,2,2,0,1,0
15,180,180,7,7,0,1,0
10,182,182,48,22,26,3,2
3,192,192,35,8,27,2,1
7,212,212,16,16,0,1,0
6,254,254,13,5,8,3,2
11,264,264,90,75,15,2,1
2,287,287,30,30,0,1,0
18,300,300,10,10,0,1,0
1,302,302,18,18,0,1,0
16,335,335,18,9,9,4,3
17,352,352,23,3,20,3,2
0,374,374,2,2,0,1,0
5,389,389,1,1,0,1,0
4,391,391,4,1,3,2,1
8,409,409,138,107,31,2,1
13,499,499,44,7,37,2,1

20,105,105,14,14,0,1,0
1,125,125,8,8,0,1,0
15,153,153,14,14,0,1,0
16,173,173,1,1,0,1,0
6,181,181,4,4,0,1,0
14,192,192,12,12,0,1,0
10,192,192,21,21,0,1,0
19,193,193,68,19,49,2,1
4,223,223,25,25,0,1,0
13,245,245,10,5,5,2,1
17,247,247,35,35,0,1,0
7,263,263,34,34,0,1,0
9,297,297,28,10,18,2,1
12,362,362,34,34,0,1,0
5,374,374,47,32,15,4,3
8,442,442,11,11,0,1,0
0,455,455,31,16,15,4,3
3,474,474,9,9,0,1,0
18,487,487,3,3,0,1,0
11,494,494,60,45,15,2,1
2,498,498,5,5,0,1,0

2,109,109,1,1,0,1,0
23,197,197,18,18,0,1,0
14,203,203,19,19,0,1,0
15,214,214,3,3,0,1,0
8,227,227,4,1,3,2,1
10,231,231,51,43,8,3,2
4,236,236,1,1,0,1,0
7,251,251,6,6,0,1,0
5,277,277,3,3,0,1,0
19,296,296,29,24,5,2,1
0,325,325,6,6,0,1,0
12,354,354,46,22,24,3,2
18,371,371,20,20,0,1,0
9,378,378,27,27,0,1,0
1,384,384,47,38,9,4,3
6,436,436,1,1,0,1,0
16,445,445,2,2,0,1,0
13,452,452,7,7,0,1,0
11,456,456,3,3,0,1,0
22,457,457,117,21,96,4,3
3,466,466,73,36,37,2,1
21,467,467,64,53,11,2,1
17,477,477,18,18,0,1,0
20,478,478,107,99,8,2,1

11,150,150,10,10,0,1,0
16,153,153,4,4,0,1,0
5,176,176,12,7,5,2,1
19,275,275,29,29,0,1,0
14,275,275,30,30,0,1,0
9,280,280,37,37,0,1,0
15,299,299,68,68,0,1,0
18,304,304,66,20,46,3,2
13,315,315,5,5,0,1,0
3,319,319,32,8,24,4,3
7,326,326,7,1,6,3,2
8,370,370,25,7,18,2,1
12,375,375,44,44,0,1,0
1,381,381,3,3,0,1,0
2,424,424,9,9,0,1,0
10,441,441,6,6,0,1,0
4,447,447,125,38,87,4,3
17,460,460,15,3,12,3,2
6,465,465,5,5,0,1,0
0,475,475,85,39,46,2,1

0,102,102,55,7,48,4,3
6,162,162,20,6,14,3,2
12,165,165,6,6,0,1,0
11,175,175,50,18,32,4,3
2,213,213,31,13,18,4,3
9,253,253,18,10,8,3,2
10,312,312,15,8,7,2,1
3,326,326,56,35,21,4,3
5,349,349,79,44,35,4,3
4,356,356,7,7,0,1,0
8,375,375,30,30,0,1,0
1,405,405,18,9,9,4,3
7,469,469,11,11,0,1,0

8,138,138,8,8,0,1,0
1,151,151,5,5,0,1,0
3,165,165,21,21,0,1,0
10,183,183,5,5,0,1,0
7,203,203,3,3,0,1,0
13,252,252,20,10,10,2,1
2,260,260,10,10,0,1,0
18,272,272,17,17,0,1,0
15,272,272,16,8,8,2,1
6,273,273,9,9,0,1,0
0,285,285,107,107,0,1,0
21,298,298,48,48,0,1,0
17,314,314,16,6,10,2,1
4,327,327,1,1,0,1,0
16,332,332,110,97,13,2,1
12,349,349,5,5,0,1,0
14,374,374,11,11,0,1,0
9,378,378,11,11,0,1,0
5,425,425,14,2,12,4,3
19,447,447,26,10,16,3,2
20,458,458,37,37,0,1,0
11,492,492,57,57,0,1,0

16,104,104,3,3,0,1,0
4,115,115,4,4,0,1,0
8,141,141,1,1,0,1,0
15,148,148,2,2,0,1,0
7,154,154,8,8,0,1,0
13,154,154,3,3,0,1,0
14,169,169,5,1,4,2,1
20,208,208,17,17,0,1,0
12,215,215,46,16,30,4,3
10,217,217,16,5,11,2,1
9,238,238,13,13,0,1,0
6,284,284,77,39,38,2,1
1,288,288,44,44,0,1,0
19,302,302,52,3,49,2,1
0,310,310,19,5,14,2,1
3,351,351,17,6,11,2,1
18,374,374,1,1,0,1,0
17,393,393,146,89,57,3,2
5,429,429,14,5,9,4,3
11,448,448,8,5,3,2,1
2,459,459,44,44,0,1,0

3,107,107,3,3,0,1,0
14,123,123,3,3,0,1,0
15,149,149,9,9,0,1,0
0,177,177,2,2,0,1,0
5,202,202,11,1,10,2,1
4,211,211,14,14,0,1,0
13,247,247,2,2,0,1,0
10,289,289,20,20,0,1,0
2,305,305,1,1,0,1,0
1,360,360,36,36,0,1,0
9,362,362,81,5,76,4,3
12,381,381,22,2,20,3,2
7,382,382,15,3,12,3,2
11,392,392,61,7,54,3,2
16,394,394,131,74,57,3,2
8,422,422,43,34,9,2,1
19,447,447,40,20,20,3,2
17,459,459,26,26,0,1,0
18,460,460,103,79,24,4,3
20,464,464,29,17,12,3,2
6,497,497,24,20,4,2,1

4,120,120,3,3,0,1,0
9,121,121,3,3,0,1,0
20,128,128,11,4,7,2,1
16,146,146,24,9,15,2,1
18,167,167,52,6,46,3,2
13,242,242,6,6,0,1,0
7,260,260,20,6,14,2,1
17,298,298,7,1,6,3,2
10,310,310,32,32,0,1,0
6,334,334,1,1,0,1,0
12,340,340,6,2,4,2,1
15,341,341,33,33,0,1,0
0,342,342,5,2,3,2,1
19,368,368,9,9,0,1,0
11,376,376,1,1,0,1,0
1,385,385,75,75,0,1,0
3,404,404,13,13,0,1,0
8,409,409,22,3,19,3,2
5,441,441,142,120,22,3,2
2,453,453,14,3,11,2,1
21,466,466,29,1,28,3,2
14,487,487,59,12,47,2,1

7,121,121,16,16,0,1,0
16,167,167,10,10,0,1,0
12,173,173,18,18,0,1,0
13,215,215,1,1,0,1,0
9,221,221,22,4,18,4,3
2,226,226,9,9,0,1,0
14,267,267,16,1,15,4,3
15,276,276,24,24,0,1,0
17,302,302,44,44,0,1,0
1,337,337,18,15,3,2,1
4,342,342,93,81,12,4,3
0,390,390,11,6,5,2,1
10,396,396,69,23,46,3,2
6,437,437,51,23,28,3,2
3,439,439,56,24,32,2,1
11,449,449,85,42,43,2,1
8,461,461,57,9,48,4,3
5,465,465,4,4,0,1,0

5,109,109,16,16,0,1,0
0,111,111,23,7,16,3,2
9,122,122,2,2,0,1,0
10,136,136,11,11,0,1,0
13,138,138,13,13,0,1,0
11,166,166,5,5,0,1,0
4,171,171,3,3,0,1,0
15,235,235,37,4,33,2,1
3,259,259,12,4,8,2,1
2,267,267,3,3,0,1,0
17,276,276,38,11,27,4,3
8,276,276,1,1,0,1,0
1,283,283,40,2,38,2,1
18,313,313,13,9,4,2,1
6,353,353,3,3,0,1,0
16,400,400,75,69,6,3,2
7,433,433,31,1,30,3,2
19,445,445,44,44,0,1,0
21,456,456,10,10,0,1,0
12,462,462,55,55,0,1,0
14,467,467,39,30,9,4,3
20,497,497,46,3,43,2,1

9,122,122,9,9,0,1,0
11,139,139,31,31,0,1,0
10,164,164,10,10,0,1,0
17,178,178,5,5,0,1,0
8,183,183,5,2,3,2,1
2,187,187,19,3,16,3,2
18,188,188,57,57,0,1,0
13,251,251,29,23,6,3,2
4,252,252,35,35,0,1,0
3,326,326,34,16,18,2,1
0,339,339,23,23,0,1,0
6,386,386,1,1,0,1,0
1,415,415,58,25,33,2,1
5,418,418,77,55,22,3,2
7,432,432,1,1,0,1,0
12,436,436,17,17,0,1,0
19,447,447,32,20,12,4,3
16,462,462,8,8,0,1,0
14,465,465,34,10,24,4,3
15,491,491,24,13,11,4,3

7,116,116,29,3,26,3,2
13,177,177,7,4,3,2,1
6,217,217,21,21,0,1,0
16,223,223,33,10,23,3,2
14,239,239,22,18,4,2,1
4,260,260,46,6,40,3,2
15,277,277,55,55,0,1,0
0,287,287,21,18,3,2,1
11,309,309,3,3,0,1,0
12,316,316,54,30,24,2,1
2,317,317,35,13,22,2,1
8,358,358,3,3,0,1,0
9,376,376,4,4,0,1,0
17,378,378,44,44,0,1,0
1,400,400,56,56,0,1,0
5,408,408,9,9,0,1,0
3,485,485,11,11,0,1,0
10,493,493,63,63,0,1,0

13,102,102,31,1,30,3,2
18,125,125,14,14,0,1,0
0,135,135,1,1,0,1,0
16,140,140,1,1,0,1,0
6,168,168,17,17,0,1,0
11,193,193,4,1,3,2,1
2,252,252,6,6,0,1,0
3,257,257,71,29,42,4,3
14,269,269,44,44,0,1,0
1,275,275,31,31,0,1,0
8,289,289,14,3,11,2,1
5,348,348,41,41,0,1,0
17,362,362,54,44,10,3,2
20,368,368,3,3,0,1,0
12,380,380,7,7,0,1,0
19,402,402,39,39,0,1,0
4,438,438,15,15,0,1,0
15,440,440,25,15,10,2,1
7,442,442,10,10,0,1,0
10,444,444,10,6,4,2,1
9,459,459,52,18,34,3,2

7,112,112,16,1,15,4,3
1,130,130,25,7,18,2,1
6,135,135,4,4,0,1,0
5,199,199,6,6,0,1,0
0,238,238,48,48,0,1,0
8,258,258,6,6,0,1,0
3,306,306,15,9,6,3,2
10,337,337,3,3,0,1,0
11,373,373,157,127,30,4,3
12,383,383,71,59,12,4,3
2,402,402,185,148,37,4,3
4,409,409,20,17,3,2,1
9,423,423,15,9,6,2,1

1,111,111,6,3,3,2,1
7,133,133,25,16,9,4,3
8,140,140,12,12,0,1,0
10,160,160,24,6,18,3,2
0,165,165,5,2,3,2,1
6,173,173,21,7,14,3,2
9,175,175,1,1,0,1,0
12,205,205,69,51,18,4,3
3,222,222,29,29,0,1,0
5,234,234,53,53,0,1,0
13,244,244,35,4,31,2,1
4,277,277,13,13,0,1,0
17,279,279,53,53,0,1,0
16,300,300,4,4,0,1,0
11,308,308,12,5,7,2,1
15,396,396,11,11,0,1,0
14,470,470,5,2,3,2,1
2,491,491,9,1,8,3,2

0,152,152,13,10,3,2,1
11,154,154,2,2,0,1,0
14,182,182,1,1,0,1,0
15,198,198,1,1,0,1,0
5,216,216,1,1,0,1,0
23,238,238,26,2,24,4,3
18,263,263,17,17,0,1,0
4,278,278,73,73,0,1,0
1,302,302,1,1,0,1,0
12,326,326,45,21,24,2,1
19,327,327,88,85,3,2,1
25,334,334,20,6,14,3,2
8,342,342,15,15,0,1,0
24,346,346,9,3,6,2,1
9,354,354,3,3,0,1,0
20,360,360,71,53,18,4,3
13,363,363,1,1,0,1,0
17,375,375,32,20,12,3,2
6,379,379,3,3,0,1,0
2,385,385,20,9,11,2,1
3,401,401,15,9,6,2,1
21,425,425,12,12,0,1,0
22,434,434,32,20,12,3,2
16,459,459,20,20,0,1,0
10,480,480,2,2,0,1,0
7,488,488,89,69,20,3,2

12,135,135,7,3,4,2,1
10,155,155,44,32,12,3,2
14,166,166,4,4,0,1,0
1,202,202,40,22,18,4,3
13,207,207,18,9,9,2,1
5,235,235,40,40,0,1,0
2,282,282,65,65,0,1,0
0,355,355,12,12,0,1,0
9,376,376,61,34,27,2,1
7,387,387,32,32,0,1,0
4,388,388,29,29,0,1,0
3,414,414,1,1,0,1,0
11,417,417,22,8,14,3,2
6,430,430,82,82,0,1,0
8,430,430,7,7,0,1,0
15,462,462,73,73,0,1,0

14,113,113,22,22,0,1,0
0,127,127,32,16,16,3,2
16,144,144,8,8,0,1,0
15,175,175,24,1,23,2,1
13,188,188,12,12,0,1,0
1,196,196,3,3,0,1,0
6,205,205,3,3,0,1,0
5,249,249,37,37,0,1,0
17,286,286,3,3,0,1,0
11,293,293,35,5,30,3,2
3,363,363,44,6,38,2,1
2,408,408,21,21,0,1,0
9,422,422,66,66,0,1,0
4,422,422,13,13,0,1,0
7,446,446,34,6,28,3,2
8,459,459,88,4,84,4,3
10,468,468,17,6,11,2,1
12,482,482,69,21,48,2,1

7,146,146,6,1,5,2,1
17,163,163,36,20,16,3,2
12,181,181,5,5,0,1,0
14,204,204,6,6,0,1,0
2,210,210,28,28,0,1,0
0,217,217,10,7,3,2,1
3,220,220,1,1,0,1,0
9,238,238,39,39,0,1,0
5,242,242,110,53,57,3,2
16,286,286,37,37,0,1,0
6,290,290,4,4,0,1,0
11,311,311,4,4,0,1,0
4,375,375,14,14,0,1,0
15,376,376,7,7,0,1,0
1,377,377,55,25,30,2,1
13,382,382,32,5,27,4,3
8,394,394,10,10,0,1,0
10,450,450,103,83,20,3,2

18,113,113,6,6,0,1,0
12,115,115,4,4,0,1,0
4,141,141,1,1,0,1,0
3,153,153,4,4,0,1,0
21,182,182,10,4,6,2,1
0,202,202,20,2,18,2,1
10,208,208,13,13,0,1,0
16,208,208,11,11,0,1,0
17,235,235,26,6,20,2,1
20,261,261,64,28,36,2,1
8,277,277,6,6,0,1,0
13,287,287,61,61,0,1,0
9,326,326,10,10,0,1,0
5,344,344,8,8,0,1,0
1,375,375,47,37,10,2,1
2,383,383,59,44,15,4,3
11,384,384,15,15,0,1,0
7,423,423,18,18,0,1,0
6,425,425,102,102,0,1,0
14,466,466,8,2,6,3,2
15,468,468,59,59,0,1,0
19,484,484,23,8,15,4,3

1,105,105,1,1,0,1,0
6,133,133,17,7,10,2,1
8,196,196,4,4,0,1,0
0,238,238,17,14,3,2,1
11,284,284,9,9,0,1,0
14,306,306,14,14,0,1,0
15,312,312,2,2,0,1,0
7,327,327,8,2,6,3,2
2,361,361,32,32,0,1,0
3,378,378,135,125,10,2,1
12,403,403,13,1,12,4,3
17,411,411,18,4,14,2,1
9,418,418,56,56,0,1,0
16,425,425,50,28,22,2,1
10,427,427,13,8,5,2,1
13,436,436,205,106,99,4,3
4,437,437,87,16,71,4,3
5,486,486,1,1,0,1,0

10,100,100,10,10,0,1,0
3,118,118,26,16,10,3,2
11,132,132,7,7,0,1,0
0,145,145,3,3,0,1,0
18,213,213,12,4,8,3,2
8,214,214,47,47,0,1,0
5,223,223,8,1,7,2,1
16,239,239,79,37,42,3,2
20,251,251,30,30,0,1,0
12,255,255,3,3,0,1,0
7,302,302,26,20,6,2,1
4,318,318,1,1,0,1,0
9,358,358,17,8,9,2,1
14,387,387,10,10,0,1,0
13,399,399,61,25,36,4,3
1,412,412,4,4,0,1,0
6,418,418,23,20,3,2,1
15,475,475,43,23,20,3,2
19,478,478,12,2,10,4,3
2,486,486,24,24,0,1,0
17,489,489,49,49,0,1,0

11,120,120,35,12,23,2,1
9,132,132,9,9,0,1,0
6,146,146,22,13,9,2,1
1,166,166,13,4,9,4,3
7,216,216,12,2,10,2,1
10,228,228,23,2,21,4,3
3,253,253,196,184,12,3,2
2,254,254,8,8,0,1,0
5,270,270,10,10,0,1,0
12,370,370,19,7,12,2,1
0,385,385,6,6,0,1,0
8,412,412,11,7,4,2,1
4,434,434,61,44,17,2,1

7,128,128,11,2,9,4,3
12,129,129,9,1,8,3,2
6,148,148,41,41,0,1,0
15,165,165,28,28,0,1,0
0,218,218,50,50,0,1,0
9,238,238,25,4,21,2,1
17,244,244,23,11,12,3,2
4,291,291,2,2,0,1,0
5,345,345,14,14,0,1,0
14,365,365,54,54,0,1,0
1,382,382,14,9,5,2,1
16,387,387,30,30,0,1,0
11,402,402,60,18,42,2,1
3,411,411,17,2,15,2,1
8,422,422,60,7,53,4,3
10,443,443,18,18,0,1,0
13,450,450,28,28,0,1,0
2,496,496,20,20,0,1,0

20,119,119,18,18,0,1,0
5,132,132,43,43,0,1,0
19,144,144,8,5,3,2,1
18,157,157,22,22,0,1,0
14,184,184,13,1,12,2,1
1,197,197,1,1,0,1,0
6,230,230,1,1,0,1,0
17,240,240,2,2,0,1,0
9,271,271,11,1,10,3,2
4,272,272,1,1,0,1,0
12,306,306,22,22,0,1,0
15,316,316,43,43,0,1,0
2,337,337,46,46,0,1,0
3,376,376,41,31,10,3,2
16,382,382,99,63,36,4,3
0,435,435,22,10,12,2,1
10,451,451,3,3,0,1,0
7,454,454,61,61,0,1,0
8,472,472,31,31,0,1,0
13,486,486,14,8,6,2,1
11,493,493,9,9,0,1,0

8,102,102,15,15,0,1,0
3,107,107,15,15,0,1,0
5,123,123,8,8,0,1,0
11,131,131,11,1,10,2,1
0,218,218,1,1,0,1,0
10,321,321,39,7,32,3,2
1,325,325,6,6,0,1,0
12,325,325,5,5,0,1,0
7,338,338,50,24,26,3,2
2,358,358,148,148,0,1,0
9,360,360,53,2,51,4,3
6,411,411,67,57,10,3,2
4,483,483,157,157,0,1,0
13,494,494,13,1,12,3,2

8,104,104,4,1,3,2,1
3,119,119,3,3,0,1,0
2,173,173,21,1,20,3,2
9,178,178,15,10,5,2,1
1,202,202,12,12,0,1,0
5,213,213,6,6,0,1,0
10,268,268,4,4,0,1,0
22,273,273,35,19,16,2,1
17,301,301,57,57,0,1,0
23,317,317,1,1,0,1,0
11,321,321,3,3,0,1,0
7,329,329,26,4,22,3,2
6,330,330,32,14,18,4,3
18,356,356,15,15,0,1,0
14,359,359,10,10,0,1,0
0,366,366,29,14,15,4,3
16,370,370,49,28,21,2,1
12,374,374,34,21,13,4,3
19,396,396,94,60,34,3,2
4,413,413,37,37,0,1,0
13,434,434,24,24,0,1,0
15,440,440,12,6,6,2,1
21,440,440,8,1,7,3,2
20,478,478,63,63,0,1,0

1,108,108,27,27,0,1,0
15,124,124,7,1,6,3,2
10,142,142,13,13,0,1,0
2,145,145,18,18,0,1,0
16,162,162,7,7,0,1,0
9,165,165,15,15,0,1,0
18,170,170,42,10,32,3,2
8,171,171,22,12,10,3,2
12,193,193,24,14,10,3,2
13,221,221,16,16,0,1,0
7,221,221,12,12,0,1,0
6,331,331,44,44,0,1,0
11,335,335,77,30,47,3,2
5,364,364,2,2,0,1,0
14,387,387,16,16,0,1,0
17,414,414,6,6,0,1,0
4,436,436,17,10,7,2,1
3,455,455,27,27,0,1,0
0,491,491,8,8,0,1,0

19,116,116,34,29,5,2,1
12,132,132,14,14,0,1,0
4,152,152,23,8,15,2,1
18,159,159,16,16,0,1,0
10,175,175,35,35,0,1,0
8,223,223,21,21,0,1,0
2,235,235,22,16,6,3,2
11,255,255,11,11,0,1,0
17,269,269,39,22,17,4,3
6,287,287,1,1,0,1,0
15,295,295,13,1,12,4,3
5,347,347,35,35,0,1,0
9,365,365,42,28,14,3,2
0,396,396,8,3,5,2,1
1,399,399,12,12,0,1,0
14,409,409,9,9,0,1,0
16,420,420,51,15,36,3,2
7,425,425,32,4,28,3,2
13,434,434,20,20,0,1,0
3,499,499,10,10,0,1,0

14,133,133,1,1,0,1,0
5,195,195,6,6,0,1,0
9,210,210,9,5,4,2,1
11,221,221,21,21,0,1,0
2,262,262,74,41,33,3,2
8,281,281,8,8,0,1,0
4,315,315,2,2,0,1,0
16,319,319,34,25,9,2,1
10,320,320,31,31,0,1,0
3,337,337,22,3,19,2,1
0,359,359,44,44,0,1,0
18,393,393,16,16,0,1,0
7,408,408,47,47,0,1,0
1,409,409,7,7,0,1,0
13,419,419,25,11,14,2,1
17,428,428,88,26,62,3,2
12,456,456,112,26,86,3,2
15,486,486,27,6,21,4,3
6,491,491,95,41,54,4,3

10,120,120,8,2,6,2,1
21,124,124,4,4,0,1,0
16,125,125,26,11,15,2,1
15,150,150,13,13,0,1,0
17,198,198,26,26,0,1,0
13,199,199,5,2,3,2,1
18,232,232,36,5,31,4,3
3,236,236,14,14,0,1,0
19,236,236,36,12,24,4,3
7,237,237,6,6,0,1,0
9,251,251,7,7,0,1,0
20,252,252,28,16,12,2,1
12,259,259,35,8,27,4,3
11,273,273,31,31,0,1,0
2,273,273,1,1,0,1,0
14,274,274,5,5,0,1,0
4,289,289,24,14,10,3,2
1,304,304,29,29,0,1,0
8,372,372,8,1,7,2,1
6,397,397,48,48,0,1,0
0,415,415,19,1,18,3,2
5,481,481,50,26,24,3,2

1,112,112,1,1,0,1,0
14,151,151,11,3,8,2,1
9,166,166,8,8,0,1,0
8,168,168,1,1,0,1,0
7,187,187,35,27,8,2,1
3,195,195,29,12,17,2,1
18,212,212,78,78,0,1,0
2,225,225,12,12,0,1,0
13,240,240,6,6,0,1,0
15,255,255,24,9,15,4,3
19,310,310,18,6,12,4,3
17,316,316,5,1,4,2,1
6,385,385,101,101,0,1,0
11,388,388,26,26,0,1,0
4,403,403,16,4,12,2,1
12,406,406,42,42,0,1,0
16,453,453,51,17,34,3,2
0,456,456,9,1,8,3,2
10,479,479,59,59,0,1,0
5,500,500,2,2,0,1,0

5,107,107,16,11,5,2,1
12,130,130,1,1,0,1,0
10,156,156,1,1,0,1,0
7,234,234,8,2,6,3,2
4,265,265,18,18,0,1,0
2,275,275,30,12,18,2,1
3,319,319,74,74,0,1,0
1,344,344,91,20,71,4,3
9,352,352,14,3,11,2,1
13,357,357,51,42,9,4,3
8,383,383,65,65,0,1,0
6,394,394,127,80,47,4,3
0,400,400,34,10,24,2,1
14,451,451,8,3,5,2,1
11,452,452,79,79,0,1,0

5,101,101,7,7,0,1,0
2,108,108,1,1,0,1,0
11,127,127,4,4,0,1,0
18,137,137,17,17,0,1,0
22,143,143,21,21,0,1,0
21,163,163,12,9,3,2,1
16,208,208,13,13,0,1,0
7,211,211,10,10,0,1,0
6,225,225,12,12,0,1,0
10,241,241,10,10,0,1,0
3,246,246,6,6,0,1,0
19,248,248,7,7,0,1,0
14,254,254,3,3,0,1,0
9,255,255,7,1,6,2,1
0,277,277,6,6,0,1,0
12,310,310,51,23,28,4,3
20,323,323,57,48,9,4,3
1,328,328,12,9,3,2,1
17,401,401,24,16,8,2,1
13,421,421,21,12,9,4,3
15,423,423,99,99,0,1,0
8,442,442,27,27,0,1,0
4,489,489,129,129,0,1,0

8,118,118,16,16,0,1,0
10,124,124,4,4,0,1,0
13,175,175,25,10,15,2,1
4,224,224,7,7,0,1,0
17,229,229,14,14,0,1,0
3,230,230,6,3,3,2,1
0,263,263,57,23,34,3,2
15,266,266,45,23,22,4,3
1,274,274,16,4,12,2,1
2,276,276,4,4,0,1,0
5,309,309,39,39,0,1,0
16,329,329,28,28,0,1,0
14,334,334,18,8,10,2,1
12,355,355,65,65,0,1,0
6,367,367,18,12,6,3,2
9,374,374,29,11,18,4,3
7,452,452,113,96,17,4,3
11,494,494,55,55,0,1,0

13,137,137,39,39,0,1,0
9,138,138,4,4,0,1,0
14,148,148,30,10,20,4,3
1,192,192,1,1,0,1,0
4,200,200,33,30,3,2,1
12,212,212,8,8,0,1,0
15,246,246,9,9,0,1,0
7,269,269,16,4,12,2,1
8,275,275,51,36,15,4,3
0,301,301,156,138,18,4,3
6,318,318,7,4,3,2,1
3,341,341,1,1,0,1,0
11,472,472,40,21,19,2,1
2,481,481,78,30,48,2,1
5,487,487,13,13,0,1,0
10,492,492,1,1,0,1,0

2,106,106,2,2,0,1,0
4,121,121,1,1,0,1,0
3,147,147,43,34,9,4,3
14,154,154,2,2,0,1,0
1,171,171,22,22,0,1,0
6,181,181,1,1,0,1,0
9,182,182,2,2,0,1,0
13,206,206,16,16,0,1,0
0,213,213,6,6,0,1,0
12,275,275,38,38,0,1,0
5,336,336,143,143,0,1,0
7,337,337,17,8,9,4,3
8,395,395,20,8,12,2,1
11,396,396,21,21,0,1,0
10,399,399,206,200,6,2,1

18,101,101,9,6,3,2,1
7,102,102,9,9,0,1,0
2,102,102,6,6,0,1,0
17,131,131,2,2,0,1,0
4,162,162,2,2,0,1,0
20,175,175,10,10,0,1,0
19,180,180,7,3,4,2,1
6,203,203,13,5,8,2,1
15,221,221,77,55,22,2,1
10,235,235,22,16,6,2,1
0,238,238,17,14,3,2,1
9,254,254,30,3,27,4,3
12,337,337,3,3,0,1,0
8,344,344,9,9,0,1,0
13,361,361,13,10,3,2,1
5,389,389,19,9,10,3,2
16,391,391,59,45,14,2,1
11,429,429,3,3,0,1,0
1,445,445,81,81,0,1,0
14,445,445,59,59,0,1,0
21,464,464,21,21,0,1,0
3,476,476,58,58,0,1,0

12,106,106,14,14,0,1,0
6,175,175,8,8,0,1,0
7,184,184,27,6,21,4,3
14,199,199,35,15,20,3,2
3,202,202,96,85,11,2,1
2,222,222,33,33,0,1,0
9,261,261,11,11,0,1,0
15,275,275,38,38,0,1,0
5,290,290,9,3,6,2,1
0,322,322,4,1,3,2,1
8,327,327,19,19,0,1,0
4,341,341,43,43,0,1,0
13,365,365,43,14,29,3,2
11,384,384,32,12,20,3,2
1,392,392,26,17,9,2,1
10,499,499,14,2,12,3,2

17,100,100,7,4,3,2,1
2,104,104,18,4,14,2,1
21,161,161,39,39,0,1,0
11,163,163,13,13,0,1,0
0,169,169,1,1,0,1,0
12,184,184,18,18,0,1,0
3,184,184,3,3,0,1,0
10,231,231,49,5,44,3,2
5,274,274,7,7,0,1,0
14,280,280,51,51,0,1,0
1,281,281,24,12,12,2,1
8,296,296,5,5,0,1,0
16,319,319,4,4,0,1,0
6,352,352,26,26,0,1,0
15,374,374,25,12,13,2,1
18,395,395,38,24,14,3,2
20,401,401,20,8,12,3,2
4,426,426,27,2,25,2,1
13,430,430,58,37,21,2,1
9,469,469,9,9,0,1,0
19,477,477,29,29,0,1,0
7,498,498,17,17,0,1,0

5,108,108,13,4,9,2,1
12,112,112,4,4,0,1,0
3,182,182,20,8,12,4,3
16,185,185,5,5,0,1,0
0,186,186,17,17,0,1,0
1,209,209,21,21,0,1,0
7,240,240,7,3,4,2,1
4,260,260,21,12,9,2,1
6,263,263,53,53,0,1,0
15,270,270,26,22,4,2,1
2,323,323,6,6,0,1,0
10,337,337,27,27,0,1,0
9,368,368,52,36,16,2,1
14,373,373,6,6,0,1,0
11,388,388,30,12,18,4,3
13,445,445,98,87,11,2,1
8,445,445,66,36,30,4,3
17,483,483,106,106,0,1,0

5,127,127,25,25,0,1,0
7,128,128,48,48,0,1,0
0,138,138,11,3,8,2,1
1,138,138,19,19,0,1,0
2,151,151,9,2,7,2,1
9,155,155,9,9,0,1,0
6,250,250,35,35,0,1,0
8,269,269,56,56,0,1,0
3,277,277,30,15,15,4,3
12,320,320,22,2,20,4,3
10,334,334,10,10,0,1,0
11,355,355,3,3,0,1,0
13,364,364,22,22,0,1,0
4,375,375,68,68,0,1,0
15,417,417,42,42,0,1,0
14,432,432,4,1,3,2,1

19,125,125,11,5,6,2,1
20,142,142,3,3,0,1,0
0,153,153,38,38,0,1,0
10,158,158,3,3,0,1,0
4,166,166,18,5,13,2,1
1,170,170,1,1,0,1,0
5,178,178,7,7,0,1,0
9,189,189,21,21,0,1,0
14,254,254,24,18,6,2,1
7,254,254,12,12,0,1,0
16,265,265,1,1,0,1,0
18,279,279,11,11,0,1,0
13,284,284,8,2,6,2,1
15,341,341,100,12,88,3,2
3,369,369,4,4,0,1,0
8,405,405,26,26,0,1,0
11,410,410,17,17,0,1,0
17,427,427,10,10,0,1,0
12,428,428,140,140,0,1,0
2,431,431,58,55,3,2,1
6,434,434,31,31,0,1,0

6,100,100,10,10,0,1,0
9,125,125,19,19,0,1,0
1,133,133,33,23,10,3,2
2,158,158,27,27,0,1,0
0,186,186,5,5,0,1,0
12,211,211,1,1,0,1,0
10,216,216,21,21,0,1,0
5,217,217,65,65,0,1,0
11,218,218,29,13,16,3,2
4,278,278,2,2,0,1,0
7,322,322,86,86,0,1,0
3,389,389,59,59,0,1,0
8,451,451,33,33,0,1,0
13,466,466,16,16,0,1,0
14,484,484,26,22,4,2,1

11,101,101,6,6,0,1,0
9,117,117,2,2,0,1,0
21,125,125,21,21,0,1,0
14,136,136,3,3,0,1,0
10,146,146,1,1,0,1,0
20,154,154,1,1,0,1,0
15,168,168,10,10,0,1,0
12,206,206,29,29,0,1,0
5,209,209,11,1,10,3,2
17,235,235,10,10,0,1,0
4,245,245,2,2,0,1,0
13,256,256,2,2,0,1,0
23,262,262,50,42,8,3,2
6,275,275,14,3,11,4,3
8,303,303,32,13,19,4,3
19,309,309,83,33,50,3,2
22,325,325,33,5,28,2,1
16,325,325,24,24,0,1,0
25,393,393,28,5,23,4,3
0,396,396,18,18,0,1,0
2,436,436,3,3,0,1,0
18,444,444,6,6,0,1,0
3,447,447,40,24,16,2,1
7,448,448,67,67,0,1,0
1,471,471,3,3,0,1,0
24,473,473,25,25,0,1,0

4,100,100,3,3,0,1,0
18,104,104,1,1,0,1,0
17,105,105,20,10,10,3,2
12,129,129,38,7,31,2,1
11,171,171,1,1,0,1,0
7,268,268,15,15,0,1,0
13,296,296,20,16,4,2,1
14,353,353,51,18,33,2,1
2,354,354,9,9,0,1,0
8,362,362,51,13,38,3,2
1,364,364,73,32,41,2,1
10,374,374,20,20,0,1,0
3,380,380,3,3,0,1,0
16,389,389,10,1,9,2,1
15,403,403,50,5,45,3,2
0,425,425,108,40,68,3,2
6,429,429,35,23,12,4,3
5,467,467,29,29,0,1,0
9,495,495,21,9,12,4,3

11,101,101,15,3,12,3,2
7,101,101,7,7,0,1,0
12,150,150,2,2,0,1,0
1,201,201,10,1,9,4,3
13,213,213,3,3,0,1,0
16,217,217,6,6,0,1,0
9,222,222,36,16,20,2,1
5,236,236,12,2,10,3,2
14,243,243,41,27,14,3,2
10,302,302,70,50,20,2,1
4,315,315,110,110,0,1,0
2,328,328,9,9,0,1,0
15,352,352,3,3,0,1,0
6,357,357,34,34,0,1,0
8,413,413,63,14,49,2,1
3,424,424,85,85,0,1,0
0,479,479,28,28,0,1,0

7,105,105,38,38,0,1,0
10,131,131,1,1,0,1,0
1,144,144,59,59,0,1,0
15,156,156,5,5,0,1,0
0,157,157,52,52,0,1,0
2,189,189,3,3,0,1,0
6,192,192,20,17,3,2,1
4,202,202,3,3,0,1,0
8,213,213,42,42,0,1,0
14,216,216,7,4,3,2,1
9,266,266,16,16,0,1,0
11,268,268,11,5,6,2,1
12,287,287,39,39,0,1,0
13,379,379,21,21,0,1,0
5,432,432,10,10,0,1,0
3,449,449,1,1,0,1,0

0,138,138,7,7,0,1,0
2,139,139,6,6,0,1,0
11,144,144,2,2,0,1,0
20,149,149,25,5,20,3,2
7,195,195,9,9,0,1,0
9,205,205,1,1,0,1,0
4,225,225,9,5,4,2,1
22,249,249,13,2,11,2,1
19,271,271,7,3,4,2,1
13,295,295,42,18,24,3,2
15,312,312,26,26,0,1,0
10,343,343,35,26,9,4,3
17,372,372,100,94,6,2,1
6,386,386,22,6,16,2,1
8,390,390,69,69,0,1,0
16,390,390,108,10,98,4,3
18,397,397,6,2,4,2,1
24,408,408,7,7,0,1,0
23,420,420,35,9,26,2,1
5,431,431,1,1,0,1,0
14,434,434,15,15,0,1,0
3,440,440,13,13,0,1,0
21,445,445,4,4,0,1,0
12,454,454,18,18,0,1,0
1,494,494,18,18,0,1,0

4,107,107,1,1,0,1,0
0,113,113,22,22,0,1,0
9,145,145,3,3,0,1,0
8,149,149,4,4,0,1,0
17,177,177,43,43,0,1,0
6,196,196,3,3,0,1,0
3,224,224,11,11,0,1,0
5,285,285,64,64,0,1,0
2,299,299,31,16,15,2,1
11,306,306,19,15,4,2,1
20,309,309,5,5,0,1,0
13,313,313,29,29,0,1,0
14,351,351,18,6,12,4,3
7,351,351,2,2,0,1,0
12,361,361,11,11,0,1,0
18,394,394,133,40,93,4,3
15,399,399,23,4,19,3,2
10,400,400,62,22,40,2,1
16,446,446,25,25,0,1,0
1,472,472,17,17,0,1,0
19,490,490,16,16,0,1,0

4,100,100,19,19,0,1,0
7,107,107,7,7,0,1,0
13,133,133,25,25,0,1,0
15,134,134,15,12,3,2,1
6,143,143,19,19,0,1,0
19,179,179,11,11,0,1,0
10,188,188,4,4,0,1,0
0,196,196,4,4,0,1,0
18,209,209,16,5,11,4,3
16,274,274,11,11,0,1,0
14,294,294,30,30,0,1,0
1,322,322,14,14,0,1,0
17,329,329,35,27,8,3,2
5,370,370,15,7,8,2,1
2,378,378,81,81,0,1,0
3,386,386,28,28,0,1,0
11,405,405,70,42,28,4,3
8,417,417,21,21,0,1,0
9,456,456,23,11,12,4,3
12,495,495,27,27,0,1,0

1,134,134,18,13,5,2,1
9,171,171,9,3,6,2,1
10,202,202,2,2,0,1,0
17,211,211,15,7,8,3,2
12,241,241,59,11,48,4,3
11,242,242,5,1,4,2,1
4,252,252,5,5,0,1,0
15,258,258,10,10,0,1,0
19,279,279,19,19,0,1,0
16,284,284,8,1,7,2,1
2,320,320,28,15,13,2,1
18,328,328,39,17,22,2,1
0,393,393,46,13,33,2,1
5,404,404,27,4,23,2,1
6,418,418,39,29,10,2,1
20,432,432,52,25,27,2,1
8,436,436,13,13,0,1,0
3,443,443,6,6,0,1,0
21,446,446,94,20,74,3,2
14,467,467,73,73,0,1,0
7,488,488,5,5,0,1,0
13,498,498,49,40,9,4,3

11,124,124,20,20,0,1,0
0,131,131,11,11,0,1,0
4,146,146,20,17,3,2,1
15,147,147,5,2,3,2,1
14,161,161,10,1,9,4,3
3,185,185,45,45,0,1,0
12,188,188,4,4,0,1,0
18,192,192,25,16,9,2,1
2,203,203,20,20,0,1,0
19,245,245,76,76,0,1,0
13,283,283,26,4,22,2,1
6,383,383,32,27,5,2,1
16,414,414,42,42,0,1,0
7,414,414,10,10,0,1,0
9,424,424,5,5,0,1,0
5,435,435,5,5,0,1,0
1,441,441,23,2,21,4,3
17,453,453,3,3,0,1,0
10,483,483,3,3,0,1,0
8,487,487,73,28,45,4,3

12,106,106,24,15,9,2,1
8,117,117,15,2,13,2,1
17,134,134,10,10,0,1,0
1,150,150,4,4,0,1,0
0,167,167,1,1,0,1,0
10,195,195,11,5,6,3,2
15,198,198,11,11,0,1,0
21,202,202,15,15,0,1,0
23,211,211,3,3,0,1,0
2,220,220,4,4,0,1,0
16,229,229,7,7,0,1,0
5,296,296,1,1,0,1,0
6,310,310,1,1,0,1,0
25,328,328,5,1,4,2,1
22,333,333,16,16,0,1,0
11,334,334,15,3,12,4,3
18,389,389,135,123,12,3,2
4,393,393,5,5,0,1,0
7,404,404,12,6,6,3,2
24,412,412,23,23,0,1,0
3,450,450,6,3,3,2,1
20,455,455,103,103,0,1,0
14,458,458,43,43,0,1,0
13,466,466,8,3,5,2,1
9,494,494,67,15,52,3,2
19,497,497,30,30,0,1,0

1,119,119,5,5,0,1,0
14,132,132,9,1,8,3,2
4,154,154,5,1,4,2,1
7,155,155,24,6,18,4,3
0,156,156,3,3,0,1,0
6,167,167,4,4,0,1,0
11,170,170,3,3,0,1,0
8,177,177,20,20,0,1,0
15,187,187,21,21,0,1,0
9,214,214,29,6,23,2,1
19,307,307,18,7,11,2,1
12,324,324,75,27,48,4,3
5,337,337,13,13,0,1,0
13,379,379,83,71,12,4,3
16,401,401,6,6,0,1,0
10,437,437,45,45,0,1,0
17,477,477,2,2,0,1,0
3,480,480,1,1,0,1,0
18,497,497,95,95,0,1,0
2,500,500,118,84,34,3,2

17,106,106,1,1,0,1,0
6,115,115,10,10,0,1,0
5,165,165,1,1,0,1,0
14,210,210,6,6,0,1,0
7,222,222,13,13,0,1,0
1,230,230,19,10,9,4,3
16,231,231,14,14,0,1,0
2,266,266,32,10,22,3,2
0,274,274,2,2,0,1,0
8,277,277,74,74,0,1,0
13,278,278,39,16,23,3,2
11,283,283,29,29,0,1,0
10,352,352,21,21,0,1,0
9,353,353,2,2,0,1,0
4,373,373,71,38,33,4,3
3,412,412,34,8,26,4,3
15,429,429,170,170,0,1,0
12,445,445,49,32,17,2,1

4,105,105,15,5,10,2,1
5,124,124,3,3,0,1,0
14,128,128,2,2,0,1,0
9,175,175,1,1,0,1,0
8,210,210,11,11,0,1,0
18,245,245,19,5,14,2,1
19,278,278,52,5,47,2,1
11,281,281,19,5,14,2,1
16,287,287,37,2,35,2,1
0,341,341,83,39,44,2,1
10,385,385,7,7,0,1,0
15,392,392,9,9,0,1,0
12,402,402,23,23,0,1,0
7,422,422,10,10,0,1,0
2,442,442,22,2,20,2,1
17,452,452,148,36,112,4,3
6,460,460,35,35,0,1,0
1,475,475,11,1,10,2,1
3,479,479,116,87,29,2,1
13,488,488,17,2,15,2,1

9,141,141,31,31,0,1,0
0,147,147,1,1,0,1,0
12,198,198,10,10,0,1,0
8,230,230,54,11,43,2,1
2,236,236,60,17,43,2,1
4,255,255,150,71,79,4,3
6,280,280,3,3,0,1,0
7,289,289,11,11,0,1,0
1,308,308,4,4,0,1,0
11,373,373,29,29,0,1,0
10,376,376,65,17,48,3,2
5,381,381,39,39,0,1,0
13,448,448,4,4,0,1,0
3,465,465,18,3,15,4,3

18,124,124,19,19,0,1,0
12,135,135,7,7,0,1,0
10,161,161,5,5,0,1,0
5,169,169,13,5,8,3,2
6,192,192,9,9,0,1,0
17,210,210,39,39,0,1,0
9,264,264,8,8,0,1,0
2,289,289,27,9,18,3,2
1,298,298,55,13,42,3,2
14,318,318,23,23,0,1,0
15,320,320,62,18,44,3,2
11,330,330,3,3,0,1,0
7,356,356,40,40,0,1,0
4,383,383,12,12,0,1,0
0,425,425,27,5,22,2,1
13,461,461,15,12,3,2,1
16,471,471,37,14,23,2,1
19,476,476,68,68,0,1,0
3,493,493,54,19,35,2,1
8,495,495,61,61,0,1,0

5,163,163,6,1,5,2,1
18,193,193,9,9,0,1,0
24,222,222,17,5,12,4,3
12,224,224,24,24,0,1,0
20,229,229,26,2,24,2,1
9,236,236,21,14,7,2,1
6,238,238,24,16,8,3,2
11,246,246,5,5,0,1,0
21,255,255,60,60,0,1,0
10,273,273,7,1,6,2,1
4,275,275,19,10,9,2,1
17,280,280,16,1,15,2,1
16,289,289,4,4,0,1,0
19,314,314,9,2,7,2,1
22,365,365,73,63,10,3,2
23,370,370,37,37,0,1,0
13,389,389,1,1,0,1,0
3,396,396,8,2,6,2,1
2,398,398,2,2,0,1,0
14,418,418,35,31,4,2,1
25,429,429,26,26,0,1,0
8,445,445,33,33,0,1,0
15,457,457,26,1,25,2,1
0,476,476,44,44,0,1,0
1,486,486,8,2,6,2,1
7,489,489,42,42,0,1,0

14,114,114,25,1,24,3,2
7,129,129,3,3,0,1,0
26,136,136,18,18,0,1,0
1,138,138,6,6,0,1,0
11,181,181,4,4,0,1,0
19,186,186,5,5,0,1,0
17,197,197,2,2,0,1,0
2,211,211,7,7,0,1,0
9,238,238,6,2,4,2,1
22,239,239,53,53,0,1,0
18,255,255,21,5,16,3,2
4,273,273,1,1,0,1,0
24,294,294,32,32,0,1,0
13,310,310,4,4,0,1,0
6,315,315,9,6,3,2,1
21,323,323,38,38,0,1,0
8,334,334,5,1,4,2,1
0,336,336,8,8,0,1,0
15,363,363,3,3,0,1,0
12,372,372,109,88,21,4,3
5,374,374,2,2,0,1,0
25,383,383,26,4,22,2,1
10,416,416,15,15,0,1,0
20,449,449,31,31,0,1,0
23,476,476,42,12,30,3,2
3,481,481,29,29,0,1,0
16,496,496,20,20,0,1,0

9,118,118,3,3,0,1,0
3,124,124,5,5,0,1,0
22,126,126,9,9,0,1,0
20,134,134,26,26,0,1,0
16,137,137,5,1,4,2,1
18,145,145,11,11,0,1,0
19,146,146,24,20,4,2,1
0,151,151,4,4,0,1,0
13,203,203,4,1,3,2,1
4,239,239,8,8,0,1,0
7,277,277,39,39,0,1,0
11,305,305,9,1,8,3,2
12,322,322,23,4,19,4,3
21,332,332,26,8,18,3,2
2,384,384,23,5,18,3,2
17,397,397,31,31,0,1,0
5,405,405,18,11,7,2,1
14,426,426,55,5,50,2,1
1,443,443,77,77,0,1,0
6,468,468,56,56,0,1,0
10,472,472,38,38,0,1,0
15,477,477,42,30,12,2,1
8,484,484,17,17,0,1,0

17,102,102,13,8,5,2,1
1,175,175,8,8,0,1,0
10,187,187,4,4,0,1,0
15,208,208,56,44,12,4,3
8,213,213,23,16,7,2,1
16,263,263,4,1,3,2,1
4,286,286,1,1,0,1,0
6,309,309,9,3,6,2,1
7,326,326,41,41,0,1,0
0,344,344,3,3,0,1,0
19,354,354,25,2,23,4,3
9,358,358,9,3,6,3,2
18,371,371,8,8,0,1,0
5,373,373,10,10,0,1,0
14,377,377,1,1,0,1,0
2,413,413,4,1,3,2,1
3,418,418,112,112,0,1,0
11,450,450,103,70,33,4,3
13,453,453,55,25,30,2,1
20,478,478,137,137,0,1,0
12,485,485,1,1,0,1,0

6,137,137,1,1,0,1,0
16,146,146,18,18,0,1,0
11,184,184,33,6,27,4,3
8,192,192,14,14,0,1,0
12,200,200,10,10,0,1,0
5,203,203,2,2,0,1,0
9,218,218,28,13,15,4,3
14,234,234,7,7,0,1,0
13,253,253,8,2,6,2,1
18,265,265,58,8,50,4,3
0,267,267,5,5,0,1,0
4,274,274,29,29,0,1,0
17,327,327,5,5,0,1,0
3,365,365,27,27,0,1,0
1,426,426,77,51,26,4,3
2,430,430,43,11,32,3,2
10,448,448,22,22,0,1,0
7,469,469,95,53,42,4,3
15,493,493,109,56,53,3,2

16,121,121,2,2,0,1,0
15,131,131,25,9,16,2,1
18,183,183,17,10,7,2,1
19,198,198,29,1,28,3,2
17,199,199,33,18,15,2,1
13,208,208,5,5,0,1,0
14,245,245,36,36,0,1,0
0,263,263,57,57,0,1,0
5,287,287,13,7,6,3,2
3,291,291,5,2,3,2,1
8,308,308,44,44,0,1,0
1,318,318,10,10,0,1,0
6,344,344,8,8,0,1,0
2,353,353,10,10,0,1,0
4,382,382,29,13,16,3,2
10,388,388,40,23,17,3,2
11,437,437,39,3,36,4,3
7,474,474,57,57,0,1,0
12,479,479,28,28,0,1,0
9,491,491,47,16,31,2,1

14,116,116,5,5,0,1,0
4,150,150,11,3,8,3,2
18,163,163,19,19,0,1,0
16,192,192,45,45,0,1,0
13,197,197,32,32,0,1,0
0,203,203,15,15,0,1,0
8,225,225,1,1,0,1,0
9,250,250,3,3,0,1,0
10,260,260,13,13,0,1,0
12,270,270,19,19,0,1,0
17,281,281,31,4,27,4,3
15,313,313,11,1,10,2,1
19,352,352,36,36,0,1,0
2,396,396,3,3,0,1,0
6,407,407,12,12,0,1,0
5,432,432,41,41,0,1,0
3,455,455,24,24,0,1,0
7,457,457,108,108,0,1,0
11,470,470,21,21,0,1,0
1,493,493,132,13,119,4,3

19,106,106,29,4,25,2,1
7,109,109,3,3,0,1,0
2,112,112,10,10,0,1,0
4,156,156,17,10,7,2,1
12,161,161,1,1,0,1,0
11,167,167,30,30,0,1,0
0,180,180,35,16,19,2,1
5,187,187,1,1,0,1,0
3,199,199,6,1,5,2,1
10,216,216,11,2,9,2,1
16,221,221,3,3,0,1,0
6,253,253,2,2,0,1,0
1,254,254,41,41,0,1,0
8,258,258,9,5,4,2,1
20,273,273,7,7,0,1,0
14,323,323,25,25,0,1,0
15,352,352,2,2,0,1,0
21,360,360,52,36,16,2,1
18,369,369,39,15,24,3,2
17,445,445,51,51,0,1,0
9,462,462,3,3,0,1,0
13,498,498,75,32,43,2,1

8,109,109,2,2,0,1,0
1,121,121,5,5,0,1,0
10,152,152,28,28,0,1,0
7,163,163,15,15,0,1,0
11,180,180,48,14,34,3,2
21,218,218,6,6,0,1,0
0,244,244,10,3,7,2,1
13,264,264,10,1,9,2,1
14,277,277,46,20,26,2,1
20,300,300,60,60,0,1,0
17,325,325,48,4,44,3,2
6,332,332,36,36,0,1,0
12,364,364,4,4,0,1,0
4,365,365,3,3,0,1,0
2,384,384,14,5,9,2,1
9,434,434,6,2,4,2,1
15,439,439,18,18,0,1,0
5,450,450,19,19,0,1,0
16,475,475,77,23,54,4,3
19,487,487,40,26,14,2,1
3,492,492,19,13,6,3,2
18,500,500,25,15,10,2,1

6,144,144,5,5,0,1,0
18,144,144,7,7,0,1,0
17,150,150,29,2,27,2,1
7,173,173,22,22,0,1,0
12,195,195,59,8,51,4,3
13,219,219,6,1,5,2,1
14,223,223,9,2,7,2,1
4,238,238,4,4,0,1,0
15,244,244,12,12,0,1,0
16,318,318,3,3,0,1,0
5,350,350,13,9,4,2,1
9,357,357,4,4,0,1,0
19,357,357,71,26,45,2,1
2,359,359,47,47,0,1,0
3,365,365,17,17,0,1,0
8,413,413,23,2,21,4,3
1,440,440,23,23,0,1,0
10,454,454,16,16,0,1,0
0,455,455,102,60,42,4,3
20,463,463,21,21,0,1,0
11,500,500,65,9,56,3,2

10,120,120,10,1,9,2,1
20,138,138,5,5,0,1,0
13,162,162,1,1,0,1,0
22,176,176,1,1,0,1,0
11,184,184,1,1,0,1,0
2,191,191,3,3,0,1,0
23,202,202,23,17,6,3,2
12,206,206,10,10,0,1,0
17,225,225,20,20,0,1,0
0,271,271,9,6,3,2,1
21,274,274,36,8,28,3,2
14,298,298,1,1,0,1,0
4,308,308,65,23,42,3,2
15,317,317,58,7,51,4,3
6,317,317,23,5,18,4,3
19,339,339,109,51,58,3,2
9,348,348,29,29,0,1,0
5,384,384,8,8,0,1,0
18,386,386,9,9,0,1,0
1,396,396,57,57,0,1,0
8,424,424,26,3,23,2,1
7,468,468,44,44,0,1,0
3,468,468,9,9,0,1,0
16,499,499,8,4,4,2,1

10,152,152,1,1,0,1,0
13,179,179,33,9,24,2,1
8,212,212,17,17,0,1,0
6,254,254,19,1,18,3,2
7,269,269,27,16,11,2,1
1,270,270,54,2,52,3,2
2,272,272,48,31,17,2,1
14,282,282,92,32,60,3,2
9,283,283,2,2,0,1,0
15,315,315,13,8,5,2,1
3,336,336,6,6,0,1,0
4,343,343,2,2,0,1,0
0,368,368,118,118,0,1,0
5,391,391,2,2,0,1,0
16,410,410,91,23,68,3,2
12,437,437,14,5,9,2,1
11,493,493,9,3,6,3,2

6,128,128,3,3,0,1,0
11,151,151,34,34,0,1,0
15,160,160,13,1,12,4,3
8,172,172,11,11,0,1,0
4,203,203,16,16,0,1,0
7,251,251,1,1,0,1,0
9,266,266,3,3,0,1,0
14,300,300,53,53,0,1,0
12,323,323,6,6,0,1,0
13,327,327,62,30,32,2,1
3,362,362,3,3,0,1,0
2,395,395,82,82,0,1,0
1,416,416,145,79,66,3,2
0,417,417,58,58,0,1,0
10,443,443,65,65,0,1,0
5,470,470,46,21,25,2,1

0,107,107,9,9,0,1,0
1,108,108,5,5,0,1,0
3,151,151,10,10,0,1,0
7,192,192,9,9,0,1,0
5,194,194,15,15,0,1,0
13,256,256,13,5,8,2,1
4,289,289,76,76,0,1,0
14,311,311,27,11,16,3,2
12,333,333,13,7,6,2,1
11,334,334,45,45,0,1,0
8,346,346,45,45,0,1,0
6,377,377,30,30,0,1,0
10,399,399,98,27,71,3,2
9,417,417,26,4,22,3,2
2,477,477,136,49,87,4,3
15,482,482,58,9,49,2,1

16,161,161,1,1,0,1,0
11,168,168,41,41,0,1,0
13,177,177,14,14,0,1,0
6,193,193,18,6,12,3,2
4,203,203,31,31,0,1,0
5,240,240,15,15,0,1,0
3,286,286,10,10,0,1,0
15,313,313,96,96,0,1,0
7,334,334,41,41,0,1,0
1,356,356,3,3,0,1,0
9,377,377,39,39,0,1,0
0,404,404,12,4,8,3,2
17,413,413,16,16,0,1,0
18,413,413,1,1,0,1,0
2,417,417,19,10,9,4,3
14,426,426,26,26,0,1,0
10,426,426,48,48,0,1,0
8,432,432,58,46,12,3,2
19,473,473,23,13,10,3,2
12,482,482,60,60,0,1,0

7,140,140,3,3,0,1,0
13,152,152,45,34,11,2,1
12,200,200,21,9,12,4,3
6,205,205,16,4,12,2,1
5,208,208,29,29,0,1,0
9,210,210,28,7,21,2,1
8,225,225,5,5,0,1,0
2,252,252,18,12,6,2,1
1,260,260,28,28,0,1,0
15,260,260,6,6,0,1,0
14,283,283,63,18,45,4,3
10,327,327,29,18,11,2,1
3,355,355,63,6,57,4,3
4,364,364,14,8,6,2,1
0,468,468,136,67,69,4,3
11,470,470,8,8,0,1,0

1,114,114,12,12,0,1,0
10,172,172,11,1,10,3,2
11,198,198,14,14,0,1,0
5,255,255,11,2,9,2,1
14,287,287,24,24,0,1,0
15,312,312,78,26,52,3,2
4,332,332,45,45,0,1,0
12,364,364,13,13,0,1,0
3,367,367,107,60,47,3,2
8,376,376,31,19,12,4,3
13,396,396,81,81,0,1,0
9,406,406,48,18,30,4,3
2,410,410,64,64,0,1,0
6,410,410,32,32,0,1,0
0,455,455,42,24,18,4,3
7,482,482,1,1,0,1,0

6,105,105,44,44,0,1,0
15,110,110,11,11,0,1,0
10,126,126,32,32,0,1,0
3,139,139,1,1,0,1,0
0,173,173,40,10,30,2,1
14,180,180,2,2,0,1,0
2,182,182,3,3,0,1,0
12,246,246,61,13,48,4,3
8,263,263,8,2,6,3,2
9,356,356,39,19,20,2,1
5,358,358,48,48,0,1,0
13,387,387,23,23,0,1,0
7,393,393,4,4,0,1,0
11,427,427,42,42,0,1,0
1,446,446,9,1,8,2,1
4,482,482,30,30,0,1,0
16,492,492,2,2,0,1,0

4,109,109,4,1,3,2,1
0,121,121,3,3,0,1,0
19,131,131,28,10,18,3,2
15,158,158,10,2,8,2,1
5,166,166,22,3,19,2,1
6,182,182,3,3,0,1,0
7,185,185,1,1,0,1,0
16,207,207,13,4,9,4,3
14,216,216,1,1,0,1,0
17,248,248,17,13,4,2,1
1,292,292,49,29,20,3,2
13,307,307,14,14,0,1,0
20,326,326,71,11,60,3,2
8,357,357,123,87,36,4,3
11,374,374,5,1,4,2,1
2,378,378,32,32,0,1,0
3,385,385,13,13,0,1,0
10,430,430,10,10,0,1,0
18,450,450,22,14,8,2,1
12,474,474,90,29,61,3,2
9,484,484,9,9,0,1,0

2,104,104,1,1,0,1,0
9,105,105,1,1,0,1,0
6,128,128,5,2,3,2,1
14,146,146,4,1,3,2,1
10,161,161,42,42,0,1,0
15,164,164,12,12,0,1,0
3,192,192,3,3,0,1,0
18,231,231,14,14,0,1,0
19,247,247,8,8,0,1,0
7,250,250,11,11,0,1,0
0,267,267,17,3,14,2,1
22,290,290,28,9,19,4,3
21,320,320,18,3,15,2,1
5,322,322,60,11,49,2,1
23,350,350,16,4,12,3,2
11,352,352,5,5,0,1,0
1,372,372,4,4,0,1,0
12,379,379,18,18,0,1,0
17,381,381,140,123,17,2,1
13,382,382,6,6,0,1,0
16,393,393,31,31,0,1,0
8,405,405,60,60,0,1,0
4,421,421,4,1,3,2,1
20,447,447,49,49,0,1,0

10,111,111,5,5,0,1,0
16,136,136,8,8,0,1,0
17,137,137,63,37,26,3,2
12,138,138,10,10,0,1,0
14,156,156,1,1,0,1,0
13,160,160,1,1,0,1,0
11,175,175,27,10,17,2,1
1,226,226,14,3,11,2,1
0,237,237,13,2,11,2,1
4,238,238,8,8,0,1,0
15,247,247,13,4,9,2,1
6,317,317,99,9,90,4,3
9,367,367,26,15,11,3,2
2,371,371,2,2,0,1,0
7,379,379,24,16,8,2,1
8,449,449,10,6,4,2,1
3,468,468,143,115,28,3,2
5,470,470,20,20,0,1,0

12,136,136,2,2,0,1,0
1,157,157,47,47,0,1,0
19,169,169,20,20,0,1,0
10,172,172,2,2,0,1,0
5,189,189,11,4,7,2,1
8,205,205,9,3,6,3,2
20,224,224,1,1,0,1,0
17,238,238,1,1,0,1,0
11,242,242,41,1,40,3,2
16,280,280,44,44,0,1,0
18,283,283,27,27,0,1,0
9,315,315,5,5,0,1,0
7,316,316,25,25,0,1,0
21,336,336,95,95,0,1,0
14,362,362,3,3,0,1,0
15,380,380,2,2,0,1,0
6,395,395,12,5,7,2,1
0,407,407,1,1,0,1,0
3,421,421,39,17,22,2,1
4,441,441,31,31,0,1,0
2,461,461,6,6,0,1,0
13,488,488,116,71,45,4,3

9,108,108,3,3,0,1,0
3,136,136,1,1,0,1,0
17,168,168,1,1,0,1,0
16,178,178,15,15,0,1,0
19,186,186,21,21,0,1,0
22,189,189,29,19,10,3,2
2,219,219,3,3,0,1,0
23,262,262,3,3,0,1,0
4,266,266,3,3,0,1,0
13,283,283,21,21,0,1,0
8,313,313,4,4,0,1,0
12,314,314,20,20,0,1,0
24,322,322,94,94,0,1,0
15,333,333,5,5,0,1,0
21,341,341,4,4,0,1,0
6,353,353,26,21,5,2,1
7,356,356,2,2,0,1,0
5,367,367,86,48,38,3,2
20,392,392,83,34,49,2,1
1,395,395,15,15,0,1,0
11,438,438,29,29,0,1,0
10,461,461,57,25,32,2,1
14,462,462,51,51,0,1,0
18,468,468,15,15,0,1,0
0,473,473,11,4,7,2,1

1,118,118,20,5,15,2,1
14,137,137,32,32,0,1,0
2,141,141,41,41,0,1,0
7,163,163,11,11,0,1,0
4,200,200,1,1,0,1,0
5,209,209,29,29,0,1,0
9,218,218,15,3,12,2,1
10,251,251,17,8,9,2,1
11,266,266,5,2,3,2,1
16,283,283,8,8,0,1,0
12,297,297,83,83,0,1,0
8,318,318,47,8,39,4,3
0,326,326,20,20,0,1,0
6,397,397,21,21,0,1,0
15,417,417,26,2,24,2,1
13,445,445,1,1,0,1,0
3,484,484,58,58,0,1,0

7,107,107,1,1,0,1,0
10,116,116,2,2,0,1,0
14,121,121,2,2,0,1,0
8,123,123,1,1,0,1,0
24,124,124,23,9,14,2,1
23,187,187,2,2,0,1,0
17,199,199,40,22,18,4,3
16,208,208,4,4,0,1,0
18,227,227,30,30,0,1,0
15,266,266,78,78,0,1,0
19,341,341,55,55,0,1,0
13,347,347,18,2,16,3,2
2,348,348,8,5,3,2,1
1,362,362,19,9,10,3,2
11,373,373,33,9,24,3,2
22,377,377,25,25,0,1,0
21,383,383,21,8,13,2,1
12,387,387,29,5,24,3,2
5,410,410,1,1,0,1,0
20,419,419,40,15,25,3,2
9,422,422,43,22,21,2,1
6,422,422,5,5,0,1,0
3,439,439,24,24,0,1,0
0,457,457,12,12,0,1,0
4,482,482,33,15,18,4,3

15,127,127,21,21,0,1,0
5,149,149,5,2,3,2,1
0,182,182,4,1,3,2,1
3,234,234,9,9,0,1,0
7,244,244,1,1,0,1,0
4,296,296,28,28,0,1,0
8,320,320,73,33,40,2,1
11,332,332,55,55,0,1,0
13,357,357,7,4,3,2,1
14,366,366,2,2,0,1,0
1,368,368,7,7,0,1,0
17,383,383,82,34,48,4,3
2,384,384,8,8,0,1,0
10,385,385,28,18,10,3,2
9,421,421,20,11,9,4,3
16,440,440,67,67,0,1,0
12,442,442,30,20,10,2,1
6,484,484,213,213,0,1,0

12,104,104,8,8,0,1,0
2,113,113,1,1,0,1,0
11,118,118,18,10,8,3,2
7,170,170,11,11,0,1,0
8,186,186,3,3,0,1,0
5,200,200,28,28,0,1,0
17,231,231,41,41,0,1,0
1,270,270,5,2,3,2,1
13,278,278,52,16,36,3,2
9,289,289,53,5,48,3,2
16,306,306,9,6,3,2,1
0,326,326,52,52,0,1,0
15,327,327,8,8,0,1,0
6,338,338,39,23,16,2,1
14,343,343,62,58,4,2,1
18,383,383,8,8,0,1,0
3,390,390,1,1,0,1,0
20,405,405,44,8,36,3,2
4,455,455,16,16,0,1,0
10,477,477,4,4,0,1,0
19,496,496,55,55,0,1,0

7,137,137,6,6,0,1,0
10,150,150,8,8,0,1,0
20,153,153,29,29,0,1,0
19,162,162,25,1,24,4,3
15,192,192,44,15,29,2,1
4,215,215,45,29,16,2,1
2,216,216,4,4,0,1,0
14,221,221,6,2,4,2,1
0,251,251,1,1,0,1,0
1,272,272,11,8,3,2,1
5,282,282,13,1,12,3,2
9,285,285,47,6,41,3,2
16,301,301,19,4,15,3,2
13,303,303,9,9,0,1,0
8,315,315,25,25,0,1,0
3,344,344,50,50,0,1,0
18,379,379,33,20,13,2,1
17,403,403,34,5,29,2,1
11,433,433,31,31,0,1,0
6,440,440,11,11,0,1,0
12,478,478,26,5,21,2,1

11,112,112,9,1,8,3,2
4,136,136,24,9,15,4,3
14,145,145,2,2,0,1,0
1,174,174,4,1,3,2,1
16,178,178,5,5,0,1,0
8,195,195,1,1,0,1,0
13,197,197,39,39,0,1,0
10,248,248,8,4,4,2,1
0,252,252,51,19,32,2,1
5,271,271,28,28,0,1,0
6,288,288,31,31,0,1,0
12,290,290,28,28,0,1,0
3,310,310,80,56,24,3,2
15,392,392,72,44,28,3,2
2,450,450,12,9,3,2,1
9,458,458,130,122,8,2,1
7,464,464,2,2,0,1,0

2,122,122,23,23,0,1,0
19,140,140,17,3,14,3,2
11,156,156,1,1,0,1,0
0,175,175,3,3,0,1,0
10,175,175,1,1,0,1,0
21,186,186,10,10,0,1,0
15,196,196,9,2,7,2,1
3,219,219,6,6,0,1,0
20,237,237,52,24,28,2,1
6,241,241,22,13,9,2,1
13,241,241,3,3,0,1,0
7,270,270,6,6,0,1,0
9,276,276,6,3,3,2,1
4,306,306,102,90,12,3,2
8,344,344,26,26,0,1,0
17,354,354,20,16,4,2,1
5,366,366,1,1,0,1,0
18,401,401,79,79,0,1,0
16,415,415,6,6,0,1,0
14,453,453,16,16,0,1,0
22,472,472,84,84,0,1,0
1,473,473,35,35,0,1,0
12,480,480,11,11,0,1,0

6,105,105,8,8,0,1,0
5,112,112,3,3,0,1,0
8,128,128,4,4,0,1,0
1,160,160,30,10,20,3,2
2,184,184,8,8,0,1,0
4,201,201,15,15,0,1,0
13,202,202,12,12,0,1,0
0,210,210,1,1,0,1,0
18,260,260,2,2,0,1,0
10,262,262,17,17,0,1,0
12,268,268,29,29,0,1,0
17,306,306,38,38,0,1,0
9,321,321,13,2,11,3,2
11,332,332,76,76,0,1,0
16,336,336,9,2,7,2,1
14,368,368,22,10,12,3,2
19,371,371,18,18,0,1,0
15,404,404,104,44,60,4,3
3,443,443,55,22,33,4,3
7,489,489,111,97,14,4,3

12,111,111,12,12,0,1,0
5,130,130,29,17,12,4,3
16,147,147,34,6,28,3,2
17,177,177,3,3,0,1,0
1,203,203,8,4,4,2,1
18,229,229,24,24,0,1,0
11,237,237,49,49,0,1,0
3,237,237,14,2,12,4,3
13,242,242,3,3,0,1,0
7,249,249,41,41,0,1,0
0,249,249,2,2,0,1,0
9,278,278,38,21,17,4,3
8,362,362,17,2,15,4,3
14,366,366,33,15,18,3,2
15,406,406,8,8,0,1,0
2,429,429,53,53,0,1,0
6,441,441,16,4,12,2,1
10,457,457,62,8,54,3,2
4,489,489,31,14,17,2,1

4,100,100,9,9,0,1,0
7,118,118,8,8,0,1,0
19,119,119,9,9,0,1,0
9,122,122,13,2,11,2,1
11,129,129,8,8,0,1,0
23,188,188,23,23,0,1,0
25,191,191,33,33,0,1,0
12,203,203,19,10,9,4,3
10,216,216,1,1,0,1,0
6,229,229,14,2,12,3,2
13,240,240,4,4,0,1,0
22,256,256,19,2,17,2,1
8,257,257,52,52,0,1,0
2,265,265,1,1,0,1,0
1,328,328,13,13,0,1,0
17,329,329,5,1,4,2,1
5,338,338,3,3,0,1,0
15,384,384,4,1,3,2,1
24,386,386,5,1,4,2,1
20,404,404,39,39,0,1,0
14,413,413,39,39,0,1,0
18,432,432,136,136,0,1,0
16,435,435,10,10,0,1,0
21,460,460,14,2,12,4,3
0,476,476,3,3,0,1,0
3,497,497,5,5,0,1,0

15,106,106,3,3,0,1,0
3,133,133,41,41,0,1,0
17,191,191,5,5,0,1,0
11,192,192,18,10,8,2,1
7,196,196,1,1,0,1,0
6,208,208,40,6,34,2,1
13,226,226,8,2,6,2,1
2,231,231,21,1,20,3,2
16,237,237,31,28,3,2,1
4,237,237,32,32,0,1,0
10,259,259,1,1,0,1,0
12,268,268,61,61,0,1,0
5,348,348,3,3,0,1,0
9,348,348,10,10,0,1,0
1,360,360,27,4,23,3,2
18,378,378,56,56,0,1,0
0,440,440,21,18,3,2,1
14,450,450,100,100,0,1,0
8,459,459,5,5,0,1,0

13,116,116,18,18,0,1,0
2,128,128,2,2,0,1,0
1,136,136,12,1,11,2,1
4,147,147,22,22,0,1,0
3,169,169,27,11,16,2,1
17,174,174,2,2,0,1,0
8,183,183,28,5,23,2,1
6,192,192,4,4,0,1,0
16,198,198,33,5,28,2,1
5,226,226,9,5,4,2,1
12,248,248,7,2,5,2,1
9,353,353,33,33,0,1,0
15,354,354,11,11,0,1,0
14,356,356,75,75,0,1,0
18,374,374,10,10,0,1,0
10,382,382,5,5,0,1,0
11,415,415,115,105,10,2,1
7,422,422,32,27,5,2,1
0,472,472,49,49,0,1,0

1,128,128,1,1,0,1,0
5,130,130,1,1,0,1,0
8,142,142,23,23,0,1,0
7,143,143,8,4,4,2,1
14,156,156,2,2,0,1,0
16,166,166,15,5,10,2,1
0,171,171,11,5,6,2,1
15,209,209,2,2,0,1,0
10,226,226,29,20,9,4,3
3,233,233,25,25,0,1,0
2,253,253,43,43,0,1,0
18,295,295,39,21,18,4,3
13,305,305,61,17,44,2,1
9,351,351,5,1,4,2,1
6,383,383,18,18,0,1,0
11,383,383,21,21,0,1,0
19,388,388,46,46,0,1,0
12,420,420,115,115,0,1,0
17,432,432,8,4,4,2,1
4,462,462,63,51,12,2,1

7,125,125,13,1,12,3,2
3,129,129,11,11,0,1,0
2,191,191,36,10,26,3,2
0,214,214,109,109,0,1,0
5,219,219,34,34,0,1,0
9,220,220,71,25,46,3,2
6,221,221,4,4,0,1,0
12,226,226,7,1,6,3,2
10,282,282,48,48,0,1,0
1,421,421,50,1,49,2,1
11,439,439,28,28,0,1,0
8,447,447,13,13,0,1,0
4,482,482,13,13,0,1,0

1,108,108,1,1,0,1,0
18,117,117,9,2,7,2,1
11,146,146,3,3,0,1,0
20,180,180,28,28,0,1,0
3,220,220,16,13,3,2,1
13,229,229,28,22,6,3,2
12,253,253,8,3,5,2,1
14,284,284,31,1,30,3,2
2,287,287,1,1,0,1,0
15,311,311,3,3,0,1,0
16,326,326,30,30,0,1,0
5,329,329,1,1,0,1,0
10,330,330,2,2,0,1,0
7,344,344,22,16,6,3,2
9,349,349,107,107,0,1,0
17,365,365,70,50,20,2,1
19,390,390,51,45,6,2,1
6,440,440,15,8,7,2,1
8,446,446,111,57,54,4,3
0,482,482,10,3,7,2,1
4,487,487,54,39,15,3,2

17,111,111,4,4,0,1,0
12,115,115,7,7,0,1,0
18,115,115,5,5,0,1,0
14,130,130,1,1,0,1,0
15,133,133,14,14,0,1,0
3,138,138,1,1,0,1,0
10,150,150,39,17,22,4,3
0,152,152,15,15,0,1,0
13,203,203,15,15,0,1,0
21,208,208,49,20,29,2,1
19,222,222,34,4,30,3,2
16,262,262,21,18,3,2,1
2,268,268,37,17,20,2,1
8,346,346,16,13,3,2,1
1,356,356,16,16,0,1,0
5,357,357,29,29,0,1,0
6,393,393,3,3,0,1,0
20,440,440,84,75,9,4,3
7,450,450,5,5,0,1,0
11,451,451,5,5,0,1,0
9,482,482,9,1,8,3,2
4,490,490,59,59,0,1,0

11,115,115,7,1,6,3,2
0,124,124,1,1,0,1,0
4,126,126,9,9,0,1,0
6,127,127,5,5,0,1,0
12,166,166,25,17,8,2,1
9,177,177,10,4,6,2,1
10,180,180,28,28,0,1,0
13,187,187,7,1,6,3,2
18,254,254,63,13,50,4,3
17,300,300,35,35,0,1,0
15,318,318,23,14,9,4,3
3,322,322,27,5,22,3,2
7,331,331,50,50,0,1,0
2,346,346,119,119,0,1,0
16,353,353,15,15,0,1,0
14,375,375,15,15,0,1,0
8,415,415,5,5,0,1,0
5,433,433,36,17,19,4,3
1,495,495,26,6,20,2,1

2,116,116,26,12,14,3,2
9,130,130,26,7,19,2,1
6,171,171,25,11,14,2,1
7,179,179,52,22,30,2,1
5,179,179,1,1,0,1,0
12,215,215,10,3,7,3,2
15,224,224,8,1,7,2,1
0,235,235,2,2,0,1,0
4,270,270,6,2,4,2,1
14,273,273,17,12,5,2,1
13,294,294,7,7,0,1,0
16,315,315,57,23,34,2,1
8,415,415,55,55,0,1,0
1,429,429,15,2,13,2,1
17,449,449,109,57,52,3,2
3,457,457,17,11,6,2,1
11,466,466,22,2,20,2,1
10,474,474,37,11,26,3,2

12,109,109,14,14,0,1,0
3,148,148,4,4,0,1,0
10,166,166,42,26,16,3,2
5,245,245,54,38,16,2,1
11,257,257,43,3,40,2,1
13,265,265,11,1,10,3,2
15,293,293,11,11,0,1,0
2,322,322,12,4,8,3,2
0,333,333,32,11,21,4,3
1,338,338,42,27,15,4,3
8,359,359,27,15,12,4,3
4,403,403,17,17,0,1,0
14,431,431,8,8,0,1,0
9,445,445,58,58,0,1,0
6,484,484,171,68,103,4,3
7,490,490,30,30,0,1,0

7,103,103,2,2,0,1,0
17,141,141,3,3,0,1,0
3,151,151,1,1,0,1,0
16,155,155,21,7,14,3,2
15,165,165,9,9,0,1,0
5,181,181,14,14,0,1,0
12,188,188,4,4,0,1,0
18,189,189,20,10,10,2,1
2,201,201,5,5,0,1,0
11,202,202,31,31,0,1,0
19,206,206,71,71,0,1,0
13,223,223,7,3,4,2,1
14,241,241,14,14,0,1,0
10,241,241,7,7,0,1,0
4,243,243,3,3,0,1,0
9,260,260,49,39,10,2,1
0,287,287,39,39,0,1,0
6,393,393,122,89,33,4,3
1,414,414,13,13,0,1,0
8,466,466,31,25,6,3,2

13,111,111,3,3,0,1,0
9,124,124,2,2,0,1,0
10,125,125,10,10,0,1,0
18,155,155,24,12,12,4,3
3,170,170,25,14,11,2,1
2,178,178,11,2,9,3,2
17,183,183,34,7,27,4,3
4,186,186,6,6,0,1,0
12,212,212,11,11,0,1,0
14,251,251,10,10,0,1,0
7,263,263,50,50,0,1,0
16,285,285,1,1,0,1,0
5,296,296,24,24,0,1,0
8,301,301,26,17,9,2,1
1,305,305,39,3,36,3,2
6,312,312,18,6,12,4,3
11,429,429,133,117,16,2,1
0,430,430,43,5,38,3,2
15,433,433,31,31,0,1,0

10,114,114,12,12,0,1,0
8,138,138,1,1,0,1,0
0,174,174,10,10,0,1,0
13,178,178,52,52,0,1,0
1,193,193,29,29,0,1,0
12,199,199,3,3,0,1,0
19,256,256,8,8,0,1,0
20,272,272,3,3,0,1,0
4,284,284,14,14,0,1,0
7,326,326,28,13,15,4,3
9,339,339,13,9,4,2,1
11,366,366,89,63,26,2,1
21,378,378,90,90,0,1,0
3,385,385,22,14,8,2,1
17,386,386,33,24,9,4,3
5,455,455,12,12,0,1,0
18,463,463,81,81,0,1,0
2,464,464,23,15,8,2,1
6,465,465,9,1,8,3,2
16,481,481,2,2,0,1,0
14,486,486,2,2,0,1,0
15,493,493,38,38,0,1,0

1,106,106,4,4,0,1,0
10,112,112,5,5,0,1,0
2,135,135,63,63,0,1,0
12,148,148,27,15,12,3,2
13,215,215,16,7,9,4,3
7,219,219,11,6,5,2,1
4,237,237,4,4,0,1,0
11,261,261,17,2,15,2,1
3,318,318,71,55,16,3,2
8,325,325,9,9,0,1,0
0,408,408,65,47,18,4,3
9,422,422,12,12,0,1,0
5,424,424,139,102,37,2,1
6,472,472,54,21,33,4,3

4,104,104,9,9,0,1,0
8,181,181,17,17,0,1,0
3,193,193,91,91,0,1,0
6,195,195,37,37,0,1,0
2,210,210,2,2,0,1,0
10,228,228,8,8,0,1,0
14,249,249,41,41,0,1,0
1,250,250,58,58,0,1,0
9,288,288,9,3,6,2,1
12,296,296,25,11,14,3,2
13,299,299,12,7,5,2,1
5,310,310,4,4,0,1,0
11,379,379,21,13,8,2,1
0,449,449,40,40,0,1,0
7,467,467,106,30,76,3,2

1,110,110,21,7,14,3,2
8,121,121,58,5,53,4,3
13,136,136,7,7,0,1,0
10,145,145,8,8,0,1,0
11,210,210,15,10,5,2,1
12,266,266,30,25,5,2,1
4,335,335,90,37,53,4,3
5,337,337,8,8,0,1,0
3,352,352,26,10,16,2,1
9,352,352,32,14,18,3,2
7,383,383,4,4,0,1,0
6,453,453,11,6,5,2,1
2,460,460,78,78,0,1,0
0,471,471,94,94,0,1,0

11,136,136,3,3,0,1,0
21,147,147,24,24,0,1,0
4,167,167,9,3,6,2,1
16,175,175,19,7,12,2,1
9,179,179,3,3,0,1,0
19,199,199,5,5,0,1,0
14,208,208,3,3,0,1,0
13,232,232,10,2,8,3,2
10,271,271,11,4,7,2,1
23,274,274,27,10,17,2,1
20,306,306,9,9,0,1,0
2,309,309,87,87,0,1,0
12,315,315,13,13,0,1,0
8,316,316,29,29,0,1,0
5,344,344,28,28,0,1,0
15,379,379,17,8,9,4,3
3,404,404,37,27,10,3,2
6,405,405,1,1,0,1,0
18,419,419,74,74,0,1,0
17,420,420,87,31,56,3,2
1,421,421,47,47,0,1,0
22,431,431,27,27,0,1,0
0,437,437,1,1,0,1,0
7,480,480,3,3,0,1,0

17,100,100,6,6,0,1,0
3,101,101,4,4,0,1,0
20,126,126,4,1,3,2,1
18,140,140,11,11,0,1,0
7,215,215,20,20,0,1,0
15,237,237,4,4,0,1,0
1,254,254,1,1,0,1,0
4,269,269,18,5,13,4,3
13,274,274,32,13,19,2,1
9,305,305,16,16,0,1,0
0,325,325,38,38,0,1,0
16,325,325,73,35,38,2,1
10,334,334,4,4,0,1,0
5,343,343,24,15,9,4,3
11,396,396,85,13,72,4,3
2,424,424,2,2,0,1,0
19,425,425,92,92,0,1,0
8,437,437,50,50,0,1,0
14,442,442,44,44,0,1,0
12,473,473,38,20,18,3,2
6,478,478,54,4,50,3,2

15,105,105,7,7,0,1,0
7,115,115,9,3,6,2,1
17,129,129,3,3,0,1,0
12,140,140,4,4,0,1,0
2,212,212,30,30,0,1,0
1,236,236,1,1,0,1,0
6,271,271,26,26,0,1,0
13,283,283,2,2,0,1,0
5,327,327,61,61,0,1,0
18,379,379,40,40,0,1,0
16,393,393,120,15,105,4,3
11,404,404,10,10,0,1,0
9,422,422,16,16,0,1,0
10,430,430,113,79,34,3,2
4,438,438,12,12,0,1,0
3,440,440,94,29,65,4,3
0,449,449,32,32,0,1,0
14,462,462,46,15,31,4,3
8,465,465,21,4,17,2,1

13,150,150,6,6,0,1,0
5,155,155,22,22,0,1,0
14,179,179,5,5,0,1,0
11,183,183,49,24,25,2,1
10,207,207,13,10,3,2,1
12,213,213,12,12,0,1,0
9,225,225,61,61,0,1,0
6,231,231,35,11,24,3,2
1,252,252,1,1,0,1,0
2,304,304,3,3,0,1,0
8,378,378,3,3,0,1,0
4,378,378,1,1,0,1,0
3,426,426,78,63,15,4,3
15,439,439,39,6,33,2,1
0,467,467,37,37,0,1,0
16,490,490,49,49,0,1,0
7,499,499,164,125,39,4,3

14,115,115,5,5,0,1,0
0,156,156,29,29,0,1,0
12,167,167,25,25,0,1,0
5,187,187,1,1,0,1,0
13,188,188,15,6,9,2,1
15,210,210,8,8,0,1,0
3,281,281,26,13,13,4,3
11,327,327,4,4,0,1,0
10,339,339,31,31,0,1,0
8,373,373,33,11,22,3,2
1,391,391,21,21,0,1,0
7,404,404,23,3,20,3,2
4,432,432,12,12,0,1,0
2,440,440,6,6,0,1,0
16,454,454,152,23,129,4,3
9,459,459,40,40,0,1,0
6,461,461,214,214,0,1,0

1,139,139,24,24,0,1,0
13,148,148,12,12,0,1,0
7,218,218,34,12,22,3,2
2,238,238,40,18,22,2,1
15,257,257,30,24,6,2,1
8,280,280,7,7,0,1,0
5,292,292,15,12,3,2,1
12,303,303,10,7,3,2,1
11,321,321,3,3,0,1,0
10,322,322,57,57,0,1,0
4,327,327,19,4,15,4,3
14,345,345,31,12,19,2,1
16,369,369,30,30,0,1,0
9,394,394,118,118,0,1,0
3,448,448,48,30,18,2,1
6,475,475,81,81,0,1,0
0,489,489,8,2,6,3,2

10,110,110,4,4,0,1,0
12,170,170,27,21,6,3,2
17,189,189,38,11,27,4,3
18,200,200,3,3,0,1,0
11,223,223,21,1,20,2,1
13,234,234,31,31,0,1,0
19,294,294,71,56,15,2,1
2,300,300,26,26,0,1,0
7,305,305,10,10,0,1,0
5,318,318,15,15,0,1,0
1,340,340,22,22,0,1,0
4,347,347,12,12,0,1,0
16,359,359,27,14,13,4,3
20,367,367,5,5,0,1,0
3,377,377,3,3,0,1,0
15,403,403,9,4,5,2,1
14,406,406,21,7,14,3,2
9,421,421,85,85,0,1,0
8,439,439,30,9,21,2,1
0,466,466,67,67,0,1,0
6,492,492,42,4,38,3,2

3,154,154,13,13,0,1,0
12,184,184,10,10,0,1,0
17,193,193,3,3,0,1,0
10,212,212,12,12,0,1,0
0,217,217,11,3,8,2,1
1,234,234,14,14,0,1,0
6,261,261,46,46,0,1,0
9,272,272,1,1,0,1,0
5,304,304,13,1,12,3,2
11,330,330,57,33,24,4,3
14,330,330,25,25,0,1,0
7,376,376,142,126,16,3,2
15,379,379,64,15,49,3,2
2,386,386,17,6,11,3,2
4,443,443,8,8,0,1,0
8,467,467,21,21,0,1,0
13,475,475,29,8,21,3,2
16,495,495,80,38,42,2,1
18,497,497,76,38,38,3,2

5,112,112,9,9,0,1,0
6,136,136,1,1,0,1,0
18,138,138,7,7,0,1,0
4,186,186,2,2,0,1,0
9,201,201,17,11,6,2,1
3,206,206,10,10,0,1,0
2,208,208,20,2,18,4,3
15,264,264,4,4,0,1,0
24,283,283,9,9,0,1,0
21,307,307,53,53,0,1,0
1,331,331,20,20,0,1,0
10,350,350,1,1,0,1,0
14,354,354,17,17,0,1,0
7,357,357,13,13,0,1,0
0,363,363,4,4,0,1,0
17,382,382,11,11,0,1,0
20,398,398,56,56,0,1,0
23,406,406,52,52,0,1,0
8,408,408,10,10,0,1,0
13,427,427,130,79,51,4,3
16,427,427,14,14,0,1,0
11,437,437,24,24,0,1,0
22,473,473,95,95,0,1,0
12,487,487,8,8,0,1,0
19,494,494,62,62,0,1,0

4,134,134,9,9,0,1,0
3,136,136,18,18,0,1,0
15,160,160,2,2,0,1,0
10,177,177,52,24,28,2,1
7,230,230,16,16,0,1,0
9,242,242,17,17,0,1,0
0,251,251,3,3,0,1,0
12,255,255,8,1,7,2,1
2,300,300,35,6,29,2,1
5,358,358,64,31,33,2,1
14,383,383,30,10,20,3,2
6,420,420,8,2,6,3,2
17,424,424,12,12,0,1,0
16,442,442,29,29,0,1,0
11,443,443,120,75,45,2,1
13,463,463,30,30,0,1,0
8,468,468,44,20,24,4,3
1,499,499,106,25,81,4,3

12,120,120,3,3,0,1,0
15,126,126,10,4,6,3,2
8,178,178,5,5,0,1,0
9,210,210,35,35,0,1,0
5,215,215,21,4,17,4,3
7,232,232,29,29,0,1,0
10,268,268,45,37,8,3,2
13,288,288,44,44,0,1,0
11,296,296,50,50,0,1,0
2,327,327,1,1,0,1,0
3,370,370,68,46,22,3,2
6,377,377,2,2,0,1,0
4,382,382,10,5,5,2,1
0,402,402,31,31,0,1,0
1,424,424,163,136,27,2,1
14,429,429,52,12,40,4,3
16,450,450,3,3,0,1,0

6,109,109,16,8,8,3,2
8,110,110,5,5,0,1,0
19,118,118,8,8,0,1,0
4,154,154,1,1,0,1,0
10,158,158,2,2,0,1,0
17,164,164,21,13,8,3,2
15,165,165,25,1,24,2,1
12,181,181,29,29,0,1,0
14,249,249,11,11,0,1,0
2,255,255,111,96,15,4,3
9,276,276,7,2,5,2,1
3,285,285,24,9,15,4,3
13,298,298,14,14,0,1,0
7,315,315,34,34,0,1,0
11,332,332,43,43,0,1,0
1,332,332,2,2,0,1,0
0,361,361,2,2,0,1,0
18,380,380,55,3,52,3,2
5,432,432,13,13,0,1,0
16,457,457,20,20,0,1,0

4,100,100,25,25,0,1,0
9,103,103,9,9,0,1,0
3,118,118,14,8,6,3,2
0,129,129,26,26,0,1,0
7,133,133,5,5,0,1,0
14,135,135,25,25,0,1,0
18,140,140,14,14,0,1,0
5,145,145,13,13,0,1,0
17,151,151,16,16,0,1,0
12,157,157,30,30,0,1,0
1,194,194,8,8,0,1,0
15,251,251,3,3,0,1,0
6,261,261,7,4,3,2,1
13,312,312,27,8,19,2,1
10,338,338,10,10,0,1,0
16,398,398,36,36,0,1,0
2,461,461,3,3,0,1,0
8,466,466,21,21,0,1,0
11,478,478,56,56,0,1,0

1,144,144,2,2,0,1,0
7,166,166,9,2,7,3,2
17,194,194,7,7,0,1,0
20,206,206,32,22,10,2,1
10,227,227,3,3,0,1,0
13,244,244,17,17,0,1,0
16,274,274,7,7,0,1,0
15,293,293,38,38,0,1,0
9,299,299,29,29,0,1,0
8,325,325,3,3,0,1,0
4,340,340,18,18,0,1,0
19,342,342,5,2,3,2,1
2,408,408,19,10,9,4,3
11,410,410,24,9,15,2,1
12,410,410,8,8,0,1,0
18,423,423,89,89,0,1,0
5,424,424,31,31,0,1,0
21,426,426,90,27,63,4,3
3,426,426,7,1,6,3,2
0,444,444,34,34,0,1,0
14,493,493,31,23,8,3,2
6,500,500,185,170,15,4,3

9,144,144,9,6,3,2,1
16,173,173,9,9,0,1,0
13,199,199,7,1,6,3,2
10,252,252,20,20,0,1,0
14,265,265,46,46,0,1,0
15,300,300,14,14,0,1,0
12,324,324,71,71,0,1,0
2,378,378,106,106,0,1,0
4,390,390,46,3,43,2,1
7,393,393,68,34,34,3,2
6,398,398,5,5,0,1,0
5,406,406,29,29,0,1,0
1,411,411,22,22,0,1,0
17,415,415,42,18,24,4,3
0,418,418,4,4,0,1,0
3,423,423,39,35,4,2,1
11,448,448,29,29,0,1,0
8,480,480,13,13,0,1,0
18,492,492,70,70,0,1,0

10,180,180,83,83,0,1,0
4,201,201,21,21,0,1,0
8,201,201,3,3,0,1,0
0,261,261,19,7,12,4,3
2,263,263,157,117,40,2,1
9,346,346,10,10,0,1,0
6,351,351,22,2,20,3,2
5,363,363,9,9,0,1,0
7,406,406,36,6,30,2,1
1,418,418,97,55,42,2,1
11,422,422,39,39,0,1,0
3,434,434,15,15,0,1,0

7,101,101,10,10,0,1,0
14,141,141,15,15,0,1,0
1,155,155,28,28,0,1,0
3,164,164,33,6,27,4,3
10,165,165,20,20,0,1,0
8,237,237,4,4,0,1,0
6,241,241,2,2,0,1,0
9,271,271,7,4,3,2,1
11,289,289,46,46,0,1,0
4,292,292,40,40,0,1,0
12,297,297,16,16,0,1,0
2,319,319,63,63,0,1,0
13,348,348,9,9,0,1,0
0,353,353,14,4,10,3,2
5,378,378,17,11,6,2,1
16,405,405,142,142,0,1,0
15,409,409,24,4,20,3,2

5,101,101,9,5,4,2,1
1,108,108,18,18,0,1,0
14,108,108,7,7,0,1,0
12,193,193,28,28,0,1,0
2,212,212,22,13,9,4,3
9,235,235,26,4,22,2,1
0,251,251,9,1,8,2,1
3,275,275,70,33,37,2,1
11,276,276,38,16,22,2,1
6,334,334,38,38,0,1,0
15,342,342,48,5,43,2,1
10,357,357,22,22,0,1,0
8,363,363,13,5,8,3,2
13,370,370,24,24,0,1,0
7,389,389,62,5,57,4,3
4,478,478,66,66,0,1,0

1,112,112,1,1,0,1,0
17,150,150,5,2,3,2,1
20,176,176,3,3,0,1,0
7,190,190,6,6,0,1,0
4,211,211,1,1,0,1,0
10,213,213,16,16,0,1,0
9,247,247,5,5,0,1,0
19,268,268,6,6,0,1,0
15,269,269,61,43,18,2,1
0,315,315,28,8,20,3,2
2,332,332,70,70,0,1,0
18,335,335,45,10,35,2,1
6,338,338,78,14,64,3,2
3,348,348,5,5,0,1,0
14,350,350,45,45,0,1,0
13,358,358,125,21,104,4,3
11,358,358,18,18,0,1,0
5,429,429,4,1,3,2,1
16,449,449,1,1,0,1,0
8,465,465,73,73,0,1,0
12,478,478,3,3,0,1,0

12,100,100,14,14,0,1,0
2,106,106,1,1,0,1,0
11,160,160,1,1,0,1,0
6,167,167,21,21,0,1,0
0,243,243,115,93,22,2,1
3,254,254,5,5,0,1,0
5,267,267,93,65,28,2,1
4,292,292,9,6,3,2,1
8,377,377,77,77,0,1,0
13,380,380,50,50,0,1,0
14,382,382,14,8,6,3,2
10,418,418,52,17,35,2,1
1,468,468,9,2,7,3,2
7,470,470,54,54,0,1,0
9,471,471,14,2,12,2,1

2,116,116,1,1,0,1,0
9,152,152,14,14,0,1,0
3,153,153,8,8,0,1,0
5,199,199,2,2,0,1,0
15,200,200,1,1,0,1,0
11,248,248,1,1,0,1,0
4,262,262,22,4,18,3,2
7,266,266,19,3,16,3,2
13,267,267,3,3,0,1,0
10,309,309,16,5,11,2,1
17,316,316,94,58,36,2,1
16,323,323,26,26,0,1,0
18,330,330,32,2,30,2,1
1,342,342,84,15,69,4,3
8,356,356,27,22,5,2,1
0,403,403,29,5,24,4,3
14,415,415,130,130,0,1,0
6,424,424,82,82,0,1,0
12,459,459,27,27,0,1,0

25,106,106,16,16,0,1,0
21,108,108,4,1,3,2,1
4,116,116,11,1,10,2,1
24,133,133,8,8,0,1,0
7,137,137,8,8,0,1,0
22,137,137,4,4,0,1,0
11,221,221,18,3,15,4,3
16,224,224,11,11,0,1,0
8,228,228,8,8,0,1,0
10,229,229,5,5,0,1,0
15,234,234,3,3,0,1,0
0,235,235,8,8,0,1,0
19,286,286,40,40,0,1,0
23,288,288,8,2,6,2,1
5,297,297,14,7,7,2,1
18,308,308,7,7,0,1,0
17,319,319,2,2,0,1,0
6,323,323,22,22,0,1,0
13,330,330,35,35,0,1,0
12,365,365,17,13,4,2,1
14,375,375,10,10,0,1,0
9,399,399,46,46,0,1,0
3,430,430,7,2,5,2,1
1,435,435,34,34,0,1,0
26,440,440,8,8,0,1,0
2,464,464,1,1,0,1,0
20,494,494,215,119,96,4,3

7,152,152,7,2,5,2,1
1,157,157,41,41,0,1,0
0,171,171,2,2,0,1,0
19,172,172,15,15,0,1,0
17,183,183,7,7,0,1,0
3,225,225,11,11,0,1,0
9,243,243,32,14,18,4,3
16,280,280,17,17,0,1,0
2,288,288,2,2,0,1,0
8,289,289,23,23,0,1,0
5,289,289,8,8,0,1,0
6,339,339,4,1,3,2,1
4,385,385,55,55,0,1,0
12,397,397,3,3,0,1,0
11,404,404,44,44,0,1,0
10,424,424,10,10,0,1,0
14,437,437,18,18,0,1,0
15,444,444,37,37,0,1,0
13,462,462,106,82,24,2,1
18,467,467,40,40,0,1,0
20,472,472,132,132,0,1,0

17,119,119,9,9,0,1,0
7,119,119,5,5,0,1,0
19,169,169,3,3,0,1,0
11,181,181,42,42,0,1,0
14,181,181,10,10,0,1,0
20,185,185,19,19,0,1,0
5,207,207,31,22,9,4,3
8,208,208,22,22,0,1,0
9,220,220,3,3,0,1,0
18,225,225,36,2,34,2,1
15,229,229,10,10,0,1,0
12,237,237,86,86,0,1,0
16,240,240,10,10,0,1,0
2,252,252,2,2,0,1,0
10,285,285,37,10,27,2,1
1,292,292,3,3,0,1,0
13,313,313,19,9,10,3,2
3,362,362,24,24,0,1,0
4,412,412,20,20,0,1,0
6,445,445,22,22,0,1,0
0,488,488,22,22,0,1,0

1,116,116,5,5,0,1,0
7,214,214,11,2,9,2,1
2,219,219,30,18,12,3,2
10,231,231,1,1,0,1,0
6,271,271,5,1,4,2,1
16,281,281,105,105,0,1,0
4,315,315,1,1,0,1,0
3,327,327,30,30,0,1,0
15,341,341,3,3,0,1,0
9,343,343,8,8,0,1,0
14,343,343,68,24,44,3,2
12,369,369,27,27,0,1,0
11,400,400,49,39,10,3,2
13,407,407,38,13,25,4,3
0,416,416,87,37,50,3,2
17,418,418,5,5,0,1,0
5,438,438,97,27,70,4,3
8,454,454,57,18,39,4,3

11,115,115,5,5,0,1,0
14,152,152,8,5,3,2,1
7,169,169,3,3,0,1,0
17,183,183,23,8,15,2,1
10,217,217,66,22,44,4,3
0,220,220,16,16,0,1,0
6,242,242,51,51,0,1,0
8,256,256,3,3,0,1,0
9,265,265,53,41,12,2,1
2,266,266,52,52,0,1,0
13,306,306,15,6,9,4,3
4,338,338,28,28,0,1,0
12,364,364,53,14,39,2,1
5,371,371,7,7,0,1,0
1,417,417,19,19,0,1,0
15,430,430,45,45,0,1,0
16,441,441,40,40,0,1,0
18,443,443,1,1,0,1,0
3,450,450,20,15,5,2,1

18,113,113,2,2,0,1,0
14,145,145,35,31,4,2,1
7,203,203,7,2,5,2,1
17,220,220,19,19,0,1,0
9,222,222,3,3,0,1,0
3,223,223,19,13,6,2,1
16,228,228,12,12,0,1,0
0,258,258,4,4,0,1,0
15,271,271,11,11,0,1,0
21,276,276,44,44,0,1,0
5,301,301,35,11,24,3,2
1,310,310,16,16,0,1,0
20,322,322,84,84,0,1,0
8,352,352,1,1,0,1,0
4,363,363,10,10,0,1,0
6,383,383,42,17,25,2,1
10,409,409,47,47,0,1,0
2,419,419,6,1,5,2,1
11,424,424,82,82,0,1,0
12,439,439,53,29,24,4,3
19,440,440,14,14,0,1,0
13,468,468,17,9,8,2,1

0,136,136,21,21,0,1,0
5,184,184,7,7,0,1,0
7,198,198,4,4,0,1,0
14,221,221,21,21,0,1,0
12,244,244,10,10,0,1,0
4,279,279,66,66,0,1,0
6,288,288,43,43,0,1,0
8,328,328,72,72,0,1,0
16,330,330,1,1,0,1,0
17,344,344,41,3,38,2,1
2,366,366,1,1,0,1,0
1,373,373,18,14,4,2,1
9,409,409,12,2,10,3,2
10,414,414,37,17,20,2,1
15,433,433,122,88,34,2,1
11,447,447,71,29,42,3,2
13,456,456,42,42,0,1,0
3,485,485,16,3,13,2,1

0,104,104,1,1,0,1,0
13,121,121,13,13,0,1,0
17,152,152,14,3,11,2,1
5,165,165,33,21,12,3,2
1,179,179,24,3,21,4,3
18,180,180,3,3,0,1,0
11,215,215,40,12,28,3,2
14,218,218,12,12,0,1,0
7,283,283,7,3,4,2,1
15,290,290,26,26,0,1,0
10,327,327,54,54,0,1,0
8,336,336,5,1,4,2,1
12,359,359,3,3,0,1,0
6,367,367,1,1,0,1,0
2,370,370,36,8,28,3,2
4,387,387,53,36,17,2,1
3,449,449,40,40,0,1,0
9,462,462,89,70,19,2,1
16,481,481,99,47,52,4,3

7,109,109,9,9,0,1,0
21,114,114,4,4,0,1,0
5,122,122,8,1,7,2,1
1,130,130,15,15,0,1,0
8,138,138,11,7,4,2,1
20,143,143,10,10,0,1,0
3,165,165,3,3,0,1,0
19,195,195,27,9,18,2,1
9,204,204,29,15,14,3,2
6,232,232,12,1,11,2,1
2,233,233,13,1,12,4,3
10,235,235,23,8,15,4,3
18,239,239,15,7,8,2,1
17,287,287,27,6,21,4,3
15,288,288,49,16,33,4,3
12,313,313,6,6,0,1,0
0,313,313,15,2,13,2,1
4,420,420,6,1,5,2,1
13,448,448,4,1,3,2,1
22,455,455,24,24,0,1,0
11,473,473,48,48,0,1,0
16,474,474,16,16,0,1,0
14,500,500,133,34,99,4,3

15,107,107,30,20,10,2,1
12,117,117,21,11,10,2,1
6,148,148,6,6,0,1,0
0,179,179,18,18,0,1,0
10,207,207,32,32,0,1,0
7,225,225,22,22,0,1,0
17,264,264,71,71,0,1,0
4,267,267,24,24,0,1,0
11,269,269,4,4,0,1,0
18,284,284,26,19,7,2,1
20,288,288,20,2,18,3,2
1,316,316,6,6,0,1,0
16,326,326,17,17,0,1,0
3,360,360,5,5,0,1,0
9,388,388,36,2,34,3,2
19,394,394,29,5,24,3,2
5,428,428,24,12,12,4,3
8,447,447,9,9,0,1,0
13,452,452,2,2,0,1,0
14,461,461,17,17,0,1,0
2,494,494,13,13,0,1,0
21,500,500,21,16,5,2,1

18,138,138,5,5,0,1,0
3,144,144,7,7,0,1,0
24,149,149,20,3,17,2,1
2,155,155,5,5,0,1,0
11,183,183,5,5,0,1,0
21,189,189,22,4,18,3,2
0,204,204,4,4,0,1,0
6,213,213,55,25,30,3,2
12,216,216,15,15,0,1,0
13,216,216,14,14,0,1,0
25,234,234,30,19,11,2,1
10,237,237,7,7,0,1,0
23,238,238,8,8,0,1,0
8,258,258,5,5,0,1,0
17,290,290,32,32,0,1,0
9,349,349,38,38,0,1,0
15,353,353,5,5,0,1,0
14,368,368,6,1,5,2,1
5,397,397,5,5,0,1,0
16,415,415,41,41,0,1,0
7,429,429,1,1,0,1,0
1,439,439,19,19,0,1,0
4,463,463,16,16,0,1,0
20,479,479,50,44,6,2,1
19,481,481,115,115,0,1,0
22,500,500,10,10,0,1,0

7,147,147,16,16,0,1,0
15,164,164,37,37,0,1,0
14,187,187,6,6,0,1,0
10,188,188,30,30,0,1,0
0,236,236,16,16,0,1,0
1,248,248,61,41,20,2,1
8,252,252,43,43,0,1,0
13,298,298,17,17,0,1,0
9,299,299,5,1,4,2,1
2,308,308,76,22,54,3,2
3,308,308,1,1,0,1,0
5,362,362,36,36,0,1,0
12,375,375,20,20,0,1,0
11,376,376,35,35,0,1,0
6,392,392,10,2,8,2,1
4,455,455,97,97,0,1,0

8,103,103,1,1,0,1,0
5,109,109,13,10,3,2,1
0,126,126,6,2,4,2,1
16,139,139,1,1,0,1,0
2,141,141,1,1,0,1,0
12,170,170,28,28,0,1,0
9,188,188,7,7,0,1,0
14,191,191,54,30,24,4,3
10,241,241,81,81,0,1,0
15,327,327,6,6,0,1,0
7,340,340,2,2,0,1,0
11,360,360,25,14,11,2,1
20,376,376,14,14,0,1,0
18,380,380,61,61,0,1,0
6,395,395,28,3,25,2,1
1,399,399,48,48,0,1,0
4,400,400,1,1,0,1,0
19,406,406,65,65,0,1,0
17,413,413,36,17,19,2,1
13,420,420,2,2,0,1,0
3,459,459,35,1,34,2,1

12,102,102,1,1,0,1,0
19,104,104,5,5,0,1,0
1,144,144,11,11,0,1,0
18,146,146,5,5,0,1,0
9,180,180,10,1,9,4,3
5,196,196,23,23,0,1,0
22,197,197,8,8,0,1,0
17,209,209,11,2,9,2,1
20,216,216,19,9,10,3,2
4,297,297,38,38,0,1,0
3,315,315,1,1,0,1,0
11,316,316,10,1,9,2,1
24,349,349,169,108,61,4,3
21,357,357,5,5,0,1,0
23,358,358,34,34,0,1,0
16,364,364,22,22,0,1,0
0,370,370,1,1,0,1,0
7,400,400,19,5,14,3,2
10,412,412,26,16,10,2,1
8,422,422,14,4,10,3,2
2,432,432,12,12,0,1,0
13,455,455,76,68,8,2,1
6,468,468,34,26,8,2,1
15,472,472,23,2,21,2,1
14,489,489,8,8,0,1,0

11,178,178,42,18,24,2,1
9,202,202,20,3,17,2,1
7,226,226,67,67,0,1,0
14,256,256,4,1,3,2,1
2,267,267,45,45,0,1,0
10,272,272,1,1,0,1,0
5,281,281,60,60,0,1,0
4,286,286,34,4,30,4,3
0,291,291,50,4,46,2,1
1,327,327,61,12,49,3,2
6,341,341,7,1,6,2,1
15,391,391,17,17,0,1,0
8,397,397,13,13,0,1,0
12,437,437,6,6,0,1,0
13,446,446,76,76,0,1,0
3,494,494,11,3,8,2,1

9,139,139,18,18,0,1,0
8,152,152,14,14,0,1,0
3,154,154,11,11,0,1,0
13,173,173,31,19,12,3,2
10,270,270,24,24,0,1,0
4,275,275,114,10,104,4,3
12,278,278,6,3,3,2,1
0,294,294,50,20,30,2,1
5,307,307,27,12,15,3,2
2,308,308,9,3,6,3,2
6,344,344,31,2,29,2,1
1,352,352,76,30,46,3,2
7,376,376,42,42,0,1,0
11,390,390,46,46,0,1,0

20,143,143,26,12,14,2,1
13,169,169,5,5,0,1,0
18,170,170,24,4,20,3,2
7,181,181,15,15,0,1,0
10,226,226,1,1,0,1,0
2,270,270,1,1,0,1,0
11,279,279,8,2,6,3,2
8,279,279,14,5,9,3,2
5,328,328,26,23,3,2,1
12,328,328,28,7,21,4,3
4,344,344,33,33,0,1,0
3,347,347,93,69,24,4,3
14,362,362,17,17,0,1,0
6,365,365,73,73,0,1,0
17,376,376,1,1,0,1,0
9,400,400,12,9,3,2,1
1,422,422,3,3,0,1,0
15,423,423,69,26,43,2,1
0,484,484,25,25,0,1,0
19,484,484,97,66,31,4,3
16,496,496,36,17,19,2,1

8,165,165,27,24,3,2,1
3,182,182,6,3,3,2,1
18,198,198,31,22,9,2,1
0,200,200,1,1,0,1,0
7,231,231,31,26,5,2,1
4,249,249,4,4,0,1,0
1,263,263,6,6,0,1,0
11,279,279,8,3,5,2,1
10,298,298,6,6,0,1,0
14,310,310,20,20,0,1,0
9,320,320,24,2,22,4,3
2,320,320,3,3,0,1,0
17,331,331,29,29,0,1,0
6,339,339,11,11,0,1,0
12,342,342,98,23,75,4,3
13,369,369,97,71,26,4,3
19,431,431,41,41,0,1,0
21,445,445,54,39,15,4,3
20,452,452,8,8,0,1,0
5,483,483,36,2,34,3,2
15,489,489,34,10,24,3,2
16,491,491,18,18,0,1,0

13,103,103,16,6,10,2,1
9,153,153,13,5,8,3,2
12,192,192,37,37,0,1,0
2,241,241,49,4,45,2,1
17,255,255,26,26,0,1,0
8,291,291,45,5,40,3,2
4,294,294,7,7,0,1,0
6,325,325,19,15,4,2,1
11,327,327,2,2,0,1,0
5,339,339,46,46,0,1,0
1,340,340,57,57,0,1,0
16,355,355,14,14,0,1,0
3,360,360,7,7,0,1,0
10,396,396,6,3,3,2,1
14,423,423,24,16,8,2,1
15,451,451,122,19,103,4,3
0,463,463,22,22,0,1,0
7,487,487,45,9,36,2,1

15,106,106,1,1,0,1,0
5,114,114,17,14,3,2,1
10,139,139,25,25,0,1,0
9,217,217,25,25,0,1,0
1,239,239,12,12,0,1,0
3,271,271,28,5,23,2,1
11,276,276,25,1,24,4,3
14,280,280,5,5,0,1,0
6,311,311,87,16,71,4,3
12,312,312,112,63,49,2,1
2,323,323,8,2,6,2,1
13,329,329,16,16,0,1,0
8,331,331,20,20,0,1,0
7,349,349,12,12,0,1,0
4,420,420,40,40,0,1,0
0,439,439,88,73,15,2,1

15,104,104,21,11,10,2,1
8,122,122,3,3,0,1,0
14,145,145,1,1,0,1,0
12,153,153,9,9,0,1,0
11,177,177,16,16,0,1,0
6,178,178,18,18,0,1,0
13,186,186,2,2,0,1,0
16,210,210,38,7,31,2,1
1,220,220,13,7,6,3,2
4,223,223,5,5,0,1,0
3,250,250,36,36,0,1,0
7,267,267,9,9,0,1,0
9,275,275,17,17,0,1,0
0,312,312,25,14,11,2,1
10,335,335,10,4,6,3,2
18,340,340,25,25,0,1,0
19,340,340,80,38,42,2,1
2,410,410,18,10,8,2,1
5,434,434,131,98,33,4,3
17,495,495,32,32,0,1,0

10,155,155,17,5,12,4,3
1,171,171,4,4,0,1,0
15,188,188,37,7,30,2,1
8,209,209,8,5,3,2,1
9,214,214,18,13,5,2,1
7,266,266,4,4,0,1,0
0,306,306,22,5,17,2,1
3,347,347,10,10,0,1,0
12,354,354,68,2,66,3,2
6,359,359,78,6,72,3,2
14,416,416,2,2,0,1,0
2,420,420,8,4,4,2,1
16,430,430,24,24,0,1,0
13,458,458,53,53,0,1,0
11,459,459,56,4,52,3,2
4,461,461,98,98,0,1,0
5,492,492,155,23,132,4,3

12,147,147,9,9,0,1,0
13,150,150,13,13,0,1,0
9,170,170,19,12,7,2,1
11,180,180,36,16,20,3,2
4,184,184,1,1,0,1,0
14,202,202,26,17,9,4,3
2,284,284,18,18,0,1,0
8,311,311,9,9,0,1,0
0,333,333,61,61,0,1,0
7,354,354,45,45,0,1,0
3,393,393,21,8,13,2,1
6,411,411,64,12,52,3,2
1,441,441,67,67,0,1,0
5,447,447,198,126,72,4,3
10,487,487,7,2,5,2,1

5,112,112,1,1,0,1,0
15,137,137,1,1,0,1,0
3,142,142,8,8,0,1,0
0,211,211,1,1,0,1,0
11,226,226,8,2,6,3,2
6,248,248,2,2,0,1,0
14,257,257,3,3,0,1,0
9,276,276,21,1,20,2,1
19,280,280,16,7,9,2,1
13,290,290,40,40,0,1,0
4,300,300,18,18,0,1,0
10,322,322,115,115,0,1,0
18,369,369,10,10,0,1,0
12,377,377,74,70,4,2,1
16,396,396,59,38,21,4,3
20,407,407,129,105,24,4,3
17,410,410,6,6,0,1,0
7,414,414,21,21,0,1,0
1,447,447,11,5,6,3,2
2,474,474,95,15,80,3,2
8,475,475,9,9,0,1,0

8,109,109,20,20,0,1,0
13,118,118,6,6,0,1,0
6,153,153,4,4,0,1,0
14,154,154,8,8,0,1,0
0,184,184,13,13,0,1,0
5,258,258,48,34,14,2,1
2,264,264,78,78,0,1,0
12,264,264,12,12,0,1,0
3,269,269,51,51,0,1,0
4,272,272,18,18,0,1,0
11,319,319,23,1,22,3,2
9,328,328,56,27,29,3,2
7,399,399,89,48,41,4,3
1,425,425,30,13,17,2,1
15,447,447,30,30,0,1,0
10,470,470,28,14,14,2,1

0,105,105,9,9,0,1,0
2,160,160,6,3,3,2,1
17,177,177,5,5,0,1,0
5,188,188,3,3,0,1,0
6,189,189,1,1,0,1,0
9,243,243,4,4,0,1,0
7,246,246,2,2,0,1,0
14,247,247,6,6,0,1,0
16,279,279,26,26,0,1,0
10,284,284,14,14,0,1,0
18,293,293,48,48,0,1,0
19,309,309,14,2,12,2,1
11,311,311,11,11,0,1,0
8,313,313,16,16,0,1,0
12,319,319,116,116,0,1,0
3,342,342,24,24,0,1,0
13,401,401,4,4,0,1,0
20,422,422,28,28,0,1,0
15,442,442,53,53,0,1,0
4,443,443,68,20,48,3,2
1,461,461,172,131,41,2,1

13,105,105,7,7,0,1,0
16,109,109,6,3,3,2,1
1,129,129,2,2,0,1,0
18,131,131,42,42,0,1,0
6,152,152,1,1,0,1,0
8,202,202,14,14,0,1,0
10,253,253,58,58,0,1,0
9,279,279,30,16,14,3,2
11,301,301,6,2,4,2,1
19,315,315,32,24,8,2,1
2,322,322,17,17,0,1,0
3,334,334,48,48,0,1,0
17,337,337,13,5,8,3,2
5,340,340,66,46,20,2,1
4,342,342,9,9,0,1,0
0,347,347,10,1,9,4,3
20,398,398,14,14,0,1,0
14,417,417,15,7,8,3,2
7,425,425,3,3,0,1,0
15,451,451,49,49,0,1,0
12,473,473,77,11,66,4,3

13,100,100,7,7,0,1,0
0,197,197,36,36,0,1,0
10,206,206,9,6,3,2,1
8,210,210,46,46,0,1,0
12,245,245,15,15,0,1,0
7,249,249,90,20,70,3,2
4,330,330,26,2,24,3,2
11,366,366,2,2,0,1,0
5,372,372,46,1,45,4,3
1,418,418,146,146,0,1,0
9,423,423,12,1,11,2,1
3,467,467,17,17,0,1,0
2,493,493,126,26,100,3,2
6,496,496,5,5,0,1,0

13,130,130,2,2,0,1,0
2,141,141,13,1,12,3,2
1,179,179,12,1,11,2,1
9,184,184,52,52,0,1,0
7,248,248,31,31,0,1,0
16,302,302,2,2,0,1,0
18,306,306,22,10,12,2,1
12,312,312,12,12,0,1,0
4,327,327,20,14,6,3,2
6,344,344,36,22,14,3,2
17,373,373,53,53,0,1,0
5,397,397,3,3,0,1,0
0,420,420,1,1,0,1,0
3,456,456,32,32,0,1,0
14,476,476,6,1,5,2,1
11,484,484,179,137,42,4,3
10,492,492,73,73,0,1,0
15,494,494,53,53,0,1,0
8,499,499,45,45,0,1,0

2,105,105,7,7,0,1,0
13,158,158,5,5,0,1,0
8,174,174,14,14,0,1,0
0,216,216,2,2,0,1,0
7,220,220,12,6,6,3,2
19,230,230,3,3,0,1,0
3,270,270,7,7,0,1,0
5,291,291,27,12,15,4,3
4,296,296,13,7,6,2,1
11,319,319,29,15,14,4,3
12,333,333,4,4,0,1,0
15,337,337,15,15,0,1,0
18,346,346,4,4,0,1,0
9,352,352,56,56,0,1,0
20,406,406,54,54,0,1,0
16,426,426,45,21,24,3,2
17,448,448,46,46,0,1,0
6,448,448,82,54,28,3,2
14,458,458,211,72,139,4,3
10,461,461,15,15,0,1,0
1,473,473,29,14,15,4,3

14,138,138,3,3,0,1,0
12,240,240,9,9,0,1,0
5,252,252,40,40,0,1,0
6,317,317,38,24,14,2,1
1,334,334,20,8,12,2,1
13,337,337,51,30,21,4,3
7,353,353,24,24,0,1,0
3,360,360,41,15,26,3,2
11,378,378,8,8,0,1,0
10,390,390,35,35,0,1,0
16,395,395,126,126,0,1,0
8,395,395,11,11,0,1,0
4,398,398,75,75,0,1,0
9,457,457,60,60,0,1,0
2,459,459,86,2,84,4,3
0,465,465,3,3,0,1,0
15,473,473,57,57,0,1,0

9,121,121,16,10,6,2,1
13,146,146,10,1,9,4,3
4,157,157,18,18,0,1,0
8,199,199,13,9,4,2,1
16,220,220,12,12,0,1,0
10,227,227,82,16,66,3,2
15,227,227,7,7,0,1,0
2,277,277,26,26,0,1,0
7,305,305,20,20,0,1,0
3,319,319,18,7,11,2,1
14,324,324,3,3,0,1,0
17,375,375,22,22,0,1,0
6,377,377,52,52,0,1,0
12,424,424,26,7,19,2,1
5,470,470,104,104,0,1,0
1,471,471,15,1,14,2,1
11,480,480,71,28,43,2,1
0,490,490,57,57,0,1,0

5,105,105,20,8,12,3,2
12,116,116,46,46,0,1,0
13,145,145,1,1,0,1,0
4,181,181,19,19,0,1,0
6,191,191,16,1,15,4,3
10,201,201,11,5,6,2,1
0,220,220,42,42,0,1,0
15,239,239,8,8,0,1,0
8,272,272,13,4,9,2,1
2,355,355,4,4,0,1,0
11,364,364,29,29,0,1,0
16,379,379,2,2,0,1,0
1,382,382,11,1,10,3,2
3,385,385,99,33,66,4,3
7,420,420,14,14,0,1,0
14,441,441,42,1,41,3,2
9,451,451,91,91,0,1,0

8,107,107,25,25,0,1,0
1,137,137,24,12,12,2,1
12,147,147,3,3,0,1,0
2,175,175,83,35,48,2,1
9,185,185,19,19,0,1,0
3,190,190,35,19,16,3,2
4,257,257,21,21,0,1,0
5,272,272,54,54,0,1,0
11,308,308,9,9,0,1,0
0,346,346,24,24,0,1,0
6,381,381,18,8,10,3,2
7,432,432,90,90,0,1,0
10,439,439,1,1,0,1,0

22,156,156,17,17,0,1,0
4,186,186,34,34,0,1,0
18,208,208,20,6,14,3,2
2,215,215,9,9,0,1,0
12,217,217,3,3,0,1,0
11,222,222,27,7,20,3,2
21,233,233,21,9,12,2,1
14,240,240,1,1,0,1,0
6,246,246,14,14,0,1,0
7,259,259,12,12,0,1,0
20,284,284,59,5,54,4,3
0,301,301,17,10,7,2,1
16,303,303,16,10,6,2,1
5,315,315,2,2,0,1,0
23,319,319,43,25,18,2,1
15,326,326,4,1,3,2,1
3,334,334,1,1,0,1,0
8,341,341,24,24,0,1,0
13,347,347,48,24,24,4,3
1,380,380,4,1,3,2,1
10,427,427,33,33,0,1,0
9,430,430,26,26,0,1,0
19,443,443,56,7,49,3,2
24,466,466,3,3,0,1,0
17,478,478,46,46,0,1,0

9,121,121,3,3,0,1,0
7,174,174,7,7,0,1,0
12,182,182,6,1,5,2,1
17,185,185,8,8,0,1,0
18,207,207,40,20,20,4,3
13,237,237,3,3,0,1,0
14,266,266,9,3,6,2,1
2,277,277,2,2,0,1,0
5,284,284,23,23,0,1,0
6,295,295,8,8,0,1,0
15,330,330,29,29,0,1,0
4,335,335,82,82,0,1,0
3,347,347,17,17,0,1,0
1,370,370,28,3,25,2,1
16,378,378,152,125,27,4,3
11,380,380,3,3,0,1,0
8,389,389,113,59,54,4,3
0,435,435,28,28,0,1,0
10,468,468,46,28,18,2,1

3,139,139,1,1,0,1,0
14,165,165,24,18,6,2,1
0,191,191,35,35,0,1,0
11,203,203,8,8,0,1,0
7,213,213,4,4,0,1,0
9,215,215,2,2,0,1,0
6,221,221,5,2,3,2,1
10,225,225,18,12,6,2,1
15,262,262,42,31,11,2,1
16,295,295,12,12,0,1,0
8,297,297,33,2,31,4,3
1,321,321,136,119,17,3,2
2,349,349,66,16,50,3,2
4,397,397,18,6,12,3,2
5,401,401,5,1,4,2,1
13,438,438,43,4,39,2,1
12,463,463,108,88,20,2,1

19,111,111,27,27,0,1,0
6,116,116,17,6,11,2,1
10,140,140,1,1,0,1,0
5,145,145,1,1,0,1,0
3,151,151,17,1,16,3,2
15,162,162,2,2,0,1,0
8,226,226,44,44,0,1,0
14,254,254,1,1,0,1,0
9,267,267,20,3,17,2,1
17,267,267,36,36,0,1,0
7,333,333,33,3,30,4,3
18,338,338,33,33,0,1,0
13,360,360,59,59,0,1,0
11,364,364,14,14,0,1,0
4,406,406,23,5,18,3,2
20,420,420,1,1,0,1,0
16,470,470,12,12,0,1,0
12,473,473,114,56,58,3,2
2,476,476,60,28,32,3,2
1,488,488,1,1,0,1,0
0,498,498,18,18,0,1,0

4,104,104,4,4,0,1,0
1,118,118,22,22,0,1,0
15,219,219,42,27,15,4,3
13,262,262,20,20,0,1,0
12,297,297,12,2,10,3,2
17,300,300,40,40,0,1,0
14,309,309,4,4,0,1,0
7,315,315,48,48,0,1,0
9,353,353,52,14,38,3,2
10,376,376,16,1,15,4,3
16,377,377,66,66,0,1,0
11,391,391,37,3,34,2,1
6,394,394,4,4,0,1,0
2,417,417,75,12,63,4,3
3,441,441,29,29,0,1,0
5,468,468,3,3,0,1,0
0,486,486,114,7,107,4,3
8,497,497,13,1,12,4,3

6,111,111,1,1,0,1,0
10,114,114,2,2,0,1,0
22,128,128,13,13,0,1,0
17,147,147,27,6,21,4,3
21,170,170,5,5,0,1,0
12,175,175,7,7,0,1,0
9,192,192,7,2,5,2,1
0,211,211,17,8,9,4,3
8,244,244,1,1,0,1,0
13,246,246,9,5,4,2,1
23,288,288,19,19,0,1,0
14,306,306,9,3,6,2,1
1,311,311,94,94,0,1,0
18,315,315,37,6,31,2,1
15,320,320,47,35,12,4,3
7,335,335,7,7,0,1,0
11,352,352,69,69,0,1,0
5,362,362,13,13,0,1,0
20,404,404,7,1,6,3,2
2,432,432,24,24,0,1,0
4,441,441,4,4,0,1,0
3,448,448,12,5,7,2,1
16,484,484,52,7,45,4,3
19,486,486,74,67,7,2,1

11,114,114,5,1,4,2,1
10,121,121,17,5,12,4,3
8,170,170,8,5,3,2,1
13,186,186,10,10,0,1,0
14,228,228,49,26,23,2,1
7,251,251,8,8,0,1,0
1,269,269,11,11,0,1,0
12,287,287,4,4,0,1,0
0,331,331,156,156,0,1,0
3,341,341,39,39,0,1,0
4,348,348,3,3,0,1,0
16,349,349,6,6,0,1,0
5,366,366,4,1,3,2,1
9,385,385,31,11,20,3,2
6,393,393,12,5,7,2,1
2,420,420,62,12,50,3,2
15,495,495,26,9,17,2,1
17,499,499,151,118,33,2,1

7,121,121,44,25,19,2,1
3,123,123,9,6,3,2,1
8,124,124,14,14,0,1,0
15,127,127,2,2,0,1,0
5,172,172,6,6,0,1,0
9,192,192,3,3,0,1,0
16,196,196,1,1,0,1,0
14,258,258,141,58,83,4,3
6,279,279,1,1,0,1,0
11,286,286,20,20,0,1,0
1,290,290,38,38,0,1,0
12,302,302,12,12,0,1,0
13,319,319,31,31,0,1,0
2,322,322,10,10,0,1,0
4,324,324,81,81,0,1,0
0,439,439,6,6,0,1,0
10,483,483,9,9,0,1,0

8,195,195,22,2,20,3,2
5,199,199,84,73,11,2,1
7,213,213,32,18,14,3,2
2,237,237,56,45,11,2,1
13,283,283,23,23,0,1,0
6,297,297,3,3,0,1,0
0,311,311,42,17,25,2,1
1,350,350,24,24,0,1,0
11,351,351,40,40,0,1,0
9,363,363,15,15,0,1,0
14,414,414,34,34,0,1,0
12,442,442,14,14,0,1,0
10,444,444,129,39,90,4,3
4,445,445,12,12,0,1,0
3,447,447,7,1,6,3,2

11,111,111,1,1,0,1,0
10,152,152,11,11,0,1,0
5,155,155,6,6,0,1,0
9,156,156,3,3,0,1,0
12,163,163,32,26,6,2,1
16,248,248,13,13,0,1,0
18,273,273,30,1,29,3,2
14,288,288,19,19,0,1,0
0,305,305,22,22,0,1,0
7,316,316,32,32,0,1,0
19,334,334,7,7,0,1,0
15,360,360,35,35,0,1,0
2,372,372,10,3,7,2,1
3,391,391,6,6,0,1,0
4,398,398,119,89,30,4,3
17,410,410,119,111,8,2,1
13,429,429,11,4,7,2,1
6,431,431,7,2,5,2,1
20,438,438,26,2,24,4,3
1,449,449,88,46,42,4,3
8,498,498,21,21,0,1,0

14,104,104,10,10,0,1,0
18,137,137,4,4,0,1,0
9,148,148,34,1,33,4,3
16,159,159,10,10,0,1,0
7,169,169,16,16,0,1,0
19,175,175,2,2,0,1,0
11,187,187,15,15,0,1,0
8,190,190,8,8,0,1,0
3,194,194,12,12,0,1,0
1,252,252,3,3,0,1,0
0,308,308,9,9,0,1,0
13,339,339,29,17,12,3,2
5,387,387,13,4,9,4,3
20,394,394,30,30,0,1,0
6,397,397,37,1,36,4,3
12,412,412,36,17,19,2,1
2,416,416,1,1,0,1,0
15,445,445,184,138,46,2,1
17,462,462,25,3,22,2,1
4,473,473,103,36,67,4,3
10,485,485,2,2,0,1,0

17,100,100,7,7,0,1,0
0,127,127,3,3,0,1,0
16,140,140,11,11,0,1,0
13,140,140,4,4,0,1,0
1,166,166,1,1,0,1,0
5,201,201,18,18,0,1,0
8,243,243,49,49,0,1,0
14,251,251,7,1,6,2,1
4,270,270,11,4,7,2,1
11,352,352,51,51,0,1,0
12,355,355,55,55,0,1,0
10,359,359,123,54,69,4,3
7,360,360,54,6,48,4,3
9,401,401,31,31,0,1,0
18,439,439,2,2,0,1,0
15,448,448,28,28,0,1,0
2,453,453,25,25,0,1,0
6,460,460,76,13,63,4,3
3,469,469,43,43,0,1,0

2,102,102,19,19,0,1,0
5,139,139,8,8,0,1,0
9,141,141,17,17,0,1,0
1,170,170,35,1,34,3,2
10,247,247,3,3,0,1,0
16,280,280,32,32,0,1,0
0,304,304,15,10,5,2,1
3,314,314,36,36,0,1,0
6,318,318,3,3,0,1,0
8,361,361,47,47,0,1,0
12,362,362,7,7,0,1,0
14,364,364,26,7,19,4,3
4,375,375,11,11,0,1,0
17,394,394,23,23,0,1,0
18,401,401,3,3,0,1,0
11,401,401,67,67,0,1,0
13,419,419,14,3,11,2,1
7,472,472,1,1,0,1,0
15,474,474,204,131,73,4,3

2,110,110,11,11,0,1,0
11,130,130,6,6,0,1,0
15,131,131,9,9,0,1,0
10,135,135,9,9,0,1,0
3,169,169,9,9,0,1,0
0,191,191,16,16,0,1,0
8,285,285,18,18,0,1,0
13,288,288,2,2,0,1,0
14,297,297,71,71,0,1,0
1,326,326,71,30,41,2,1
5,342,342,50,24,26,3,2
4,410,410,59,9,50,2,1
9,415,415,10,4,6,2,1
7,428,428,55,11,44,3,2
6,430,430,67,67,0,1,0
12,491,491,134,59,75,4,3

17,116,116,12,12,0,1,0
11,143,143,12,2,10,3,2
6,154,154,15,15,0,1,0
13,172,172,4,4,0,1,0
18,184,184,28,28,0,1,0
10,197,197,4,1,3,2,1
19,200,200,2,2,0,1,0
20,211,211,17,13,4,2,1
9,226,226,14,4,10,3,2
4,289,289,17,17,0,1,0
14,296,296,28,17,11,2,1
15,310,310,38,38,0,1,0
8,329,329,28,28,0,1,0
1,338,338,34,28,6,3,2
2,379,379,2,2,0,1,0
21,423,423,26,11,15,2,1
16,424,424,116,61,55,4,3
7,448,448,43,1,42,2,1
5,451,451,64,64,0,1,0
3,454,454,23,1,22,4,3
0,454,454,3,3,0,1,0
12,480,480,44,44,0,1,0

12,114,114,2,2,0,1,0
7,150,150,1,1,0,1,0
4,150,150,30,30,0,1,0
16,154,154,21,21,0,1,0
0,166,166,9,9,0,1,0
11,172,172,1,1,0,1,0
9,186,186,11,11,0,1,0
6,211,211,4,4,0,1,0
1,243,243,23,23,0,1,0
3,251,251,20,11,9,2,1
2,255,255,24,24,0,1,0
19,256,256,5,5,0,1,0
13,273,273,9,2,7,2,1
18,375,375,81,81,0,1,0
14,394,394,46,46,0,1,0
10,410,410,54,21,33,4,3
17,428,428,123,73,50,2,1
8,434,434,68,20,48,3,2
5,470,470,3,3,0,1,0
15,499,499,42,42,0,1,0

18,105,105,5,2,3,2,1
7,128,128,11,11,0,1,0
2,132,132,15,12,3,2,1
14,146,146,35,35,0,1,0
13,186,186,29,29,0,1,0
15,192,192,29,3,26,2,1
17,208,208,2,2,0,1,0
3,210,210,2,2,0,1,0
10,230,230,10,10,0,1,0
11,235,235,19,13,6,2,1
0,252,252,32,32,0,1,0
9,262,262,17,2,15,2,1
4,318,318,56,35,21,4,3
5,328,328,12,4,8,3,2
8,355,355,7,7,0,1,0
16,389,389,33,33,0,1,0
12,391,391,38,30,8,2,1
6,432,432,85,76,9,4,3
1,462,462,33,15,18,4,3

6,112,112,34,34,0,1,0
15,112,112,4,1,3,2,1
13,134,134,43,9,34,4,3
4,149,149,10,6,4,2,1
3,159,159,6,6,0,1,0
8,213,213,19,19,0,1,0
11,243,243,14,14,0,1,0
12,256,256,42,15,27,4,3
5,257,257,23,15,8,3,2
10,300,300,1,1,0,1,0
9,332,332,4,4,0,1,0
7,344,344,81,41,40,2,1
14,349,349,1,1,0,1,0
0,354,354,29,17,12,3,2
1,385,385,13,13,0,1,0
2,469,469,137,137,0,1,0

7,114,114,9,9,0,1,0
16,153,153,9,9,0,1,0
14,221,221,9,3,6,3,2
12,244,244,3,3,0,1,0
6,256,256,9,3,6,3,2
15,272,272,24,24,0,1,0
4,281,281,4,4,0,1,0
13,312,312,12,12,0,1,0
0,339,339,201,186,15,2,1
1,349,349,5,5,0,1,0
9,368,368,49,49,0,1,0
3,408,408,10,10,0,1,0
2,411,411,7,7,0,1,0
11,414,414,66,61,5,2,1
10,437,437,130,115,15,4,3
8,449,449,38,35,3,2,1
5,452,452,56,44,12,2,1

16,187,187,52,34,18,3,2
15,229,229,3,3,0,1,0
8,255,255,29,8,21,4,3
4,262,262,20,20,0,1,0
9,303,303,21,21,0,1,0
3,334,334,14,4,10,3,2
2,369,369,16,16,0,1,0
12,386,386,37,1,36,4,3
0,389,389,1,1,0,1,0
14,392,392,40,40,0,1,0
11,409,409,55,42,13,2,1
7,421,421,65,65,0,1,0
10,422,422,27,15,12,4,3
13,423,423,18,12,6,2,1
5,440,440,58,26,32,3,2
6,458,458,81,81,0,1,0
1,481,481,132,100,32,3,2

4,192,192,24,24,0,1,0
16,267,267,64,34,30,2,1
15,275,275,34,34,0,1,0
10,277,277,13,3,10,2,1
8,295,295,9,9,0,1,0
6,298,298,1,1,0,1,0
0,315,315,76,46,30,3,2
14,361,361,112,112,0,1,0
1,363,363,5,5,0,1,0
5,395,395,15,3,12,4,3
2,404,404,70,70,0,1,0
11,452,452,11,2,9,4,3
13,456,456,18,18,0,1,0
7,461,461,8,2,6,3,2
9,466,466,31,31,0,1,0
3,487,487,141,63,78,4,3
12,491,491,16,11,5,2,1

3,130,130,12,12,0,1,0
16,160,160,3,3,0,1,0
6,181,181,11,11,0,1,0
14,182,182,5,1,4,2,1
10,185,185,2,2,0,1,0
17,201,201,9,9,0,1,0
18,226,226,35,11,24,4,3
19,234,234,4,1,3,2,1
24,265,265,67,67,0,1,0
2,278,278,7,7,0,1,0
7,289,289,14,3,11,3,2
22,302,302,23,23,0,1,0
9,310,310,59,3,56,4,3
1,318,318,62,23,39,4,3
20,318,318,14,14,0,1,0
0,332,332,3,3,0,1,0
23,358,358,106,106,0,1,0
13,367,367,4,4,0,1,0
11,392,392,10,10,0,1,0
4,393,393,32,32,0,1,0
5,408,408,8,4,4,2,1
21,419,419,5,5,0,1,0
8,430,430,7,1,6,2,1
15,439,439,17,2,15,2,1
12,446,446,22,22,0,1,0

3,117,117,15,15,0,1,0
1,161,161,13,13,0,1,0
10,174,174,8,8,0,1,0
19,176,176,3,3,0,1,0
0,190,190,29,29,0,1,0
17,248,248,65,65,0,1,0
8,249,249,29,11,18,2,1
12,276,276,44,44,0,1,0
5,290,290,16,2,14,3,2
9,300,300,8,2,6,2,1
7,302,302,1,1,0,1,0
2,307,307,12,12,0,1,0
15,354,354,8,5,3,2,1
14,357,357,13,13,0,1,0
13,369,369,29,29,0,1,0
16,373,373,15,15,0,1,0
6,408,408,33,33,0,1,0
4,476,476,83,56,27,4,3
11,493,493,9,9,0,1,0
18,494,494,138,57,81,3,2

6,112,112,16,6,10,4,3
5,122,122,1,1,0,1,0
12,124,124,13,9,4,2,1
10,163,163,18,11,7,2,1
14,220,220,17,17,0,1,0
9,222,222,33,9,24,2,1
8,238,238,6,6,0,1,0
13,244,244,16,10,6,2,1
4,250,250,13,4,9,4,3
17,270,270,11,11,0,1,0
0,303,303,35,25,10,2,1
3,316,316,35,7,28,2,1
2,329,329,19,19,0,1,0
16,356,356,33,5,28,2,1
18,380,380,76,76,0,1,0
15,392,392,43,8,35,2,1
1,412,412,95,55,40,2,1
11,437,437,48,42,6,2,1
7,462,462,5,2,3,2,1

14,119,119,17,6,11,2,1
11,162,162,4,4,0,1,0
4,178,178,11,11,0,1,0
15,183,183,43,28,15,4,3
16,230,230,68,44,24,4,3
5,252,252,1,1,0,1,0
6,256,256,100,100,0,1,0
2,259,259,5,5,0,1,0
13,271,271,19,2,17,4,3
12,320,320,21,1,20,2,1
10,334,334,3,3,0,1,0
8,343,343,12,3,9,4,3
1,346,346,18,18,0,1,0
9,350,350,16,1,15,2,1
0,367,367,19,19,0,1,0
3,381,381,25,25,0,1,0
7,394,394,101,59,42,3,2

0,120,120,1,1,0,1,0
17,127,127,2,2,0,1,0
11,129,129,13,3,10,2,1
6,153,153,20,20,0,1,0
16,155,155,8,4,4,2,1
2,181,181,5,5,0,1,0
4,211,211,53,53,0,1,0
5,228,228,69,10,59,4,3
12,239,239,65,17,48,3,2
10,261,261,3,3,0,1,0
15,264,264,6,6,0,1,0
1,265,265,5,5,0,1,0
13,355,355,46,4,42,2,1
3,384,384,20,14,6,2,1
19,390,390,47,16,31,3,2
7,405,405,34,8,26,3,2
8,415,415,6,6,0,1,0
9,490,490,1,1,0,1,0
14,493,493,8,8,0,1,0
18,499,499,98,98,0,1,0

19,181,181,4,1,3,2,1
7,185,185,24,24,0,1,0
20,196,196,41,41,0,1,0
21,213,213,13,13,0,1,0
18,214,214,9,5,4,2,1
13,232,232,14,14,0,1,0
8,235,235,7,7,0,1,0
0,245,245,17,7,10,2,1
16,278,278,69,69,0,1,0
15,290,290,14,8,6,2,1
6,305,305,3,3,0,1,0
3,306,306,18,18,0,1,0
11,335,335,24,24,0,1,0
12,351,351,27,12,15,3,2
1,375,375,17,2,15,4,3
14,376,376,15,15,0,1,0
9,409,409,4,4,0,1,0
2,432,432,41,35,6,2,1
5,437,437,103,60,43,2,1
4,440,440,20,10,10,2,1
17,479,479,89,77,12,4,3
10,491,491,12,12,0,1,0

3,163,163,1,1,0,1,0
13,179,179,5,5,0,1,0
19,220,220,11,11,0,1,0
18,263,263,23,16,7,2,1
8,300,300,25,25,0,1,0
7,305,305,2,2,0,1,0
1,320,320,12,6,6,3,2
9,321,321,6,6,0,1,0
12,345,345,3,3,0,1,0
4,351,351,72,72,0,1,0
2,351,351,35,35,0,1,0
16,357,357,98,30,68,3,2
0,362,362,10,10,0,1,0
10,371,371,55,55,0,1,0
14,379,379,55,19,36,2,1
20,473,473,19,19,0,1,0
11,480,480,71,14,57,4,3
6,481,481,40,40,0,1,0
15,485,485,124,118,6,3,2
17,493,493,11,11,0,1,0
5,498,498,18,18,0,1,0

3,119,119,16,16,0,1,0
5,125,125,17,9,8,2,1
16,175,175,33,33,0,1,0
4,207,207,45,42,3,2,1
8,226,226,1,1,0,1,0
12,238,238,20,2,18,3,2
18,245,245,70,32,38,2,1
6,250,250,26,26,0,1,0
19,297,297,24,17,7,2,1
11,298,298,15,15,0,1,0
2,303,303,7,7,0,1,0
15,334,334,8,1,7,2,1
0,350,350,19,19,0,1,0
17,367,367,50,24,26,2,1
1,404,404,67,61,6,2,1
9,407,407,9,9,0,1,0
14,412,412,12,7,5,2,1
13,434,434,16,16,0,1,0
10,452,452,17,11,6,2,1
7,463,463,1,1,0,1,0

0,116,116,8,4,4,2,1
2,128,128,16,1,15,4,3
12,128,128,42,42,0,1,0
8,130,130,8,8,0,1,0
6,136,136,25,21,4,2,1
16,154,154,4,4,0,1,0
15,159,159,11,1,10,3,2
10,222,222,11,11,0,1,0
14,301,301,38,4,34,2,1
5,347,347,5,5,0,1,0
3,352,352,72,62,10,2,1
11,374,374,41,41,0,1,0
9,427,427,6,6,0,1,0
1,441,441,23,23,0,1,0
7,462,462,100,18,82,4,3
13,472,472,66,66,0,1,0
4,475,475,17,2,15,4,3

12,100,100,11,4,7,2,1
0,101,101,7,7,0,1,0
11,125,125,3,3,0,1,0
8,172,172,13,4,9,2,1
14,173,173,6,3,3,2,1
4,177,177,34,19,15,2,1
7,187,187,28,28,0,1,0
13,257,257,35,35,0,1,0
2,311,311,36,36,0,1,0
16,342,342,3,3,0,1,0
9,376,376,68,17,51,4,3
6,382,382,9,3,6,3,2
3,401,401,1,1,0,1,0
1,403,403,7,7,0,1,0
15,412,412,36,20,16,2,1
5,458,458,119,106,13,2,1
10,485,485,153,118,35,4,3
17,490,490,10,10,0,1,0

22,109,109,28,5,23,2,1
10,132,132,3,3,0,1,0
13,148,148,4,4,0,1,0
15,159,159,13,13,0,1,0
0,238,238,9,3,6,2,1
11,239,239,8,8,0,1,0
8,262,262,6,6,0,1,0
9,292,292,23,17,6,3,2
20,297,297,6,6,0,1,0
7,307,307,8,2,6,2,1
2,325,325,18,18,0,1,0
21,330,330,14,14,0,1,0
14,332,332,16,16,0,1,0
4,347,347,20,20,0,1,0
16,365,365,33,13,20,2,1
19,368,368,18,6,12,4,3
18,386,386,104,47,57,4,3
5,432,432,29,5,24,2,1
17,440,440,28,28,0,1,0
12,446,446,34,4,30,3,2
3,466,466,45,3,42,4,3
1,467,467,117,93,24,3,2
6,472,472,25,25,0,1,0

7,130,130,24,24,0,1,0
0,148,148,37,1,36,4,3
5,148,148,10,10,0,1,0
15,184,184,42,42,0,1,0
4,227,227,35,35,0,1,0
14,230,230,10,1,9,2,1
10,250,250,14,7,7,2,1
13,250,250,4,4,0,1,0
3,264,264,18,18,0,1,0
2,266,266,12,9,3,2,1
8,289,289,1,1,0,1,0
12,342,342,117,117,0,1,0
6,345,345,9,9,0,1,0
9,359,359,12,12,0,1,0
17,381,381,7,7,0,1,0
18,398,398,7,3,4,2,1
19,421,421,77,77,0,1,0
16,437,437,8,8,0,1,0
11,450,450,23,23,0,1,0
1,457,457,6,6,0,1,0

16,111,111,9,1,8,2,1
7,158,158,8,8,0,1,0
8,172,172,1,1,0,1,0
14,182,182,2,2,0,1,0
20,206,206,7,7,0,1,0
10,213,213,42,30,12,4,3
21,219,219,38,38,0,1,0
4,282,282,9,9,0,1,0
6,300,300,4,4,0,1,0
2,301,301,10,10,0,1,0
15,331,331,38,10,28,3,2
1,352,352,3,3,0,1,0
12,353,353,58,58,0,1,0
19,354,354,42,4,38,3,2
0,383,383,82,40,42,3,2
18,384,384,129,103,26,3,2
5,385,385,5,2,3,2,1
11,429,429,59,59,0,1,0
13,453,453,1,1,0,1,0
17,454,454,22,7,15,4,3
3,461,461,8,8,0,1,0
9,476,476,7,4,3,2,1

8,114,114,1,1,0,1,0
7,140,140,12,12,0,1,0
3,165,165,4,1,3,2,1
19,166,166,1,1,0,1,0
10,184,184,1,1,0,1,0
21,204,204,8,8,0,1,0
6,229,229,3,3,0,1,0
14,239,239,13,13,0,1,0
15,263,263,8,2,6,2,1
2,293,293,30,15,15,2,1
16,321,321,109,109,0,1,0
1,361,361,42,20,22,2,1
4,364,364,10,10,0,1,0
17,380,380,27,27,0,1,0
18,392,392,95,59,36,4,3
11,395,395,42,42,0,1,0
12,399,399,1,1,0,1,0
20,413,413,2,2,0,1,0
13,416,416,53,5,48,4,3
5,435,435,116,116,0,1,0
0,451,451,37,15,22,2,1
9,476,476,29,29,0,1,0

12,149,149,27,27,0,1,0
11,174,174,32,32,0,1,0
7,177,177,15,8,7,2,1
14,195,195,13,9,4,2,1
9,215,215,4,4,0,1,0
3,262,262,30,30,0,1,0
4,274,274,92,18,74,3,2
8,277,277,21,21,0,1,0
5,299,299,5,5,0,1,0
1,305,305,30,7,23,4,3
13,376,376,15,15,0,1,0
2,395,395,84,74,10,3,2
10,435,435,63,63,0,1,0
6,437,437,4,4,0,1,0
15,478,478,54,54,0,1,0
16,485,485,45,25,20,3,2
0,495,495,14,4,10,3,2

21,115,115,16,16,0,1,0
1,139,139,8,8,0,1,0
19,142,142,30,30,0,1,0
0,145,145,5,5,0,1,0
5,159,159,6,6,0,1,0
15,167,167,10,1,9,2,1
12,214,214,8,8,0,1,0
7,254,254,19,19,0,1,0
14,259,259,16,6,10,2,1
18,271,271,2,2,0,1,0
11,294,294,56,23,33,4,3
8,312,312,2,2,0,1,0
3,321,321,48,48,0,1,0
2,350,350,31,31,0,1,0
17,374,374,74,74,0,1,0
20,388,388,10,10,0,1,0
4,415,415,13,6,7,2,1
16,433,433,38,38,0,1,0
9,441,441,32,32,0,1,0
13,476,476,61,61,0,1,0
6,482,482,42,20,22,2,1
10,491,491,16,2,14,3,2

2,104,104,21,21,0,1,0
0,133,133,3,3,0,1,0
13,134,134,21,21,0,1,0
17,186,186,5,2,3,2,1
6,216,216,14,1,13,4,3
20,237,237,48,39,9,4,3
8,251,251,3,3,0,1,0
18,253,253,19,3,16,3,2
1,257,257,40,40,0,1,0
14,261,261,37,37,0,1,0
3,267,267,3,3,0,1,0
22,292,292,5,5,0,1,0
11,296,296,7,1,6,3,2
12,304,304,42,42,0,1,0
19,317,317,26,15,11,2,1
10,331,331,6,6,0,1,0
5,358,358,5,5,0,1,0
15,360,360,19,1,18,3,2
21,387,387,27,15,12,3,2
4,407,407,11,11,0,1,0
9,419,419,14,14,0,1,0
7,456,456,10,10,0,1,0
16,493,493,121,1,120,4,3

13,127,127,20,8,12,2,1
10,167,167,9,9,0,1,0
5,190,190,92,92,0,1,0
12,201,201,10,10,0,1,0
4,203,203,8,8,0,1,0
9,292,292,54,54,0,1,0
11,313,313,9,9,0,1,0
1,365,365,10,10,0,1,0
8,379,379,49,29,20,2,1
14,402,402,85,85,0,1,0
0,406,406,4,4,0,1,0
7,425,425,23,3,20,2,1
6,428,428,20,20,0,1,0
3,446,446,90,49,41,2,1
2,449,449,63,63,0,1,0

2,102,102,4,1,3,2,1
10,137,137,17,2,15,2,1
15,143,143,19,19,0,1,0
0,151,151,8,8,0,1,0
6,225,225,21,21,0,1,0
7,226,226,23,23,0,1,0
4,231,231,2,2,0,1,0
12,244,244,5,5,0,1,0
3,278,278,2,2,0,1,0
9,301,301,67,35,32,2,1
8,305,305,54,20,34,2,1
11,327,327,7,1,6,3,2
5,348,348,88,28,60,3,2
14,397,397,24,16,8,2,1
1,469,469,163,31,132,4,3
13,479,479,16,10,6,3,2
16,486,486,59,10,49,2,1

5,132,132,16,16,0,1,0
14,132,132,8,8,0,1,0
11,164,164,23,23,0,1,0
10,187,187,3,3,0,1,0
9,205,205,13,13,0,1,0
4,224,224,17,8,9,4,3
7,299,299,45,45,0,1,0
12,367,367,10,4,6,2,1
1,371,371,77,26,51,3,2
13,375,375,65,9,56,4,3
2,385,385,1,1,0,1,0
6,389,389,64,8,56,4,3
15,398,398,52,30,22,2,1
3,403,403,77,27,50,3,2
0,441,441,61,17,44,2,1
8,477,477,76,38,38,3,2

14,100,100,8,8,0,1,0
17,146,146,10,10,0,1,0
13,159,159,2,2,0,1,0
16,171,171,12,12,0,1,0
8,224,224,8,8,0,1,0
4,237,237,3,3,0,1,0
0,268,268,16,2,14,3,2
18,308,308,28,12,16,3,2
1,343,343,49,40,9,2,1
3,345,345,14,1,13,2,1
9,353,353,64,54,10,2,1
7,358,358,28,28,0,1,0
12,361,361,6,6,0,1,0
11,401,401,12,3,9,2,1
6,431,431,83,49,34,2,1
2,437,437,67,67,0,1,0
10,451,451,59,3,56,3,2
5,459,459,2,2,0,1,0
15,469,469,197,119,78,4,3

6,117,117,8,3,5,2,1
1,145,145,5,5,0,1,0
3,163,163,16,16,0,1,0
9,173,173,4,4,0,1,0
10,176,176,19,3,16,3,2
12,202,202,3,3,0,1,0
13,210,210,5,5,0,1,0
14,216,216,25,25,0,1,0
16,233,233,51,51,0,1,0
18,276,276,1,1,0,1,0
8,298,298,39,39,0,1,0
4,302,302,57,57,0,1,0
7,308,308,40,1,39,3,2
17,316,316,43,7,36,4,3
2,361,361,1,1,0,1,0
0,369,369,43,30,13,2,1
5,402,402,45,45,0,1,0
11,419,419,113,57,56,3,2
15,460,460,13,7,6,2,1

10,110,110,3,3,0,1,0
4,162,162,1,1,0,1,0
2,166,166,9,9,0,1,0
13,185,185,27,3,24,2,1
14,204,204,7,3,4,2,1
12,206,206,16,2,14,3,2
5,223,223,93,93,0,1,0
3,243,243,22,4,18,3,2
11,275,275,44,44,0,1,0
8,279,279,21,21,0,1,0
16,292,292,15,15,0,1,0
9,302,302,63,12,51,4,3
6,314,314,9,3,6,2,1
7,322,322,27,27,0,1,0
0,379,379,81,61,20,2,1
15,404,404,55,27,28,3,2
1,441,441,3,3,0,1,0

11,100,100,19,6,13,2,1
9,117,117,16,6,10,2,1
6,119,119,25,25,0,1,0
19,122,122,18,18,0,1,0
13,128,128,9,3,6,2,1
17,139,139,22,22,0,1,0
0,141,141,6,6,0,1,0
15,167,167,2,2,0,1,0
2,180,180,13,7,6,2,1
7,210,210,28,18,10,3,2
4,251,251,9,9,0,1,0
3,254,254,6,6,0,1,0
5,260,260,15,3,12,3,2
16,270,270,12,12,0,1,0
12,357,357,3,3,0,1,0
8,358,358,33,33,0,1,0
1,369,369,22,9,13,4,3
18,405,405,83,10,73,3,2
14,434,434,37,37,0,1,0
10,477,477,18,18,0,1,0

10,112,112,9,3,6,3,2
4,125,125,1,1,0,1,0
8,212,212,45,16,29,2,1
1,224,224,1,1,0,1,0
9,230,230,10,10,0,1,0
6,281,281,66,52,14,2,1
12,306,306,39,18,21,4,3
7,310,310,150,51,99,4,3
14,334,334,8,8,0,1,0
15,371,371,61,24,37,4,3
0,396,396,1,1,0,1,0
11,406,406,81,51,30,4,3
5,418,418,60,6,54,4,3
3,439,439,2,2,0,1,0
16,440,440,19,11,8,2,1
13,457,457,13,3,10,2,1
2,462,462,9,9,0,1,0

3,103,103,14,14,0,1,0
10,142,142,62,62,0,1,0
7,160,160,32,10,22,3,2
9,170,170,13,13,0,1,0
6,184,184,4,4,0,1,0
13,219,219,39,39,0,1,0
1,227,227,23,23,0,1,0
11,292,292,4,4,0,1,0
2,295,295,80,25,55,3,2
4,298,298,3,3,0,1,0
12,302,302,6,6,0,1,0
5,326,326,15,5,10,3,2
14,327,327,20,15,5,2,1
15,330,330,20,20,0,1,0
8,398,398,23,11,12,4,3
0,454,454,54,54,0,1,0
16,484,484,10,10,0,1,0

3,113,113,8,4,4,2,1
4,115,115,42,36,6,3,2
13,116,116,28,1,27,2,1
1,196,196,18,1,17,2,1
15,235,235,51,11,40,2,1
10,281,281,25,11,14,3,2
0,305,305,1,1,0,1,0
8,313,313,4,4,0,1,0
9,313,313,2,2,0,1,0
14,375,375,17,17,0,1,0
17,381,381,17,17,0,1,0
16,387,387,9,3,6,3,2
11,390,390,5,5,0,1,0
12,395,395,63,63,0,1,0
6,403,403,30,30,0,1,0
7,449,449,40,40,0,1,0
18,454,454,38,28,10,2,1
5,457,457,70,70,0,1,0
2,472,472,16,4,12,4,3

18,103,103,13,13,0,1,0
2,117,117,7,7,0,1,0
9,136,136,14,10,4,2,1
6,148,148,12,12,0,1,0
10,150,150,3,3,0,1,0
19,198,198,48,33,15,4,3
3,213,213,32,32,0,1,0
20,217,217,9,4,5,2,1
5,224,224,15,15,0,1,0
1,228,228,16,16,0,1,0
11,231,231,18,3,15,4,3
8,240,240,19,3,16,2,1
15,267,267,75,31,44,2,1
13,299,299,18,18,0,1,0
4,300,300,53,15,38,3,2
0,319,319,4,4,0,1,0
12,355,355,4,4,0,1,0
16,363,363,21,15,6,2,1
17,378,378,21,1,20,3,2
7,400,400,1,1,0,1,0
14,500,500,21,18,3,2,1

15,119,119,7,7,0,1,0
16,126,126,40,5,35,4,3
13,160,160,19,19,0,1,0
7,171,171,12,2,10,2,1
6,217,217,14,14,0,1,0
17,238,238,3,3,0,1,0
14,313,313,17,5,12,3,2
5,318,318,1,1,0,1,0
12,318,318,55,55,0,1,0
9,318,318,46,4,42,4,3
10,321,321,15,15,0,1,0
11,348,348,1,1,0,1,0
3,349,349,22,22,0,1,0
1,375,375,29,29,0,1,0
0,432,432,63,20,43,2,1
8,448,448,130,130,0,1,0
2,484,484,58,2,56,3,2
4,485,485,32,11,21,4,3

6,121,121,1,1,0,1,0
1,123,123,13,5,8,3,2
18,141,141,3,3,0,1,0
15,144,144,4,4,0,1,0
10,158,158,4,4,0,1,0
7,208,208,19,19,0,1,0
5,220,220,31,17,14,3,2
17,230,230,40,35,5,2,1
13,250,250,26,2,24,2,1
16,266,266,17,10,7,2,1
14,297,297,117,72,45,4,3
8,317,317,22,3,19,2,1
2,320,320,1,1,0,1,0
4,366,366,37,12,25,2,1
11,374,374,51,51,0,1,0
0,423,423,20,3,17,3,2
20,437,437,10,3,7,2,1
12,449,449,48,48,0,1,0
19,459,459,3,3,0,1,0
9,467,467,29,24,5,2,1
3,495,495,55,8,47,2,1

7,136,136,4,1,3,2,1
10,165,165,8,3,5,2,1
18,189,189,5,5,0,1,0
9,195,195,6,3,3,2,1
6,218,218,52,52,0,1,0
3,218,218,3,3,0,1,0
12,219,219,46,2,44,2,1
0,236,236,1,1,0,1,0
4,242,242,54,54,0,1,0
13,274,274,51,9,42,3,2
11,308,308,4,1,3,2,1
15,311,311,108,108,0,1,0
1,314,314,13,2,11,2,1
8,368,368,25,25,0,1,0
16,369,369,13,13,0,1,0
17,395,395,1,1,0,1,0
14,425,425,20,20,0,1,0
5,444,444,54,51,3,2,1
2,453,453,59,23,36,2,1

19,109,109,5,5,0,1,0
15,122,122,2,2,0,1,0
4,154,154,1,1,0,1,0
20,225,225,20,20,0,1,0
13,258,258,51,14,37,4,3
5,259,259,15,15,0,1,0
2,267,267,3,3,0,1,0
14,273,273,76,55,21,4,3
10,282,282,1,1,0,1,0
11,314,314,52,18,34,2,1
8,324,324,61,61,0,1,0
0,325,325,10,10,0,1,0
22,329,329,40,40,0,1,0
18,332,332,27,12,15,4,3
16,335,335,37,37,0,1,0
9,354,354,18,11,7,2,1
1,357,357,3,3,0,1,0
21,359,359,37,37,0,1,0
6,375,375,4,4,0,1,0
7,382,382,6,3,3,2,1
12,418,418,26,12,14,3,2
3,458,458,43,9,34,3,2
17,459,459,33,33,0,1,0

4,105,105,3,3,0,1,0
3,133,133,10,4,6,2,1
18,136,136,1,1,0,1,0
11,136,136,1,1,0,1,0
6,141,141,25,3,22,3,2
2,149,149,21,3,18,2,1
1,181,181,1,1,0,1,0
13,240,240,1,1,0,1,0
5,258,258,12,2,10,2,1
19,280,280,59,59,0,1,0
17,324,324,12,12,0,1,0
0,376,376,67,13,54,4,3
14,396,396,141,92,49,4,3
7,414,414,11,11,0,1,0
8,438,438,54,25,29,2,1
15,446,446,15,2,13,2,1
10,469,469,42,42,0,1,0
12,486,486,5,2,3,2,1
9,492,492,5,1,4,2,1
16,493,493,121,69,52,3,2

2,150,150,55,39,16,3,2
3,150,150,22,18,4,2,1
1,180,180,17,17,0,1,0
8,185,185,3,3,0,1,0
10,220,220,16,4,12,2,1
7,245,245,5,5,0,1,0
5,269,269,55,55,0,1,0
4,277,277,2,2,0,1,0
11,361,361,17,17,0,1,0
9,394,394,48,48,0,1,0
0,423,423,187,187,0,1,0
6,468,468,135,18,117,4,3

19,109,109,3,3,0,1,0
11,118,118,14,6,8,3,2
0,132,132,6,6,0,1,0
4,150,150,11,2,9,4,3
3,159,159,26,26,0,1,0
1,162,162,6,3,3,2,1
2,208,208,7,7,0,1,0
7,233,233,16,9,7,2,1
16,268,268,38,23,15,2,1
6,340,340,45,15,30,4,3
8,342,342,43,43,0,1,0
15,343,343,25,25,0,1,0
18,349,349,20,16,4,2,1
14,419,419,67,67,0,1,0
13,443,443,112,112,0,1,0
17,448,448,4,4,0,1,0
5,450,450,28,28,0,1,0
12,459,459,36,28,8,2,1
9,480,480,37,37,0,1,0
10,497,497,41,15,26,2,1

2,144,144,39,39,0,1,0
9,161,161,6,6,0,1,0
1,163,163,1,1,0,1,0
6,187,187,1,1,0,1,0
14,230,230,9,5,4,2,1
17,247,247,58,58,0,1,0
4,267,267,8,8,0,1,0
13,273,273,12,7,5,2,1
5,323,323,14,14,0,1,0
10,325,325,10,2,8,3,2
12,327,327,96,96,0,1,0
0,332,332,6,6,0,1,0
7,347,347,129,99,30,2,1
11,353,353,7,7,0,1,0
15,379,379,22,6,16,2,1
8,380,380,57,57,0,1,0
3,439,439,2,2,0,1,0
16,494,494,76,76,0,1,0

12,107,107,7,3,4,2,1
1,114,114,22,4,18,4,3
2,121,121,9,9,0,1,0
3,128,128,1,1,0,1,0
8,130,130,4,4,0,1,0
7,137,137,6,6,0,1,0
18,188,188,7,7,0,1,0
6,286,286,75,31,44,3,2
15,314,314,86,71,15,4,3
5,326,326,22,6,16,3,2
9,340,340,71,56,15,4,3
4,352,352,1,1,0,1,0
13,412,412,17,17,0,1,0
0,433,433,4,4,0,1,0
11,436,436,13,3,10,2,1
10,455,455,14,8,6,3,2
16,477,477,137,137,0,1,0
14,491,491,67,67,0,1,0
17,492,492,6,6,0,1,0

16,120,120,10,2,8,3,2
5,122,122,32,32,0,1,0
2,142,142,33,14,19,2,1
3,149,149,8,8,0,1,0
1,180,180,5,2,3,2,1
17,216,216,12,12,0,1,0
6,285,285,2,2,0,1,0
10,294,294,11,11,0,1,0
9,329,329,14,14,0,1,0
8,332,332,44,44,0,1,0
12,334,334,25,6,19,2,1
13,355,355,52,52,0,1,0
0,375,375,1,1,0,1,0
15,377,377,43,8,35,2,1
14,400,400,13,2,11,3,2
4,403,403,25,1,24,3,2
11,437,437,94,70,24,2,1
19,463,463,65,41,24,3,2
18,475,475,23,2,21,4,3
7,483,483,20,6,14,3,2

4,135,135,3,3,0,1,0
13,135,135,6,6,0,1,0
11,161,161,3,3,0,1,0
6,163,163,7,2,5,2,1
19,195,195,11,1,10,2,1
8,224,224,7,2,5,2,1
5,225,225,67,67,0,1,0
18,257,257,85,85,0,1,0
1,275,275,15,11,4,2,1
0,305,305,2,2,0,1,0
2,318,318,10,4,6,2,1
9,350,350,8,8,0,1,0
16,359,359,3,3,0,1,0
10,363,363,30,30,0,1,0
12,382,382,19,3,16,3,2
20,391,391,32,32,0,1,0
15,397,397,75,12,63,4,3
17,399,399,5,5,0,1,0
21,466,466,16,16,0,1,0
3,483,483,47,19,28,2,1
14,490,490,81,6,75,4,3
7,497,497,71,71,0,1,0

10,159,159,39,39,0,1,0
0,209,209,6,6,0,1,0
14,212,212,9,9,0,1,0
1,218,218,15,15,0,1,0
3,225,225,7,7,0,1,0
9,227,227,55,5,50,3,2
7,229,229,17,17,0,1,0
11,283,283,16,10,6,2,1
12,333,333,47,47,0,1,0
8,370,370,25,25,0,1,0
6,398,398,54,54,0,1,0
4,409,409,47,47,0,1,0
2,429,429,51,51,0,1,0
15,453,453,8,8,0,1,0
5,472,472,190,136,54,4,3
13,478,478,16,16,0,1,0

17,104,104,5,2,3,2,1
13,104,104,13,4,9,4,3
18,122,122,10,10,0,1,0
15,141,141,23,23,0,1,0
7,199,199,33,33,0,1,0
14,219,219,40,40,0,1,0
5,230,230,14,11,3,2,1
11,233,233,4,4,0,1,0
10,240,240,48,48,0,1,0
16,254,254,16,8,8,3,2
1,288,288,27,27,0,1,0
0,294,294,26,26,0,1,0
3,305,305,53,53,0,1,0
12,306,306,32,14,18,4,3
6,329,329,12,12,0,1,0
8,352,352,1,1,0,1,0
19,391,391,55,55,0,1,0
9,428,428,30,13,17,2,1
4,465,465,1,1,0,1,0
2,483,483,3,3,0,1,0

9,107,107,2,2,0,1,0
3,108,108,7,7,0,1,0
16,126,126,39,11,28,2,1
6,161,161,88,20,68,4,3
0,172,172,14,3,11,2,1
5,173,173,7,7,0,1,0
10,226,226,49,49,0,1,0
14,269,269,40,22,18,2,1
7,335,335,33,33,0,1,0
15,346,346,22,14,8,2,1
17,348,348,10,10,0,1,0
12,360,360,30,30,0,1,0
8,361,361,7,3,4,2,1
13,389,389,3,3,0,1,0
1,392,392,1,1,0,1,0
11,432,432,19,5,14,2,1
2,435,435,19,3,16,3,2
4,480,480,2,2,0,1,0

12,103,103,11,2,9,2,1
11,128,128,9,5,4,2,1
10,203,203,2,2,0,1,0
9,250,250,19,13,6,3,2
8,259,259,62,62,0,1,0
13,259,259,14,4,10,2,1
1,262,262,34,13,21,2,1
4,264,264,24,8,16,2,1
5,275,275,51,51,0,1,0
6,277,277,43,43,0,1,0
2,324,324,15,5,10,3,2
7,364,364,8,5,3,2,1
3,489,489,145,145,0,1,0
0,498,498,168,105,63,4,3

5,105,105,1,1,0,1,0
14,106,106,14,14,0,1,0
4,134,134,32,32,0,1,0
7,150,150,15,15,0,1,0
15,153,153,3,3,0,1,0
3,213,213,21,21,0,1,0
0,228,228,16,16,0,1,0
1,249,249,4,4,0,1,0
8,253,253,14,8,6,3,2
12,285,285,23,12,11,2,1
2,287,287,39,39,0,1,0
13,290,290,79,79,0,1,0
9,314,314,4,4,0,1,0
16,365,365,9,3,6,2,1
11,389,389,17,13,4,2,1
10,416,416,11,5,6,2,1
17,462,462,140,101,39,4,3
6,499,499,89,89,0,1,0

11,104,104,3,3,0,1,0
8,120,120,7,7,0,1,0
19,129,129,12,12,0,1,0
10,136,136,1,1,0,1,0
4,138,138,17,17,0,1,0
5,151,151,1,1,0,1,0
17,191,191,5,5,0,1,0
9,194,194,8,8,0,1,0
7,203,203,14,14,0,1,0
18,203,203,49,49,0,1,0
12,228,228,2,2,0,1,0
14,233,233,13,6,7,2,1
22,236,236,5,5,0,1,0
3,244,244,39,39,0,1,0
2,252,252,33,33,0,1,0
13,312,312,21,14,7,2,1
6,313,313,10,10,0,1,0
15,329,329,26,2,24,3,2
20,351,351,18,1,17,2,1
23,368,368,59,59,0,1,0
21,370,370,69,69,0,1,0
16,372,372,11,11,0,1,0
1,394,394,12,12,0,1,0
0,448,448,1,1,0,1,0
24,472,472,48,24,24,4,3

17,139,139,17,5,12,4,3
6,172,172,70,70,0,1,0
16,197,197,6,3,3,2,1
11,220,220,5,1,4,2,1
8,272,272,13,13,0,1,0
15,284,284,21,11,10,2,1
4,329,329,2,2,0,1,0
5,333,333,25,25,0,1,0
0,339,339,38,38,0,1,0
14,347,347,10,4,6,2,1
7,391,391,7,7,0,1,0
12,398,398,35,35,0,1,0
1,407,407,48,27,21,4,3
10,437,437,57,45,12,3,2
2,440,440,12,3,9,2,1
13,445,445,143,135,8,3,2
9,485,485,50,4,46,4,3
3,493,493,45,3,42,4,3

18,102,102,1,1,0,1,0
10,128,128,12,12,0,1,0
1,146,146,43,43,0,1,0
3,179,179,3,3,0,1,0
2,184,184,7,7,0,1,0
4,198,198,8,1,7,2,1
19,225,225,49,20,29,2,1
7,237,237,22,2,20,3,2
12,241,241,2,2,0,1,0
20,248,248,34,34,0,1,0
14,334,334,12,2,10,3,2
16,337,337,2,2,0,1,0
0,387,387,6,6,0,1,0
5,392,392,76,76,0,1,0
9,424,424,5,5,0,1,0
13,428,428,3,3,0,1,0
8,432,432,10,10,0,1,0
11,444,444,17,17,0,1,0
6,452,452,16,3,13,4,3
17,459,459,13,9,4,2,1
15,473,473,219,141,78,4,3
21,493,493,3,3,0,1,0

9,158,158,12,6,6,3,2
3,190,190,12,5,7,2,1
2,238,238,40,16,24,4,3
10,239,239,25,7,18,2,1
12,250,250,27,6,21,2,1
16,253,253,7,3,4,2,1
6,280,280,12,12,0,1,0
15,334,334,15,2,13,3,2
13,363,363,13,13,0,1,0
8,378,378,87,87,0,1,0
11,390,390,105,105,0,1,0
1,396,396,16,16,0,1,0
4,437,437,60,13,47,2,1
0,446,446,56,56,0,1,0
7,468,468,42,42,0,1,0
14,497,497,11,11,0,1,0
5,500,500,117,86,31,2,1

12,107,107,44,44,0,1,0
4,111,111,18,8,10,3,2
8,114,114,3,3,0,1,0
16,126,126,11,2,9,2,1
18,139,139,6,6,0,1,0
11,156,156,1,1,0,1,0
17,168,168,13,13,0,1,0
3,183,183,45,45,0,1,0
13,223,223,6,6,0,1,0
7,273,273,2,2,0,1,0
0,273,273,6,6,0,1,0
9,283,283,5,5,0,1,0
15,301,301,48,21,27,4,3
10,376,376,45,45,0,1,0
5,384,384,1,1,0,1,0
14,402,402,24,4,20,2,1
2,407,407,87,87,0,1,0
19,435,435,23,23,0,1,0
1,467,467,11,11,0,1,0
6,469,469,28,28,0,1,0

14,117,117,17,17,0,1,0
1,157,157,35,27,8,2,1
9,171,171,8,8,0,1,0
8,189,189,69,69,0,1,0
0,191,191,10,4,6,3,2
5,254,254,40,40,0,1,0
3,272,272,14,14,0,1,0
4,280,280,24,24,0,1,0
6,301,301,76,76,0,1,0
12,309,309,10,10,0,1,0
10,319,319,15,2,13,2,1
13,343,343,5,1,4,2,1
7,398,398,93,23,70,4,3
11,447,447,4,4,0,1,0
2,459,459,36,36,0,1,0
15,459,459,10,10,0,1,0

10,149,149,17,7,10,2,1
5,170,170,2,2,0,1,0
14,198,198,61,16,45,4,3
0,210,210,43,43,0,1,0
13,268,268,5,5,0,1,0
1,278,278,2,2,0,1,0
3,320,320,9,9,0,1,0
8,376,376,30,9,21,2,1
4,378,378,189,133,56,3,2
12,382,382,22,2,20,2,1
7,385,385,10,3,7,2,1
2,397,397,60,22,38,3,2
6,421,421,44,2,42,2,1
9,464,464,27,27,0,1,0
11,482,482,72,72,0,1,0

3,123,123,1,1,0,1,0
13,194,194,28,13,15,4,3
4,196,196,14,8,6,2,1
0,203,203,43,11,32,3,2
11,215,215,3,3,0,1,0
14,239,239,38,38,0,1,0
1,281,281,25,10,15,2,1
6,310,310,141,108,33,4,3
9,356,356,34,34,0,1,0
15,398,398,91,68,23,4,3
7,451,451,62,39,23,4,3
2,460,460,30,8,22,3,2
8,468,468,4,4,0,1,0
12,485,485,34,34,0,1,0
5,486,486,1,1,0,1,0
10,486,486,27,27,0,1,0

6,109,109,28,9,19,2,1
2,122,122,6,6,0,1,0
1,141,141,17,17,0,1,0
8,191,191,6,6,0,1,0
10,193,193,5,5,0,1,0
3,204,204,24,1,23,2,1
14,205,205,27,27,0,1,0
4,237,237,13,5,8,3,2
18,242,242,50,28,22,3,2
9,263,263,13,4,9,4,3
7,273,273,25,1,24,3,2
12,303,303,1,1,0,1,0
5,314,314,32,17,15,4,3
16,332,332,21,13,8,2,1
15,338,338,81,18,63,4,3
17,359,359,21,14,7,2,1
11,418,418,41,41,0,1,0
0,422,422,2,2,0,1,0
13,451,451,27,27,0,1,0
19,458,458,24,1,23,2,1

9,149,149,5,1,4,2,1
11,181,181,41,5,36,2,1
0,230,230,13,3,10,2,1
5,249,249,33,33,0,1,0
15,272,272,80,22,58,3,2
10,279,279,11,11,0,1,0
14,282,282,29,29,0,1,0
7,313,313,53,53,0,1,0
6,316,316,63,45,18,4,3
2,326,326,65,41,24,4,3
12,358,358,40,10,30,2,1
17,376,376,10,2,8,3,2
4,380,380,1,1,0,1,0
16,433,433,18,18,0,1,0
8,440,440,11,11,0,1,0
13,454,454,18,18,0,1,0
3,461,461,51,51,0,1,0
1,487,487,3,3,0,1,0

14,123,123,5,5,0,1,0
11,129,129,26,26,0,1,0
6,132,132,1,1,0,1,0
1,166,166,1,1,0,1,0
12,293,293,18,18,0,1,0
3,299,299,7,7,0,1,0
9,325,325,80,80,0,1,0
0,359,359,59,56,3,2,1
4,395,395,51,3,48,2,1
13,432,432,19,6,13,2,1
10,451,451,1,1,0,1,0
5,457,457,246,164,82,3,2
2,458,458,18,18,0,1,0
7,482,482,67,44,23,2,1
8,497,497,90,16,74,3,2

11,100,100,5,2,3,2,1
6,178,178,10,10,0,1,0
0,183,183,16,16,0,1,0
3,225,225,53,23,30,4,3
9,225,225,44,44,0,1,0
4,233,233,25,25,0,1,0
2,282,282,12,3,9,4,3
1,376,376,201,126,75,4,3
7,377,377,107,49,58,3,2
5,394,394,66,22,44,2,1
10,470,470,20,13,7,2,1
12,488,488,7,1,6,2,1
8,490,490,3,3,0,1,0

15,141,141,18,18,0,1,0
17,145,145,5,1,4,2,1
1,153,153,22,22,0,1,0
3,155,155,6,6,0,1,0
8,158,158,12,4,8,2,1
6,180,180,51,51,0,1,0
9,200,200,1,1,0,1,0
14,232,232,41,41,0,1,0
13,259,259,42,42,0,1,0
0,292,292,12,2,10,2,1
11,301,301,58,58,0,1,0
7,303,303,36,36,0,1,0
10,348,348,17,17,0,1,0
2,381,381,38,30,8,2,1
5,387,387,35,10,25,2,1
4,406,406,5,5,0,1,0
12,445,445,41,8,33,2,1
16,475,475,36,36,0,1,0

5,127,127,27,23,4,2,1
3,200,200,59,14,45,2,1
6,200,200,20,11,9,2,1
8,207,207,6,6,0,1,0
13,228,228,42,10,32,2,1
7,244,244,22,4,18,3,2
15,247,247,103,87,16,3,2
11,274,274,6,6,0,1,0
14,287,287,5,2,3,2,1
12,304,304,6,1,5,2,1
1,314,314,48,6,42,2,1
4,355,355,35,7,28,3,2
0,397,397,16,4,12,2,1
2,436,436,1,1,0,1,0
9,457,457,48,9,39,3,2
10,460,460,15,6,9,2,1

15,146,146,7,7,0,1,0
12,183,183,13,13,0,1,0
10,185,185,18,7,11,2,1
4,217,217,67,7,60,4,3
1,240,240,8,2,6,2,1
16,258,258,6,6,0,1,0
6,299,299,12,7,5,2,1
14,304,304,8,5,3,2,1
0,326,326,31,10,21,4,3
9,328,328,3,3,0,1,0
8,358,358,24,24,0,1,0
7,366,366,25,10,15,2,1
3,369,369,74,47,27,4,3
18,412,412,3,3,0,1,0
17,416,416,66,21,45,2,1
11,429,429,181,58,123,4,3
2,443,443,6,6,0,1,0
13,464,464,28,22,6,3,2
5,465,465,30,8,22,3,2

15,152,152,30,30,0,1,0
18,158,158,6,2,4,2,1
12,202,202,17,7,10,3,2
5,203,203,23,5,18,4,3
8,210,210,19,19,0,1,0
10,253,253,18,12,6,2,1
14,298,298,13,9,4,2,1
4,326,326,15,11,4,2,1
9,344,344,77,77,0,1,0
17,356,356,48,48,0,1,0
11,363,363,3,3,0,1,0
16,367,367,105,39,66,4,3
1,393,393,31,4,27,2,1
13,398,398,19,19,0,1,0
2,420,420,22,22,0,1,0
3,460,460,67,67,0,1,0
6,466,466,2,2,0,1,0
7,471,471,6,6,0,1,0
0,489,489,65,65,0,1,0

8,112,112,19,6,13,2,1
0,113,113,10,10,0,1,0
6,119,119,16,16,0,1,0
3,156,156,6,6,0,1,0
9,162,162,8,8,0,1,0
12,224,224,26,26,0,1,0
2,228,228,6,6,0,1,0
1,260,260,5,5,0,1,0
7,292,292,28,12,16,3,2
10,300,300,19,19,0,1,0
13,336,336,2,2,0,1,0
15,350,350,49,49,0,1,0
14,375,375,36,28,8,2,1
4,406,406,64,64,0,1,0
11,443,443,84,58,26,4,3
5,447,447,197,143,54,3,2

8,139,139,2,2,0,1,0
10,146,146,4,1,3,2,1
0,159,159,26,11,15,4,3
3,177,177,9,1,8,3,2
12,182,182,64,64,0,1,0
7,188,188,7,7,0,1,0
5,189,189,16,16,0,1,0
14,194,194,9,9,0,1,0
11,194,194,31,10,21,4,3
18,259,259,27,13,14,3,2
9,307,307,5,5,0,1,0
4,312,312,56,56,0,1,0
6,314,314,105,48,57,4,3
13,346,346,11,5,6,3,2
16,353,353,5,2,3,2,1
17,365,365,19,1,18,4,3
1,421,421,2,2,0,1,0
15,423,423,54,54,0,1,0
2,487,487,8,8,0,1,0

12,108,108,1,1,0,1,0
6,153,153,2,2,0,1,0
8,155,155,10,10,0,1,0
15,189,189,2,2,0,1,0
16,211,211,56,14,42,4,3
18,235,235,39,21,18,3,2
4,248,248,17,5,12,3,2
3,271,271,37,37,0,1,0
1,284,284,15,15,0,1,0
14,294,294,23,23,0,1,0
11,303,303,25,25,0,1,0
7,320,320,2,2,0,1,0
20,345,345,9,1,8,3,2
10,359,359,12,4,8,2,1
5,362,362,22,7,15,4,3
19,382,382,39,39,0,1,0
17,406,406,46,46,0,1,0
9,411,411,99,99,0,1,0
0,461,461,42,5,37,3,2
13,472,472,71,71,0,1,0
2,488,488,25,13,12,3,2

3,102,102,26,26,0,1,0
8,107,107,10,10,0,1,0
13,121,121,3,3,0,1,0
9,148,148,19,19,0,1,0
0,184,184,6,6,0,1,0
10,185,185,50,50,0,1,0
7,194,194,17,17,0,1,0
2,227,227,28,13,15,4,3
5,262,262,51,51,0,1,0
14,370,370,12,12,0,1,0
4,374,374,62,33,29,3,2
11,379,379,31,1,30,2,1
1,407,407,13,4,9,4,3
6,418,418,5,5,0,1,0
12,434,434,4,4,0,1,0
15,471,471,36,3,33,2,1
16,497,497,100,100,0,1,0

7,133,133,8,8,0,1,0
8,155,155,15,15,0,1,0
3,171,171,24,24,0,1,0
10,181,181,25,25,0,1,0
11,183,183,16,16,0,1,0
15,207,207,69,40,29,2,1
16,240,240,9,9,0,1,0
2,274,274,20,20,0,1,0
5,300,300,40,40,0,1,0
13,337,337,19,19,0,1,0
0,340,340,88,37,51,4,3
6,361,361,51,51,0,1,0
4,369,369,11,11,0,1,0
14,374,374,9,9,0,1,0
12,399,399,47,47,0,1,0
1,409,409,26,26,0,1,0
9,458,458,14,4,10,2,1

7,107,107,2,2,0,1,0
4,110,110,7,7,0,1,0
17,161,161,54,19,35,4,3
2,185,185,6,1,5,2,1
8,196,196,14,14,0,1,0
3,247,247,31,1,30,3,2
11,276,276,20,20,0,1,0
6,341,341,55,43,12,3,2
12,345,345,32,32,0,1,0
13,368,368,29,10,19,2,1
10,385,385,16,1,15,4,3
15,414,414,6,6,0,1,0
1,419,419,107,47,60,4,3
5,425,425,29,29,0,1,0
14,447,447,64,55,9,4,3
16,455,455,39,39,0,1,0
9,477,477,23,12,11,2,1
0,482,482,51,47,4,2,1

14,120,120,12,12,0,1,0
11,142,142,12,12,0,1,0
3,179,179,15,2,13,2,1
17,183,183,36,36,0,1,0
12,187,187,31,10,21,4,3
9,204,204,25,1,24,2,1
1,207,207,31,16,15,4,3
5,230,230,14,14,0,1,0
2,238,238,29,21,8,3,2
10,247,247,4,1,3,2,1
8,286,286,64,4,60,4,3
15,286,286,46,46,0,1,0
0,289,289,5,5,0,1,0
4,316,316,32,24,8,2,1
13,316,316,22,22,0,1,0
7,323,323,4,4,0,1,0
16,329,329,3,3,0,1,0
6,420,420,55,55,0,1,0

8,100,100,12,12,0,1,0
17,107,107,11,11,0,1,0
1,133,133,6,6,0,1,0
10,140,140,9,9,0,1,0
11,156,156,11,7,4,2,1
5,167,167,12,12,0,1,0
3,207,207,50,50,0,1,0
6,261,261,50,50,0,1,0
12,275,275,5,5,0,1,0
7,281,281,55,19,36,2,1
4,330,330,1,1,0,1,0
16,387,387,17,17,0,1,0
15,390,390,34,34,0,1,0
14,398,398,96,48,48,3,2
0,405,405,3,3,0,1,0
2,426,426,11,11,0,1,0
9,471,471,101,38,63,4,3
13,481,481,34,8,26,3,2

1,113,113,6,1,5,2,1
2,117,117,14,1,13,2,1
15,147,147,18,18,0,1,0
10,155,155,20,6,14,3,2
17,177,177,2,2,0,1,0
9,212,212,2,2,0,1,0
14,237,237,18,18,0,1,0
18,243,243,52,52,0,1,0
6,251,251,20,20,0,1,0
0,254,254,35,17,18,4,3
8,271,271,2,2,0,1,0
12,343,343,16,16,0,1,0
3,384,384,28,4,24,4,3
7,417,417,85,85,0,1,0
13,422,422,12,12,0,1,0
11,450,450,26,26,0,1,0
16,473,473,112,112,0,1,0
4,484,484,64,64,0,1,0
5,491,491,42,42,0,1,0

17,108,108,8,2,6,3,2
8,110,110,7,7,0,1,0
3,130,130,9,9,0,1,0
4,176,176,1,1,0,1,0
16,194,194,44,8,36,3,2
20,196,196,17,17,0,1,0
7,204,204,46,16,30,3,2
5,208,208,1,1,0,1,0
9,222,222,21,21,0,1,0
2,240,240,15,15,0,1,0
1,254,254,8,8,0,1,0
15,321,321,2,2,0,1,0
12,325,325,18,18,0,1,0
0,334,334,33,33,0,1,0
18,344,344,91,79,12,3,2
19,367,367,20,2,18,3,2
13,369,369,2,2,0,1,0
6,376,376,65,20,45,4,3
10,380,380,17,17,0,1,0
14,405,405,57,57,0,1,0
11,448,448,12,12,0,1,0

10,102,102,3,3,0,1,0
2,120,120,1,1,0,1,0
15,166,166,16,4,12,3,2
8,174,174,13,13,0,1,0
7,184,184,55,27,28,2,1
9,188,188,3,3,0,1,0
3,207,207,24,4,20,3,2
6,249,249,15,12,3,2,1
12,252,252,14,14,0,1,0
14,261,261,30,30,0,1,0
1,266,266,4,4,0,1,0
16,273,273,68,68,0,1,0
11,278,278,27,11,16,3,2
0,282,282,11,11,0,1,0
4,294,294,8,8,0,1,0
13,355,355,65,65,0,1,0
5,438,438,148,49,99,4,3

9,123,123,14,14,0,1,0
15,159,159,1,1,0,1,0
7,160,160,29,10,19,2,1
4,164,164,7,7,0,1,0
1,206,206,57,57,0,1,0
6,237,237,78,42,36,4,3
8,241,241,3,3,0,1,0
14,252,252,10,2,8,2,1
5,255,255,30,27,3,2,1
3,337,337,10,10,0,1,0
11,358,358,66,66,0,1,0
10,388,388,33,33,0,1,0
2,402,402,31,22,9,4,3
13,459,459,123,19,104,4,3
0,484,484,15,15,0,1,0
12,489,489,13,3,10,3,2

8,132,132,2,2,0,1,0
9,137,137,2,2,0,1,0
12,163,163,59,59,0,1,0
7,168,168,4,4,0,1,0
1,171,171,22,2,20,2,1
13,174,174,29,20,9,4,3
5,179,179,1,1,0,1,0
3,206,206,50,20,30,4,3
0,208,208,37,37,0,1,0
14,238,238,22,22,0,1,0
2,259,259,7,3,4,2,1
10,317,317,23,17,6,2,1
4,320,320,67,67,0,1,0
6,325,325,36,25,11,2,1
15,456,456,19,19,0,1,0
11,485,485,66,37,29,3,2

14,102,102,9,9,0,1,0
3,174,174,22,22,0,1,0
9,192,192,20,20,0,1,0
13,199,199,47,47,0,1,0
11,221,221,30,22,8,2,1
2,230,230,1,1,0,1,0
12,240,240,5,2,3,2,1
6,276,276,18,18,0,1,0
1,312,312,25,25,0,1,0
7,336,336,89,47,42,4,3
15,347,347,3,3,0,1,0
16,351,351,10,2,8,3,2
4,384,384,68,18,50,3,2
5,413,413,41,41,0,1,0
10,447,447,109,109,0,1,0
0,479,479,40,25,15,2,1
8,495,495,24,24,0,1,0

16,101,101,10,7,3,2,1
12,114,114,1,1,0,1,0
6,167,167,5,5,0,1,0
3,168,168,18,11,7,2,1
9,173,173,4,4,0,1,0
8,185,185,20,20,0,1,0
15,224,224,42,14,28,2,1
4,252,252,21,4,17,4,3
13,258,258,8,8,0,1,0
7,432,432,136,76,60,3,2
0,433,433,1,1,0,1,0
14,448,448,42,42,0,1,0
1,467,467,75,43,32,2,1
5,488,488,39,30,9,4,3
2,492,492,61,61,0,1,0
10,493,493,151,22,129,4,3
11,500,500,33,12,21,2,1

11,132,132,7,4,3,2,1
12,144,144,16,16,0,1,0
13,149,149,14,14,0,1,0
0,150,150,12,12,0,1,0
15,171,171,6,6,0,1,0
14,217,217,36,6,30,2,1
4,274,274,49,49,0,1,0
8,280,280,20,8,12,4,3
9,350,350,5,5,0,1,0
10,405,405,36,36,0,1,0
2,414,414,48,30,18,2,1
3,424,424,56,6,50,3,2
5,451,451,37,37,0,1,0
7,480,480,139,61,78,3,2
1,483,483,7,7,0,1,0
6,497,497,148,148,0,1,0

0,138,138,24,24,0,1,0
16,159,159,5,5,0,1,0
8,170,170,2,2,0,1,0
2,189,189,25,25,0,1,0
13,231,231,51,9,42,3,2
10,233,233,16,10,6,2,1
6,263,263,11,11,0,1,0
7,297,297,48,48,0,1,0
1,298,298,21,3,18,3,2
15,304,304,29,5,24,3,2
5,311,311,75,40,35,2,1
14,314,314,13,4,9,4,3
17,329,329,8,8,0,1,0
9,368,368,27,18,9,2,1
11,436,436,53,17,36,3,2
3,452,452,12,9,3,2,1
4,475,475,20,20,0,1,0
12,493,493,119,100,19,2,1

7,109,109,11,11,0,1,0
21,155,155,3,3,0,1,0
5,160,160,2,2,0,1,0
20,162,162,34,7,27,4,3
13,183,183,38,30,8,2,1
11,185,185,8,8,0,1,0
15,199,199,6,6,0,1,0
17,233,233,26,26,0,1,0
4,241,241,4,4,0,1,0
12,243,243,5,5,0,1,0
3,289,289,76,30,46,2,1
2,302,302,7,7,0,1,0
10,327,327,12,5,7,3,2
16,331,331,29,29,0,1,0
18,344,344,22,8,14,3,2
8,345,345,5,5,0,1,0
1,396,396,13,10,3,2,1
9,397,397,13,13,0,1,0
19,417,417,69,69,0,1,0
14,419,419,6,6,0,1,0
6,464,464,21,9,12,4,3
0,466,466,121,121,0,1,0

5,149,149,1,1,0,1,0
1,151,151,1,1,0,1,0
12,161,161,13,13,0,1,0
2,183,183,25,25,0,1,0
10,212,212,29,29,0,1,0
9,254,254,66,45,21,4,3
6,257,257,73,1,72,3,2
3,276,276,91,31,60,4,3
7,314,314,10,10,0,1,0
4,318,318,20,20,0,1,0
14,325,325,4,4,0,1,0
11,328,328,12,12,0,1,0
0,405,405,146,60,86,3,2
13,413,413,30,19,11,2,1
8,428,428,2,2,0,1,0

14,117,117,14,14,0,1,0
4,130,130,12,12,0,1,0
12,153,153,58,2,56,3,2
10,171,171,2,2,0,1,0
8,173,173,1,1,0,1,0
11,188,188,4,1,3,2,1
18,205,205,29,29,0,1,0
16,225,225,33,33,0,1,0
6,231,231,3,3,0,1,0
17,240,240,3,3,0,1,0
0,280,280,31,13,18,3,2
13,338,338,32,18,14,3,2
5,346,346,80,65,15,4,3
2,379,379,66,66,0,1,0
7,404,404,17,17,0,1,0
3,447,447,3,3,0,1,0
1,466,466,76,26,50,4,3
9,469,469,29,29,0,1,0
15,470,470,1,1,0,1,0

1,159,159,4,4,0,1,0
18,173,173,10,10,0,1,0
2,176,176,41,5,36,2,1
4,216,216,21,9,12,4,3
16,251,251,16,16,0,1,0
6,299,299,5,5,0,1,0
9,307,307,37,37,0,1,0
17,353,353,36,36,0,1,0
12,379,379,21,21,0,1,0
8,380,380,23,16,7,2,1
13,424,424,62,36,26,2,1
15,424,424,3,3,0,1,0
11,425,425,41,41,0,1,0
7,431,431,34,18,16,3,2
0,443,443,29,5,24,3,2
14,455,455,144,144,0,1,0
3,463,463,81,81,0,1,0
10,467,467,31,1,30,4,3
5,476,476,14,3,11,3,2

15,117,117,6,6,0,1,0
1,118,118,27,6,21,4,3
11,149,149,4,4,0,1,0
13,175,175,25,25,0,1,0
6,224,224,10,10,0,1,0
4,259,259,19,3,16,2,1
19,273,273,7,2,5,2,1
3,307,307,1,1,0,1,0
9,307,307,3,3,0,1,0
17,312,312,11,11,0,1,0
2,363,363,62,28,34,3,2
18,366,366,36,29,7,2,1
12,371,371,15,6,9,3,2
10,376,376,23,23,0,1,0
22,378,378,112,46,66,4,3
0,389,389,1,1,0,1,0
16,394,394,122,14,108,4,3
8,445,445,10,10,0,1,0
7,474,474,10,10,0,1,0
21,481,481,7,3,4,2,1
5,492,492,26,10,16,3,2
14,493,493,1,1,0,1,0
20,498,498,40,17,23,2,1

14,123,123,3,3,0,1,0
15,129,129,5,5,0,1,0
6,152,152,19,7,12,3,2
7,172,172,32,32,0,1,0
0,185,185,7,7,0,1,0
9,192,192,44,8,36,3,2
10,213,213,23,2,21,4,3
12,268,268,7,7,0,1,0
1,297,297,83,83,0,1,0
11,307,307,49,49,0,1,0
8,310,310,39,21,18,4,3
3,318,318,23,9,14,2,1
4,321,321,14,14,0,1,0
2,421,421,90,18,72,4,3
5,440,440,58,23,35,2,1
13,500,500,9,2,7,2,1

6,112,112,2,2,0,1,0
0,121,121,7,2,5,2,1
3,133,133,4,4,0,1,0
2,166,166,14,5,9,4,3
5,176,176,33,33,0,1,0
11,236,236,16,2,14,2,1
7,241,241,24,1,23,3,2
8,275,275,19,11,8,3,2
16,295,295,41,41,0,1,0
14,295,295,70,25,45,4,3
13,314,314,22,4,18,2,1
19,338,338,63,36,27,4,3
12,343,343,17,2,15,4,3
10,386,386,56,48,8,3,2
17,390,390,3,3,0,1,0
1,392,392,23,19,4,2,1
9,394,394,1,1,0,1,0
15,439,439,18,8,10,2,1
18,447,447,52,47,5,2,1
4,495,495,73,59,14,2,1

17,104,104,20,20,0,1,0
15,120,120,12,12,0,1,0
8,146,146,42,42,0,1,0
11,183,183,24,4,20,3,2
1,184,184,1,1,0,1,0
4,212,212,64,26,38,2,1
2,220,220,8,1,7,2,1
16,246,246,4,4,0,1,0
14,280,280,9,9,0,1,0
7,290,290,40,6,34,3,2
13,303,303,7,2,5,2,1
3,355,355,1,1,0,1,0
6,401,401,22,14,8,3,2
12,428,428,12,5,7,2,1
9,434,434,36,36,0,1,0
5,448,448,1,1,0,1,0
10,466,466,148,104,44,2,1
0,470,470,34,34,0,1,0

19,100,100,10,10,0,1,0
0,111,111,5,5,0,1,0
5,132,132,12,7,5,2,1
15,168,168,22,22,0,1,0
2,172,172,53,53,0,1,0
17,179,179,7,2,5,2,1
12,194,194,9,9,0,1,0
9,206,206,2,2,0,1,0
1,240,240,31,9,22,2,1
7,255,255,11,3,8,3,2
13,273,273,6,6,0,1,0
18,280,280,21,21,0,1,0
11,285,285,3,3,0,1,0
4,328,328,6,6,0,1,0
6,336,336,13,13,0,1,0
3,350,350,1,1,0,1,0
8,402,402,48,48,0,1,0
10,452,452,43,31,12,3,2
14,484,484,27,27,0,1,0
16,496,496,220,152,68,3,2

13,131,131,26,2,24,4,3
16,136,136,9,9,0,1,0
4,189,189,6,6,0,1,0
14,224,224,25,4,21,2,1
3,256,256,19,19,0,1,0
5,259,259,107,107,0,1,0
6,284,284,36,31,5,2,1
7,327,327,39,39,0,1,0
12,347,347,52,52,0,1,0
17,355,355,14,14,0,1,0
11,406,406,69,44,25,3,2
15,407,407,19,19,0,1,0
8,407,407,24,24,0,1,0
2,426,426,13,1,12,2,1
0,436,436,10,10,0,1,0
9,450,450,28,7,21,4,3
10,457,457,37,26,11,2,1
1,482,482,12,9,3,2,1

19,101,101,8,2,6,2,1
4,111,111,11,5,6,3,2
18,119,119,17,13,4,2,1
8,132,132,7,1,6,2,1
20,139,139,4,4,0,1,0
3,153,153,19,16,3,2,1
13,175,175,20,10,10,2,1
11,178,178,6,6,0,1,0
2,179,179,31,9,22,2,1
17,207,207,40,32,8,3,2
6,227,227,37,22,15,4,3
1,246,246,8,8,0,1,0
7,254,254,18,18,0,1,0
15,264,264,17,7,10,2,1
10,315,315,1,1,0,1,0
12,321,321,13,13,0,1,0
21,388,388,17,2,15,2,1
0,399,399,4,4,0,1,0
14,403,403,50,5,45,2,1
5,422,422,4,4,0,1,0
16,423,423,54,54,0,1,0
9,455,455,41,41,0,1,0

12,123,123,4,4,0,1,0
8,169,169,13,13,0,1,0
17,173,173,3,3,0,1,0
15,235,235,3,3,0,1,0
7,242,242,1,1,0,1,0
5,246,246,49,41,8,3,2
1,262,262,2,2,0,1,0
14,264,264,64,40,24,4,3
13,279,279,1,1,0,1,0
21,286,286,18,1,17,2,1
11,304,304,11,11,0,1,0
20,308,308,86,50,36,4,3
6,322,322,2,2,0,1,0
19,325,325,1,1,0,1,0
18,332,332,83,27,56,3,2
9,373,373,102,22,80,3,2
2,394,394,5,5,0,1,0
10,407,407,26,26,0,1,0
3,448,448,8,8,0,1,0
0,491,491,12,4,8,3,2
4,497,497,74,74,0,1,0
16,500,500,20,20,0,1,0

11,101,101,4,1,3,2,1
3,174,174,15,1,14,3,2
0,180,180,81,42,39,4,3
2,244,244,27,27,0,1,0
4,257,257,61,37,24,4,3
7,266,266,24,18,6,2,1
12,277,277,4,4,0,1,0
10,299,299,16,12,4,2,1
8,301,301,45,21,24,3,2
1,304,304,77,33,44,2,1
5,412,412,35,7,28,2,1
9,471,471,8,8,0,1,0
6,473,473,107,68,39,2,1

10,142,142,16,4,12,4,3
3,142,142,11,1,10,3,2
6,200,200,48,48,0,1,0
2,209,209,1,1,0,1,0
5,219,219,7,7,0,1,0
14,231,231,84,84,0,1,0
1,322,322,25,25,0,1,0
18,334,334,10,2,8,3,2
4,340,340,71,39,32,4,3
12,370,370,37,2,35,2,1
16,384,384,28,10,18,4,3
17,392,392,11,1,10,3,2
0,405,405,40,40,0,1,0
11,419,419,12,12,0,1,0
13,425,425,46,22,24,4,3
8,462,462,10,10,0,1,0
7,467,467,48,48,0,1,0
15,477,477,33,20,13,2,1
9,478,478,18,18,0,1,0

9,138,138,24,24,0,1,0
7,176,176,37,14,23,2,1
3,202,202,61,17,44,4,3
0,249,249,4,4,0,1,0
2,257,257,19,11,8,3,2
6,260,260,10,10,0,1,0
17,311,311,26,26,0,1,0
14,327,327,37,37,0,1,0
15,345,345,19,9,10,2,1
16,363,363,48,48,0,1,0
4,365,365,21,21,0,1,0
10,372,372,5,2,3,2,1
20,378,378,89,53,36,4,3
13,383,383,78,2,76,3,2
8,391,391,1,1,0,1,0
19,394,394,6,6,0,1,0
1,402,402,1,1,0,1,0
18,431,431,9,3,6,3,2
12,438,438,23,23,0,1,0
11,470,470,4,4,0,1,0
5,488,488,1,1,0,1,0

16,107,107,8,8,0,1,0
0,113,113,3,3,0,1,0
12,144,144,6,6,0,1,0
9,174,174,18,12,6,3,2
13,237,237,19,6,13,4,3
11,242,242,11,6,5,2,1
6,307,307,87,83,4,2,1
5,337,337,33,17,16,4,3
4,384,384,19,19,0,1,0
8,388,388,39,7,32,4,3
10,394,394,158,135,23,2,1
7,403,403,29,29,0,1,0
15,407,407,33,14,19,3,2
1,429,429,64,9,55,4,3
2,472,472,34,16,18,2,1
17,478,478,22,11,11,2,1
3,488,488,24,8,16,3,2
14,496,496,23,23,0,1,0

0,147,147,3,3,0,1,0
17,154,154,34,34,0,1,0
7,184,184,1,1,0,1,0
12,205,205,3,3,0,1,0
11,207,207,4,1,3,2,1
20,284,284,4,1,3,2,1
18,291,291,20,20,0,1,0
4,311,311,12,12,0,1,0
9,355,355,13,7,6,3,2
10,355,355,100,100,0,1,0
6,372,372,22,18,4,2,1
8,376,376,35,35,0,1,0
15,376,376,2,2,0,1,0
14,385,385,17,2,15,2,1
3,390,390,9,1,8,3,2
5,392,392,32,32,0,1,0
2,441,441,97,97,0,1,0
16,450,450,7,7,0,1,0
21,456,456,218,218,0,1,0
13,483,483,9,9,0,1,0
19,494,494,24,24,0,1,0
1,497,497,5,5,0,1,0

2,100,100,20,20,0,1,0
6,117,117,9,9,0,1,0
5,122,122,11,1,10,3,2
0,187,187,26,26,0,1,0
16,232,232,81,81,0,1,0
3,235,235,24,24,0,1,0
4,322,322,3,3,0,1,0
15,331,331,18,18,0,1,0
7,337,337,56,45,11,2,1
11,347,347,1,1,0,1,0
13,361,361,50,50,0,1,0
12,364,364,34,34,0,1,0
10,367,367,10,10,0,1,0
14,396,396,67,33,34,2,1
9,419,419,24,7,17,4,3
1,454,454,53,53,0,1,0
8,488,488,11,11,0,1,0

18,100,100,12,6,6,2,1
14,107,107,16,9,7,2,1
1,153,153,21,6,15,4,3
17,169,169,15,15,0,1,0
7,175,175,8,8,0,1,0
9,191,191,2,2,0,1,0
6,208,208,37,1,36,4,3
3,215,215,15,15,0,1,0
10,221,221,1,1,0,1,0
16,232,232,44,30,14,3,2
20,235,235,18,15,3,2,1
19,280,280,12,2,10,3,2
13,284,284,28,28,0,1,0
21,338,338,27,5,22,3,2
8,362,362,41,19,22,3,2
2,410,410,57,41,16,2,1
15,414,414,36,36,0,1,0
12,419,419,4,4,0,1,0
11,426,426,16,5,11,2,1
0,442,442,4,4,0,1,0
4,458,458,61,46,15,4,3
5,465,465,7,7,0,1,0

11,107,107,8,2,6,3,2
8,153,153,16,16,0,1,0
19,158,158,2,2,0,1,0
9,183,183,12,12,0,1,0
7,200,200,19,19,0,1,0
18,217,217,55,49,6,3,2
17,219,219,6,6,0,1,0
16,246,246,3,3,0,1,0
10,260,260,12,1,11,2,1
15,266,266,34,34,0,1,0
1,311,311,14,11,3,2,1
14,355,355,42,28,14,3,2
6,379,379,18,18,0,1,0
0,380,380,12,12,0,1,0
13,437,437,32,9,23,2,1
2,438,438,86,86,0,1,0
3,446,446,10,10,0,1,0
4,470,470,68,44,24,4,3
5,483,483,49,49,0,1,0
12,499,499,112,88,24,3,2

6,129,129,4,4,0,1,0
8,135,135,2,2,0,1,0
5,147,147,4,4,0,1,0
9,174,174,9,9,0,1,0
13,258,258,69,49,20,3,2
0,297,297,10,1,9,2,1
2,304,304,66,48,18,4,3
1,324,324,108,50,58,3,2
10,346,346,21,21,0,1,0
11,346,346,75,75,0,1,0
4,381,381,77,77,0,1,0
7,403,403,17,13,4,2,1
12,406,406,81,59,22,2,1
3,431,431,50,50,0,1,0

17,106,106,1,1,0,1,0
3,109,109,6,6,0,1,0
23,110,110,1,1,0,1,0
1,168,168,4,4,0,1,0
15,180,180,3,3,0,1,0
21,220,220,33,21,12,3,2
16,232,232,7,7,0,1,0
19,234,234,21,21,0,1,0
20,248,248,21,5,16,3,2
28,253,253,21,4,17,2,1
7,277,277,19,4,15,2,1
9,319,319,4,4,0,1,0
5,363,363,1,1,0,1,0
10,364,364,4,1,3,2,1
4,389,389,21,11,10,2,1
8,394,394,5,5,0,1,0
24,395,395,44,32,12,4,3
2,414,414,7,7,0,1,0
6,415,415,57,57,0,1,0
11,418,418,58,22,36,4,3
25,419,419,66,66,0,1,0
0,439,439,49,5,44,3,2
27,442,442,4,1,3,2,1
14,445,445,18,7,11,2,1
13,454,454,1,1,0,1,0
22,455,455,37,37,0,1,0
18,461,461,8,2,6,3,2
12,486,486,25,20,5,2,1
26,493,493,110,62,48,2,1

19,107,107,15,15,0,1,0
21,114,114,4,1,3,2,1
5,129,129,32,2,30,4,3
10,133,133,8,2,6,2,1
0,143,143,6,6,0,1,0
6,168,168,8,2,6,2,1
3,193,193,4,1,3,2,1
9,219,219,11,7,4,2,1
12,237,237,4,4,0,1,0
16,245,245,8,8,0,1,0
1,266,266,30,30,0,1,0
7,326,326,30,21,9,3,2
20,378,378,11,11,0,1,0
17,383,383,3,3,0,1,0
14,392,392,118,118,0,1,0
8,409,409,5,1,4,2,1
4,414,414,32,32,0,1,0
15,417,417,25,25,0,1,0
2,425,425,6,6,0,1,0
13,445,445,46,46,0,1,0
18,464,464,101,29,72,3,2
11,500,500,55,2,53,4,3

13,114,114,13,13,0,1,0
15,131,131,5,5,0,1,0
4,186,186,6,6,0,1,0
10,202,202,1,1,0,1,0
7,271,271,1,1,0,1,0
12,272,272,5,5,0,1,0
16,279,279,42,42,0,1,0
1,285,285,138,138,0,1,0
3,289,289,31,31,0,1,0
8,301,301,74,42,32,3,2
6,321,321,12,3,9,4,3
14,337,337,16,16,0,1,0
5,370,370,47,47,0,1,0
0,372,372,6,6,0,1,0
9,391,391,72,72,0,1,0
2,406,406,38,38,0,1,0
11,488,488,57,42,15,4,3

7,139,139,40,10,30,2,1
11,146,146,5,1,4,2,1
12,161,161,8,8,0,1,0
13,248,248,12,12,0,1,0
10,266,266,23,23,0,1,0
8,268,268,47,47,0,1,0
2,283,283,15,2,13,2,1
4,353,353,131,131,0,1,0
1,360,360,140,128,12,3,2
3,365,365,32,12,20,3,2
6,405,405,25,1,24,4,3
5,443,443,46,7,39,2,1
9,447,447,32,32,0,1,0
0,467,467,1,1,0,1,0

8,106,106,8,8,0,1,0
16,120,120,9,3,6,3,2
19,145,145,17,6,11,4,3
14,152,152,48,48,0,1,0
12,153,153,8,8,0,1,0
9,167,167,42,24,18,3,2
18,174,174,2,2,0,1,0
4,198,198,1,1,0,1,0
2,204,204,20,20,0,1,0
20,208,208,33,33,0,1,0
3,220,220,15,15,0,1,0
0,227,227,32,25,7,2,1
10,239,239,27,27,0,1,0
1,261,261,2,2,0,1,0
7,288,288,3,3,0,1,0
11,300,300,1,1,0,1,0
13,367,367,11,11,0,1,0
5,386,386,5,5,0,1,0
22,432,432,56,47,9,4,3
6,454,454,15,15,0,1,0
15,460,460,4,4,0,1,0
17,486,486,8,8,0,1,0
21,487,487,43,43,0,1,0

8,130,130,3,3,0,1,0
14,156,156,38,38,0,1,0
2,255,255,15,8,7,2,1
1,283,283,51,17,34,3,2
4,305,305,31,19,12,3,2
11,308,308,35,23,12,3,2
12,314,314,42,18,24,2,1
6,318,318,45,15,30,4,3
0,333,333,5,5,0,1,0
9,334,334,10,10,0,1,0
5,424,424,24,24,0,1,0
10,454,454,41,41,0,1,0
7,470,470,14,7,7,2,1
13,490,490,55,38,17,2,1
3,497,497,243,197,46,3,2

10,139,139,7,7,0,1,0
13,145,145,25,25,0,1,0
4,149,149,22,22,0,1,0
16,171,171,11,5,6,3,2
19,205,205,13,10,3,2,1
1,225,225,9,3,6,3,2
9,243,243,45,38,7,2,1
8,249,249,7,7,0,1,0
6,250,250,3,3,0,1,0
7,270,270,29,5,24,3,2
17,286,286,6,6,0,1,0
20,289,289,20,2,18,3,2
3,290,290,13,6,7,2,1
14,302,302,14,10,4,2,1
0,351,351,12,3,9,2,1
5,364,364,31,31,0,1,0
2,405,405,26,26,0,1,0
15,411,411,12,12,0,1,0
11,414,414,42,28,14,3,2
12,466,466,142,142,0,1,0
18,467,467,68,46,22,3,2

14,107,107,2,2,0,1,0
11,125,125,4,4,0,1,0
2,177,177,8,8,0,1,0
6,247,247,28,28,0,1,0
10,268,268,21,9,12,3,2
13,281,281,61,26,35,2,1
3,299,299,45,23,22,2,1
16,306,306,83,35,48,4,3
17,311,311,18,9,9,2,1
9,317,317,50,50,0,1,0
15,319,319,16,4,12,2,1
12,320,320,38,38,0,1,0
0,347,347,9,9,0,1,0
8,364,364,3,3,0,1,0
18,364,364,32,32,0,1,0
1,368,368,14,6,8,3,2
19,404,404,26,4,22,3,2
4,408,408,96,51,45,4,3
5,439,439,5,1,4,2,1
7,480,480,19,6,13,2,1

2,104,104,3,3,0,1,0
12,114,114,6,6,0,1,0
0,135,135,13,13,0,1,0
9,147,147,11,11,0,1,0
5,148,148,5,5,0,1,0
18,148,148,4,4,0,1,0
17,160,160,32,12,20,2,1
8,169,169,47,47,0,1,0
4,179,179,1,1,0,1,0
3,191,191,1,1,0,1,0
11,263,263,28,28,0,1,0
19,280,280,42,42,0,1,0
1,370,370,42,42,0,1,0
7,375,375,25,25,0,1,0
13,377,377,25,10,15,3,2
16,446,446,36,20,16,2,1
6,448,448,7,7,0,1,0
15,452,452,51,51,0,1,0
14,457,457,55,4,51,4,3
10,496,496,91,53,38,2,1

7,145,145,8,8,0,1,0
5,163,163,6,6,0,1,0
8,163,163,15,15,0,1,0
2,217,217,20,8,12,2,1
14,231,231,3,3,0,1,0
18,237,237,26,26,0,1,0
12,244,244,37,37,0,1,0
9,256,256,72,32,40,2,1
3,280,280,6,6,0,1,0
19,305,305,21,10,11,2,1
17,321,321,52,6,46,4,3
11,329,329,57,57,0,1,0
15,329,329,27,3,24,3,2
6,341,341,49,18,31,2,1
4,347,347,35,30,5,2,1
0,370,370,4,1,3,2,1
1,384,384,12,12,0,1,0
16,390,390,40,40,0,1,0
10,416,416,15,15,0,1,0
13,420,420,22,22,0,1,0

1,127,127,4,4,0,1,0
11,140,140,21,17,4,2,1
6,146,146,12,12,0,1,0
10,191,191,12,12,0,1,0
9,200,200,17,10,7,2,1
18,263,263,18,18,0,1,0
0,264,264,3,3,0,1,0
20,283,283,8,4,4,2,1
16,300,300,1,1,0,1,0
15,327,327,48,48,0,1,0
12,334,334,6,1,5,2,1
2,343,343,45,45,0,1,0
7,353,353,52,52,0,1,0
3,380,380,38,32,6,2,1
4,395,395,1,1,0,1,0
13,427,427,23,3,20,3,2
8,447,447,40,40,0,1,0
14,465,465,41,41,0,1,0
5,467,467,5,5,0,1,0
19,490,490,118,94,24,4,3
17,498,498,132,33,99,4,3

5,100,100,13,13,0,1,0
9,131,131,17,17,0,1,0
14,170,170,11,11,0,1,0
8,174,174,13,1,12,2,1
12,195,195,20,20,0,1,0
0,204,204,17,5,12,3,2
1,267,267,12,6,6,2,1
6,328,328,9,9,0,1,0
2,409,409,135,135,0,1,0
10,449,449,43,29,14,2,1
4,453,453,119,119,0,1,0
13,453,453,48,35,13,2,1
7,454,454,68,28,40,2,1
15,484,484,85,85,0,1,0
11,486,486,13,6,7,3,2
3,489,489,12,6,6,2,1

10,122,122,4,4,0,1,0
6,143,143,18,4,14,2,1
16,146,146,3,3,0,1,0
14,161,161,26,26,0,1,0
21,173,173,25,11,14,2,1
7,174,174,11,5,6,2,1
20,186,186,13,13,0,1,0
4,231,231,37,1,36,4,3
17,237,237,94,38,56,3,2
5,243,243,6,6,0,1,0
3,249,249,11,2,9,2,1
11,278,278,5,5,0,1,0
15,278,278,5,5,0,1,0
19,334,334,18,11,7,2,1
18,336,336,18,18,0,1,0
12,341,341,21,21,0,1,0
2,344,344,35,35,0,1,0
0,358,358,1,1,0,1,0
8,386,386,4,4,0,1,0
1,399,399,71,31,40,2,1
13,429,429,2,2,0,1,0
9,473,473,37,26,11,2,1

9,107,107,2,2,0,1,0
2,138,138,7,7,0,1,0
15,169,169,43,25,18,3,2
3,174,174,57,57,0,1,0
11,181,181,28,28,0,1,0
17,220,220,44,9,35,4,3
16,221,221,25,25,0,1,0
4,241,241,44,13,31,2,1
12,251,251,5,1,4,2,1
8,328,328,1,1,0,1,0
0,328,328,12,12,0,1,0
1,367,367,20,12,8,2,1
6,378,378,6,6,0,1,0
13,389,389,40,16,24,4,3
5,454,454,10,10,0,1,0
7,483,483,101,85,16,2,1
14,488,488,2,2,0,1,0
10,495,495,26,26,0,1,0

12,126,126,7,1,6,2,1
15,134,134,7,7,0,1,0
6,176,176,1,1,0,1,0
14,193,193,35,35,0,1,0
4,196,196,1,1,0,1,0
20,198,198,3,3,0,1,0
2,200,200,12,12,0,1,0
17,234,234,3,3,0,1,0
16,251,251,4,4,0,1,0
3,258,258,1,1,0,1,0
0,288,288,24,24,0,1,0
22,314,314,1,1,0,1,0
26,318,318,6,6,0,1,0
8,337,337,16,1,15,4,3
13,339,339,14,14,0,1,0
19,356,356,5,5,0,1,0
5,358,358,82,82,0,1,0
18,363,363,207,144,63,4,3
11,370,370,4,4,0,1,0
1,385,385,1,1,0,1,0
7,440,440,1,1,0,1,0
9,445,445,34,34,0,1,0
10,458,458,8,2,6,2,1
21,472,472,17,1,16,3,2
23,493,493,6,6,0,1,0
24,494,494,110,92,18,3,2
25,496,496,10,10,0,1,0

13,107,107,40,40,0,1,0
14,143,143,1,1,0,1,0
3,163,163,9,5,4,2,1
10,182,182,28,13,15,2,1
11,187,187,16,2,14,2,1
9,211,211,10,3,7,2,1
8,235,235,86,86,0,1,0
15,252,252,4,4,0,1,0
0,263,263,5,5,0,1,0
5,276,276,11,5,6,3,2
4,292,292,50,50,0,1,0
7,297,297,5,2,3,2,1
1,358,358,22,22,0,1,0
6,370,370,44,38,6,2,1
16,376,376,43,17,26,2,1
17,377,377,24,8,16,3,2
2,436,436,24,24,0,1,0
12,498,498,26,8,18,4,3

11,107,107,5,2,3,2,1
21,117,117,13,5,8,3,2
19,126,126,12,12,0,1,0
10,130,130,7,7,0,1,0
4,134,134,1,1,0,1,0
9,170,170,9,9,0,1,0
3,194,194,9,9,0,1,0
15,205,205,12,12,0,1,0
7,225,225,10,10,0,1,0
26,241,241,38,38,0,1,0
1,244,244,1,1,0,1,0
6,250,250,10,10,0,1,0
22,262,262,5,5,0,1,0
18,321,321,12,12,0,1,0
13,330,330,26,26,0,1,0
5,352,352,25,7,18,4,3
25,353,353,109,109,0,1,0
16,382,382,6,6,0,1,0
27,418,418,26,11,15,4,3
8,418,418,2,2,0,1,0
0,432,432,11,3,8,2,1
17,435,435,52,1,51,4,3
14,441,441,31,9,22,2,1
12,445,445,19,7,12,4,3
2,449,449,37,37,0,1,0
24,452,452,40,22,18,4,3
20,495,495,16,4,12,4,3
23,498,498,22,2,20,3,2

13,102,102,11,11,0,1,0
8,103,103,30,30,0,1,0
2,171,171,2,2,0,1,0
4,206,206,14,1,13,2,1
3,209,209,8,8,0,1,0
0,278,278,64,49,15,4,3
10,278,278,43,43,0,1,0
16,278,278,10,10,0,1,0
7,282,282,46,27,19,3,2
14,286,286,25,25,0,1,0
1,302,302,22,1,21,4,3
11,317,317,21,21,0,1,0
9,418,418,60,18,42,3,2
5,436,436,118,118,0,1,0
15,446,446,9,9,0,1,0
6,484,484,23,23,0,1,0
12,492,492,6,2,4,2,1

1,105,105,6,3,3,2,1
9,112,112,1,1,0,1,0
13,120,120,1,1,0,1,0
8,177,177,3,3,0,1,0
17,185,185,9,3,6,2,1
19,192,192,8,8,0,1,0
3,214,214,8,1,7,2,1
0,251,251,82,82,0,1,0
5,310,310,7,7,0,1,0
4,327,327,6,1,5,2,1
14,342,342,35,35,0,1,0
21,345,345,9,1,8,2,1
10,348,348,16,7,9,2,1
11,362,362,11,2,9,4,3
7,395,395,25,5,20,3,2
22,399,399,20,11,9,4,3
6,406,406,68,68,0,1,0
16,428,428,61,56,5,2,1
18,433,433,58,58,0,1,0
20,451,451,46,46,0,1,0
2,458,458,20,20,0,1,0
12,478,478,26,26,0,1,0
15,497,497,130,130,0,1,0

9,109,109,1,1,0,1,0
10,116,116,3,3,0,1,0
15,163,163,10,10,0,1,0
14,199,199,7,2,5,2,1
18,217,217,60,29,31,4,3
4,220,220,20,7,13,2,1
5,221,221,21,21,0,1,0
0,224,224,3,3,0,1,0
6,252,252,30,30,0,1,0
16,263,263,11,11,0,1,0
1,271,271,18,18,0,1,0
7,287,287,62,62,0,1,0
17,305,305,1,1,0,1,0
2,359,359,22,8,14,3,2
3,407,407,15,15,0,1,0
12,411,411,95,58,37,2,1
8,414,414,71,71,0,1,0
13,438,438,18,18,0,1,0
11,487,487,90,90,0,1,0
19,500,500,23,2,21,4,3

9,144,144,8,8,0,1,0
5,147,147,5,5,0,1,0
1,152,152,24,2,22,2,1
11,199,199,41,15,26,3,2
15,210,210,6,1,5,2,1
8,325,325,19,19,0,1,0
7,346,346,35,21,14,2,1
6,361,361,15,15,0,1,0
18,384,384,103,91,12,4,3
16,395,395,2,2,0,1,0
17,396,396,29,1,28,2,1
4,400,400,15,6,9,4,3
12,423,423,23,23,0,1,0
2,444,444,13,13,0,1,0
3,447,447,1,1,0,1,0
20,450,450,10,7,3,2,1
10,453,453,38,38,0,1,0
14,458,458,60,28,32,2,1
0,471,471,45,34,11,2,1
19,471,471,76,43,33,3,2
13,472,472,78,35,43,3,2

7,129,129,25,25,0,1,0
15,142,142,8,8,0,1,0
3,158,158,17,8,9,2,1
4,159,159,8,8,0,1,0
2,162,162,5,2,3,2,1
5,186,186,1,1,0,1,0
6,187,187,16,16,0,1,0
0,199,199,28,14,14,2,1
18,227,227,38,38,0,1,0
10,264,264,13,13,0,1,0
11,287,287,14,14,0,1,0
12,314,314,4,1,3,2,1
1,320,320,22,22,0,1,0
9,352,352,3,3,0,1,0
19,393,393,54,54,0,1,0
13,401,401,72,24,48,4,3
14,411,411,39,11,28,2,1
8,415,415,67,31,36,2,1
16,437,437,89,27,62,3,2
17,482,482,7,7,0,1,0

7,108,108,53,41,12,4,3
9,121,121,14,6,8,2,1
1,175,175,14,8,6,3,2
17,177,177,17,17,0,1,0
2,201,201,5,5,0,1,0
12,231,231,5,5,0,1,0
10,232,232,16,9,7,2,1
6,233,233,16,5,11,2,1
11,287,287,34,8,26,2,1
3,299,299,1,1,0,1,0
8,319,319,20,20,0,1,0
0,330,330,8,8,0,1,0
14,350,350,40,22,18,4,3
16,379,379,31,16,15,2,1
15,384,384,93,78,15,4,3
5,446,446,19,19,0,1,0
4,449,449,47,5,42,3,2
13,490,490,26,26,0,1,0

6,134,134,1,1,0,1,0
3,142,142,1,1,0,1,0
7,180,180,8,8,0,1,0
1,184,184,41,41,0,1,0
0,198,198,52,52,0,1,0
15,271,271,46,21,25,2,1
8,272,272,30,30,0,1,0
16,305,305,32,32,0,1,0
12,306,306,26,26,0,1,0
5,311,311,2,2,0,1,0
9,351,351,13,13,0,1,0
13,371,371,19,14,5,2,1
14,390,390,9,9,0,1,0
4,399,399,39,9,30,4,3
10,422,422,54,16,38,3,2
2,428,428,108,108,0,1,0
11,437,437,89,26,63,4,3

0,118,118,1,1,0,1,0
10,152,152,15,15,0,1,0
20,175,175,8,4,4,2,1
4,178,178,27,27,0,1,0
13,204,204,14,14,0,1,0
6,214,214,11,1,10,2,1
9,221,221,10,10,0,1,0
15,264,264,28,11,17,2,1
17,299,299,30,30,0,1,0
21,301,301,56,30,26,2,1
11,310,310,7,7,0,1,0
1,332,332,19,19,0,1,0
7,336,336,55,6,49,2,1
8,356,356,55,10,45,4,3
12,388,388,11,4,7,2,1
3,413,413,25,18,7,2,1
5,419,419,18,18,0,1,0
2,421,421,7,7,0,1,0
14,425,425,61,61,0,1,0
16,464,464,14,4,10,3,2
19,469,469,62,39,23,2,1
18,483,483,49,30,19,2,1

5,109,109,42,17,25,2,1
2,120,120,17,1,16,3,2
14,136,136,18,2,16,3,2
8,212,212,37,37,0,1,0
16,213,213,1,1,0,1,0
0,214,214,3,3,0,1,0
9,258,258,36,36,0,1,0
12,301,301,8,8,0,1,0
7,309,309,14,6,8,2,1
1,317,317,8,8,0,1,0
6,342,342,43,43,0,1,0
3,374,374,55,55,0,1,0
11,392,392,6,6,0,1,0
4,439,439,7,7,0,1,0
13,450,450,113,95,18,3,2
10,460,460,5,5,0,1,0
15,475,475,75,25,50,3,2

3,101,101,13,1,12,4,3
1,143,143,16,16,0,1,0
6,245,245,10,10,0,1,0
9,246,246,24,24,0,1,0
12,261,261,31,11,20,3,2
11,275,275,18,3,15,4,3
7,279,279,40,40,0,1,0
2,284,284,95,95,0,1,0
8,288,288,68,68,0,1,0
4,323,323,102,102,0,1,0
13,355,355,45,45,0,1,0
5,391,391,4,4,0,1,0
0,417,417,4,4,0,1,0
10,460,460,35,35,0,1,0

3,181,181,2,2,0,1,0
6,189,189,31,25,6,3,2
5,212,212,3,3,0,1,0
1,223,223,5,5,0,1,0
9,274,274,63,63,0,1,0
4,291,291,19,1,18,4,3
7,311,311,45,3,42,2,1
10,354,354,58,13,45,2,1
8,371,371,38,23,15,2,1
0,444,444,391,383,8,3,2
2,500,500,8,8,0,1,0

14,113,113,15,1,14,3,2
9,190,190,32,17,15,2,1
10,195,195,8,8,0,1,0
15,232,232,6,6,0,1,0
16,235,235,20,20,0,1,0
6,255,255,6,3,3,2,1
0,283,283,72,15,57,4,3
12,293,293,22,22,0,1,0
3,296,296,1,1,0,1,0
11,322,322,18,13,5,2,1
8,384,384,28,28,0,1,0
1,403,403,10,10,0,1,0
5,404,404,24,24,0,1,0
4,404,404,103,83,20,2,1
2,440,440,69,69,0,1,0
17,443,443,100,34,66,4,3
7,482,482,25,15,10,3,2
13,491,491,57,23,34,3,2

12,118,118,10,10,0,1,0
8,145,145,22,22,0,1,0
15,154,154,7,7,0,1,0
3,160,160,5,5,0,1,0
0,170,170,7,7,0,1,0
2,296,296,21,21,0,1,0
16,306,306,14,14,0,1,0
6,317,317,34,34,0,1,0
9,319,319,27,27,0,1,0
5,343,343,75,27,48,4,3
4,345,345,47,5,42,3,2
7,346,346,11,1,10,2,1
13,346,346,83,83,0,1,0
10,366,366,21,21,0,1,0
11,399,399,19,19,0,1,0
1,407,407,46,46,0,1,0
17,423,423,121,107,14,3,2
14,442,442,12,12,0,1,0

3,132,132,8,8,0,1,0
16,140,140,31,20,11,2,1
8,141,141,14,6,8,2,1
10,162,162,2,2,0,1,0
0,165,165,20,8,12,2,1
17,168,168,6,6,0,1,0
14,179,179,10,2,8,3,2
12,186,186,8,8,0,1,0
18,199,199,9,2,7,2,1
4,261,261,51,51,0,1,0
13,267,267,26,8,18,2,1
1,269,269,7,7,0,1,0
2,278,278,47,47,0,1,0
7,321,321,10,10,0,1,0
6,323,323,14,1,13,2,1
9,341,341,24,24,0,1,0
11,365,365,86,36,50,2,1
5,409,409,35,35,0,1,0
15,433,433,76,76,0,1,0

6,157,157,27,6,21,4,3
7,192,192,56,56,0,1,0
4,200,200,27,27,0,1,0
0,219,219,7,7,0,1,0
2,234,234,55,23,32,2,1
9,251,251,18,18,0,1,0
5,260,260,14,14,0,1,0
1,290,290,6,6,0,1,0
11,299,299,7,7,0,1,0
8,385,385,15,15,0,1,0
12,431,431,39,18,21,2,1
10,478,478,18,18,0,1,0
3,499,499,306,282,24,4,3

20,140,140,45,3,42,3,2
6,160,160,11,11,0,1,0
1,192,192,8,3,5,2,1
15,202,202,17,17,0,1,0
17,204,204,14,14,0,1,0
8,240,240,14,14,0,1,0
19,255,255,14,14,0,1,0
18,270,270,34,29,5,2,1
5,286,286,17,2,15,4,3
4,291,291,1,1,0,1,0
2,317,317,11,11,0,1,0
0,339,339,12,12,0,1,0
14,339,339,7,7,0,1,0
21,341,341,11,5,6,2,1
16,348,348,48,48,0,1,0
11,362,362,59,25,34,3,2
9,385,385,14,14,0,1,0
3,392,392,53,53,0,1,0
7,400,400,16,4,12,3,2
10,419,419,12,2,10,3,2
13,420,420,32,32,0,1,0
12,486,486,95,47,48,2,1

9,120,120,1,1,0,1,0
3,129,129,1,1,0,1,0
1,182,182,20,4,16,3,2
17,188,188,9,9,0,1,0
20,254,254,1,1,0,1,0
11,322,322,28,7,21,2,1
15,328,328,19,3,16,3,2
4,337,337,85,85,0,1,0
22,348,348,22,1,21,4,3
6,352,352,1,1,0,1,0
7,372,372,75,27,48,4,3
21,383,383,44,44,0,1,0
0,402,402,18,11,7,2,1
16,408,408,28,20,8,2,1
19,409,409,165,27,138,4,3
5,414,414,35,23,12,3,2
2,429,429,1,1,0,1,0
18,440,440,40,40,0,1,0
10,445,445,7,7,0,1,0
13,449,449,19,14,5,2,1
8,460,460,16,16,0,1,0
12,474,474,3,3,0,1,0
14,483,483,29,29,0,1,0

9,117,117,3,3,0,1,0
17,131,131,21,21,0,1,0
1,148,148,23,23,0,1,0
8,158,158,1,1,0,1,0
6,174,174,2,2,0,1,0
12,176,176,31,10,21,4,3
4,201,201,45,14,31,2,1
16,237,237,7,2,5,2,1
7,265,265,10,10,0,1,0
15,269,269,11,11,0,1,0
10,288,288,23,23,0,1,0
0,355,355,78,4,74,3,2
13,387,387,23,3,20,3,2
18,389,389,44,18,26,2,1
11,419,419,43,43,0,1,0
3,427,427,1,1,0,1,0
14,435,435,64,64,0,1,0
5,452,452,12,12,0,1,0
2,477,477,95,95,0,1,0

0,173,173,5,5,0,1,0
3,178,178,21,5,16,3,2
5,181,181,45,13,32,3,2
4,193,193,5,5,0,1,0
10,207,207,9,9,0,1,0
8,254,254,61,8,53,4,3
11,257,257,2,2,0,1,0
1,297,297,72,34,38,2,1
9,317,317,15,15,0,1,0
2,357,357,184,67,117,4,3
7,451,451,6,6,0,1,0
6,468,468,38,38,0,1,0
12,492,492,104,81,23,2,1

15,141,141,12,9,3,2,1
10,185,185,9,9,0,1,0
12,211,211,44,44,0,1,0
7,226,226,51,51,0,1,0
4,243,243,63,21,42,2,1
8,246,246,5,2,3,2,1
3,257,257,28,3,25,3,2
1,281,281,41,41,0,1,0
0,288,288,14,14,0,1,0
6,290,290,73,23,50,2,1
9,299,299,44,5,39,2,1
2,340,340,22,2,20,4,3
5,345,345,8,8,0,1,0
13,384,384,19,15,4,2,1
11,466,466,44,44,0,1,0
14,474,474,20,10,10,3,2

13,122,122,18,18,0,1,0
15,145,145,1,1,0,1,0
19,167,167,10,10,0,1,0
1,184,184,21,1,20,4,3
6,186,186,2,2,0,1,0
10,219,219,21,21,0,1,0
0,221,221,1,1,0,1,0
5,243,243,71,20,51,4,3
17,260,260,58,58,0,1,0
9,274,274,12,12,0,1,0
12,275,275,16,16,0,1,0
16,278,278,78,32,46,3,2
7,301,301,44,23,21,2,1
18,429,429,39,27,12,2,1
11,432,432,13,7,6,3,2
4,444,444,21,21,0,1,0
2,458,458,16,16,0,1,0
14,462,462,11,11,0,1,0
8,475,475,28,1,27,4,3
3,494,494,27,19,8,3,2

5,108,108,16,16,0,1,0
0,115,115,1,1,0,1,0
16,119,119,10,2,8,3,2
1,159,159,5,5,0,1,0
10,182,182,1,1,0,1,0
19,191,191,24,12,12,4,3
6,203,203,1,1,0,1,0
3,230,230,3,3,0,1,0
8,238,238,24,24,0,1,0
13,244,244,5,5,0,1,0
4,251,251,55,55,0,1,0
22,255,255,26,26,0,1,0
18,277,277,12,12,0,1,0
14,322,322,48,36,12,3,2
12,345,345,7,3,4,2,1
7,347,347,24,24,0,1,0
9,348,348,19,11,8,2,1
21,394,394,38,38,0,1,0
20,410,410,43,43,0,1,0
11,430,430,17,17,0,1,0
17,438,438,83,23,60,4,3
2,458,458,77,77,0,1,0
15,500,500,10,10,0,1,0

16,109,109,2,2,0,1,0
11,112,112,13,6,7,3,2
3,151,151,47,47,0,1,0
6,160,160,4,4,0,1,0
7,163,163,27,7,20,3,2
9,168,168,19,19,0,1,0
2,181,181,1,1,0,1,0
12,249,249,23,23,0,1,0
0,255,255,37,37,0,1,0
13,280,280,31,11,20,2,1
8,301,301,29,29,0,1,0
1,428,428,59,59,0,1,0
14,439,439,71,37,34,4,3
4,447,447,42,12,30,2,1
15,471,471,94,94,0,1,0
5,483,483,9,9,0,1,0
10,485,485,3,3,0,1,0

2,157,157,1,1,0,1,0
4,182,182,80,80,0,1,0
14,199,199,3,3,0,1,0
8,216,216,2,2,0,1,0
13,222,222,3,3,0,1,0
11,224,224,12,6,6,3,2
7,227,227,5,1,4,2,1
5,230,230,19,3,16,2,1
0,290,290,35,35,0,1,0
9,306,306,44,44,0,1,0
1,321,321,66,6,60,4,3
12,329,329,87,87,0,1,0
10,342,342,33,33,0,1,0
3,387,387,18,13,5,2,1
6,403,403,122,97,25,2,1

5,143,143,1,1,0,1,0
12,150,150,12,6,6,3,2
20,161,161,30,26,4,2,1
17,170,170,15,15,0,1,0
0,179,179,8,5,3,2,1
1,186,186,10,10,0,1,0
19,187,187,1,1,0,1,0
14,205,205,1,1,0,1,0
9,218,218,26,26,0,1,0
2,226,226,4,4,0,1,0
15,251,251,80,29,51,3,2
18,320,320,5,5,0,1,0
16,330,330,22,22,0,1,0
8,343,343,14,14,0,1,0
10,361,361,37,37,0,1,0
13,366,366,13,5,8,3,2
11,367,367,5,5,0,1,0
22,370,370,73,33,40,4,3
6,379,379,28,28,0,1,0
7,392,392,43,25,18,3,2
21,414,414,12,3,9,3,2
3,427,427,51,51,0,1,0
4,431,431,36,36,0,1,0

0,106,106,1,1,0,1,0
4,115,115,1,1,0,1,0
2,126,126,18,3,15,3,2
1,134,134,6,3,3,2,1
16,155,155,26,3,23,3,2
15,178,178,19,19,0,1,0
9,229,229,6,6,0,1,0
10,282,282,5,5,0,1,0
7,290,290,63,7,56,4,3
14,300,300,33,33,0,1,0
8,320,320,18,6,12,3,2
3,334,334,8,8,0,1,0
5,334,334,31,17,14,3,2
18,349,349,57,40,17,4,3
12,353,353,9,6,3,2,1
11,357,357,12,12,0,1,0
6,390,390,109,109,0,1,0
13,403,403,104,58,46,2,1
17,496,496,16,4,12,3,2

15,106,106,11,11,0,1,0
13,138,138,23,7,16,2,1
14,172,172,11,11,0,1,0
2,188,188,9,9,0,1,0
8,191,191,13,13,0,1,0
4,197,197,1,1,0,1,0
10,235,235,11,1,10,2,1
1,258,258,8,8,0,1,0
0,283,283,3,3,0,1,0
9,322,322,86,59,27,4,3
7,328,328,39,39,0,1,0
6,339,339,17,5,12,2,1
12,352,352,63,21,42,2,1
11,359,359,17,3,14,3,2
17,373,373,36,15,21,2,1
18,374,374,5,2,3,2,1
16,425,425,86,38,48,4,3
5,461,461,87,87,0,1,0
3,489,489,56,46,10,3,2

7,104,104,3,3,0,1,0
10,150,150,12,3,9,4,3
6,161,161,6,6,0,1,0
8,162,162,3,3,0,1,0
18,164,164,9,1,8,2,1
9,246,246,64,6,58,3,2
13,255,255,1,1,0,1,0
5,263,263,10,10,0,1,0
12,265,265,70,70,0,1,0
11,271,271,43,40,3,2,1
0,292,292,10,1,9,2,1
14,294,294,12,12,0,1,0
17,363,363,33,9,24,3,2
4,364,364,99,99,0,1,0
2,369,369,38,7,31,2,1
1,376,376,15,15,0,1,0
16,391,391,60,60,0,1,0
3,394,394,27,27,0,1,0
15,423,423,29,29,0,1,0

17,118,118,21,21,0,1,0
16,129,129,1,1,0,1,0
5,135,135,13,13,0,1,0
2,150,150,5,5,0,1,0
13,167,167,10,10,0,1,0
3,210,210,14,2,12,2,1
12,212,212,58,44,14,3,2
4,228,228,6,6,0,1,0
14,232,232,13,7,6,3,2
7,265,265,1,1,0,1,0
9,271,271,36,36,0,1,0
1,331,331,39,10,29,2,1
18,337,337,38,6,32,3,2
10,368,368,66,66,0,1,0
0,368,368,11,1,10,2,1
15,461,461,3,3,0,1,0
11,468,468,19,6,13,2,1
6,470,470,74,71,3,2,1
8,479,479,113,65,48,4,3

14,105,105,14,7,7,2,1
12,114,114,11,2,9,2,1
2,128,128,34,3,31,4,3
19,150,150,18,18,0,1,0
16,211,211,16,16,0,1,0
18,230,230,26,11,15,4,3
6,242,242,19,5,14,2,1
0,243,243,7,7,0,1,0
17,266,266,61,28,33,4,3
11,277,277,4,4,0,1,0
1,291,291,11,11,0,1,0
13,308,308,42,17,25,2,1
10,343,343,17,2,15,4,3
5,409,409,75,5,70,3,2
4,411,411,24,24,0,1,0
7,437,437,10,4,6,3,2
15,439,439,3,3,0,1,0
3,451,451,57,44,13,2,1
8,479,479,17,1,16,2,1
9,500,500,7,3,4,2,1

13,109,109,3,3,0,1,0
12,122,122,36,11,25,2,1
11,146,146,8,4,4,2,1
0,159,159,6,6,0,1,0
3,176,176,2,2,0,1,0
7,187,187,15,3,12,2,1
16,211,211,35,13,22,3,2
8,260,260,2,2,0,1,0
6,292,292,48,48,0,1,0
4,328,328,51,15,36,4,3
15,355,355,6,6,0,1,0
14,360,360,5,5,0,1,0
1,427,427,31,31,0,1,0
2,435,435,35,20,15,3,2
9,455,455,73,73,0,1,0
10,483,483,89,70,19,2,1
5,488,488,147,64,83,4,3

13,104,104,31,5,26,3,2
6,122,122,15,15,0,1,0
3,142,142,13,13,0,1,0
18,163,163,7,7,0,1,0
2,174,174,10,10,0,1,0
0,182,182,3,3,0,1,0
19,193,193,31,14,17,2,1
15,218,218,53,6,47,3,2
14,231,231,6,6,0,1,0
11,244,244,24,18,6,2,1
4,273,273,47,32,15,4,3
10,287,287,11,4,7,2,1
5,305,305,6,6,0,1,0
12,306,306,1,1,0,1,0
7,327,327,12,12,0,1,0
8,353,353,13,13,0,1,0
1,378,378,28,13,15,4,3
17,382,382,18,18,0,1,0
9,386,386,53,7,46,3,2
20,456,456,16,16,0,1,0
16,480,480,33,8,25,4,3

16,104,104,9,9,0,1,0
3,121,121,1,1,0,1,0
2,138,138,17,2,15,2,1
10,140,140,4,4,0,1,0
1,213,213,31,13,18,4,3
19,233,233,18,2,16,2,1
7,273,273,14,3,11,2,1
9,300,300,4,4,0,1,0
14,304,304,50,50,0,1,0
6,309,309,8,8,0,1,0
13,326,326,98,71,27,4,3
8,377,377,6,6,0,1,0
20,378,378,16,4,12,3,2
4,379,379,14,14,0,1,0
5,394,394,84,8,76,3,2
11,404,404,2,2,0,1,0
21,418,418,28,28,0,1,0
18,430,430,16,7,9,4,3
0,434,434,69,69,0,1,0
15,457,457,34,34,0,1,0
12,488,488,37,7,30,4,3
17,491,491,31,5,26,3,2

3,108,108,11,3,8,2,1
6,165,165,13,13,0,1,0
5,216,216,7,7,0,1,0
4,218,218,9,9,0,1,0
16,230,230,16,16,0,1,0
11,237,237,5,1,4,2,1
13,248,248,16,16,0,1,0
15,253,253,5,5,0,1,0
2,254,254,24,24,0,1,0
0,288,288,74,47,27,2,1
8,318,318,32,1,31,3,2
9,336,336,15,11,4,2,1
14,336,336,19,16,3,2,1
10,351,351,9,3,6,3,2
1,398,398,38,38,0,1,0
17,413,413,109,109,0,1,0
7,428,428,43,4,39,4,3
12,457,457,160,60,100,4,3

8,118,118,3,3,0,1,0
1,146,146,4,4,0,1,0
6,164,164,18,18,0,1,0
12,249,249,27,27,0,1,0
4,251,251,27,27,0,1,0
15,275,275,11,6,5,2,1
0,284,284,75,75,0,1,0
17,311,311,5,5,0,1,0
10,340,340,42,22,20,2,1
3,348,348,70,2,68,4,3
19,351,351,31,31,0,1,0
18,366,366,11,8,3,2,1
2,374,374,12,12,0,1,0
7,377,377,1,1,0,1,0
13,386,386,4,4,0,1,0
5,399,399,1,1,0,1,0
9,410,410,2,2,0,1,0
11,419,419,89,21,68,3,2
16,468,468,43,19,24,4,3
14,470,470,147,54,93,4,3

9,112,112,4,4,0,1,0
4,131,131,15,11,4,2,1
20,138,138,3,3,0,1,0
8,157,157,3,3,0,1,0
18,164,164,2,2,0,1,0
14,169,169,12,2,10,4,3
11,184,184,7,7,0,1,0
21,192,192,7,7,0,1,0
17,201,201,57,57,0,1,0
19,205,205,22,3,19,2,1
0,215,215,3,3,0,1,0
5,235,235,3,3,0,1,0
23,258,258,91,91,0,1,0
7,301,301,9,9,0,1,0
12,319,319,5,5,0,1,0
2,332,332,84,84,0,1,0
13,358,358,32,32,0,1,0
22,359,359,26,2,24,4,3
16,369,369,1,1,0,1,0
10,385,385,5,5,0,1,0
3,407,407,36,36,0,1,0
6,443,443,6,6,0,1,0
1,478,478,46,20,26,3,2
15,488,488,15,10,5,2,1

8,124,124,2,2,0,1,0
9,147,147,1,1,0,1,0
7,152,152,32,32,0,1,0
10,162,162,21,21,0,1,0
3,164,164,13,2,11,2,1
1,223,223,3,3,0,1,0
0,229,229,6,6,0,1,0
20,238,238,19,7,12,2,1
14,251,251,15,15,0,1,0
13,262,262,13,1,12,3,2
11,271,271,12,12,0,1,0
19,288,288,52,52,0,1,0
18,389,389,58,16,42,2,1
4,431,431,15,15,0,1,0
17,441,441,20,2,18,2,1
15,453,453,4,1,3,2,1
12,473,473,83,83,0,1,0
16,474,474,80,80,0,1,0
2,486,486,136,86,50,2,1
5,490,490,24,24,0,1,0
6,500,500,6,6,0,1,0

13,186,186,7,1,6,3,2
3,232,232,9,9,0,1,0
12,249,249,31,31,0,1,0
4,257,257,16,10,6,3,2
10,257,257,14,5,9,2,1
6,323,323,17,17,0,1,0
1,339,339,39,19,20,3,2
8,340,340,10,5,5,2,1
0,347,347,26,26,0,1,0
7,401,401,54,6,48,4,3
14,413,413,61,61,0,1,0
11,426,426,31,31,0,1,0
9,447,447,5,5,0,1,0
15,465,465,139,139,0,1,0
2,476,476,27,11,16,2,1
5,489,489,245,159,86,3,2

2,109,109,4,4,0,1,0
9,115,115,9,1,8,2,1
16,119,119,25,25,0,1,0
4,146,146,1,1,0,1,0
3,178,178,1,1,0,1,0
13,181,181,27,9,18,2,1
5,205,205,9,9,0,1,0
17,205,205,30,30,0,1,0
7,224,224,23,23,0,1,0
20,242,242,1,1,0,1,0
6,317,317,66,66,0,1,0
12,319,319,51,11,40,3,2
8,341,341,56,56,0,1,0
10,357,357,44,44,0,1,0
18,395,395,45,45,0,1,0
0,400,400,38,30,8,3,2
15,400,400,16,5,11,2,1
19,432,432,10,10,0,1,0
1,438,438,12,3,9,2,1
14,475,475,34,4,30,2,1
11,496,496,4,4,0,1,0

12,128,128,4,4,0,1,0
2,206,206,14,14,0,1,0
6,222,222,16,16,0,1,0
1,250,250,59,2,57,4,3
7,288,288,45,45,0,1,0
8,296,296,64,8,56,3,2
0,318,318,180,51,129,4,3
9,319,319,20,15,5,2,1
11,320,320,6,6,0,1,0
5,406,406,68,68,0,1,0
4,414,414,49,27,22,2,1
10,448,448,32,32,0,1,0
3,477,477,15,8,7,2,1

6,117,117,1,1,0,1,0
11,156,156,4,4,0,1,0
15,171,171,45,15,30,4,3
0,196,196,5,5,0,1,0
17,200,200,14,4,10,3,2
3,217,217,18,2,16,2,1
14,224,224,5,5,0,1,0
12,265,265,1,1,0,1,0
9,266,266,3,3,0,1,0
23,273,273,52,31,21,2,1
10,278,278,11,3,8,2,1
18,285,285,21,21,0,1,0
21,298,298,9,9,0,1,0
2,321,321,55,13,42,2,1
13,327,327,23,4,19,2,1
7,431,431,3,3,0,1,0
16,448,448,50,14,36,3,2
20,459,459,10,2,8,3,2
4,460,460,26,14,12,4,3
1,464,464,63,63,0,1,0
22,469,469,67,60,7,2,1
19,471,471,4,4,0,1,0
5,472,472,1,1,0,1,0
8,476,476,114,114,0,1,0

2,107,107,20,20,0,1,0
15,119,119,27,27,0,1,0
9,120,120,21,21,0,1,0
12,143,143,10,2,8,2,1
1,158,158,15,7,8,3,2
0,167,167,30,6,24,4,3
14,168,168,28,28,0,1,0
8,243,243,21,21,0,1,0
6,253,253,4,4,0,1,0
4,267,267,7,3,4,2,1
16,274,274,14,8,6,2,1
5,285,285,3,3,0,1,0
13,313,313,3,3,0,1,0
17,320,320,9,6,3,2,1
10,340,340,24,2,22,2,1
3,345,345,34,21,13,2,1
7,428,428,87,87,0,1,0
11,467,467,54,54,0,1,0

11,110,110,11,6,5,2,1
0,147,147,4,4,0,1,0
14,156,156,80,14,66,4,3
15,170,170,15,15,0,1,0
13,173,173,8,8,0,1,0
3,204,204,4,4,0,1,0
6,218,218,24,17,7,2,1
12,219,219,12,12,0,1,0
9,260,260,1,1,0,1,0
2,287,287,8,8,0,1,0
4,333,333,43,3,40,3,2
7,334,334,21,21,0,1,0
17,345,345,18,10,8,2,1
8,364,364,44,20,24,2,1
1,385,385,28,20,8,2,1
10,395,395,4,4,0,1,0
5,405,405,134,78,56,4,3
16,445,445,20,9,11,2,1

18,101,101,9,6,3,2,1
8,116,116,15,15,0,1,0
5,120,120,10,10,0,1,0
2,127,127,5,1,4,2,1
12,148,148,30,6,24,2,1
7,156,156,17,17,0,1,0
20,165,165,10,10,0,1,0
10,209,209,57,57,0,1,0
0,233,233,26,12,14,2,1
4,248,248,2,2,0,1,0
17,257,257,22,22,0,1,0
3,258,258,8,8,0,1,0
16,303,303,2,2,0,1,0
6,324,324,6,6,0,1,0
14,324,324,25,10,15,2,1
13,382,382,4,4,0,1,0
15,387,387,1,1,0,1,0
19,401,401,156,156,0,1,0
1,413,413,24,11,13,2,1
9,432,432,13,13,0,1,0
11,486,486,5,5,0,1,0

11,109,109,34,34,0,1,0
7,121,121,11,11,0,1,0
5,149,149,3,3,0,1,0
8,201,201,5,5,0,1,0
1,226,226,18,18,0,1,0
3,328,328,193,171,22,2,1
12,333,333,51,15,36,3,2
10,337,337,18,18,0,1,0
4,341,341,29,29,0,1,0
9,365,365,8,8,0,1,0
2,386,386,75,5,70,3,2
6,396,396,64,64,0,1,0
0,457,457,18,18,0,1,0

13,169,169,30,30,0,1,0
3,193,193,2,2,0,1,0
8,198,198,23,2,21,4,3
10,204,204,3,3,0,1,0
1,220,220,17,17,0,1,0
2,248,248,15,15,0,1,0
12,264,264,2,2,0,1,0
4,280,280,31,31,0,1,0
5,291,291,53,8,45,4,3
6,343,343,62,17,45,4,3
11,352,352,26,18,8,2,1
9,362,362,30,30,0,1,0
18,395,395,10,10,0,1,0
14,403,403,82,61,21,2,1
0,409,409,14,14,0,1,0
7,421,421,20,6,14,2,1
15,450,450,98,12,86,3,2
16,487,487,3,3,0,1,0
17,496,496,94,3,91,4,3

4,110,110,12,4,8,3,2
11,119,119,9,9,0,1,0
16,148,148,60,60,0,1,0
7,168,168,5,5,0,1,0
6,183,183,50,39,11,2,1
15,194,194,16,2,14,2,1
2,220,220,36,36,0,1,0
0,249,249,1,1,0,1,0
1,372,372,49,11,38,3,2
12,378,378,21,11,10,2,1
5,392,392,19,19,0,1,0
14,426,426,22,22,0,1,0
13,442,442,3,3,0,1,0
3,445,445,64,61,3,2,1
8,460,460,19,19,0,1,0
10,475,475,52,48,4,2,1
9,477,477,45,45,0,1,0

15,101,101,15,5,10,3,2
13,143,143,7,2,5,2,1
9,170,170,5,5,0,1,0
4,180,180,3,3,0,1,0
7,184,184,16,1,15,4,3
19,213,213,2,2,0,1,0
16,223,223,3,3,0,1,0
0,236,236,1,1,0,1,0
18,236,236,20,20,0,1,0
8,251,251,27,27,0,1,0
17,300,300,14,14,0,1,0
11,352,352,19,1,18,2,1
20,355,355,100,20,80,4,3
2,362,362,32,32,0,1,0
3,371,371,44,44,0,1,0
12,375,375,41,41,0,1,0
6,384,384,5,1,4,2,1
1,400,400,116,75,41,2,1
14,437,437,80,7,73,4,3
5,472,472,15,15,0,1,0
10,500,500,30,12,18,3,2

0,101,101,13,13,0,1,0
10,111,111,19,19,0,1,0
17,138,138,9,9,0,1,0
7,147,147,1,1,0,1,0
4,159,159,2,2,0,1,0
1,191,191,3,3,0,1,0
3,194,194,42,42,0,1,0
6,207,207,17,1,16,2,1
11,215,215,10,10,0,1,0
8,243,243,19,19,0,1,0
15,298,298,71,71,0,1,0
18,300,300,20,20,0,1,0
14,366,366,23,23,0,1,0
2,392,392,38,26,12,4,3
12,402,402,31,1,30,3,2
16,415,415,85,37,48,4,3
5,421,421,18,18,0,1,0
9,446,446,1,1,0,1,0
13,475,475,16,16,0,1,0
20,479,479,64,58,6,2,1
19,496,496,14,14,0,1,0

7,100,100,3,3,0,1,0
12,105,105,1,1,0,1,0
10,110,110,1,1,0,1,0
11,117,117,3,3,0,1,0
8,118,118,12,12,0,1,0
17,119,119,10,1,9,4,3
15,126,126,2,2,0,1,0
24,129,129,16,7,9,4,3
21,172,172,25,25,0,1,0
5,190,190,1,1,0,1,0
0,254,254,45,18,27,2,1
23,268,268,4,1,3,2,1
1,273,273,1,1,0,1,0
6,299,299,6,6,0,1,0
22,300,300,65,62,3,2,1
13,301,301,37,37,0,1,0
19,315,315,18,9,9,4,3
3,337,337,14,14,0,1,0
25,355,355,58,13,45,4,3
16,365,365,4,1,3,2,1
2,374,374,3,3,0,1,0
20,376,376,36,12,24,4,3
14,391,391,60,34,26,3,2
4,402,402,30,21,9,4,3
9,482,482,44,44,0,1,0
18,498,498,8,2,6,2,1

11,133,133,10,7,3,2,1
6,135,135,2,2,0,1,0
5,142,142,3,3,0,1,0
4,153,153,5,1,4,2,1
13,167,167,3,3,0,1,0
15,167,167,6,6,0,1,0
0,195,195,2,2,0,1,0
12,216,216,1,1,0,1,0
3,218,218,21,7,14,2,1
9,222,222,4,1,3,2,1
17,271,271,44,44,0,1,0
16,285,285,2,2,0,1,0
8,296,296,8,2,6,3,2
21,299,299,46,46,0,1,0
22,316,316,27,27,0,1,0
1,370,370,116,116,0,1,0
7,373,373,11,5,6,3,2
19,375,375,97,97,0,1,0
2,397,397,42,42,0,1,0
23,448,448,28,9,19,3,2
18,460,460,28,12,16,3,2
20,461,461,43,26,17,4,3
10,464,464,50,50,0,1,0
14,483,483,13,13,0,1,0

9,104,104,28,10,18,2,1
0,111,111,37,37,0,1,0
8,126,126,11,5,6,3,2
5,205,205,50,10,40,3,2
10,251,251,60,22,38,3,2
2,272,272,32,32,0,1,0
11,312,312,15,15,0,1,0
13,314,314,8,2,6,2,1
14,338,338,1,1,0,1,0
4,361,361,22,11,11,2,1
1,375,375,31,31,0,1,0
6,393,393,36,36,0,1,0
12,421,421,65,65,0,1,0
7,425,425,2,2,0,1,0
3,495,495,32,8,24,4,3

10,141,141,3,3,0,1,0
5,187,187,19,3,16,2,1
8,190,190,103,103,0,1,0
6,203,203,15,10,5,2,1
0,257,257,48,3,45,2,1
3,273,273,28,28,0,1,0
12,304,304,12,12,0,1,0
15,361,361,9,9,0,1,0
1,385,385,21,9,12,3,2
4,387,387,124,113,11,2,1
16,388,388,6,6,0,1,0
11,389,389,3,3,0,1,0
13,425,425,21,21,0,1,0
14,471,471,71,35,36,3,2
7,473,473,27,7,20,3,2
2,484,484,2,2,0,1,0
9,495,495,30,24,6,2,1

3,155,155,7,7,0,1,0
2,157,157,17,17,0,1,0
9,176,176,8,8,0,1,0
17,207,207,11,11,0,1,0
10,207,207,4,4,0,1,0
8,218,218,35,35,0,1,0
4,239,239,1,1,0,1,0
11,250,250,46,18,28,3,2
0,268,268,68,50,18,3,2
14,269,269,17,17,0,1,0
16,281,281,33,11,22,2,1
12,287,287,4,4,0,1,0
18,351,351,126,85,41,4,3
7,351,351,18,18,0,1,0
15,358,358,6,6,0,1,0
13,410,410,36,25,11,2,1
1,419,419,16,16,0,1,0
6,427,427,16,16,0,1,0
5,454,454,73,59,14,2,1

13,101,101,13,5,8,2,1
7,134,134,4,4,0,1,0
8,192,192,43,43,0,1,0
11,253,253,37,37,0,1,0
10,260,260,53,53,0,1,0
3,298,298,9,1,8,3,2
5,319,319,11,11,0,1,0
6,359,359,31,3,28,4,3
1,362,362,10,1,9,2,1
12,365,365,12,6,6,2,1
0,378,378,83,83,0,1,0
2,416,416,10,10,0,1,0
9,430,430,16,10,6,3,2
4,481,481,288,288,0,1,0

21,105,105,2,2,0,1,0
28,136,136,12,12,0,1,0
25,187,187,25,16,9,2,1
7,194,194,32,3,29,4,3
9,197,197,3,3,0,1,0
29,214,214,36,36,0,1,0
4,233,233,2,2,0,1,0
20,241,241,2,2,0,1,0
27,250,250,16,16,0,1,0
14,267,267,12,1,11,4,3
10,269,269,4,4,0,1,0
1,286,286,22,1,21,2,1
5,288,288,4,4,0,1,0
13,294,294,45,37,8,2,1
8,299,299,22,5,17,2,1
3,325,325,35,4,31,2,1
17,330,330,5,5,0,1,0
15,332,332,1,1,0,1,0
6,360,360,7,7,0,1,0
26,363,363,35,35,0,1,0
22,371,371,46,43,3,2,1
16,382,382,9,9,0,1,0
0,401,401,13,2,11,2,1
2,447,447,1,1,0,1,0
11,463,463,1,1,0,1,0
18,467,467,7,7,0,1,0
24,469,469,34,4,30,4,3
12,474,474,3,3,0,1,0
23,484,484,72,31,41,2,1
19,494,494,50,4,46,3,2

14,105,105,12,2,10,2,1
16,136,136,1,1,0,1,0
5,182,182,34,6,28,3,2
1,221,221,1,1,0,1,0
2,292,292,2,2,0,1,0
9,292,292,7,7,0,1,0
3,294,294,56,56,0,1,0
17,330,330,33,23,10,3,2
4,332,332,15,15,0,1,0
8,336,336,25,3,22,2,1
0,337,337,6,6,0,1,0
18,392,392,9,3,6,2,1
6,409,409,85,65,20,3,2
7,420,420,60,60,0,1,0
13,441,441,21,21,0,1,0
10,448,448,141,33,108,4,3
11,461,461,84,84,0,1,0
12,476,476,28,6,22,2,1
15,490,490,36,2,34,3,2

6,117,117,5,5,0,1,0
0,165,165,14,14,0,1,0
14,186,186,10,2,8,3,2
9,197,197,70,70,0,1,0
16,215,215,10,10,0,1,0
3,230,230,32,13,19,4,3
4,244,244,5,5,0,1,0
2,244,244,25,4,21,4,3
13,341,341,46,34,12,2,1
10,377,377,25,25,0,1,0
12,400,400,32,32,0,1,0
17,402,402,22,4,18,2,1
8,448,448,72,72,0,1,0
5,471,471,71,21,50,3,2
7,478,478,70,4,66,3,2
11,481,481,58,58,0,1,0
1,487,487,26,26,0,1,0
15,496,496,1,1,0,1,0

13,140,140,8,2,6,2,1
4,161,161,21,9,12,2,1
1,232,232,28,28,0,1,0
16,233,233,40,40,0,1,0
0,243,243,1,1,0,1,0
3,262,262,25,16,9,4,3
17,265,265,3,3,0,1,0
10,310,310,36,8,28,3,2
9,317,317,13,1,12,3,2
6,327,327,79,79,0,1,0
2,341,341,4,4,0,1,0
8,347,347,42,8,34,2,1
14,384,384,25,25,0,1,0
12,388,388,135,135,0,1,0
7,430,430,15,8,7,2,1
5,446,446,63,63,0,1,0
11,476,476,10,6,4,2,1
15,489,489,43,24,19,2,1

4,114,114,15,15,0,1,0
2,234,234,4,4,0,1,0
13,242,242,13,4,9,4,3
9,254,254,49,49,0,1,0
6,301,301,10,1,9,4,3
12,312,312,44,17,27,2,1
1,322,322,12,9,3,2,1
10,323,323,46,46,0,1,0
14,347,347,46,46,0,1,0
7,357,357,4,4,0,1,0
11,383,383,2,2,0,1,0
5,400,400,117,47,70,3,2
3,460,460,39,2,37,2,1
0,463,463,156,156,0,1,0
8,469,469,93,39,54,4,3

5,106,106,1,1,0,1,0
2,114,114,12,4,8,3,2
10,117,117,33,33,0,1,0
13,124,124,3,3,0,1,0
16,127,127,1,1,0,1,0
6,149,149,18,18,0,1,0
12,191,191,1,1,0,1,0
7,212,212,23,23,0,1,0
17,212,212,34,34,0,1,0
18,217,217,17,8,9,2,1
0,247,247,4,4,0,1,0
15,268,268,14,7,7,2,1
9,269,269,1,1,0,1,0
14,273,273,76,43,33,2,1
3,279,279,11,8,3,2,1
4,322,322,6,6,0,1,0
1,380,380,20,15,5,2,1
8,392,392,167,143,24,4,3
11,473,473,13,13,0,1,0

16,118,118,3,3,0,1,0
7,171,171,2,2,0,1,0
9,178,178,13,13,0,1,0
3,186,186,15,9,6,3,2
0,197,197,7,7,0,1,0
15,216,216,7,7,0,1,0
19,221,221,7,7,0,1,0
2,226,226,2,2,0,1,0
14,229,229,3,3,0,1,0
8,243,243,15,10,5,2,1
5,262,262,2,2,0,1,0
13,284,284,29,29,0,1,0
10,306,306,99,99,0,1,0
18,339,339,4,4,0,1,0
11,366,366,133,40,93,4,3
6,395,395,3,3,0,1,0
12,398,398,123,47,76,3,2
1,409,409,98,98,0,1,0
4,479,479,25,5,20,3,2
17,492,492,13,13,0,1,0

11,108,108,3,3,0,1,0
21,131,131,6,6,0,1,0
3,145,145,11,11,0,1,0
4,145,145,4,1,3,2,1
16,168,168,17,1,16,2,1
18,186,186,32,12,20,2,1
19,195,195,31,31,0,1,0
5,211,211,37,17,20,3,2
8,229,229,1,1,0,1,0
17,272,272,8,3,5,2,1
1,292,292,17,17,0,1,0
15,341,341,48,48,0,1,0
10,356,356,86,64,22,2,1
12,358,358,12,12,0,1,0
7,377,377,14,14,0,1,0
2,382,382,13,1,12,2,1
14,383,383,83,50,33,4,3
0,385,385,57,17,40,3,2
20,394,394,3,3,0,1,0
6,397,397,4,1,3,2,1
9,431,431,12,12,0,1,0
13,499,499,22,1,21,4,3

15,114,114,7,7,0,1,0
5,124,124,8,8,0,1,0
7,185,185,25,9,16,3,2
14,212,212,10,2,8,3,2
4,221,221,19,10,9,4,3
13,242,242,12,12,0,1,0
9,320,320,112,78,34,3,2
0,333,333,37,37,0,1,0
12,345,345,10,10,0,1,0
2,346,346,23,4,19,2,1
1,354,354,87,18,69,4,3
10,366,366,9,1,8,2,1
11,389,389,21,21,0,1,0
16,402,402,65,23,42,3,2
3,410,410,67,67,0,1,0
6,457,457,13,1,12,3,2
8,490,490,67,67,0,1,0

5,103,103,1,1,0,1,0
18,118,118,27,2,25,2,1
9,127,127,1,1,0,1,0
6,128,128,8,8,0,1,0
12,157,157,21,21,0,1,0
0,208,208,16,8,8,3,2
17,209,209,2,2,0,1,0
11,229,229,1,1,0,1,0
2,240,240,1,1,0,1,0
20,243,243,1,1,0,1,0
14,245,245,29,11,18,4,3
15,291,291,11,11,0,1,0
8,306,306,12,3,9,2,1
13,372,372,34,2,32,3,2
10,403,403,15,15,0,1,0
16,403,403,92,64,28,3,2
3,428,428,9,5,4,2,1
21,445,445,82,48,34,2,1
19,448,448,4,4,0,1,0
4,481,481,5,2,3,2,1
7,495,495,11,4,7,2,1
1,497,497,236,146,90,3,2

8,135,135,1,1,0,1,0
12,188,188,7,7,0,1,0
10,194,194,11,3,8,3,2
6,242,242,5,5,0,1,0
1,247,247,45,45,0,1,0
9,287,287,23,23,0,1,0
11,288,288,93,76,17,2,1
14,325,325,72,43,29,2,1
2,344,344,57,10,47,2,1
4,368,368,15,2,13,2,1
0,396,396,134,96,38,2,1
13,420,420,47,47,0,1,0
5,453,453,3,3,0,1,0
7,476,476,29,13,16,3,2
3,494,494,83,69,14,3,2

3,109,109,22,13,9,2,1
4,133,133,22,7,15,3,2
1,153,153,9,3,6,2,1
7,195,195,13,13,0,1,0
14,219,219,12,4,8,2,1
12,235,235,49,49,0,1,0
17,269,269,28,2,26,2,1
16,279,279,2,2,0,1,0
2,282,282,43,43,0,1,0
6,322,322,27,27,0,1,0
11,330,330,5,5,0,1,0
10,339,339,16,16,0,1,0
15,373,373,66,8,58,3,2
9,402,402,12,5,7,2,1
8,423,423,27,18,9,2,1
0,436,436,3,3,0,1,0
5,454,454,32,32,0,1,0
13,471,471,115,115,0,1,0
18,492,492,25,25,0,1,0

16,106,106,11,11,0,1,0
13,144,144,10,1,9,4,3
8,167,167,34,8,26,3,2
14,193,193,4,4,0,1,0
10,223,223,61,34,27,4,3
0,269,269,18,18,0,1,0
3,273,273,15,8,7,2,1
2,294,294,77,77,0,1,0
11,296,296,35,35,0,1,0
9,303,303,28,6,22,2,1
1,333,333,13,7,6,3,2
6,354,354,53,53,0,1,0
15,364,364,10,10,0,1,0
4,371,371,117,117,0,1,0
12,414,414,5,5,0,1,0
5,457,457,2,2,0,1,0
7,490,490,4,4,0,1,0

20,105,105,11,7,4,2,1
21,144,144,8,8,0,1,0
1,165,165,11,8,3,2,1
12,168,168,4,4,0,1,0
11,179,179,4,4,0,1,0
19,187,187,10,1,9,2,1
0,202,202,18,18,0,1,0
6,217,217,16,1,15,2,1
22,236,236,50,31,19,2,1
18,264,264,14,14,0,1,0
2,268,268,1,1,0,1,0
8,287,287,15,15,0,1,0
14,314,314,12,12,0,1,0
13,342,342,23,17,6,3,2
3,349,349,8,8,0,1,0
10,363,363,30,26,4,2,1
5,387,387,79,9,70,3,2
16,389,389,27,27,0,1,0
9,424,424,21,21,0,1,0
15,429,429,65,65,0,1,0
4,432,432,29,29,0,1,0
17,449,449,80,47,33,2,1
7,452,452,35,23,12,4,3

18,152,152,4,4,0,1,0
6,174,174,11,3,8,2,1
11,179,179,45,45,0,1,0
4,187,187,27,27,0,1,0
2,276,276,8,8,0,1,0
9,286,286,2,2,0,1,0
13,289,289,24,24,0,1,0
0,306,306,10,10,0,1,0
15,331,331,72,33,39,4,3
20,332,332,31,13,18,3,2
10,349,349,6,6,0,1,0
17,360,360,40,31,9,4,3
16,361,361,10,2,8,2,1
8,365,365,24,5,19,2,1
14,372,372,35,24,11,2,1
21,381,381,5,5,0,1,0
19,387,387,98,26,72,4,3
1,392,392,9,4,5,2,1
7,393,393,1,1,0,1,0
5,401,401,80,58,22,2,1
12,420,420,27,27,0,1,0
3,498,498,1,1,0,1,0

6,110,110,1,1,0,1,0
10,111,111,12,9,3,2,1
19,129,129,5,5,0,1,0
12,139,139,14,14,0,1,0
0,148,148,31,31,0,1,0
15,148,148,35,7,28,2,1
8,189,189,8,3,5,2,1
5,217,217,3,3,0,1,0
3,241,241,12,2,10,2,1
11,244,244,1,1,0,1,0
2,246,246,13,10,3,2,1
9,254,254,17,17,0,1,0
16,310,310,18,18,0,1,0
14,364,364,5,2,3,2,1
17,370,370,115,115,0,1,0
1,387,387,41,41,0,1,0
13,397,397,49,3,46,3,2
4,409,409,94,86,8,3,2
18,409,409,12,4,8,3,2
7,500,500,9,9,0,1,0

14,103,103,25,3,22,3,2
7,119,119,18,18,0,1,0
19,123,123,2,2,0,1,0
11,125,125,3,3,0,1,0
17,147,147,11,2,9,2,1
18,172,172,9,3,6,2,1
3,200,200,1,1,0,1,0
4,275,275,3,3,0,1,0
5,277,277,6,1,5,2,1
13,305,305,41,3,38,2,1
21,315,315,30,10,20,3,2
8,325,325,80,55,25,2,1
0,343,343,6,2,4,2,1
9,348,348,19,3,16,2,1
12,350,350,4,4,0,1,0
15,356,356,88,10,78,3,2
1,382,382,29,5,24,4,3
16,391,391,12,3,9,4,3
6,392,392,8,8,0,1,0
10,418,418,9,2,7,2,1
20,425,425,13,13,0,1,0
2,471,471,113,113,0,1,0

17,108,108,34,1,33,4,3
10,120,120,23,23,0,1,0
1,131,131,13,13,0,1,0
11,195,195,11,11,0,1,0
18,221,221,21,3,18,4,3
16,223,223,19,1,18,4,3
13,259,259,25,25,0,1,0
0,268,268,29,3,26,3,2
14,268,268,12,12,0,1,0
5,272,272,17,7,10,2,1
3,277,277,1,1,0,1,0
9,280,280,28,9,19,2,1
4,293,293,13,1,12,4,3
20,324,324,29,29,0,1,0
8,335,335,8,8,0,1,0
15,342,342,26,20,6,3,2
2,356,356,12,12,0,1,0
7,369,369,17,17,0,1,0
6,399,399,54,54,0,1,0
19,401,401,43,43,0,1,0
12,406,406,3,3,0,1,0

11,119,119,3,3,0,1,0
1,120,120,6,6,0,1,0
13,126,126,6,2,4,2,1
0,137,137,17,3,14,3,2
9,141,141,6,6,0,1,0
15,157,157,19,19,0,1,0
19,201,201,14,14,0,1,0
10,213,213,17,7,10,2,1
16,238,238,51,51,0,1,0
8,245,245,4,4,0,1,0
18,293,293,36,18,18,3,2
5,301,301,7,3,4,2,1
12,301,301,20,2,18,3,2
2,342,342,34,1,33,4,3
22,347,347,22,15,7,2,1
20,375,375,17,17,0,1,0
3,391,391,92,51,41,2,1
6,393,393,12,12,0,1,0
14,394,394,10,10,0,1,0
21,423,423,98,23,75,4,3
7,425,425,15,15,0,1,0
4,464,464,12,12,0,1,0
17,487,487,12,3,9,2,1

13,114,114,6,1,5,2,1
15,121,121,12,5,7,2,1
0,166,166,12,12,0,1,0
2,174,174,7,7,0,1,0
14,235,235,9,9,0,1,0
11,283,283,13,13,0,1,0
10,296,296,126,126,0,1,0
9,306,306,2,2,0,1,0
1,312,312,22,22,0,1,0
3,373,373,21,8,13,2,1
16,375,375,6,1,5,2,1
12,380,380,60,60,0,1,0
6,387,387,44,11,33,4,3
7,391,391,126,75,51,4,3
5,396,396,20,20,0,1,0
4,417,417,42,42,0,1,0
8,425,425,32,16,16,2,1
17,447,447,37,15,22,3,2

10,111,111,16,5,11,2,1
4,124,124,28,28,0,1,0
15,147,147,3,3,0,1,0
2,169,169,35,35,0,1,0
8,172,172,50,50,0,1,0
5,172,172,17,10,7,2,1
12,202,202,30,2,28,3,2
11,209,209,4,4,0,1,0
9,231,231,5,5,0,1,0
13,232,232,20,20,0,1,0
6,261,261,7,7,0,1,0
7,323,323,9,9,0,1,0
0,333,333,29,5,24,3,2
1,342,342,74,8,66,4,3
3,364,364,4,1,3,2,1
16,418,418,1,1,0,1,0
14,476,476,87,23,64,4,3

13,102,102,13,13,0,1,0
0,103,103,14,6,8,2,1
14,123,123,3,3,0,1,0
17,149,149,5,1,4,2,1
12,183,183,13,7,6,2,1
19,196,196,16,8,8,2,1
1,226,226,2,2,0,1,0
9,246,246,37,12,25,2,1
10,255,255,24,16,8,2,1
2,266,266,18,9,9,3,2
5,267,267,7,7,0,1,0
6,286,286,8,8,0,1,0
16,308,308,9,9,0,1,0
15,313,313,15,1,14,2,1
4,323,323,1,1,0,1,0
18,386,386,98,98,0,1,0
11,388,388,5,1,4,2,1
20,397,397,99,99,0,1,0
8,399,399,7,7,0,1,0
3,439,439,59,2,57,4,3
7,451,451,100,61,39,4,3

5,107,107,6,6,0,1,0
3,110,110,1,1,0,1,0
18,126,126,5,2,3,2,1
7,141,141,27,22,5,2,1
0,164,164,10,10,0,1,0
16,173,173,6,6,0,1,0
8,215,215,18,18,0,1,0
17,249,249,17,13,4,2,1
10,254,254,72,41,31,2,1
13,255,255,26,26,0,1,0
15,282,282,25,25,0,1,0
12,296,296,39,18,21,4,3
1,306,306,13,5,8,3,2
11,327,327,50,50,0,1,0
4,371,371,26,26,0,1,0
2,377,377,42,42,0,1,0
6,401,401,92,40,52,3,2
9,432,432,20,2,18,4,3
14,449,449,8,8,0,1,0

3,176,176,16,16,0,1,0
5,177,177,3,3,0,1,0
4,186,186,4,1,3,2,1
12,196,196,13,13,0,1,0
11,196,196,21,21,0,1,0
13,201,201,67,11,56,3,2
7,202,202,1,1,0,1,0
14,275,275,2,2,0,1,0
6,316,316,31,27,4,2,1
9,346,346,38,14,24,4,3
15,351,351,8,8,0,1,0
8,368,368,34,34,0,1,0
10,419,419,44,44,0,1,0
1,438,438,185,87,98,3,2
2,459,459,42,17,25,3,2
0,468,468,72,72,0,1,0
16,469,469,31,31,0,1,0

10,115,115,25,25,0,1,0
8,130,130,27,18,9,2,1
2,156,156,58,22,36,4,3
16,170,170,1,1,0,1,0
7,189,189,10,6,4,2,1
13,215,215,1,1,0,1,0
5,261,261,8,8,0,1,0
14,273,273,6,1,5,2,1
15,290,290,43,25,18,2,1
0,300,300,1,1,0,1,0
6,309,309,13,13,0,1,0
11,309,309,7,7,0,1,0
1,323,323,20,20,0,1,0
4,373,373,31,21,10,2,1
9,379,379,61,5,56,3,2
12,390,390,51,36,15,2,1
3,418,418,107,71,36,4,3

13,104,104,26,23,3,2,1
1,128,128,21,10,11,2,1
19,129,129,9,3,6,3,2
7,131,131,9,9,0,1,0
5,148,148,9,9,0,1,0
8,168,168,11,8,3,2,1
14,205,205,8,8,0,1,0
17,210,210,6,6,0,1,0
18,213,213,15,3,12,4,3
2,224,224,43,5,38,3,2
4,247,247,19,19,0,1,0
12,290,290,20,6,14,2,1
3,316,316,7,4,3,2,1
16,386,386,92,89,3,2,1
15,391,391,29,29,0,1,0
10,414,414,2,2,0,1,0
0,429,429,30,21,9,4,3
6,442,442,56,29,27,4,3
9,470,470,23,10,13,4,3
11,496,496,42,42,0,1,0

2,111,111,5,5,0,1,0
4,142,142,8,2,6,2,1
15,197,197,6,6,0,1,0
14,214,214,36,11,25,2,1
0,306,306,18,10,8,2,1
8,337,337,57,57,0,1,0
12,351,351,8,8,0,1,0
5,362,362,29,20,9,4,3
11,381,381,4,1,3,2,1
6,417,417,162,162,0,1,0
13,428,428,142,94,48,4,3
7,437,437,6,6,0,1,0
9,453,453,37,11,26,2,1
1,465,465,111,111,0,1,0
10,465,465,41,10,31,2,1
3,488,488,16,16,0,1,0

15,112,112,21,21,0,1,0
8,137,137,16,4,12,3,2
2,143,143,13,5,8,2,1
1,149,149,9,9,0,1,0
14,222,222,2,2,0,1,0
10,238,238,31,3,28,2,1
0,298,298,2,2,0,1,0
16,300,300,20,20,0,1,0
6,315,315,8,3,5,2,1
5,332,332,3,3,0,1,0
11,354,354,87,87,0,1,0
3,355,355,148,148,0,1,0
4,405,405,81,60,21,2,1
7,407,407,37,19,18,4,3
13,409,409,41,41,0,1,0
9,461,461,28,9,19,2,1
12,487,487,1,1,0,1,0

8,128,128,10,10,0,1,0
13,137,137,19,19,0,1,0
16,157,157,10,10,0,1,0
4,190,190,69,9,60,3,2
14,220,220,13,6,7,2,1
3,225,225,6,3,3,2,1
9,226,226,11,8,3,2,1
12,249,249,81,32,49,4,3
7,378,378,14,14,0,1,0
1,405,405,30,17,13,2,1
5,434,434,92,92,0,1,0
6,447,447,11,11,0,1,0
0,453,453,36,22,14,3,2
10,454,454,14,1,13,2,1
15,458,458,8,1,7,2,1
2,464,464,39,20,19,2,1
11,475,475,74,74,0,1,0

1,104,104,1,1,0,1,0
13,115,115,8,8,0,1,0
9,130,130,6,3,3,2,1
4,140,140,4,4,0,1,0
14,250,250,9,5,4,2,1
0,256,256,14,14,0,1,0
6,268,268,18,8,10,3,2
2,273,273,95,37,58,3,2
8,286,286,17,17,0,1,0
7,299,299,15,15,0,1,0
3,307,307,55,16,39,2,1
11,387,387,194,71,123,4,3
10,403,403,41,6,35,4,3
5,424,424,91,76,15,4,3
15,468,468,8,8,0,1,0
12,481,481,19,19,0,1,0

12,104,104,3,3,0,1,0
8,132,132,3,3,0,1,0
3,171,171,1,1,0,1,0
15,182,182,3,3,0,1,0
4,236,236,10,2,8,2,1
5,242,242,29,15,14,2,1
18,250,250,14,14,0,1,0
17,255,255,126,111,15,4,3
21,256,256,5,2,3,2,1
1,271,271,1,1,0,1,0
10,273,273,10,10,0,1,0
19,281,281,12,12,0,1,0
7,291,291,14,2,12,4,3
13,298,298,3,3,0,1,0
16,299,299,6,2,4,2,1
0,312,312,11,11,0,1,0
9,350,350,142,117,25,2,1
11,381,381,10,4,6,3,2
2,403,403,43,43,0,1,0
20,406,406,71,71,0,1,0
14,469,469,36,26,10,2,1
6,473,473,13,13,0,1,0

6,114,114,4,4,0,1,0
10,130,130,12,4,8,2,1
0,176,176,10,1,9,4,3
1,190,190,9,1,8,3,2
14,306,306,102,74,28,3,2
3,309,309,4,4,0,1,0
12,310,310,3,3,0,1,0
15,315,315,38,20,18,3,2
8,320,320,137,127,10,3,2
16,342,342,12,2,10,3,2
7,347,347,1,1,0,1,0
13,372,372,61,61,0,1,0
9,390,390,20,20,0,1,0
17,395,395,7,7,0,1,0
2,416,416,70,22,48,2,1
11,423,423,39,21,18,2,1
5,447,447,34,34,0,1,0
4,480,480,36,2,34,3,2

3,128,128,5,2,3,2,1
12,142,142,3,3,0,1,0
20,165,165,12,12,0,1,0
22,202,202,25,25,0,1,0
0,208,208,10,10,0,1,0
2,210,210,30,30,0,1,0
14,228,228,21,21,0,1,0
11,231,231,4,4,0,1,0
15,238,238,9,9,0,1,0
19,239,239,18,1,17,3,2
5,244,244,21,21,0,1,0
21,245,245,22,2,20,3,2
16,276,276,20,20,0,1,0
10,281,281,3,3,0,1,0
4,330,330,7,7,0,1,0
18,336,336,112,32,80,4,3
17,421,421,3,3,0,1,0
6,432,432,33,18,15,4,3
7,433,433,19,3,16,2,1
13,436,436,1,1,0,1,0
23,458,458,49,24,25,2,1
8,462,462,66,45,21,2,1
9,477,477,51,51,0,1,0
1,495,495,26,26,0,1,0

7,106,106,1,1,0,1,0
13,124,124,31,31,0,1,0
8,168,168,11,7,4,2,1
6,198,198,10,1,9,4,3
20,209,209,29,29,0,1,0
14,214,214,25,25,0,1,0
0,231,231,59,59,0,1,0
21,255,255,11,11,0,1,0
12,277,277,34,34,0,1,0
18,281,281,4,4,0,1,0
10,288,288,8,8,0,1,0
16,328,328,12,5,7,2,1
19,339,339,20,10,10,3,2
15,344,344,19,19,0,1,0
17,349,349,71,5,66,3,2
1,377,377,21,9,12,4,3
4,397,397,9,6,3,2,1
2,415,415,37,15,22,3,2
11,424,424,14,14,0,1,0
5,433,433,47,47,0,1,0
3,461,461,15,6,9,4,3
9,499,499,14,1,13,2,1

4,110,110,5,5,0,1,0
12,141,141,8,8,0,1,0
9,152,152,2,2,0,1,0
0,165,165,4,4,0,1,0
2,172,172,2,2,0,1,0
7,175,175,17,11,6,3,2
15,194,194,5,1,4,2,1
6,220,220,22,22,0,1,0
3,256,256,102,102,0,1,0
13,300,300,38,38,0,1,0
8,384,384,54,54,0,1,0
11,436,436,19,19,0,1,0
5,437,437,14,14,0,1,0
1,446,446,130,130,0,1,0
14,454,454,103,103,0,1,0
10,456,456,85,54,31,2,1

12,114,114,8,2,6,3,2
6,120,120,1,1,0,1,0
14,138,138,24,9,15,4,3
7,184,184,21,3,18,3,2
16,201,201,32,14,18,2,1
2,211,211,14,14,0,1,0
18,265,265,32,32,0,1,0
17,270,270,14,14,0,1,0
11,277,277,1,1,0,1,0
1,278,278,20,20,0,1,0
8,326,326,48,12,36,2,1
13,351,351,9,3,6,3,2
3,380,380,11,11,0,1,0
10,386,386,47,47,0,1,0
5,392,392,101,17,84,4,3
4,428,428,13,5,8,3,2
9,460,460,50,10,40,3,2
0,480,480,32,23,9,2,1
15,489,489,97,97,0,1,0

16,109,109,13,3,10,3,2
11,122,122,4,4,0,1,0
13,185,185,16,7,9,2,1
4,201,201,21,21,0,1,0
6,202,202,4,4,0,1,0
14,245,245,73,28,45,2,1
7,256,256,35,35,0,1,0
8,273,273,6,6,0,1,0
3,292,292,27,27,0,1,0
1,293,293,23,23,0,1,0
2,358,358,66,29,37,3,2
0,369,369,100,85,15,4,3
5,403,403,6,6,0,1,0
15,404,404,69,55,14,2,1
10,410,410,47,39,8,3,2
12,413,413,9,9,0,1,0
9,457,457,24,14,10,2,1

6,117,117,6,6,0,1,0
16,121,121,1,1,0,1,0
12,126,126,13,5,8,2,1
5,145,145,2,2,0,1,0
19,145,145,28,12,16,3,2
4,175,175,1,1,0,1,0
7,177,177,61,61,0,1,0
11,185,185,47,35,12,3,2
18,201,201,6,1,5,2,1
2,230,230,12,2,10,3,2
8,249,249,3,3,0,1,0
9,266,266,25,25,0,1,0
10,290,290,13,3,10,3,2
3,307,307,40,40,0,1,0
1,367,367,27,3,24,4,3
17,447,447,1,1,0,1,0
15,466,466,23,5,18,3,2
14,486,486,23,3,20,4,3
13,495,495,119,109,10,2,1
0,500,500,39,39,0,1,0

8,106,106,12,4,8,3,2
11,210,210,49,31,18,3,2
5,216,216,1,1,0,1,0
12,241,241,19,4,15,4,3
13,254,254,29,3,26,2,1
6,298,298,36,15,21,4,3
1,309,309,3,3,0,1,0
9,318,318,11,1,10,3,2
2,319,319,25,25,0,1,0
16,349,349,1,1,0,1,0
3,367,367,16,7,9,4,3
17,399,399,29,29,0,1,0
0,415,415,165,109,56,3,2
14,433,433,48,38,10,2,1
15,442,442,96,41,55,4,3
4,445,445,27,7,20,3,2
7,454,454,35,17,18,4,3
10,497,497,25,5,20,2,1

4,112,112,4,1,3,2,1
14,117,117,6,1,5,2,1
17,178,178,42,42,0,1,0
9,186,186,2,2,0,1,0
16,187,187,27,5,22,3,2
19,198,198,22,9,13,2,1
20,209,209,4,4,0,1,0
5,235,235,8,2,6,2,1
6,256,256,43,43,0,1,0
18,263,263,39,8,31,2,1
15,289,289,44,44,0,1,0
11,309,309,1,1,0,1,0
8,333,333,12,12,0,1,0
22,342,342,12,2,10,2,1
21,344,344,9,9,0,1,0
1,370,370,39,4,35,2,1
10,377,377,56,13,43,2,1
12,385,385,14,11,3,2,1
3,398,398,19,15,4,2,1
2,417,417,25,25,0,1,0
7,436,436,34,34,0,1,0
0,470,470,55,11,44,4,3
13,487,487,10,10,0,1,0

16,131,131,24,12,12,3,2
9,132,132,6,6,0,1,0
5,172,172,26,26,0,1,0
3,187,187,31,4,27,2,1
10,200,200,15,15,0,1,0
1,219,219,44,44,0,1,0
13,235,235,38,23,15,4,3
7,299,299,30,16,14,2,1
0,307,307,15,15,0,1,0
6,310,310,22,22,0,1,0
12,403,403,6,6,0,1,0
14,422,422,95,55,40,3,2
11,450,450,51,18,33,4,3
4,465,465,61,61,0,1,0
2,479,479,16,16,0,1,0
15,483,483,8,8,0,1,0
8,489,489,42,30,12,2,1

15,132,132,4,4,0,1,0
7,142,142,31,19,12,4,3
0,145,145,50,8,42,4,3
10,150,150,35,16,19,2,1
5,169,169,22,22,0,1,0
3,181,181,6,1,5,2,1
16,201,201,29,11,18,4,3
12,290,290,12,6,6,3,2
8,340,340,49,15,34,3,2
2,348,348,5,1,4,2,1
11,380,380,18,15,3,2,1
13,388,388,8,5,3,2,1
14,402,402,66,41,25,2,1
6,432,432,46,7,39,2,1
1,466,466,6,6,0,1,0
9,469,469,41,41,0,1,0
4,471,471,21,4,17,4,3

12,103,103,1,1,0,1,0
6,117,117,2,2,0,1,0
15,120,120,5,5,0,1,0
2,137,137,2,2,0,1,0
14,155,155,18,18,0,1,0
0,172,172,1,1,0,1,0
9,173,173,6,6,0,1,0
8,205,205,13,7,6,3,2
7,221,221,50,4,46,2,1
10,233,233,17,4,13,3,2
19,258,258,16,16,0,1,0
18,277,277,7,7,0,1,0
21,282,282,19,7,12,4,3
13,294,294,71,71,0,1,0
3,365,365,8,4,4,2,1
20,400,400,45,6,39,2,1
11,422,422,12,5,7,3,2
1,438,438,25,25,0,1,0
5,466,466,55,55,0,1,0
17,476,476,5,5,0,1,0
4,486,486,112,80,32,3,2
16,487,487,120,85,35,2,1

3,117,117,15,1,14,2,1
10,174,174,1,1,0,1,0
13,188,188,28,28,0,1,0
2,189,189,24,24,0,1,0
12,235,235,12,12,0,1,0
7,241,241,8,8,0,1,0
1,265,265,42,42,0,1,0
5,286,286,5,5,0,1,0
0,300,300,21,21,0,1,0
6,372,372,57,57,0,1,0
8,383,383,165,57,108,4,3
15,386,386,33,6,27,2,1
9,416,416,37,37,0,1,0
11,424,424,6,3,3,2,1
14,436,436,26,3,23,2,1
4,499,499,123,25,98,3,2

6,151,151,29,24,5,2,1
18,153,153,4,1,3,2,1
0,196,196,5,2,3,2,1
12,226,226,81,4,77,4,3
9,229,229,16,16,0,1,0
11,245,245,8,8,0,1,0
13,269,269,18,18,0,1,0
4,312,312,3,3,0,1,0
17,316,316,41,41,0,1,0
15,337,337,38,14,24,4,3
3,342,342,29,29,0,1,0
10,346,346,18,9,9,4,3
14,363,363,14,14,0,1,0
8,376,376,1,1,0,1,0
16,389,389,13,13,0,1,0
19,419,419,50,50,0,1,0
2,428,428,35,35,0,1,0
7,433,433,6,1,5,2,1
5,473,473,41,20,21,4,3
1,473,473,133,45,88,3,2

12,110,110,1,1,0,1,0
3,122,122,6,6,0,1,0
1,125,125,20,9,11,2,1
4,131,131,15,15,0,1,0
11,139,139,13,13,0,1,0
7,165,165,18,18,0,1,0
6,167,167,11,11,0,1,0
5,173,173,10,10,0,1,0
17,184,184,1,1,0,1,0
0,196,196,7,4,3,2,1
9,237,237,25,3,22,3,2
2,239,239,27,19,8,3,2
15,302,302,10,10,0,1,0
14,370,370,136,136,0,1,0
18,395,395,76,76,0,1,0
16,400,400,7,1,6,2,1
13,403,403,64,64,0,1,0
19,418,418,16,8,8,2,1
8,464,464,15,15,0,1,0
10,497,497,29,29,0,1,0

6,118,118,28,8,20,2,1
9,178,178,26,26,0,1,0
0,207,207,40,40,0,1,0
14,207,207,27,27,0,1,0
3,223,223,6,2,4,2,1
11,229,229,23,1,22,2,1
5,232,232,16,16,0,1,0
12,249,249,12,12,0,1,0
7,254,254,3,3,0,1,0
2,268,268,10,10,0,1,0
13,321,321,8,2,6,2,1
4,330,330,71,71,0,1,0
10,339,339,91,2,89,4,3
15,340,340,27,18,9,2,1
8,393,393,44,5,39,4,3
1,428,428,55,35,20,3,2

8,169,169,25,3,22,3,2
7,183,183,22,22,0,1,0
0,204,204,76,76,0,1,0
2,254,254,34,34,0,1,0
11,289,289,1,1,0,1,0
1,319,319,10,10,0,1,0
5,330,330,44,44,0,1,0
12,353,353,13,13,0,1,0
9,355,355,6,6,0,1,0
14,401,401,105,105,0,1,0
3,442,442,97,25,72,4,3
10,453,453,7,3,4,2,1
13,454,454,56,42,14,3,2
6,488,488,94,32,62,3,2
4,498,498,5,2,3,2,1

0,100,100,11,11,0,1,0
17,103,103,3,3,0,1,0
4,156,156,30,18,12,3,2
9,159,159,15,15,0,1,0
19,185,185,23,17,6,3,2
2,223,223,13,13,0,1,0
7,232,232,3,3,0,1,0
13,238,238,16,16,0,1,0
8,239,239,1,1,0,1,0
15,285,285,30,30,0,1,0
16,286,286,2,2,0,1,0
1,310,310,15,15,0,1,0
5,360,360,14,6,8,3,2
11,364,364,35,27,8,2,1
12,371,371,47,20,27,2,1
18,418,418,101,93,8,3,2
3,453,453,62,17,45,4,3
10,466,466,50,29,21,4,3
6,474,474,46,8,38,3,2
14,491,491,61,27,34,2,1

13,121,121,7,1,6,2,1
8,144,144,35,35,0,1,0
18,187,187,21,7,14,4,3
2,200,200,6,6,0,1,0
14,202,202,11,2,9,4,3
19,202,202,57,13,44,2,1
6,211,211,35,23,12,3,2
10,273,273,30,30,0,1,0
0,282,282,15,11,4,2,1
11,358,358,4,4,0,1,0
16,367,367,45,15,30,2,1
15,376,376,30,30,0,1,0
7,381,381,39,39,0,1,0
1,382,382,25,9,16,3,2
4,401,401,1,1,0,1,0
3,429,429,2,2,0,1,0
9,447,447,48,48,0,1,0
17,454,454,22,22,0,1,0
20,462,462,19,5,14,3,2
12,469,469,58,58,0,1,0
5,478,478,3,3,0,1,0

0,114,114,1,1,0,1,0
16,119,119,15,15,0,1,0
5,125,125,6,6,0,1,0
11,146,146,47,47,0,1,0
3,153,153,38,38,0,1,0
2,196,196,37,10,27,2,1
13,201,201,17,17,0,1,0
9,223,223,17,17,0,1,0
7,231,231,7,7,0,1,0
17,295,295,41,30,11,2,1
10,300,300,27,2,25,2,1
4,337,337,23,7,16,2,1
12,341,341,12,12,0,1,0
8,366,366,23,23,0,1,0
18,367,367,27,15,12,4,3
1,377,377,58,25,33,2,1
14,421,421,11,11,0,1,0
6,425,425,7,7,0,1,0
15,488,488,9,9,0,1,0

10,130,130,8,8,0,1,0
5,134,134,2,2,0,1,0
15,134,134,10,3,7,2,1
0,140,140,18,18,0,1,0
1,140,140,8,8,0,1,0
11,149,149,4,4,0,1,0
16,169,169,17,17,0,1,0
9,174,174,1,1,0,1,0
8,199,199,17,3,14,2,1
14,202,202,12,12,0,1,0
3,218,218,78,15,63,4,3
6,234,234,19,19,0,1,0
19,259,259,51,51,0,1,0
17,283,283,47,5,42,3,2
2,323,323,3,3,0,1,0
12,330,330,28,28,0,1,0
18,351,351,17,17,0,1,0
13,396,396,25,7,18,3,2
7,398,398,23,12,11,2,1
20,399,399,49,49,0,1,0
4,444,444,9,9,0,1,0

2,134,134,2,2,0,1,0
10,143,143,10,4,6,3,2
18,147,147,19,7,12,2,1
0,164,164,14,14,0,1,0
3,181,181,5,5,0,1,0
14,206,206,11,1,10,3,2
7,212,212,18,18,0,1,0
5,220,220,75,28,47,2,1
8,222,222,21,9,12,2,1
16,234,234,10,10,0,1,0
12,247,247,10,10,0,1,0
17,275,275,18,18,0,1,0
13,286,286,2,2,0,1,0
6,340,340,9,3,6,3,2
11,358,358,23,9,14,3,2
1,380,380,16,7,9,2,1
9,391,391,62,54,8,3,2
15,395,395,177,135,42,2,1
4,496,496,13,2,11,2,1

11,130,130,18,9,9,4,3
17,135,135,7,2,5,2,1
20,137,137,15,1,14,3,2
4,139,139,29,5,24,4,3
19,188,188,13,13,0,1,0
13,189,189,4,4,0,1,0
0,200,200,1,1,0,1,0
1,224,224,45,45,0,1,0
16,246,246,29,11,18,2,1
6,247,247,26,26,0,1,0
18,256,256,92,37,55,4,3
14,307,307,29,21,8,2,1
5,314,314,11,7,4,2,1
2,327,327,4,4,0,1,0
15,354,354,14,1,13,2,1
3,413,413,1,1,0,1,0
8,415,415,10,2,8,3,2
9,426,426,31,31,0,1,0
12,464,464,35,10,25,2,1
10,467,467,9,9,0,1,0
7,469,469,1,1,0,1,0
21,485,485,28,4,24,3,2

6,110,110,8,1,7,2,1
17,183,183,20,15,5,2,1
15,211,211,3,3,0,1,0
18,229,229,31,31,0,1,0
13,247,247,36,36,0,1,0
7,256,256,6,6,0,1,0
8,276,276,46,40,6,3,2
9,280,280,8,8,0,1,0
10,283,283,3,3,0,1,0
11,289,289,4,4,0,1,0
5,374,374,4,4,0,1,0
4,378,378,11,11,0,1,0
12,384,384,156,156,0,1,0
19,389,389,16,16,0,1,0
3,408,408,113,30,83,4,3
0,420,420,81,67,14,2,1
1,433,433,5,5,0,1,0
14,455,455,7,2,5,2,1
16,488,488,16,16,0,1,0
2,489,489,38,5,33,4,3

11,126,126,22,22,0,1,0
20,130,130,2,2,0,1,0
18,148,148,23,2,21,4,3
10,172,172,15,15,0,1,0
3,191,191,12,12,0,1,0
21,198,198,9,9,0,1,0
8,230,230,1,1,0,1,0
7,242,242,8,1,7,2,1
1,261,261,16,11,5,2,1
0,268,268,3,3,0,1,0
5,276,276,3,3,0,1,0
16,314,314,16,6,10,2,1
12,359,359,26,26,0,1,0
9,380,380,66,66,0,1,0
14,407,407,52,33,19,2,1
6,410,410,23,23,0,1,0
4,419,419,41,36,5,2,1
2,432,432,24,24,0,1,0
13,440,440,18,12,6,3,2
17,460,460,101,37,64,3,2
15,484,484,59,34,25,2,1
19,497,497,68,68,0,1,0

2,123,123,6,6,0,1,0
5,147,147,12,12,0,1,0
13,169,169,13,7,6,3,2
7,170,170,40,40,0,1,0
18,195,195,25,25,0,1,0
4,201,201,5,2,3,2,1
9,213,213,1,1,0,1,0
6,228,228,24,7,17,2,1
3,253,253,26,26,0,1,0
12,268,268,2,2,0,1,0
17,290,290,1,1,0,1,0
16,295,295,75,15,60,3,2
0,330,330,7,7,0,1,0
20,334,334,13,13,0,1,0
19,337,337,14,7,7,2,1
1,342,342,24,24,0,1,0
8,348,348,21,21,0,1,0
14,371,371,21,12,9,4,3
10,379,379,19,4,15,4,3
15,430,430,81,1,80,4,3
21,453,453,58,47,11,2,1
11,496,496,45,45,0,1,0

9,100,100,4,4,0,1,0
13,113,113,16,10,6,3,2
2,128,128,28,28,0,1,0
4,154,154,4,4,0,1,0
5,160,160,51,51,0,1,0
3,182,182,4,4,0,1,0
15,207,207,4,4,0,1,0
8,208,208,34,6,28,2,1
11,248,248,3,3,0,1,0
0,263,263,4,4,0,1,0
7,280,280,20,11,9,2,1
16,295,295,26,26,0,1,0
6,324,324,11,11,0,1,0
1,331,331,65,65,0,1,0
14,348,348,81,53,28,4,3
10,473,473,66,66,0,1,0
12,488,488,41,41,0,1,0

0,118,118,2,2,0,1,0
12,155,155,21,21,0,1,0
7,171,171,6,6,0,1,0
4,184,184,10,6,4,2,1
17,203,203,37,25,12,3,2
11,247,247,67,28,39,4,3
9,298,298,14,7,7,2,1
8,311,311,23,23,0,1,0
3,328,328,33,33,0,1,0
13,342,342,14,14,0,1,0
14,353,353,2,2,0,1,0
15,360,360,10,10,0,1,0
10,379,379,77,77,0,1,0
16,424,424,1,1,0,1,0
1,454,454,178,178,0,1,0
6,468,468,31,4,27,4,3
2,490,490,5,5,0,1,0
5,498,498,76,76,0,1,0

3,123,123,37,37,0,1,0
8,128,128,1,1,0,1,0
7,129,129,1,1,0,1,0
2,139,139,17,17,0,1,0
6,154,154,24,24,0,1,0
15,161,161,17,17,0,1,0
17,169,169,30,30,0,1,0
5,218,218,34,25,9,4,3
4,219,219,13,5,8,3,2
13,289,289,5,5,0,1,0
12,346,346,33,33,0,1,0
14,347,347,37,37,0,1,0
10,358,358,59,25,34,3,2
11,358,358,9,4,5,2,1
9,364,364,41,3,38,2,1
1,406,406,1,1,0,1,0
16,418,418,45,45,0,1,0
0,453,453,40,36,4,2,1

11,116,116,24,7,17,2,1
12,143,143,2,2,0,1,0
5,149,149,18,18,0,1,0
14,182,182,2,2,0,1,0
8,187,187,16,4,12,3,2
6,208,208,13,3,10,3,2
7,230,230,15,15,0,1,0
3,283,283,85,85,0,1,0
10,305,305,56,51,5,2,1
0,323,323,75,51,24,4,3
9,330,330,54,43,11,2,1
1,359,359,45,19,26,3,2
2,400,400,38,2,36,4,3
4,446,446,13,13,0,1,0
13,481,481,62,62,0,1,0

7,128,128,7,7,0,1,0
9,137,137,18,18,0,1,0
2,143,143,6,2,4,2,1
14,149,149,31,5,26,2,1
0,173,173,62,56,6,3,2
13,183,183,8,8,0,1,0
10,185,185,8,2,6,2,1
8,218,218,62,62,0,1,0
16,253,253,12,3,9,2,1
12,276,276,21,21,0,1,0
11,342,342,13,13,0,1,0
5,346,346,20,11,9,2,1
4,359,359,16,16,0,1,0
6,390,390,76,76,0,1,0
1,396,396,14,14,0,1,0
15,441,441,26,5,21,2,1
3,473,473,56,23,33,4,3

4,197,197,1,1,0,1,0
14,205,205,9,3,6,2,1
1,220,220,39,2,37,4,3
13,226,226,3,3,0,1,0
6,228,228,40,5,35,4,3
5,238,238,7,3,4,2,1
0,249,249,4,1,3,2,1
10,253,253,26,7,19,2,1
8,254,254,7,7,0,1,0
18,255,255,46,46,0,1,0
9,268,268,5,5,0,1,0
7,311,311,17,17,0,1,0
16,326,326,54,23,31,2,1
17,340,340,23,9,14,3,2
15,342,342,30,5,25,2,1
2,380,380,51,51,0,1,0
11,391,391,80,41,39,4,3
12,430,430,28,28,0,1,0
3,439,439,70,70,0,1,0
19,448,448,38,30,8,3,2

0,114,114,1,1,0,1,0
4,138,138,8,8,0,1,0
9,179,179,11,1,10,2,1
10,182,182,37,37,0,1,0
1,194,194,12,12,0,1,0
6,205,205,1,1,0,1,0
14,208,208,1,1,0,1,0
16,219,219,16,16,0,1,0
11,244,244,56,56,0,1,0
5,277,277,1,1,0,1,0
18,286,286,1,1,0,1,0
12,290,290,26,26,0,1,0
17,315,315,64,64,0,1,0
19,361,361,55,55,0,1,0
13,391,391,15,5,10,2,1
8,394,394,85,85,0,1,0
2,404,404,5,5,0,1,0
3,447,447,90,90,0,1,0
15,448,448,50,50,0,1,0
7,496,496,36,36,0,1,0

9,123,123,13,1,12,3,2
10,142,142,8,8,0,1,0
13,170,170,21,21,0,1,0
0,183,183,74,74,0,1,0
8,216,216,24,14,10,3,2
7,235,235,23,23,0,1,0
1,243,243,66,52,14,3,2
2,254,254,52,32,20,3,2
6,287,287,39,39,0,1,0
4,296,296,4,4,0,1,0
11,323,323,29,29,0,1,0
12,378,378,36,36,0,1,0
3,386,386,3,3,0,1,0
5,448,448,45,29,16,2,1

0,106,106,1,1,0,1,0
1,107,107,3,3,0,1,0
2,109,109,29,7,22,2,1
16,110,110,2,2,0,1,0
8,114,114,2,2,0,1,0
13,148,148,19,7,12,4,3
14,243,243,37,11,26,4,3
9,289,289,15,15,0,1,0
4,294,294,27,27,0,1,0
10,300,300,12,12,0,1,0
11,308,308,12,12,0,1,0
12,391,391,143,56,87,4,3
7,398,398,68,68,0,1,0
5,424,424,43,43,0,1,0
6,433,433,12,1,11,2,1
17,436,436,22,22,0,1,0
3,458,458,87,87,0,1,0
15,492,492,31,9,22,3,2

11,118,118,7,7,0,1,0
17,124,124,2,2,0,1,0
14,160,160,17,17,0,1,0
19,166,166,32,32,0,1,0
12,189,189,1,1,0,1,0
15,197,197,63,24,39,4,3
20,220,220,16,12,4,2,1
10,223,223,51,51,0,1,0
4,246,246,6,6,0,1,0
22,246,246,26,26,0,1,0
0,249,249,11,11,0,1,0
5,255,255,16,16,0,1,0
21,306,306,1,1,0,1,0
23,319,319,15,15,0,1,0
9,320,320,35,35,0,1,0
3,328,328,14,5,9,4,3
2,336,336,6,6,0,1,0
13,354,354,49,7,42,4,3
16,391,391,43,43,0,1,0
7,401,401,2,2,0,1,0
1,426,426,10,10,0,1,0
6,428,428,9,4,5,2,1
18,461,461,24,24,0,1,0
8,487,487,6,6,0,1,0

4,101,101,8,2,6,3,2
0,112,112,8,8,0,1,0
13,126,126,23,23,0,1,0
19,134,134,7,7,0,1,0
1,146,146,6,6,0,1,0
17,151,151,4,1,3,2,1
12,170,170,7,7,0,1,0
2,173,173,1,1,0,1,0
10,188,188,12,12,0,1,0
14,218,218,15,15,0,1,0
16,226,226,69,69,0,1,0
5,317,317,8,8,0,1,0
7,323,323,68,68,0,1,0
8,373,373,1,1,0,1,0
11,383,383,24,24,0,1,0
18,388,388,65,65,0,1,0
9,402,402,110,77,33,4,3
3,487,487,59,14,45,2,1
15,493,493,10,10,0,1,0
6,495,495,4,4,0,1,0

23,122,122,10,10,0,1,0
20,133,133,6,6,0,1,0
2,137,137,32,32,0,1,0
0,198,198,9,3,6,3,2
13,198,198,6,1,5,2,1
22,203,203,34,6,28,3,2
10,230,230,4,1,3,2,1
12,256,256,9,9,0,1,0
4,265,265,21,12,9,2,1
8,270,270,31,31,0,1,0
14,302,302,30,20,10,3,2
24,307,307,25,3,22,3,2
16,322,322,61,61,0,1,0
7,323,323,27,27,0,1,0
11,347,347,9,3,6,3,2
3,353,353,14,14,0,1,0
1,357,357,6,6,0,1,0
5,364,364,4,1,3,2,1
15,364,364,16,16,0,1,0
17,450,450,33,33,0,1,0
21,466,466,6,6,0,1,0
19,473,473,2,2,0,1,0
18,480,480,126,63,63,4,3
9,485,485,8,8,0,1,0
6,500,500,4,4,0,1,0

12,132,132,3,3,0,1,0
16,175,175,11,3,8,3,2
14,199,199,2,2,0,1,0
1,206,206,11,11,0,1,0
15,210,210,18,18,0,1,0
10,212,212,5,5,0,1,0
7,214,214,46,43,3,2,1
13,237,237,6,6,0,1,0
0,254,254,49,26,23,3,2
5,291,291,34,34,0,1,0
3,323,323,24,6,18,4,3
6,334,334,45,45,0,1,0
4,385,385,3,3,0,1,0
2,409,409,43,43,0,1,0
8,443,443,180,80,100,4,3
11,475,475,82,8,74,3,2
9,487,487,51,30,21,2,1

9,103,103,1,1,0,1,0
8,103,103,1,1,0,1,0
7,107,107,8,8,0,1,0
23,123,123,2,2,0,1,0
3,132,132,1,1,0,1,0
5,161,161,5,5,0,1,0
6,203,203,3,3,0,1,0
21,211,211,19,19,0,1,0
22,212,212,37,37,0,1,0
18,213,213,67,8,59,3,2
1,216,216,10,1,9,4,3
2,218,218,1,1,0,1,0
16,222,222,11,7,4,2,1
24,241,241,7,1,6,2,1
20,301,301,14,2,12,2,1
10,317,317,19,19,0,1,0
19,334,334,30,15,15,2,1
15,351,351,17,8,9,3,2
25,378,378,1,1,0,1,0
4,433,433,25,25,0,1,0
14,443,443,45,5,40,3,2
13,460,460,18,18,0,1,0
0,465,465,13,1,12,2,1
12,475,475,17,17,0,1,0
11,475,475,135,127,8,3,2
17,498,498,76,28,48,4,3

2,110,110,1,1,0,1,0
22,165,165,31,13,18,4,3
1,172,172,15,6,9,2,1
0,196,196,12,12,0,1,0
20,217,217,40,7,33,4,3
3,261,261,16,7,9,2,1
19,261,261,16,16,0,1,0
5,325,325,24,21,3,2,1
13,335,335,1,1,0,1,0
23,351,351,60,12,48,4,3
24,355,355,3,3,0,1,0
12,356,356,49,13,36,3,2
15,359,359,80,56,24,2,1
10,369,369,5,5,0,1,0
16,388,388,10,5,5,2,1
9,403,403,15,15,0,1,0
14,407,407,4,4,0,1,0
8,413,413,13,13,0,1,0
4,417,417,15,9,6,3,2
7,439,439,13,13,0,1,0
21,447,447,54,27,27,4,3
6,455,455,22,3,19,2,1
18,468,468,55,42,13,2,1
17,470,470,18,18,0,1,0
11,484,484,19,5,14,3,2

1,215,215,30,12,18,3,2
16,220,220,35,35,0,1,0
15,226,226,5,5,0,1,0
7,233,233,23,17,6,2,1
9,244,244,12,12,0,1,0
3,246,246,45,12,33,4,3
8,252,252,35,32,3,2,1
4,256,256,21,21,0,1,0
14,268,268,17,14,3,2,1
19,290,290,1,1,0,1,0
0,297,297,27,17,10,4,3
6,311,311,5,5,0,1,0
13,319,319,79,8,71,4,3
5,338,338,12,5,7,2,1
17,357,357,15,6,9,2,1
18,424,424,66,66,0,1,0
10,472,472,17,5,12,4,3
2,476,476,15,3,12,2,1
12,489,489,9,9,0,1,0
11,490,490,98,36,62,3,2

14,139,139,5,1,4,2,1
18,154,154,12,12,0,1,0
10,157,157,31,16,15,2,1
3,166,166,4,4,0,1,0
13,217,217,42,30,12,4,3
20,269,269,45,5,40,4,3
1,270,270,42,25,17,2,1
11,272,272,6,6,0,1,0
15,272,272,8,8,0,1,0
7,283,283,2,2,0,1,0
5,290,290,21,8,13,2,1
8,323,323,2,2,0,1,0
6,399,399,28,28,0,1,0
0,400,400,23,23,0,1,0
16,415,415,45,45,0,1,0
4,421,421,68,42,26,2,1
19,427,427,112,81,31,2,1
12,441,441,23,23,0,1,0
17,464,464,17,17,0,1,0
21,467,467,2,2,0,1,0
2,476,476,26,26,0,1,0
9,494,494,10,1,9,4,3

23,109,109,11,11,0,1,0
0,164,164,9,9,0,1,0
14,199,199,24,4,20,3,2
21,209,209,2,2,0,1,0
22,222,222,33,26,7,2,1
3,258,258,9,9,0,1,0
16,260,260,1,1,0,1,0
11,268,268,63,1,62,3,2
12,312,312,41,3,38,2,1
9,316,316,8,2,6,2,1
19,331,331,44,35,9,2,1
1,331,331,1,1,0,1,0
15,332,332,12,12,0,1,0
6,357,357,34,10,24,4,3
17,368,368,92,3,89,4,3
20,368,368,83,5,78,4,3
8,373,373,7,7,0,1,0
4,373,373,15,15,0,1,0
2,384,384,26,26,0,1,0
5,426,426,10,10,0,1,0
10,472,472,18,18,0,1,0
13,480,480,4,4,0,1,0
18,493,493,3,3,0,1,0
7,498,498,2,2,0,1,0

13,124,124,24,7,17,2,1
0,156,156,12,3,9,2,1
10,157,157,38,18,20,2,1
2,217,217,70,49,21,2,1
16,241,241,22,22,0,1,0
8,271,271,25,1,24,3,2
3,332,332,15,15,0,1,0
7,344,344,39,39,0,1,0
1,355,355,3,3,0,1,0
9,378,378,1,1,0,1,0
12,384,384,57,32,25,2,1
6,397,397,49,16,33,2,1
14,401,401,15,15,0,1,0
5,418,418,10,10,0,1,0
11,448,448,31,11,20,3,2
15,468,468,20,2,18,4,3
4,472,472,88,18,70,4,3

14,127,127,11,2,9,2,1
8,139,139,13,13,0,1,0
3,146,146,43,38,5,2,1
1,181,181,21,12,9,2,1
4,224,224,13,7,6,2,1
9,257,257,3,3,0,1,0
11,257,257,54,54,0,1,0
10,287,287,57,57,0,1,0
13,288,288,37,16,21,4,3
2,303,303,12,12,0,1,0
5,311,311,23,23,0,1,0
6,319,319,35,7,28,3,2
15,376,376,1,1,0,1,0
12,442,442,70,70,0,1,0
0,497,497,104,20,84,4,3
7,497,497,15,3,12,4,3

14,129,129,30,30,0,1,0
5,174,174,94,94,0,1,0
6,175,175,14,14,0,1,0
11,185,185,9,4,5,2,1
0,188,188,30,30,0,1,0
10,300,300,55,43,12,4,3
2,329,329,51,21,30,3,2
12,345,345,3,3,0,1,0
8,350,350,41,41,0,1,0
13,371,371,16,4,12,2,1
9,375,375,48,4,44,4,3
3,461,461,10,4,6,3,2
4,466,466,5,5,0,1,0
1,469,469,7,7,0,1,0
7,494,494,38,38,0,1,0

4,121,121,13,1,12,3,2
13,128,128,1,1,0,1,0
0,207,207,39,9,30,4,3
2,210,210,3,3,0,1,0
9,216,216,6,6,0,1,0
11,237,237,31,31,0,1,0
3,298,298,8,8,0,1,0
12,330,330,52,35,17,2,1
6,356,356,24,24,0,1,0
10,367,367,76,76,0,1,0
8,374,374,68,68,0,1,0
5,414,414,4,1,3,2,1
1,420,420,9,9,0,1,0
15,438,438,10,10,0,1,0
16,452,452,4,1,3,2,1
14,476,476,83,29,54,4,3
7,500,500,233,233,0,1,0

0,110,110,5,5,0,1,0
8,114,114,5,5,0,1,0
1,121,121,3,3,0,1,0
13,161,161,15,15,0,1,0
15,200,200,7,7,0,1,0
12,210,210,21,21,0,1,0
4,240,240,34,34,0,1,0
10,260,260,69,69,0,1,0
9,296,296,47,47,0,1,0
6,306,306,64,64,0,1,0
14,393,393,70,38,32,2,1
7,412,412,14,14,0,1,0
11,419,419,3,3,0,1,0
5,472,472,140,113,27,4,3
2,488,488,83,83,0,1,0
3,496,496,7,7,0,1,0

8,113,113,43,26,17,2,1
3,125,125,19,19,0,1,0
4,157,157,27,17,10,2,1
13,211,211,38,35,3,2,1
7,247,247,10,3,7,2,1
11,258,258,5,5,0,1,0
9,264,264,6,6,0,1,0
6,291,291,1,1,0,1,0
16,325,325,60,43,17,2,1
12,328,328,1,1,0,1,0
15,348,348,24,24,0,1,0
14,376,376,6,1,5,2,1
5,392,392,50,50,0,1,0
0,417,417,70,70,0,1,0
10,472,472,21,21,0,1,0
1,489,489,74,35,39,3,2
2,493,493,43,38,5,2,1

5,101,101,6,2,4,2,1
2,116,116,18,18,0,1,0
15,155,155,21,6,15,2,1
19,162,162,9,9,0,1,0
14,170,170,15,15,0,1,0
11,173,173,16,16,0,1,0
20,185,185,31,15,16,3,2
8,227,227,19,4,15,2,1
7,240,240,24,10,14,2,1
10,273,273,2,2,0,1,0
4,287,287,26,26,0,1,0
13,351,351,36,36,0,1,0
18,372,372,69,33,36,4,3
0,382,382,29,8,21,2,1
16,423,423,4,4,0,1,0
12,424,424,29,20,9,3,2
1,442,442,5,5,0,1,0
9,451,451,27,5,22,3,2
6,466,466,63,57,6,2,1
17,467,467,51,30,21,4,3
3,473,473,14,14,0,1,0

13,113,113,2,2,0,1,0
16,120,120,19,19,0,1,0
6,143,143,15,3,12,3,2
7,184,184,17,17,0,1,0
11,233,233,5,5,0,1,0
3,257,257,1,1,0,1,0
21,262,262,30,30,0,1,0
4,263,263,47,47,0,1,0
19,276,276,44,6,38,2,1
12,281,281,16,16,0,1,0
20,284,284,46,22,24,2,1
17,289,289,49,49,0,1,0
2,301,301,16,10,6,3,2
0,315,315,4,4,0,1,0
9,345,345,42,26,16,3,2
18,347,347,2,2,0,1,0
15,360,360,27,27,0,1,0
5,399,399,17,17,0,1,0
14,404,404,18,18,0,1,0
10,427,427,11,6,5,2,1
22,444,444,13,13,0,1,0
8,457,457,60,26,34,2,1
1,486,486,19,19,0,1,0

12,130,130,1,1,0,1,0
0,153,153,2,2,0,1,0
5,167,167,31,12,19,3,2
10,182,182,17,17,0,1,0
1,208,208,15,2,13,2,1
13,210,210,18,7,11,2,1
3,214,214,14,4,10,3,2
2,218,218,32,11,21,4,3
18,249,249,54,54,0,1,0
7,254,254,46,14,32,4,3
9,286,286,1,1,0,1,0
8,299,299,14,14,0,1,0
11,309,309,57,15,42,4,3
15,323,323,20,20,0,1,0
4,403,403,18,5,13,2,1
16,409,409,3,3,0,1,0
6,424,424,61,21,40,2,1
17,454,454,31,18,13,4,3
14,497,497,95,11,84,4,3

15,135,135,17,17,0,1,0
10,152,152,20,20,0,1,0
2,178,178,8,8,0,1,0
9,185,185,1,1,0,1,0
3,221,221,5,5,0,1,0
12,243,243,37,8,29,3,2
13,266,266,62,62,0,1,0
1,273,273,49,49,0,1,0
5,288,288,24,3,21,3,2
4,301,301,10,10,0,1,0
7,328,328,37,16,21,4,3
17,371,371,42,42,0,1,0
14,374,374,25,18,7,2,1
0,387,387,59,41,18,4,3
6,410,410,65,65,0,1,0
16,417,417,6,6,0,1,0
11,466,466,35,35,0,1,0
8,487,487,55,35,20,2,1

17,111,111,3,3,0,1,0
3,116,116,23,9,14,3,2
1,137,137,5,1,4,2,1
20,156,156,37,37,0,1,0
14,166,166,7,7,0,1,0
0,179,179,21,21,0,1,0
13,190,190,47,47,0,1,0
12,197,197,13,13,0,1,0
8,197,197,1,1,0,1,0
4,209,209,20,20,0,1,0
18,225,225,59,59,0,1,0
2,241,241,22,18,4,2,1
15,260,260,4,4,0,1,0
19,310,310,4,4,0,1,0
10,317,317,3,3,0,1,0
16,330,330,3,3,0,1,0
7,352,352,1,1,0,1,0
11,358,358,29,13,16,2,1
5,411,411,79,34,45,4,3
6,436,436,25,25,0,1,0
9,494,494,7,1,6,2,1

18,106,106,12,7,5,2,1
8,137,137,13,1,12,3,2
0,150,150,14,4,10,2,1
7,154,154,9,9,0,1,0
4,187,187,16,16,0,1,0
6,204,204,54,54,0,1,0
14,233,233,48,48,0,1,0
1,251,251,8,1,7,2,1
11,306,306,21,21,0,1,0
19,316,316,7,1,6,2,1
10,345,345,5,5,0,1,0
20,381,381,95,26,69,4,3
2,401,401,2,2,0,1,0
12,411,411,5,5,0,1,0
13,421,421,4,4,0,1,0
5,431,431,45,45,0,1,0
9,432,432,20,17,3,2,1
15,433,433,3,3,0,1,0
16,444,444,41,41,0,1,0
3,453,453,16,16,0,1,0
17,466,466,92,8,84,3,2

15,100,100,14,2,12,3,2
20,114,114,15,15,0,1,0
17,129,129,32,32,0,1,0
0,150,150,2,2,0,1,0
21,191,191,6,6,0,1,0
7,194,194,10,7,3,2,1
4,234,234,39,39,0,1,0
2,288,288,102,12,90,3,2
1,311,311,8,8,0,1,0
16,314,314,59,8,51,4,3
12,332,332,16,2,14,4,3
14,358,358,17,8,9,3,2
9,363,363,1,1,0,1,0
8,382,382,16,12,4,2,1
19,396,396,14,14,0,1,0
13,399,399,29,6,23,2,1
11,408,408,1,1,0,1,0
18,408,408,12,7,5,2,1
6,441,441,19,2,17,2,1
5,443,443,52,52,0,1,0
3,459,459,4,1,3,2,1
10,486,486,13,9,4,2,1

11,110,110,5,5,0,1,0
14,172,172,29,2,27,4,3
0,180,180,12,8,4,2,1
2,184,184,1,1,0,1,0
18,214,214,44,13,31,2,1
9,219,219,6,3,3,2,1
16,237,237,46,46,0,1,0
13,255,255,6,1,5,2,1
3,269,269,21,15,6,3,2
19,274,274,8,3,5,2,1
1,285,285,49,16,33,4,3
4,301,301,24,9,15,4,3
5,351,351,47,4,43,2,1
12,357,357,72,39,33,2,1
10,367,367,14,14,0,1,0
7,375,375,64,10,54,3,2
6,409,409,4,4,0,1,0
8,426,426,51,37,14,2,1
15,486,486,17,8,9,4,3
17,491,491,8,8,0,1,0

0,103,103,8,8,0,1,0
19,116,116,3,3,0,1,0
15,119,119,17,3,14,2,1
8,127,127,1,1,0,1,0
11,129,129,37,37,0,1,0
7,149,149,13,13,0,1,0
16,169,169,24,24,0,1,0
18,191,191,11,11,0,1,0
1,255,255,3,3,0,1,0
5,261,261,18,13,5,2,1
9,275,275,5,2,3,2,1
10,290,290,58,58,0,1,0
2,309,309,10,6,4,2,1
4,337,337,48,48,0,1,0
14,376,376,3,3,0,1,0
6,414,414,34,8,26,4,3
13,440,440,17,17,0,1,0
17,446,446,90,8,82,4,3
12,478,478,11,11,0,1,0
3,481,481,83,55,28,2,1

2,119,119,29,17,12,4,3
17,129,129,6,6,0,1,0
10,141,141,10,10,0,1,0
15,152,152,7,4,3,2,1
4,162,162,16,16,0,1,0
1,185,185,14,14,0,1,0
16,195,195,51,37,14,3,2
12,261,261,31,11,20,3,2
0,286,286,12,7,5,2,1
14,297,297,60,51,9,2,1
6,301,301,45,45,0,1,0
8,349,349,32,32,0,1,0
5,353,353,33,11,22,4,3
3,419,419,19,19,0,1,0
9,470,470,46,6,40,3,2
13,470,470,12,12,0,1,0
7,474,474,29,29,0,1,0
11,480,480,26,11,15,4,3

3,137,137,33,33,0,1,0
9,168,168,21,7,14,2,1
11,179,179,3,3,0,1,0
4,202,202,45,15,30,3,2
7,236,236,5,5,0,1,0
2,247,247,11,11,0,1,0
0,329,329,33,33,0,1,0
12,337,337,34,3,31,4,3
13,338,338,36,36,0,1,0
8,356,356,46,26,20,3,2
14,390,390,72,72,0,1,0
5,413,413,109,63,46,2,1
1,427,427,12,12,0,1,0
6,436,436,29,29,0,1,0
10,451,451,73,1,72,3,2

3,101,101,3,3,0,1,0
13,124,124,6,6,0,1,0
6,127,127,13,13,0,1,0
19,127,127,11,11,0,1,0
14,131,131,12,4,8,3,2
1,134,134,8,8,0,1,0
12,150,150,4,4,0,1,0
8,187,187,1,1,0,1,0
15,192,192,46,12,34,2,1
20,205,205,17,2,15,4,3
18,254,254,28,4,24,2,1
21,261,261,56,12,44,2,1
10,291,291,19,11,8,3,2
2,299,299,1,1,0,1,0
17,305,305,15,15,0,1,0
16,330,330,3,3,0,1,0
5,334,334,32,9,23,2,1
11,388,388,36,2,34,3,2
4,402,402,41,3,38,2,1
9,404,404,38,38,0,1,0
7,417,417,37,37,0,1,0
0,429,429,58,7,51,3,2

16,129,129,6,6,0,1,0
5,150,150,27,27,0,1,0
18,161,161,8,8,0,1,0
12,166,166,60,18,42,4,3
14,171,171,16,8,8,3,2
3,186,186,39,10,29,4,3
1,193,193,3,3,0,1,0
9,202,202,5,5,0,1,0
10,218,218,1,1,0,1,0
6,263,263,20,20,0,1,0
4,278,278,15,8,7,2,1
2,310,310,52,20,32,2,1
13,357,357,8,8,0,1,0
15,366,366,1,1,0,1,0
7,391,391,29,29,0,1,0
11,396,396,22,1,21,4,3
0,401,401,1,1,0,1,0
8,413,413,40,40,0,1,0
17,435,435,124,124,0,1,0

5,106,106,21,5,16,3,2
3,160,160,14,14,0,1,0
10,178,178,17,17,0,1,0
7,213,213,13,13,0,1,0
9,247,247,2,2,0,1,0
13,288,288,53,53,0,1,0
1,323,323,47,2,45,4,3
14,339,339,19,11,8,2,1
15,354,354,118,91,27,4,3
2,368,368,22,22,0,1,0
11,371,371,7,2,5,2,1
0,375,375,45,45,0,1,0
6,385,385,17,17,0,1,0
8,439,439,46,43,3,2,1
4,455,455,112,4,108,4,3
12,498,498,28,28,0,1,0

6,100,100,5,2,3,2,1
15,127,127,2,2,0,1,0
17,138,138,6,6,0,1,0
1,143,143,2,2,0,1,0
22,181,181,14,14,0,1,0
12,189,189,32,32,0,1,0
9,193,193,8,5,3,2,1
0,196,196,1,1,0,1,0
10,205,205,29,29,0,1,0
11,213,213,3,3,0,1,0
3,215,215,6,3,3,2,1
18,238,238,24,8,16,3,2
20,257,257,77,25,52,3,2
8,262,262,10,10,0,1,0
4,359,359,72,56,16,3,2
14,363,363,78,78,0,1,0
5,394,394,44,20,24,4,3
21,399,399,3,3,0,1,0
7,408,408,5,5,0,1,0
19,423,423,53,53,0,1,0
2,451,451,17,7,10,2,1
13,466,466,17,17,0,1,0
16,483,483,18,18,0,1,0

17,115,115,3,3,0,1,0
5,147,147,5,2,3,2,1
16,151,151,13,13,0,1,0
6,172,172,1,1,0,1,0
0,183,183,11,11,0,1,0
22,192,192,39,3,36,4,3
3,194,194,1,1,0,1,0
2,195,195,32,29,3,2,1
19,225,225,62,4,58,4,3
15,238,238,3,3,0,1,0
13,240,240,1,1,0,1,0
9,240,240,10,2,8,2,1
4,248,248,22,1,21,4,3
8,278,278,10,1,9,2,1
7,303,303,11,11,0,1,0
11,337,337,23,23,0,1,0
18,378,378,4,1,3,2,1
1,397,397,8,2,6,3,2
20,411,411,23,11,12,2,1
23,445,445,104,6,98,3,2
12,466,466,76,44,32,2,1
14,468,468,33,33,0,1,0
21,474,474,9,9,0,1,0
10,476,476,49,49,0,1,0

6,141,141,8,8,0,1,0
12,144,144,10,6,4,2,1
11,152,152,24,24,0,1,0
8,156,156,20,20,0,1,0
0,181,181,16,1,15,4,3
9,191,191,5,5,0,1,0
14,275,275,65,47,18,3,2
10,290,290,36,5,31,2,1
3,307,307,5,5,0,1,0
1,334,334,76,76,0,1,0
2,349,349,13,5,8,2,1
17,349,349,50,44,6,3,2
5,423,423,125,29,96,3,2
13,429,429,15,15,0,1,0
4,446,446,4,4,0,1,0
16,461,461,33,9,24,3,2
7,478,478,9,9,0,1,0
18,482,482,35,23,12,2,1
15,494,494,3,3,0,1,0

15,102,102,1,1,0,1,0
23,117,117,12,12,0,1,0
2,143,143,2,2,0,1,0
16,162,162,10,3,7,2,1
11,181,181,6,1,5,2,1
26,186,186,11,11,0,1,0
14,194,194,9,9,0,1,0
19,213,213,5,5,0,1,0
4,227,227,2,2,0,1,0
10,229,229,35,35,0,1,0
13,264,264,11,11,0,1,0
12,295,295,1,1,0,1,0
3,297,297,7,7,0,1,0
24,327,327,62,23,39,2,1
25,331,331,114,30,84,3,2
1,333,333,62,62,0,1,0
21,336,336,4,4,0,1,0
18,344,344,15,15,0,1,0
22,359,359,23,23,0,1,0
6,364,364,4,4,0,1,0
7,391,391,38,2,36,2,1
0,395,395,25,25,0,1,0
5,402,402,4,4,0,1,0
17,421,421,26,26,0,1,0
20,435,435,38,32,6,2,1
8,456,456,33,33,0,1,0
9,489,489,2,2,0,1,0

9,130,130,2,2,0,1,0
20,162,162,8,3,5,2,1
13,167,167,11,11,0,1,0
12,182,182,21,21,0,1,0
14,202,202,32,2,30,4,3
5,203,203,11,11,0,1,0
17,224,224,4,1,3,2,1
1,231,231,97,68,29,4,3
18,246,246,9,1,8,3,2
6,284,284,8,8,0,1,0
7,286,286,39,10,29,2,1
15,336,336,25,25,0,1,0
0,357,357,10,1,9,2,1
19,358,358,106,106,0,1,0
3,369,369,15,15,0,1,0
16,393,393,44,9,35,2,1
2,409,409,16,11,5,2,1
10,430,430,7,7,0,1,0
8,461,461,1,1,0,1,0
4,466,466,26,10,16,3,2
11,489,489,32,32,0,1,0

3,121,121,9,9,0,1,0
15,143,143,8,3,5,2,1
11,145,145,1,1,0,1,0
2,189,189,8,8,0,1,0
17,227,227,37,37,0,1,0
7,244,244,32,32,0,1,0
8,257,257,10,10,0,1,0
18,260,260,8,8,0,1,0
5,290,290,55,55,0,1,0
9,304,304,39,5,34,2,1
4,327,327,67,67,0,1,0
1,357,357,18,6,12,2,1
14,374,374,113,59,54,4,3
0,399,399,8,8,0,1,0
12,445,445,1,1,0,1,0
10,449,449,127,57,70,4,3
13,454,454,23,23,0,1,0
16,472,472,10,10,0,1,0
6,483,483,11,3,8,3,2

3,192,192,23,23,0,1,0
14,228,228,16,16,0,1,0
5,232,232,15,5,10,3,2
7,261,261,48,22,26,3,2
10,262,262,1,1,0,1,0
6,277,277,28,20,8,3,2
12,329,329,15,7,8,3,2
1,354,354,69,20,49,2,1
13,354,354,22,22,0,1,0
2,383,383,59,32,27,4,3
4,418,418,95,62,33,4,3
11,421,421,36,10,26,3,2
0,432,432,18,5,13,2,1
9,442,442,3,3,0,1,0
15,467,467,155,151,4,2,1
8,485,485,62,62,0,1,0

4,110,110,13,10,3,2,1
14,133,133,19,7,12,3,2
17,175,175,19,8,11,4,3
1,177,177,14,8,6,3,2
0,201,201,29,26,3,2,1
11,258,258,22,22,0,1,0
7,276,276,7,7,0,1,0
5,276,276,96,29,67,4,3
9,311,311,9,9,0,1,0
13,328,328,31,31,0,1,0
15,337,337,3,3,0,1,0
16,369,369,74,74,0,1,0
12,389,389,20,14,6,2,1
8,403,403,11,11,0,1,0
10,420,420,82,60,22,3,2
6,431,431,5,5,0,1,0
3,435,435,5,2,3,2,1
2,476,476,65,36,29,2,1

6,103,103,1,1,0,1,0
21,114,114,8,8,0,1,0
13,204,204,13,13,0,1,0
5,207,207,14,8,6,3,2
7,220,220,7,2,5,2,1
0,226,226,17,10,7,2,1
14,242,242,17,17,0,1,0
4,247,247,4,4,0,1,0
22,248,248,61,22,39,2,1
19,249,249,22,22,0,1,0
3,263,263,1,1,0,1,0
20,301,301,20,9,11,2,1
15,306,306,79,79,0,1,0
18,331,331,16,13,3,2,1
1,354,354,10,10,0,1,0
2,366,366,39,39,0,1,0
8,380,380,26,16,10,2,1
11,393,393,26,26,0,1,0
10,414,414,80,15,65,3,2
9,423,423,8,8,0,1,0
12,447,447,68,68,0,1,0
16,449,449,4,1,3,2,1
17,477,477,28,9,19,2,1

14,118,118,6,6,0,1,0
1,136,136,23,10,13,2,1
5,143,143,20,20,0,1,0
4,153,153,13,7,6,3,2
0,161,161,3,3,0,1,0
3,184,184,3,3,0,1,0
9,199,199,27,27,0,1,0
16,284,284,19,1,18,3,2
6,285,285,26,13,13,4,3
12,291,291,63,63,0,1,0
15,305,305,2,2,0,1,0
2,317,317,41,41,0,1,0
10,399,399,52,16,36,4,3
7,429,429,106,69,37,4,3
11,434,434,62,62,0,1,0
17,440,440,37,4,33,2,1
13,447,447,36,8,28,3,2
8,462,462,2,2,0,1,0

3,114,114,7,2,5,2,1
11,121,121,2,2,0,1,0
13,137,137,1,1,0,1,0
8,145,145,3,3,0,1,0
1,151,151,7,7,0,1,0
19,180,180,12,2,10,3,2
9,208,208,17,8,9,2,1
0,222,222,14,14,0,1,0
2,246,246,25,25,0,1,0
4,262,262,16,3,13,4,3
14,281,281,8,8,0,1,0
5,288,288,6,6,0,1,0
20,297,297,90,90,0,1,0
12,337,337,5,1,4,2,1
10,352,352,6,6,0,1,0
18,376,376,30,4,26,3,2
23,409,409,3,3,0,1,0
15,410,410,42,1,41,2,1
17,417,417,56,53,3,2,1
22,430,430,65,65,0,1,0
7,436,436,62,29,33,4,3
6,440,440,51,51,0,1,0
24,449,449,51,41,10,2,1
16,451,451,25,25,0,1,0
21,454,454,1,1,0,1,0

0,103,103,17,14,3,2,1
6,120,120,47,38,9,2,1
5,152,152,14,6,8,3,2
8,163,163,2,2,0,1,0
1,175,175,54,31,23,3,2
9,246,246,4,4,0,1,0
3,272,272,16,16,0,1,0
4,290,290,63,63,0,1,0
12,290,290,51,28,23,2,1
13,290,290,10,3,7,3,2
2,345,345,53,53,0,1,0
11,354,354,49,49,0,1,0
10,392,392,10,10,0,1,0
7,433,433,14,6,8,3,2

6,100,100,16,16,0,1,0
10,111,111,5,5,0,1,0
19,118,118,2,2,0,1,0
12,151,151,14,14,0,1,0
1,163,163,1,1,0,1,0
11,181,181,29,29,0,1,0
13,182,182,14,9,5,2,1
8,222,222,16,16,0,1,0
18,227,227,38,11,27,2,1
4,295,295,4,4,0,1,0
9,295,295,5,1,4,2,1
17,314,314,43,43,0,1,0
16,319,319,19,4,15,3,2
3,336,336,30,6,24,4,3
14,339,339,23,2,21,4,3
5,342,342,73,73,0,1,0
7,372,372,37,28,9,2,1
2,480,480,70,70,0,1,0
0,481,481,20,20,0,1,0
15,498,498,71,71,0,1,0

6,151,151,8,3,5,2,1
4,180,180,18,6,12,3,2
2,187,187,29,29,0,1,0
9,199,199,24,24,0,1,0
17,229,229,50,35,15,4,3
14,277,277,64,30,34,2,1
10,291,291,4,1,3,2,1
12,309,309,23,23,0,1,0
8,331,331,142,58,84,4,3
3,341,341,23,2,21,4,3
15,380,380,31,21,10,2,1
0,410,410,5,5,0,1,0
1,433,433,17,12,5,2,1
13,433,433,23,18,5,2,1
7,437,437,11,8,3,2,1
5,483,483,10,10,0,1,0
11,488,488,13,3,10,2,1
16,492,492,48,48,0,1,0

14,115,115,4,4,0,1,0
7,143,143,2,2,0,1,0
6,153,153,12,3,9,4,3
5,178,178,6,6,0,1,0
13,190,190,11,1,10,2,1
9,227,227,4,1,3,2,1
10,282,282,56,56,0,1,0
2,291,291,59,59,0,1,0
8,299,299,11,11,0,1,0
1,361,361,22,22,0,1,0
3,392,392,48,13,35,3,2
0,403,403,160,160,0,1,0
11,455,455,14,2,12,3,2
15,462,462,174,174,0,1,0
12,493,493,76,16,60,4,3
4,499,499,4,4,0,1,0

10,123,123,5,5,0,1,0
4,163,163,14,14,0,1,0
7,165,165,4,4,0,1,0
9,170,170,51,26,25,2,1
6,175,175,29,11,18,3,2
2,242,242,77,34,43,2,1
11,248,248,28,4,24,3,2
13,285,285,60,51,9,4,3
12,328,328,9,1,8,3,2
8,329,329,9,9,0,1,0
14,397,397,6,6,0,1,0
5,464,464,54,38,16,4,3
0,476,476,17,17,0,1,0
3,488,488,36,36,0,1,0
1,494,494,134,134,0,1,0

3,106,106,1,1,0,1,0
12,130,130,23,11,12,2,1
18,149,149,3,3,0,1,0
8,151,151,2,2,0,1,0
11,176,176,10,10,0,1,0
14,191,191,22,22,0,1,0
16,195,195,33,33,0,1,0
15,203,203,8,2,6,2,1
20,231,231,16,6,10,3,2
10,276,276,10,5,5,2,1
2,302,302,34,10,24,2,1
0,326,326,17,1,16,4,3
9,347,347,12,12,0,1,0
6,356,356,3,3,0,1,0
13,371,371,90,20,70,3,2
17,419,419,27,3,24,4,3
19,446,446,8,8,0,1,0
5,456,456,44,44,0,1,0
7,458,458,59,8,51,4,3
1,463,463,151,151,0,1,0
4,500,500,14,1,13,2,1

4,147,147,12,4,8,3,2
6,184,184,18,9,9,2,1
3,188,188,23,10,13,2,1
17,244,244,8,2,6,3,2
15,250,250,17,17,0,1,0
14,250,250,7,7,0,1,0
10,253,253,2,2,0,1,0
5,254,254,6,6,0,1,0
18,265,265,107,37,70,3,2
7,317,317,12,12,0,1,0
9,348,348,49,49,0,1,0
16,371,371,19,19,0,1,0
12,372,372,84,69,15,2,1
11,373,373,9,1,8,2,1
2,373,373,46,46,0,1,0
1,374,374,52,52,0,1,0
8,376,376,18,11,7,3,2
13,376,376,27,27,0,1,0
0,483,483,42,42,0,1,0

6,110,110,5,5,0,1,0
10,137,137,9,1,8,3,2
5,160,160,18,6,12,2,1
11,249,249,31,31,0,1,0
4,287,287,33,33,0,1,0
1,293,293,50,50,0,1,0
3,310,310,18,8,10,2,1
8,325,325,4,4,0,1,0
0,356,356,151,121,30,4,3
2,421,421,57,9,48,3,2
13,444,444,78,57,21,3,2
12,450,450,11,11,0,1,0
7,497,497,32,20,12,2,1
9,500,500,151,151,0,1,0

15,111,111,20,20,0,1,0
0,115,115,2,2,0,1,0
8,128,128,1,1,0,1,0
18,131,131,4,4,0,1,0
4,165,165,6,6,0,1,0
12,176,176,6,6,0,1,0
14,182,182,56,26,30,3,2
6,197,197,53,53,0,1,0
1,222,222,22,5,17,2,1
11,239,239,16,8,8,2,1
2,246,246,7,7,0,1,0
22,293,293,23,23,0,1,0
9,305,305,14,5,9,4,3
17,310,310,2,2,0,1,0
16,355,355,22,2,20,3,2
19,368,368,41,41,0,1,0
21,368,368,43,25,18,3,2
13,373,373,38,38,0,1,0
5,422,422,53,53,0,1,0
7,449,449,7,7,0,1,0
3,460,460,2,2,0,1,0
20,477,477,16,16,0,1,0
10,497,497,24,3,21,4,3

10,118,118,32,32,0,1,0
6,210,210,5,2,3,2,1
1,264,264,9,9,0,1,0
13,285,285,5,1,4,2,1
12,306,306,21,6,15,4,3
5,325,325,51,7,44,3,2
9,334,334,21,10,11,2,1
15,337,337,1,1,0,1,0
8,351,351,27,27,0,1,0
3,363,363,61,13,48,4,3
14,382,382,36,36,0,1,0
0,410,410,111,27,84,3,2
2,418,418,44,20,24,2,1
7,439,439,65,65,0,1,0
4,472,472,67,7,60,3,2
11,492,492,83,83,0,1,0

1,113,113,6,6,0,1,0
15,142,142,24,24,0,1,0
11,161,161,38,38,0,1,0
14,185,185,4,4,0,1,0
8,199,199,7,7,0,1,0
13,209,209,13,13,0,1,0
7,215,215,16,6,10,2,1
3,236,236,18,18,0,1,0
2,243,243,1,1,0,1,0
6,255,255,55,55,0,1,0
12,335,335,54,6,48,4,3
10,371,371,47,47,0,1,0
0,393,393,4,4,0,1,0
4,394,394,157,19,138,4,3
17,418,418,33,33,0,1,0
16,425,425,3,3,0,1,0
5,425,425,14,14,0,1,0
9,464,464,27,24,3,2,1

12,104,104,9,9,0,1,0
9,121,121,6,6,0,1,0
8,145,145,2,2,0,1,0
4,171,171,3,3,0,1,0
6,195,195,3,3,0,1,0
5,198,198,9,5,4,2,1
3,199,199,25,25,0,1,0
11,207,207,12,12,0,1,0
16,247,247,30,8,22,3,2
14,249,249,78,65,13,2,1
18,270,270,3,3,0,1,0
7,289,289,64,58,6,3,2
0,315,315,6,3,3,2,1
13,328,328,12,12,0,1,0
17,362,362,34,34,0,1,0
1,374,374,6,6,0,1,0
2,385,385,147,18,129,4,3
10,416,416,65,54,11,2,1
15,452,452,17,9,8,3,2

17,100,100,7,1,6,2,1
1,110,110,11,11,0,1,0
10,112,112,17,1,16,3,2
0,113,113,9,9,0,1,0
8,166,166,31,31,0,1,0
7,169,169,4,4,0,1,0
19,208,208,7,7,0,1,0
2,249,249,4,4,0,1,0
14,254,254,49,7,42,3,2
13,275,275,17,11,6,3,2
15,276,276,10,10,0,1,0
16,285,285,8,8,0,1,0
12,322,322,69,62,7,2,1
18,353,353,31,9,22,4,3
3,389,389,23,7,16,3,2
5,413,413,30,30,0,1,0
4,419,419,34,25,9,2,1
11,466,466,89,89,0,1,0
9,470,470,42,10,32,2,1
6,485,485,22,22,0,1,0

2,116,116,21,7,14,2,1
9,119,119,4,4,0,1,0
3,133,133,7,1,6,2,1
6,159,159,1,1,0,1,0
0,170,170,13,13,0,1,0
17,175,175,20,8,12,3,2
4,204,204,24,17,7,2,1
8,208,208,1,1,0,1,0
14,227,227,51,51,0,1,0
1,287,287,67,67,0,1,0
18,306,306,13,1,12,2,1
16,332,332,26,26,0,1,0
15,369,369,14,6,8,2,1
13,377,377,103,13,90,4,3
21,406,406,50,50,0,1,0
19,416,416,2,2,0,1,0
7,422,422,34,30,4,2,1
5,440,440,18,13,5,2,1
20,460,460,7,4,3,2,1
12,462,462,18,18,0,1,0
11,470,470,2,2,0,1,0
10,475,475,14,6,8,3,2

12,108,108,5,2,3,2,1
15,119,119,13,2,11,2,1
7,137,137,5,5,0,1,0
2,160,160,22,22,0,1,0
10,167,167,39,39,0,1,0
11,176,176,16,2,14,2,1
6,198,198,12,5,7,2,1
17,211,211,15,15,0,1,0
1,213,213,24,15,9,2,1
8,224,224,49,41,8,2,1
5,255,255,13,5,8,3,2
16,273,273,48,3,45,2,1
4,319,319,11,5,6,2,1
9,327,327,21,21,0,1,0
3,403,403,45,23,22,3,2
0,436,436,61,61,0,1,0
14,481,481,18,18,0,1,0
13,495,495,44,2,42,2,1

19,118,118,15,5,10,3,2
11,119,119,9,3,6,3,2
5,121,121,11,5,6,3,2
2,189,189,9,9,0,1,0
3,206,206,12,1,11,2,1
6,259,259,53,35,18,4,3
7,269,269,2,2,0,1,0
0,288,288,21,21,0,1,0
8,297,297,2,2,0,1,0
17,304,304,36,36,0,1,0
16,322,322,35,35,0,1,0
14,348,348,36,36,0,1,0
9,388,388,47,14,33,4,3
15,434,434,29,1,28,2,1
1,442,442,27,3,24,4,3
12,442,442,42,42,0,1,0
20,453,453,19,5,14,3,2
4,469,469,33,7,26,2,1
10,472,472,42,42,0,1,0
13,480,480,116,116,0,1,0
18,498,498,7,2,5,2,1

14,113,113,1,1,0,1,0
9,117,117,2,2,0,1,0
3,121,121,26,20,6,3,2
1,136,136,29,2,27,4,3
16,152,152,6,2,4,2,1
19,154,154,43,43,0,1,0
0,202,202,4,4,0,1,0
5,203,203,8,8,0,1,0
10,207,207,3,3,0,1,0
6,252,252,12,12,0,1,0
11,265,265,51,51,0,1,0
8,295,295,1,1,0,1,0
2,300,300,43,1,42,4,3
12,309,309,25,25,0,1,0
13,360,360,25,17,8,3,2
7,368,368,44,18,26,2,1
15,371,371,15,15,0,1,0
18,453,453,42,42,0,1,0
4,456,456,32,32,0,1,0
17,467,467,55,35,20,3,2

9,110,110,11,11,0,1,0
0,112,112,3,3,0,1,0
7,113,113,10,7,3,2,1
6,118,118,6,6,0,1,0
2,125,125,8,8,0,1,0
11,144,144,5,5,0,1,0
10,204,204,14,2,12,3,2
13,251,251,34,19,15,4,3
14,286,286,35,35,0,1,0
12,297,297,61,32,29,2,1
5,327,327,150,73,77,4,3
1,333,333,92,4,88,3,2
4,394,394,16,16,0,1,0
3,443,443,16,16,0,1,0
8,486,486,60,27,33,2,1

7,194,194,37,37,0,1,0
14,205,205,24,24,0,1,0
9,210,210,3,3,0,1,0
6,228,228,19,1,18,4,3
5,239,239,76,40,36,3,2
11,264,264,4,1,3,2,1
1,271,271,51,51,0,1,0
0,282,282,20,16,4,2,1
8,289,289,9,6,3,2,1
3,301,301,16,16,0,1,0
4,323,323,5,5,0,1,0
15,379,379,27,10,17,2,1
13,431,431,101,62,39,4,3
10,446,446,55,37,18,4,3
12,464,464,53,25,28,2,1
2,490,490,85,37,48,2,1

1,122,122,10,1,9,2,1
6,136,136,13,5,8,2,1
14,169,169,13,9,4,2,1
7,225,225,7,7,0,1,0
11,238,238,9,9,0,1,0
4,271,271,3,3,0,1,0
9,346,346,79,79,0,1,0
3,358,358,1,1,0,1,0
2,374,374,83,83,0,1,0
10,382,382,117,78,39,2,1
16,400,400,6,6,0,1,0
18,416,416,4,4,0,1,0
8,419,419,15,5,10,2,1
12,423,423,6,1,5,2,1
5,448,448,79,71,8,2,1
0,452,452,8,8,0,1,0
15,455,455,40,40,0,1,0
13,485,485,148,24,124,4,3
17,487,487,29,9,20,2,1

12,124,124,4,4,0,1,0
9,149,149,15,3,12,2,1
7,155,155,3,3,0,1,0
5,184,184,29,29,0,1,0
3,188,188,12,4,8,3,2
6,200,200,21,3,18,3,2
16,204,204,28,28,0,1,0
4,256,256,11,4,7,3,2
8,294,294,29,5,24,2,1
0,309,309,13,13,0,1,0
10,317,317,54,25,29,2,1
2,383,383,42,42,0,1,0
1,425,425,155,106,49,2,1
13,457,457,7,1,6,3,2
14,465,465,110,110,0,1,0
11,470,470,22,5,17,2,1
15,496,496,40,40,0,1,0

2,114,114,5,5,0,1,0
18,178,178,8,2,6,3,2
1,187,187,21,15,6,2,1
4,226,226,1,1,0,1,0
0,241,241,41,1,40,3,2
11,259,259,25,19,6,2,1
19,277,277,6,6,0,1,0
14,281,281,14,14,0,1,0
17,290,290,16,8,8,2,1
23,293,293,12,12,0,1,0
8,343,343,10,10,0,1,0
22,352,352,4,4,0,1,0
16,355,355,46,22,24,2,1
15,380,380,52,19,33,2,1
9,382,382,5,5,0,1,0
5,385,385,14,11,3,2,1
6,415,415,101,56,45,4,3
13,427,427,18,18,0,1,0
12,452,452,18,18,0,1,0
7,455,455,1,1,0,1,0
3,486,486,8,8,0,1,0
10,493,493,1,1,0,1,0
21,493,493,95,90,5,2,1
20,495,495,141,86,55,4,3

18,137,137,11,8,3,2,1
20,146,146,21,21,0,1,0
12,156,156,3,3,0,1,0
4,159,159,10,1,9,2,1
11,177,177,23,23,0,1,0
6,184,184,37,1,36,4,3
5,233,233,1,1,0,1,0
7,234,234,21,9,12,4,3
19,234,234,23,5,18,2,1
9,247,247,1,1,0,1,0
17,268,268,130,130,0,1,0
14,287,287,8,8,0,1,0
3,321,321,27,20,7,2,1
10,335,335,81,34,47,2,1
15,349,349,10,3,7,2,1
0,360,360,1,1,0,1,0
13,364,364,8,8,0,1,0
2,404,404,1,1,0,1,0
8,470,470,29,2,27,4,3
1,473,473,9,9,0,1,0
16,475,475,11,3,8,3,2

7,163,163,21,6,15,2,1
11,198,198,8,8,0,1,0
1,225,225,11,5,6,3,2
8,234,234,69,30,39,2,1
10,263,263,18,6,12,3,2
4,274,274,64,40,24,3,2
2,275,275,11,11,0,1,0
13,323,323,38,38,0,1,0
12,323,323,79,6,73,4,3
14,342,342,4,4,0,1,0
9,347,347,12,2,10,3,2
16,359,359,18,2,16,2,1
3,431,431,7,7,0,1,0
6,446,446,10,10,0,1,0
0,456,456,52,46,6,2,1
5,458,458,1,1,0,1,0
15,490,490,19,13,6,3,2
17,498,498,152,35,117,4,3

0,147,147,6,6,0,1,0
4,172,172,15,15,0,1,0
11,185,185,6,6,0,1,0
7,227,227,33,29,4,2,1
14,262,262,10,1,9,2,1
9,265,265,44,44,0,1,0
8,273,273,33,15,18,2,1
5,355,355,156,135,21,4,3
2,426,426,29,29,0,1,0
10,431,431,95,5,90,3,2
12,434,434,16,16,0,1,0
6,438,438,24,24,0,1,0
13,439,439,48,31,17,2,1
15,442,442,20,8,12,4,3
1,454,454,43,43,0,1,0
3,499,499,58,58,0,1,0

4,140,140,1,1,0,1,0
10,141,141,13,4,9,4,3
14,145,145,18,18,0,1,0
13,168,168,26,14,12,2,1
5,172,172,2,2,0,1,0
12,174,174,2,2,0,1,0
6,183,183,3,3,0,1,0
2,191,191,3,3,0,1,0
3,197,197,3,3,0,1,0
16,270,270,45,36,9,2,1
11,275,275,47,27,20,3,2
1,340,340,168,63,105,4,3
8,345,345,13,13,0,1,0
15,385,385,10,10,0,1,0
7,387,387,94,37,57,4,3
0,402,402,39,13,26,3,2
9,478,478,65,38,27,3,2

3,108,108,6,6,0,1,0
17,125,125,9,9,0,1,0
8,213,213,1,1,0,1,0
2,237,237,15,15,0,1,0
5,246,246,24,1,23,4,3
0,257,257,2,2,0,1,0
4,274,274,42,9,33,4,3
20,278,278,45,24,21,4,3
6,353,353,40,5,35,2,1
12,354,354,80,52,28,3,2
11,382,382,27,17,10,2,1
7,395,395,32,14,18,2,1
10,411,411,4,4,0,1,0
15,423,423,31,22,9,2,1
18,426,426,45,45,0,1,0
14,437,437,33,7,26,3,2
13,440,440,68,68,0,1,0
9,447,447,89,89,0,1,0
19,449,449,1,1,0,1,0
16,459,459,19,19,0,1,0
1,498,498,22,18,4,2,1

17,120,120,12,12,0,1,0
7,131,131,11,11,0,1,0
9,143,143,13,13,0,1,0
20,159,159,2,2,0,1,0
2,199,199,7,1,6,3,2
14,204,204,33,13,20,4,3
19,270,270,18,14,4,2,1
10,312,312,36,36,0,1,0
3,322,322,35,25,10,3,2
15,334,334,36,24,12,3,2
12,337,337,57,57,0,1,0
6,379,379,14,14,0,1,0
11,383,383,35,35,0,1,0
0,388,388,17,17,0,1,0
1,399,399,93,36,57,4,3
16,441,441,41,23,18,4,3
5,444,444,5,5,0,1,0
4,467,467,17,7,10,3,2
13,474,474,93,78,15,4,3
18,476,476,6,6,0,1,0
8,488,488,7,2,5,2,1

4,117,117,5,2,3,2,1
18,130,130,2,2,0,1,0
13,150,150,2,2,0,1,0
6,155,155,20,20,0,1,0
1,170,170,27,11,16,2,1
10,189,189,54,5,49,3,2
17,262,262,73,73,0,1,0
16,303,303,11,5,6,3,2
5,320,320,16,2,14,3,2
8,321,321,25,25,0,1,0
12,344,344,26,2,24,3,2
9,356,356,25,25,0,1,0
3,373,373,52,52,0,1,0
0,383,383,52,52,0,1,0
14,408,408,43,43,0,1,0
2,445,445,33,11,22,2,1
7,457,457,11,8,3,2,1
11,479,479,11,11,0,1,0
15,491,491,39,6,33,4,3

1,139,139,5,5,0,1,0
0,169,169,24,16,8,3,2
2,180,180,49,49,0,1,0
8,230,230,32,2,30,4,3
15,246,246,12,1,11,2,1
12,252,252,77,9,68,3,2
11,272,272,50,50,0,1,0
5,305,305,21,10,11,2,1
16,308,308,65,1,64,3,2
6,318,318,10,10,0,1,0
9,358,358,2,2,0,1,0
13,360,360,9,1,8,2,1
7,373,373,9,9,0,1,0
3,379,379,13,9,4,2,1
10,389,389,12,2,10,3,2
4,391,391,61,17,44,2,1
17,407,407,4,4,0,1,0
14,483,483,46,46,0,1,0

4,112,112,5,5,0,1,0
6,119,119,7,7,0,1,0
18,130,130,1,1,0,1,0
9,133,133,1,1,0,1,0
1,143,143,2,2,0,1,0
20,155,155,7,7,0,1,0
15,169,169,23,23,0,1,0
23,193,193,6,6,0,1,0
11,221,221,51,33,18,3,2
19,222,222,67,67,0,1,0
2,224,224,27,23,4,2,1
7,235,235,8,2,6,3,2
12,236,236,15,15,0,1,0
8,258,258,2,2,0,1,0
5,264,264,1,1,0,1,0
14,275,275,14,1,13,2,1
3,303,303,20,8,12,3,2
13,307,307,8,1,7,2,1
10,368,368,12,12,0,1,0
17,385,385,26,26,0,1,0
0,419,419,59,18,41,2,1
16,445,445,54,23,31,2,1
22,451,451,18,12,6,2,1
21,483,483,80,57,23,2,1

5,121,121,4,1,3,2,1
14,142,142,7,7,0,1,0
2,145,145,27,27,0,1,0
0,173,173,29,29,0,1,0
1,175,175,50,41,9,4,3
11,219,219,8,8,0,1,0
10,227,227,6,6,0,1,0
7,258,258,21,21,0,1,0
12,325,325,1,1,0,1,0
4,377,377,3,3,0,1,0
8,393,393,78,78,0,1,0
3,409,409,70,35,35,4,3
9,443,443,44,44,0,1,0
13,448,448,98,80,18,4,3
6,463,463,23,4,19,2,1
15,483,483,99,55,44,2,1

2,153,153,12,12,0,1,0
13,179,179,44,44,0,1,0
11,187,187,7,3,4,2,1
18,194,194,14,4,10,3,2
1,217,217,3,3,0,1,0
4,238,238,22,22,0,1,0
0,270,270,27,3,24,3,2
6,270,270,14,5,9,2,1
8,292,292,2,2,0,1,0
12,296,296,7,7,0,1,0
17,303,303,87,87,0,1,0
10,320,320,90,90,0,1,0
16,372,372,47,47,0,1,0
9,379,379,19,19,0,1,0
19,396,396,3,3,0,1,0
3,399,399,30,30,0,1,0
14,402,402,43,43,0,1,0
15,408,408,6,6,0,1,0
5,458,458,17,17,0,1,0
7,478,478,54,20,34,2,1

3,107,107,31,31,0,1,0
0,108,108,9,9,0,1,0
18,115,115,24,3,21,4,3
23,119,119,26,26,0,1,0
10,127,127,3,3,0,1,0
20,130,130,17,17,0,1,0
6,131,131,1,1,0,1,0
13,163,163,6,6,0,1,0
15,219,219,2,2,0,1,0
2,309,309,1,1,0,1,0
5,325,325,20,2,18,3,2
19,331,331,10,10,0,1,0
7,372,372,13,2,11,2,1
16,389,389,9,9,0,1,0
17,405,405,75,53,22,3,2
22,406,406,7,7,0,1,0
8,409,409,9,3,6,2,1
14,425,425,25,13,12,3,2
21,425,425,42,42,0,1,0
12,436,436,21,4,17,2,1
9,462,462,9,6,3,2,1
4,477,477,27,27,0,1,0
11,480,480,58,31,27,4,3
1,493,493,17,8,9,4,3

2,144,144,21,21,0,1,0
11,188,188,29,11,18,4,3
6,194,194,63,50,13,2,1
12,194,194,5,1,4,2,1
0,214,214,67,33,34,2,1
1,247,247,46,4,42,4,3
10,306,306,19,19,0,1,0
9,323,323,27,14,13,2,1
4,365,365,26,26,0,1,0
13,378,378,12,9,3,2,1
5,388,388,25,25,0,1,0
8,453,453,42,42,0,1,0
3,474,474,88,46,42,4,3
7,475,475,37,37,0,1,0

17,100,100,2,2,0,1,0
0,117,117,6,3,3,2,1
16,127,127,15,8,7,2,1
3,140,140,8,2,6,2,1
7,180,180,1,1,0,1,0
12,182,182,5,5,0,1,0
9,185,185,29,25,4,2,1
1,235,235,19,1,18,2,1
4,263,263,3,3,0,1,0
8,294,294,15,2,13,2,1
10,331,331,43,43,0,1,0
11,380,380,32,32,0,1,0
2,401,401,129,81,48,4,3
13,443,443,51,15,36,3,2
6,448,448,57,12,45,4,3
15,461,461,81,24,57,4,3
14,466,466,43,43,0,1,0
5,499,499,98,98,0,1,0

4,160,160,47,47,0,1,0
12,185,185,22,22,0,1,0
16,227,227,7,4,3,2,1
15,255,255,1,1,0,1,0
3,265,265,31,31,0,1,0
13,308,308,25,17,8,3,2
5,325,325,39,3,36,4,3
11,341,341,130,72,58,3,2
1,346,346,6,1,5,2,1
17,351,351,33,33,0,1,0
2,357,357,17,17,0,1,0
6,370,370,44,21,23,2,1
14,397,397,41,6,35,2,1
0,416,416,17,11,6,3,2
10,420,420,23,23,0,1,0
7,433,433,53,47,6,2,1
9,470,470,22,22,0,1,0
8,470,470,11,11,0,1,0

5,114,114,9,9,0,1,0
21,116,116,2,2,0,1,0
3,127,127,5,5,0,1,0
2,168,168,12,5,7,2,1
12,184,184,4,4,0,1,0
23,185,185,39,39,0,1,0
0,188,188,9,9,0,1,0
13,195,195,19,19,0,1,0
7,217,217,13,9,4,2,1
16,248,248,10,10,0,1,0
6,260,260,45,45,0,1,0
4,277,277,33,33,0,1,0
1,299,299,5,5,0,1,0
20,305,305,27,14,13,2,1
17,309,309,73,7,66,4,3
19,315,315,6,6,0,1,0
10,321,321,2,2,0,1,0
9,381,381,2,2,0,1,0
8,389,389,37,17,20,2,1
18,412,412,16,16,0,1,0
15,414,414,23,14,9,4,3
14,444,444,10,10,0,1,0
22,455,455,96,60,36,2,1
11,467,467,22,22,0,1,0

16,111,111,9,9,0,1,0
5,170,170,1,1,0,1,0
6,235,235,3,3,0,1,0
13,271,271,15,15,0,1,0
4,288,288,3,3,0,1,0
8,297,297,27,3,24,2,1
19,300,300,45,45,0,1,0
15,302,302,66,66,0,1,0
2,342,342,5,5,0,1,0
17,361,361,16,16,0,1,0
11,377,377,15,3,12,4,3
3,389,389,22,22,0,1,0
14,395,395,70,70,0,1,0
12,410,410,14,1,13,2,1
9,416,416,174,174,0,1,0
10,435,435,31,31,0,1,0
0,442,442,76,7,69,4,3
7,451,451,6,6,0,1,0
1,469,469,16,10,6,3,2
18,476,476,56,24,32,3,2

6,125,125,25,25,0,1,0
17,162,162,9,9,0,1,0
7,167,167,18,8,10,2,1
12,173,173,17,17,0,1,0
2,180,180,1,1,0,1,0
13,261,261,1,1,0,1,0
10,280,280,18,10,8,3,2
9,331,331,116,22,94,3,2
1,383,383,59,21,38,2,1
4,399,399,83,4,79,4,3
14,410,410,43,43,0,1,0
8,414,414,33,33,0,1,0
16,416,416,13,10,3,2,1
5,435,435,24,18,6,3,2
0,442,442,7,3,4,2,1
15,451,451,58,28,30,2,1
11,476,476,37,37,0,1,0
3,482,482,36,36,0,1,0

0,134,134,11,8,3,2,1
6,144,144,7,1,6,2,1
9,164,164,20,2,18,2,1
13,167,167,1,1,0,1,0
8,187,187,3,3,0,1,0
1,189,189,35,11,24,2,1
12,227,227,30,30,0,1,0
16,233,233,111,73,38,2,1
2,243,243,19,19,0,1,0
11,248,248,11,11,0,1,0
4,314,314,66,53,13,2,1
3,333,333,16,16,0,1,0
15,360,360,39,21,18,4,3
5,403,403,46,11,35,2,1
7,406,406,55,41,14,2,1
14,426,426,3,3,0,1,0
10,474,474,4,4,0,1,0

21,157,157,23,1,22,2,1
11,159,159,4,4,0,1,0
16,184,184,5,5,0,1,0
17,190,190,17,17,0,1,0
3,240,240,17,17,0,1,0
19,255,255,102,102,0,1,0
12,264,264,28,28,0,1,0
10,272,272,4,1,3,2,1
14,280,280,6,3,3,2,1
4,286,286,26,13,13,2,1
15,289,289,19,4,15,2,1
8,293,293,8,4,4,2,1
9,295,295,56,27,29,2,1
5,302,302,2,2,0,1,0
2,335,335,58,58,0,1,0
1,363,363,3,3,0,1,0
18,371,371,6,6,0,1,0
7,372,372,49,49,0,1,0
0,373,373,10,10,0,1,0
20,432,432,52,52,0,1,0
6,468,468,14,14,0,1,0
13,469,469,14,14,0,1,0

9,120,120,15,15,0,1,0
6,125,125,10,10,0,1,0
0,137,137,2,2,0,1,0
5,141,141,22,6,16,4,3
10,156,156,6,6,0,1,0
14,166,166,5,5,0,1,0
16,168,168,2,2,0,1,0
17,175,175,35,35,0,1,0
15,251,251,24,24,0,1,0
4,309,309,72,42,30,4,3
11,325,325,25,25,0,1,0
2,339,339,9,9,0,1,0
1,376,376,7,7,0,1,0
7,380,380,15,15,0,1,0
13,380,380,19,19,0,1,0
20,381,381,30,30,0,1,0
3,413,413,7,3,4,2,1
19,436,436,149,61,88,3,2
18,445,445,48,48,0,1,0
12,448,448,2,2,0,1,0
8,466,466,36,36,0,1,0

3,101,101,5,5,0,1,0
1,133,133,20,20,0,1,0
7,133,133,24,24,0,1,0
5,149,149,3,3,0,1,0
14,161,161,18,7,11,2,1
15,218,218,16,16,0,1,0
12,250,250,4,4,0,1,0
13,255,255,2,2,0,1,0
6,277,277,59,23,36,2,1
16,325,325,120,44,76,4,3
4,367,367,18,18,0,1,0
11,381,381,21,8,13,2,1
0,405,405,58,23,35,2,1
10,438,438,16,1,15,3,2
2,463,463,44,44,0,1,0
9,469,469,30,3,27,4,3
8,478,478,86,74,12,4,3

14,120,120,30,30,0,1,0
3,174,174,12,7,5,2,1
5,245,245,81,15,66,3,2
13,249,249,2,2,0,1,0
2,281,281,65,14,51,3,2
8,291,291,38,18,20,3,2
9,307,307,15,15,0,1,0
12,327,327,16,16,0,1,0
4,346,346,39,39,0,1,0
6,363,363,28,28,0,1,0
0,367,367,42,42,0,1,0
7,383,383,16,16,0,1,0
11,491,491,146,146,0,1,0
1,498,498,21,17,4,2,1
10,500,500,3,3,0,1,0

14,105,105,36,2,34,2,1
4,109,109,7,7,0,1,0
3,131,131,13,13,0,1,0
6,204,204,8,8,0,1,0
10,222,222,42,5,37,4,3
12,224,224,13,1,12,2,1
11,327,327,21,21,0,1,0
15,336,336,35,26,9,4,3
7,357,357,39,12,27,4,3
5,366,366,19,19,0,1,0
16,371,371,29,29,0,1,0
13,409,409,18,1,17,2,1
0,413,413,94,17,77,4,3
9,432,432,11,11,0,1,0
8,455,455,5,5,0,1,0
1,493,493,92,40,52,3,2
2,498,498,61,33,28,2,1

1,179,179,28,28,0,1,0
21,225,225,4,4,0,1,0
9,226,226,12,3,9,4,3
7,256,256,6,2,4,2,1
20,257,257,8,8,0,1,0
11,278,278,20,20,0,1,0
8,280,280,8,3,5,2,1
4,286,286,1,1,0,1,0
0,299,299,2,2,0,1,0
14,315,315,34,34,0,1,0
19,334,334,20,7,13,4,3
2,334,334,39,39,0,1,0
6,338,338,42,1,41,2,1
12,353,353,50,41,9,4,3
18,356,356,53,32,21,2,1
17,395,395,23,23,0,1,0
13,396,396,8,8,0,1,0
16,406,406,31,8,23,3,2
10,439,439,16,8,8,3,2
22,473,473,9,1,8,3,2
15,475,475,186,144,42,4,3
3,479,479,11,5,6,2,1
5,499,499,48,48,0,1,0

12,112,112,6,6,0,1,0
10,114,114,15,7,8,3,2
9,115,115,3,3,0,1,0
3,133,133,2,2,0,1,0
5,214,214,4,4,0,1,0
13,232,232,26,26,0,1,0
6,264,264,4,4,0,1,0
11,276,276,34,30,4,2,1
1,279,279,55,55,0,1,0
14,379,379,73,73,0,1,0
2,393,393,167,63,104,4,3
8,403,403,44,44,0,1,0
7,408,408,63,52,11,2,1
0,440,440,104,104,0,1,0
4,442,442,4,4,0,1,0

19,101,101,2,2,0,1,0
14,137,137,1,1,0,1,0
10,141,141,13,5,8,3,2
17,144,144,11,11,0,1,0
15,179,179,15,15,0,1,0
9,188,188,12,12,0,1,0
16,222,222,17,10,7,2,1
6,245,245,47,16,31,2,1
8,247,247,14,14,0,1,0
1,260,260,7,2,5,2,1
13,284,284,99,8,91,4,3
0,286,286,1,1,0,1,0
4,290,290,1,1,0,1,0
2,317,317,1,1,0,1,0
7,336,336,13,13,0,1,0
21,367,367,38,35,3,2,1
11,372,372,53,53,0,1,0
12,384,384,27,14,13,2,1
18,415,415,12,12,0,1,0
20,454,454,80,6,74,3,2
5,465,465,6,3,3,2,1
3,474,474,93,85,8,3,2

2,100,100,1,1,0,1,0
13,170,170,10,2,8,2,1
21,176,176,22,22,0,1,0
19,182,182,24,16,8,2,1
3,215,215,3,3,0,1,0
5,232,232,24,12,12,4,3
17,243,243,4,4,0,1,0
11,251,251,28,10,18,2,1
22,277,277,16,8,8,3,2
7,281,281,7,7,0,1,0
20,283,283,2,2,0,1,0
6,293,293,44,44,0,1,0
0,298,298,26,26,0,1,0
18,306,306,5,5,0,1,0
14,354,354,153,62,91,4,3
4,368,368,13,13,0,1,0
8,387,387,25,11,14,3,2
10,419,419,75,75,0,1,0
16,424,424,16,6,10,2,1
12,443,443,2,2,0,1,0
1,447,447,13,6,7,2,1
9,460,460,15,15,0,1,0
15,489,489,43,43,0,1,0

10,149,149,17,17,0,1,0
20,149,149,13,13,0,1,0
9,205,205,1,1,0,1,0
11,243,243,26,26,0,1,0
15,278,278,29,29,0,1,0
17,280,280,61,18,43,2,1
6,281,281,25,25,0,1,0
7,283,283,9,4,5,2,1
18,285,285,36,8,28,2,1
16,304,304,36,36,0,1,0
1,307,307,6,6,0,1,0
2,314,314,12,12,0,1,0
5,340,340,6,6,0,1,0
3,354,354,9,4,5,2,1
14,366,366,36,36,0,1,0
4,372,372,34,34,0,1,0
0,374,374,19,19,0,1,0
22,381,381,8,3,5,2,1
21,393,393,32,16,16,3,2
23,408,408,37,37,0,1,0
13,416,416,13,9,4,2,1
8,426,426,39,11,28,3,2
19,449,449,28,4,24,3,2
12,481,481,44,7,37,4,3

1,110,110,16,2,14,4,3
0,118,118,6,6,0,1,0
5,122,122,9,9,0,1,0
20,123,123,5,5,0,1,0
2,135,135,1,1,0,1,0
13,141,141,34,34,0,1,0
7,154,154,7,2,5,2,1
17,235,235,3,3,0,1,0
4,238,238,12,12,0,1,0
15,238,238,20,6,14,3,2
6,248,248,6,1,5,2,1
10,293,293,13,13,0,1,0
18,294,294,95,95,0,1,0
14,295,295,23,23,0,1,0
21,300,300,16,16,0,1,0
19,311,311,25,25,0,1,0
11,321,321,15,15,0,1,0
12,363,363,29,29,0,1,0
9,394,394,40,40,0,1,0
8,424,424,11,2,9,4,3
3,454,454,93,52,41,2,1
16,492,492,5,5,0,1,0

3,126,126,2,2,0,1,0
16,148,148,3,3,0,1,0
11,153,153,4,4,0,1,0
15,206,206,19,19,0,1,0
19,223,223,40,40,0,1,0
13,227,227,64,7,57,4,3
20,241,241,5,5,0,1,0
7,250,250,26,19,7,2,1
10,342,342,11,11,0,1,0
12,345,345,53,47,6,3,2
14,371,371,41,11,30,4,3
2,404,404,63,9,54,4,3
5,419,419,2,2,0,1,0
1,430,430,76,76,0,1,0
0,435,435,58,58,0,1,0
6,444,444,24,4,20,4,3
18,458,458,26,26,0,1,0
17,459,459,1,1,0,1,0
8,478,478,27,9,18,4,3
4,479,479,23,23,0,1,0
9,492,492,47,17,30,4,3

10,131,131,29,29,0,1,0
15,147,147,4,4,0,1,0
19,177,177,30,8,22,3,2
11,178,178,4,4,0,1,0
4,181,181,5,5,0,1,0
5,201,201,24,24,0,1,0
16,205,205,14,14,0,1,0
12,222,222,3,3,0,1,0
2,234,234,10,10,0,1,0
6,264,264,2,2,0,1,0
0,267,267,31,8,23,2,1
20,325,325,15,9,6,2,1
21,331,331,17,17,0,1,0
9,342,342,11,11,0,1,0
3,345,345,1,1,0,1,0
13,350,350,114,77,37,2,1
18,361,361,48,48,0,1,0
14,386,386,14,14,0,1,0
17,398,398,25,7,18,4,3
7,424,424,17,17,0,1,0
8,446,446,53,53,0,1,0
1,465,465,63,63,0,1,0

20,143,143,7,1,6,3,2
12,150,150,2,2,0,1,0
4,199,199,10,10,0,1,0
11,224,224,57,43,14,3,2
16,245,245,74,74,0,1,0
19,260,260,30,30,0,1,0
9,266,266,23,23,0,1,0
1,283,283,5,5,0,1,0
0,311,311,5,5,0,1,0
10,318,318,26,17,9,4,3
13,324,324,32,32,0,1,0
7,347,347,8,8,0,1,0
5,360,360,11,11,0,1,0
15,366,366,25,10,15,2,1
18,378,378,39,22,17,2,1
3,399,399,9,9,0,1,0
6,403,403,21,21,0,1,0
8,410,410,102,12,90,3,2
2,423,423,7,7,0,1,0
14,467,467,75,25,50,3,2
17,485,485,2,2,0,1,0

5,103,103,8,2,6,3,2
11,110,110,26,26,0,1,0
6,113,113,1,1,0,1,0
3,191,191,3,3,0,1,0
1,210,210,64,64,0,1,0
14,253,253,12,12,0,1,0
0,277,277,52,52,0,1,0
8,290,290,41,27,14,2,1
15,292,292,19,4,15,2,1
12,365,365,29,29,0,1,0
13,400,400,16,4,12,4,3
9,418,418,71,71,0,1,0
7,423,423,65,65,0,1,0
16,430,430,19,7,12,4,3
2,441,441,31,1,30,3,2
4,453,453,37,27,10,3,2
10,487,487,44,15,29,4,3

9,119,119,1,1,0,1,0
13,152,152,16,16,0,1,0
15,176,176,17,17,0,1,0
10,190,190,9,1,8,3,2
17,205,205,7,7,0,1,0
19,226,226,61,61,0,1,0
4,262,262,82,53,29,4,3
5,287,287,2,2,0,1,0
18,290,290,31,22,9,4,3
16,303,303,2,2,0,1,0
14,306,306,41,21,20,2,1
11,324,324,47,1,46,2,1
8,330,330,3,3,0,1,0
12,332,332,6,6,0,1,0
3,338,338,15,15,0,1,0
1,353,353,9,9,0,1,0
6,367,367,87,87,0,1,0
0,395,395,30,6,24,2,1
7,469,469,28,6,22,3,2
2,483,483,37,11,26,4,3

4,117,117,35,9,26,2,1
9,147,147,2,2,0,1,0
0,182,182,10,10,0,1,0
3,197,197,15,3,12,2,1
10,198,198,18,18,0,1,0
12,204,204,35,35,0,1,0
1,277,277,112,7,105,4,3
11,282,282,17,17,0,1,0
14,324,324,3,3,0,1,0
2,366,366,11,11,0,1,0
5,385,385,14,3,11,2,1
13,403,403,38,14,24,3,2
6,473,473,94,49,45,4,3
7,492,492,56,56,0,1,0
8,492,492,81,50,31,3,2

4,114,114,32,4,28,2,1
12,132,132,3,3,0,1,0
8,170,170,14,14,0,1,0
6,193,193,55,55,0,1,0
9,218,218,6,6,0,1,0
7,228,228,18,18,0,1,0
11,253,253,30,30,0,1,0
15,295,295,64,48,16,3,2
14,321,321,32,22,10,3,2
3,328,328,40,34,6,2,1
13,341,341,48,21,27,3,2
5,358,358,19,19,0,1,0
1,388,388,23,23,0,1,0
0,435,435,29,11,18,2,1
2,476,476,16,9,7,3,2
10,482,482,63,63,0,1,0

2,139,139,29,29,0,1,0
9,153,153,17,17,0,1,0
1,158,158,78,52,26,4,3
0,161,161,32,32,0,1,0
7,274,274,19,5,14,3,2
5,418,418,94,52,42,3,2
10,433,433,9,9,0,1,0
3,434,434,45,45,0,1,0
6,458,458,46,46,0,1,0
11,483,483,1,1,0,1,0
4,486,486,81,60,21,4,3
8,496,496,55,27,28,3,2

6,117,117,4,4,0,1,0
18,131,131,10,10,0,1,0
3,137,137,3,3,0,1,0
12,140,140,42,42,0,1,0
10,142,142,1,1,0,1,0
13,159,159,14,14,0,1,0
15,176,176,11,11,0,1,0
0,211,211,9,9,0,1,0
14,211,211,37,37,0,1,0
4,260,260,12,12,0,1,0
5,273,273,50,50,0,1,0
9,317,317,3,3,0,1,0
2,321,321,17,17,0,1,0
20,333,333,20,20,0,1,0
8,342,342,71,20,51,3,2
17,343,343,26,26,0,1,0
1,364,364,88,82,6,2,1
16,378,378,27,27,0,1,0
19,401,401,5,5,0,1,0
11,419,419,17,17,0,1,0
7,475,475,7,7,0,1,0

13,119,119,1,1,0,1,0
0,128,128,2,2,0,1,0
2,139,139,29,7,22,3,2
1,151,151,4,4,0,1,0
7,157,157,2,2,0,1,0
17,168,168,2,2,0,1,0
3,177,177,62,62,0,1,0
18,234,234,14,14,0,1,0
4,264,264,11,3,8,2,1
15,321,321,4,4,0,1,0
12,339,339,81,38,43,2,1
14,346,346,7,7,0,1,0
5,365,365,44,35,9,2,1
9,390,390,10,2,8,2,1
11,400,400,37,7,30,2,1
16,455,455,190,153,37,2,1
10,472,472,28,28,0,1,0
6,481,481,13,3,10,2,1
8,486,486,35,25,10,3,2

5,101,101,10,1,9,4,3
3,137,137,14,14,0,1,0
6,215,215,17,8,9,4,3
16,222,222,38,5,33,2,1
9,236,236,19,1,18,3,2
1,240,240,21,9,12,3,2
17,242,242,13,13,0,1,0
10,259,259,23,6,17,2,1
8,315,315,16,16,0,1,0
7,322,322,28,28,0,1,0
11,327,327,1,1,0,1,0
0,367,367,24,3,21,4,3
13,429,429,12,12,0,1,0
14,442,442,5,5,0,1,0
15,450,450,7,4,3,2,1
4,453,453,40,40,0,1,0
2,475,475,115,73,42,4,3
12,490,490,226,157,69,4,3

1,116,116,32,3,29,2,1
14,117,117,3,3,0,1,0
5,122,122,1,1,0,1,0
6,164,164,10,3,7,2,1
7,193,193,7,7,0,1,0
15,210,210,73,34,39,2,1
8,229,229,5,5,0,1,0
10,248,248,14,14,0,1,0
11,256,256,12,12,0,1,0
12,267,267,3,3,0,1,0
4,280,280,11,11,0,1,0
0,289,289,26,26,0,1,0
19,292,292,41,23,18,2,1
20,333,333,56,56,0,1,0
2,337,337,23,23,0,1,0
9,370,370,66,32,34,3,2
13,376,376,9,9,0,1,0
3,435,435,8,2,6,3,2
16,446,446,24,24,0,1,0
18,459,459,26,26,0,1,0
17,460,460,41,41,0,1,0

5,111,111,9,2,7,2,1
12,115,115,1,1,0,1,0
8,133,133,18,3,15,4,3
2,155,155,1,1,0,1,0
3,179,179,6,6,0,1,0
13,193,193,5,5,0,1,0
11,209,209,2,2,0,1,0
20,214,214,16,16,0,1,0
19,217,217,6,6,0,1,0
17,218,218,42,42,0,1,0
15,251,251,14,5,9,4,3
10,298,298,38,38,0,1,0
0,302,302,3,3,0,1,0
4,306,306,1,1,0,1,0
21,357,357,22,22,0,1,0
6,360,360,24,24,0,1,0
1,362,362,64,37,27,2,1
9,364,364,20,20,0,1,0
14,373,373,25,25,0,1,0
7,422,422,69,21,48,3,2
22,423,423,66,37,29,2,1
16,465,465,28,28,0,1,0
18,485,485,108,108,0,1,0

11,113,113,1,1,0,1,0
6,167,167,35,1,34,3,2
0,168,168,61,61,0,1,0
5,230,230,1,1,0,1,0
15,250,250,6,6,0,1,0
12,279,279,23,5,18,4,3
14,301,301,42,28,14,3,2
9,308,308,54,54,0,1,0
1,344,344,7,7,0,1,0
3,347,347,44,15,29,2,1
2,351,351,55,35,20,2,1
8,407,407,10,10,0,1,0
13,458,458,196,184,12,2,1
7,459,459,5,5,0,1,0
10,474,474,9,2,7,2,1
4,497,497,10,1,9,2,1

12,104,104,2,2,0,1,0
18,120,120,27,7,20,4,3
10,122,122,29,19,10,3,2
9,185,185,17,17,0,1,0
13,193,193,8,8,0,1,0
4,211,211,7,7,0,1,0
3,222,222,6,6,0,1,0
8,241,241,8,2,6,2,1
19,282,282,6,3,3,2,1
0,293,293,43,7,36,4,3
17,299,299,20,20,0,1,0
2,303,303,25,16,9,2,1
21,305,305,22,6,16,2,1
1,336,336,16,16,0,1,0
5,340,340,15,2,13,2,1
14,362,362,40,40,0,1,0
16,377,377,39,39,0,1,0
15,396,396,26,10,16,3,2
6,428,428,12,12,0,1,0
20,429,429,57,26,31,3,2
7,437,437,14,14,0,1,0
22,438,438,53,53,0,1,0
11,495,495,18,1,17,2,1

11,129,129,30,12,18,3,2
6,191,191,6,3,3,2,1
1,211,211,36,11,25,2,1
0,231,231,39,39,0,1,0
8,248,248,23,23,0,1,0
7,260,260,62,23,39,4,3
13,274,274,52,52,0,1,0
2,307,307,123,111,12,3,2
9,346,346,6,3,3,2,1
10,366,366,14,14,0,1,0
3,386,386,21,21,0,1,0
12,413,413,11,2,9,2,1
5,462,462,21,8,13,2,1
4,484,484,52,24,28,3,2

1,126,126,7,7,0,1,0
8,126,126,5,5,0,1,0
6,160,160,4,4,0,1,0
0,164,164,13,13,0,1,0
3,198,198,12,12,0,1,0
4,220,220,18,10,8,3,2
15,229,229,8,8,0,1,0
17,244,244,49,46,3,2,1
22,254,254,17,17,0,1,0
18,290,290,75,75,0,1,0
10,299,299,19,14,5,2,1
11,350,350,20,9,11,3,2
2,359,359,27,27,0,1,0
9,362,362,20,20,0,1,0
19,408,408,12,12,0,1,0
5,432,432,11,11,0,1,0
12,438,438,83,83,0,1,0
16,449,449,37,37,0,1,0
21,457,457,96,96,0,1,0
13,476,476,6,1,5,2,1
14,476,476,8,4,4,2,1
20,482,482,8,8,0,1,0
7,488,488,39,4,35,3,2

3,105,105,26,10,16,2,1
12,115,115,2,2,0,1,0
0,133,133,7,1,6,3,2
11,136,136,22,7,15,4,3
7,153,153,11,2,9,4,3
14,156,156,46,46,0,1,0
9,184,184,8,8,0,1,0
8,191,191,8,8,0,1,0
6,193,193,10,5,5,2,1
2,262,262,28,28,0,1,0
5,306,306,46,46,0,1,0
10,307,307,36,36,0,1,0
4,329,329,6,6,0,1,0
15,341,341,56,56,0,1,0
1,359,359,73,51,22,3,2
16,440,440,31,3,28,2,1
13,453,453,8,3,5,2,1

1,120,120,43,33,10,2,1
11,124,124,12,12,0,1,0
6,159,159,18,18,0,1,0
8,170,170,2,2,0,1,0
12,173,173,18,4,14,4,3
2,210,210,33,10,23,3,2
4,215,215,19,1,18,4,3
13,222,222,21,21,0,1,0
7,262,262,31,31,0,1,0
15,303,303,11,4,7,2,1
14,321,321,57,31,26,3,2
3,371,371,16,4,12,4,3
10,428,428,87,87,0,1,0
0,439,439,24,10,14,2,1
5,459,459,41,41,0,1,0
9,497,497,38,24,14,2,1

4,117,117,1,1,0,1,0
10,126,126,4,4,0,1,0
16,181,181,3,3,0,1,0
5,203,203,12,7,5,2,1
17,205,205,6,6,0,1,0
20,220,220,48,2,46,3,2
8,265,265,13,13,0,1,0
9,265,265,9,1,8,2,1
25,274,274,4,4,0,1,0
2,286,286,13,1,12,2,1
7,297,297,46,19,27,2,1
15,322,322,1,1,0,1,0
19,324,324,43,43,0,1,0
6,346,346,19,19,0,1,0
23,347,347,1,1,0,1,0
24,352,352,79,5,74,3,2
3,353,353,1,1,0,1,0
18,366,366,24,18,6,2,1
0,382,382,93,24,69,4,3
1,386,386,17,17,0,1,0
22,393,393,32,7,25,2,1
11,419,419,15,5,10,2,1
13,432,432,6,1,5,2,1
12,457,457,32,22,10,2,1
21,462,462,66,2,64,3,2
14,477,477,18,18,0,1,0

19,106,106,27,27,0,1,0
18,126,126,5,5,0,1,0
14,160,160,12,12,0,1,0
15,162,162,7,7,0,1,0
5,172,172,39,39,0,1,0
12,190,190,14,14,0,1,0
13,205,205,9,9,0,1,0
3,219,219,4,1,3,2,1
10,221,221,28,4,24,3,2
4,231,231,7,7,0,1,0
8,234,234,12,6,6,2,1
2,252,252,1,1,0,1,0
9,281,281,18,18,0,1,0
0,282,282,10,10,0,1,0
21,315,315,41,41,0,1,0
16,374,374,76,76,0,1,0
11,397,397,25,9,16,3,2
1,419,419,49,16,33,4,3
17,425,425,9,9,0,1,0
7,442,442,22,17,5,2,1
6,470,470,20,15,5,2,1
20,474,474,51,51,0,1,0

12,118,118,22,7,15,4,3
10,127,127,14,14,0,1,0
8,134,134,1,1,0,1,0
17,140,140,32,32,0,1,0
5,146,146,24,24,0,1,0
0,181,181,1,1,0,1,0
14,203,203,11,11,0,1,0
13,220,220,16,11,5,2,1
9,232,232,40,40,0,1,0
20,291,291,1,1,0,1,0
11,298,298,17,17,0,1,0
2,317,317,6,6,0,1,0
7,342,342,3,3,0,1,0
16,403,403,82,51,31,3,2
3,408,408,60,29,31,2,1
15,421,421,48,3,45,2,1
19,428,428,13,13,0,1,0
1,430,430,68,35,33,4,3
18,439,439,14,14,0,1,0
6,451,451,12,3,9,2,1
4,488,488,13,13,0,1,0

14,119,119,2,2,0,1,0
1,132,132,1,1,0,1,0
10,152,152,25,1,24,4,3
0,206,206,12,5,7,2,1
13,237,237,10,10,0,1,0
15,280,280,32,2,30,3,2
8,286,286,1,1,0,1,0
16,295,295,26,18,8,3,2
3,349,349,12,12,0,1,0
5,368,368,13,13,0,1,0
18,391,391,63,63,0,1,0
17,392,392,7,3,4,2,1
19,398,398,47,23,24,3,2
6,405,405,8,1,7,2,1
20,412,412,82,46,36,2,1
7,430,430,34,14,20,3,2
9,461,461,45,45,0,1,0
2,462,462,65,65,0,1,0
12,466,466,71,71,0,1,0
4,486,486,120,62,58,4,3
11,499,499,7,3,4,2,1

3,100,100,7,7,0,1,0
21,136,136,24,16,8,2,1
15,140,140,47,21,26,2,1
13,142,142,5,5,0,1,0
7,147,147,26,26,0,1,0
5,156,156,1,1,0,1,0
1,189,189,6,6,0,1,0
18,192,192,19,2,17,2,1
4,231,231,32,8,24,2,1
9,254,254,59,41,18,2,1
11,261,261,4,4,0,1,0
17,291,291,16,1,15,3,2
8,297,297,1,1,0,1,0
10,305,305,11,11,0,1,0
20,318,318,10,10,0,1,0
14,327,327,21,21,0,1,0
2,352,352,17,17,0,1,0
0,352,352,14,14,0,1,0
22,360,360,19,19,0,1,0
6,405,405,6,6,0,1,0
19,425,425,41,15,26,3,2
16,444,444,4,4,0,1,0
12,444,444,23,4,19,4,3

13,100,100,3,3,0,1,0
2,122,122,2,2,0,1,0
0,132,132,6,3,3,2,1
8,157,157,1,1,0,1,0
19,163,163,7,4,3,2,1
21,171,171,13,5,8,3,2
20,180,180,1,1,0,1,0
7,216,216,11,3,8,3,2
17,218,218,9,9,0,1,0
11,219,219,2,2,0,1,0
16,235,235,9,9,0,1,0
14,240,240,118,98,20,4,3
15,258,258,26,10,16,2,1
3,297,297,35,35,0,1,0
5,328,328,90,81,9,2,1
1,341,341,38,38,0,1,0
10,389,389,34,7,27,3,2
18,399,399,49,49,0,1,0
9,425,425,1,1,0,1,0
22,441,441,2,2,0,1,0
4,476,476,15,15,0,1,0
6,486,486,40,40,0,1,0
12,497,497,18,18,0,1,0

18,115,115,10,10,0,1,0
16,119,119,3,3,0,1,0
2,139,139,1,1,0,1,0
14,139,139,34,34,0,1,0
11,142,142,14,14,0,1,0
8,160,160,10,3,7,2,1
5,194,194,4,4,0,1,0
13,203,203,23,3,20,3,2
0,209,209,2,2,0,1,0
12,239,239,14,14,0,1,0
19,274,274,15,15,0,1,0
3,295,295,49,31,18,4,3
20,306,306,54,9,45,4,3
7,317,317,20,10,10,3,2
15,324,324,36,9,27,4,3
1,353,353,26,26,0,1,0
17,366,366,21,5,16,3,2
4,374,374,36,36,0,1,0
6,378,378,7,7,0,1,0
9,430,430,68,33,35,4,3
10,496,496,63,5,58,3,2

0,100,100,1,1,0,1,0
7,107,107,3,3,0,1,0
3,117,117,18,12,6,3,2
20,121,121,27,27,0,1,0
14,121,121,15,15,0,1,0
8,161,161,17,1,16,2,1
13,216,216,14,4,10,2,1
16,236,236,19,6,13,2,1
9,237,237,49,49,0,1,0
10,268,268,11,11,0,1,0
6,277,277,9,2,7,2,1
12,291,291,30,4,26,3,2
17,302,302,10,7,3,2,1
2,354,354,1,1,0,1,0
4,386,386,44,38,6,2,1
5,403,403,25,25,0,1,0
19,412,412,19,11,8,2,1
1,418,418,51,51,0,1,0
18,452,452,69,6,63,4,3
15,459,459,42,26,16,2,1
11,461,461,10,10,0,1,0

6,130,130,23,23,0,1,0
16,170,170,22,22,0,1,0
14,171,171,30,30,0,1,0
2,201,201,11,11,0,1,0
12,229,229,26,26,0,1,0
5,264,264,9,9,0,1,0
8,279,279,54,54,0,1,0
13,280,280,7,7,0,1,0
15,298,298,14,14,0,1,0
9,299,299,31,12,19,2,1
7,311,311,31,1,30,3,2
1,334,334,48,48,0,1,0
4,363,363,49,49,0,1,0
10,396,396,37,37,0,1,0
3,400,400,65,65,0,1,0
0,459,459,43,43,0,1,0
11,497,497,17,17,0,1,0

18,109,109,4,1,3,2,1
11,113,113,12,12,0,1,0
26,122,122,33,33,0,1,0
4,134,134,2,2,0,1,0
7,138,138,2,2,0,1,0
0,146,146,4,4,0,1,0
10,163,163,1,1,0,1,0
9,214,214,6,6,0,1,0
20,222,222,61,19,42,3,2
16,224,224,18,2,16,3,2
8,260,260,8,8,0,1,0
21,290,290,20,20,0,1,0
25,319,319,28,17,11,2,1
17,331,331,21,13,8,3,2
13,344,344,36,3,33,4,3
22,367,367,17,5,12,2,1
5,368,368,21,21,0,1,0
12,393,393,17,17,0,1,0
28,403,403,1,1,0,1,0
3,403,403,17,8,9,4,3
23,436,436,1,1,0,1,0
1,439,439,23,23,0,1,0
14,441,441,22,8,14,3,2
2,448,448,31,31,0,1,0
6,465,465,9,1,8,2,1
27,467,467,14,7,7,2,1
19,473,473,25,25,0,1,0
15,481,481,1,1,0,1,0
24,484,484,62,12,50,2,1

9,137,137,43,13,30,2,1
13,165,165,6,6,0,1,0
4,174,174,34,34,0,1,0
3,295,295,91,91,0,1,0
0,305,305,30,30,0,1,0
10,310,310,19,19,0,1,0
5,359,359,29,29,0,1,0
8,376,376,60,45,15,4,3
7,392,392,4,4,0,1,0
2,412,412,49,18,31,2,1
11,430,430,80,80,0,1,0
1,437,437,80,64,16,2,1
12,444,444,24,11,13,2,1
6,477,477,7,7,0,1,0

17,100,100,7,7,0,1,0
4,137,137,42,12,30,2,1
0,161,161,10,10,0,1,0
7,167,167,2,2,0,1,0
10,224,224,15,15,0,1,0
14,245,245,27,27,0,1,0
8,284,284,42,9,33,2,1
5,293,293,33,33,0,1,0
12,315,315,45,36,9,2,1
15,325,325,25,1,24,2,1
6,342,342,62,62,0,1,0
13,362,362,11,11,0,1,0
16,402,402,42,10,32,3,2
11,403,403,63,63,0,1,0
2,422,422,11,11,0,1,0
9,446,446,73,61,12,4,3
3,463,463,18,18,0,1,0
1,465,465,7,7,0,1,0

6,119,119,10,3,7,2,1
17,121,121,27,27,0,1,0
9,183,183,1,1,0,1,0
0,208,208,1,1,0,1,0
14,238,238,11,11,0,1,0
8,244,244,28,28,0,1,0
13,289,289,11,11,0,1,0
15,293,293,60,43,17,2,1
12,305,305,58,58,0,1,0
19,318,318,36,36,0,1,0
7,337,337,47,26,21,2,1
4,346,346,21,7,14,3,2
3,362,362,61,61,0,1,0
1,393,393,8,8,0,1,0
5,420,420,78,6,72,3,2
16,457,457,1,1,0,1,0
18,461,461,27,27,0,1,0
2,472,472,43,43,0,1,0
10,489,489,13,9,4,2,1
11,497,497,21,3,18,2,1

17,109,109,14,4,10,3,2
3,116,116,13,13,0,1,0
10,127,127,25,16,9,2,1
18,127,127,10,10,0,1,0
14,131,131,5,1,4,2,1
5,154,154,2,2,0,1,0
4,157,157,21,3,18,3,2
2,162,162,1,1,0,1,0
1,183,183,16,2,14,2,1
15,183,183,32,2,30,4,3
0,216,216,14,14,0,1,0
6,249,249,1,1,0,1,0
16,260,260,93,18,75,4,3
11,262,262,45,23,22,2,1
19,318,318,20,20,0,1,0
13,365,365,1,1,0,1,0
9,368,368,9,9,0,1,0
7,375,375,6,3,3,2,1
12,404,404,17,6,11,2,1
8,475,475,34,6,28,4,3
20,485,485,19,19,0,1,0

17,101,101,31,13,18,4,3
3,146,146,52,40,12,2,1
4,150,150,28,17,11,2,1
5,155,155,1,1,0,1,0
6,184,184,5,5,0,1,0
13,227,227,30,30,0,1,0
8,261,261,5,5,0,1,0
7,266,266,2,2,0,1,0
12,282,282,18,18,0,1,0
0,322,322,13,1,12,4,3
2,348,348,32,32,0,1,0
10,377,377,10,4,6,3,2
14,378,378,11,3,8,2,1
9,406,406,79,69,10,2,1
16,415,415,40,40,0,1,0
11,433,433,14,14,0,1,0
1,447,447,75,68,7,2,1
15,484,484,17,17,0,1,0

17,103,103,2,2,0,1,0
21,123,123,8,8,0,1,0
0,128,128,9,9,0,1,0
10,140,140,13,13,0,1,0
22,145,145,11,11,0,1,0
2,175,175,17,17,0,1,0
8,187,187,3,3,0,1,0
14,205,205,48,33,15,4,3
13,267,267,7,1,6,2,1
19,295,295,49,7,42,4,3
9,296,296,8,1,7,2,1
1,309,309,24,24,0,1,0
6,313,313,5,1,4,2,1
11,351,351,20,20,0,1,0
18,360,360,33,33,0,1,0
12,377,377,1,1,0,1,0
15,411,411,31,7,24,2,1
20,442,442,43,13,30,2,1
3,448,448,30,12,18,2,1
5,454,454,74,67,7,2,1
4,468,468,85,85,0,1,0
7,488,488,3,3,0,1,0
16,494,494,47,41,6,2,1

7,151,151,14,6,8,2,1
19,152,152,9,4,5,2,1
14,201,201,5,5,0,1,0
18,211,211,83,62,21,4,3
10,253,253,17,17,0,1,0
0,263,263,15,3,12,2,1
5,265,265,32,5,27,4,3
15,276,276,21,21,0,1,0
2,289,289,8,2,6,2,1
20,291,291,14,14,0,1,0
16,299,299,29,3,26,3,2
12,311,311,5,5,0,1,0
4,341,341,21,13,8,3,2
9,348,348,18,18,0,1,0
3,365,365,26,6,20,2,1
11,378,378,16,1,15,4,3
1,419,419,44,44,0,1,0
17,447,447,16,3,13,2,1
8,463,463,6,6,0,1,0
13,475,475,80,30,50,4,3
6,477,477,91,59,32,2,1

8,153,153,8,8,0,1,0
0,201,201,20,4,16,3,2
12,224,224,15,6,9,4,3
5,230,230,31,31,0,1,0
3,330,330,101,1,100,3,2
9,365,365,2,2,0,1,0
4,369,369,27,27,0,1,0
7,401,401,47,47,0,1,0
14,407,407,28,28,0,1,0
11,414,414,91,73,18,2,1
13,422,422,127,39,88,4,3
6,436,436,10,10,0,1,0
2,453,453,24,24,0,1,0
1,481,481,114,57,57,4,3
10,498,498,28,28,0,1,0

10,110,110,1,1,0,1,0
11,117,117,1,1,0,1,0
13,127,127,13,13,0,1,0
0,151,151,1,1,0,1,0
6,160,160,24,7,17,3,2
19,195,195,11,8,3,2,1
15,202,202,16,16,0,1,0
17,225,225,9,5,4,2,1
7,285,285,11,5,6,3,2
8,292,292,67,20,47,3,2
4,318,318,17,2,15,4,3
5,331,331,21,7,14,2,1
9,369,369,13,3,10,3,2
12,390,390,7,7,0,1,0
16,418,418,8,8,0,1,0
3,433,433,113,85,28,4,3
18,451,451,32,32,0,1,0
14,456,456,125,125,0,1,0
20,479,479,39,33,6,2,1
1,480,480,4,4,0,1,0
2,491,491,10,5,5,2,1
21,495,495,97,65,32,3,2

18,143,143,12,6,6,3,2
4,200,200,32,32,0,1,0
15,204,204,9,9,0,1,0
11,208,208,19,19,0,1,0
3,232,232,4,1,3,2,1
10,239,239,12,12,0,1,0
16,252,252,9,9,0,1,0
6,255,255,1,1,0,1,0
13,262,262,67,67,0,1,0
8,265,265,29,21,8,2,1
12,330,330,62,17,45,4,3
1,368,368,57,35,22,2,1
9,403,403,68,68,0,1,0
0,429,429,31,31,0,1,0
5,443,443,14,14,0,1,0
17,460,460,24,13,11,3,2
2,472,472,1,1,0,1,0
19,474,474,14,14,0,1,0
14,498,498,63,5,58,4,3
7,500,500,65,65,0,1,0

8,108,108,28,28,0,1,0
18,128,128,12,12,0,1,0
13,147,147,29,29,0,1,0
1,159,159,1,1,0,1,0
15,174,174,16,16,0,1,0
5,174,174,12,2,10,3,2
0,213,213,12,7,5,2,1
4,217,217,26,11,15,4,3
2,263,263,15,15,0,1,0
14,309,309,11,11,0,1,0
12,326,326,15,2,13,2,1
3,353,353,25,25,0,1,0
10,360,360,24,14,10,3,2
6,389,389,38,38,0,1,0
11,416,416,83,83,0,1,0
16,442,442,47,26,21,2,1
9,445,445,15,15,0,1,0
17,470,470,37,31,6,2,1
7,489,489,64,24,40,2,1

17,101,101,2,2,0,1,0
24,112,112,4,4,0,1,0
15,115,115,5,5,0,1,0
21,142,142,13,13,0,1,0
23,159,159,6,6,0,1,0
2,179,179,13,5,8,3,2
16,184,184,2,2,0,1,0
25,195,195,1,1,0,1,0
27,201,201,1,1,0,1,0
20,227,227,49,49,0,1,0
1,300,300,1,1,0,1,0
22,306,306,78,69,9,2,1
8,310,310,39,5,34,3,2
7,313,313,3,3,0,1,0
5,314,314,22,2,20,3,2
4,320,320,25,25,0,1,0
14,325,325,5,1,4,2,1
18,328,328,7,7,0,1,0
0,346,346,17,17,0,1,0
10,386,386,14,5,9,4,3
11,420,420,19,19,0,1,0
19,421,421,63,31,32,3,2
26,425,425,50,50,0,1,0
13,447,447,34,34,0,1,0
6,450,450,71,59,12,4,3
12,453,453,4,4,0,1,0
3,477,477,12,2,10,2,1
9,495,495,16,16,0,1,0

2,128,128,7,1,6,2,1
18,132,132,7,3,4,2,1
3,136,136,3,3,0,1,0
23,145,145,16,4,12,4,3
9,235,235,9,9,0,1,0
8,237,237,9,5,4,2,1
4,257,257,13,13,0,1,0
17,260,260,15,15,0,1,0
12,267,267,52,52,0,1,0
22,271,271,47,17,30,3,2
19,296,296,15,15,0,1,0
14,309,309,11,2,9,4,3
1,321,321,11,2,9,2,1
7,346,346,94,79,15,4,3
0,366,366,17,13,4,2,1
10,366,366,18,18,0,1,0
13,375,375,11,2,9,2,1
21,380,380,66,40,26,2,1
6,383,383,1,1,0,1,0
20,473,473,36,36,0,1,0
11,474,474,9,1,8,2,1
16,492,492,12,3,9,2,1
5,493,493,8,8,0,1,0
15,495,495,101,85,16,3,2

17,111,111,5,5,0,1,0
7,113,113,14,10,4,2,1
3,118,118,2,2,0,1,0
23,125,125,11,11,0,1,0
20,131,131,25,25,0,1,0
1,137,137,16,16,0,1,0
14,175,175,21,21,0,1,0
8,180,180,1,1,0,1,0
2,182,182,1,1,0,1,0
10,186,186,49,4,45,2,1
4,189,189,22,6,16,2,1
6,190,190,3,3,0,1,0
15,210,210,6,6,0,1,0
16,210,210,2,2,0,1,0
22,225,225,55,55,0,1,0
18,226,226,5,5,0,1,0
11,230,230,4,4,0,1,0
0,232,232,14,8,6,3,2
13,239,239,1,1,0,1,0
12,350,350,2,2,0,1,0
21,385,385,35,35,0,1,0
19,406,406,81,32,49,2,1
5,493,493,7,3,4,2,1
9,496,496,9,9,0,1,0

9,133,133,7,7,0,1,0
8,161,161,10,10,0,1,0
10,175,175,6,6,0,1,0
1,202,202,3,3,0,1,0
5,211,211,3,3,0,1,0
3,230,230,58,58,0,1,0
2,274,274,11,7,4,2,1
7,317,317,47,3,44,3,2
13,327,327,3,3,0,1,0
14,353,353,184,66,118,4,3
6,383,383,78,44,34,3,2
4,423,423,64,55,9,4,3
0,425,425,33,24,9,2,1
11,431,431,30,1,29,2,1
12,435,435,22,22,0,1,0
15,458,458,32,17,15,2,1
16,495,495,22,2,20,2,1

5,111,111,12,12,0,1,0
6,120,120,2,2,0,1,0
13,122,122,14,14,0,1,0
11,169,169,2,2,0,1,0
8,208,208,40,40,0,1,0
0,239,239,19,11,8,3,2
9,257,257,56,44,12,3,2
16,257,257,15,15,0,1,0
4,305,305,48,15,33,4,3
2,344,344,21,21,0,1,0
10,384,384,24,24,0,1,0
3,388,388,118,118,0,1,0
14,408,408,3,3,0,1,0
7,461,461,62,62,0,1,0
1,466,466,19,16,3,2,1
12,480,480,22,9,13,3,2
15,498,498,105,38,67,3,2

7,151,151,11,11,0,1,0
0,167,167,26,12,14,3,2
13,173,173,33,33,0,1,0
2,187,187,10,10,0,1,0
8,199,199,2,2,0,1,0
5,225,225,20,2,18,2,1
6,230,230,65,65,0,1,0
1,363,363,21,21,0,1,0
14,367,367,31,31,0,1,0
11,372,372,73,73,0,1,0
10,375,375,4,4,0,1,0
4,430,430,77,61,16,2,1
9,455,455,9,3,6,2,1
15,478,478,42,42,0,1,0
12,486,486,121,121,0,1,0
3,496,496,41,7,34,2,1

1,101,101,15,3,12,2,1
15,117,117,6,6,0,1,0
3,128,128,12,2,10,3,2
14,134,134,8,3,5,2,1
11,141,141,16,10,6,2,1
0,145,145,8,8,0,1,0
13,154,154,3,3,0,1,0
6,194,194,7,2,5,2,1
4,225,225,35,7,28,2,1
9,237,237,36,12,24,2,1
12,237,237,86,2,84,3,2
16,264,264,1,1,0,1,0
17,324,324,45,45,0,1,0
10,367,367,5,2,3,2,1
5,373,373,43,38,5,2,1
8,403,403,22,4,18,2,1
7,413,413,99,49,50,2,1
2,434,434,1,1,0,1,0

9,107,107,1,1,0,1,0
21,113,113,8,3,5,2,1
10,115,115,13,13,0,1,0
18,127,127,8,2,6,2,1
5,140,140,1,1,0,1,0
0,151,151,18,8,10,3,2
11,164,164,1,1,0,1,0
22,165,165,40,40,0,1,0
20,173,173,16,16,0,1,0
15,203,203,1,1,0,1,0
8,218,218,5,2,3,2,1
25,229,229,13,13,0,1,0
7,250,250,7,7,0,1,0
1,264,264,6,6,0,1,0
2,274,274,3,3,0,1,0
14,297,297,7,1,6,2,1
12,298,298,31,16,15,4,3
17,333,333,49,49,0,1,0
23,339,339,43,43,0,1,0
16,357,357,51,33,18,4,3
4,360,360,19,1,18,4,3
13,372,372,46,6,40,3,2
24,449,449,52,7,45,4,3
6,477,477,41,9,32,3,2
3,482,482,11,4,7,2,1
19,495,495,5,1,4,2,1

10,108,108,7,1,6,3,2
1,114,114,7,1,6,2,1
15,114,114,2,2,0,1,0
20,134,134,4,1,3,2,1
12,135,135,8,8,0,1,0
14,148,148,8,8,0,1,0
18,157,157,3,3,0,1,0
5,165,165,1,1,0,1,0
6,172,172,4,4,0,1,0
8,220,220,15,15,0,1,0
13,273,273,72,52,20,3,2
11,282,282,6,1,5,2,1
4,320,320,87,87,0,1,0
19,323,323,11,5,6,3,2
7,341,341,8,8,0,1,0
3,383,383,47,47,0,1,0
21,390,390,102,23,79,4,3
16,420,420,30,30,0,1,0
2,422,422,8,8,0,1,0
9,428,428,56,56,0,1,0
0,442,442,13,3,10,3,2
17,443,443,75,29,46,2,1

5,103,103,10,10,0,1,0
13,104,104,5,5,0,1,0
2,118,118,14,4,10,2,1
1,130,130,17,7,10,3,2
14,192,192,21,11,10,3,2
6,213,213,36,36,0,1,0
8,220,220,16,11,5,2,1
10,224,224,1,1,0,1,0
7,228,228,3,3,0,1,0
0,244,244,1,1,0,1,0
3,251,251,56,48,8,2,1
9,273,273,49,49,0,1,0
4,285,285,46,18,28,2,1
12,449,449,206,206,0,1,0
11,473,473,14,14,0,1,0
15,490,490,4,4,0,1,0

2,122,122,20,20,0,1,0
11,164,164,1,1,0,1,0
12,210,210,8,1,7,2,1
16,218,218,35,35,0,1,0
21,230,230,40,40,0,1,0
8,268,268,21,7,14,3,2
10,272,272,3,3,0,1,0
7,325,325,6,6,0,1,0
0,330,330,39,15,24,4,3
3,331,331,26,26,0,1,0
18,343,343,21,8,13,3,2
9,343,343,1,1,0,1,0
1,363,363,14,14,0,1,0
6,409,409,80,75,5,2,1
13,412,412,60,60,0,1,0
4,419,419,48,48,0,1,0
17,426,426,5,2,3,2,1
19,431,431,17,17,0,1,0
14,433,433,25,4,21,4,3
5,463,463,18,3,15,2,1
15,473,473,37,16,21,4,3
20,490,490,92,92,0,1,0

10,102,102,4,1,3,2,1
8,139,139,17,11,6,3,2
6,141,141,8,8,0,1,0
9,182,182,27,8,19,2,1
14,183,183,4,4,0,1,0
13,184,184,4,1,3,2,1
4,193,193,3,3,0,1,0
18,227,227,44,44,0,1,0
1,281,281,4,4,0,1,0
15,326,326,93,93,0,1,0
17,339,339,34,19,15,2,1
7,341,341,30,5,25,4,3
3,385,385,85,85,0,1,0
5,392,392,21,9,12,4,3
11,419,419,27,27,0,1,0
0,440,440,22,2,20,2,1
12,468,468,30,18,12,4,3
16,481,481,60,4,56,3,2
2,488,488,65,65,0,1,0

1,110,110,7,3,4,2,1
0,134,134,72,28,44,2,1
4,136,136,19,9,10,3,2
5,190,190,47,28,19,2,1
8,223,223,10,10,0,1,0
9,277,277,38,38,0,1,0
6,316,316,1,1,0,1,0
7,364,364,23,17,6,3,2
11,400,400,71,71,0,1,0
2,402,402,121,77,44,3,2
10,422,422,10,10,0,1,0
3,430,430,36,16,20,3,2

10,112,112,8,2,6,2,1
17,116,116,4,1,3,2,1
8,132,132,21,21,0,1,0
7,132,132,4,1,3,2,1
18,169,169,6,6,0,1,0
0,191,191,19,19,0,1,0
6,201,201,8,8,0,1,0
13,246,246,23,20,3,2,1
9,268,268,88,88,0,1,0
11,287,287,12,12,0,1,0
16,326,326,47,13,34,3,2
3,347,347,13,3,10,4,3
4,348,348,34,29,5,2,1
15,387,387,26,26,0,1,0
14,390,390,40,13,27,2,1
5,415,415,4,1,3,2,1
2,433,433,13,13,0,1,0
1,468,468,32,32,0,1,0
12,478,478,159,91,68,4,3

17,120,120,4,4,0,1,0
13,155,155,12,7,5,2,1
7,169,169,10,2,8,3,2
3,185,185,16,5,11,2,1
4,210,210,59,9,50,3,2
8,225,225,7,7,0,1,0
10,245,245,58,5,53,3,2
15,273,273,17,13,4,2,1
0,354,354,28,28,0,1,0
11,373,373,10,10,0,1,0
2,410,410,11,11,0,1,0
16,434,434,82,40,42,3,2
5,471,471,15,7,8,3,2
9,477,477,66,6,60,3,2
6,479,479,28,28,0,1,0
14,493,493,26,26,0,1,0
12,496,496,49,1,48,4,3
1,499,499,124,124,0,1,0

16,125,125,7,7,0,1,0
4,195,195,12,12,0,1,0
14,224,224,4,4,0,1,0
17,234,234,7,7,0,1,0
10,244,244,17,5,12,2,1
9,247,247,26,26,0,1,0
0,257,257,49,49,0,1,0
12,344,344,74,43,31,2,1
8,363,363,22,13,9,4,3
19,367,367,5,2,3,2,1
15,393,393,2,2,0,1,0
3,408,408,31,31,0,1,0
5,469,469,1,1,0,1,0
1,469,469,96,81,15,4,3
6,471,471,42,42,0,1,0
18,481,481,104,13,91,4,3
2,490,490,1,1,0,1,0
13,492,492,137,137,0,1,0
11,496,496,39,27,12,3,2
7,500,500,20,12,8,3,2

15,110,110,5,5,0,1,0
4,118,118,23,23,0,1,0
11,135,135,1,1,0,1,0
16,143,143,11,5,6,2,1
8,181,181,19,19,0,1,0
14,205,205,22,5,17,4,3
10,273,273,10,10,0,1,0
12,287,287,93,93,0,1,0
3,303,303,39,9,30,3,2
1,319,319,26,20,6,3,2
2,355,355,28,28,0,1,0
5,361,361,24,18,6,2,1
7,386,386,99,36,63,4,3
13,399,399,55,45,10,3,2
0,449,449,26,26,0,1,0
9,452,452,38,24,14,2,1
6,490,490,18,18,0,1,0

3,129,129,3,3,0,1,0
16,156,156,24,24,0,1,0
15,193,193,13,7,6,2,1
6,201,201,1,1,0,1,0
18,218,218,15,11,4,2,1
10,219,219,26,26,0,1,0
8,228,228,3,3,0,1,0
19,235,235,36,36,0,1,0
5,245,245,53,14,39,2,1
7,247,247,5,5,0,1,0
4,259,259,83,75,8,3,2
20,265,265,21,21,0,1,0
12,272,272,39,9,30,2,1
1,312,312,7,7,0,1,0
0,321,321,30,13,17,3,2
13,353,353,20,20,0,1,0
17,378,378,45,9,36,4,3
11,403,403,6,6,0,1,0
2,408,408,5,5,0,1,0
14,438,438,33,15,18,4,3
9,460,460,19,10,9,2,1

5,116,116,7,1,6,2,1
10,122,122,9,9,0,1,0
4,209,209,45,45,0,1,0
18,222,222,10,10,0,1,0
1,229,229,4,1,3,2,1
11,243,243,58,58,0,1,0
13,246,246,13,4,9,2,1
6,284,284,18,18,0,1,0
19,285,285,10,4,6,2,1
9,288,288,2,2,0,1,0
0,311,311,28,28,0,1,0
15,378,378,22,1,21,4,3
2,412,412,9,9,0,1,0
16,431,431,139,37,102,4,3
3,444,444,7,7,0,1,0
17,446,446,16,16,0,1,0
7,473,473,83,77,6,2,1
12,475,475,59,59,0,1,0
8,480,480,78,8,70,3,2
14,489,489,2,2,0,1,0

6,101,101,16,16,0,1,0
11,114,114,1,1,0,1,0
3,134,134,8,8,0,1,0
10,144,144,11,11,0,1,0
8,161,161,12,12,0,1,0
9,178,178,5,5,0,1,0
1,247,247,58,51,7,2,1
18,259,259,35,35,0,1,0
5,304,304,7,7,0,1,0
2,310,310,12,12,0,1,0
13,340,340,26,2,24,3,2
12,346,346,9,9,0,1,0
0,355,355,24,24,0,1,0
14,404,404,20,20,0,1,0
7,444,444,54,54,0,1,0
19,462,462,8,8,0,1,0
15,469,469,236,236,0,1,0
17,476,476,40,40,0,1,0
16,488,488,7,7,0,1,0
4,500,500,10,10,0,1,0

15,113,113,32,20,12,2,1
11,127,127,7,3,4,2,1
17,130,130,9,9,0,1,0
18,135,135,24,13,11,2,1
14,146,146,29,8,21,2,1
19,151,151,4,4,0,1,0
2,164,164,10,10,0,1,0
6,188,188,8,2,6,3,2
13,226,226,1,1,0,1,0
5,230,230,7,7,0,1,0
20,251,251,2,2,0,1,0
12,259,259,1,1,0,1,0
9,269,269,39,15,24,2,1
22,300,300,4,4,0,1,0
21,309,309,74,74,0,1,0
10,321,321,1,1,0,1,0
3,341,341,80,5,75,4,3
1,350,350,19,19,0,1,0
7,380,380,5,5,0,1,0
0,399,399,11,3,8,2,1
4,417,417,3,3,0,1,0
8,439,439,9,1,8,3,2
16,448,448,15,9,6,3,2
23,452,452,33,13,20,3,2

0,110,110,6,6,0,1,0
8,126,126,9,5,4,2,1
11,152,152,14,14,0,1,0
1,183,183,16,16,0,1,0
6,192,192,18,9,9,2,1
12,194,194,16,16,0,1,0
13,200,200,23,5,18,4,3
5,232,232,25,25,0,1,0
7,333,333,48,48,0,1,0
4,338,338,12,3,9,3,2
16,347,347,3,3,0,1,0
10,424,424,151,151,0,1,0
9,433,433,47,47,0,1,0
15,452,452,6,6,0,1,0
14,465,465,32,23,9,4,3
2,490,490,115,100,15,2,1
3,497,497,71,8,63,4,3

8,120,120,22,4,18,4,3
7,131,131,14,14,0,1,0
13,154,154,5,5,0,1,0
9,159,159,22,22,0,1,0
1,219,219,31,5,26,3,2
12,238,238,10,10,0,1,0
14,245,245,75,9,66,4,3
15,261,261,8,8,0,1,0
11,328,328,20,20,0,1,0
4,373,373,26,26,0,1,0
6,398,398,25,25,0,1,0
10,420,420,12,1,11,4,3
2,441,441,78,45,33,2,1
3,487,487,94,94,0,1,0
5,491,491,82,82,0,1,0
0,500,500,45,2,43,2,1

12,111,111,7,7,0,1,0
8,176,176,13,13,0,1,0
14,180,180,40,20,20,2,1
13,230,230,9,9,0,1,0
3,244,244,88,77,11,2,1
9,303,303,71,47,24,2,1
1,319,319,37,37,0,1,0
7,320,320,2,2,0,1,0
4,324,324,74,74,0,1,0
11,365,365,36,4,32,3,2
5,422,422,40,40,0,1,0
0,428,428,28,3,25,3,2
10,430,430,2,2,0,1,0
6,491,491,84,84,0,1,0
2,499,499,18,18,0,1,0

19,106,106,6,6,0,1,0
2,112,112,11,11,0,1,0
1,114,114,5,5,0,1,0
8,171,171,5,5,0,1,0
3,173,173,12,2,10,2,1
14,175,175,22,22,0,1,0
20,179,179,13,1,12,3,2
4,202,202,13,4,9,4,3
7,215,215,14,14,0,1,0
5,223,223,8,8,0,1,0
9,232,232,6,6,0,1,0
16,277,277,7,7,0,1,0
12,288,288,48,32,16,3,2
11,290,290,1,1,0,1,0
6,298,298,1,1,0,1,0
17,322,322,15,3,12,4,3
18,327,327,28,10,18,2,1
13,440,440,3,3,0,1,0
15,454,454,180,143,37,2,1
21,464,464,46,20,26,3,2
10,464,464,136,136,0,1,0
0,493,493,2,2,0,1,0

17,113,113,4,4,0,1,0
8,119,119,20,20,0,1,0
13,165,165,26,20,6,3,2
1,172,172,1,1,0,1,0
16,194,194,21,21,0,1,0
6,244,244,2,2,0,1,0
5,278,278,16,16,0,1,0
4,281,281,4,1,3,2,1
2,307,307,21,3,18,2,1
3,336,336,22,10,12,3,2
12,347,347,6,6,0,1,0
19,358,358,12,12,0,1,0
9,361,361,68,24,44,3,2
11,365,365,9,9,0,1,0
15,376,376,126,113,13,4,3
18,392,392,40,40,0,1,0
0,401,401,9,3,6,2,1
7,451,451,102,6,96,4,3
10,455,455,35,35,0,1,0
14,462,462,48,48,0,1,0

11,111,111,16,16,0,1,0
4,190,190,46,46,0,1,0
7,234,234,34,34,0,1,0
1,240,240,61,61,0,1,0
3,280,280,91,75,16,2,1
6,288,288,62,20,42,4,3
12,289,289,20,20,0,1,0
0,310,310,10,10,0,1,0
9,365,365,69,69,0,1,0
8,375,375,3,3,0,1,0
13,377,377,27,12,15,2,1
5,387,387,5,5,0,1,0
2,406,406,14,14,0,1,0
10,415,415,13,7,6,3,2
14,476,476,19,1,18,3,2

4,155,155,9,9,0,1,0
7,156,156,2,2,0,1,0
16,167,167,39,9,30,4,3
2,171,171,28,28,0,1,0
15,193,193,28,28,0,1,0
11,217,217,6,6,0,1,0
14,249,249,20,11,9,4,3
13,265,265,39,33,6,2,1
9,272,272,38,38,0,1,0
3,291,291,11,11,0,1,0
18,292,292,22,22,0,1,0
19,305,305,37,37,0,1,0
1,336,336,15,10,5,2,1
8,355,355,72,2,70,3,2
10,387,387,4,4,0,1,0
0,423,423,4,4,0,1,0
6,440,440,67,67,0,1,0
12,451,451,32,24,8,2,1
17,454,454,7,7,0,1,0
5,482,482,34,34,0,1,0

3,132,132,5,5,0,1,0
11,132,132,14,14,0,1,0
19,154,154,9,9,0,1,0
5,198,198,33,33,0,1,0
6,224,224,1,1,0,1,0
0,227,227,14,14,0,1,0
13,232,232,27,15,12,4,3
20,240,240,3,3,0,1,0
2,251,251,10,10,0,1,0
17,294,294,30,7,23,2,1
1,300,300,46,1,45,2,1
15,320,320,52,52,0,1,0
9,334,334,17,17,0,1,0
10,344,344,18,8,10,3,2
4,372,372,6,2,4,2,1
14,384,384,49,49,0,1,0
8,422,422,44,44,0,1,0
18,425,425,36,36,0,1,0
21,427,427,84,65,19,2,1
7,432,432,39,21,18,2,1
16,452,452,22,4,18,2,1
12,474,474,8,8,0,1,0

10,145,145,1,1,0,1,0
1,171,171,4,4,0,1,0
6,182,182,4,4,0,1,0
13,182,182,10,4,6,3,2
4,201,201,29,29,0,1,0
14,222,222,5,5,0,1,0
15,227,227,32,6,26,4,3
5,286,286,19,19,0,1,0
11,288,288,4,4,0,1,0
9,292,292,60,20,40,2,1
0,310,310,65,34,31,2,1
2,412,412,15,3,12,4,3
3,429,429,172,118,54,4,3
7,436,436,132,85,47,2,1
8,450,450,17,17,0,1,0
12,457,457,60,24,36,3,2

6,180,180,18,18,0,1,0
5,185,185,3,3,0,1,0
7,223,223,5,5,0,1,0
1,263,263,17,7,10,3,2
0,266,266,80,80,0,1,0
8,290,290,42,18,24,3,2
4,312,312,54,29,25,2,1
2,369,369,114,41,73,4,3
10,383,383,40,8,32,3,2
12,409,409,67,34,33,2,1
11,418,418,138,108,30,4,3
3,430,430,23,23,0,1,0
13,436,436,5,5,0,1,0
9,483,483,10,10,0,1,0

3,123,123,3,3,0,1,0
9,135,135,10,10,0,1,0
10,155,155,25,25,0,1,0
5,192,192,1,1,0,1,0
15,225,225,14,9,5,2,1
13,256,256,1,1,0,1,0
12,287,287,20,10,10,2,1
8,298,298,4,4,0,1,0
1,332,332,193,145,48,4,3
14,332,332,40,15,25,2,1
6,365,365,37,16,21,4,3
11,371,371,111,60,51,4,3
2,404,404,15,15,0,1,0
4,419,419,42,42,0,1,0
7,445,445,50,50,0,1,0
0,492,492,25,4,21,2,1

13,102,102,12,12,0,1,0
2,111,111,7,7,0,1,0
4,169,169,16,16,0,1,0
10,171,171,24,10,14,3,2
0,184,184,9,9,0,1,0
16,229,229,8,1,7,2,1
15,239,239,2,2,0,1,0
3,250,250,17,17,0,1,0
8,284,284,12,12,0,1,0
7,299,299,5,2,3,2,1
5,302,302,19,19,0,1,0
6,332,332,83,83,0,1,0
14,365,365,90,90,0,1,0
17,369,369,100,79,21,4,3
12,382,382,2,2,0,1,0
1,440,440,112,26,86,4,3
9,495,495,23,23,0,1,0
11,497,497,23,3,20,2,1

16,100,100,3,3,0,1,0
7,227,227,40,7,33,4,3
8,247,247,11,3,8,3,2
12,266,266,43,21,22,2,1
0,272,272,1,1,0,1,0
2,308,308,36,36,0,1,0
6,336,336,10,10,0,1,0
15,344,344,17,2,15,4,3
3,360,360,5,5,0,1,0
14,372,372,84,69,15,4,3
13,373,373,19,7,12,4,3
1,380,380,28,28,0,1,0
9,382,382,78,36,42,2,1
10,416,416,22,22,0,1,0
19,425,425,62,29,33,2,1
17,456,456,95,77,18,4,3
4,466,466,12,1,11,2,1
5,467,467,75,12,63,4,3
11,483,483,14,1,13,2,1
18,498,498,5,5,0,1,0

23,105,105,17,17,0,1,0
18,160,160,12,12,0,1,0
13,171,171,6,1,5,2,1
8,177,177,7,7,0,1,0
6,204,204,5,5,0,1,0
4,220,220,5,5,0,1,0
0,239,239,32,11,21,4,3
7,269,269,36,36,0,1,0
16,286,286,11,11,0,1,0
22,293,293,19,19,0,1,0
5,305,305,16,16,0,1,0
14,307,307,1,1,0,1,0
9,325,325,23,7,16,3,2
1,337,337,35,21,14,2,1
3,337,337,52,52,0,1,0
11,340,340,1,1,0,1,0
10,373,373,36,12,24,4,3
21,416,416,80,80,0,1,0
20,431,431,33,3,30,4,3
17,453,453,23,7,16,3,2
19,479,479,73,61,12,4,3
12,489,489,5,5,0,1,0
15,494,494,51,36,15,2,1
2,495,495,8,5,3,2,1

9,121,121,24,9,15,3,2
14,135,135,8,3,5,2,1
13,154,154,19,8,11,2,1
1,180,180,28,16,12,2,1
2,185,185,7,7,0,1,0
6,235,235,1,1,0,1,0
4,239,239,33,27,6,3,2
7,263,263,14,2,12,3,2
8,280,280,5,5,0,1,0
0,314,314,35,8,27,4,3
10,361,361,5,5,0,1,0
3,386,386,50,15,35,2,1
5,389,389,127,82,45,4,3
12,411,411,2,2,0,1,0
11,447,447,177,117,60,3,2
15,459,459,22,22,0,1,0

8,100,100,5,5,0,1,0
17,121,121,37,20,17,3,2
15,124,124,6,6,0,1,0
0,140,140,2,2,0,1,0
19,146,146,3,3,0,1,0
1,187,187,8,8,0,1,0
21,225,225,18,18,0,1,0
12,225,225,1,1,0,1,0
4,230,230,16,16,0,1,0
5,239,239,4,4,0,1,0
2,257,257,47,47,0,1,0
9,281,281,11,11,0,1,0
14,334,334,2,2,0,1,0
11,362,362,108,44,64,3,2
20,386,386,54,14,40,4,3
16,394,394,13,10,3,2,1
18,405,405,9,2,7,2,1
7,434,434,27,27,0,1,0
6,451,451,13,5,8,2,1
13,451,451,117,36,81,4,3
10,470,470,10,5,5,2,1
3,498,498,36,36,0,1,0

19,101,101,1,1,0,1,0
6,106,106,8,8,0,1,0
13,108,108,1,1,0,1,0
21,130,130,20,20,0,1,0
7,156,156,5,5,0,1,0
8,211,211,31,31,0,1,0
23,225,225,32,21,11,2,1
18,230,230,37,12,25,2,1
0,260,260,37,37,0,1,0
2,272,272,1,1,0,1,0
5,274,274,25,25,0,1,0
15,285,285,4,4,0,1,0
14,317,317,32,32,0,1,0
16,329,329,40,40,0,1,0
4,373,373,23,23,0,1,0
9,383,383,14,14,0,1,0
12,387,387,15,8,7,2,1
20,392,392,52,52,0,1,0
10,417,417,4,4,0,1,0
17,431,431,51,51,0,1,0
11,442,442,9,9,0,1,0
3,445,445,13,13,0,1,0
1,464,464,41,41,0,1,0
22,480,480,16,16,0,1,0
24,490,490,24,24,0,1,0

5,111,111,4,4,0,1,0
1,121,121,26,12,14,3,2
6,150,150,6,6,0,1,0
18,255,255,14,14,0,1,0
9,261,261,10,10,0,1,0
11,267,267,5,1,4,2,1
17,298,298,15,8,7,2,1
2,300,300,7,7,0,1,0
15,311,311,18,18,0,1,0
12,321,321,45,27,18,3,2
20,336,336,21,21,0,1,0
10,345,345,40,40,0,1,0
3,355,355,27,23,4,2,1
13,370,370,61,61,0,1,0
16,397,397,5,5,0,1,0
4,415,415,6,6,0,1,0
0,415,415,54,54,0,1,0
14,446,446,114,86,28,3,2
19,455,455,51,51,0,1,0
7,474,474,83,9,74,3,2
8,489,489,10,10,0,1,0

17,178,178,25,21,4,2,1
3,186,186,9,6,3,2,1
15,199,199,34,19,15,2,1
19,263,263,22,22,0,1,0
10,281,281,34,34,0,1,0
6,292,292,8,4,4,2,1
13,317,317,8,3,5,2,1
4,332,332,4,4,0,1,0
18,355,355,14,14,0,1,0
12,355,355,21,6,15,2,1
2,357,357,16,16,0,1,0
11,367,367,40,20,20,3,2
0,368,368,1,1,0,1,0
9,378,378,52,26,26,2,1
5,400,400,47,47,0,1,0
20,437,437,50,50,0,1,0
14,453,453,16,10,6,3,2
1,453,453,70,39,31,3,2
8,469,469,25,25,0,1,0
7,473,473,35,35,0,1,0
16,485,485,121,43,78,4,3

11,140,140,18,15,3,2,1
14,143,143,3,3,0,1,0
9,164,164,1,1,0,1,0
4,166,166,14,14,0,1,0
10,192,192,23,23,0,1,0
12,227,227,2,2,0,1,0
18,229,229,31,31,0,1,0
15,251,251,29,18,11,2,1
1,282,282,2,2,0,1,0
2,310,310,9,4,5,2,1
16,318,318,50,19,31,2,1
7,335,335,7,7,0,1,0
17,348,348,91,37,54,3,2
8,362,362,52,52,0,1,0
6,362,362,13,3,10,2,1
13,382,382,19,11,8,2,1
3,393,393,85,85,0,1,0
20,446,446,26,17,9,4,3
19,473,473,50,13,37,4,3
0,477,477,42,16,26,2,1
5,490,490,13,5,8,3,2

21,142,142,25,25,0,1,0
1,178,178,4,4,0,1,0
16,187,187,10,10,0,1,0
13,207,207,2,2,0,1,0
14,218,218,52,15,37,2,1
19,222,222,5,5,0,1,0
9,224,224,16,7,9,4,3
8,225,225,3,3,0,1,0
12,226,226,23,17,6,2,1
15,229,229,8,8,0,1,0
0,252,252,3,3,0,1,0
7,252,252,12,1,11,3,2
6,333,333,4,4,0,1,0
20,337,337,31,31,0,1,0
4,345,345,85,60,25,3,2
5,356,356,34,34,0,1,0
3,379,379,54,54,0,1,0
17,380,380,12,12,0,1,0
10,443,443,53,53,0,1,0
11,465,465,1,1,0,1,0
2,469,469,7,1,6,3,2
18,493,493,127,28,99,4,3

15,156,156,14,14,0,1,0
0,190,190,54,54,0,1,0
2,191,191,39,6,33,2,1
5,193,193,24,24,0,1,0
12,199,199,4,4,0,1,0
11,229,229,34,34,0,1,0
16,241,241,15,11,4,2,1
10,289,289,78,34,44,3,2
8,310,310,17,17,0,1,0
14,333,333,59,32,27,2,1
7,353,353,22,22,0,1,0
9,358,358,1,1,0,1,0
6,362,362,39,31,8,3,2
3,365,365,11,1,10,3,2
13,415,415,37,33,4,2,1
4,485,485,21,2,19,2,1
1,494,494,22,6,16,3,2

12,150,150,65,49,16,4,3
13,203,203,3,3,0,1,0
1,246,246,22,22,0,1,0
8,290,290,10,10,0,1,0
4,347,347,82,73,9,4,3
5,358,358,11,11,0,1,0
11,359,359,50,50,0,1,0
7,379,379,25,9,16,2,1
2,395,395,139,25,114,4,3
6,431,431,42,10,32,2,1
3,435,435,11,11,0,1,0
0,441,441,88,88,0,1,0
10,447,447,25,10,15,3,2
9,499,499,23,23,0,1,0

9,107,107,19,1,18,3,2
5,119,119,7,1,6,3,2
12,136,136,11,11,0,1,0
7,174,174,8,8,0,1,0
3,215,215,6,6,0,1,0
14,246,246,7,3,4,2,1
8,261,261,58,58,0,1,0
13,261,261,39,39,0,1,0
0,282,282,18,6,12,4,3
18,312,312,19,16,3,2,1
2,313,313,9,9,0,1,0
15,345,345,5,5,0,1,0
4,394,394,27,17,10,2,1
6,397,397,7,7,0,1,0
10,402,402,13,13,0,1,0
17,438,438,48,3,45,4,3
1,447,447,71,71,0,1,0
19,462,462,17,17,0,1,0
11,496,496,130,130,0,1,0
16,500,500,87,59,28,2,1

4,123,123,21,21,0,1,0
17,162,162,11,11,0,1,0
19,165,165,16,10,6,2,1
14,171,171,19,8,11,2,1
0,181,181,13,13,0,1,0
13,212,212,27,24,3,2,1
5,236,236,6,1,5,2,1
15,245,245,27,8,19,3,2
6,303,303,33,24,9,4,3
18,317,317,50,50,0,1,0
10,329,329,23,2,21,2,1
12,354,354,73,73,0,1,0
1,384,384,83,59,24,3,2
8,400,400,21,7,14,3,2
9,410,410,29,29,0,1,0
2,420,420,16,1,15,4,3
16,427,427,7,3,4,2,1
3,445,445,22,7,15,2,1
11,474,474,11,11,0,1,0
7,485,485,14,14,0,1,0

1,128,128,20,20,0,1,0
15,171,171,30,27,3,2,1
3,178,178,8,1,7,2,1
5,196,196,31,31,0,1,0
13,208,208,12,2,10,3,2
10,216,216,23,23,0,1,0
11,247,247,21,5,16,4,3
6,256,256,16,16,0,1,0
9,374,374,69,69,0,1,0
7,391,391,5,5,0,1,0
14,399,399,10,2,8,3,2
2,403,403,175,107,68,3,2
4,441,441,10,10,0,1,0
8,481,481,8,8,0,1,0
12,481,481,122,71,51,4,3
0,493,493,11,11,0,1,0

8,111,111,4,4,0,1,0
6,151,151,31,31,0,1,0
11,151,151,17,17,0,1,0
9,220,220,22,17,5,2,1
7,230,230,7,7,0,1,0
13,234,234,6,6,0,1,0
2,309,309,6,1,5,2,1
0,330,330,109,109,0,1,0
12,358,358,59,47,12,4,3
4,368,368,34,16,18,4,3
3,392,392,140,74,66,4,3
1,446,446,45,45,0,1,0
5,447,447,30,1,29,2,1
10,453,453,85,85,0,1,0

21,102,102,48,48,0,1,0
8,122,122,3,3,0,1,0
14,156,156,5,5,0,1,0
6,159,159,5,5,0,1,0
7,181,181,10,10,0,1,0
1,183,183,44,26,18,3,2
17,188,188,16,2,14,4,3
20,223,223,9,5,4,2,1
12,307,307,51,37,14,2,1
18,321,321,25,25,0,1,0
4,338,338,4,4,0,1,0
0,344,344,1,1,0,1,0
5,366,366,34,16,18,4,3
2,402,402,28,18,10,2,1
16,435,435,26,26,0,1,0
10,446,446,28,28,0,1,0
11,450,450,38,6,32,3,2
9,461,461,14,6,8,3,2
15,473,473,30,30,0,1,0
3,477,477,14,14,0,1,0
19,479,479,19,4,15,3,2
13,498,498,26,26,0,1,0

0,131,131,11,11,0,1,0
4,150,150,12,12,0,1,0
13,158,158,9,9,0,1,0
14,166,166,30,30,0,1,0
10,169,169,3,3,0,1,0
18,215,215,4,4,0,1,0
5,233,233,13,13,0,1,0
2,279,279,19,13,6,2,1
21,291,291,25,25,0,1,0
16,294,294,16,16,0,1,0
9,298,298,24,24,0,1,0
7,313,313,79,79,0,1,0
11,330,330,2,2,0,1,0
8,341,341,6,6,0,1,0
19,346,346,109,61,48,4,3
3,347,347,17,17,0,1,0
17,365,365,20,20,0,1,0
15,382,382,45,45,0,1,0
1,435,435,1,1,0,1,0
6,468,468,2,2,0,1,0
12,468,468,86,86,0,1,0
20,485,485,17,4,13,2,1

9,103,103,12,9,3,2,1
13,111,111,1,1,0,1,0
11,122,122,7,7,0,1,0
5,151,151,17,17,0,1,0
8,183,183,2,2,0,1,0
15,205,205,4,4,0,1,0
16,229,229,77,77,0,1,0
2,248,248,1,1,0,1,0
1,266,266,18,1,17,2,1
0,286,286,14,8,6,2,1
3,319,319,82,82,0,1,0
7,347,347,9,6,3,2,1
10,383,383,37,37,0,1,0
12,386,386,53,11,42,2,1
14,399,399,54,54,0,1,0
6,451,451,46,46,0,1,0
4,483,483,137,137,0,1,0

9,102,102,3,3,0,1,0
1,135,135,4,4,0,1,0
18,217,217,8,8,0,1,0
15,222,222,20,20,0,1,0
3,244,244,8,8,0,1,0
4,246,246,52,52,0,1,0
2,250,250,13,13,0,1,0
17,262,262,31,3,28,2,1
13,264,264,27,27,0,1,0
5,289,289,3,3,0,1,0
19,313,313,43,30,13,2,1
7,373,373,7,7,0,1,0
14,407,407,10,4,6,3,2
11,412,412,70,18,52,3,2
10,429,429,9,9,0,1,0
6,454,454,83,83,0,1,0
8,462,462,83,83,0,1,0
16,467,467,91,60,31,4,3
0,476,476,64,50,14,2,1
12,485,485,20,14,6,3,2

12,100,100,3,3,0,1,0
0,142,142,6,1,5,2,1
13,186,186,3,3,0,1,0
9,196,196,20,20,0,1,0
10,203,203,20,2,18,3,2
19,255,255,103,103,0,1,0
3,260,260,7,3,4,2,1
8,277,277,8,8,0,1,0
1,291,291,14,14,0,1,0
15,300,300,18,6,12,2,1
14,318,318,9,9,0,1,0
6,321,321,45,45,0,1,0
7,324,324,8,2,6,2,1
16,330,330,38,20,18,4,3
20,352,352,46,14,32,3,2
11,383,383,28,10,18,3,2
2,392,392,37,1,36,3,2
18,394,394,17,1,16,3,2
4,431,431,63,19,44,2,1
5,447,447,34,34,0,1,0
17,478,478,45,45,0,1,0

3,101,101,1,1,0,1,0
12,131,131,17,17,0,1,0
19,135,135,4,4,0,1,0
10,143,143,3,3,0,1,0
22,155,155,1,1,0,1,0
5,160,160,7,1,6,2,1
14,215,215,14,6,8,2,1
17,233,233,16,4,12,4,3
18,243,243,74,41,33,4,3
20,261,261,7,3,4,2,1
11,263,263,3,3,0,1,0
6,263,263,19,19,0,1,0
9,264,264,6,6,0,1,0
7,280,280,14,14,0,1,0
21,295,295,16,8,8,2,1
1,302,302,39,39,0,1,0
16,308,308,77,77,0,1,0
15,331,331,48,48,0,1,0
23,390,390,13,13,0,1,0
8,429,429,11,11,0,1,0
4,454,454,1,1,0,1,0
0,454,454,1,1,0,1,0
13,461,461,116,34,82,4,3
2,483,483,32,6,26,2,1

7,101,101,20,10,10,4,3
17,123,123,4,1,3,2,1
0,124,124,13,7,6,3,2
16,131,131,4,4,0,1,0
9,132,132,6,6,0,1,0
13,166,166,8,8,0,1,0
5,178,178,16,1,15,4,3
15,242,242,9,4,5,2,1
10,245,245,19,19,0,1,0
8,249,249,7,7,0,1,0
4,284,284,48,41,7,2,1
11,304,304,9,9,0,1,0
2,388,388,1,1,0,1,0
20,415,415,132,57,75,4,3
18,419,419,16,16,0,1,0
6,419,419,34,6,28,3,2
3,435,435,10,10,0,1,0
14,441,441,42,4,38,3,2
19,444,444,60,60,0,1,0
1,449,449,23,14,9,2,1
12,494,494,90,90,0,1,0

13,100,100,6,6,0,1,0
19,121,121,3,3,0,1,0
6,126,126,4,1,3,2,1
10,154,154,1,1,0,1,0
12,175,175,37,37,0,1,0
2,181,181,1,1,0,1,0
11,203,203,14,14,0,1,0
1,251,251,1,1,0,1,0
0,255,255,9,9,0,1,0
16,266,266,24,3,21,2,1
17,289,289,26,3,23,2,1
8,304,304,19,19,0,1,0
7,362,362,105,6,99,4,3
4,373,373,43,43,0,1,0
9,373,373,10,10,0,1,0
15,410,410,54,6,48,3,2
3,420,420,15,8,7,2,1
5,458,458,133,67,66,3,2
18,462,462,93,63,30,2,1
14,478,478,13,13,0,1,0

12,112,112,40,40,0,1,0
11,131,131,26,17,9,4,3
7,164,164,5,2,3,2,1
4,166,166,23,23,0,1,0
8,172,172,1,1,0,1,0
9,206,206,25,25,0,1,0
5,267,267,46,5,41,2,1
14,306,306,14,14,0,1,0
10,334,334,7,7,0,1,0
0,339,339,43,25,18,3,2
2,378,378,121,81,40,4,3
13,381,381,3,3,0,1,0
3,388,388,9,1,8,3,2
6,414,414,56,56,0,1,0
1,482,482,58,58,0,1,0

1,107,107,5,5,0,1,0
21,133,133,4,4,0,1,0
18,153,153,5,5,0,1,0
6,161,161,9,3,6,3,2
10,163,163,4,4,0,1,0
17,171,171,13,9,4,2,1
14,174,174,20,20,0,1,0
4,176,176,7,2,5,2,1
0,188,188,9,6,3,2,1
22,216,216,3,3,0,1,0
23,217,217,58,58,0,1,0
3,257,257,23,23,0,1,0
7,332,332,16,4,12,4,3
11,337,337,12,12,0,1,0
16,342,342,12,12,0,1,0
15,405,405,7,7,0,1,0
13,415,415,43,43,0,1,0
8,419,419,13,13,0,1,0
19,420,420,85,85,0,1,0
20,421,421,39,39,0,1,0
24,438,438,77,47,30,4,3
12,458,458,16,16,0,1,0
2,488,488,20,20,0,1,0
5,491,491,18,12,6,2,1
9,500,500,67,67,0,1,0

6,115,115,5,5,0,1,0
17,141,141,4,4,0,1,0
4,150,150,27,27,0,1,0
7,166,166,14,14,0,1,0
5,176,176,35,35,0,1,0
11,210,210,18,18,0,1,0
9,217,217,15,10,5,2,1
10,234,234,26,5,21,4,3
13,239,239,109,36,73,4,3
15,245,245,24,24,0,1,0
1,271,271,18,18,0,1,0
12,272,272,4,4,0,1,0
0,307,307,37,5,32,3,2
14,320,320,1,1,0,1,0
8,393,393,33,27,6,3,2
3,457,457,17,17,0,1,0
2,477,477,41,2,39,2,1
16,498,498,27,27,0,1,0

1,103,103,25,25,0,1,0
8,108,108,1,1,0,1,0
15,113,113,17,3,14,3,2
10,122,122,6,6,0,1,0
6,137,137,14,4,10,2,1
0,147,147,5,2,3,2,1
14,148,148,31,31,0,1,0
7,154,154,21,21,0,1,0
12,177,177,20,20,0,1,0
4,187,187,11,2,9,2,1
17,212,212,4,4,0,1,0
20,217,217,6,6,0,1,0
2,256,256,4,1,3,2,1
16,259,259,16,5,11,2,1
13,290,290,59,24,35,4,3
11,378,378,57,30,27,4,3
19,381,381,28,14,14,3,2
18,397,397,24,24,0,1,0
9,409,409,3,3,0,1,0
5,446,446,42,24,18,2,1
3,478,478,1,1,0,1,0

12,117,117,2,2,0,1,0
8,118,118,12,12,0,1,0
15,142,142,3,3,0,1,0
10,146,146,41,41,0,1,0
5,166,166,35,9,26,3,2
17,174,174,7,4,3,2,1
7,186,186,2,2,0,1,0
14,203,203,14,14,0,1,0
16,257,257,22,10,12,2,1
1,306,306,17,17,0,1,0
2,308,308,20,3,17,2,1
3,329,329,9,9,0,1,0
13,338,338,123,9,114,4,3
9,341,341,8,3,5,2,1
4,376,376,95,95,0,1,0
0,432,432,10,10,0,1,0
6,437,437,67,67,0,1,0
11,442,442,8,8,0,1,0

2,126,126,4,4,0,1,0
20,131,131,15,5,10,2,1
14,149,149,11,11,0,1,0
9,187,187,13,13,0,1,0
17,204,204,3,3,0,1,0
15,207,207,11,11,0,1,0
6,211,211,30,30,0,1,0
19,227,227,19,19,0,1,0
7,227,227,3,3,0,1,0
16,230,230,53,53,0,1,0
11,235,235,7,7,0,1,0
10,237,237,3,3,0,1,0
13,351,351,93,93,0,1,0
4,376,376,36,36,0,1,0
18,395,395,18,2,16,2,1
3,420,420,107,66,41,4,3
1,421,421,46,10,36,4,3
0,421,421,42,42,0,1,0
8,462,462,13,13,0,1,0
12,478,478,19,19,0,1,0
5,499,499,7,4,3,2,1

15,191,191,16,16,0,1,0
16,195,195,48,48,0,1,0
13,232,232,24,24,0,1,0
14,233,233,13,5,8,2,1
1,234,234,12,5,7,2,1
8,238,238,11,11,0,1,0
6,297,297,9,9,0,1,0
10,307,307,16,10,6,2,1
3,317,317,18,18,0,1,0
0,318,318,156,156,0,1,0
2,323,323,44,44,0,1,0
7,325,325,1,1,0,1,0
11,327,327,25,3,22,2,1
9,410,410,7,7,0,1,0
17,436,436,41,41,0,1,0
5,448,448,17,17,0,1,0
18,449,449,51,51,0,1,0
4,453,453,14,14,0,1,0
12,486,486,44,44,0,1,0

15,100,100,8,2,6,3,2
4,121,121,8,8,0,1,0
7,133,133,11,11,0,1,0
3,138,138,8,8,0,1,0
2,143,143,4,4,0,1,0
13,157,157,3,3,0,1,0
23,193,193,17,7,10,2,1
26,208,208,13,13,0,1,0
17,222,222,8,8,0,1,0
11,226,226,1,1,0,1,0
24,305,305,100,100,0,1,0
0,348,348,30,30,0,1,0
8,348,348,20,20,0,1,0
12,366,366,27,9,18,3,2
10,370,370,20,20,0,1,0
6,375,375,65,60,5,2,1
9,397,397,2,2,0,1,0
5,397,397,1,1,0,1,0
21,405,405,7,7,0,1,0
19,413,413,1,1,0,1,0
25,414,414,71,46,25,2,1
16,417,417,15,3,12,3,2
20,419,419,43,43,0,1,0
18,429,429,4,4,0,1,0
22,451,451,61,19,42,4,3
1,458,458,16,16,0,1,0
14,498,498,3,3,0,1,0

1,107,107,1,1,0,1,0
16,111,111,23,23,0,1,0
5,129,129,36,36,0,1,0
17,154,154,24,24,0,1,0
0,168,168,1,1,0,1,0
14,190,190,25,25,0,1,0
4,198,198,15,2,13,2,1
6,200,200,24,24,0,1,0
2,202,202,20,14,6,2,1
9,226,226,16,16,0,1,0
19,254,254,16,1,15,4,3
12,274,274,4,4,0,1,0
20,358,358,24,24,0,1,0
11,413,413,31,31,0,1,0
7,415,415,4,4,0,1,0
15,417,417,33,33,0,1,0
13,440,440,21,21,0,1,0
18,466,466,69,34,35,4,3
8,480,480,59,17,42,3,2
3,489,489,7,2,5,2,1
10,490,490,9,9,0,1,0

0,103,103,1,1,0,1,0
23,106,106,1,1,0,1,0
16,110,110,10,6,4,2,1
19,111,111,11,7,4,2,1
14,119,119,1,1,0,1,0
2,129,129,15,4,11,4,3
9,160,160,8,8,0,1,0
15,168,168,6,6,0,1,0
22,172,172,15,15,0,1,0
5,173,173,3,3,0,1,0
21,174,174,5,5,0,1,0
24,210,210,8,8,0,1,0
18,239,239,11,11,0,1,0
8,245,245,11,11,0,1,0
4,253,253,6,6,0,1,0
17,285,285,53,19,34,2,1
1,297,297,17,17,0,1,0
6,314,314,66,62,4,2,1
20,361,361,127,78,49,2,1
12,367,367,29,29,0,1,0
11,413,413,10,10,0,1,0
3,414,414,20,20,0,1,0
13,423,423,47,47,0,1,0
10,424,424,24,16,8,2,1
7,461,461,4,4,0,1,0

5,142,142,3,3,0,1,0
0,155,155,38,26,12,4,3
9,164,164,7,7,0,1,0
8,199,199,17,5,12,2,1
3,226,226,27,27,0,1,0
6,226,226,45,45,0,1,0
2,263,263,2,2,0,1,0
7,284,284,2,2,0,1,0
1,311,311,25,25,0,1,0
4,320,320,74,74,0,1,0
10,347,347,38,38,0,1,0
11,411,411,72,72,0,1,0
13,442,442,38,24,14,3,2
15,443,443,1,1,0,1,0
12,476,476,48,19,29,2,1
14,492,492,150,111,39,4,3

7,155,155,4,1,3,2,1
8,156,156,10,7,3,2,1
6,195,195,6,6,0,1,0
12,224,224,13,13,0,1,0
5,250,250,58,58,0,1,0
14,253,253,10,5,5,2,1
1,293,293,18,12,6,3,2
11,314,314,24,24,0,1,0
15,326,326,68,68,0,1,0
3,331,331,67,67,0,1,0
2,354,354,1,1,0,1,0
13,361,361,64,44,20,2,1
0,403,403,55,35,20,2,1
4,407,407,97,88,9,2,1
9,418,418,17,3,14,2,1
10,430,430,99,63,36,4,3

11,113,113,1,1,0,1,0
0,132,132,34,34,0,1,0
13,132,132,26,10,16,3,2
2,170,170,23,1,22,2,1
14,200,200,7,2,5,2,1
12,211,211,38,11,27,2,1
5,216,216,42,9,33,4,3
1,218,218,12,12,0,1,0
16,269,269,26,26,0,1,0
9,299,299,26,26,0,1,0
3,325,325,22,22,0,1,0
6,336,336,3,3,0,1,0
10,397,397,20,20,0,1,0
8,400,400,48,17,31,2,1
15,422,422,60,60,0,1,0
4,482,482,41,13,28,2,1
7,490,490,48,48,0,1,0

16,109,109,48,48,0,1,0
1,147,147,18,18,0,1,0
9,154,154,43,43,0,1,0
5,163,163,1,1,0,1,0
14,198,198,9,2,7,3,2
11,229,229,8,3,5,2,1
8,276,276,6,6,0,1,0
6,293,293,22,22,0,1,0
13,295,295,17,17,0,1,0
3,307,307,15,15,0,1,0
10,337,337,31,18,13,3,2
0,349,349,76,26,50,3,2
18,350,350,2,2,0,1,0
4,373,373,20,11,9,2,1
17,407,407,36,36,0,1,0
15,414,414,17,12,5,2,1
2,414,414,6,6,0,1,0
12,431,431,50,50,0,1,0
7,479,479,31,31,0,1,0

6,122,122,7,1,6,3,2
21,127,127,7,7,0,1,0
9,153,153,12,12,0,1,0
7,156,156,7,7,0,1,0
22,163,163,10,10,0,1,0
2,170,170,6,6,0,1,0
18,177,177,23,5,18,4,3
14,185,185,7,7,0,1,0
3,196,196,44,34,10,2,1
11,247,247,12,2,10,3,2
17,247,247,7,7,0,1,0
20,258,258,26,14,12,3,2
1,266,266,25,10,15,2,1
15,290,290,131,92,39,2,1
19,300,300,7,7,0,1,0
5,337,337,44,8,36,4,3
10,373,373,5,5,0,1,0
8,379,379,2,2,0,1,0
13,393,393,8,8,0,1,0
16,400,400,11,11,0,1,0
4,403,403,1,1,0,1,0
0,450,450,35,35,0,1,0
12,474,474,32,8,24,4,3

18,116,116,14,14,0,1,0
1,124,124,8,8,0,1,0
20,125,125,1,1,0,1,0
5,150,150,24,24,0,1,0
24,156,156,7,7,0,1,0
23,197,197,49,49,0,1,0
4,240,240,13,13,0,1,0
16,274,274,12,12,0,1,0
7,274,274,1,1,0,1,0
9,288,288,24,12,12,2,1
2,289,289,5,5,0,1,0
11,290,290,10,10,0,1,0
17,296,296,36,36,0,1,0
3,319,319,23,4,19,4,3
13,321,321,11,11,0,1,0
21,324,324,1,1,0,1,0
19,327,327,6,1,5,2,1
10,335,335,14,5,9,2,1
22,350,350,3,3,0,1,0
26,375,375,49,29,20,3,2
25,377,377,123,123,0,1,0
8,385,385,8,8,0,1,0
0,403,403,9,9,0,1,0
12,423,423,16,16,0,1,0
6,428,428,1,1,0,1,0
15,440,440,28,28,0,1,0
14,473,473,11,11,0,1,0

19,165,165,7,7,0,1,0
2,175,175,6,6,0,1,0
1,175,175,3,3,0,1,0
18,220,220,41,41,0,1,0
9,227,227,16,16,0,1,0
3,228,228,12,12,0,1,0
0,247,247,1,1,0,1,0
22,255,255,25,25,0,1,0
5,264,264,14,14,0,1,0
6,289,289,29,29,0,1,0
10,327,327,15,3,12,3,2
8,333,333,1,1,0,1,0
15,348,348,9,9,0,1,0
4,373,373,23,23,0,1,0
21,378,378,12,12,0,1,0
20,405,405,136,25,111,4,3
14,411,411,43,6,37,2,1
12,416,416,118,25,93,4,3
17,430,430,30,30,0,1,0
11,454,454,21,7,14,3,2
7,465,465,53,43,10,2,1
13,487,487,7,3,4,2,1
16,494,494,12,5,7,3,2

11,116,116,5,5,0,1,0
16,122,122,17,17,0,1,0
3,126,126,19,7,12,4,3
13,126,126,6,6,0,1,0
21,149,149,11,11,0,1,0
17,151,151,35,35,0,1,0
20,153,153,1,1,0,1,0
14,166,166,10,10,0,1,0
4,185,185,3,3,0,1,0
6,215,215,1,1,0,1,0
15,217,217,5,1,4,2,1
19,242,242,26,5,21,2,1
8,243,243,11,11,0,1,0
10,245,245,1,1,0,1,0
7,282,282,34,19,15,4,3
12,348,348,9,9,0,1,0
0,351,351,8,4,4,2,1
5,364,364,7,7,0,1,0
22,371,371,5,5,0,1,0
9,379,379,1,1,0,1,0
1,408,408,15,7,8,3,2
18,441,441,117,117,0,1,0
2,478,478,174,156,18,4,3

9,232,232,8,8,0,1,0
4,321,321,24,24,0,1,0
15,369,369,34,14,20,2,1
5,371,371,23,23,0,1,0
7,374,374,138,138,0,1,0
2,378,378,29,29,0,1,0
11,423,423,13,13,0,1,0
14,436,436,11,11,0,1,0
6,438,438,116,103,13,2,1
12,449,449,68,68,0,1,0
10,453,453,13,13,0,1,0
13,460,460,26,26,0,1,0
1,472,472,63,63,0,1,0
3,482,482,94,1,93,4,3
8,483,483,60,60,0,1,0
0,498,498,47,9,38,2,1

10,105,105,9,9,0,1,0
16,118,118,5,5,0,1,0
14,123,123,17,17,0,1,0
3,168,168,35,35,0,1,0
6,171,171,1,1,0,1,0
8,173,173,9,9,0,1,0
17,179,179,31,31,0,1,0
13,261,261,40,1,39,4,3
1,275,275,3,3,0,1,0
15,278,278,2,2,0,1,0
5,316,316,52,41,11,2,1
12,319,319,45,27,18,4,3
18,324,324,36,36,0,1,0
9,371,371,58,58,0,1,0
0,378,378,70,1,69,3,2
7,382,382,26,26,0,1,0
11,410,410,27,21,6,3,2
4,428,428,2,2,0,1,0
2,495,495,23,23,0,1,0

1,107,107,1,1,0,1,0
4,111,111,7,7,0,1,0
13,120,120,16,16,0,1,0
9,144,144,9,9,0,1,0
0,145,145,12,4,8,3,2
12,153,153,8,8,0,1,0
3,174,174,77,42,35,2,1
11,175,175,7,7,0,1,0
15,218,218,13,1,12,3,2
5,259,259,1,1,0,1,0
14,259,259,46,12,34,2,1
2,284,284,37,7,30,2,1
6,311,311,53,53,0,1,0
10,332,332,36,36,0,1,0
7,410,410,112,112,0,1,0
8,430,430,9,9,0,1,0

6,101,101,4,4,0,1,0
3,107,107,13,13,0,1,0
17,135,135,9,9,0,1,0
7,211,211,90,90,0,1,0
15,223,223,34,2,32,2,1
4,234,234,1,1,0,1,0
1,269,269,14,14,0,1,0
2,284,284,4,4,0,1,0
8,302,302,7,7,0,1,0
14,323,323,30,30,0,1,0
16,345,345,9,9,0,1,0
11,390,390,25,10,15,4,3
10,391,391,92,92,0,1,0
13,433,433,75,33,42,4,3
5,477,477,86,86,0,1,0
9,482,482,48,22,26,3,2
0,489,489,20,15,5,2,1
12,496,496,4,4,0,1,0

4,107,107,4,4,0,1,0
13,124,124,5,5,0,1,0
15,213,213,27,27,0,1,0
3,231,231,15,15,0,1,0
5,244,244,6,3,3,2,1
11,244,244,12,12,0,1,0
2,262,262,1,1,0,1,0
8,274,274,21,5,16,4,3
6,297,297,26,8,18,2,1
0,321,321,64,47,17,2,1
14,335,335,4,4,0,1,0
7,376,376,117,92,25,2,1
17,395,395,76,15,61,3,2
12,401,401,54,18,36,4,3
16,406,406,68,50,18,2,1
9,407,407,44,44,0,1,0
1,424,424,41,41,0,1,0
10,431,431,37,1,36,4,3

4,113,113,3,3,0,1,0
21,138,138,13,5,8,3,2
7,164,164,1,1,0,1,0
9,189,189,4,4,0,1,0
0,227,227,2,2,0,1,0
17,229,229,23,23,0,1,0
14,236,236,16,13,3,2,1
11,253,253,26,17,9,4,3
20,284,284,67,35,32,2,1
10,305,305,26,26,0,1,0
2,321,321,118,1,117,4,3
19,322,322,58,1,57,3,2
13,333,333,2,2,0,1,0
8,343,343,5,5,0,1,0
18,346,346,2,2,0,1,0
12,348,348,21,9,12,4,3
16,412,412,72,18,54,4,3
3,416,416,2,2,0,1,0
15,456,456,4,4,0,1,0
22,465,465,24,24,0,1,0
6,469,469,3,3,0,1,0
1,479,479,72,28,44,3,2
5,481,481,19,19,0,1,0

4,102,102,25,22,3,2,1
0,129,129,13,13,0,1,0
14,144,144,29,29,0,1,0
13,157,157,10,10,0,1,0
11,173,173,15,15,0,1,0
5,201,201,12,12,0,1,0
3,226,226,10,1,9,2,1
17,249,249,7,7,0,1,0
2,303,303,12,5,7,2,1
8,362,362,23,5,18,4,3
10,376,376,6,6,0,1,0
9,383,383,41,18,23,2,1
7,392,392,27,11,16,2,1
15,407,407,91,91,0,1,0
18,412,412,41,41,0,1,0
1,456,456,55,22,33,2,1
12,466,466,86,23,63,4,3
16,466,466,4,4,0,1,0
6,493,493,26,3,23,2,1

1,132,132,41,41,0,1,0
4,137,137,22,22,0,1,0
5,138,138,16,10,6,2,1
13,210,210,18,9,9,2,1
11,215,215,8,2,6,3,2
8,275,275,2,2,0,1,0
0,278,278,31,1,30,2,1
2,319,319,50,50,0,1,0
12,374,374,5,5,0,1,0
9,376,376,53,53,0,1,0
7,377,377,55,11,44,3,2
10,381,381,82,28,54,4,3
14,402,402,9,9,0,1,0
6,433,433,107,94,13,2,1
3,469,469,21,7,14,2,1

7,163,163,23,23,0,1,0
11,189,189,9,9,0,1,0
8,193,193,11,2,9,2,1
4,207,207,20,2,18,3,2
9,250,250,18,10,8,2,1
17,268,268,31,17,14,2,1
12,283,283,31,4,27,2,1
5,313,313,30,6,24,2,1
16,363,363,61,61,0,1,0
1,378,378,40,40,0,1,0
14,385,385,5,5,0,1,0
10,392,392,16,4,12,2,1
6,423,423,1,1,0,1,0
15,426,426,55,1,54,3,2
0,461,461,34,10,24,2,1
13,463,463,15,2,13,3,2
18,481,481,126,4,122,4,3
3,484,484,24,4,20,3,2
2,500,500,104,57,47,2,1

8,105,105,14,2,12,4,3
20,134,134,7,7,0,1,0
10,139,139,7,3,4,2,1
1,183,183,16,16,0,1,0
11,249,249,16,5,11,2,1
13,259,259,29,20,9,4,3
7,275,275,7,7,0,1,0
16,292,292,26,26,0,1,0
0,299,299,15,2,13,3,2
21,305,305,9,3,6,3,2
14,307,307,3,3,0,1,0
15,341,341,28,28,0,1,0
12,345,345,17,17,0,1,0
4,352,352,14,14,0,1,0
2,367,367,2,2,0,1,0
3,367,367,60,27,33,2,1
9,449,449,4,1,3,2,1
19,470,470,75,1,74,3,2
5,470,470,41,41,0,1,0
18,472,472,11,2,9,2,1
6,482,482,12,12,0,1,0
22,487,487,173,139,34,2,1
17,488,488,54,18,36,4,3

7,107,107,1,1,0,1,0
21,148,148,28,4,24,3,2
1,171,171,6,2,4,2,1
11,208,208,12,12,0,1,0
9,213,213,13,13,0,1,0
15,232,232,49,49,0,1,0
16,233,233,6,6,0,1,0
19,235,235,13,13,0,1,0
13,253,253,26,8,18,3,2
6,290,290,2,2,0,1,0
10,296,296,17,10,7,2,1
4,303,303,11,11,0,1,0
14,309,309,19,11,8,2,1
0,347,347,97,97,0,1,0
8,358,358,35,35,0,1,0
18,364,364,2,2,0,1,0
2,392,392,26,3,23,2,1
5,403,403,13,1,12,3,2
17,441,441,62,62,0,1,0
12,448,448,62,62,0,1,0
20,454,454,57,57,0,1,0
3,499,499,12,6,6,3,2

4,120,120,4,4,0,1,0
9,130,130,6,1,5,2,1
5,145,145,17,9,8,2,1
7,152,152,2,2,0,1,0
1,232,232,1,1,0,1,0
16,237,237,3,3,0,1,0
18,246,246,50,2,48,4,3
10,261,261,26,26,0,1,0
11,299,299,20,20,0,1,0
3,302,302,2,2,0,1,0
14,333,333,54,16,38,3,2
0,373,373,79,16,63,4,3
12,374,374,51,24,27,4,3
17,388,388,22,4,18,3,2
2,415,415,45,45,0,1,0
15,426,426,10,3,7,2,1
6,434,434,86,53,33,2,1
8,436,436,71,5,66,3,2
13,497,497,74,12,62,3,2

18,152,152,19,19,0,1,0
10,160,160,6,6,0,1,0
2,165,165,11,11,0,1,0
14,169,169,34,34,0,1,0
19,179,179,1,1,0,1,0
9,203,203,13,7,6,3,2
0,206,206,7,3,4,2,1
12,257,257,2,2,0,1,0
4,295,295,15,15,0,1,0
13,309,309,3,3,0,1,0
5,310,310,16,6,10,2,1
1,322,322,12,12,0,1,0
7,350,350,51,39,12,4,3
8,377,377,69,54,15,4,3
3,381,381,18,18,0,1,0
6,401,401,29,11,18,4,3
21,410,410,17,7,10,2,1
11,425,425,45,1,44,2,1
15,450,450,33,9,24,3,2
16,452,452,161,150,11,2,1
20,489,489,17,17,0,1,0
17,490,490,31,13,18,4,3

9,123,123,1,1,0,1,0
6,131,131,1,1,0,1,0
16,161,161,41,41,0,1,0
3,178,178,84,12,72,4,3
8,182,182,4,4,0,1,0
2,194,194,1,1,0,1,0
19,232,232,10,5,5,2,1
7,281,281,29,29,0,1,0
14,295,295,10,4,6,2,1
18,298,298,52,6,46,2,1
15,317,317,21,21,0,1,0
0,345,345,11,3,8,3,2
17,368,368,43,10,33,4,3
4,374,374,73,23,50,2,1
10,406,406,5,5,0,1,0
5,412,412,6,6,0,1,0
12,429,429,2,2,0,1,0
13,449,449,93,37,56,3,2
11,456,456,9,9,0,1,0
1,499,499,15,15,0,1,0

4,117,117,5,1,4,2,1
15,143,143,19,1,18,3,2
10,162,162,4,4,0,1,0
19,168,168,7,7,0,1,0
22,182,182,2,2,0,1,0
1,199,199,23,3,20,2,1
0,201,201,22,9,13,4,3
7,201,201,35,35,0,1,0
14,239,239,15,15,0,1,0
23,263,263,73,73,0,1,0
2,266,266,1,1,0,1,0
16,295,295,13,1,12,2,1
11,298,298,19,19,0,1,0
5,304,304,23,7,16,2,1
8,309,309,29,29,0,1,0
18,334,334,57,17,40,3,2
13,360,360,2,2,0,1,0
9,362,362,2,2,0,1,0
21,367,367,41,41,0,1,0
12,388,388,39,39,0,1,0
17,440,440,39,39,0,1,0
6,443,443,6,6,0,1,0
20,462,462,19,10,9,2,1
3,467,467,5,2,3,2,1

3,104,104,30,30,0,1,0
15,142,142,33,33,0,1,0
1,160,160,6,2,4,2,1
2,162,162,8,2,6,3,2
9,228,228,17,4,13,2,1
16,249,249,60,60,0,1,0
5,249,249,8,8,0,1,0
11,274,274,10,10,0,1,0
13,305,305,32,14,18,2,1
6,307,307,36,22,14,3,2
7,331,331,28,16,12,4,3
14,342,342,7,3,4,2,1
0,356,356,42,6,36,4,3
10,359,359,30,15,15,4,3
12,362,362,37,37,0,1,0
8,380,380,9,9,0,1,0
4,475,475,83,21,62,3,2

9,180,180,7,2,5,2,1
1,192,192,6,3,3,2,1
11,207,207,37,3,34,2,1
3,215,215,10,1,9,4,3
14,215,215,14,8,6,3,2
4,222,222,19,1,18,4,3
0,279,279,25,4,21,4,3
2,317,317,119,42,77,4,3
5,345,345,14,8,6,2,1
10,361,361,14,14,0,1,0
8,373,373,57,14,43,3,2
7,391,391,43,43,0,1,0
15,407,407,21,7,14,3,2
13,415,415,88,10,78,4,3
6,456,456,106,100,6,3,2
12,482,482,32,22,10,2,1

11,110,110,7,7,0,1,0
8,164,164,6,6,0,1,0
10,202,202,29,29,0,1,0
1,226,226,16,2,14,3,2
16,321,321,20,6,14,3,2
13,329,329,49,1,48,4,3
17,374,374,68,6,62,4,3
6,381,381,2,2,0,1,0
3,398,398,10,1,9,4,3
14,408,408,5,5,0,1,0
12,417,417,60,60,0,1,0
0,418,418,111,54,57,4,3
9,438,438,21,4,17,4,3
4,442,442,28,18,10,2,1
15,442,442,50,50,0,1,0
7,475,475,105,5,100,3,2
2,490,490,46,7,39,4,3
5,490,490,60,60,0,1,0

11,118,118,9,9,0,1,0
3,124,124,27,20,7,2,1
18,130,130,9,9,0,1,0
16,146,146,56,15,41,4,3
0,176,176,6,6,0,1,0
4,219,219,15,10,5,2,1
1,231,231,6,3,3,2,1
7,249,249,29,5,24,2,1
12,285,285,8,8,0,1,0
10,287,287,5,2,3,2,1
15,293,293,12,12,0,1,0
2,294,294,29,29,0,1,0
6,315,315,27,27,0,1,0
9,316,316,8,2,6,2,1
14,355,355,9,9,0,1,0
5,356,356,58,32,26,2,1
17,373,373,78,5,73,3,2
13,420,420,31,17,14,3,2
8,421,421,28,25,3,2,1

6,104,104,6,6,0,1,0
10,104,104,1,1,0,1,0
17,110,110,15,6,9,2,1
15,158,158,14,2,12,2,1
13,189,189,7,7,0,1,0
16,191,191,6,6,0,1,0
8,192,192,4,1,3,2,1
20,222,222,5,5,0,1,0
1,293,293,23,16,7,2,1
3,304,304,47,10,37,4,3
12,329,329,6,6,0,1,0
18,342,342,43,43,0,1,0
7,362,362,45,31,14,2,1
9,401,401,45,45,0,1,0
11,407,407,1,1,0,1,0
19,415,415,43,15,28,2,1
14,430,430,17,5,12,2,1
4,449,449,2,2,0,1,0
2,451,451,31,7,24,3,2
5,461,461,9,9,0,1,0
22,465,465,44,34,10,3,2
21,485,485,137,137,0,1,0
0,496,496,97,43,54,3,2

2,105,105,15,9,6,3,2
9,110,110,7,4,3,2,1
19,146,146,9,9,0,1,0
18,175,175,5,5,0,1,0
6,186,186,16,4,12,2,1
5,225,225,1,1,0,1,0
1,249,249,3,3,0,1,0
8,252,252,3,3,0,1,0
13,276,276,19,16,3,2,1
3,300,300,40,40,0,1,0
11,302,302,4,4,0,1,0
21,320,320,29,29,0,1,0
0,359,359,82,55,27,4,3
7,373,373,1,1,0,1,0
12,392,392,15,15,0,1,0
17,394,394,30,30,0,1,0
16,398,398,119,15,104,4,3
4,422,422,29,14,15,2,1
15,432,432,35,35,0,1,0
20,452,452,49,9,40,2,1
14,464,464,48,19,29,2,1
10,475,475,45,12,33,3,2

10,116,116,9,2,7,2,1
11,133,133,11,3,8,2,1
4,162,162,4,4,0,1,0
17,254,254,19,4,15,2,1
13,260,260,13,2,11,2,1
1,280,280,23,8,15,4,3
20,304,304,52,10,42,2,1
9,305,305,51,34,17,2,1
16,326,326,17,5,12,3,2
8,329,329,49,49,0,1,0
0,345,345,36,36,0,1,0
14,364,364,12,2,10,2,1
12,371,371,8,1,7,2,1
2,379,379,11,11,0,1,0
6,399,399,62,56,6,3,2
18,413,413,89,79,10,2,1
5,418,418,9,3,6,3,2
15,438,438,90,74,16,2,1
19,443,443,40,19,21,2,1
3,474,474,3,3,0,1,0
7,478,478,2,2,0,1,0

12,109,109,20,11,9,3,2
10,126,126,14,14,0,1,0
9,184,184,9,9,0,1,0
4,189,189,16,16,0,1,0
7,238,238,1,1,0,1,0
0,245,245,52,24,28,2,1
3,257,257,62,62,0,1,0
5,335,335,56,2,54,4,3
11,339,339,9,9,0,1,0
1,343,343,21,21,0,1,0
6,454,454,104,52,52,3,2
13,454,454,57,13,44,4,3
8,464,464,12,12,0,1,0
2,497,497,150,105,45,2,1

18,101,101,6,6,0,1,0
4,105,105,3,3,0,1,0
13,121,121,10,7,3,2,1
0,157,157,18,18,0,1,0
9,163,163,7,1,6,3,2
21,171,171,6,1,5,2,1
11,194,194,1,1,0,1,0
6,221,221,4,4,0,1,0
5,222,222,9,4,5,2,1
24,226,226,59,59,0,1,0
8,253,253,1,1,0,1,0
1,260,260,24,14,10,2,1
12,276,276,19,3,16,2,1
22,278,278,53,53,0,1,0
10,279,279,22,22,0,1,0
15,362,362,19,19,0,1,0
23,365,365,7,3,4,2,1
2,369,369,22,22,0,1,0
19,369,369,56,32,24,3,2
14,383,383,9,9,0,1,0
25,422,422,60,12,48,4,3
20,465,465,13,3,10,2,1
17,465,465,3,3,0,1,0
7,471,471,2,2,0,1,0
26,487,487,16,2,14,2,1
16,496,496,63,59,4,2,1
3,499,499,26,26,0,1,0

18,119,119,6,6,0,1,0
9,158,158,2,2,0,1,0
14,171,171,15,15,0,1,0
2,178,178,25,19,6,2,1
13,227,227,17,9,8,3,2
4,228,228,58,10,48,2,1
11,229,229,35,35,0,1,0
0,249,249,19,9,10,3,2
6,284,284,8,8,0,1,0
16,293,293,46,46,0,1,0
15,312,312,54,39,15,2,1
10,366,366,5,2,3,2,1
17,377,377,2,2,0,1,0
5,432,432,48,3,45,2,1
8,443,443,35,2,33,4,3
19,457,457,58,58,0,1,0
3,458,458,68,10,58,3,2
1,474,474,4,4,0,1,0
12,492,492,41,41,0,1,0
7,499,499,15,6,9,4,3

6,131,131,1,1,0,1,0
5,139,139,23,11,12,3,2
0,166,166,5,5,0,1,0
2,184,184,1,1,0,1,0
12,214,214,56,48,8,3,2
19,228,228,3,3,0,1,0
14,264,264,6,2,4,2,1
16,297,297,41,41,0,1,0
9,318,318,27,4,23,2,1
15,320,320,26,26,0,1,0
4,326,326,51,23,28,2,1
8,334,334,40,13,27,2,1
10,355,355,16,7,9,2,1
7,419,419,24,8,16,3,2
1,438,438,30,30,0,1,0
3,438,438,70,70,0,1,0
18,441,441,122,71,51,4,3
13,466,466,21,13,8,3,2
11,472,472,28,10,18,4,3
17,493,493,6,2,4,2,1

20,109,109,14,14,0,1,0
9,114,114,12,12,0,1,0
13,126,126,1,1,0,1,0
1,141,141,6,6,0,1,0
23,154,154,1,1,0,1,0
8,170,170,2,2,0,1,0
4,182,182,7,1,6,3,2
17,192,192,13,4,9,2,1
12,193,193,13,13,0,1,0
19,200,200,39,39,0,1,0
6,219,219,1,1,0,1,0
14,243,243,3,3,0,1,0
16,314,314,2,2,0,1,0
18,339,339,121,49,72,4,3
11,342,342,23,23,0,1,0
15,388,388,39,39,0,1,0
7,421,421,31,31,0,1,0
21,423,423,3,3,0,1,0
3,433,433,70,70,0,1,0
0,444,444,70,19,51,4,3
10,445,445,11,11,0,1,0
5,472,472,30,30,0,1,0
22,486,486,24,24,0,1,0
2,498,498,32,8,24,3,2

7,135,135,4,1,3,2,1
2,172,172,12,12,0,1,0
10,182,182,13,1,12,3,2
18,216,216,15,15,0,1,0
0,217,217,34,34,0,1,0
9,253,253,7,1,6,3,2
5,278,278,28,28,0,1,0
4,279,279,37,10,27,4,3
1,288,288,14,14,0,1,0
19,310,310,15,3,12,2,1
14,354,354,14,8,6,2,1
3,394,394,21,21,0,1,0
13,422,422,2,2,0,1,0
6,431,431,90,71,19,4,3
12,432,432,73,10,63,4,3
8,463,463,1,1,0,1,0
16,478,478,83,65,18,2,1
15,479,479,25,15,10,3,2
11,484,484,11,11,0,1,0
17,499,499,165,165,0,1,0

9,117,117,5,5,0,1,0
5,192,192,21,5,16,2,1
1,200,200,6,3,3,2,1
10,203,203,19,19,0,1,0
16,235,235,19,7,12,2,1
13,243,243,18,18,0,1,0
0,273,273,15,2,13,2,1
14,295,295,3,3,0,1,0
8,336,336,11,11,0,1,0
6,400,400,100,16,84,4,3
2,405,405,52,2,50,2,1
15,417,417,54,6,48,3,2
11,427,427,64,19,45,4,3
7,432,432,1,1,0,1,0
4,437,437,140,96,44,2,1
12,483,483,147,59,88,3,2
3,492,492,3,3,0,1,0

13,105,105,29,29,0,1,0
7,156,156,11,3,8,3,2
2,156,156,63,15,48,3,2
1,166,166,1,1,0,1,0
0,197,197,31,31,0,1,0
4,214,214,4,4,0,1,0
6,293,293,6,6,0,1,0
16,299,299,2,2,0,1,0
15,306,306,15,5,10,3,2
3,316,316,15,6,9,2,1
12,318,318,5,5,0,1,0
10,344,344,96,49,47,4,3
11,344,344,23,23,0,1,0
9,369,369,20,20,0,1,0
8,379,379,55,55,0,1,0
5,379,379,67,19,48,2,1
14,452,452,8,8,0,1,0

11,145,145,11,11,0,1,0
1,146,146,24,11,13,2,1
7,162,162,1,1,0,1,0
13,166,166,13,3,10,3,2
10,189,189,2,2,0,1,0
16,218,218,1,1,0,1,0
15,252,252,39,33,6,3,2
5,256,256,57,57,0,1,0
4,259,259,3,3,0,1,0
8,263,263,68,68,0,1,0
3,289,289,95,95,0,1,0
0,338,338,30,9,21,4,3
9,397,397,118,98,20,2,1
14,398,398,15,11,4,2,1
2,421,421,28,28,0,1,0
12,424,424,2,2,0,1,0
6,440,440,5,5,0,1,0

19,140,140,4,4,0,1,0
11,152,152,14,2,12,3,2
8,159,159,2,2,0,1,0
10,171,171,7,7,0,1,0
21,184,184,4,4,0,1,0
6,187,187,10,10,0,1,0
3,206,206,13,13,0,1,0
5,232,232,22,12,10,3,2
13,248,248,4,4,0,1,0
16,253,253,19,11,8,2,1
4,265,265,7,7,0,1,0
14,307,307,37,37,0,1,0
2,344,344,4,4,0,1,0
1,363,363,49,13,36,2,1
17,376,376,163,140,23,4,3
9,418,418,26,26,0,1,0
7,423,423,97,52,45,4,3
0,434,434,15,6,9,2,1
12,452,452,13,13,0,1,0
22,454,454,2,2,0,1,0
15,460,460,16,16,0,1,0
18,465,465,50,21,29,2,1
20,469,469,42,21,21,4,3

9,101,101,12,1,11,2,1
13,105,105,17,17,0,1,0
16,107,107,6,2,4,2,1
6,115,115,2,2,0,1,0
14,129,129,12,12,0,1,0
18,132,132,2,2,0,1,0
17,197,197,36,36,0,1,0
8,220,220,41,16,25,2,1
3,238,238,25,25,0,1,0
5,296,296,12,12,0,1,0
11,306,306,16,16,0,1,0
10,322,322,15,3,12,4,3
0,334,334,2,2,0,1,0
7,374,374,8,2,6,3,2
19,387,387,11,11,0,1,0
1,411,411,95,70,25,2,1
12,416,416,70,58,12,3,2
15,424,424,73,73,0,1,0
4,437,437,17,7,10,3,2
2,499,499,45,39,6,2,1

2,106,106,37,37,0,1,0
3,125,125,2,2,0,1,0
5,142,142,4,4,0,1,0
15,193,193,2,2,0,1,0
13,202,202,34,31,3,2,1
16,203,203,23,2,21,4,3
17,236,236,34,3,31,2,1
8,257,257,29,29,0,1,0
4,262,262,15,15,0,1,0
1,294,294,28,23,5,2,1
10,305,305,39,39,0,1,0
6,317,317,23,14,9,4,3
14,340,340,51,51,0,1,0
0,342,342,17,17,0,1,0
11,358,358,39,3,36,2,1
12,361,361,20,20,0,1,0
9,435,435,16,13,3,2,1
7,436,436,53,3,50,2,1

11,119,119,1,1,0,1,0
14,140,140,24,7,17,2,1
0,143,143,11,5,6,2,1
22,159,159,17,1,16,2,1
23,174,174,19,19,0,1,0
9,192,192,26,15,11,2,1
5,195,195,4,1,3,2,1
2,218,218,3,3,0,1,0
13,220,220,20,5,15,3,2
20,247,247,8,8,0,1,0
12,280,280,3,3,0,1,0
15,290,290,38,38,0,1,0
18,293,293,48,48,0,1,0
16,295,295,15,3,12,4,3
10,309,309,9,9,0,1,0
1,353,353,60,27,33,4,3
21,356,356,64,57,7,2,1
3,388,388,1,1,0,1,0
17,391,391,10,4,6,2,1
4,394,394,8,1,7,2,1
7,398,398,11,11,0,1,0
6,416,416,49,33,16,3,2
8,445,445,5,5,0,1,0
19,480,480,57,57,0,1,0

8,129,129,27,13,14,3,2
15,149,149,10,10,0,1,0
7,165,165,39,39,0,1,0
11,196,196,3,3,0,1,0
12,215,215,9,9,0,1,0
4,226,226,19,19,0,1,0
13,233,233,3,3,0,1,0
2,255,255,1,1,0,1,0
10,262,262,14,14,0,1,0
0,295,295,60,60,0,1,0
6,361,361,35,35,0,1,0
3,369,369,10,1,9,4,3
9,389,389,20,20,0,1,0
5,391,391,10,10,0,1,0
14,446,446,78,28,50,2,1
1,452,452,102,18,84,3,2
16,484,484,143,69,74,3,2

7,107,107,20,20,0,1,0
12,110,110,14,2,12,4,3
1,163,163,30,9,21,2,1
14,191,191,56,14,42,2,1
3,192,192,45,5,40,3,2
13,230,230,28,28,0,1,0
8,271,271,12,12,0,1,0
10,274,274,11,5,6,3,2
5,313,313,40,40,0,1,0
9,343,343,2,2,0,1,0
4,345,345,23,8,15,4,3
6,414,414,70,21,49,2,1
11,426,426,19,13,6,2,1
15,430,430,25,25,0,1,0
2,480,480,33,12,21,2,1
0,498,498,25,25,0,1,0

3,154,154,67,17,50,4,3
8,157,157,23,23,0,1,0
1,203,203,8,2,6,2,1
13,239,239,2,2,0,1,0
14,261,261,35,5,30,3,2
9,307,307,5,5,0,1,0
7,313,313,23,16,7,2,1
15,336,336,2,2,0,1,0
4,341,341,9,9,0,1,0
11,388,388,44,5,39,2,1
10,401,401,12,12,0,1,0
0,411,411,14,7,7,2,1
12,430,430,166,139,27,2,1
2,454,454,121,23,98,4,3
5,477,477,37,9,28,2,1
6,488,488,11,1,10,3,2

6,122,122,34,1,33,4,3
5,159,159,1,1,0,1,0
17,159,159,23,23,0,1,0
15,194,194,2,2,0,1,0
12,228,228,19,19,0,1,0
4,230,230,8,4,4,2,1
10,235,235,28,28,0,1,0
9,239,239,27,27,0,1,0
0,280,280,66,28,38,3,2
1,338,338,13,8,5,2,1
2,358,358,51,33,18,2,1
13,386,386,90,90,0,1,0
3,390,390,22,14,8,2,1
8,415,415,16,16,0,1,0
11,418,418,19,13,6,2,1
7,485,485,34,30,4,2,1
16,487,487,30,30,0,1,0
14,494,494,51,5,46,2,1

1,122,122,26,26,0,1,0
10,135,135,9,9,0,1,0
5,139,139,16,2,14,3,2
13,173,173,23,17,6,2,1
0,203,203,119,119,0,1,0
11,217,217,22,22,0,1,0
4,302,302,20,20,0,1,0
8,336,336,13,13,0,1,0
3,380,380,1,1,0,1,0
12,400,400,8,3,5,2,1
2,427,427,15,15,0,1,0
7,455,455,144,113,31,4,3
9,465,465,42,20,22,3,2
6,493,493,18,12,6,3,2

5,112,112,3,3,0,1,0
16,119,119,5,2,3,2,1
14,133,133,62,62,0,1,0
15,135,135,9,9,0,1,0
0,184,184,28,28,0,1,0
7,234,234,16,6,10,3,2
9,247,247,43,28,15,4,3
4,260,260,16,16,0,1,0
6,285,285,31,31,0,1,0
13,388,388,19,19,0,1,0
1,395,395,102,12,90,3,2
8,401,401,13,1,12,3,2
11,401,401,28,15,13,2,1
3,420,420,49,49,0,1,0
12,435,435,3,3,0,1,0
2,459,459,50,43,7,2,1
10,485,485,6,6,0,1,0

9,110,110,41,41,0,1,0
12,126,126,15,15,0,1,0
6,130,130,8,8,0,1,0
1,168,168,17,17,0,1,0
14,177,177,20,20,0,1,0
13,213,213,2,2,0,1,0
0,253,253,39,14,25,2,1
8,298,298,10,10,0,1,0
3,389,389,76,37,39,4,3
11,396,396,37,37,0,1,0
5,399,399,30,30,0,1,0
10,408,408,43,43,0,1,0
4,425,425,49,1,48,2,1
7,429,429,4,4,0,1,0
2,463,463,120,120,0,1,0

8,102,102,8,8,0,1,0
12,111,111,34,34,0,1,0
13,115,115,3,3,0,1,0
6,142,142,2,2,0,1,0
10,168,168,9,1,8,3,2
4,237,237,4,4,0,1,0
3,241,241,59,52,7,2,1
1,244,244,2,2,0,1,0
2,251,251,53,53,0,1,0
15,251,251,59,45,14,2,1
14,260,260,2,2,0,1,0
0,301,301,122,83,39,3,2
7,319,319,17,17,0,1,0
11,342,342,52,52,0,1,0
5,356,356,1,1,0,1,0
9,414,414,7,1,6,3,2

1,109,109,18,18,0,1,0
3,110,110,5,5,0,1,0
15,113,113,46,8,38,3,2
2,121,121,19,2,17,2,1
14,145,145,11,11,0,1,0
6,146,146,4,4,0,1,0
11,154,154,12,12,0,1,0
5,173,173,5,5,0,1,0
0,192,192,13,13,0,1,0
9,205,205,3,3,0,1,0
12,234,234,2,2,0,1,0
7,310,310,19,19,0,1,0
10,330,330,16,7,9,2,1
17,346,346,28,28,0,1,0
16,380,380,28,28,0,1,0
13,383,383,54,21,33,2,1
4,412,412,4,4,0,1,0
8,498,498,169,169,0,1,0

0,113,113,18,18,0,1,0
8,125,125,1,1,0,1,0
7,148,148,2,2,0,1,0
6,151,151,3,3,0,1,0
13,192,192,42,42,0,1,0
16,198,198,2,2,0,1,0
14,252,252,26,23,3,2,1
12,256,256,2,2,0,1,0
9,285,285,13,10,3,2,1
4,299,299,15,15,0,1,0
1,300,300,64,64,0,1,0
21,320,320,26,3,23,2,1
19,320,320,8,2,6,2,1
3,338,338,30,2,28,4,3
11,359,359,23,19,4,2,1
2,381,381,29,11,18,3,2
17,386,386,5,5,0,1,0
18,389,389,161,99,62,4,3
10,395,395,1,1,0,1,0
5,398,398,61,35,26,2,1
15,407,407,2,2,0,1,0
20,436,436,18,12,6,3,2

12,104,104,11,8,3,2,1
16,104,104,5,1,4,2,1
14,116,116,22,10,12,2,1
13,125,125,4,1,3,2,1
8,138,138,14,5,9,2,1
9,145,145,12,12,0,1,0
17,148,148,9,9,0,1,0
6,165,165,21,21,0,1,0
4,235,235,22,22,0,1,0
2,296,296,2,2,0,1,0
0,300,300,20,17,3,2,1
3,319,319,98,62,36,4,3
10,325,325,102,93,9,2,1
7,334,334,6,6,0,1,0
15,345,345,13,13,0,1,0
18,359,359,12,9,3,2,1
1,404,404,14,14,0,1,0
11,444,444,46,46,0,1,0
5,464,464,31,31,0,1,0

2,129,129,49,49,0,1,0
9,133,133,16,3,13,2,1
4,156,156,20,1,19,2,1
10,211,211,13,13,0,1,0
8,261,261,41,17,24,2,1
3,269,269,16,6,10,2,1
5,271,271,9,2,7,2,1
0,304,304,119,119,0,1,0
1,317,317,22,4,18,4,3
12,356,356,31,16,15,2,1
7,400,400,23,23,0,1,0
6,405,405,9,9,0,1,0
11,435,435,110,87,23,4,3

10,103,103,13,13,0,1,0
13,112,112,3,3,0,1,0
4,121,121,1,1,0,1,0
15,124,124,29,20,9,2,1
2,192,192,2,2,0,1,0
17,194,194,5,1,4,2,1
11,196,196,14,3,11,2,1
7,207,207,4,1,3,2,1
0,214,214,47,23,24,2,1
22,230,230,101,101,0,1,0
18,234,234,10,10,0,1,0
1,251,251,22,11,11,2,1
8,255,255,21,21,0,1,0
3,276,276,28,28,0,1,0
5,288,288,18,18,0,1,0
16,311,311,9,9,0,1,0
19,334,334,14,14,0,1,0
6,337,337,14,14,0,1,0
12,337,337,5,1,4,2,1
21,338,338,27,27,0,1,0
14,339,339,7,7,0,1,0
20,408,408,2,2,0,1,0
9,436,436,15,15,0,1,0

3,126,126,1,1,0,1,0
9,139,139,4,4,0,1,0
15,148,148,7,3,4,2,1
2,150,150,44,44,0,1,0
0,180,180,7,7,0,1,0
5,194,194,1,1,0,1,0
20,195,195,16,16,0,1,0
10,199,199,12,12,0,1,0
1,201,201,41,41,0,1,0
6,209,209,2,2,0,1,0
14,232,232,45,1,44,3,2
8,250,250,15,15,0,1,0
7,273,273,10,10,0,1,0
19,301,301,11,11,0,1,0
18,358,358,88,51,37,4,3
11,372,372,23,2,21,2,1
12,383,383,1,1,0,1,0
16,402,402,38,32,6,3,2
17,423,423,43,43,0,1,0
13,441,441,51,43,8,3,2
4,454,454,43,31,12,4,3

6,116,116,1,1,0,1,0
21,118,118,4,4,0,1,0
2,131,131,3,3,0,1,0
8,142,142,1,1,0,1,0
12,190,190,29,29,0,1,0
3,192,192,28,15,13,2,1
1,214,214,2,2,0,1,0
5,232,232,7,7,0,1,0
11,261,261,1,1,0,1,0
19,286,286,2,2,0,1,0
7,302,302,11,2,9,4,3
0,309,309,28,28,0,1,0
14,329,329,13,3,10,2,1
4,352,352,23,23,0,1,0
18,354,354,39,34,5,2,1
22,358,358,21,21,0,1,0
20,367,367,116,93,23,4,3
10,382,382,80,42,38,4,3
17,404,404,1,1,0,1,0
15,446,446,27,22,5,2,1
13,453,453,49,1,48,4,3
9,461,461,5,2,3,2,1
16,490,490,140,44,96,3,2

13,103,103,2,2,0,1,0
11,111,111,3,3,0,1,0
2,129,129,18,12,6,2,1
21,141,141,30,10,20,3,2
17,149,149,6,1,5,2,1
9,151,151,3,3,0,1,0
18,154,154,17,17,0,1,0
15,195,195,8,8,0,1,0
12,196,196,9,9,0,1,0
16,223,223,11,11,0,1,0
22,238,238,61,37,24,4,3
1,244,244,13,5,8,3,2
7,252,252,22,22,0,1,0
8,253,253,15,1,14,3,2
0,303,303,7,3,4,2,1
4,309,309,32,8,24,2,1
3,312,312,15,1,14,4,3
10,336,336,13,13,0,1,0
5,360,360,50,12,38,2,1
14,407,407,40,40,0,1,0
19,418,418,17,1,16,3,2
6,448,448,46,26,20,3,2
20,485,485,33,6,27,4,3

19,131,131,33,33,0,1,0
2,140,140,16,16,0,1,0
11,177,177,14,14,0,1,0
3,183,183,12,9,3,2,1
4,183,183,41,41,0,1,0
9,190,190,13,13,0,1,0
6,202,202,4,4,0,1,0
17,207,207,28,3,25,2,1
15,229,229,13,7,6,3,2
1,236,236,4,4,0,1,0
5,238,238,8,3,5,2,1
14,247,247,6,3,3,2,1
16,250,250,47,29,18,4,3
8,286,286,7,7,0,1,0
12,305,305,45,24,21,4,3
13,326,326,4,4,0,1,0
18,374,374,9,9,0,1,0
7,385,385,8,8,0,1,0
10,437,437,45,45,0,1,0
0,497,497,105,59,46,3,2

