29,115,115,8,8,0,1,0
26,149,149,4,4,0,1,0
16,149,149,20,20,0,1,0
17,153,153,2,2,0,1,0
31,161,161,22,7,15,2,1
1,179,179,7,4,3,2,1
30,180,180,49,49,0,1,0
2,189,189,27,24,3,2,1
13,204,204,3,3,0,1,0
22,215,215,7,7,0,1,0
5,217,217,8,8,0,1,0
12,217,217,6,3,3,2,1
21,217,217,34,1,33,4,3
24,266,266,2,2,0,1,0
7,274,274,5,2,3,2,1
23,276,276,49,49,0,1,0
14,307,307,52,52,0,1,0
6,318,318,48,48,0,1,0
0,323,323,5,5,0,1,0
28,342,342,21,8,13,2,1
20,357,357,7,7,0,1,0
8,375,375,73,25,48,4,3
11,377,377,20,20,0,1,0
32,387,387,24,24,0,1,0
10,427,427,15,12,3,2,1
18,430,430,69,15,54,3,2
27,447,447,51,24,27,4,3
19,448,448,88,88,0,1,0
4,456,456,34,34,0,1,0
9,460,460,34,34,0,1,0
15,480,480,16,7,9,4,3
25,481,481,47,47,0,1,0
3,495,495,7,7,0,1,0

35,115,115,4,4,0,1,0
32,128,128,17,9,8,2,1
4,149,149,20,20,0,1,0
23,167,167,13,13,0,1,0
11,178,178,1,1,0,1,0
31,185,185,30,30,0,1,0
3,191,191,15,15,0,1,0
24,199,199,68,35,33,2,1
15,227,227,25,20,5,2,1
26,237,237,47,5,42,4,3
5,240,240,18,1,17,2,1
21,250,250,2,2,0,1,0
2,258,258,2,2,0,1,0
27,270,270,53,53,0,1,0
7,289,289,6,2,4,2,1
9,308,308,52,52,0,1,0
20,337,337,6,6,0,1,0
0,341,341,8,8,0,1,0
12,367,367,23,23,0,1,0
19,367,367,39,33,6,2,1
17,380,380,35,35,0,1,0
6,387,387,43,43,0,1,0
22,389,389,11,11,0,1,0
14,392,392,30,30,0,1,0
28,411,411,13,13,0,1,0
13,411,411,46,10,36,4,3
34,418,418,43,27,16,3,2
18,427,427,24,1,23,4,3
29,461,461,9,9,0,1,0
16,467,467,26,2,24,3,2
30,474,474,12,12,0,1,0
1,477,477,16,16,0,1,0
25,480,480,7,7,0,1,0
8,487,487,13,5,8,2,1
33,487,487,29,29,0,1,0
10,496,496,9,3,6,3,2

20,102,102,3,3,0,1,0
11,122,122,45,45,0,1,0
28,178,178,59,17,42,4,3
1,186,186,26,26,0,1,0
9,198,198,16,16,0,1,0
25,200,200,1,1,0,1,0
4,201,201,67,46,21,4,3
17,207,207,5,5,0,1,0
2,222,222,6,6,0,1,0
27,222,222,7,1,6,3,2
26,248,248,3,3,0,1,0
5,249,249,7,7,0,1,0
24,283,283,28,4,24,2,1
13,287,287,14,1,13,3,2
12,291,291,13,13,0,1,0
23,302,302,41,41,0,1,0
8,321,321,13,3,10,3,2
7,338,338,15,15,0,1,0
21,357,357,2,2,0,1,0
22,366,366,38,38,0,1,0
6,370,370,1,1,0,1,0
18,390,390,26,4,22,3,2
16,412,412,183,183,0,1,0
10,417,417,10,10,0,1,0
0,418,418,44,44,0,1,0
14,421,421,9,9,0,1,0
15,430,430,42,42,0,1,0
3,483,483,44,44,0,1,0
19,490,490,20,2,18,4,3

20,101,101,2,2,0,1,0
12,107,107,7,7,0,1,0
4,112,112,7,7,0,1,0
18,114,114,23,23,0,1,0
11,146,146,20,16,4,2,1
10,154,154,3,3,0,1,0
3,155,155,1,1,0,1,0
22,163,163,4,4,0,1,0
0,186,186,5,5,0,1,0
26,218,218,7,4,3,2,1
2,227,227,29,19,10,2,1
27,231,231,7,4,3,2,1
16,235,235,6,6,0,1,0
5,248,248,4,4,0,1,0
6,288,288,29,1,28,2,1
19,321,321,119,85,34,2,1
13,336,336,78,52,26,3,2
7,387,387,33,33,0,1,0
15,391,391,95,95,0,1,0
1,403,403,84,9,75,4,3
21,442,442,6,6,0,1,0
14,451,451,53,5,48,3,2
9,459,459,86,15,71,3,2
23,459,459,97,76,21,4,3
8,461,461,58,22,36,4,3
25,478,478,16,4,12,2,1
24,488,488,18,4,14,3,2
17,500,500,30,24,6,3,2

9,118,118,1,1,0,1,0
21,123,123,2,2,0,1,0
0,149,149,30,20,10,2,1
26,158,158,8,8,0,1,0
20,159,159,57,57,0,1,0
7,213,213,7,7,0,1,0
2,215,215,18,18,0,1,0
17,218,218,30,12,18,2,1
11,221,221,23,23,0,1,0
27,227,227,6,6,0,1,0
6,270,270,2,2,0,1,0
19,283,283,70,70,0,1,0
22,296,296,38,21,17,2,1
12,299,299,5,1,4,2,1
24,309,309,2,2,0,1,0
15,311,311,8,8,0,1,0
25,311,311,16,11,5,2,1
8,316,316,21,6,15,4,3
29,339,339,27,7,20,3,2
1,392,392,8,8,0,1,0
23,394,394,5,5,0,1,0
30,421,421,21,21,0,1,0
14,438,438,75,51,24,3,2
13,438,438,8,8,0,1,0
3,441,441,86,86,0,1,0
5,441,441,46,17,29,3,2
18,449,449,84,84,0,1,0
4,462,462,64,64,0,1,0
16,466,466,7,7,0,1,0
28,470,470,38,21,17,2,1
10,480,480,92,92,0,1,0

13,155,155,35,35,0,1,0
1,172,172,8,4,4,2,1
17,208,208,21,21,0,1,0
11,213,213,1,1,0,1,0
23,220,220,8,8,0,1,0
7,249,249,1,1,0,1,0
0,252,252,19,10,9,4,3
8,266,266,43,38,5,2,1
20,280,280,69,69,0,1,0
22,293,293,8,8,0,1,0
10,310,310,2,2,0,1,0
19,317,317,31,31,0,1,0
21,334,334,44,23,21,2,1
3,341,341,23,2,21,4,3
12,350,350,8,2,6,3,2
25,381,381,31,15,16,2,1
18,382,382,8,8,0,1,0
9,390,390,116,116,0,1,0
16,395,395,31,18,13,2,1
6,402,402,63,63,0,1,0
5,404,404,107,20,87,4,3
15,410,410,18,18,0,1,0
14,410,410,13,13,0,1,0
4,474,474,37,7,30,2,1
24,479,479,129,120,9,4,3
2,485,485,117,117,0,1,0

23,132,132,9,9,0,1,0
0,161,161,17,1,16,4,3
18,169,169,8,8,0,1,0
26,170,170,14,14,0,1,0
20,183,183,17,17,0,1,0
16,213,213,34,17,17,2,1
8,231,231,15,15,0,1,0
19,231,231,17,11,6,3,2
17,234,234,9,9,0,1,0
3,244,244,27,3,24,4,3
1,268,268,5,1,4,2,1
7,291,291,5,5,0,1,0
14,301,301,40,40,0,1,0
9,307,307,80,80,0,1,0
4,309,309,45,12,33,4,3
25,332,332,57,12,45,2,1
21,332,332,66,66,0,1,0
15,336,336,17,17,0,1,0
2,336,336,3,3,0,1,0
11,342,342,132,36,96,4,3
12,371,371,20,10,10,2,1
6,390,390,8,8,0,1,0
5,434,434,24,18,6,2,1
22,436,436,89,33,56,3,2
13,462,462,22,11,11,2,1
10,470,470,72,72,0,1,0
24,484,484,30,15,15,4,3

0,101,101,4,4,0,1,0
8,103,103,9,9,0,1,0
24,106,106,21,13,8,3,2
3,130,130,2,2,0,1,0
20,145,145,5,5,0,1,0
21,147,147,7,7,0,1,0
23,172,172,1,1,0,1,0
14,180,180,16,11,5,2,1
13,208,208,56,44,12,2,1
22,209,209,9,9,0,1,0
27,229,229,28,1,27,2,1
5,250,250,27,27,0,1,0
2,269,269,4,1,3,2,1
11,298,298,1,1,0,1,0
26,326,326,44,44,0,1,0
16,331,331,14,3,11,2,1
25,339,339,12,12,0,1,0
12,366,366,91,63,28,3,2
1,381,381,92,26,66,4,3
7,391,391,16,16,0,1,0
18,424,424,16,16,0,1,0
19,426,426,51,14,37,2,1
17,436,436,145,26,119,4,3
9,444,444,2,2,0,1,0
10,454,454,19,19,0,1,0
6,486,486,32,17,15,2,1
4,488,488,107,107,0,1,0
15,493,493,97,78,19,4,3

8,122,122,10,10,0,1,0
6,156,156,38,38,0,1,0
14,170,170,8,8,0,1,0
16,185,185,22,1,21,2,1
7,203,203,33,33,0,1,0
11,208,208,4,4,0,1,0
2,238,238,13,10,3,2,1
22,251,251,101,7,94,3,2
15,271,271,34,34,0,1,0
19,277,277,8,8,0,1,0
10,285,285,31,31,0,1,0
23,292,292,78,78,0,1,0
4,292,292,34,34,0,1,0
18,316,316,34,34,0,1,0
12,337,337,15,6,9,4,3
0,379,379,102,102,0,1,0
17,395,395,5,5,0,1,0
21,408,408,3,3,0,1,0
20,410,410,4,4,0,1,0
13,416,416,11,6,5,2,1
9,449,449,47,14,33,4,3
5,458,458,18,18,0,1,0
3,461,461,1,1,0,1,0
1,492,492,107,41,66,4,3
24,500,500,103,98,5,2,1

16,111,111,8,8,0,1,0
6,123,123,29,26,3,2,1
13,144,144,3,3,0,1,0
15,150,150,34,34,0,1,0
20,174,174,22,22,0,1,0
7,180,180,12,12,0,1,0
21,230,230,6,6,0,1,0
12,281,281,4,4,0,1,0
14,311,311,60,60,0,1,0
19,314,314,52,40,12,3,2
2,315,315,155,116,39,4,3
1,315,315,90,90,0,1,0
22,321,321,47,13,34,3,2
3,364,364,16,16,0,1,0
9,365,365,54,54,0,1,0
4,389,389,17,17,0,1,0
8,397,397,29,29,0,1,0
0,406,406,1,1,0,1,0
18,412,412,56,40,16,3,2
5,430,430,68,20,48,2,1
17,437,437,53,39,14,2,1
10,475,475,6,6,0,1,0
11,481,481,9,9,0,1,0

21,118,118,25,9,16,3,2
15,136,136,2,2,0,1,0
17,139,139,10,10,0,1,0
11,141,141,10,10,0,1,0
23,149,149,15,15,0,1,0
1,158,158,10,6,4,2,1
20,172,172,16,16,0,1,0
3,194,194,24,24,0,1,0
27,215,215,29,29,0,1,0
10,220,220,6,3,3,2,1
18,235,235,26,2,24,2,1
26,241,241,43,13,30,3,2
13,279,279,42,42,0,1,0
4,281,281,6,6,0,1,0
2,300,300,18,18,0,1,0
24,300,300,46,46,0,1,0
16,344,344,28,6,22,3,2
8,348,348,62,6,56,3,2
22,371,371,15,4,11,2,1
25,372,372,15,3,12,3,2
19,381,381,72,72,0,1,0
6,391,391,138,57,81,4,3
14,393,393,1,1,0,1,0
5,398,398,5,1,4,2,1
7,408,408,30,30,0,1,0
12,411,411,107,58,49,4,3
0,463,463,1,1,0,1,0
9,470,470,2,2,0,1,0

16,135,135,10,4,6,3,2
19,195,195,13,1,12,4,3
17,201,201,15,15,0,1,0
20,201,201,1,1,0,1,0
18,216,216,23,23,0,1,0
21,217,217,10,10,0,1,0
14,231,231,22,22,0,1,0
5,239,239,4,4,0,1,0
15,246,246,6,6,0,1,0
9,275,275,6,6,0,1,0
7,290,290,1,1,0,1,0
0,317,317,105,56,49,2,1
4,319,319,91,33,58,3,2
2,328,328,3,3,0,1,0
10,351,351,29,6,23,2,1
23,355,355,13,1,12,3,2
3,373,373,56,44,12,2,1
13,403,403,15,6,9,2,1
26,413,413,218,182,36,4,3
25,417,417,76,31,45,2,1
22,447,447,63,63,0,1,0
12,461,461,87,45,42,4,3
11,469,469,26,4,22,3,2
1,473,473,70,10,60,4,3
24,480,480,8,4,4,2,1
6,496,496,15,15,0,1,0
8,500,500,39,32,7,2,1

21,100,100,7,1,6,3,2
18,103,103,11,1,10,3,2
22,107,107,3,3,0,1,0
6,121,121,8,8,0,1,0
24,131,131,10,5,5,2,1
13,144,144,1,1,0,1,0
2,149,149,29,8,21,4,3
16,157,157,17,5,12,2,1
4,161,161,11,11,0,1,0
12,161,161,7,7,0,1,0
28,164,164,9,9,0,1,0
10,226,226,33,9,24,2,1
27,232,232,30,20,10,3,2
19,257,257,32,32,0,1,0
8,286,286,29,29,0,1,0
14,297,297,5,5,0,1,0
7,328,328,81,31,50,2,1
5,348,348,18,1,17,2,1
3,349,349,22,2,20,3,2
23,353,353,43,43,0,1,0
15,366,366,7,1,6,2,1
9,391,391,45,27,18,2,1
1,398,398,76,1,75,3,2
25,401,401,180,107,73,4,3
11,419,419,21,21,0,1,0
0,433,433,17,8,9,2,1
26,438,438,2,2,0,1,0
17,443,443,40,40,0,1,0
20,456,456,22,4,18,4,3

21,124,124,4,1,3,2,1
3,154,154,8,3,5,2,1
6,176,176,7,7,0,1,0
5,194,194,6,3,3,2,1
7,221,221,62,44,18,3,2
13,236,236,3,3,0,1,0
24,246,246,27,27,0,1,0
0,254,254,80,6,74,3,2
9,259,259,55,22,33,4,3
20,263,263,30,14,16,2,1
23,271,271,31,13,18,3,2
1,289,289,25,25,0,1,0
10,291,291,11,11,0,1,0
22,314,314,9,9,0,1,0
19,339,339,12,12,0,1,0
17,345,345,29,29,0,1,0
4,370,370,31,31,0,1,0
18,378,378,26,1,25,2,1
2,393,393,81,36,45,2,1
11,442,442,174,79,95,4,3
14,453,453,42,42,0,1,0
16,457,457,8,8,0,1,0
15,464,464,81,51,30,2,1
12,475,475,68,45,23,4,3
8,475,475,27,6,21,2,1

16,135,135,17,14,3,2,1
5,137,137,64,7,57,4,3
17,145,145,20,20,0,1,0
19,146,146,28,28,0,1,0
18,172,172,9,9,0,1,0
11,190,190,12,5,7,2,1
14,227,227,19,19,0,1,0
20,246,246,5,5,0,1,0
2,247,247,54,54,0,1,0
15,266,266,21,21,0,1,0
7,332,332,22,22,0,1,0
8,333,333,16,10,6,3,2
13,340,340,135,12,123,4,3
6,358,358,58,19,39,4,3
12,364,364,28,28,0,1,0
9,458,458,17,17,0,1,0
3,469,469,61,19,42,3,2
0,477,477,87,42,45,2,1
1,486,486,87,87,0,1,0
10,488,488,25,22,3,2,1
4,493,493,30,14,16,2,1

26,105,105,12,3,9,4,3
12,106,106,11,11,0,1,0
10,112,112,6,6,0,1,0
19,127,127,4,4,0,1,0
24,135,135,19,7,12,2,1
17,140,140,11,3,8,2,1
3,152,152,8,8,0,1,0
2,172,172,21,1,20,3,2
14,176,176,2,2,0,1,0
11,222,222,21,3,18,3,2
29,232,232,19,19,0,1,0
25,236,236,40,40,0,1,0
6,256,256,91,52,39,4,3
20,286,286,19,6,13,3,2
16,291,291,19,19,0,1,0
23,300,300,108,10,98,3,2
30,300,300,25,7,18,3,2
27,314,314,8,2,6,2,1
8,314,314,64,64,0,1,0
7,316,316,24,24,0,1,0
0,321,321,4,4,0,1,0
4,358,358,7,7,0,1,0
9,367,367,19,8,11,2,1
22,367,367,30,10,20,2,1
18,392,392,15,5,10,2,1
28,424,424,4,4,0,1,0
31,435,435,46,29,17,2,1
21,437,437,54,54,0,1,0
5,441,441,12,3,9,4,3
15,463,463,1,1,0,1,0
13,463,463,32,32,0,1,0
1,497,497,1,1,0,1,0

16,120,120,16,7,9,2,1
30,134,134,11,1,10,3,2
1,152,152,23,12,11,2,1
25,154,154,2,2,0,1,0
29,157,157,35,13,22,3,2
8,163,163,8,8,0,1,0
5,166,166,26,16,10,2,1
34,176,176,13,13,0,1,0
24,177,177,10,10,0,1,0
23,189,189,48,1,47,3,2
33,217,217,19,19,0,1,0
27,225,225,37,37,0,1,0
7,228,228,12,5,7,2,1
32,267,267,15,15,0,1,0
2,272,272,21,21,0,1,0
3,302,302,27,10,17,2,1
14,324,324,42,42,0,1,0
28,331,331,30,30,0,1,0
10,336,336,36,36,0,1,0
0,338,338,7,7,0,1,0
26,344,344,23,23,0,1,0
19,353,353,45,17,28,3,2
31,408,408,56,29,27,4,3
13,408,408,7,7,0,1,0
20,424,424,15,15,0,1,0
4,432,432,17,12,5,2,1
6,441,441,2,2,0,1,0
21,444,444,49,49,0,1,0
22,447,447,7,1,6,2,1
17,451,451,29,29,0,1,0
9,463,463,16,2,14,2,1
15,468,468,12,12,0,1,0
18,471,471,13,13,0,1,0
12,473,473,6,1,5,2,1
11,491,491,22,22,0,1,0

18,112,112,21,2,19,4,3
5,130,130,15,1,14,2,1
1,132,132,3,3,0,1,0
9,137,137,49,49,0,1,0
11,147,147,31,25,6,3,2
14,150,150,13,13,0,1,0
24,165,165,17,7,10,2,1
19,172,172,15,1,14,3,2
7,178,178,2,2,0,1,0
20,232,232,36,23,13,2,1
22,244,244,46,46,0,1,0
17,247,247,15,15,0,1,0
23,250,250,4,4,0,1,0
6,259,259,13,7,6,3,2
12,269,269,30,30,0,1,0
13,290,290,28,28,0,1,0
16,310,310,33,7,26,2,1
4,345,345,19,19,0,1,0
0,381,381,69,69,0,1,0
10,382,382,18,18,0,1,0
3,399,399,67,13,54,4,3
8,451,451,107,107,0,1,0
2,462,462,72,72,0,1,0
21,484,484,2,2,0,1,0
15,498,498,17,8,9,2,1

8,121,121,1,1,0,1,0
13,121,121,20,17,3,2,1
16,129,129,29,11,18,3,2
22,132,132,3,3,0,1,0
14,133,133,9,9,0,1,0
18,134,134,23,7,16,3,2
24,150,150,15,5,10,2,1
21,151,151,14,14,0,1,0
1,160,160,63,56,7,2,1
12,165,165,5,1,4,2,1
5,193,193,12,12,0,1,0
9,196,196,14,14,0,1,0
10,203,203,4,4,0,1,0
11,210,210,3,3,0,1,0
29,217,217,5,1,4,2,1
19,219,219,48,23,25,2,1
25,232,232,15,5,10,2,1
23,236,236,14,6,8,2,1
20,242,242,61,61,0,1,0
28,297,297,3,3,0,1,0
0,311,311,28,15,13,2,1
15,316,316,15,15,0,1,0
3,406,406,69,33,36,4,3
26,416,416,11,4,7,3,2
4,423,423,65,65,0,1,0
27,427,427,37,37,0,1,0
6,443,443,13,13,0,1,0
2,449,449,2,2,0,1,0
17,489,489,42,42,0,1,0
7,498,498,37,37,0,1,0

12,100,100,1,1,0,1,0
20,109,109,23,2,21,4,3
5,180,180,11,1,10,3,2
13,183,183,11,1,10,3,2
4,184,184,1,1,0,1,0
0,187,187,36,36,0,1,0
17,193,193,21,21,0,1,0
19,219,219,11,1,10,3,2
15,221,221,16,16,0,1,0
9,234,234,12,12,0,1,0
11,276,276,19,19,0,1,0
28,289,289,71,39,32,2,1
6,292,292,86,6,80,3,2
8,295,295,44,44,0,1,0
23,303,303,27,27,0,1,0
14,304,304,6,6,0,1,0
21,307,307,25,25,0,1,0
1,341,341,7,1,6,3,2
26,349,349,6,2,4,2,1
16,365,365,18,9,9,2,1
2,378,378,68,68,0,1,0
27,383,383,66,10,56,4,3
22,397,397,67,62,5,2,1
3,413,413,2,2,0,1,0
24,427,427,29,29,0,1,0
29,452,452,8,8,0,1,0
7,472,472,69,23,46,3,2
25,475,475,58,58,0,1,0
18,484,484,10,10,0,1,0
10,489,489,33,25,8,2,1

8,107,107,12,12,0,1,0
21,135,135,10,10,0,1,0
26,155,155,38,4,34,2,1
3,174,174,25,13,12,4,3
15,178,178,20,11,9,4,3
10,180,180,15,15,0,1,0
5,184,184,1,1,0,1,0
14,196,196,7,7,0,1,0
18,217,217,14,8,6,3,2
0,227,227,41,3,38,2,1
19,227,227,27,27,0,1,0
7,235,235,4,1,3,2,1
6,240,240,1,1,0,1,0
2,251,251,26,26,0,1,0
32,262,262,3,3,0,1,0
30,268,268,7,7,0,1,0
11,272,272,20,4,16,2,1
27,276,276,39,14,25,2,1
13,301,301,51,51,0,1,0
1,303,303,14,2,12,3,2
25,323,323,13,5,8,2,1
28,335,335,31,31,0,1,0
29,371,371,21,21,0,1,0
9,384,384,22,8,14,3,2
12,397,397,14,14,0,1,0
20,401,401,63,44,19,2,1
4,413,413,1,1,0,1,0
31,462,462,17,3,14,2,1
16,465,465,41,13,28,2,1
22,471,471,82,82,0,1,0
24,472,472,41,1,40,3,2
17,472,472,32,32,0,1,0
23,474,474,79,5,74,3,2

2,108,108,32,6,26,4,3
10,124,124,21,10,11,2,1
18,138,138,25,25,0,1,0
1,145,145,25,25,0,1,0
12,171,171,12,9,3,2,1
11,206,206,11,2,9,4,3
13,213,213,19,8,11,2,1
15,219,219,10,10,0,1,0
7,293,293,69,15,54,4,3
9,311,311,104,104,0,1,0
14,335,335,6,1,5,2,1
19,348,348,36,16,20,2,1
0,351,351,44,44,0,1,0
6,405,405,23,23,0,1,0
8,409,409,20,10,10,3,2
3,424,424,256,226,30,2,1
16,431,431,2,2,0,1,0
17,457,457,10,10,0,1,0
4,458,458,45,45,0,1,0
5,474,474,50,50,0,1,0

16,106,106,1,1,0,1,0
13,145,145,20,20,0,1,0
6,169,169,13,13,0,1,0
4,173,173,8,8,0,1,0
2,184,184,11,11,0,1,0
25,189,189,7,7,0,1,0
20,196,196,9,9,0,1,0
0,201,201,1,1,0,1,0
1,206,206,1,1,0,1,0
9,231,231,2,2,0,1,0
18,236,236,31,22,9,4,3
8,246,246,22,14,8,2,1
21,264,264,28,13,15,4,3
10,303,303,35,12,23,2,1
7,303,303,114,90,24,3,2
19,312,312,102,102,0,1,0
3,342,342,3,3,0,1,0
23,356,356,36,36,0,1,0
17,358,358,51,51,0,1,0
27,402,402,55,50,5,2,1
26,407,407,9,2,7,2,1
12,409,409,1,1,0,1,0
14,411,411,43,29,14,2,1
11,450,450,207,207,0,1,0
15,459,459,69,5,64,4,3
22,468,468,37,2,35,2,1
5,472,472,4,4,0,1,0
24,480,480,15,15,0,1,0

19,131,131,16,16,0,1,0
0,134,134,1,1,0,1,0
12,146,146,36,26,10,3,2
1,166,166,2,2,0,1,0
17,169,169,1,1,0,1,0
21,182,182,14,6,8,3,2
7,220,220,30,30,0,1,0
8,227,227,7,3,4,2,1
20,240,240,6,3,3,2,1
4,245,245,8,8,0,1,0
15,279,279,60,60,0,1,0
16,287,287,27,5,22,3,2
6,319,319,18,18,0,1,0
18,332,332,13,5,8,3,2
5,366,366,19,19,0,1,0
13,374,374,5,5,0,1,0
22,378,378,2,2,0,1,0
24,411,411,90,64,26,2,1
25,417,417,30,6,24,4,3
23,418,418,50,26,24,4,3
2,433,433,232,232,0,1,0
14,434,434,75,17,58,3,2
9,458,458,115,25,90,4,3
11,460,460,4,4,0,1,0
3,469,469,124,124,0,1,0
10,481,481,6,2,4,2,1

13,101,101,8,4,4,2,1
0,135,135,31,31,0,1,0
16,163,163,47,23,24,4,3
19,196,196,29,7,22,4,3
1,206,206,10,2,8,3,2
8,218,218,8,8,0,1,0
4,225,225,10,5,5,2,1
7,225,225,16,16,0,1,0
21,246,246,15,15,0,1,0
20,247,247,22,22,0,1,0
9,261,261,20,20,0,1,0
12,301,301,22,2,20,3,2
17,304,304,52,25,27,4,3
3,313,313,98,74,24,2,1
6,319,319,100,100,0,1,0
11,328,328,12,8,4,2,1
18,386,386,56,56,0,1,0
2,399,399,93,77,16,2,1
10,403,403,67,67,0,1,0
15,406,406,39,27,12,2,1
5,441,441,15,6,9,4,3
22,445,445,11,11,0,1,0
23,447,447,12,1,11,2,1
14,479,479,5,5,0,1,0

12,122,122,17,9,8,2,1
9,136,136,17,17,0,1,0
24,139,139,4,4,0,1,0
27,145,145,19,19,0,1,0
21,172,172,2,2,0,1,0
23,202,202,8,8,0,1,0
7,203,203,60,24,36,2,1
14,217,217,12,12,0,1,0
1,220,220,31,31,0,1,0
20,226,226,8,8,0,1,0
28,228,228,37,37,0,1,0
15,273,273,66,66,0,1,0
22,308,308,6,6,0,1,0
18,308,308,50,22,28,3,2
26,326,326,81,81,0,1,0
3,337,337,11,4,7,2,1
8,349,349,5,2,3,2,1
16,368,368,18,8,10,2,1
6,372,372,26,26,0,1,0
0,375,375,7,7,0,1,0
19,376,376,19,11,8,3,2
17,380,380,124,88,36,2,1
29,417,417,22,11,11,2,1
2,417,417,1,1,0,1,0
10,439,439,52,11,41,2,1
30,451,451,62,2,60,3,2
25,476,476,9,9,0,1,0
11,482,482,7,7,0,1,0
5,488,488,24,17,7,2,1
4,491,491,1,1,0,1,0
13,494,494,16,3,13,2,1

7,109,109,9,1,8,3,2
25,113,113,17,6,11,2,1
28,146,146,3,3,0,1,0
21,162,162,8,8,0,1,0
5,180,180,2,2,0,1,0
29,197,197,8,8,0,1,0
1,199,199,7,7,0,1,0
32,221,221,14,8,6,3,2
27,227,227,1,1,0,1,0
15,239,239,28,28,0,1,0
2,258,258,16,9,7,2,1
0,262,262,15,15,0,1,0
11,262,262,48,27,21,2,1
14,262,262,4,4,0,1,0
16,286,286,8,8,0,1,0
20,315,315,42,12,30,4,3
6,330,330,4,4,0,1,0
12,338,338,12,12,0,1,0
30,340,340,108,108,0,1,0
26,348,348,29,29,0,1,0
10,350,350,47,47,0,1,0
8,364,364,31,31,0,1,0
3,379,379,17,17,0,1,0
22,385,385,15,11,4,2,1
18,393,393,71,14,57,4,3
13,409,409,50,50,0,1,0
23,417,417,100,94,6,2,1
9,420,420,25,25,0,1,0
31,421,421,10,1,9,4,3
24,423,423,15,15,0,1,0
19,429,429,100,25,75,4,3
4,485,485,9,9,0,1,0
17,488,488,57,57,0,1,0

9,113,113,7,7,0,1,0
19,124,124,24,10,14,3,2
14,133,133,6,6,0,1,0
26,166,166,4,4,0,1,0
2,169,169,1,1,0,1,0
11,169,169,54,54,0,1,0
1,173,173,30,30,0,1,0
0,183,183,4,1,3,2,1
4,197,197,22,22,0,1,0
21,199,199,14,14,0,1,0
6,209,209,8,2,6,3,2
28,212,212,5,5,0,1,0
12,218,218,1,1,0,1,0
27,257,257,7,1,6,3,2
25,258,258,47,47,0,1,0
23,258,258,27,3,24,3,2
18,262,262,76,76,0,1,0
10,273,273,29,29,0,1,0
3,294,294,87,3,84,3,2
7,307,307,36,36,0,1,0
22,325,325,16,13,3,2,1
16,354,354,7,7,0,1,0
8,364,364,22,22,0,1,0
13,367,367,13,5,8,3,2
24,437,437,17,17,0,1,0
15,444,444,32,27,5,2,1
5,447,447,4,4,0,1,0
20,468,468,108,101,7,2,1
17,488,488,45,34,11,2,1

5,104,104,2,2,0,1,0
6,104,104,8,2,6,3,2
19,115,115,24,24,0,1,0
15,120,120,17,13,4,2,1
11,130,130,5,5,0,1,0
25,152,152,1,1,0,1,0
12,172,172,17,17,0,1,0
7,247,247,41,41,0,1,0
3,250,250,27,20,7,2,1
0,252,252,1,1,0,1,0
2,265,265,1,1,0,1,0
27,288,288,21,21,0,1,0
21,314,314,31,7,24,2,1
29,325,325,23,9,14,3,2
4,335,335,51,51,0,1,0
10,339,339,79,40,39,4,3
9,351,351,19,3,16,2,1
16,365,365,42,9,33,4,3
20,368,368,30,30,0,1,0
1,374,374,4,4,0,1,0
14,382,382,87,87,0,1,0
22,383,383,31,31,0,1,0
28,384,384,24,13,11,2,1
23,385,385,173,154,19,2,1
24,424,424,10,4,6,2,1
26,455,455,52,22,30,3,2
17,463,463,7,1,6,3,2
8,471,471,2,2,0,1,0
13,482,482,31,6,25,2,1
18,482,482,11,3,8,2,1

18,110,110,5,5,0,1,0
6,128,128,8,2,6,2,1
14,136,136,4,4,0,1,0
0,143,143,4,4,0,1,0
21,146,146,20,3,17,3,2
2,199,199,3,3,0,1,0
24,220,220,35,1,34,2,1
1,236,236,43,10,33,4,3
22,274,274,2,2,0,1,0
29,278,278,127,16,111,4,3
15,287,287,11,5,6,2,1
20,290,290,72,31,41,2,1
10,301,301,27,13,14,3,2
5,311,311,1,1,0,1,0
26,312,312,10,10,0,1,0
9,313,313,5,5,0,1,0
23,318,318,7,7,0,1,0
7,333,333,3,3,0,1,0
31,339,339,2,2,0,1,0
25,341,341,15,15,0,1,0
3,355,355,1,1,0,1,0
19,381,381,8,8,0,1,0
28,381,381,30,6,24,2,1
11,389,389,29,20,9,4,3
30,390,390,24,4,20,2,1
16,404,404,10,10,0,1,0
27,404,404,44,35,9,4,3
4,437,437,59,59,0,1,0
12,456,456,7,7,0,1,0
13,462,462,5,5,0,1,0
17,464,464,93,15,78,4,3
8,498,498,231,231,0,1,0

10,101,101,2,2,0,1,0
16,142,142,8,8,0,1,0
1,175,175,10,10,0,1,0
19,202,202,19,19,0,1,0
15,228,228,34,21,13,2,1
23,233,233,8,3,5,2,1
9,268,268,27,27,0,1,0
12,274,274,44,14,30,3,2
3,323,323,9,9,0,1,0
22,323,323,3,3,0,1,0
21,328,328,39,17,22,2,1
0,345,345,141,87,54,4,3
11,348,348,86,40,46,2,1
7,349,349,27,27,0,1,0
14,357,357,12,6,6,3,2
8,376,376,36,29,7,2,1
6,386,386,9,3,6,3,2
17,394,394,4,4,0,1,0
20,394,394,93,33,60,3,2
4,411,411,9,9,0,1,0
2,434,434,93,45,48,4,3
5,475,475,178,129,49,2,1
18,479,479,81,32,49,4,3
13,490,490,47,23,24,4,3

8,100,100,1,1,0,1,0
12,117,117,4,1,3,2,1
6,129,129,17,17,0,1,0
21,133,133,6,6,0,1,0
25,140,140,3,3,0,1,0
4,164,164,16,12,4,2,1
1,183,183,50,50,0,1,0
11,194,194,1,1,0,1,0
19,199,199,51,51,0,1,0
17,205,205,2,2,0,1,0
24,212,212,3,3,0,1,0
16,221,221,15,4,11,2,1
0,257,257,1,1,0,1,0
3,279,279,90,90,0,1,0
22,316,316,31,31,0,1,0
18,320,320,46,46,0,1,0
7,347,347,23,23,0,1,0
9,348,348,11,3,8,2,1
13,377,377,42,42,0,1,0
5,386,386,107,107,0,1,0
10,395,395,48,1,47,4,3
15,418,418,2,2,0,1,0
2,422,422,11,3,8,3,2
20,424,424,2,2,0,1,0
14,439,439,235,235,0,1,0
26,439,439,3,3,0,1,0
23,468,468,55,55,0,1,0

1,117,117,30,30,0,1,0
18,123,123,50,50,0,1,0
20,124,124,2,2,0,1,0
10,138,138,2,2,0,1,0
15,146,146,42,42,0,1,0
13,146,146,28,28,0,1,0
19,170,170,8,2,6,3,2
5,172,172,6,6,0,1,0
6,178,178,64,18,46,4,3
2,192,192,36,2,34,2,1
9,220,220,8,3,5,2,1
21,262,262,53,31,22,3,2
16,286,286,4,4,0,1,0
7,383,383,50,20,30,4,3
0,427,427,48,48,0,1,0
14,433,433,12,12,0,1,0
4,436,436,13,13,0,1,0
12,438,438,25,25,0,1,0
11,450,450,10,10,0,1,0
8,458,458,50,28,22,3,2
3,458,458,133,133,0,1,0
17,478,478,3,3,0,1,0

32,102,102,45,45,0,1,0
6,114,114,20,6,14,2,1
28,156,156,5,5,0,1,0
13,158,158,1,1,0,1,0
15,161,161,12,12,0,1,0
5,164,164,7,7,0,1,0
10,165,165,5,5,0,1,0
1,168,168,14,3,11,2,1
17,178,178,7,7,0,1,0
24,178,178,5,5,0,1,0
33,181,181,6,3,3,2,1
12,191,191,1,1,0,1,0
30,203,203,6,1,5,2,1
19,221,221,10,1,9,4,3
26,226,226,39,1,38,3,2
4,245,245,8,8,0,1,0
20,271,271,39,7,32,3,2
22,278,278,20,20,0,1,0
25,300,300,53,53,0,1,0
3,308,308,80,54,26,2,1
7,329,329,63,17,46,2,1
27,335,335,25,5,20,3,2
16,338,338,3,3,0,1,0
9,343,343,1,1,0,1,0
8,394,394,13,1,12,4,3
21,397,397,11,1,10,2,1
18,397,397,5,5,0,1,0
11,406,406,78,2,76,4,3
2,407,407,13,9,4,2,1
0,413,413,54,54,0,1,0
23,432,432,29,29,0,1,0
14,445,445,2,2,0,1,0
29,449,449,20,20,0,1,0
31,482,482,41,41,0,1,0

12,103,103,4,4,0,1,0
11,118,118,24,24,0,1,0
5,125,125,6,3,3,2,1
28,133,133,8,8,0,1,0
2,140,140,11,11,0,1,0
23,170,170,2,2,0,1,0
4,174,174,63,25,38,3,2
15,178,178,3,3,0,1,0
8,180,180,4,1,3,2,1
20,202,202,45,25,20,3,2
25,205,205,43,43,0,1,0
18,263,263,47,47,0,1,0
24,282,282,11,3,8,3,2
7,287,287,1,1,0,1,0
17,294,294,33,33,0,1,0
10,322,322,15,2,13,3,2
1,336,336,7,7,0,1,0
21,350,350,13,1,12,3,2
27,354,354,22,13,9,2,1
9,360,360,6,6,0,1,0
16,370,370,2,2,0,1,0
6,414,414,27,15,12,3,2
22,415,415,74,74,0,1,0
14,416,416,24,24,0,1,0
13,416,416,31,14,17,2,1
3,434,434,135,135,0,1,0
0,444,444,23,23,0,1,0
26,456,456,124,28,96,3,2
19,500,500,10,4,6,2,1

8,122,122,11,11,0,1,0
12,123,123,8,1,7,2,1
24,148,148,16,16,0,1,0
23,163,163,4,1,3,2,1
13,185,185,12,12,0,1,0
25,223,223,16,16,0,1,0
10,255,255,39,39,0,1,0
3,278,278,52,52,0,1,0
9,287,287,30,8,22,2,1
20,306,306,64,10,54,3,2
14,309,309,2,2,0,1,0
21,310,310,1,1,0,1,0
6,323,323,33,3,30,4,3
5,339,339,106,47,59,4,3
22,348,348,157,119,38,2,1
19,359,359,62,62,0,1,0
11,361,361,17,17,0,1,0
2,361,361,34,30,4,2,1
1,374,374,31,10,21,4,3
18,381,381,22,6,16,3,2
17,425,425,2,2,0,1,0
4,429,429,70,48,22,2,1
7,432,432,3,3,0,1,0
0,437,437,25,25,0,1,0
15,442,442,75,70,5,2,1
16,443,443,7,7,0,1,0

14,131,131,5,5,0,1,0
13,139,139,1,1,0,1,0
15,216,216,4,4,0,1,0
9,243,243,46,46,0,1,0
3,256,256,41,41,0,1,0
11,272,272,42,42,0,1,0
10,278,278,10,10,0,1,0
19,284,284,61,61,0,1,0
21,294,294,8,8,0,1,0
7,301,301,37,37,0,1,0
4,310,310,5,5,0,1,0
23,331,331,21,1,20,2,1
2,354,354,82,10,72,3,2
5,363,363,16,6,10,3,2
0,368,368,67,67,0,1,0
22,409,409,104,62,42,2,1
18,415,415,32,32,0,1,0
1,418,418,126,87,39,4,3
12,425,425,41,29,12,3,2
8,444,444,12,12,0,1,0
17,473,473,1,1,0,1,0
20,489,489,115,115,0,1,0
6,495,495,63,63,0,1,0
16,498,498,98,98,0,1,0

3,100,100,5,5,0,1,0
22,102,102,1,1,0,1,0
29,107,107,37,16,21,4,3
20,112,112,10,7,3,2,1
6,122,122,1,1,0,1,0
8,124,124,6,6,0,1,0
11,126,126,1,1,0,1,0
14,135,135,2,2,0,1,0
9,153,153,40,32,8,2,1
21,183,183,37,1,36,4,3
18,188,188,21,21,0,1,0
33,189,189,34,34,0,1,0
32,208,208,25,4,21,2,1
19,215,215,6,6,0,1,0
25,228,228,1,1,0,1,0
2,245,245,32,18,14,2,1
28,254,254,28,28,0,1,0
12,277,277,5,5,0,1,0
4,286,286,1,1,0,1,0
15,304,304,1,1,0,1,0
31,305,305,17,17,0,1,0
30,312,312,13,3,10,3,2
27,312,312,33,33,0,1,0
24,380,380,14,4,10,3,2
16,381,381,37,37,0,1,0
0,391,391,13,6,7,2,1
23,415,415,5,5,0,1,0
1,421,421,8,2,6,3,2
10,421,421,7,7,0,1,0
7,431,431,64,9,55,4,3
26,434,434,50,5,45,4,3
17,465,465,9,5,4,2,1
13,471,471,30,30,0,1,0
5,495,495,158,14,144,4,3

1,103,103,7,7,0,1,0
19,109,109,1,1,0,1,0
4,110,110,14,14,0,1,0
15,159,159,34,13,21,2,1
11,164,164,13,13,0,1,0
13,198,198,1,1,0,1,0
12,212,212,14,14,0,1,0
25,213,213,7,7,0,1,0
9,221,221,2,2,0,1,0
21,224,224,38,9,29,3,2
16,226,226,38,38,0,1,0
5,241,241,44,44,0,1,0
29,256,256,16,9,7,2,1
0,276,276,3,3,0,1,0
10,280,280,81,76,5,2,1
2,307,307,34,28,6,3,2
23,326,326,13,3,10,3,2
28,327,327,42,14,28,2,1
24,362,362,25,7,18,4,3
22,391,391,87,57,30,2,1
3,395,395,25,10,15,4,3
20,415,415,89,79,10,2,1
6,436,436,7,1,6,3,2
27,444,444,78,25,53,4,3
26,454,454,35,20,15,4,3
8,478,478,43,18,25,2,1
17,482,482,17,7,10,3,2
18,488,488,8,8,0,1,0
7,491,491,16,1,15,2,1
14,499,499,19,19,0,1,0

15,103,103,19,19,0,1,0
7,105,105,16,5,11,2,1
5,149,149,3,3,0,1,0
6,156,156,5,5,0,1,0
2,165,165,34,34,0,1,0
20,165,165,33,9,24,2,1
8,173,173,20,20,0,1,0
29,176,176,11,11,0,1,0
22,177,177,3,3,0,1,0
3,179,179,1,1,0,1,0
21,185,185,58,58,0,1,0
25,197,197,2,2,0,1,0
16,222,222,36,21,15,4,3
4,243,243,10,3,7,2,1
17,253,253,56,44,12,4,3
12,253,253,26,26,0,1,0
11,257,257,4,4,0,1,0
0,289,289,5,5,0,1,0
28,299,299,4,4,0,1,0
10,302,302,10,5,5,2,1
19,303,303,7,7,0,1,0
30,318,318,3,3,0,1,0
27,323,323,24,24,0,1,0
9,325,325,55,55,0,1,0
14,326,326,11,5,6,2,1
24,354,354,48,2,46,2,1
1,379,379,32,32,0,1,0
26,407,407,23,23,0,1,0
13,436,436,12,12,0,1,0
18,462,462,6,6,0,1,0
23,472,472,128,128,0,1,0

9,108,108,8,8,0,1,0
25,113,113,8,8,0,1,0
22,121,121,7,1,6,3,2
17,144,144,4,4,0,1,0
6,193,193,23,13,10,3,2
24,216,216,47,20,27,2,1
18,219,219,5,2,3,2,1
5,221,221,5,2,3,2,1
0,248,248,33,33,0,1,0
21,263,263,17,17,0,1,0
2,276,276,24,24,0,1,0
19,294,294,15,15,0,1,0
12,318,318,14,14,0,1,0
13,319,319,3,3,0,1,0
8,330,330,44,20,24,2,1
10,338,338,71,32,39,4,3
20,352,352,8,8,0,1,0
3,375,375,24,24,0,1,0
1,382,382,38,38,0,1,0
23,383,383,128,128,0,1,0
27,398,398,3,3,0,1,0
11,412,412,27,27,0,1,0
4,425,425,34,34,0,1,0
16,444,444,44,1,43,2,1
7,449,449,70,52,18,2,1
28,452,452,54,54,0,1,0
15,482,482,92,92,0,1,0
14,486,486,50,50,0,1,0
26,487,487,64,37,27,2,1

11,107,107,17,17,0,1,0
0,125,125,12,12,0,1,0
20,133,133,3,3,0,1,0
6,136,136,6,2,4,2,1
17,156,156,5,1,4,2,1
15,180,180,13,13,0,1,0
8,196,196,1,1,0,1,0
24,201,201,24,24,0,1,0
2,203,203,26,26,0,1,0
19,220,220,33,15,18,4,3
1,239,239,7,7,0,1,0
14,277,277,42,12,30,2,1
10,285,285,15,7,8,3,2
23,297,297,104,86,18,4,3
5,321,321,1,1,0,1,0
26,336,336,39,15,24,4,3
13,339,339,13,3,10,2,1
9,356,356,127,123,4,2,1
16,362,362,4,4,0,1,0
3,370,370,24,24,0,1,0
4,371,371,8,2,6,2,1
12,382,382,94,1,93,4,3
25,410,410,105,105,0,1,0
7,411,411,2,2,0,1,0
18,423,423,50,50,0,1,0
28,436,436,33,14,19,4,3
22,451,451,3,3,0,1,0
27,457,457,7,3,4,2,1
21,485,485,41,41,0,1,0

1,109,109,10,10,0,1,0
13,169,169,28,20,8,3,2
7,182,182,80,8,72,4,3
14,212,212,3,3,0,1,0
25,226,226,2,2,0,1,0
17,232,232,10,10,0,1,0
8,267,267,50,15,35,2,1
3,269,269,17,8,9,2,1
12,289,289,27,23,4,2,1
5,304,304,15,1,14,3,2
0,315,315,30,16,14,2,1
9,317,317,58,25,33,2,1
19,320,320,51,5,46,2,1
10,329,329,11,11,0,1,0
15,330,330,77,77,0,1,0
16,393,393,106,67,39,4,3
18,393,393,17,17,0,1,0
23,422,422,92,92,0,1,0
11,441,441,33,13,20,2,1
22,443,443,16,2,14,4,3
24,448,448,25,25,0,1,0
2,453,453,74,74,0,1,0
20,457,457,31,31,0,1,0
4,465,465,6,3,3,2,1
6,474,474,3,3,0,1,0
21,499,499,9,5,4,2,1

16,103,103,4,4,0,1,0
4,107,107,9,9,0,1,0
9,142,142,1,1,0,1,0
1,144,144,27,18,9,4,3
28,184,184,23,23,0,1,0
0,196,196,22,22,0,1,0
8,208,208,11,3,8,2,1
10,234,234,1,1,0,1,0
23,241,241,21,12,9,4,3
3,252,252,47,32,15,4,3
25,260,260,52,32,20,2,1
22,270,270,40,10,30,4,3
12,274,274,32,12,20,3,2
15,300,300,14,2,12,3,2
14,312,312,7,7,0,1,0
11,328,328,55,37,18,3,2
27,346,346,69,32,37,4,3
24,386,386,16,16,0,1,0
21,390,390,45,14,31,2,1
26,411,411,21,3,18,3,2
19,413,413,51,23,28,2,1
6,426,426,1,1,0,1,0
18,438,438,36,36,0,1,0
5,447,447,13,5,8,2,1
20,448,448,8,8,0,1,0
17,461,461,68,32,36,2,1
29,466,466,25,25,0,1,0
7,491,491,55,7,48,4,3
13,493,493,88,53,35,3,2
2,494,494,45,17,28,2,1

9,103,103,4,4,0,1,0
15,132,132,8,8,0,1,0
17,136,136,5,5,0,1,0
22,166,166,28,28,0,1,0
16,182,182,18,18,0,1,0
13,215,215,10,10,0,1,0
14,227,227,23,23,0,1,0
25,232,232,20,2,18,4,3
4,285,285,10,2,8,2,1
20,289,289,11,11,0,1,0
2,297,297,20,20,0,1,0
3,297,297,12,4,8,2,1
10,319,319,4,4,0,1,0
12,321,321,4,4,0,1,0
26,358,358,32,8,24,4,3
7,363,363,122,48,74,3,2
18,364,364,18,9,9,4,3
6,406,406,36,36,0,1,0
19,428,428,67,22,45,4,3
21,434,434,172,172,0,1,0
24,438,438,1,1,0,1,0
8,471,471,204,204,0,1,0
23,471,471,48,48,0,1,0
5,472,472,2,2,0,1,0
11,482,482,71,71,0,1,0
0,485,485,34,34,0,1,0
1,489,489,57,22,35,2,1

13,126,126,5,5,0,1,0
18,155,155,19,14,5,2,1
19,160,160,3,3,0,1,0
21,177,177,14,5,9,4,3
20,202,202,9,9,0,1,0
11,204,204,76,29,47,4,3
0,205,205,9,9,0,1,0
23,215,215,10,10,0,1,0
30,226,226,7,7,0,1,0
9,243,243,13,9,4,2,1
17,249,249,1,1,0,1,0
10,259,259,2,2,0,1,0
25,302,302,27,3,24,3,2
24,315,315,41,23,18,4,3
2,317,317,7,7,0,1,0
14,325,325,45,45,0,1,0
6,348,348,33,1,32,2,1
3,352,352,12,2,10,3,2
28,361,361,8,3,5,2,1
31,371,371,55,17,38,2,1
22,377,377,92,67,25,4,3
16,389,389,53,53,0,1,0
26,392,392,9,1,8,2,1
29,396,396,16,16,0,1,0
15,401,401,13,13,0,1,0
7,406,406,27,11,16,2,1
4,420,420,17,5,12,2,1
32,425,425,156,120,36,4,3
8,441,441,5,5,0,1,0
12,449,449,22,22,0,1,0
5,460,460,43,43,0,1,0
1,467,467,20,12,8,3,2
27,481,481,68,20,48,3,2

5,103,103,16,5,11,2,1
20,105,105,10,10,0,1,0
1,115,115,41,23,18,2,1
4,122,122,14,6,8,3,2
10,124,124,22,8,14,3,2
14,166,166,9,9,0,1,0
21,187,187,43,1,42,4,3
11,206,206,43,13,30,3,2
9,224,224,5,5,0,1,0
7,273,273,57,25,32,2,1
13,304,304,7,3,4,2,1
17,307,307,58,58,0,1,0
3,349,349,11,8,3,2,1
12,364,364,30,30,0,1,0
18,416,416,45,3,42,4,3
2,428,428,93,9,84,3,2
8,438,438,70,70,0,1,0
19,456,456,32,1,31,2,1
16,463,463,1,1,0,1,0
15,464,464,2,2,0,1,0
6,484,484,48,32,16,2,1
0,490,490,107,65,42,4,3

7,106,106,3,3,0,1,0
3,109,109,10,10,0,1,0
24,113,113,12,4,8,2,1
2,115,115,5,5,0,1,0
25,116,116,1,1,0,1,0
20,118,118,22,22,0,1,0
4,127,127,4,4,0,1,0
10,146,146,15,1,14,3,2
26,165,165,9,9,0,1,0
22,181,181,5,5,0,1,0
17,218,218,17,17,0,1,0
27,223,223,19,12,7,2,1
21,227,227,64,64,0,1,0
19,228,228,23,9,14,2,1
18,230,230,4,4,0,1,0
11,249,249,41,41,0,1,0
5,266,266,13,13,0,1,0
15,301,301,9,4,5,2,1
14,333,333,34,13,21,4,3
12,354,354,65,61,4,2,1
16,365,365,26,26,0,1,0
9,372,372,80,18,62,4,3
28,376,376,97,97,0,1,0
23,404,404,10,10,0,1,0
29,422,422,57,33,24,3,2
13,431,431,62,17,45,2,1
0,438,438,10,10,0,1,0
6,470,470,5,5,0,1,0
1,484,484,51,8,43,2,1
8,498,498,38,10,28,4,3

21,120,120,3,3,0,1,0
18,126,126,21,14,7,2,1
22,139,139,18,2,16,3,2
26,149,149,2,2,0,1,0
7,173,173,1,1,0,1,0
12,200,200,7,7,0,1,0
19,216,216,10,10,0,1,0
24,232,232,17,17,0,1,0
16,255,255,19,19,0,1,0
13,260,260,45,45,0,1,0
23,263,263,17,17,0,1,0
28,266,266,89,8,81,4,3
3,266,266,1,1,0,1,0
11,273,273,6,2,4,2,1
9,285,285,27,17,10,3,2
2,289,289,14,8,6,3,2
6,298,298,11,5,6,3,2
8,325,325,3,3,0,1,0
14,357,357,1,1,0,1,0
10,375,375,52,15,37,2,1
25,376,376,10,4,6,3,2
17,382,382,19,19,0,1,0
15,390,390,127,53,74,4,3
5,415,415,124,111,13,2,1
4,421,421,186,186,0,1,0
20,429,429,27,1,26,3,2
0,436,436,28,12,16,2,1
1,454,454,12,12,0,1,0
27,499,499,22,9,13,2,1

5,128,128,12,12,0,1,0
20,174,174,2,2,0,1,0
12,174,174,4,4,0,1,0
2,178,178,2,2,0,1,0
16,198,198,13,13,0,1,0
10,216,216,14,14,0,1,0
6,231,231,5,5,0,1,0
14,252,252,2,2,0,1,0
21,259,259,37,37,0,1,0
11,264,264,53,53,0,1,0
0,265,265,130,91,39,2,1
7,267,267,47,47,0,1,0
8,271,271,38,38,0,1,0
19,293,293,11,11,0,1,0
18,307,307,19,19,0,1,0
24,322,322,72,72,0,1,0
1,341,341,58,58,0,1,0
13,346,346,148,118,30,4,3
22,363,363,24,24,0,1,0
9,377,377,57,27,30,4,3
23,384,384,4,1,3,2,1
4,403,403,1,1,0,1,0
17,440,440,40,12,28,3,2
3,475,475,39,19,20,3,2
15,490,490,25,25,0,1,0

1,123,123,3,3,0,1,0
19,152,152,15,15,0,1,0
14,156,156,24,24,0,1,0
5,164,164,14,14,0,1,0
10,171,171,12,12,0,1,0
12,200,200,3,3,0,1,0
2,205,205,24,10,14,2,1
18,222,222,64,64,0,1,0
7,223,223,47,11,36,4,3
25,224,224,4,4,0,1,0
16,232,232,1,1,0,1,0
11,241,241,3,3,0,1,0
17,242,242,60,60,0,1,0
13,244,244,46,29,17,2,1
15,252,252,4,4,0,1,0
6,291,291,69,9,60,3,2
22,297,297,9,9,0,1,0
0,306,306,30,30,0,1,0
8,329,329,40,40,0,1,0
4,331,331,78,59,19,4,3
21,349,349,31,13,18,4,3
26,351,351,35,35,0,1,0
9,407,407,38,38,0,1,0
23,452,452,5,5,0,1,0
20,465,465,26,5,21,4,3
24,485,485,64,64,0,1,0
3,500,500,41,41,0,1,0

23,130,130,5,2,3,2,1
10,145,145,1,1,0,1,0
19,155,155,29,29,0,1,0
20,171,171,9,9,0,1,0
6,173,173,16,16,0,1,0
1,195,195,20,15,5,2,1
24,196,196,8,2,6,3,2
12,199,199,31,31,0,1,0
27,202,202,42,42,0,1,0
13,243,243,36,10,26,2,1
4,247,247,38,20,18,4,3
8,249,249,35,35,0,1,0
16,261,261,18,9,9,4,3
25,323,323,68,68,0,1,0
0,326,326,5,2,3,2,1
2,332,332,14,14,0,1,0
11,338,338,37,11,26,4,3
5,340,340,1,1,0,1,0
17,345,345,6,3,3,2,1
7,357,357,109,37,72,4,3
21,361,361,82,82,0,1,0
22,402,402,20,20,0,1,0
9,416,416,42,32,10,2,1
26,427,427,21,21,0,1,0
18,428,428,5,5,0,1,0
14,461,461,9,9,0,1,0
28,467,467,70,31,39,4,3
3,472,472,2,2,0,1,0
15,487,487,55,51,4,2,1

6,139,139,6,3,3,2,1
20,154,154,5,5,0,1,0
17,180,180,9,1,8,3,2
7,184,184,50,16,34,2,1
0,198,198,8,1,7,2,1
14,266,266,45,45,0,1,0
4,271,271,196,126,70,4,3
12,277,277,87,87,0,1,0
8,285,285,24,24,0,1,0
2,304,304,2,2,0,1,0
16,340,340,42,25,17,2,1
13,390,390,15,15,0,1,0
1,391,391,55,47,8,2,1
5,404,404,4,1,3,2,1
10,430,430,20,17,3,2,1
18,448,448,9,3,6,3,2
11,470,470,15,3,12,2,1
3,471,471,206,196,10,3,2
15,473,473,45,45,0,1,0
9,480,480,43,7,36,3,2
19,480,480,24,10,14,2,1

23,100,100,4,4,0,1,0
27,113,113,26,3,23,2,1
31,123,123,3,3,0,1,0
9,126,126,6,6,0,1,0
22,130,130,4,4,0,1,0
12,131,131,4,4,0,1,0
4,138,138,3,3,0,1,0
18,151,151,5,5,0,1,0
14,153,153,18,4,14,3,2
11,164,164,31,31,0,1,0
28,189,189,14,3,11,2,1
16,189,189,10,10,0,1,0
19,194,194,9,9,0,1,0
15,197,197,1,1,0,1,0
21,214,214,27,27,0,1,0
32,218,218,13,7,6,3,2
10,224,224,3,3,0,1,0
2,227,227,13,13,0,1,0
26,240,240,34,34,0,1,0
8,301,301,1,1,0,1,0
30,303,303,17,2,15,2,1
6,310,310,45,26,19,2,1
20,340,340,20,20,0,1,0
7,363,363,48,48,0,1,0
25,366,366,70,22,48,3,2
17,377,377,23,23,0,1,0
3,383,383,62,62,0,1,0
5,421,421,40,40,0,1,0
0,435,435,15,2,13,4,3
1,453,453,18,10,8,2,1
33,454,454,33,33,0,1,0
29,491,491,127,127,0,1,0
24,493,493,37,4,33,4,3
13,493,493,56,24,32,2,1

12,108,108,1,1,0,1,0
6,110,110,3,3,0,1,0
21,121,121,21,7,14,3,2
8,133,133,24,3,21,2,1
3,143,143,10,10,0,1,0
33,145,145,4,4,0,1,0
17,147,147,7,7,0,1,0
5,168,168,3,3,0,1,0
24,172,172,70,20,50,4,3
31,173,173,24,24,0,1,0
2,181,181,1,1,0,1,0
27,181,181,5,1,4,2,1
28,188,188,4,4,0,1,0
11,213,213,8,8,0,1,0
19,216,216,63,9,54,3,2
9,237,237,4,1,3,2,1
1,239,239,6,6,0,1,0
4,260,260,19,7,12,2,1
16,266,266,1,1,0,1,0
14,313,313,15,7,8,2,1
10,333,333,46,25,21,4,3
13,355,355,1,1,0,1,0
25,361,361,76,30,46,2,1
0,402,402,65,55,10,2,1
22,421,421,25,25,0,1,0
18,422,422,7,7,0,1,0
30,422,422,8,8,0,1,0
23,436,436,30,18,12,2,1
15,460,460,1,1,0,1,0
32,465,465,80,20,60,4,3
26,468,468,13,3,10,2,1
20,483,483,22,22,0,1,0
29,492,492,14,14,0,1,0
7,494,494,113,83,30,2,1

14,106,106,5,1,4,2,1
19,128,128,35,11,24,4,3
23,139,139,2,2,0,1,0
10,154,154,78,12,66,3,2
7,163,163,1,1,0,1,0
0,173,173,7,3,4,2,1
1,204,204,43,34,9,2,1
15,208,208,10,6,4,2,1
27,211,211,25,25,0,1,0
12,214,214,1,1,0,1,0
29,226,226,45,3,42,3,2
13,228,228,9,4,5,2,1
21,260,260,85,40,45,4,3
20,260,260,4,4,0,1,0
16,261,261,47,47,0,1,0
18,280,280,13,3,10,3,2
22,301,301,11,11,0,1,0
11,319,319,30,21,9,2,1
9,319,319,1,1,0,1,0
25,338,338,23,5,18,4,3
3,351,351,2,2,0,1,0
30,358,358,5,5,0,1,0
26,359,359,76,14,62,3,2
17,361,361,21,21,0,1,0
8,361,361,39,39,0,1,0
5,375,375,5,5,0,1,0
24,378,378,11,2,9,4,3
6,379,379,8,3,5,2,1
28,433,433,3,3,0,1,0
4,484,484,5,5,0,1,0
2,494,494,32,32,0,1,0

15,108,108,3,3,0,1,0
25,109,109,5,5,0,1,0
20,133,133,41,36,5,2,1
10,146,146,46,46,0,1,0
23,147,147,11,1,10,2,1
17,152,152,28,17,11,2,1
26,186,186,4,4,0,1,0
8,195,195,1,1,0,1,0
6,227,227,15,9,6,3,2
27,234,234,26,10,16,2,1
16,238,238,40,28,12,2,1
18,241,241,11,4,7,2,1
0,255,255,31,25,6,3,2
24,257,257,16,16,0,1,0
21,282,282,10,7,3,2,1
4,289,289,3,3,0,1,0
12,324,324,40,27,13,2,1
28,341,341,62,4,58,3,2
2,350,350,27,27,0,1,0
14,374,374,1,1,0,1,0
13,379,379,11,8,3,2,1
19,388,388,31,31,0,1,0
7,393,393,30,1,29,2,1
3,405,405,6,3,3,2,1
22,418,418,37,37,0,1,0
1,419,419,5,5,0,1,0
11,479,479,56,56,0,1,0
9,479,479,17,17,0,1,0
5,484,484,191,171,20,3,2

14,106,106,4,4,0,1,0
3,115,115,37,26,11,2,1
0,149,149,14,8,6,2,1
26,156,156,16,16,0,1,0
7,210,210,17,17,0,1,0
12,215,215,12,12,0,1,0
20,238,238,3,3,0,1,0
17,247,247,14,3,11,2,1
24,251,251,53,39,14,2,1
13,252,252,4,1,3,2,1
15,285,285,102,17,85,4,3
27,288,288,21,3,18,3,2
2,298,298,17,1,16,2,1
10,315,315,36,36,0,1,0
4,320,320,21,1,20,3,2
22,322,322,43,43,0,1,0
11,333,333,9,9,0,1,0
6,339,339,128,89,39,4,3
19,345,345,42,42,0,1,0
1,352,352,16,7,9,2,1
18,356,356,2,2,0,1,0
5,369,369,21,21,0,1,0
21,396,396,11,5,6,3,2
16,419,419,105,63,42,4,3
25,423,423,1,1,0,1,0
9,447,447,36,33,3,2,1
23,473,473,17,17,0,1,0
8,483,483,4,4,0,1,0

18,110,110,2,2,0,1,0
9,115,115,40,40,0,1,0
1,122,122,3,3,0,1,0
4,124,124,9,9,0,1,0
23,163,163,19,15,4,2,1
7,165,165,4,4,0,1,0
21,168,168,9,9,0,1,0
31,172,172,3,3,0,1,0
28,191,191,28,10,18,2,1
8,199,199,8,3,5,2,1
25,229,229,15,15,0,1,0
20,250,250,23,23,0,1,0
0,258,258,17,17,0,1,0
10,276,276,1,1,0,1,0
29,283,283,36,14,22,2,1
3,284,284,4,4,0,1,0
32,284,284,80,44,36,3,2
6,316,316,47,8,39,2,1
12,318,318,7,7,0,1,0
5,325,325,6,1,5,2,1
30,343,343,28,28,0,1,0
22,358,358,41,27,14,2,1
27,401,401,9,3,6,3,2
19,411,411,96,65,31,3,2
17,416,416,3,3,0,1,0
14,423,423,39,39,0,1,0
16,440,440,33,18,15,3,2
24,441,441,21,7,14,3,2
2,442,442,104,17,87,4,3
15,452,452,47,12,35,2,1
11,455,455,42,10,32,4,3
13,465,465,1,1,0,1,0
26,474,474,12,5,7,2,1

13,103,103,23,2,21,4,3
22,116,116,10,1,9,4,3
8,120,120,8,8,0,1,0
1,136,136,5,1,4,2,1
24,146,146,36,24,12,4,3
19,181,181,23,9,14,2,1
29,188,188,43,43,0,1,0
11,220,220,2,2,0,1,0
15,225,225,70,70,0,1,0
28,259,259,1,1,0,1,0
23,264,264,15,15,0,1,0
18,282,282,15,15,0,1,0
7,289,289,16,16,0,1,0
14,292,292,39,39,0,1,0
6,292,292,3,3,0,1,0
4,293,293,15,6,9,4,3
9,335,335,34,19,15,4,3
20,363,363,6,6,0,1,0
16,366,366,20,20,0,1,0
26,367,367,30,30,0,1,0
0,389,389,10,10,0,1,0
27,400,400,16,16,0,1,0
25,400,400,150,42,108,4,3
2,412,412,52,35,17,2,1
10,427,427,8,3,5,2,1
17,433,433,3,3,0,1,0
3,449,449,3,3,0,1,0
5,471,471,5,5,0,1,0
21,480,480,25,22,3,2,1
12,481,481,103,81,22,3,2

7,123,123,22,1,21,2,1
10,150,150,35,35,0,1,0
8,178,178,8,8,0,1,0
23,185,185,4,1,3,2,1
15,237,237,34,16,18,2,1
4,241,241,53,21,32,3,2
2,246,246,16,16,0,1,0
18,247,247,25,4,21,4,3
20,249,249,6,6,0,1,0
6,259,259,28,28,0,1,0
12,263,263,12,3,9,2,1
22,313,313,33,1,32,2,1
1,331,331,6,6,0,1,0
16,336,336,7,7,0,1,0
3,346,346,16,2,14,2,1
11,388,388,38,38,0,1,0
9,398,398,1,1,0,1,0
21,418,418,3,3,0,1,0
5,425,425,68,18,50,2,1
14,426,426,54,54,0,1,0
13,445,445,36,16,20,2,1
25,456,456,192,192,0,1,0
17,460,460,95,85,10,2,1
0,468,468,106,106,0,1,0
24,489,489,16,16,0,1,0
19,492,492,40,4,36,4,3

17,145,145,30,6,24,3,2
10,153,153,1,1,0,1,0
3,160,160,3,3,0,1,0
24,174,174,26,26,0,1,0
8,210,210,1,1,0,1,0
13,210,210,13,1,12,4,3
1,215,215,62,22,40,3,2
11,220,220,15,15,0,1,0
16,222,222,31,4,27,4,3
18,230,230,20,2,18,3,2
25,238,238,28,13,15,2,1
15,265,265,61,7,54,4,3
9,269,269,23,23,0,1,0
0,271,271,15,15,0,1,0
19,287,287,7,7,0,1,0
12,323,323,11,11,0,1,0
29,330,330,35,35,0,1,0
26,346,346,21,21,0,1,0
28,355,355,69,69,0,1,0
20,398,398,26,26,0,1,0
5,413,413,12,7,5,2,1
22,415,415,12,4,8,2,1
4,434,434,63,34,29,2,1
6,439,439,132,66,66,4,3
14,448,448,2,2,0,1,0
21,455,455,36,8,28,4,3
7,471,471,11,11,0,1,0
23,477,477,14,5,9,2,1
2,483,483,22,22,0,1,0
27,492,492,63,54,9,4,3

7,104,104,3,3,0,1,0
1,117,117,20,20,0,1,0
23,130,130,4,4,0,1,0
14,133,133,8,5,3,2,1
8,149,149,1,1,0,1,0
20,155,155,4,4,0,1,0
15,218,218,5,5,0,1,0
26,220,220,3,3,0,1,0
12,230,230,1,1,0,1,0
16,235,235,1,1,0,1,0
5,252,252,3,3,0,1,0
4,276,276,9,6,3,2,1
24,280,280,32,10,22,4,3
27,297,297,8,8,0,1,0
6,304,304,68,7,61,4,3
17,340,340,33,1,32,3,2
21,343,343,92,59,33,4,3
18,348,348,140,88,52,4,3
9,358,358,11,8,3,2,1
2,361,361,148,148,0,1,0
0,378,378,73,73,0,1,0
10,394,394,1,1,0,1,0
3,397,397,2,2,0,1,0
25,403,403,26,26,0,1,0
19,422,422,64,6,58,3,2
13,438,438,67,67,0,1,0
28,451,451,47,47,0,1,0
11,452,452,32,9,23,2,1
22,459,459,45,18,27,2,1

1,111,111,3,3,0,1,0
13,111,111,13,13,0,1,0
26,118,118,1,1,0,1,0
12,128,128,13,7,6,3,2
5,131,131,8,3,5,2,1
6,150,150,4,4,0,1,0
10,163,163,5,5,0,1,0
29,190,190,58,11,47,2,1
20,202,202,7,7,0,1,0
28,214,214,28,20,8,3,2
16,217,217,33,33,0,1,0
18,252,252,6,6,0,1,0
11,268,268,13,13,0,1,0
21,320,320,19,2,17,2,1
23,337,337,27,27,0,1,0
7,360,360,18,8,10,3,2
0,373,373,41,41,0,1,0
9,387,387,9,9,0,1,0
25,388,388,83,47,36,4,3
8,388,388,18,8,10,2,1
24,398,398,29,29,0,1,0
14,410,410,56,56,0,1,0
4,430,430,203,203,0,1,0
3,436,436,41,41,0,1,0
19,453,453,7,7,0,1,0
2,457,457,21,8,13,4,3
15,463,463,5,5,0,1,0
27,463,463,117,67,50,2,1
22,464,464,6,3,3,2,1
17,473,473,31,31,0,1,0

7,101,101,13,1,12,2,1
2,130,130,18,10,8,2,1
5,141,141,31,31,0,1,0
10,144,144,35,35,0,1,0
22,149,149,19,19,0,1,0
18,149,149,3,3,0,1,0
6,169,169,5,5,0,1,0
0,179,179,26,26,0,1,0
4,190,190,22,22,0,1,0
9,211,211,5,2,3,2,1
11,302,302,53,3,50,3,2
1,340,340,47,47,0,1,0
21,343,343,3,3,0,1,0
20,353,353,39,9,30,3,2
3,375,375,84,84,0,1,0
13,417,417,54,54,0,1,0
8,424,424,111,31,80,3,2
16,426,426,11,5,6,3,2
12,429,429,11,11,0,1,0
15,443,443,49,22,27,4,3
19,485,485,131,86,45,4,3
14,492,492,56,56,0,1,0
17,500,500,22,22,0,1,0

5,107,107,17,17,0,1,0
6,121,121,1,1,0,1,0
18,124,124,1,1,0,1,0
20,128,128,8,3,5,2,1
7,129,129,60,60,0,1,0
33,141,141,40,40,0,1,0
30,141,141,15,8,7,2,1
21,145,145,15,2,13,2,1
28,149,149,7,4,3,2,1
22,162,162,22,12,10,3,2
13,162,162,1,1,0,1,0
12,168,168,1,1,0,1,0
35,174,174,22,1,21,2,1
34,176,176,13,13,0,1,0
9,206,206,26,26,0,1,0
15,239,239,1,1,0,1,0
19,288,288,22,22,0,1,0
24,290,290,23,1,22,2,1
1,291,291,38,38,0,1,0
26,298,298,6,6,0,1,0
17,306,306,6,1,5,2,1
0,317,317,16,6,10,3,2
32,317,317,12,12,0,1,0
2,317,317,4,4,0,1,0
14,340,340,2,2,0,1,0
4,350,350,5,5,0,1,0
31,370,370,51,51,0,1,0
27,387,387,1,1,0,1,0
29,424,424,143,110,33,4,3
11,439,439,7,7,0,1,0
16,459,459,1,1,0,1,0
8,470,470,4,4,0,1,0
25,477,477,10,10,0,1,0
23,483,483,14,14,0,1,0
10,484,484,38,38,0,1,0
3,487,487,18,10,8,3,2

18,109,109,5,5,0,1,0
8,120,120,1,1,0,1,0
20,130,130,2,2,0,1,0
4,138,138,17,8,9,4,3
3,149,149,70,25,45,4,3
24,165,165,24,24,0,1,0
13,183,183,50,50,0,1,0
5,200,200,63,63,0,1,0
2,252,252,3,3,0,1,0
12,308,308,8,8,0,1,0
0,341,341,43,43,0,1,0
14,347,347,25,25,0,1,0
15,351,351,10,5,5,2,1
10,353,353,31,2,29,2,1
7,361,361,29,3,26,3,2
9,365,365,1,1,0,1,0
25,375,375,49,49,0,1,0
21,390,390,60,11,49,4,3
1,401,401,4,4,0,1,0
6,405,405,18,18,0,1,0
23,410,410,74,74,0,1,0
17,445,445,100,83,17,2,1
11,451,451,55,45,10,2,1
19,452,452,1,1,0,1,0
22,467,467,3,3,0,1,0
16,497,497,58,24,34,3,2

17,105,105,42,42,0,1,0
25,117,117,8,1,7,2,1
12,160,160,2,2,0,1,0
22,179,179,7,3,4,2,1
4,188,188,10,10,0,1,0
9,188,188,8,8,0,1,0
2,199,199,4,4,0,1,0
24,204,204,13,1,12,3,2
16,209,209,15,15,0,1,0
8,226,226,30,30,0,1,0
14,240,240,1,1,0,1,0
13,280,280,16,4,12,4,3
1,283,283,14,1,13,2,1
27,293,293,51,9,42,4,3
19,307,307,11,11,0,1,0
7,309,309,33,33,0,1,0
21,319,319,10,1,9,2,1
3,324,324,230,172,58,4,3
11,335,335,2,2,0,1,0
5,337,337,30,1,29,2,1
26,352,352,37,3,34,3,2
10,369,369,10,10,0,1,0
23,379,379,50,31,19,2,1
0,410,410,4,4,0,1,0
20,429,429,32,32,0,1,0
6,475,475,40,40,0,1,0
15,479,479,90,24,66,3,2
18,479,479,22,22,0,1,0

14,118,118,3,3,0,1,0
12,245,245,10,10,0,1,0
17,247,247,24,1,23,4,3
3,247,247,64,33,31,2,1
9,251,251,4,4,0,1,0
19,256,256,4,4,0,1,0
1,259,259,3,3,0,1,0
0,260,260,53,41,12,4,3
13,298,298,1,1,0,1,0
10,306,306,56,25,31,2,1
20,309,309,23,5,18,2,1
5,322,322,129,24,105,4,3
11,359,359,75,18,57,4,3
8,379,379,20,20,0,1,0
2,379,379,10,4,6,2,1
7,393,393,95,95,0,1,0
4,445,445,106,63,43,2,1
16,459,459,137,65,72,4,3
15,460,460,38,23,15,4,3
6,467,467,122,20,102,4,3
18,494,494,47,47,0,1,0

10,110,110,24,24,0,1,0
0,113,113,1,1,0,1,0
13,168,168,9,9,0,1,0
12,186,186,2,2,0,1,0
8,193,193,14,2,12,3,2
21,209,209,7,1,6,3,2
20,265,265,30,30,0,1,0
17,274,274,54,12,42,4,3
9,282,282,29,29,0,1,0
2,298,298,1,1,0,1,0
15,322,322,27,27,0,1,0
18,330,330,99,99,0,1,0
5,337,337,68,68,0,1,0
14,408,408,58,58,0,1,0
1,444,444,144,47,97,4,3
11,452,452,23,14,9,2,1
4,460,460,211,160,51,4,3
19,470,470,20,20,0,1,0
7,477,477,111,90,21,2,1
3,490,490,55,15,40,4,3
16,496,496,6,6,0,1,0
6,497,497,29,18,11,2,1

5,104,104,2,2,0,1,0
32,128,128,4,4,0,1,0
26,141,141,18,18,0,1,0
9,147,147,1,1,0,1,0
3,219,219,19,1,18,3,2
28,221,221,21,3,18,4,3
18,222,222,8,8,0,1,0
21,223,223,8,8,0,1,0
7,252,252,62,62,0,1,0
10,257,257,2,2,0,1,0
12,268,268,10,10,0,1,0
6,283,283,3,3,0,1,0
33,290,290,70,4,66,3,2
16,295,295,55,10,45,2,1
1,311,311,10,2,8,3,2
29,314,314,8,2,6,3,2
23,317,317,26,2,24,4,3
20,318,318,12,6,6,3,2
19,319,319,2,2,0,1,0
14,324,324,22,4,18,4,3
34,329,329,14,14,0,1,0
25,337,337,21,1,20,3,2
15,339,339,31,9,22,3,2
13,377,377,32,3,29,2,1
24,389,389,32,22,10,3,2
22,390,390,17,2,15,2,1
11,401,401,48,7,41,2,1
17,408,408,33,33,0,1,0
4,408,408,2,2,0,1,0
0,429,429,91,52,39,4,3
30,443,443,11,11,0,1,0
27,470,470,197,169,28,3,2
8,473,473,9,1,8,2,1
31,481,481,55,55,0,1,0
2,496,496,4,4,0,1,0

11,101,101,19,5,14,3,2
5,106,106,12,12,0,1,0
29,132,132,1,1,0,1,0
8,143,143,7,7,0,1,0
27,172,172,4,4,0,1,0
22,180,180,16,10,6,2,1
21,187,187,18,9,9,4,3
6,188,188,37,20,17,2,1
12,203,203,8,8,0,1,0
4,207,207,2,2,0,1,0
25,207,207,5,5,0,1,0
13,213,213,9,9,0,1,0
1,245,245,16,16,0,1,0
16,254,254,9,9,0,1,0
26,257,257,30,30,0,1,0
7,261,261,7,7,0,1,0
19,356,356,22,22,0,1,0
9,358,358,57,57,0,1,0
14,379,379,5,5,0,1,0
20,384,384,133,97,36,3,2
2,388,388,1,1,0,1,0
18,390,390,113,113,0,1,0
28,421,421,7,1,6,2,1
24,433,433,59,34,25,3,2
3,449,449,53,53,0,1,0
17,456,456,33,33,0,1,0
23,457,457,48,48,0,1,0
0,467,467,69,69,0,1,0
15,479,479,5,5,0,1,0
10,479,479,105,105,0,1,0

15,123,123,7,7,0,1,0
9,173,173,12,12,0,1,0
6,175,175,33,33,0,1,0
4,198,198,10,10,0,1,0
24,200,200,2,2,0,1,0
3,225,225,1,1,0,1,0
21,242,242,11,11,0,1,0
2,265,265,16,13,3,2,1
0,267,267,18,13,5,2,1
10,280,280,16,16,0,1,0
7,285,285,39,23,16,2,1
20,286,286,3,3,0,1,0
25,326,326,114,114,0,1,0
11,341,341,3,3,0,1,0
19,377,377,122,26,96,4,3
14,395,395,61,24,37,2,1
1,411,411,74,74,0,1,0
12,426,426,50,50,0,1,0
26,432,432,20,14,6,3,2
17,435,435,9,3,6,3,2
23,445,445,27,4,23,2,1
8,448,448,197,56,141,4,3
22,450,450,52,34,18,4,3
18,463,463,41,23,18,4,3
16,469,469,9,9,0,1,0
5,481,481,10,7,3,2,1
13,488,488,58,18,40,3,2

5,126,126,86,76,10,3,2
10,153,153,50,17,33,2,1
2,188,188,30,15,15,4,3
0,203,203,19,4,15,4,3
15,205,205,3,3,0,1,0
4,226,226,65,4,61,4,3
14,270,270,15,15,0,1,0
7,271,271,5,1,4,2,1
16,291,291,12,12,0,1,0
17,308,308,41,25,16,3,2
8,312,312,19,9,10,3,2
18,318,318,36,6,30,2,1
12,329,329,60,60,0,1,0
1,374,374,37,37,0,1,0
11,400,400,30,26,4,2,1
9,409,409,34,34,0,1,0
6,421,421,50,50,0,1,0
13,468,468,64,57,7,2,1
3,479,479,41,21,20,3,2
19,488,488,30,30,0,1,0

5,102,102,24,6,18,3,2
1,106,106,15,15,0,1,0
13,150,150,17,1,16,2,1
16,155,155,43,1,42,3,2
20,157,157,3,3,0,1,0
8,159,159,9,9,0,1,0
2,203,203,8,5,3,2,1
10,215,215,8,8,0,1,0
25,245,245,35,8,27,2,1
6,277,277,80,42,38,3,2
3,282,282,7,7,0,1,0
4,282,282,30,18,12,3,2
24,286,286,12,12,0,1,0
26,290,290,47,47,0,1,0
15,295,295,53,53,0,1,0
0,301,301,59,1,58,3,2
7,311,311,24,24,0,1,0
14,323,323,6,6,0,1,0
11,348,348,10,6,4,2,1
18,368,368,43,43,0,1,0
19,383,383,44,5,39,4,3
9,387,387,14,14,0,1,0
12,409,409,10,10,0,1,0
23,417,417,52,52,0,1,0
17,442,442,1,1,0,1,0
27,454,454,11,5,6,2,1
22,479,479,52,5,47,2,1
21,488,488,42,42,0,1,0

3,117,117,1,1,0,1,0
16,123,123,7,7,0,1,0
8,136,136,48,48,0,1,0
15,149,149,20,20,0,1,0
24,161,161,25,25,0,1,0
2,192,192,15,8,7,2,1
19,200,200,9,3,6,2,1
20,206,206,17,12,5,2,1
18,206,206,20,20,0,1,0
13,251,251,18,4,14,3,2
6,284,284,77,52,25,2,1
17,289,289,35,18,17,2,1
23,292,292,14,14,0,1,0
14,294,294,13,13,0,1,0
7,344,344,63,58,5,2,1
9,360,360,1,1,0,1,0
0,365,365,11,5,6,3,2
11,377,377,40,29,11,2,1
25,381,381,1,1,0,1,0
5,415,415,24,8,16,2,1
10,423,423,57,49,8,2,1
22,423,423,106,40,66,3,2
1,438,438,38,3,35,4,3
21,449,449,1,1,0,1,0
12,456,456,144,144,0,1,0
4,465,465,42,42,0,1,0

6,103,103,7,1,6,3,2
20,105,105,22,2,20,3,2
12,132,132,2,2,0,1,0
23,138,138,8,1,7,2,1
14,143,143,1,1,0,1,0
9,158,158,1,1,0,1,0
1,159,159,15,11,4,2,1
25,162,162,8,3,5,2,1
8,176,176,7,7,0,1,0
24,197,197,40,18,22,2,1
22,219,219,26,2,24,4,3
4,239,239,21,21,0,1,0
16,246,246,29,7,22,3,2
18,264,264,3,3,0,1,0
15,270,270,122,74,48,3,2
3,290,290,17,17,0,1,0
17,294,294,35,35,0,1,0
11,295,295,4,4,0,1,0
13,311,311,17,7,10,2,1
26,312,312,10,3,7,2,1
2,358,358,28,23,5,2,1
27,365,365,44,44,0,1,0
0,395,395,1,1,0,1,0
21,416,416,10,10,0,1,0
30,435,435,61,29,32,2,1
5,444,444,48,16,32,2,1
28,448,448,123,87,36,4,3
10,460,460,62,24,38,3,2
29,469,469,16,16,0,1,0
19,473,473,15,1,14,3,2
7,486,486,31,31,0,1,0

11,100,100,8,8,0,1,0
26,115,115,25,25,0,1,0
4,138,138,16,4,12,4,3
13,175,175,12,2,10,4,3
17,196,196,26,10,16,3,2
15,201,201,5,5,0,1,0
12,217,217,51,51,0,1,0
25,219,219,29,29,0,1,0
7,228,228,24,24,0,1,0
8,235,235,2,2,0,1,0
9,269,269,34,18,16,3,2
3,273,273,65,24,41,2,1
5,276,276,9,9,0,1,0
27,288,288,30,6,24,3,2
2,298,298,23,12,11,2,1
1,349,349,12,12,0,1,0
20,367,367,38,10,28,2,1
10,373,373,99,60,39,2,1
16,375,375,11,11,0,1,0
0,380,380,2,2,0,1,0
23,403,403,35,11,24,2,1
14,418,418,60,57,3,2,1
18,424,424,52,42,10,2,1
19,434,434,27,27,0,1,0
22,438,438,51,51,0,1,0
24,472,472,25,25,0,1,0
21,487,487,49,28,21,2,1
6,491,491,5,5,0,1,0

32,116,116,42,35,7,2,1
13,141,141,13,2,11,2,1
29,168,168,5,5,0,1,0
30,172,172,16,6,10,3,2
24,175,175,33,21,12,2,1
11,187,187,4,1,3,2,1
22,201,201,21,21,0,1,0
1,209,209,2,2,0,1,0
6,231,231,8,8,0,1,0
2,238,238,27,27,0,1,0
34,248,248,6,6,0,1,0
28,251,251,36,7,29,2,1
0,261,261,8,8,0,1,0
18,270,270,2,2,0,1,0
8,274,274,42,2,40,3,2
9,280,280,81,3,78,4,3
15,289,289,1,1,0,1,0
25,298,298,14,14,0,1,0
7,325,325,16,3,13,2,1
19,342,342,24,10,14,2,1
33,342,342,20,20,0,1,0
10,346,346,6,2,4,2,1
20,356,356,45,45,0,1,0
5,373,373,8,8,0,1,0
21,387,387,15,8,7,2,1
16,388,388,10,10,0,1,0
27,390,390,18,3,15,4,3
12,397,397,39,39,0,1,0
17,420,420,45,32,13,2,1
3,434,434,5,2,3,2,1
31,437,437,33,33,0,1,0
4,450,450,17,17,0,1,0
14,472,472,38,26,12,2,1
23,494,494,89,89,0,1,0
26,500,500,17,17,0,1,0

15,153,153,8,8,0,1,0
13,158,158,41,41,0,1,0
19,159,159,27,27,0,1,0
16,228,228,11,2,9,4,3
3,236,236,15,11,4,2,1
22,238,238,36,36,0,1,0
24,274,274,10,10,0,1,0
4,281,281,4,4,0,1,0
26,298,298,39,12,27,2,1
7,310,310,20,20,0,1,0
8,334,334,33,33,0,1,0
9,339,339,67,19,48,4,3
11,343,343,7,7,0,1,0
5,355,355,16,16,0,1,0
14,368,368,5,5,0,1,0
10,376,376,158,122,36,3,2
17,386,386,89,37,52,4,3
6,397,397,42,42,0,1,0
0,443,443,21,21,0,1,0
20,452,452,9,9,0,1,0
21,457,457,13,13,0,1,0
23,470,470,29,7,22,2,1
2,476,476,115,109,6,3,2
25,478,478,96,89,7,2,1
1,480,480,1,1,0,1,0
18,484,484,14,11,3,2,1
12,492,492,39,39,0,1,0

9,111,111,8,2,6,2,1
26,114,114,9,3,6,3,2
17,117,117,15,6,9,4,3
22,142,142,26,26,0,1,0
20,154,154,11,2,9,2,1
19,193,193,8,8,0,1,0
6,230,230,12,4,8,2,1
10,232,232,23,16,7,2,1
5,243,243,24,24,0,1,0
12,243,243,16,16,0,1,0
13,259,259,89,89,0,1,0
25,263,263,3,3,0,1,0
16,269,269,28,28,0,1,0
4,298,298,10,1,9,2,1
7,312,312,11,7,4,2,1
2,333,333,141,75,66,4,3
11,349,349,1,1,0,1,0
14,356,356,77,9,68,3,2
0,357,357,20,20,0,1,0
8,384,384,18,2,16,3,2
15,387,387,7,1,6,3,2
24,387,387,74,74,0,1,0
18,410,410,18,1,17,2,1
1,424,424,169,165,4,2,1
21,426,426,2,2,0,1,0
23,438,438,1,1,0,1,0
3,449,449,8,8,0,1,0

27,130,130,6,6,0,1,0
18,133,133,9,9,0,1,0
11,150,150,9,1,8,2,1
3,152,152,5,5,0,1,0
7,153,153,14,8,6,3,2
9,163,163,9,9,0,1,0
23,199,199,2,2,0,1,0
25,202,202,6,6,0,1,0
17,206,206,35,35,0,1,0
20,213,213,32,2,30,4,3
13,226,226,33,33,0,1,0
32,230,230,10,3,7,2,1
8,240,240,36,15,21,4,3
26,242,242,70,70,0,1,0
21,244,244,5,2,3,2,1
14,249,249,3,3,0,1,0
29,267,267,62,6,56,3,2
24,276,276,28,11,17,4,3
28,279,279,21,21,0,1,0
31,294,294,28,28,0,1,0
1,333,333,17,17,0,1,0
5,342,342,37,37,0,1,0
16,347,347,39,1,38,3,2
15,369,369,19,19,0,1,0
0,371,371,31,31,0,1,0
10,391,391,19,1,18,2,1
4,428,428,36,26,10,3,2
2,440,440,23,11,12,2,1
30,467,467,131,107,24,2,1
6,475,475,6,6,0,1,0
12,482,482,8,5,3,2,1
19,488,488,18,18,0,1,0
22,489,489,9,9,0,1,0

23,122,122,18,18,0,1,0
1,133,133,18,13,5,2,1
28,140,140,4,4,0,1,0
8,144,144,14,14,0,1,0
30,185,185,11,11,0,1,0
26,197,197,22,22,0,1,0
11,229,229,6,6,0,1,0
24,242,242,68,68,0,1,0
20,242,242,16,5,11,2,1
10,244,244,42,20,22,2,1
27,258,258,6,1,5,2,1
13,265,265,11,11,0,1,0
21,274,274,9,9,0,1,0
22,276,276,74,74,0,1,0
16,307,307,5,5,0,1,0
9,312,312,2,2,0,1,0
4,313,313,18,8,10,3,2
12,318,318,57,57,0,1,0
2,319,319,5,2,3,2,1
18,347,347,3,3,0,1,0
15,366,366,21,18,3,2,1
14,384,384,20,20,0,1,0
17,385,385,34,25,9,2,1
29,396,396,86,15,71,4,3
6,414,414,91,19,72,4,3
5,424,424,28,28,0,1,0
25,440,440,17,17,0,1,0
0,458,458,3,3,0,1,0
19,463,463,30,30,0,1,0
7,463,463,23,23,0,1,0
3,469,469,95,95,0,1,0

19,102,102,26,26,0,1,0
2,102,102,6,6,0,1,0
0,123,123,12,12,0,1,0
22,128,128,35,35,0,1,0
5,134,134,3,3,0,1,0
11,139,139,6,3,3,2,1
1,151,151,2,2,0,1,0
3,163,163,49,49,0,1,0
21,169,169,28,18,10,2,1
15,190,190,10,10,0,1,0
13,210,210,20,13,7,2,1
4,220,220,11,1,10,2,1
20,244,244,37,13,24,4,3
14,256,256,15,5,10,2,1
24,260,260,41,41,0,1,0
17,292,292,7,7,0,1,0
10,305,305,61,24,37,3,2
16,314,314,19,19,0,1,0
23,358,358,17,17,0,1,0
7,381,381,22,22,0,1,0
6,405,405,108,68,40,2,1
12,411,411,2,2,0,1,0
18,436,436,17,17,0,1,0
8,451,451,14,14,0,1,0
9,469,469,142,102,40,3,2

3,107,107,1,1,0,1,0
9,117,117,6,6,0,1,0
5,144,144,51,51,0,1,0
8,161,161,13,5,8,2,1
14,184,184,23,23,0,1,0
7,186,186,6,6,0,1,0
17,209,209,28,24,4,2,1
22,235,235,4,1,3,2,1
11,255,255,59,59,0,1,0
26,277,277,2,2,0,1,0
28,280,280,13,13,0,1,0
21,344,344,81,39,42,4,3
25,363,363,137,68,69,4,3
23,365,365,7,1,6,3,2
19,388,388,19,19,0,1,0
2,390,390,5,5,0,1,0
27,391,391,80,80,0,1,0
10,421,421,10,6,4,2,1
12,426,426,11,11,0,1,0
16,447,447,28,28,0,1,0
13,449,449,2,2,0,1,0
15,457,457,25,4,21,2,1
20,470,470,25,20,5,2,1
24,470,470,48,29,19,3,2
6,489,489,10,10,0,1,0
18,490,490,28,28,0,1,0
4,491,491,29,29,0,1,0
1,492,492,109,61,48,4,3
0,493,493,75,55,20,3,2

22,110,110,19,19,0,1,0
32,115,115,10,10,0,1,0
28,116,116,15,12,3,2,1
31,137,137,12,1,11,2,1
17,148,148,1,1,0,1,0
8,151,151,16,16,0,1,0
19,153,153,1,1,0,1,0
6,153,153,5,5,0,1,0
1,165,165,3,3,0,1,0
14,175,175,33,2,31,2,1
29,224,224,51,51,0,1,0
26,244,244,8,8,0,1,0
7,245,245,7,7,0,1,0
33,247,247,1,1,0,1,0
20,249,249,40,28,12,4,3
25,283,283,17,17,0,1,0
27,286,286,56,56,0,1,0
4,290,290,47,11,36,4,3
30,319,319,17,17,0,1,0
15,330,330,13,7,6,2,1
5,335,335,39,39,0,1,0
18,354,354,20,12,8,3,2
21,387,387,37,37,0,1,0
11,400,400,18,8,10,2,1
9,404,404,51,51,0,1,0
3,419,419,18,18,0,1,0
24,429,429,34,34,0,1,0
13,429,429,43,24,19,2,1
0,453,453,17,4,13,4,3
12,456,456,15,6,9,4,3
16,463,463,20,20,0,1,0
2,471,471,31,31,0,1,0
10,482,482,71,71,0,1,0
23,494,494,29,9,20,4,3

22,153,153,18,7,11,2,1
19,171,171,14,14,0,1,0
4,177,177,6,6,0,1,0
16,213,213,26,26,0,1,0
25,228,228,16,16,0,1,0
2,250,250,71,50,21,2,1
23,258,258,26,14,12,2,1
21,263,263,6,6,0,1,0
1,274,274,2,2,0,1,0
6,297,297,2,2,0,1,0
7,310,310,58,26,32,3,2
12,326,326,14,14,0,1,0
14,330,330,11,11,0,1,0
18,337,337,7,4,3,2,1
11,338,338,47,47,0,1,0
0,355,355,55,42,13,2,1
5,380,380,42,35,7,2,1
3,387,387,17,7,10,2,1
10,403,403,97,97,0,1,0
15,405,405,42,18,24,3,2
9,429,429,1,1,0,1,0
17,439,439,180,180,0,1,0
24,458,458,20,20,0,1,0
20,469,469,75,67,8,3,2
13,472,472,41,41,0,1,0
8,486,486,93,20,73,4,3

22,104,104,2,2,0,1,0
2,105,105,31,31,0,1,0
6,141,141,1,1,0,1,0
12,153,153,23,23,0,1,0
16,167,167,11,5,6,3,2
8,170,170,11,2,9,4,3
17,170,170,13,13,0,1,0
13,180,180,16,6,10,3,2
24,190,190,6,6,0,1,0
5,246,246,1,1,0,1,0
18,274,274,23,6,17,2,1
11,293,293,87,66,21,2,1
3,296,296,5,5,0,1,0
4,326,326,1,1,0,1,0
9,336,336,76,70,6,2,1
21,366,366,22,13,9,4,3
26,383,383,60,15,45,4,3
1,394,394,5,5,0,1,0
20,412,412,55,55,0,1,0
19,413,413,15,15,0,1,0
15,418,418,27,27,0,1,0
7,420,420,62,11,51,4,3
23,435,435,78,27,51,3,2
14,439,439,97,69,28,2,1
10,448,448,63,33,30,2,1
25,476,476,103,29,74,3,2
0,492,492,19,19,0,1,0

24,125,125,30,4,26,2,1
17,132,132,4,1,3,2,1
22,157,157,1,1,0,1,0
13,159,159,34,15,19,2,1
4,167,167,4,4,0,1,0
10,171,171,17,1,16,2,1
19,172,172,18,7,11,4,3
11,204,204,9,9,0,1,0
16,205,205,27,27,0,1,0
3,212,212,1,1,0,1,0
8,221,221,26,14,12,4,3
6,249,249,58,58,0,1,0
12,279,279,29,20,9,4,3
7,291,291,91,58,33,2,1
21,295,295,36,36,0,1,0
26,353,353,6,6,0,1,0
2,392,392,16,16,0,1,0
23,409,409,48,48,0,1,0
9,419,419,87,43,44,2,1
5,422,422,50,12,38,2,1
14,426,426,15,15,0,1,0
20,432,432,102,9,93,4,3
15,445,445,39,7,32,3,2
1,451,451,32,32,0,1,0
25,454,454,33,19,14,3,2
18,466,466,6,1,5,2,1
0,500,500,13,4,9,2,1

26,100,100,2,2,0,1,0
5,116,116,3,3,0,1,0
0,124,124,1,1,0,1,0
28,127,127,12,12,0,1,0
17,132,132,11,11,0,1,0
23,156,156,1,1,0,1,0
22,167,167,18,9,9,4,3
1,172,172,10,3,7,2,1
24,196,196,9,5,4,2,1
20,203,203,62,40,22,3,2
10,204,204,1,1,0,1,0
4,223,223,1,1,0,1,0
6,241,241,4,4,0,1,0
13,251,251,21,21,0,1,0
27,322,322,12,3,9,4,3
18,329,329,1,1,0,1,0
25,346,346,128,8,120,4,3
15,379,379,1,1,0,1,0
8,405,405,1,1,0,1,0
29,410,410,46,41,5,2,1
3,417,417,17,4,13,2,1
16,420,420,45,45,0,1,0
21,421,421,55,34,21,4,3
19,431,431,6,6,0,1,0
11,450,450,52,52,0,1,0
12,460,460,53,27,26,2,1
9,467,467,183,51,132,4,3
14,471,471,77,32,45,2,1
2,478,478,50,50,0,1,0
7,496,496,131,14,117,4,3

13,121,121,11,11,0,1,0
27,131,131,24,24,0,1,0
6,132,132,9,3,6,3,2
16,140,140,5,1,4,2,1
7,141,141,6,2,4,2,1
14,186,186,1,1,0,1,0
28,252,252,15,4,11,2,1
15,255,255,30,30,0,1,0
30,262,262,2,2,0,1,0
10,275,275,4,4,0,1,0
26,292,292,23,4,19,2,1
3,293,293,18,18,0,1,0
20,307,307,73,3,70,3,2
24,331,331,43,7,36,4,3
12,340,340,31,7,24,2,1
22,344,344,40,40,0,1,0
2,347,347,37,1,36,4,3
19,348,348,66,66,0,1,0
23,360,360,11,11,0,1,0
31,381,381,2,2,0,1,0
0,381,381,12,9,3,2,1
11,382,382,7,7,0,1,0
5,384,384,65,32,33,4,3
25,388,388,2,2,0,1,0
4,397,397,78,74,4,2,1
29,428,428,87,54,33,4,3
17,445,445,57,57,0,1,0
8,455,455,82,14,68,4,3
21,483,483,80,74,6,2,1
18,488,488,6,6,0,1,0
9,493,493,20,20,0,1,0
1,495,495,1,1,0,1,0

20,104,104,16,4,12,2,1
8,129,129,9,2,7,2,1
12,135,135,15,15,0,1,0
24,136,136,5,5,0,1,0
11,148,148,2,2,0,1,0
19,164,164,2,2,0,1,0
17,186,186,14,2,12,3,2
26,188,188,44,44,0,1,0
14,188,188,8,2,6,3,2
1,209,209,4,4,0,1,0
23,219,219,31,16,15,4,3
16,235,235,38,38,0,1,0
5,244,244,6,6,0,1,0
7,255,255,51,51,0,1,0
6,279,279,45,45,0,1,0
25,344,344,65,50,15,4,3
3,367,367,31,31,0,1,0
9,374,374,26,9,17,2,1
2,376,376,181,109,72,4,3
0,382,382,1,1,0,1,0
18,389,389,21,21,0,1,0
13,398,398,1,1,0,1,0
4,452,452,69,40,29,2,1
21,463,463,16,16,0,1,0
10,463,463,5,5,0,1,0
15,495,495,15,15,0,1,0
22,496,496,131,131,0,1,0

14,110,110,2,2,0,1,0
11,118,118,2,2,0,1,0
4,119,119,1,1,0,1,0
10,140,140,21,5,16,2,1
25,153,153,18,18,0,1,0
9,157,157,7,7,0,1,0
20,164,164,43,1,42,3,2
29,182,182,39,36,3,2,1
5,206,206,40,40,0,1,0
22,213,213,12,12,0,1,0
27,223,223,10,10,0,1,0
26,232,232,33,17,16,2,1
1,253,253,57,51,6,2,1
13,266,266,3,3,0,1,0
16,280,280,24,24,0,1,0
7,286,286,67,17,50,3,2
18,290,290,3,3,0,1,0
6,295,295,7,7,0,1,0
19,340,340,50,50,0,1,0
17,343,343,4,4,0,1,0
2,357,357,26,12,14,4,3
28,365,365,2,2,0,1,0
21,369,369,78,42,36,3,2
8,371,371,4,4,0,1,0
24,379,379,6,1,5,2,1
12,396,396,12,12,0,1,0
15,398,398,15,12,3,2,1
3,410,410,107,43,64,4,3
23,431,431,44,44,0,1,0
0,476,476,29,15,14,3,2

17,143,143,31,31,0,1,0
16,154,154,23,8,15,4,3
20,195,195,6,2,4,2,1
12,196,196,4,4,0,1,0
5,215,215,75,39,36,2,1
0,229,229,107,14,93,4,3
2,236,236,40,40,0,1,0
10,267,267,9,1,8,3,2
6,313,313,61,61,0,1,0
19,331,331,13,3,10,2,1
1,334,334,8,8,0,1,0
9,349,349,61,57,4,2,1
11,372,372,17,5,12,2,1
4,387,387,28,28,0,1,0
7,404,404,39,21,18,4,3
13,414,414,50,30,20,3,2
18,423,423,9,9,0,1,0
14,434,434,91,48,43,2,1
15,466,466,53,42,11,2,1
3,478,478,60,60,0,1,0
8,486,486,72,72,0,1,0

16,111,111,4,4,0,1,0
1,121,121,20,10,10,2,1
12,146,146,9,1,8,2,1
17,148,148,7,7,0,1,0
0,161,161,5,5,0,1,0
23,182,182,2,2,0,1,0
14,187,187,1,1,0,1,0
15,189,189,14,4,10,3,2
2,194,194,12,12,0,1,0
4,204,204,13,13,0,1,0
5,217,217,4,1,3,2,1
21,240,240,9,9,0,1,0
24,278,278,45,45,0,1,0
13,279,279,11,11,0,1,0
8,287,287,17,17,0,1,0
9,307,307,5,1,4,2,1
19,307,307,2,2,0,1,0
20,344,344,212,188,24,4,3
6,348,348,47,47,0,1,0
26,353,353,39,39,0,1,0
27,384,384,21,21,0,1,0
7,427,427,19,1,18,2,1
3,450,450,61,49,12,3,2
22,455,455,79,79,0,1,0
11,459,459,113,113,0,1,0
18,462,462,33,21,12,4,3
10,483,483,157,157,0,1,0
25,483,483,13,13,0,1,0

14,110,110,9,6,3,2,1
28,110,110,4,4,0,1,0
5,122,122,1,1,0,1,0
9,140,140,35,11,24,4,3
6,163,163,1,1,0,1,0
20,189,189,26,14,12,3,2
16,200,200,6,2,4,2,1
18,208,208,1,1,0,1,0
29,221,221,12,4,8,3,2
17,236,236,6,2,4,2,1
8,247,247,27,9,18,2,1
23,247,247,4,4,0,1,0
19,282,282,6,6,0,1,0
31,324,324,28,28,0,1,0
4,328,328,31,31,0,1,0
21,337,337,36,36,0,1,0
7,349,349,4,4,0,1,0
13,352,352,11,5,6,2,1
12,353,353,37,6,31,2,1
25,361,361,97,58,39,4,3
30,361,361,29,9,20,2,1
0,395,395,44,44,0,1,0
26,396,396,5,5,0,1,0
24,410,410,63,46,17,2,1
11,438,438,21,14,7,2,1
1,442,442,121,121,0,1,0
32,447,447,8,8,0,1,0
2,450,450,21,7,14,3,2
15,451,451,5,5,0,1,0
10,451,451,61,21,40,4,3
3,483,483,8,8,0,1,0
27,486,486,141,6,135,4,3
22,500,500,75,55,20,4,3

3,104,104,19,19,0,1,0
15,111,111,3,3,0,1,0
2,117,117,4,4,0,1,0
20,122,122,12,6,6,2,1
26,130,130,10,6,4,2,1
12,236,236,13,13,0,1,0
5,238,238,59,32,27,2,1
14,238,238,16,16,0,1,0
6,254,254,19,19,0,1,0
13,257,257,19,19,0,1,0
16,270,270,32,2,30,2,1
10,284,284,26,26,0,1,0
17,285,285,25,15,10,2,1
8,297,297,51,51,0,1,0
11,315,315,36,36,0,1,0
4,315,315,2,2,0,1,0
25,339,339,8,8,0,1,0
23,384,384,19,1,18,4,3
21,408,408,36,36,0,1,0
22,409,409,4,4,0,1,0
7,426,426,37,20,17,2,1
24,437,437,120,111,9,4,3
0,448,448,42,4,38,3,2
18,448,448,142,91,51,3,2
9,475,475,70,70,0,1,0
1,481,481,46,46,0,1,0
19,494,494,57,18,39,4,3

13,101,101,1,1,0,1,0
9,108,108,8,3,5,2,1
1,118,118,4,4,0,1,0
18,148,148,10,1,9,4,3
10,151,151,15,15,0,1,0
6,157,157,42,16,26,2,1
28,157,157,9,9,0,1,0
27,163,163,22,22,0,1,0
14,198,198,17,4,13,2,1
3,204,204,3,3,0,1,0
11,234,234,1,1,0,1,0
17,240,240,56,11,45,2,1
7,261,261,34,12,22,2,1
5,273,273,8,4,4,2,1
20,278,278,24,24,0,1,0
21,291,291,66,66,0,1,0
0,337,337,18,18,0,1,0
16,350,350,34,34,0,1,0
25,366,366,22,22,0,1,0
22,380,380,14,4,10,2,1
4,392,392,23,2,21,4,3
2,392,392,51,48,3,2,1
12,394,394,21,9,12,3,2
23,415,415,20,11,9,3,2
19,418,418,13,6,7,2,1
15,419,419,11,2,9,2,1
29,443,443,70,70,0,1,0
24,461,461,51,3,48,4,3
8,465,465,154,40,114,4,3
26,466,466,38,2,36,2,1

19,122,122,16,16,0,1,0
3,122,122,16,1,15,4,3
15,160,160,38,12,26,3,2
1,195,195,27,27,0,1,0
25,201,201,1,1,0,1,0
22,203,203,7,4,3,2,1
11,221,221,13,1,12,4,3
12,221,221,23,23,0,1,0
14,251,251,5,5,0,1,0
9,280,280,12,12,0,1,0
20,303,303,75,39,36,4,3
7,307,307,95,95,0,1,0
4,316,316,11,11,0,1,0
17,320,320,17,13,4,2,1
23,326,326,11,2,9,4,3
10,328,328,11,11,0,1,0
16,345,345,95,71,24,3,2
8,360,360,69,36,33,2,1
13,374,374,35,22,13,2,1
24,379,379,27,27,0,1,0
21,420,420,15,6,9,4,3
6,436,436,30,30,0,1,0
2,446,446,36,16,20,3,2
18,470,470,39,39,0,1,0
5,477,477,37,37,0,1,0
0,486,486,113,113,0,1,0

27,109,109,35,35,0,1,0
5,119,119,1,1,0,1,0
2,143,143,2,2,0,1,0
18,154,154,3,3,0,1,0
8,169,169,11,5,6,3,2
21,169,169,3,3,0,1,0
19,173,173,2,2,0,1,0
6,179,179,18,4,14,2,1
20,200,200,42,13,29,2,1
10,204,204,14,14,0,1,0
7,213,213,9,9,0,1,0
0,262,262,4,4,0,1,0
29,266,266,109,109,0,1,0
13,272,272,39,39,0,1,0
25,279,279,12,6,6,2,1
15,303,303,6,6,0,1,0
30,332,332,6,6,0,1,0
16,340,340,57,28,29,2,1
24,344,344,48,12,36,4,3
4,350,350,76,76,0,1,0
31,351,351,7,7,0,1,0
26,359,359,16,9,7,2,1
12,376,376,16,16,0,1,0
23,377,377,11,11,0,1,0
1,378,378,7,2,5,2,1
14,392,392,29,13,16,3,2
3,401,401,1,1,0,1,0
22,420,420,40,23,17,2,1
28,434,434,18,18,0,1,0
9,447,447,90,32,58,4,3
11,455,455,56,11,45,4,3
17,491,491,38,2,36,3,2

13,104,104,1,1,0,1,0
10,123,123,20,20,0,1,0
11,140,140,5,5,0,1,0
26,140,140,4,4,0,1,0
2,169,169,2,2,0,1,0
29,191,191,2,2,0,1,0
4,216,216,22,22,0,1,0
0,220,220,41,38,3,2,1
17,227,227,28,28,0,1,0
24,237,237,6,2,4,2,1
3,240,240,37,17,20,3,2
1,244,244,28,3,25,3,2
14,254,254,15,15,0,1,0
16,267,267,18,9,9,2,1
6,268,268,1,1,0,1,0
8,273,273,17,5,12,2,1
32,275,275,15,15,0,1,0
25,276,276,35,35,0,1,0
27,282,282,3,3,0,1,0
9,342,342,15,1,14,3,2
20,358,358,98,17,81,4,3
7,368,368,1,1,0,1,0
18,396,396,54,54,0,1,0
23,409,409,19,10,9,2,1
28,409,409,29,29,0,1,0
12,416,416,9,1,8,3,2
5,424,424,34,34,0,1,0
31,447,447,95,21,74,3,2
21,455,455,132,97,35,4,3
30,466,466,67,43,24,4,3
15,484,484,12,12,0,1,0
19,484,484,36,12,24,2,1
22,497,497,26,26,0,1,0

13,102,102,19,6,13,2,1
25,151,151,18,18,0,1,0
12,172,172,12,12,0,1,0
8,175,175,6,1,5,2,1
17,193,193,58,19,39,4,3
0,201,201,53,38,15,4,3
21,233,233,1,1,0,1,0
6,234,234,4,1,3,2,1
20,238,238,12,12,0,1,0
1,250,250,16,4,12,4,3
11,264,264,5,5,0,1,0
18,288,288,30,30,0,1,0
9,293,293,1,1,0,1,0
14,294,294,8,2,6,2,1
2,307,307,16,1,15,4,3
3,327,327,185,101,84,4,3
5,334,334,7,7,0,1,0
7,343,343,16,13,3,2,1
19,344,344,10,10,0,1,0
22,384,384,7,1,6,3,2
26,385,385,55,55,0,1,0
16,387,387,41,41,0,1,0
4,401,401,7,4,3,2,1
23,407,407,65,36,29,2,1
10,433,433,18,8,10,3,2
15,449,449,18,18,0,1,0
24,459,459,85,56,29,2,1
27,488,488,66,38,28,2,1

18,127,127,8,4,4,2,1
26,129,129,50,23,27,2,1
28,129,129,8,2,6,2,1
12,138,138,15,3,12,4,3
27,142,142,14,14,0,1,0
8,144,144,23,18,5,2,1
17,166,166,28,28,0,1,0
23,180,180,12,12,0,1,0
20,215,215,6,6,0,1,0
5,216,216,12,12,0,1,0
22,246,246,9,9,0,1,0
24,257,257,27,21,6,3,2
0,261,261,7,4,3,2,1
9,267,267,9,9,0,1,0
16,271,271,20,20,0,1,0
14,286,286,3,3,0,1,0
21,293,293,49,40,9,4,3
15,300,300,31,31,0,1,0
2,314,314,33,33,0,1,0
6,324,324,20,20,0,1,0
4,340,340,82,82,0,1,0
7,356,356,54,54,0,1,0
13,366,366,46,46,0,1,0
25,386,386,32,11,21,2,1
3,442,442,26,7,19,3,2
19,458,458,36,2,34,2,1
29,460,460,7,3,4,2,1
11,462,462,18,18,0,1,0
1,462,462,17,17,0,1,0
10,476,476,39,7,32,3,2

6,102,102,9,1,8,2,1
17,112,112,2,2,0,1,0
15,116,116,3,3,0,1,0
10,129,129,6,6,0,1,0
13,164,164,28,28,0,1,0
8,165,165,9,5,4,2,1
21,166,166,23,20,3,2,1
7,188,188,89,5,84,4,3
4,191,191,18,18,0,1,0
24,195,195,12,12,0,1,0
23,213,213,51,51,0,1,0
5,219,219,16,16,0,1,0
2,219,219,14,14,0,1,0
19,236,236,54,16,38,2,1
12,241,241,13,13,0,1,0
0,243,243,57,19,38,3,2
22,271,271,52,35,17,4,3
9,284,284,24,24,0,1,0
20,290,290,66,66,0,1,0
1,338,338,32,32,0,1,0
11,353,353,6,3,3,2,1
14,384,384,18,18,0,1,0
25,386,386,6,6,0,1,0
18,401,401,6,6,0,1,0
16,464,464,2,2,0,1,0
3,488,488,37,37,0,1,0

15,106,106,8,8,0,1,0
13,112,112,16,16,0,1,0
4,129,129,13,13,0,1,0
14,189,189,7,7,0,1,0
7,195,195,24,24,0,1,0
21,197,197,13,5,8,3,2
11,201,201,9,9,0,1,0
0,221,221,15,15,0,1,0
6,226,226,19,19,0,1,0
24,228,228,11,2,9,4,3
26,273,273,59,59,0,1,0
2,277,277,12,9,3,2,1
18,287,287,32,32,0,1,0
5,328,328,52,52,0,1,0
23,329,329,4,4,0,1,0
22,343,343,28,1,27,2,1
17,355,355,114,107,7,2,1
19,365,365,2,2,0,1,0
3,374,374,123,93,30,4,3
20,420,420,87,24,63,4,3
16,439,439,12,12,0,1,0
1,443,443,142,88,54,3,2
25,449,449,36,6,30,4,3
12,459,459,25,25,0,1,0
9,462,462,19,19,0,1,0
10,478,478,15,15,0,1,0
8,478,478,1,1,0,1,0

20,131,131,14,8,6,2,1
30,142,142,10,10,0,1,0
5,151,151,1,1,0,1,0
28,188,188,18,18,0,1,0
21,193,193,23,23,0,1,0
0,198,198,1,1,0,1,0
26,204,204,12,12,0,1,0
7,243,243,18,12,6,3,2
24,253,253,14,14,0,1,0
17,277,277,33,5,28,2,1
8,283,283,14,14,0,1,0
14,296,296,63,63,0,1,0
11,316,316,23,23,0,1,0
19,316,316,9,3,6,2,1
13,317,317,1,1,0,1,0
31,320,320,81,27,54,4,3
12,321,321,4,1,3,2,1
27,336,336,11,3,8,2,1
16,355,355,20,16,4,2,1
29,360,360,73,68,5,2,1
1,363,363,43,27,16,3,2
9,381,381,103,64,39,2,1
22,396,396,90,52,38,2,1
2,418,418,1,1,0,1,0
18,434,434,54,10,44,3,2
23,452,452,11,3,8,3,2
10,456,456,52,48,4,2,1
15,467,467,57,19,38,4,3
6,480,480,49,49,0,1,0
4,492,492,13,13,0,1,0
25,494,494,15,15,0,1,0
3,500,500,17,5,12,4,3

7,128,128,4,4,0,1,0
10,145,145,4,4,0,1,0
1,174,174,48,10,38,3,2
13,187,187,38,38,0,1,0
20,188,188,3,3,0,1,0
11,201,201,7,7,0,1,0
12,214,214,7,7,0,1,0
9,265,265,1,1,0,1,0
18,272,272,48,48,0,1,0
19,290,290,72,72,0,1,0
4,302,302,63,35,28,2,1
17,305,305,19,19,0,1,0
16,349,349,34,34,0,1,0
14,365,365,29,11,18,2,1
15,370,370,92,92,0,1,0
0,372,372,71,62,9,2,1
3,434,434,183,87,96,4,3
2,452,452,67,29,38,3,2
5,462,462,39,39,0,1,0
8,464,464,64,16,48,2,1
21,471,471,27,2,25,4,3
6,481,481,19,9,10,2,1

30,110,110,13,13,0,1,0
19,122,122,1,1,0,1,0
4,146,146,42,42,0,1,0
9,147,147,25,25,0,1,0
21,152,152,26,8,18,3,2
11,176,176,32,32,0,1,0
20,185,185,8,8,0,1,0
6,186,186,1,1,0,1,0
15,196,196,1,1,0,1,0
7,199,199,2,2,0,1,0
3,206,206,22,4,18,3,2
24,211,211,6,3,3,2,1
1,223,223,9,9,0,1,0
12,238,238,15,15,0,1,0
22,239,239,8,3,5,2,1
0,271,271,33,27,6,3,2
10,302,302,8,1,7,2,1
26,316,316,37,3,34,3,2
29,358,358,36,36,0,1,0
27,374,374,112,112,0,1,0
28,377,377,22,17,5,2,1
31,404,404,51,42,9,2,1
18,429,429,36,10,26,4,3
17,443,443,8,5,3,2,1
13,459,459,3,3,0,1,0
5,459,459,28,28,0,1,0
16,468,468,18,4,14,2,1
14,470,470,58,58,0,1,0
2,480,480,23,11,12,4,3
23,483,483,15,15,0,1,0
8,492,492,43,43,0,1,0
25,495,495,104,104,0,1,0

22,104,104,12,12,0,1,0
5,128,128,7,7,0,1,0
4,128,128,2,2,0,1,0
16,135,135,2,2,0,1,0
14,148,148,16,16,0,1,0
11,163,163,9,3,6,3,2
3,167,167,54,9,45,4,3
0,176,176,1,1,0,1,0
1,201,201,13,4,9,4,3
21,244,244,18,2,16,4,3
20,266,266,5,5,0,1,0
12,294,294,77,77,0,1,0
8,298,298,3,3,0,1,0
13,301,301,33,33,0,1,0
7,302,302,86,83,3,2,1
25,337,337,92,92,0,1,0
18,357,357,96,42,54,4,3
17,369,369,21,10,11,2,1
10,371,371,61,61,0,1,0
15,415,415,12,12,0,1,0
19,415,415,3,3,0,1,0
6,425,425,89,14,75,4,3
9,435,435,54,54,0,1,0
24,471,471,10,10,0,1,0
2,493,493,44,44,0,1,0
23,494,494,32,32,0,1,0

17,129,129,6,6,0,1,0
7,139,139,40,8,32,3,2
12,149,149,1,1,0,1,0
15,150,150,65,26,39,2,1
19,154,154,25,1,24,4,3
20,160,160,13,13,0,1,0
0,172,172,3,3,0,1,0
9,174,174,26,5,21,2,1
5,176,176,22,22,0,1,0
22,181,181,34,11,23,2,1
6,270,270,13,13,0,1,0
1,291,291,3,3,0,1,0
3,309,309,19,19,0,1,0
13,375,375,1,1,0,1,0
18,404,404,89,53,36,2,1
11,436,436,2,2,0,1,0
16,444,444,15,15,0,1,0
21,446,446,21,3,18,3,2
10,468,468,3,3,0,1,0
8,476,476,90,61,29,4,3
2,479,479,241,145,96,4,3
14,482,482,19,16,3,2,1
4,491,491,78,78,0,1,0

9,105,105,1,1,0,1,0
24,123,123,18,18,0,1,0
7,136,136,25,25,0,1,0
19,160,160,11,11,0,1,0
3,212,212,35,35,0,1,0
27,215,215,99,99,0,1,0
13,222,222,16,16,0,1,0
1,241,241,42,34,8,3,2
2,241,241,29,13,16,2,1
17,246,246,13,5,8,3,2
14,271,271,11,11,0,1,0
26,274,274,3,3,0,1,0
15,277,277,17,6,11,2,1
0,279,279,45,45,0,1,0
11,287,287,24,24,0,1,0
21,294,294,35,35,0,1,0
16,298,298,39,39,0,1,0
4,352,352,19,8,11,2,1
8,366,366,26,26,0,1,0
18,386,386,31,14,17,4,3
10,394,394,34,34,0,1,0
22,394,394,52,7,45,4,3
6,426,426,55,31,24,3,2
23,433,433,33,33,0,1,0
12,469,469,35,14,21,4,3
5,471,471,9,9,0,1,0
25,481,481,6,3,3,2,1
20,482,482,16,16,0,1,0

12,104,104,10,6,4,2,1
1,141,141,11,11,0,1,0
25,144,144,24,24,0,1,0
20,148,148,11,11,0,1,0
21,153,153,38,38,0,1,0
14,164,164,12,12,0,1,0
19,182,182,29,17,12,4,3
9,195,195,19,19,0,1,0
4,199,199,19,4,15,2,1
10,201,201,62,26,36,4,3
22,232,232,16,16,0,1,0
7,233,233,2,2,0,1,0
18,234,234,8,2,6,2,1
27,245,245,24,24,0,1,0
24,246,246,6,6,0,1,0
23,268,268,38,7,31,4,3
6,297,297,43,4,39,3,2
26,297,297,34,31,3,2,1
2,297,297,18,18,0,1,0
8,312,312,12,12,0,1,0
15,328,328,4,4,0,1,0
3,340,340,1,1,0,1,0
0,343,343,70,27,43,4,3
16,352,352,33,28,5,2,1
17,374,374,45,3,42,2,1
11,389,389,5,5,0,1,0
5,419,419,89,80,9,2,1
13,447,447,18,18,0,1,0

16,126,126,7,7,0,1,0
14,139,139,16,12,4,2,1
0,156,156,2,2,0,1,0
1,159,159,16,16,0,1,0
12,196,196,6,6,0,1,0
3,205,205,8,8,0,1,0
6,207,207,11,11,0,1,0
11,219,219,14,2,12,4,3
2,228,228,36,36,0,1,0
10,237,237,59,59,0,1,0
21,257,257,69,25,44,4,3
8,261,261,34,34,0,1,0
25,280,280,3,3,0,1,0
19,286,286,58,58,0,1,0
4,300,300,39,17,22,2,1
18,315,315,41,13,28,2,1
15,328,328,30,14,16,2,1
5,331,331,18,18,0,1,0
7,346,346,31,16,15,2,1
20,350,350,8,8,0,1,0
13,373,373,9,9,0,1,0
22,419,419,4,4,0,1,0
17,429,429,45,17,28,2,1
24,451,451,63,27,36,4,3
9,473,473,138,128,10,2,1
26,486,486,83,83,0,1,0
23,495,495,42,4,38,3,2

10,116,116,2,2,0,1,0
5,117,117,4,4,0,1,0
31,123,123,14,2,12,2,1
2,127,127,22,22,0,1,0
1,128,128,20,20,0,1,0
24,135,135,24,24,0,1,0
30,144,144,25,25,0,1,0
14,151,151,10,4,6,2,1
15,152,152,6,6,0,1,0
28,174,174,15,15,0,1,0
33,191,191,15,7,8,2,1
11,218,218,8,8,0,1,0
12,221,221,20,14,6,3,2
25,230,230,11,11,0,1,0
0,260,260,1,1,0,1,0
21,281,281,25,11,14,3,2
7,286,286,19,8,11,2,1
29,293,293,30,30,0,1,0
26,296,296,46,30,16,2,1
16,300,300,18,18,0,1,0
20,305,305,12,12,0,1,0
22,319,319,46,26,20,2,1
4,338,338,45,45,0,1,0
23,340,340,47,38,9,2,1
17,342,342,30,30,0,1,0
9,350,350,5,1,4,2,1
19,368,368,69,69,0,1,0
27,372,372,10,2,8,3,2
18,381,381,9,9,0,1,0
3,391,391,4,4,0,1,0
32,442,442,26,26,0,1,0
6,455,455,23,23,0,1,0
13,461,461,55,13,42,3,2
8,485,485,15,1,14,3,2

9,123,123,29,7,22,2,1
19,141,141,5,5,0,1,0
8,146,146,40,28,12,3,2
20,149,149,1,1,0,1,0
0,155,155,10,10,0,1,0
6,169,169,29,29,0,1,0
2,179,179,25,2,23,2,1
7,212,212,14,5,9,4,3
3,231,231,9,9,0,1,0
21,240,240,35,35,0,1,0
13,247,247,5,5,0,1,0
24,258,258,62,56,6,2,1
1,278,278,28,28,0,1,0
22,288,288,35,35,0,1,0
12,324,324,16,16,0,1,0
4,342,342,21,21,0,1,0
11,352,352,57,11,46,2,1
18,359,359,91,28,63,4,3
10,365,365,16,2,14,2,1
23,367,367,43,43,0,1,0
17,368,368,21,21,0,1,0
15,435,435,107,71,36,2,1
25,437,437,3,3,0,1,0
5,444,444,19,8,11,4,3
14,463,463,40,24,16,2,1
16,490,490,19,19,0,1,0

12,109,109,2,2,0,1,0
4,112,112,22,22,0,1,0
16,123,123,7,7,0,1,0
0,129,129,9,3,6,3,2
24,165,165,11,11,0,1,0
17,172,172,24,24,0,1,0
5,192,192,12,5,7,2,1
26,192,192,6,6,0,1,0
22,192,192,9,6,3,2,1
11,202,202,3,3,0,1,0
14,208,208,16,4,12,4,3
13,218,218,17,17,0,1,0
27,240,240,10,1,9,4,3
30,264,264,30,30,0,1,0
9,273,273,6,6,0,1,0
20,290,290,21,21,0,1,0
6,293,293,3,3,0,1,0
15,303,303,2,2,0,1,0
21,331,331,116,102,14,2,1
8,378,378,33,16,17,2,1
23,386,386,74,22,52,3,2
18,396,396,25,7,18,3,2
19,409,409,2,2,0,1,0
3,410,410,4,1,3,2,1
25,447,447,51,13,38,2,1
28,454,454,51,51,0,1,0
1,463,463,102,54,48,3,2
7,467,467,118,48,70,3,2
2,467,467,78,15,63,4,3
29,472,472,35,35,0,1,0
10,495,495,28,1,27,4,3

12,157,157,28,28,0,1,0
17,158,158,6,6,0,1,0
18,182,182,14,8,6,3,2
8,185,185,72,36,36,3,2
19,185,185,31,31,0,1,0
2,198,198,7,7,0,1,0
14,201,201,29,29,0,1,0
28,207,207,27,9,18,3,2
27,208,208,1,1,0,1,0
1,214,214,7,7,0,1,0
25,218,218,39,4,35,4,3
3,219,219,8,3,5,2,1
10,240,240,1,1,0,1,0
9,243,243,3,3,0,1,0
13,244,244,5,1,4,2,1
22,276,276,55,55,0,1,0
16,277,277,5,1,4,2,1
5,292,292,5,5,0,1,0
0,301,301,57,57,0,1,0
24,333,333,15,9,6,2,1
11,338,338,57,57,0,1,0
4,342,342,16,16,0,1,0
26,359,359,43,43,0,1,0
7,371,371,16,6,10,2,1
6,388,388,33,33,0,1,0
23,439,439,76,76,0,1,0
15,448,448,29,5,24,2,1
20,483,483,19,19,0,1,0
21,495,495,88,16,72,3,2

10,125,125,5,1,4,2,1
23,136,136,9,5,4,2,1
12,181,181,4,4,0,1,0
19,185,185,34,34,0,1,0
22,210,210,14,2,12,3,2
20,224,224,3,3,0,1,0
5,251,251,21,7,14,3,2
0,261,261,24,8,16,3,2
1,267,267,23,10,13,2,1
18,270,270,25,7,18,4,3
15,305,305,16,16,0,1,0
4,310,310,3,3,0,1,0
28,314,314,2,2,0,1,0
7,318,318,25,12,13,4,3
9,348,348,62,62,0,1,0
8,348,348,1,1,0,1,0
25,350,350,53,17,36,3,2
14,358,358,15,6,9,2,1
24,360,360,67,32,35,3,2
3,396,396,72,72,0,1,0
26,403,403,64,18,46,3,2
17,433,433,23,23,0,1,0
11,448,448,151,93,58,4,3
6,451,451,12,1,11,2,1
16,461,461,61,43,18,2,1
13,485,485,91,84,7,2,1
21,488,488,89,72,17,2,1
27,493,493,41,4,37,4,3
2,499,499,16,16,0,1,0

9,110,110,2,2,0,1,0
6,117,117,17,17,0,1,0
0,129,129,2,2,0,1,0
7,141,141,2,2,0,1,0
13,164,164,1,1,0,1,0
24,171,171,14,7,7,2,1
19,189,189,42,2,40,2,1
29,190,190,1,1,0,1,0
22,196,196,15,15,0,1,0
23,207,207,49,21,28,2,1
1,211,211,31,31,0,1,0
8,234,234,32,23,9,4,3
2,254,254,19,19,0,1,0
27,274,274,28,28,0,1,0
12,275,275,57,21,36,2,1
17,293,293,3,3,0,1,0
16,295,295,61,12,49,3,2
25,307,307,3,3,0,1,0
3,328,328,10,10,0,1,0
11,331,331,14,3,11,2,1
4,335,335,109,109,0,1,0
20,339,339,8,1,7,2,1
5,390,390,30,12,18,2,1
28,419,419,103,55,48,3,2
21,434,434,17,12,5,2,1
10,468,468,68,68,0,1,0
26,470,470,36,36,0,1,0
14,484,484,1,1,0,1,0
15,493,493,7,2,5,2,1
18,494,494,45,24,21,4,3

18,109,109,1,1,0,1,0
24,122,122,16,5,11,2,1
22,134,134,6,1,5,2,1
19,161,161,9,3,6,2,1
23,164,164,5,5,0,1,0
20,173,173,39,39,0,1,0
6,183,183,9,9,0,1,0
28,188,188,10,1,9,4,3
26,215,215,96,57,39,3,2
0,246,246,15,15,0,1,0
10,265,265,38,38,0,1,0
7,274,274,6,6,0,1,0
11,274,274,9,9,0,1,0
21,294,294,11,11,0,1,0
29,301,301,8,8,0,1,0
17,305,305,60,33,27,4,3
9,319,319,25,25,0,1,0
8,320,320,24,14,10,3,2
13,337,337,56,56,0,1,0
4,344,344,5,5,0,1,0
3,357,357,61,61,0,1,0
16,406,406,42,2,40,2,1
27,410,410,2,2,0,1,0
15,427,427,24,8,16,3,2
5,448,448,56,56,0,1,0
2,450,450,7,1,6,3,2
1,452,452,64,64,0,1,0
12,456,456,46,46,0,1,0
30,461,461,54,54,0,1,0
25,463,463,22,22,0,1,0
14,490,490,22,22,0,1,0

29,101,101,15,15,0,1,0
6,110,110,9,9,0,1,0
31,129,129,55,55,0,1,0
21,137,137,2,2,0,1,0
32,149,149,52,42,10,3,2
26,154,154,7,7,0,1,0
14,160,160,1,1,0,1,0
4,161,161,25,25,0,1,0
15,178,178,14,14,0,1,0
7,185,185,10,10,0,1,0
17,186,186,10,1,9,4,3
28,192,192,30,30,0,1,0
5,249,249,26,26,0,1,0
3,259,259,7,7,0,1,0
16,269,269,18,8,10,3,2
24,285,285,2,2,0,1,0
0,304,304,49,4,45,4,3
2,307,307,12,8,4,2,1
10,357,357,10,1,9,4,3
25,361,361,14,14,0,1,0
22,373,373,3,3,0,1,0
9,375,375,89,74,15,4,3
20,385,385,23,5,18,3,2
1,399,399,29,29,0,1,0
19,406,406,18,18,0,1,0
12,406,406,18,7,11,2,1
13,426,426,18,18,0,1,0
18,432,432,45,45,0,1,0
8,444,444,1,1,0,1,0
30,462,462,16,16,0,1,0
27,473,473,31,12,19,4,3
11,490,490,20,6,14,2,1
23,498,498,13,2,11,2,1

12,102,102,1,1,0,1,0
20,146,146,20,20,0,1,0
0,147,147,8,5,3,2,1
15,151,151,18,8,10,3,2
23,161,161,17,7,10,3,2
21,162,162,8,8,0,1,0
6,179,179,27,8,19,2,1
10,204,204,3,3,0,1,0
29,208,208,10,10,0,1,0
5,209,209,14,14,0,1,0
9,216,216,10,10,0,1,0
1,234,234,1,1,0,1,0
16,238,238,3,3,0,1,0
13,240,240,18,18,0,1,0
31,248,248,2,2,0,1,0
4,283,283,7,1,6,3,2
14,290,290,51,15,36,2,1
24,304,304,85,85,0,1,0
3,334,334,9,9,0,1,0
7,340,340,103,67,36,4,3
27,352,352,8,8,0,1,0
30,360,360,22,22,0,1,0
26,369,369,2,2,0,1,0
8,372,372,3,3,0,1,0
18,398,398,7,1,6,3,2
28,427,427,42,14,28,3,2
22,450,450,76,54,22,2,1
2,472,472,54,54,0,1,0
17,476,476,25,25,0,1,0
11,476,476,67,49,18,3,2
25,480,480,68,68,0,1,0
19,496,496,137,105,32,2,1

7,115,115,10,10,0,1,0
14,136,136,15,12,3,2,1
3,144,144,45,45,0,1,0
21,213,213,38,26,12,2,1
12,224,224,14,14,0,1,0
24,228,228,4,4,0,1,0
1,234,234,37,37,0,1,0
11,237,237,8,8,0,1,0
16,241,241,7,1,6,3,2
0,251,251,9,9,0,1,0
6,252,252,24,15,9,4,3
20,269,269,4,4,0,1,0
10,302,302,1,1,0,1,0
9,309,309,11,11,0,1,0
13,325,325,3,3,0,1,0
25,329,329,10,4,6,3,2
19,335,335,7,7,0,1,0
18,344,344,34,30,4,2,1
17,359,359,7,7,0,1,0
27,360,360,78,78,0,1,0
4,376,376,58,30,28,3,2
15,405,405,30,15,15,4,3
2,424,424,115,14,101,4,3
23,430,430,59,59,0,1,0
8,441,441,9,9,0,1,0
5,451,451,8,8,0,1,0
22,486,486,204,186,18,4,3
28,487,487,54,54,0,1,0
26,492,492,28,6,22,2,1

21,105,105,10,10,0,1,0
9,122,122,15,11,4,2,1
1,124,124,17,5,12,4,3
2,141,141,35,13,22,2,1
8,156,156,33,13,20,3,2
16,160,160,41,3,38,3,2
7,165,165,1,1,0,1,0
3,184,184,23,9,14,3,2
11,186,186,5,5,0,1,0
18,197,197,57,57,0,1,0
6,220,220,39,25,14,2,1
5,260,260,33,33,0,1,0
17,262,262,1,1,0,1,0
10,263,263,16,16,0,1,0
13,280,280,5,5,0,1,0
0,298,298,16,1,15,4,3
20,311,311,23,2,21,2,1
4,313,313,61,61,0,1,0
15,323,323,61,37,24,2,1
14,452,452,91,3,88,3,2
22,454,454,8,8,0,1,0
23,464,464,31,28,3,2,1
12,475,475,25,25,0,1,0
19,492,492,35,35,0,1,0

6,109,109,15,15,0,1,0
14,134,134,40,20,20,3,2
13,138,138,36,8,28,3,2
5,163,163,8,8,0,1,0
20,165,165,4,4,0,1,0
25,168,168,59,59,0,1,0
0,175,175,2,2,0,1,0
28,223,223,14,5,9,4,3
22,248,248,1,1,0,1,0
21,254,254,18,8,10,3,2
30,254,254,102,33,69,4,3
26,265,265,36,9,27,4,3
17,280,280,19,5,14,4,3
9,282,282,32,6,26,3,2
2,284,284,2,2,0,1,0
11,286,286,3,3,0,1,0
3,306,306,8,8,0,1,0
7,308,308,2,2,0,1,0
24,311,311,27,23,4,2,1
1,312,312,6,3,3,2,1
12,316,316,46,46,0,1,0
27,364,364,17,11,6,2,1
23,387,387,4,1,3,2,1
15,394,394,15,15,0,1,0
29,399,399,23,16,7,2,1
10,401,401,43,13,30,3,2
31,404,404,2,2,0,1,0
8,451,451,1,1,0,1,0
18,468,468,71,16,55,3,2
19,471,471,8,8,0,1,0
16,476,476,29,5,24,4,3
4,485,485,20,1,19,3,2

24,117,117,6,1,5,2,1
12,132,132,10,1,9,4,3
0,137,137,18,4,14,2,1
3,138,138,1,1,0,1,0
26,142,142,4,4,0,1,0
10,181,181,4,4,0,1,0
20,205,205,30,22,8,2,1
13,224,224,2,2,0,1,0
22,231,231,61,61,0,1,0
6,240,240,3,3,0,1,0
27,241,241,26,26,0,1,0
1,263,263,23,23,0,1,0
17,288,288,4,1,3,2,1
4,298,298,41,41,0,1,0
15,305,305,11,1,10,3,2
7,309,309,38,38,0,1,0
9,315,315,30,12,18,3,2
11,352,352,120,60,60,4,3
23,372,372,36,36,0,1,0
14,388,388,37,12,25,2,1
8,391,391,8,2,6,2,1
2,400,400,5,5,0,1,0
18,400,400,4,1,3,2,1
28,406,406,24,24,0,1,0
5,407,407,80,80,0,1,0
21,419,419,43,25,18,4,3
25,423,423,87,33,54,3,2
19,431,431,72,15,57,4,3
16,456,456,72,13,59,4,3
29,482,482,6,2,4,2,1

4,157,157,5,5,0,1,0
13,168,168,26,14,12,3,2
25,174,174,9,3,6,3,2
17,180,180,30,12,18,2,1
26,204,204,30,30,0,1,0
12,208,208,12,12,0,1,0
27,227,227,24,24,0,1,0
8,234,234,11,2,9,4,3
5,238,238,14,2,12,2,1
24,243,243,30,6,24,2,1
1,252,252,77,77,0,1,0
15,257,257,42,15,27,3,2
23,261,261,17,17,0,1,0
11,275,275,63,48,15,2,1
20,294,294,22,13,9,4,3
6,313,313,19,19,0,1,0
16,348,348,16,5,11,2,1
14,380,380,15,15,0,1,0
9,386,386,29,29,0,1,0
22,416,416,66,24,42,2,1
0,425,425,26,2,24,3,2
7,430,430,9,3,6,3,2
3,438,438,1,1,0,1,0
21,466,466,84,84,0,1,0
19,471,471,21,2,19,2,1
10,484,484,33,33,0,1,0
2,493,493,113,83,30,4,3
18,499,499,27,27,0,1,0

34,106,106,17,11,6,2,1
38,110,110,24,6,18,4,3
31,119,119,1,1,0,1,0
19,134,134,1,1,0,1,0
22,137,137,4,4,0,1,0
4,158,158,13,2,11,4,3
1,186,186,3,3,0,1,0
36,190,190,25,25,0,1,0
33,204,204,1,1,0,1,0
8,237,237,8,8,0,1,0
17,237,237,7,4,3,2,1
24,271,271,15,3,12,3,2
35,281,281,14,8,6,3,2
3,282,282,2,2,0,1,0
11,284,284,1,1,0,1,0
9,286,286,4,4,0,1,0
18,293,293,11,1,10,3,2
20,296,296,46,46,0,1,0
15,312,312,38,16,22,4,3
14,342,342,8,8,0,1,0
21,347,347,5,5,0,1,0
10,351,351,44,44,0,1,0
7,354,354,50,50,0,1,0
30,354,354,14,2,12,4,3
5,355,355,36,36,0,1,0
37,363,363,65,53,12,4,3
16,373,373,22,7,15,4,3
26,384,384,62,16,46,2,1
29,390,390,16,16,0,1,0
0,406,406,11,3,8,2,1
23,409,409,1,1,0,1,0
25,410,410,103,64,39,2,1
27,419,419,31,31,0,1,0
6,423,423,12,12,0,1,0
12,435,435,10,10,0,1,0
13,448,448,67,67,0,1,0
28,451,451,31,31,0,1,0
2,463,463,53,53,0,1,0
32,488,488,19,19,0,1,0

11,102,102,36,36,0,1,0
21,104,104,10,10,0,1,0
17,136,136,2,2,0,1,0
14,151,151,6,6,0,1,0
16,178,178,30,12,18,3,2
10,183,183,23,7,16,4,3
0,211,211,4,4,0,1,0
1,213,213,53,53,0,1,0
6,259,259,7,7,0,1,0
13,270,270,6,3,3,2,1
7,273,273,9,9,0,1,0
19,297,297,15,15,0,1,0
2,315,315,150,140,10,2,1
15,316,316,42,42,0,1,0
12,335,335,13,13,0,1,0
8,385,385,42,20,22,2,1
3,387,387,163,160,3,2,1
4,395,395,5,5,0,1,0
18,399,399,10,10,0,1,0
20,405,405,66,12,54,4,3
5,448,448,73,58,15,4,3
9,487,487,48,26,22,3,2

27,105,105,6,3,3,2,1
11,107,107,3,3,0,1,0
18,109,109,14,14,0,1,0
3,178,178,32,32,0,1,0
0,181,181,2,2,0,1,0
12,206,206,3,3,0,1,0
25,211,211,23,7,16,3,2
8,249,249,26,26,0,1,0
28,264,264,36,14,22,2,1
4,272,272,4,1,3,2,1
13,280,280,1,1,0,1,0
29,310,310,27,6,21,2,1
22,313,313,11,11,0,1,0
23,336,336,118,118,0,1,0
24,343,343,6,6,0,1,0
14,352,352,4,4,0,1,0
10,352,352,30,30,0,1,0
7,370,370,1,1,0,1,0
15,370,370,41,41,0,1,0
30,395,395,67,67,0,1,0
1,421,421,34,34,0,1,0
31,426,426,41,41,0,1,0
6,427,427,38,2,36,2,1
17,436,436,6,6,0,1,0
32,436,436,65,34,31,2,1
2,453,453,94,62,32,3,2
26,462,462,63,3,60,4,3
19,477,477,25,19,6,2,1
9,479,479,26,26,0,1,0
20,487,487,13,9,4,2,1
16,487,487,115,20,95,4,3
5,494,494,14,14,0,1,0
21,495,495,2,2,0,1,0

27,117,117,11,11,0,1,0
13,134,134,12,6,6,2,1
5,143,143,18,18,0,1,0
29,147,147,13,13,0,1,0
8,159,159,3,3,0,1,0
4,181,181,3,3,0,1,0
23,185,185,1,1,0,1,0
10,186,186,42,42,0,1,0
24,189,189,1,1,0,1,0
19,190,190,4,4,0,1,0
14,191,191,16,16,0,1,0
15,202,202,26,26,0,1,0
16,204,204,10,10,0,1,0
17,215,215,22,22,0,1,0
6,221,221,8,8,0,1,0
31,247,247,66,3,63,4,3
0,259,259,25,6,19,4,3
25,273,273,18,18,0,1,0
28,304,304,2,2,0,1,0
9,324,324,3,3,0,1,0
26,336,336,54,54,0,1,0
20,338,338,50,41,9,4,3
12,347,347,64,13,51,4,3
30,359,359,76,43,33,2,1
7,371,371,1,1,0,1,0
11,374,374,3,3,0,1,0
18,378,378,86,86,0,1,0
1,407,407,43,13,30,3,2
3,415,415,27,19,8,3,2
21,432,432,49,7,42,3,2
2,454,454,25,25,0,1,0
22,475,475,11,1,10,2,1

9,122,122,1,1,0,1,0
11,136,136,19,1,18,4,3
21,162,162,7,7,0,1,0
2,171,171,1,1,0,1,0
7,197,197,54,12,42,2,1
19,224,224,20,9,11,4,3
20,254,254,39,39,0,1,0
13,270,270,80,2,78,4,3
5,271,271,49,49,0,1,0
4,276,276,5,5,0,1,0
0,284,284,144,57,87,4,3
8,286,286,4,4,0,1,0
12,302,302,47,36,11,2,1
1,322,322,63,63,0,1,0
10,353,353,64,22,42,4,3
3,368,368,14,14,0,1,0
14,375,375,16,7,9,2,1
16,378,378,1,1,0,1,0
18,379,379,34,27,7,2,1
15,453,453,53,53,0,1,0
6,487,487,89,65,24,2,1
17,493,493,46,46,0,1,0

20,104,104,2,2,0,1,0
15,105,105,6,6,0,1,0
25,115,115,11,8,3,2,1
8,123,123,1,1,0,1,0
7,132,132,2,2,0,1,0
21,150,150,29,7,22,3,2
22,158,158,2,2,0,1,0
28,181,181,22,4,18,4,3
16,231,231,48,48,0,1,0
17,292,292,15,7,8,3,2
5,306,306,84,36,48,4,3
18,324,324,43,37,6,2,1
23,363,363,63,9,54,3,2
31,365,365,79,47,32,3,2
30,366,366,31,31,0,1,0
3,367,367,38,38,0,1,0
19,390,390,48,22,26,2,1
2,399,399,4,1,3,2,1
27,400,400,30,16,14,2,1
24,407,407,15,15,0,1,0
29,410,410,10,10,0,1,0
26,426,426,49,49,0,1,0
9,430,430,7,7,0,1,0
0,433,433,45,45,0,1,0
14,447,447,1,1,0,1,0
11,459,459,11,1,10,3,2
10,465,465,69,55,14,2,1
12,476,476,25,19,6,2,1
6,485,485,7,1,6,3,2
13,487,487,80,34,46,4,3
1,495,495,35,19,16,2,1
4,497,497,38,38,0,1,0

15,104,104,5,5,0,1,0
26,105,105,2,2,0,1,0
27,135,135,1,1,0,1,0
0,147,147,54,54,0,1,0
9,153,153,1,1,0,1,0
4,204,204,1,1,0,1,0
21,226,226,47,47,0,1,0
17,228,228,83,17,66,3,2
6,290,290,27,13,14,3,2
29,297,297,5,5,0,1,0
2,301,301,7,4,3,2,1
3,304,304,79,10,69,4,3
8,327,327,23,10,13,2,1
18,337,337,54,54,0,1,0
12,346,346,2,2,0,1,0
22,354,354,30,24,6,3,2
25,361,361,6,6,0,1,0
14,368,368,83,43,40,2,1
24,376,376,8,8,0,1,0
23,389,389,42,26,16,2,1
13,394,394,7,1,6,3,2
1,415,415,30,30,0,1,0
19,416,416,3,3,0,1,0
11,429,429,28,2,26,4,3
5,458,458,15,6,9,3,2
20,463,463,76,76,0,1,0
16,463,463,53,53,0,1,0
28,470,470,63,63,0,1,0
7,478,478,32,32,0,1,0
10,486,486,24,6,18,3,2

16,109,109,29,29,0,1,0
5,116,116,5,5,0,1,0
20,116,116,1,1,0,1,0
12,140,140,16,16,0,1,0
1,183,183,41,24,17,2,1
10,191,191,35,35,0,1,0
6,238,238,74,71,3,2,1
13,242,242,16,4,12,3,2
0,252,252,13,13,0,1,0
14,273,273,64,24,40,3,2
15,292,292,15,3,12,3,2
4,296,296,110,45,65,4,3
17,317,317,4,1,3,2,1
11,324,324,13,13,0,1,0
3,357,357,52,52,0,1,0
7,370,370,29,17,12,4,3
9,398,398,103,85,18,3,2
2,413,413,106,106,0,1,0
19,429,429,25,1,24,2,1
18,453,453,19,1,18,3,2
8,493,493,10,10,0,1,0

1,114,114,57,5,52,3,2
0,128,128,8,3,5,2,1
17,161,161,17,17,0,1,0
23,173,173,31,31,0,1,0
18,180,180,14,3,11,2,1
6,182,182,2,2,0,1,0
11,200,200,13,4,9,2,1
10,210,210,37,37,0,1,0
4,214,214,41,18,23,3,2
3,218,218,21,13,8,2,1
19,227,227,5,5,0,1,0
9,229,229,23,10,13,2,1
15,240,240,63,63,0,1,0
16,267,267,26,4,22,2,1
7,295,295,42,42,0,1,0
13,327,327,45,45,0,1,0
21,356,356,54,43,11,3,2
12,407,407,20,12,8,3,2
20,425,425,6,3,3,2,1
14,440,440,5,5,0,1,0
22,451,451,106,68,38,4,3
24,456,456,7,7,0,1,0
8,466,466,2,2,0,1,0
2,486,486,32,32,0,1,0
5,490,490,25,15,10,3,2

0,105,105,2,2,0,1,0
27,107,107,11,11,0,1,0
1,109,109,3,3,0,1,0
23,122,122,6,6,0,1,0
24,124,124,15,9,6,2,1
14,127,127,4,4,0,1,0
20,148,148,5,5,0,1,0
3,170,170,9,9,0,1,0
30,192,192,15,15,0,1,0
28,204,204,57,21,36,4,3
22,224,224,8,8,0,1,0
17,250,250,12,12,0,1,0
9,254,254,15,15,0,1,0
18,292,292,22,22,0,1,0
12,297,297,24,24,0,1,0
19,338,338,75,75,0,1,0
6,350,350,42,42,0,1,0
13,351,351,2,2,0,1,0
11,352,352,32,32,0,1,0
4,381,381,62,62,0,1,0
5,401,401,6,6,0,1,0
8,410,410,47,47,0,1,0
10,422,422,31,31,0,1,0
29,422,422,73,73,0,1,0
26,450,450,24,9,15,4,3
2,456,456,35,13,22,3,2
25,477,477,37,7,30,3,2
7,479,479,168,168,0,1,0
15,484,484,25,14,11,2,1
21,488,488,45,39,6,3,2
16,499,499,34,22,12,2,1

8,146,146,3,3,0,1,0
5,184,184,6,6,0,1,0
7,192,192,17,7,10,3,2
11,202,202,20,20,0,1,0
17,238,238,14,14,0,1,0
3,256,256,6,6,0,1,0
18,260,260,27,27,0,1,0
13,262,262,12,12,0,1,0
19,263,263,26,26,0,1,0
9,264,264,42,42,0,1,0
20,377,377,38,38,0,1,0
1,379,379,133,85,48,4,3
21,391,391,14,14,0,1,0
10,392,392,30,30,0,1,0
2,400,400,25,1,24,2,1
16,424,424,14,6,8,3,2
6,441,441,1,1,0,1,0
12,476,476,110,85,25,2,1
15,476,476,171,154,17,2,1
0,477,477,177,96,81,4,3
4,483,483,228,108,120,4,3
14,489,489,2,2,0,1,0

5,110,110,5,5,0,1,0
29,139,139,12,6,6,2,1
0,166,166,12,8,4,2,1
18,203,203,2,2,0,1,0
12,207,207,10,10,0,1,0
10,227,227,27,8,19,4,3
26,229,229,31,31,0,1,0
2,237,237,10,10,0,1,0
21,264,264,91,13,78,4,3
25,268,268,10,2,8,2,1
6,271,271,1,1,0,1,0
27,277,277,40,21,19,2,1
9,277,277,3,3,0,1,0
11,299,299,24,5,19,2,1
19,317,317,16,4,12,3,2
4,341,341,4,4,0,1,0
14,350,350,28,25,3,2,1
3,356,356,21,21,0,1,0
16,364,364,60,37,23,3,2
13,369,369,8,8,0,1,0
8,405,405,54,54,0,1,0
1,410,410,55,23,32,2,1
24,420,420,2,2,0,1,0
15,430,430,170,170,0,1,0
22,432,432,34,13,21,2,1
17,435,435,15,3,12,2,1
28,459,459,19,19,0,1,0
20,461,461,107,83,24,4,3
23,479,479,29,29,0,1,0
7,480,480,69,19,50,2,1

12,132,132,11,8,3,2,1
0,146,146,44,18,26,2,1
14,164,164,3,3,0,1,0
2,172,172,1,1,0,1,0
23,197,197,22,8,14,3,2
3,205,205,16,16,0,1,0
18,220,220,108,108,0,1,0
11,224,224,13,13,0,1,0
10,225,225,31,31,0,1,0
9,253,253,1,1,0,1,0
13,253,253,7,7,0,1,0
1,267,267,13,5,8,3,2
7,283,283,28,10,18,3,2
21,315,315,10,2,8,3,2
4,331,331,6,1,5,2,1
6,343,343,11,11,0,1,0
5,362,362,37,34,3,2,1
24,409,409,90,48,42,4,3
22,416,416,27,17,10,3,2
16,431,431,3,3,0,1,0
19,432,432,30,30,0,1,0
17,436,436,69,69,0,1,0
15,451,451,38,38,0,1,0
20,459,459,3,3,0,1,0
8,484,484,279,279,0,1,0

11,108,108,24,24,0,1,0
18,118,118,4,4,0,1,0
6,120,120,27,27,0,1,0
25,156,156,4,4,0,1,0
22,167,167,13,1,12,4,3
16,192,192,19,14,5,2,1
20,203,203,67,45,22,2,1
21,206,206,78,78,0,1,0
0,228,228,25,2,23,3,2
15,252,252,1,1,0,1,0
17,259,259,21,3,18,2,1
24,262,262,56,56,0,1,0
9,267,267,13,13,0,1,0
1,268,268,17,7,10,3,2
4,284,284,61,20,41,2,1
2,287,287,3,3,0,1,0
7,306,306,78,69,9,4,3
12,318,318,5,5,0,1,0
13,334,334,17,17,0,1,0
8,363,363,35,7,28,4,3
19,380,380,12,12,0,1,0
10,389,389,17,17,0,1,0
3,413,413,18,9,9,4,3
23,453,453,20,20,0,1,0
5,482,482,36,13,23,4,3
14,498,498,25,25,0,1,0

6,101,101,24,24,0,1,0
1,116,116,2,2,0,1,0
25,116,116,12,4,8,2,1
0,172,172,19,10,9,4,3
3,185,185,5,1,4,2,1
30,191,191,74,6,68,4,3
15,202,202,1,1,0,1,0
24,206,206,11,2,9,2,1
14,230,230,33,12,21,4,3
22,231,231,11,11,0,1,0
20,247,247,19,19,0,1,0
5,264,264,43,43,0,1,0
11,276,276,11,3,8,3,2
9,331,331,1,1,0,1,0
7,339,339,1,1,0,1,0
28,344,344,69,19,50,3,2
12,347,347,69,69,0,1,0
27,350,350,3,3,0,1,0
10,361,361,10,2,8,2,1
23,365,365,45,45,0,1,0
31,366,366,12,12,0,1,0
29,395,395,91,57,34,3,2
18,397,397,20,16,4,2,1
17,417,417,45,45,0,1,0
16,421,421,33,23,10,2,1
2,436,436,8,2,6,3,2
8,446,446,13,7,6,3,2
26,451,451,15,10,5,2,1
13,462,462,43,17,26,3,2
4,463,463,46,15,31,2,1
19,473,473,26,2,24,3,2
21,499,499,13,13,0,1,0

15,102,102,22,22,0,1,0
18,103,103,7,4,3,2,1
24,108,108,19,5,14,3,2
16,112,112,29,29,0,1,0
14,117,117,3,3,0,1,0
4,149,149,5,5,0,1,0
22,175,175,5,5,0,1,0
3,186,186,10,10,0,1,0
11,192,192,2,2,0,1,0
25,209,209,5,5,0,1,0
26,222,222,71,71,0,1,0
6,233,233,19,10,9,4,3
5,258,258,41,41,0,1,0
7,285,285,31,31,0,1,0
28,291,291,24,24,0,1,0
27,292,292,38,38,0,1,0
21,325,325,41,41,0,1,0
13,343,343,21,17,4,2,1
2,386,386,24,24,0,1,0
17,402,402,14,2,12,3,2
12,407,407,113,71,42,4,3
10,412,412,27,27,0,1,0
23,413,413,2,2,0,1,0
1,425,425,23,23,0,1,0
20,426,426,18,6,12,2,1
8,427,427,5,5,0,1,0
9,429,429,67,13,54,4,3
19,447,447,18,18,0,1,0
0,454,454,14,14,0,1,0
29,488,488,49,3,46,2,1

9,105,105,8,8,0,1,0
19,125,125,5,2,3,2,1
12,125,125,4,4,0,1,0
13,133,133,26,26,0,1,0
35,139,139,24,15,9,4,3
36,160,160,16,11,5,2,1
20,161,161,9,9,0,1,0
26,214,214,5,5,0,1,0
10,234,234,6,6,0,1,0
27,234,234,25,25,0,1,0
22,238,238,7,2,5,2,1
0,253,253,13,13,0,1,0
15,263,263,14,14,0,1,0
29,283,283,26,5,21,4,3
18,306,306,5,5,0,1,0
6,322,322,10,7,3,2,1
11,325,325,1,1,0,1,0
7,337,337,15,15,0,1,0
17,354,354,11,7,4,2,1
38,354,354,23,9,14,3,2
24,360,360,2,2,0,1,0
16,364,364,22,9,13,2,1
2,378,378,73,73,0,1,0
8,379,379,13,5,8,3,2
31,390,390,1,1,0,1,0
37,402,402,3,3,0,1,0
4,403,403,8,4,4,2,1
14,407,407,13,13,0,1,0
33,411,411,38,38,0,1,0
34,420,420,79,23,56,3,2
30,424,424,181,181,0,1,0
28,426,426,30,30,0,1,0
5,433,433,93,93,0,1,0
32,437,437,32,3,29,2,1
25,441,441,3,3,0,1,0
21,448,448,6,6,0,1,0
3,471,471,18,18,0,1,0
1,486,486,26,8,18,2,1
23,493,493,25,3,22,2,1

25,143,143,4,4,0,1,0
13,150,150,12,12,0,1,0
21,172,172,2,2,0,1,0
7,192,192,26,26,0,1,0
23,211,211,24,24,0,1,0
15,213,213,38,5,33,4,3
3,236,236,21,3,18,3,2
6,251,251,2,2,0,1,0
4,257,257,19,19,0,1,0
10,259,259,3,3,0,1,0
20,278,278,27,3,24,3,2
9,282,282,28,1,27,2,1
17,287,287,10,10,0,1,0
1,306,306,137,57,80,4,3
12,317,317,56,56,0,1,0
19,364,364,78,78,0,1,0
16,366,366,11,11,0,1,0
14,371,371,11,11,0,1,0
2,380,380,39,39,0,1,0
18,382,382,72,52,20,3,2
11,419,419,15,11,4,2,1
24,423,423,106,91,15,4,3
5,424,424,27,27,0,1,0
0,446,446,29,2,27,3,2
22,451,451,1,1,0,1,0
26,476,476,76,59,17,2,1
8,477,477,45,6,39,4,3

4,142,142,25,3,22,3,2
0,155,155,13,5,8,2,1
24,161,161,6,6,0,1,0
11,161,161,29,29,0,1,0
22,170,170,14,6,8,2,1
17,197,197,42,42,0,1,0
6,220,220,47,25,22,2,1
18,236,236,27,27,0,1,0
2,241,241,54,54,0,1,0
14,263,263,23,5,18,2,1
13,287,287,23,19,4,2,1
5,311,311,22,22,0,1,0
15,322,322,7,1,6,3,2
16,322,322,51,51,0,1,0
1,327,327,24,24,0,1,0
21,376,376,11,5,6,2,1
8,386,386,23,23,0,1,0
7,392,392,7,7,0,1,0
20,399,399,48,9,39,4,3
10,414,414,79,79,0,1,0
9,426,426,59,59,0,1,0
19,428,428,43,43,0,1,0
3,445,445,68,68,0,1,0
23,451,451,37,37,0,1,0
12,470,470,53,53,0,1,0

18,100,100,10,1,9,2,1
22,111,111,4,4,0,1,0
7,111,111,4,1,3,2,1
1,127,127,11,3,8,3,2
20,139,139,1,1,0,1,0
5,140,140,13,6,7,2,1
23,145,145,3,3,0,1,0
2,148,148,31,31,0,1,0
13,154,154,26,14,12,3,2
14,174,174,4,4,0,1,0
21,190,190,102,22,80,3,2
8,221,221,14,14,0,1,0
24,241,241,35,35,0,1,0
16,299,299,22,10,12,2,1
15,315,315,37,37,0,1,0
0,358,358,43,43,0,1,0
3,370,370,19,4,15,4,3
4,385,385,78,78,0,1,0
12,388,388,14,14,0,1,0
11,395,395,145,84,61,3,2
10,403,403,8,8,0,1,0
6,403,403,2,2,0,1,0
19,448,448,12,7,5,2,1
17,449,449,39,39,0,1,0
9,469,469,69,15,54,4,3
25,480,480,29,29,0,1,0

20,110,110,1,1,0,1,0
12,111,111,3,3,0,1,0
37,119,119,6,6,0,1,0
15,145,145,12,12,0,1,0
16,150,150,24,12,12,2,1
17,157,157,13,1,12,4,3
31,161,161,14,14,0,1,0
35,173,173,13,13,0,1,0
28,184,184,26,26,0,1,0
38,192,192,7,7,0,1,0
11,202,202,1,1,0,1,0
22,206,206,1,1,0,1,0
2,228,228,14,6,8,2,1
23,231,231,57,29,28,3,2
32,238,238,6,1,5,2,1
13,256,256,6,6,0,1,0
6,257,257,2,2,0,1,0
4,267,267,3,3,0,1,0
5,275,275,1,1,0,1,0
34,294,294,59,59,0,1,0
40,344,344,25,25,0,1,0
10,372,372,28,1,27,4,3
26,392,392,10,10,0,1,0
27,400,400,25,4,21,4,3
33,406,406,39,21,18,2,1
25,409,409,7,7,0,1,0
7,413,413,49,49,0,1,0
39,415,415,148,140,8,2,1
1,418,418,1,1,0,1,0
19,420,420,5,2,3,2,1
18,421,421,8,8,0,1,0
21,429,429,56,40,16,2,1
36,429,429,21,3,18,3,2
9,435,435,70,70,0,1,0
0,446,446,2,2,0,1,0
24,454,454,4,4,0,1,0
3,486,486,20,20,0,1,0
14,492,492,18,2,16,3,2
30,494,494,45,8,37,4,3
8,494,494,12,12,0,1,0
29,495,495,46,46,0,1,0

20,102,102,6,6,0,1,0
22,131,131,1,1,0,1,0
5,136,136,1,1,0,1,0
6,137,137,12,12,0,1,0
31,147,147,12,5,7,2,1
1,157,157,3,3,0,1,0
18,169,169,8,8,0,1,0
23,176,176,77,77,0,1,0
7,185,185,18,2,16,3,2
15,188,188,1,1,0,1,0
17,226,226,27,15,12,3,2
2,227,227,6,6,0,1,0
29,262,262,51,48,3,2,1
28,281,281,1,1,0,1,0
0,300,300,2,2,0,1,0
21,310,310,78,30,48,4,3
11,319,319,26,26,0,1,0
19,327,327,11,3,8,2,1
24,337,337,2,2,0,1,0
13,346,346,22,22,0,1,0
27,351,351,80,80,0,1,0
12,361,361,17,1,16,3,2
10,381,381,16,16,0,1,0
14,398,398,29,2,27,2,1
8,405,405,181,111,70,3,2
4,408,408,10,1,9,4,3
16,428,428,35,6,29,4,3
9,439,439,34,34,0,1,0
3,439,439,41,23,18,4,3
25,448,448,8,4,4,2,1
26,460,460,15,15,0,1,0
30,462,462,15,6,9,4,3

23,109,109,40,40,0,1,0
14,116,116,11,11,0,1,0
5,122,122,1,1,0,1,0
7,136,136,8,4,4,2,1
31,191,191,29,29,0,1,0
16,201,201,16,16,0,1,0
12,209,209,8,2,6,3,2
13,215,215,1,1,0,1,0
26,218,218,7,7,0,1,0
18,229,229,60,60,0,1,0
4,231,231,2,2,0,1,0
15,282,282,12,1,11,2,1
0,292,292,58,12,46,2,1
1,299,299,12,12,0,1,0
17,316,316,32,32,0,1,0
8,329,329,8,8,0,1,0
30,330,330,3,3,0,1,0
20,337,337,5,5,0,1,0
25,344,344,85,85,0,1,0
34,360,360,27,27,0,1,0
22,378,378,73,15,58,3,2
33,410,410,10,5,5,2,1
9,418,418,64,64,0,1,0
6,419,419,12,12,0,1,0
21,431,431,10,10,0,1,0
3,432,432,30,30,0,1,0
19,439,439,4,4,0,1,0
10,442,442,3,3,0,1,0
2,443,443,12,2,10,3,2
28,446,446,22,8,14,2,1
27,457,457,32,19,13,2,1
32,472,472,43,28,15,2,1
24,480,480,19,19,0,1,0
11,491,491,64,45,19,2,1
29,491,491,24,24,0,1,0

16,109,109,8,3,5,2,1
23,114,114,7,7,0,1,0
25,118,118,1,1,0,1,0
2,122,122,8,3,5,2,1
24,129,129,53,53,0,1,0
12,155,155,4,4,0,1,0
18,176,176,16,16,0,1,0
6,183,183,7,1,6,2,1
14,205,205,37,37,0,1,0
13,228,228,4,4,0,1,0
5,244,244,23,13,10,2,1
0,252,252,38,33,5,2,1
7,255,255,13,5,8,3,2
9,281,281,20,20,0,1,0
19,283,283,64,64,0,1,0
8,316,316,26,12,14,2,1
4,334,334,97,97,0,1,0
22,338,338,35,26,9,4,3
26,362,362,18,18,0,1,0
27,369,369,51,51,0,1,0
3,373,373,87,65,22,2,1
1,394,394,8,8,0,1,0
21,395,395,6,6,0,1,0
10,408,408,16,16,0,1,0
20,421,421,11,8,3,2,1
11,449,449,100,32,68,4,3
17,452,452,3,3,0,1,0
15,454,454,17,17,0,1,0

29,103,103,4,4,0,1,0
23,116,116,29,29,0,1,0
15,121,121,18,10,8,2,1
31,133,133,12,12,0,1,0
24,137,137,4,4,0,1,0
7,138,138,15,2,13,2,1
10,143,143,2,2,0,1,0
21,143,143,1,1,0,1,0
9,145,145,17,17,0,1,0
2,149,149,10,1,9,4,3
27,157,157,14,14,0,1,0
6,178,178,6,3,3,2,1
20,184,184,3,3,0,1,0
32,185,185,49,49,0,1,0
13,198,198,1,1,0,1,0
11,210,210,54,33,21,4,3
17,217,217,21,21,0,1,0
1,263,263,7,1,6,2,1
12,271,271,42,12,30,4,3
0,309,309,28,28,0,1,0
8,326,326,14,6,8,3,2
4,343,343,7,1,6,3,2
14,346,346,4,4,0,1,0
5,349,349,6,6,0,1,0
26,351,351,72,72,0,1,0
18,372,372,8,1,7,2,1
25,404,404,13,13,0,1,0
22,415,415,27,9,18,3,2
19,425,425,32,32,0,1,0
16,461,461,3,3,0,1,0
28,466,466,24,24,0,1,0
3,489,489,78,54,24,3,2
30,490,490,108,38,70,3,2

10,110,110,6,6,0,1,0
8,142,142,18,18,0,1,0
6,143,143,33,3,30,3,2
13,144,144,8,8,0,1,0
1,170,170,1,1,0,1,0
9,174,174,46,46,0,1,0
14,176,176,53,53,0,1,0
11,212,212,7,7,0,1,0
19,272,272,4,4,0,1,0
20,276,276,7,7,0,1,0
12,283,283,43,43,0,1,0
0,286,286,108,108,0,1,0
18,300,300,36,36,0,1,0
4,304,304,26,6,20,2,1
17,304,304,24,24,0,1,0
15,319,319,16,6,10,2,1
7,410,410,30,30,0,1,0
5,420,420,44,13,31,2,1
2,432,432,150,130,20,3,2
21,436,436,1,1,0,1,0
16,437,437,67,23,44,3,2
3,452,452,80,5,75,4,3

16,101,101,13,9,4,2,1
26,111,111,12,8,4,2,1
31,133,133,15,15,0,1,0
1,138,138,1,1,0,1,0
30,138,138,3,3,0,1,0
12,145,145,19,19,0,1,0
29,147,147,32,32,0,1,0
19,147,147,3,3,0,1,0
7,149,149,1,1,0,1,0
22,163,163,3,3,0,1,0
2,169,169,1,1,0,1,0
25,172,172,19,19,0,1,0
23,187,187,68,68,0,1,0
21,187,187,13,13,0,1,0
4,206,206,7,7,0,1,0
20,208,208,8,1,7,2,1
5,228,228,46,46,0,1,0
6,231,231,36,36,0,1,0
0,236,236,2,2,0,1,0
17,268,268,4,4,0,1,0
28,292,292,26,26,0,1,0
14,306,306,1,1,0,1,0
15,307,307,14,10,4,2,1
27,326,326,75,41,34,3,2
24,338,338,7,7,0,1,0
8,340,340,17,1,16,3,2
13,341,341,22,22,0,1,0
3,362,362,13,4,9,4,3
10,451,451,42,42,0,1,0
11,472,472,15,9,6,3,2
18,476,476,10,10,0,1,0
9,482,482,184,136,48,2,1

15,140,140,2,2,0,1,0
7,203,203,10,10,0,1,0
2,227,227,5,2,3,2,1
20,239,239,104,104,0,1,0
6,244,244,39,29,10,2,1
13,261,261,6,2,4,2,1
0,288,288,20,20,0,1,0
14,348,348,66,66,0,1,0
12,349,349,4,1,3,2,1
11,368,368,79,55,24,2,1
3,368,368,257,243,14,3,2
18,371,371,51,51,0,1,0
10,375,375,59,10,49,4,3
4,388,388,18,18,0,1,0
21,401,401,31,31,0,1,0
9,440,440,8,3,5,2,1
16,448,448,12,12,0,1,0
1,450,450,46,4,42,2,1
19,473,473,29,29,0,1,0
17,493,493,11,3,8,3,2
8,494,494,17,9,8,2,1
5,494,494,125,90,35,3,2

8,133,133,7,7,0,1,0
20,136,136,29,14,15,2,1
27,166,166,14,3,11,2,1
10,174,174,1,1,0,1,0
15,175,175,2,2,0,1,0
1,189,189,28,25,3,2,1
0,190,190,1,1,0,1,0
29,194,194,37,37,0,1,0
30,199,199,1,1,0,1,0
28,211,211,20,6,14,2,1
22,223,223,35,35,0,1,0
7,224,224,8,1,7,2,1
2,228,228,6,3,3,2,1
21,304,304,21,21,0,1,0
19,347,347,28,28,0,1,0
18,350,350,11,11,0,1,0
11,367,367,26,26,0,1,0
14,394,394,57,57,0,1,0
12,395,395,51,51,0,1,0
3,400,400,13,13,0,1,0
6,405,405,4,4,0,1,0
25,422,422,13,13,0,1,0
23,428,428,18,9,9,4,3
26,428,428,91,1,90,4,3
24,432,432,70,6,64,3,2
17,434,434,24,24,0,1,0
4,435,435,153,153,0,1,0
13,441,441,93,21,72,3,2
5,454,454,7,1,6,2,1
16,465,465,32,14,18,2,1
9,495,495,41,41,0,1,0

3,108,108,5,5,0,1,0
6,109,109,6,6,0,1,0
33,137,137,2,2,0,1,0
16,150,150,2,2,0,1,0
31,163,163,24,5,19,2,1
19,166,166,13,13,0,1,0
22,177,177,8,8,0,1,0
15,182,182,15,7,8,3,2
2,194,194,6,6,0,1,0
28,195,195,24,19,5,2,1
21,200,200,5,5,0,1,0
30,204,204,60,18,42,3,2
14,213,213,35,35,0,1,0
32,234,234,39,23,16,2,1
34,257,257,30,16,14,3,2
11,272,272,10,10,0,1,0
4,300,300,19,19,0,1,0
29,320,320,17,17,0,1,0
17,341,341,14,1,13,2,1
7,362,362,23,23,0,1,0
27,362,362,35,5,30,2,1
9,392,392,33,33,0,1,0
18,399,399,59,7,52,3,2
5,404,404,35,3,32,3,2
20,405,405,70,70,0,1,0
13,407,407,8,3,5,2,1
10,408,408,12,2,10,3,2
0,421,421,34,34,0,1,0
1,429,429,13,13,0,1,0
26,431,431,56,56,0,1,0
24,439,439,69,69,0,1,0
12,445,445,31,27,4,2,1
23,455,455,9,9,0,1,0
25,461,461,14,2,12,2,1
8,496,496,2,2,0,1,0

4,123,123,2,2,0,1,0
7,139,139,13,13,0,1,0
24,146,146,40,24,16,3,2
26,175,175,11,11,0,1,0
31,189,189,4,1,3,2,1
2,217,217,82,40,42,3,2
8,217,217,10,10,0,1,0
6,223,223,9,4,5,2,1
12,260,260,15,15,0,1,0
1,280,280,13,4,9,4,3
29,280,280,38,30,8,3,2
14,294,294,20,20,0,1,0
17,351,351,5,5,0,1,0
9,352,352,9,4,5,2,1
28,360,360,29,23,6,3,2
18,369,369,50,11,39,2,1
10,375,375,25,25,0,1,0
0,409,409,13,7,6,2,1
11,415,415,16,8,8,3,2
20,417,417,43,43,0,1,0
3,432,432,25,25,0,1,0
27,445,445,57,57,0,1,0
30,448,448,22,9,13,2,1
25,454,454,18,2,16,3,2
15,457,457,161,59,102,4,3
23,467,467,40,26,14,4,3
16,468,468,29,29,0,1,0
19,470,470,23,23,0,1,0
13,476,476,1,1,0,1,0
22,490,490,89,65,24,4,3
21,497,497,35,35,0,1,0
5,500,500,2,2,0,1,0

27,102,102,26,7,19,2,1
2,142,142,1,1,0,1,0
30,167,167,26,5,21,2,1
7,175,175,5,5,0,1,0
11,207,207,28,4,24,3,2
14,221,221,12,2,10,3,2
24,233,233,1,1,0,1,0
20,250,250,22,15,7,2,1
29,266,266,37,4,33,4,3
25,270,270,5,5,0,1,0
12,275,275,31,31,0,1,0
18,276,276,38,38,0,1,0
3,278,278,45,6,39,4,3
26,281,281,13,13,0,1,0
10,288,288,8,8,0,1,0
5,295,295,71,56,15,4,3
17,300,300,16,6,10,3,2
0,301,301,6,6,0,1,0
22,306,306,23,23,0,1,0
1,311,311,7,1,6,3,2
28,326,326,8,8,0,1,0
15,345,345,24,24,0,1,0
19,374,374,71,71,0,1,0
21,386,386,84,54,30,3,2
8,411,411,15,15,0,1,0
4,441,441,12,6,6,2,1
6,450,450,41,12,29,2,1
23,452,452,13,13,0,1,0
9,471,471,22,6,16,3,2
16,492,492,75,23,52,3,2
13,493,493,82,51,31,2,1

23,108,108,17,17,0,1,0
5,110,110,2,2,0,1,0
20,118,118,8,8,0,1,0
30,120,120,8,8,0,1,0
34,141,141,10,1,9,2,1
35,151,151,20,2,18,3,2
27,155,155,4,4,0,1,0
19,160,160,6,1,5,2,1
31,164,164,33,13,20,2,1
24,177,177,15,15,0,1,0
7,177,177,28,13,15,4,3
25,181,181,8,2,6,3,2
3,186,186,19,19,0,1,0
21,190,190,2,2,0,1,0
12,193,193,19,19,0,1,0
18,215,215,2,2,0,1,0
10,220,220,25,16,9,2,1
9,230,230,7,7,0,1,0
4,249,249,17,1,16,2,1
8,250,250,4,4,0,1,0
14,252,252,18,18,0,1,0
36,255,255,36,16,20,2,1
15,255,255,54,42,12,2,1
16,272,272,8,8,0,1,0
33,277,277,6,6,0,1,0
0,303,303,18,15,3,2,1
22,311,311,9,1,8,2,1
32,321,321,39,39,0,1,0
28,337,337,35,20,15,2,1
11,340,340,12,12,0,1,0
29,356,356,35,35,0,1,0
6,381,381,37,13,24,3,2
17,381,381,19,12,7,2,1
1,411,411,20,20,0,1,0
26,420,420,67,67,0,1,0
2,428,428,13,7,6,2,1
13,470,470,4,4,0,1,0

23,117,117,27,14,13,2,1
19,155,155,7,7,0,1,0
8,156,156,21,15,6,2,1
17,165,165,4,4,0,1,0
15,190,190,9,9,0,1,0
18,214,214,67,44,23,2,1
14,223,223,6,6,0,1,0
10,230,230,27,27,0,1,0
28,237,237,5,5,0,1,0
31,240,240,45,45,0,1,0
11,247,247,5,5,0,1,0
22,276,276,13,10,3,2,1
3,280,280,5,5,0,1,0
30,331,331,25,15,10,2,1
1,352,352,1,1,0,1,0
9,353,353,53,53,0,1,0
0,375,375,57,36,21,4,3
21,380,380,83,44,39,3,2
25,382,382,62,35,27,2,1
27,383,383,6,6,0,1,0
29,384,384,7,7,0,1,0
12,385,385,18,3,15,2,1
5,400,400,2,2,0,1,0
6,421,421,4,1,3,2,1
2,438,438,29,29,0,1,0
16,440,440,71,5,66,4,3
7,444,444,93,69,24,3,2
26,444,444,9,9,0,1,0
24,446,446,23,2,21,4,3
13,477,477,70,52,18,4,3
20,487,487,9,9,0,1,0
4,492,492,31,31,0,1,0

8,101,101,19,11,8,3,2
22,116,116,9,9,0,1,0
18,136,136,28,28,0,1,0
9,145,145,1,1,0,1,0
11,155,155,21,21,0,1,0
4,164,164,11,11,0,1,0
13,164,164,12,12,0,1,0
19,169,169,1,1,0,1,0
21,177,177,2,2,0,1,0
10,189,189,18,2,16,2,1
16,219,219,4,4,0,1,0
15,236,236,11,1,10,2,1
12,286,286,67,36,31,2,1
20,310,310,69,69,0,1,0
24,334,334,28,28,0,1,0
3,359,359,54,33,21,2,1
7,360,360,19,19,0,1,0
0,365,365,68,68,0,1,0
1,371,371,184,110,74,3,2
5,383,383,19,4,15,2,1
23,399,399,42,42,0,1,0
2,408,408,15,15,0,1,0
6,409,409,31,31,0,1,0
14,429,429,33,1,32,2,1
17,498,498,70,13,57,4,3

1,141,141,12,1,11,2,1
19,142,142,4,4,0,1,0
2,161,161,11,11,0,1,0
27,172,172,5,5,0,1,0
20,212,212,2,2,0,1,0
26,220,220,13,13,0,1,0
22,225,225,30,30,0,1,0
23,245,245,6,6,0,1,0
11,279,279,19,14,5,2,1
14,283,283,46,24,22,2,1
29,284,284,74,60,14,3,2
21,291,291,103,64,39,2,1
18,306,306,27,20,7,2,1
4,322,322,98,24,74,4,3
15,324,324,4,1,3,2,1
10,330,330,2,2,0,1,0
9,333,333,42,36,6,2,1
33,335,335,7,7,0,1,0
13,341,341,23,15,8,3,2
5,390,390,15,15,0,1,0
25,393,393,66,2,64,3,2
8,398,398,13,13,0,1,0
31,399,399,11,11,0,1,0
6,407,407,1,1,0,1,0
32,410,410,75,61,14,2,1
24,411,411,46,22,24,3,2
17,415,415,20,15,5,2,1
7,417,417,1,1,0,1,0
30,439,439,6,6,0,1,0
12,447,447,69,69,0,1,0
16,452,452,2,2,0,1,0
0,468,468,39,39,0,1,0
3,469,469,11,11,0,1,0
28,488,488,17,5,12,4,3

16,109,109,1,1,0,1,0
22,111,111,24,18,6,2,1
5,123,123,5,5,0,1,0
20,130,130,16,3,13,2,1
14,132,132,3,3,0,1,0
1,133,133,11,11,0,1,0
27,142,142,7,7,0,1,0
26,147,147,20,20,0,1,0
15,175,175,11,11,0,1,0
25,198,198,42,42,0,1,0
18,200,200,51,22,29,2,1
19,208,208,2,2,0,1,0
4,233,233,9,9,0,1,0
23,234,234,2,2,0,1,0
17,259,259,44,11,33,2,1
2,273,273,12,12,0,1,0
12,287,287,125,64,61,4,3
11,306,306,26,8,18,2,1
28,307,307,12,1,11,2,1
24,330,330,3,3,0,1,0
13,333,333,31,31,0,1,0
7,360,360,21,21,0,1,0
29,393,393,25,2,23,2,1
21,398,398,55,55,0,1,0
6,409,409,31,19,12,2,1
0,414,414,10,10,0,1,0
9,464,464,11,11,0,1,0
8,473,473,75,75,0,1,0
3,485,485,14,14,0,1,0
10,493,493,64,64,0,1,0

18,100,100,22,2,20,2,1
12,102,102,3,3,0,1,0
13,109,109,2,2,0,1,0
4,119,119,2,2,0,1,0
22,140,140,44,44,0,1,0
6,163,163,27,9,18,3,2
7,173,173,10,10,0,1,0
10,191,191,28,12,16,3,2
16,200,200,14,14,0,1,0
31,226,226,7,7,0,1,0
23,231,231,5,2,3,2,1
5,235,235,18,3,15,2,1
21,241,241,7,1,6,3,2
3,242,242,9,1,8,3,2
19,257,257,10,2,8,2,1
14,281,281,8,8,0,1,0
28,297,297,24,13,11,2,1
30,298,298,71,55,16,3,2
25,305,305,14,14,0,1,0
11,327,327,20,20,0,1,0
17,348,348,27,20,7,2,1
2,363,363,3,3,0,1,0
20,368,368,67,47,20,2,1
8,369,369,48,48,0,1,0
9,381,381,39,39,0,1,0
24,383,383,7,7,0,1,0
32,413,413,8,8,0,1,0
26,429,429,24,3,21,4,3
29,429,429,40,18,22,3,2
27,431,431,112,60,52,3,2
1,444,444,29,4,25,4,3
15,477,477,39,39,0,1,0
0,500,500,5,5,0,1,0

14,105,105,1,1,0,1,0
8,107,107,1,1,0,1,0
7,108,108,11,11,0,1,0
18,171,171,14,14,0,1,0
22,203,203,4,4,0,1,0
4,208,208,8,8,0,1,0
26,216,216,21,21,0,1,0
29,227,227,35,23,12,4,3
20,238,238,13,13,0,1,0
2,242,242,8,3,5,2,1
3,261,261,46,46,0,1,0
30,270,270,20,8,12,4,3
1,271,271,16,7,9,2,1
27,278,278,26,7,19,4,3
17,280,280,18,1,17,4,3
25,311,311,51,7,44,4,3
24,327,327,29,12,17,2,1
6,328,328,33,14,19,3,2
11,337,337,84,51,33,4,3
13,371,371,19,1,18,4,3
9,374,374,38,38,0,1,0
16,376,376,2,2,0,1,0
5,381,381,39,39,0,1,0
28,393,393,121,121,0,1,0
10,433,433,6,6,0,1,0
23,442,442,56,56,0,1,0
0,444,444,21,7,14,3,2
15,462,462,59,59,0,1,0
21,482,482,44,44,0,1,0
12,485,485,85,22,63,4,3
19,494,494,3,3,0,1,0

1,106,106,1,1,0,1,0
18,112,112,4,1,3,2,1
23,113,113,19,6,13,3,2
22,113,113,5,1,4,2,1
6,118,118,26,26,0,1,0
17,119,119,3,3,0,1,0
12,126,126,1,1,0,1,0
15,142,142,26,15,11,4,3
24,149,149,15,15,0,1,0
26,151,151,26,26,0,1,0
14,155,155,42,36,6,2,1
7,194,194,21,9,12,4,3
27,202,202,43,17,26,3,2
5,270,270,33,33,0,1,0
10,322,322,20,20,0,1,0
8,345,345,2,2,0,1,0
0,359,359,41,23,18,4,3
3,390,390,43,6,37,2,1
21,392,392,11,11,0,1,0
25,404,404,29,17,12,2,1
11,414,414,79,79,0,1,0
4,433,433,8,8,0,1,0
13,436,436,106,5,101,4,3
2,449,449,71,71,0,1,0
19,474,474,27,12,15,2,1
9,475,475,14,3,11,2,1
20,479,479,1,1,0,1,0
16,496,496,37,37,0,1,0

26,103,103,7,7,0,1,0
3,113,113,11,1,10,2,1
11,147,147,9,1,8,2,1
18,152,152,2,2,0,1,0
5,157,157,73,73,0,1,0
10,163,163,2,2,0,1,0
15,164,164,1,1,0,1,0
8,165,165,17,1,16,3,2
17,166,166,6,1,5,2,1
14,210,210,3,3,0,1,0
19,235,235,36,7,29,2,1
16,259,259,89,17,72,4,3
20,276,276,57,45,12,4,3
24,277,277,28,28,0,1,0
4,286,286,5,5,0,1,0
6,287,287,11,1,10,3,2
13,311,311,9,9,0,1,0
21,318,318,26,26,0,1,0
9,358,358,8,2,6,2,1
2,370,370,22,7,15,4,3
0,409,409,59,59,0,1,0
23,418,418,46,46,0,1,0
7,419,419,70,70,0,1,0
12,435,435,79,79,0,1,0
1,456,456,14,14,0,1,0
25,476,476,46,46,0,1,0
22,486,486,83,57,26,3,2

18,111,111,10,4,6,2,1
9,118,118,2,2,0,1,0
3,170,170,4,4,0,1,0
14,172,172,24,8,16,2,1
24,175,175,3,3,0,1,0
27,176,176,35,35,0,1,0
2,197,197,52,29,23,2,1
22,203,203,15,15,0,1,0
12,206,206,22,4,18,2,1
26,234,234,20,20,0,1,0
8,252,252,2,2,0,1,0
6,258,258,10,10,0,1,0
13,259,259,101,53,48,4,3
4,276,276,59,51,8,3,2
0,340,340,29,29,0,1,0
21,357,357,76,31,45,2,1
25,375,375,67,67,0,1,0
16,381,381,22,4,18,3,2
5,412,412,24,24,0,1,0
17,431,431,3,3,0,1,0
7,432,432,17,8,9,4,3
15,434,434,90,90,0,1,0
20,449,449,8,1,7,2,1
1,471,471,60,60,0,1,0
10,472,472,10,10,0,1,0
11,475,475,5,5,0,1,0
19,478,478,22,22,0,1,0
23,480,480,48,48,0,1,0

8,117,117,5,5,0,1,0
15,123,123,40,16,24,4,3
14,149,149,15,15,0,1,0
22,154,154,12,12,0,1,0
16,170,170,3,3,0,1,0
6,171,171,55,10,45,4,3
4,194,194,3,3,0,1,0
9,202,202,4,4,0,1,0
5,203,203,30,7,23,2,1
17,219,219,59,59,0,1,0
26,240,240,14,14,0,1,0
11,244,244,48,17,31,3,2
23,264,264,7,1,6,3,2
19,317,317,1,1,0,1,0
1,325,325,42,20,22,3,2
24,345,345,45,25,20,3,2
27,349,349,1,1,0,1,0
13,362,362,33,21,12,3,2
20,386,386,58,14,44,2,1
2,387,387,3,3,0,1,0
7,397,397,19,19,0,1,0
18,427,427,47,19,28,2,1
3,438,438,109,94,15,2,1
21,446,446,40,37,3,2,1
0,455,455,15,10,5,2,1
25,475,475,32,32,0,1,0
12,484,484,45,45,0,1,0
10,495,495,3,3,0,1,0

32,133,133,1,1,0,1,0
3,150,150,15,15,0,1,0
7,156,156,18,18,0,1,0
18,157,157,12,12,0,1,0
22,162,162,1,1,0,1,0
9,162,162,5,5,0,1,0
27,168,168,29,8,21,4,3
25,172,172,44,44,0,1,0
2,211,211,2,2,0,1,0
36,230,230,40,40,0,1,0
13,237,237,4,4,0,1,0
1,240,240,24,3,21,4,3
19,258,258,11,11,0,1,0
24,270,270,18,18,0,1,0
5,286,286,53,53,0,1,0
37,293,293,24,24,0,1,0
6,296,296,49,34,15,4,3
28,299,299,40,16,24,3,2
8,300,300,1,1,0,1,0
20,314,314,8,8,0,1,0
14,320,320,5,5,0,1,0
12,323,323,6,6,0,1,0
30,361,361,41,41,0,1,0
0,367,367,12,12,0,1,0
34,372,372,1,1,0,1,0
35,374,374,6,6,0,1,0
16,379,379,30,30,0,1,0
33,383,383,44,17,27,4,3
11,404,404,3,3,0,1,0
23,430,430,26,1,25,2,1
10,442,442,20,2,18,3,2
31,446,446,81,49,32,3,2
21,462,462,69,17,52,3,2
29,468,468,6,6,0,1,0
17,484,484,24,24,0,1,0
26,493,493,46,46,0,1,0
4,497,497,31,31,0,1,0
15,500,500,2,2,0,1,0

17,114,114,13,1,12,2,1
0,126,126,9,5,4,2,1
4,153,153,13,13,0,1,0
22,160,160,15,15,0,1,0
15,160,160,35,21,14,2,1
7,165,165,31,31,0,1,0
13,171,171,24,24,0,1,0
8,194,194,25,25,0,1,0
14,209,209,5,5,0,1,0
11,226,226,22,22,0,1,0
3,233,233,58,58,0,1,0
1,252,252,43,43,0,1,0
6,258,258,22,22,0,1,0
21,325,325,21,21,0,1,0
20,340,340,133,93,40,3,2
18,349,349,25,25,0,1,0
9,356,356,33,18,15,2,1
19,370,370,26,1,25,3,2
2,371,371,8,8,0,1,0
24,375,375,5,5,0,1,0
10,410,410,39,39,0,1,0
12,438,438,16,16,0,1,0
5,451,451,96,32,64,3,2
16,484,484,28,15,13,4,3
23,491,491,20,20,0,1,0

12,103,103,29,29,0,1,0
13,105,105,2,2,0,1,0
21,115,115,1,1,0,1,0
6,126,126,35,8,27,4,3
4,131,131,15,15,0,1,0
0,203,203,71,25,46,3,2
11,211,211,52,52,0,1,0
22,212,212,2,2,0,1,0
15,225,225,32,14,18,2,1
9,235,235,24,4,20,4,3
1,243,243,18,8,10,2,1
14,248,248,24,24,0,1,0
23,257,257,12,8,4,2,1
2,268,268,23,6,17,2,1
8,270,270,12,12,0,1,0
19,273,273,32,10,22,4,3
20,310,310,11,11,0,1,0
18,367,367,5,2,3,2,1
16,389,389,7,2,5,2,1
17,391,391,99,99,0,1,0
5,396,396,39,6,33,4,3
10,454,454,62,26,36,2,1
7,454,454,85,80,5,2,1
3,493,493,33,14,19,2,1

7,101,101,4,1,3,2,1
24,111,111,4,4,0,1,0
16,148,148,2,2,0,1,0
14,157,157,53,35,18,4,3
9,180,180,5,5,0,1,0
10,185,185,4,4,0,1,0
2,193,193,32,32,0,1,0
0,203,203,17,11,6,2,1
20,216,216,56,2,54,3,2
1,245,245,67,25,42,2,1
15,262,262,1,1,0,1,0
17,271,271,18,9,9,4,3
13,275,275,29,12,17,2,1
18,276,276,3,3,0,1,0
8,300,300,79,55,24,2,1
4,300,300,51,9,42,3,2
12,304,304,42,2,40,3,2
3,371,371,4,4,0,1,0
6,413,413,55,55,0,1,0
5,453,453,97,37,60,4,3
19,455,455,11,11,0,1,0
21,460,460,57,57,0,1,0
23,480,480,59,59,0,1,0
22,482,482,20,4,16,3,2
11,494,494,70,6,64,3,2

21,100,100,11,11,0,1,0
7,101,101,1,1,0,1,0
17,112,112,8,8,0,1,0
9,122,122,8,5,3,2,1
25,123,123,7,3,4,2,1
29,163,163,56,56,0,1,0
10,166,166,13,2,11,2,1
8,175,175,24,3,21,4,3
2,217,217,13,3,10,3,2
6,268,268,36,16,20,2,1
4,268,268,22,22,0,1,0
12,276,276,1,1,0,1,0
19,304,304,13,4,9,4,3
24,307,307,34,34,0,1,0
1,310,310,1,1,0,1,0
15,317,317,4,4,0,1,0
28,317,317,7,1,6,2,1
11,325,325,57,16,41,2,1
26,334,334,8,8,0,1,0
30,362,362,19,19,0,1,0
5,368,368,22,7,15,4,3
23,374,374,130,55,75,4,3
14,383,383,46,22,24,4,3
13,394,394,43,5,38,3,2
18,428,428,2,2,0,1,0
22,433,433,43,11,32,2,1
20,454,454,33,30,3,2,1
0,459,459,49,27,22,3,2
27,467,467,13,13,0,1,0
3,471,471,17,17,0,1,0
16,488,488,67,67,0,1,0
31,498,498,52,44,8,3,2

17,110,110,5,2,3,2,1
24,113,113,20,20,0,1,0
18,133,133,13,4,9,2,1
2,136,136,16,16,0,1,0
20,148,148,1,1,0,1,0
22,152,152,2,2,0,1,0
1,174,174,42,42,0,1,0
13,200,200,9,3,6,3,2
8,210,210,36,15,21,4,3
15,228,228,15,1,14,3,2
9,238,238,1,1,0,1,0
0,253,253,65,47,18,3,2
4,273,273,23,23,0,1,0
10,293,293,65,65,0,1,0
7,316,316,30,30,0,1,0
26,321,321,105,54,51,4,3
11,359,359,12,12,0,1,0
19,368,368,92,92,0,1,0
21,393,393,31,31,0,1,0
5,418,418,13,13,0,1,0
16,422,422,21,21,0,1,0
23,440,440,39,39,0,1,0
25,447,447,8,8,0,1,0
12,450,450,16,1,15,4,3
6,474,474,43,33,10,3,2
14,486,486,81,81,0,1,0
3,498,498,9,9,0,1,0

9,116,116,1,1,0,1,0
8,128,128,24,2,22,2,1
5,129,129,5,5,0,1,0
18,129,129,7,1,6,2,1
10,133,133,16,16,0,1,0
4,154,154,7,7,0,1,0
22,157,157,13,7,6,2,1
25,165,165,27,13,14,3,2
21,186,186,13,13,0,1,0
16,200,200,27,12,15,4,3
13,213,213,1,1,0,1,0
3,256,256,11,3,8,3,2
24,293,293,58,30,28,3,2
15,341,341,29,21,8,3,2
1,349,349,137,116,21,4,3
6,360,360,13,9,4,2,1
7,366,366,9,2,7,2,1
14,390,390,74,50,24,4,3
11,404,404,26,26,0,1,0
12,428,428,20,4,16,3,2
23,429,429,64,64,0,1,0
20,456,456,15,15,0,1,0
2,458,458,6,1,5,2,1
0,475,475,203,141,62,3,2
19,482,482,39,13,26,2,1
17,484,484,69,69,0,1,0

22,116,116,16,4,12,3,2
10,131,131,36,7,29,4,3
21,131,131,4,4,0,1,0
12,136,136,1,1,0,1,0
23,163,163,5,1,4,2,1
24,186,186,4,4,0,1,0
6,187,187,9,9,0,1,0
7,189,189,4,4,0,1,0
2,207,207,26,17,9,2,1
15,244,244,12,9,3,2,1
26,244,244,57,14,43,2,1
13,249,249,11,11,0,1,0
19,261,261,52,35,17,2,1
31,293,293,19,19,0,1,0
28,303,303,91,91,0,1,0
20,304,304,8,8,0,1,0
0,309,309,39,31,8,2,1
3,322,322,1,1,0,1,0
29,345,345,3,3,0,1,0
9,354,354,4,4,0,1,0
18,379,379,15,8,7,2,1
17,386,386,27,27,0,1,0
11,397,397,48,48,0,1,0
25,397,397,27,3,24,4,3
8,434,434,6,6,0,1,0
14,438,438,114,82,32,4,3
27,443,443,85,85,0,1,0
5,446,446,44,44,0,1,0
16,459,459,23,23,0,1,0
1,460,460,34,34,0,1,0
30,477,477,41,41,0,1,0
4,479,479,1,1,0,1,0

7,112,112,15,15,0,1,0
11,151,151,11,11,0,1,0
13,155,155,18,12,6,3,2
10,160,160,24,12,12,4,3
12,167,167,4,4,0,1,0
21,197,197,2,2,0,1,0
8,247,247,24,24,0,1,0
18,248,248,69,37,32,3,2
3,254,254,14,14,0,1,0
25,267,267,14,4,10,2,1
20,274,274,6,6,0,1,0
6,280,280,58,58,0,1,0
17,284,284,5,5,0,1,0
24,292,292,69,69,0,1,0
5,302,302,13,2,11,2,1
15,326,326,70,46,24,2,1
1,329,329,52,30,22,3,2
16,347,347,3,3,0,1,0
0,359,359,60,49,11,2,1
4,386,386,32,32,0,1,0
2,389,389,20,20,0,1,0
22,416,416,32,32,0,1,0
9,439,439,81,57,24,4,3
19,443,443,26,26,0,1,0
23,458,458,75,75,0,1,0
14,459,459,68,68,0,1,0

11,106,106,2,2,0,1,0
14,114,114,4,4,0,1,0
30,122,122,48,48,0,1,0
34,140,140,7,7,0,1,0
22,148,148,11,2,9,2,1
32,159,159,6,6,0,1,0
0,172,172,3,3,0,1,0
31,183,183,3,3,0,1,0
12,191,191,2,2,0,1,0
24,192,192,2,2,0,1,0
21,195,195,10,10,0,1,0
26,209,209,93,93,0,1,0
8,242,242,8,8,0,1,0
13,261,261,27,8,19,2,1
5,275,275,14,5,9,4,3
2,276,276,8,8,0,1,0
19,283,283,10,1,9,4,3
3,301,301,99,42,57,4,3
16,337,337,22,22,0,1,0
28,342,342,32,10,22,3,2
18,347,347,4,4,0,1,0
20,356,356,110,100,10,2,1
1,366,366,22,10,12,3,2
15,374,374,17,9,8,2,1
9,385,385,13,13,0,1,0
10,388,388,37,10,27,4,3
17,394,394,19,8,11,2,1
4,406,406,8,8,0,1,0
23,419,419,11,5,6,2,1
29,434,434,10,10,0,1,0
7,439,439,4,1,3,2,1
27,447,447,62,17,45,2,1
25,473,473,12,12,0,1,0
33,491,491,24,24,0,1,0
6,495,495,20,20,0,1,0

3,139,139,19,19,0,1,0
7,140,140,15,1,14,3,2
20,143,143,1,1,0,1,0
8,149,149,5,5,0,1,0
6,164,164,57,57,0,1,0
19,205,205,61,19,42,2,1
5,215,215,25,16,9,4,3
14,226,226,7,7,0,1,0
1,237,237,5,5,0,1,0
15,279,279,31,21,10,2,1
17,303,303,4,1,3,2,1
13,374,374,83,75,8,3,2
9,379,379,8,4,4,2,1
16,413,413,77,77,0,1,0
18,415,415,10,7,3,2,1
12,426,426,42,36,6,2,1
4,451,451,38,38,0,1,0
21,457,457,135,64,71,4,3
2,467,467,239,239,0,1,0
11,475,475,21,21,0,1,0
0,478,478,38,38,0,1,0
10,497,497,18,18,0,1,0

2,100,100,5,5,0,1,0
25,100,100,1,1,0,1,0
8,108,108,1,1,0,1,0
12,112,112,5,1,4,2,1
16,149,149,35,35,0,1,0
1,181,181,10,1,9,3,2
18,193,193,12,12,0,1,0
23,202,202,8,2,6,3,2
10,209,209,55,55,0,1,0
20,226,226,8,8,0,1,0
19,228,228,4,4,0,1,0
13,239,239,24,24,0,1,0
36,239,239,25,5,20,2,1
29,253,253,25,25,0,1,0
30,271,271,16,16,0,1,0
22,287,287,9,9,0,1,0
11,316,316,1,1,0,1,0
40,317,317,16,3,13,2,1
31,322,322,28,28,0,1,0
6,323,323,2,2,0,1,0
15,324,324,2,2,0,1,0
14,352,352,6,6,0,1,0
28,353,353,44,14,30,2,1
35,356,356,26,16,10,3,2
24,374,374,1,1,0,1,0
7,396,396,5,5,0,1,0
37,402,402,15,15,0,1,0
5,404,404,53,53,0,1,0
34,405,405,40,7,33,4,3
17,412,412,1,1,0,1,0
38,414,414,59,59,0,1,0
21,415,415,8,8,0,1,0
3,419,419,29,3,26,3,2
4,423,423,24,24,0,1,0
39,433,433,52,13,39,4,3
0,435,435,22,19,3,2,1
9,449,449,23,13,10,2,1
33,459,459,23,23,0,1,0
27,479,479,124,86,38,3,2
26,487,487,9,9,0,1,0
32,496,496,57,27,30,3,2

32,115,115,7,7,0,1,0
6,156,156,1,1,0,1,0
23,157,157,1,1,0,1,0
7,161,161,18,18,0,1,0
10,164,164,1,1,0,1,0
30,164,164,14,5,9,2,1
26,192,192,5,1,4,2,1
4,195,195,1,1,0,1,0
1,203,203,108,73,35,2,1
20,208,208,11,11,0,1,0
22,234,234,31,6,25,2,1
17,235,235,11,11,0,1,0
9,251,251,2,2,0,1,0
19,252,252,85,85,0,1,0
27,256,256,49,18,31,2,1
8,257,257,1,1,0,1,0
14,267,267,17,17,0,1,0
29,272,272,44,44,0,1,0
2,279,279,28,19,9,4,3
21,287,287,13,13,0,1,0
16,311,311,15,15,0,1,0
5,326,326,19,3,16,3,2
15,334,334,5,5,0,1,0
13,343,343,1,1,0,1,0
11,358,358,4,1,3,2,1
0,365,365,14,3,11,2,1
3,376,376,38,4,34,3,2
28,385,385,46,46,0,1,0
18,417,417,57,5,52,3,2
24,436,436,34,34,0,1,0
12,452,452,48,14,34,3,2
31,470,470,13,13,0,1,0
25,485,485,46,46,0,1,0

20,105,105,2,2,0,1,0
11,114,114,1,1,0,1,0
0,117,117,21,1,20,2,1
19,118,118,13,13,0,1,0
24,136,136,15,7,8,2,1
6,139,139,18,18,0,1,0
23,141,141,44,44,0,1,0
13,150,150,4,4,0,1,0
3,155,155,58,12,46,2,1
4,162,162,1,1,0,1,0
8,187,187,2,2,0,1,0
7,225,225,30,30,0,1,0
10,259,259,33,33,0,1,0
18,277,277,78,34,44,3,2
14,282,282,16,16,0,1,0
16,314,314,3,3,0,1,0
21,323,323,2,2,0,1,0
1,328,328,23,23,0,1,0
17,333,333,6,6,0,1,0
25,355,355,49,49,0,1,0
12,362,362,20,20,0,1,0
22,400,400,60,27,33,4,3
2,435,435,84,15,69,4,3
9,442,442,56,56,0,1,0
15,447,447,61,49,12,4,3
5,456,456,21,21,0,1,0

13,119,119,2,2,0,1,0
6,151,151,13,13,0,1,0
7,165,165,7,2,5,2,1
23,169,169,3,3,0,1,0
25,194,194,37,9,28,3,2
12,207,207,37,10,27,4,3
10,222,222,27,1,26,4,3
11,243,243,21,21,0,1,0
4,251,251,14,14,0,1,0
24,252,252,7,7,0,1,0
1,255,255,10,10,0,1,0
5,273,273,8,8,0,1,0
29,276,276,10,10,0,1,0
2,287,287,30,30,0,1,0
8,310,310,59,35,24,3,2
16,331,331,33,33,0,1,0
15,358,358,3,3,0,1,0
20,360,360,83,83,0,1,0
14,378,378,71,1,70,4,3
0,389,389,73,37,36,2,1
26,400,400,69,51,18,4,3
18,403,403,138,72,66,3,2
3,426,426,11,2,9,4,3
27,427,427,18,18,0,1,0
9,431,431,18,18,0,1,0
19,465,465,15,15,0,1,0
21,478,478,12,8,4,2,1
17,484,484,25,25,0,1,0
22,494,494,13,5,8,3,2
28,500,500,62,52,10,2,1

11,106,106,25,25,0,1,0
5,118,118,11,1,10,3,2
14,152,152,3,3,0,1,0
8,155,155,6,6,0,1,0
21,169,169,31,21,10,3,2
19,175,175,15,15,0,1,0
10,229,229,14,4,10,3,2
13,232,232,17,17,0,1,0
12,246,246,1,1,0,1,0
16,250,250,9,2,7,2,1
6,271,271,13,13,0,1,0
15,281,281,51,13,38,4,3
9,285,285,20,2,18,3,2
17,294,294,27,27,0,1,0
24,298,298,42,42,0,1,0
18,305,305,36,36,0,1,0
20,331,331,27,27,0,1,0
0,346,346,3,3,0,1,0
3,357,357,115,115,0,1,0
2,359,359,4,4,0,1,0
4,383,383,59,21,38,3,2
7,391,391,177,53,124,4,3
23,443,443,58,58,0,1,0
22,472,472,23,23,0,1,0
1,477,477,68,68,0,1,0

23,103,103,1,1,0,1,0
13,125,125,2,2,0,1,0
27,155,155,4,4,0,1,0
26,187,187,28,6,22,3,2
7,198,198,12,5,7,2,1
20,204,204,27,27,0,1,0
5,205,205,31,31,0,1,0
25,212,212,14,4,10,2,1
8,213,213,1,1,0,1,0
15,225,225,38,38,0,1,0
4,244,244,3,3,0,1,0
9,249,249,1,1,0,1,0
1,262,262,156,138,18,3,2
24,262,262,67,67,0,1,0
22,283,283,40,40,0,1,0
19,285,285,3,3,0,1,0
12,285,285,12,12,0,1,0
3,363,363,5,2,3,2,1
0,401,401,90,90,0,1,0
11,406,406,25,25,0,1,0
2,417,417,38,14,24,2,1
14,427,427,11,11,0,1,0
18,429,429,124,85,39,2,1
10,438,438,37,8,29,2,1
21,452,452,26,8,18,4,3
6,464,464,18,18,0,1,0
17,478,478,30,5,25,4,3
16,489,489,19,12,7,2,1

31,114,114,16,1,15,4,3
27,124,124,6,1,5,2,1
35,140,140,3,3,0,1,0
0,151,151,26,26,0,1,0
20,155,155,4,4,0,1,0
17,161,161,14,5,9,4,3
15,161,161,4,4,0,1,0
22,181,181,18,14,4,2,1
4,215,215,16,4,12,3,2
2,244,244,30,1,29,2,1
8,255,255,4,4,0,1,0
9,258,258,34,34,0,1,0
1,262,262,1,1,0,1,0
29,278,278,8,8,0,1,0
24,284,284,40,40,0,1,0
11,298,298,3,3,0,1,0
34,316,316,39,6,33,4,3
10,349,349,10,10,0,1,0
32,350,350,53,53,0,1,0
14,357,357,19,19,0,1,0
12,374,374,34,14,20,4,3
21,390,390,50,37,13,2,1
19,399,399,1,1,0,1,0
16,404,404,17,2,15,2,1
36,410,410,26,26,0,1,0
7,422,422,16,6,10,2,1
30,426,426,4,4,0,1,0
3,434,434,1,1,0,1,0
5,446,446,9,2,7,2,1
26,454,454,39,39,0,1,0
6,460,460,10,1,9,2,1
28,462,462,4,4,0,1,0
18,463,463,21,12,9,2,1
13,464,464,75,22,53,3,2
33,468,468,82,18,64,3,2
25,476,476,165,69,96,3,2
23,490,490,48,48,0,1,0

20,156,156,3,3,0,1,0
8,157,157,1,1,0,1,0
21,170,170,24,24,0,1,0
23,176,176,11,11,0,1,0
22,194,194,16,1,15,4,3
7,221,221,25,25,0,1,0
10,221,221,1,1,0,1,0
19,243,243,63,63,0,1,0
0,254,254,59,59,0,1,0
3,256,256,18,9,9,2,1
12,279,279,48,41,7,2,1
16,306,306,3,3,0,1,0
9,309,309,15,9,6,2,1
5,325,325,21,21,0,1,0
24,335,335,24,3,21,4,3
13,351,351,39,39,0,1,0
1,362,362,19,11,8,3,2
6,364,364,106,106,0,1,0
18,418,418,28,8,20,2,1
4,431,431,38,38,0,1,0
17,432,432,2,2,0,1,0
25,443,443,23,2,21,4,3
2,452,452,11,11,0,1,0
14,470,470,124,88,36,4,3
15,488,488,54,54,0,1,0
11,488,488,198,54,144,4,3

13,101,101,1,1,0,1,0
34,102,102,17,1,16,3,2
9,119,119,11,1,10,3,2
7,121,121,1,1,0,1,0
6,123,123,8,3,5,2,1
27,128,128,18,18,0,1,0
12,129,129,2,2,0,1,0
28,135,135,7,7,0,1,0
1,141,141,44,44,0,1,0
14,151,151,7,7,0,1,0
20,187,187,5,5,0,1,0
0,194,194,1,1,0,1,0
4,203,203,6,6,0,1,0
15,206,206,57,57,0,1,0
23,209,209,24,4,20,3,2
25,216,216,2,2,0,1,0
10,234,234,3,3,0,1,0
29,240,240,37,19,18,3,2
17,254,254,15,15,0,1,0
5,275,275,33,15,18,4,3
16,284,284,11,1,10,3,2
19,286,286,1,1,0,1,0
21,289,289,43,43,0,1,0
30,300,300,15,15,0,1,0
33,303,303,19,8,11,2,1
22,307,307,3,3,0,1,0
8,311,311,7,7,0,1,0
11,369,369,20,4,16,3,2
18,393,393,53,53,0,1,0
2,406,406,2,2,0,1,0
32,411,411,19,19,0,1,0
3,434,434,27,3,24,3,2
26,437,437,61,15,46,3,2
31,452,452,132,81,51,3,2
24,474,474,24,17,7,2,1

5,100,100,1,1,0,1,0
8,129,129,27,27,0,1,0
15,160,160,3,3,0,1,0
16,163,163,11,11,0,1,0
24,165,165,31,9,22,2,1
21,167,167,17,1,16,2,1
3,173,173,40,10,30,2,1
20,180,180,44,44,0,1,0
14,181,181,25,14,11,4,3
22,191,191,26,16,10,3,2
1,269,269,1,1,0,1,0
4,283,283,2,2,0,1,0
18,288,288,56,16,40,3,2
19,288,288,20,20,0,1,0
26,295,295,34,34,0,1,0
0,318,318,25,11,14,3,2
2,324,324,34,34,0,1,0
13,354,354,2,2,0,1,0
23,371,371,24,24,0,1,0
6,397,397,140,112,28,2,1
10,407,407,8,8,0,1,0
28,411,411,23,9,14,2,1
12,418,418,13,13,0,1,0
9,431,431,26,26,0,1,0
17,433,433,5,1,4,2,1
11,454,454,31,16,15,4,3
27,456,456,74,27,47,4,3
25,463,463,2,2,0,1,0
7,487,487,41,41,0,1,0

13,101,101,30,30,0,1,0
3,151,151,11,11,0,1,0
18,213,213,15,15,0,1,0
1,214,214,33,12,21,2,1
0,216,216,11,7,4,2,1
11,217,217,1,1,0,1,0
25,229,229,24,8,16,2,1
4,239,239,19,19,0,1,0
21,260,260,2,2,0,1,0
6,265,265,6,6,0,1,0
19,301,301,34,34,0,1,0
15,316,316,5,1,4,2,1
23,321,321,59,59,0,1,0
14,329,329,15,8,7,2,1
5,332,332,21,21,0,1,0
2,347,347,72,72,0,1,0
17,365,365,118,75,43,4,3
27,377,377,10,3,7,2,1
10,378,378,96,9,87,4,3
8,390,390,16,3,13,2,1
26,390,390,68,32,36,2,1
24,395,395,101,73,28,2,1
12,405,405,11,3,8,2,1
7,418,418,47,27,20,3,2
20,427,427,5,5,0,1,0
9,461,461,6,6,0,1,0
16,469,469,40,40,0,1,0
22,486,486,3,3,0,1,0

10,103,103,3,3,0,1,0
21,127,127,26,13,13,2,1
14,129,129,25,25,0,1,0
11,141,141,2,2,0,1,0
28,144,144,7,7,0,1,0
2,165,165,44,44,0,1,0
4,181,181,1,1,0,1,0
22,192,192,15,15,0,1,0
23,226,226,36,36,0,1,0
6,248,248,6,3,3,2,1
13,254,254,42,13,29,4,3
12,256,256,13,13,0,1,0
7,270,270,22,22,0,1,0
17,292,292,36,16,20,3,2
0,301,301,6,6,0,1,0
24,313,313,14,14,0,1,0
9,321,321,3,3,0,1,0
20,322,322,20,2,18,4,3
1,349,349,11,11,0,1,0
29,386,386,9,5,4,2,1
3,389,389,59,59,0,1,0
16,415,415,96,51,45,4,3
19,423,423,12,2,10,2,1
26,435,435,43,13,30,3,2
27,436,436,64,64,0,1,0
18,445,445,36,4,32,3,2
25,446,446,45,45,0,1,0
8,446,446,79,79,0,1,0
15,455,455,19,19,0,1,0
5,494,494,68,68,0,1,0

13,103,103,26,26,0,1,0
7,109,109,16,16,0,1,0
0,149,149,2,2,0,1,0
2,154,154,12,3,9,4,3
28,174,174,26,14,12,3,2
15,177,177,14,14,0,1,0
1,188,188,1,1,0,1,0
20,205,205,1,1,0,1,0
4,211,211,13,13,0,1,0
5,221,221,43,43,0,1,0
10,270,270,18,9,9,2,1
18,277,277,7,7,0,1,0
24,279,279,64,64,0,1,0
26,284,284,32,32,0,1,0
23,320,320,44,44,0,1,0
6,321,321,26,26,0,1,0
3,326,326,17,17,0,1,0
27,335,335,31,31,0,1,0
30,336,336,12,3,9,4,3
17,344,344,1,1,0,1,0
16,357,357,31,31,0,1,0
12,389,389,22,22,0,1,0
11,405,405,76,61,15,4,3
8,419,419,2,2,0,1,0
22,420,420,10,10,0,1,0
29,422,422,27,27,0,1,0
19,438,438,137,110,27,4,3
21,451,451,8,8,0,1,0
9,476,476,9,3,6,3,2
25,477,477,103,43,60,4,3
14,497,497,8,2,6,3,2

7,113,113,1,1,0,1,0
19,114,114,1,1,0,1,0
11,116,116,8,2,6,3,2
12,134,134,33,33,0,1,0
20,160,160,14,8,6,3,2
15,161,161,20,8,12,4,3
8,174,174,52,7,45,4,3
4,178,178,59,7,52,3,2
9,185,185,4,1,3,2,1
6,210,210,61,29,32,2,1
3,220,220,4,1,3,2,1
21,227,227,73,73,0,1,0
10,234,234,2,2,0,1,0
16,287,287,6,6,0,1,0
1,302,302,44,44,0,1,0
13,319,319,27,27,0,1,0
18,351,351,25,25,0,1,0
0,356,356,45,45,0,1,0
17,370,370,88,39,49,3,2
5,389,389,61,8,53,4,3
14,413,413,38,10,28,3,2
22,441,441,15,11,4,2,1
2,473,473,12,12,0,1,0

1,100,100,1,1,0,1,0
15,120,120,8,8,0,1,0
4,122,122,6,6,0,1,0
10,126,126,2,2,0,1,0
18,137,137,8,8,0,1,0
0,149,149,32,32,0,1,0
14,185,185,1,1,0,1,0
13,216,216,27,18,9,4,3
11,243,243,5,5,0,1,0
5,306,306,255,246,9,4,3
20,316,316,46,28,18,3,2
16,323,323,1,1,0,1,0
22,387,387,20,4,16,3,2
8,397,397,50,50,0,1,0
21,403,403,44,37,7,2,1
19,404,404,30,7,23,2,1
7,415,415,24,24,0,1,0
9,417,417,297,297,0,1,0
17,441,441,5,1,4,2,1
12,460,460,10,10,0,1,0
3,471,471,14,14,0,1,0
2,471,471,37,37,0,1,0
6,486,486,1,1,0,1,0

17,108,108,8,8,0,1,0
16,114,114,21,21,0,1,0
23,133,133,8,8,0,1,0
22,160,160,27,4,23,3,2
25,164,164,11,11,0,1,0
6,175,175,10,1,9,2,1
3,192,192,8,8,0,1,0
9,212,212,93,93,0,1,0
10,221,221,9,1,8,2,1
28,226,226,14,14,0,1,0
26,249,249,7,7,0,1,0
5,258,258,54,24,30,4,3
4,264,264,8,8,0,1,0
7,317,317,1,1,0,1,0
29,319,319,10,4,6,2,1
27,333,333,65,41,24,3,2
13,340,340,18,18,0,1,0
20,343,343,91,87,4,2,1
1,344,344,66,66,0,1,0
24,356,356,18,6,12,4,3
12,374,374,13,13,0,1,0
14,378,378,8,8,0,1,0
8,401,401,5,5,0,1,0
2,406,406,25,12,13,2,1
11,409,409,23,23,0,1,0
21,420,420,56,56,0,1,0
0,442,442,61,61,0,1,0
19,470,470,34,34,0,1,0
15,482,482,5,5,0,1,0
18,483,483,12,8,4,2,1

1,100,100,4,1,3,2,1
10,104,104,37,37,0,1,0
25,106,106,3,3,0,1,0
15,142,142,12,12,0,1,0
14,154,154,24,24,0,1,0
23,155,155,13,4,9,2,1
24,164,164,3,3,0,1,0
5,182,182,12,6,6,3,2
7,258,258,58,12,46,2,1
27,264,264,6,6,0,1,0
3,265,265,13,13,0,1,0
16,266,266,23,23,0,1,0
20,284,284,34,34,0,1,0
9,285,285,3,3,0,1,0
28,296,296,7,7,0,1,0
22,312,312,82,40,42,2,1
21,338,338,60,60,0,1,0
19,341,341,32,18,14,2,1
6,348,348,2,2,0,1,0
8,381,381,16,16,0,1,0
0,387,387,31,31,0,1,0
11,409,409,27,13,14,3,2
18,420,420,149,41,108,4,3
13,431,431,15,15,0,1,0
4,450,450,31,31,0,1,0
12,461,461,84,64,20,2,1
17,462,462,37,7,30,2,1
2,485,485,9,9,0,1,0
26,495,495,2,2,0,1,0

24,108,108,14,1,13,2,1
27,140,140,9,9,0,1,0
21,144,144,1,1,0,1,0
4,169,169,59,41,18,2,1
23,182,182,19,5,14,2,1
5,211,211,5,1,4,2,1
12,211,211,7,4,3,2,1
0,212,212,4,4,0,1,0
30,215,215,48,8,40,2,1
29,222,222,11,5,6,3,2
15,233,233,50,8,42,4,3
9,246,246,16,10,6,3,2
25,254,254,15,15,0,1,0
16,256,256,3,3,0,1,0
32,260,260,15,15,0,1,0
26,267,267,42,32,10,3,2
19,270,270,7,7,0,1,0
6,273,273,7,7,0,1,0
31,277,277,35,35,0,1,0
20,294,294,53,7,46,3,2
8,298,298,3,3,0,1,0
10,313,313,30,30,0,1,0
17,330,330,15,15,0,1,0
7,357,357,6,6,0,1,0
2,373,373,5,5,0,1,0
13,397,397,66,26,40,3,2
28,415,415,60,60,0,1,0
18,427,427,2,2,0,1,0
11,433,433,22,22,0,1,0
3,440,440,59,59,0,1,0
14,447,447,10,10,0,1,0
33,451,451,10,7,3,2,1
22,456,456,51,51,0,1,0
1,464,464,35,17,18,4,3

14,121,121,14,8,6,3,2
6,140,140,11,5,6,3,2
4,140,140,38,6,32,3,2
1,183,183,63,63,0,1,0
13,187,187,11,11,0,1,0
11,200,200,64,25,39,4,3
2,240,240,19,10,9,4,3
15,263,263,60,60,0,1,0
5,277,277,17,17,0,1,0
18,290,290,9,9,0,1,0
16,295,295,7,7,0,1,0
8,312,312,15,15,0,1,0
7,315,315,33,33,0,1,0
0,327,327,88,23,65,3,2
19,347,347,11,2,9,4,3
9,368,368,8,2,6,3,2
17,416,416,41,41,0,1,0
3,450,450,136,116,20,2,1
20,454,454,67,52,15,2,1
12,484,484,42,21,21,4,3
10,486,486,55,55,0,1,0

29,105,105,11,11,0,1,0
8,116,116,16,2,14,3,2
0,122,122,17,9,8,3,2
1,126,126,2,2,0,1,0
27,147,147,9,9,0,1,0
26,167,167,23,17,6,3,2
19,180,180,36,24,12,4,3
31,187,187,8,2,6,2,1
21,199,199,29,21,8,2,1
7,208,208,18,18,0,1,0
3,220,220,5,5,0,1,0
2,227,227,20,20,0,1,0
25,229,229,50,50,0,1,0
10,236,236,1,1,0,1,0
9,237,237,4,4,0,1,0
13,239,239,7,7,0,1,0
28,263,263,16,16,0,1,0
12,275,275,8,8,0,1,0
6,294,294,26,26,0,1,0
23,322,322,41,41,0,1,0
4,325,325,32,11,21,4,3
20,329,329,21,3,18,3,2
16,331,331,15,15,0,1,0
17,362,362,60,1,59,4,3
14,364,364,21,11,10,2,1
5,379,379,31,31,0,1,0
30,384,384,21,21,0,1,0
18,398,398,22,22,0,1,0
24,414,414,38,12,26,4,3
15,448,448,108,108,0,1,0
11,460,460,24,9,15,4,3
22,481,481,28,2,26,3,2

23,117,117,1,1,0,1,0
24,124,124,20,3,17,2,1
26,135,135,9,9,0,1,0
12,147,147,3,3,0,1,0
20,155,155,5,5,0,1,0
32,160,160,4,4,0,1,0
5,167,167,12,4,8,2,1
3,168,168,6,6,0,1,0
27,169,169,8,8,0,1,0
17,183,183,4,1,3,2,1
6,189,189,12,12,0,1,0
21,189,189,9,3,6,3,2
13,192,192,17,17,0,1,0
10,196,196,13,5,8,2,1
7,231,231,95,95,0,1,0
30,233,233,19,7,12,3,2
22,245,245,57,36,21,2,1
14,286,286,13,13,0,1,0
19,301,301,32,17,15,4,3
8,303,303,9,9,0,1,0
1,308,308,19,19,0,1,0
28,339,339,79,79,0,1,0
0,345,345,13,9,4,2,1
34,353,353,55,52,3,2,1
11,358,358,5,5,0,1,0
2,364,364,19,19,0,1,0
9,377,377,43,43,0,1,0
15,389,389,37,37,0,1,0
18,390,390,11,4,7,2,1
29,399,399,8,8,0,1,0
31,412,412,37,37,0,1,0
33,452,452,60,60,0,1,0
16,456,456,1,1,0,1,0
25,479,479,59,46,13,3,2
4,496,496,1,1,0,1,0

31,101,101,8,1,7,2,1
28,116,116,11,11,0,1,0
20,125,125,14,14,0,1,0
1,129,129,11,11,0,1,0
22,145,145,7,3,4,2,1
7,173,173,8,8,0,1,0
10,192,192,31,31,0,1,0
26,193,193,13,5,8,3,2
12,207,207,43,43,0,1,0
13,209,209,2,2,0,1,0
6,214,214,9,9,0,1,0
11,221,221,70,70,0,1,0
27,248,248,8,8,0,1,0
17,250,250,24,8,16,2,1
21,251,251,26,26,0,1,0
16,286,286,2,2,0,1,0
18,288,288,33,33,0,1,0
5,300,300,5,2,3,2,1
0,341,341,15,15,0,1,0
30,349,349,1,1,0,1,0
19,352,352,43,43,0,1,0
4,352,352,1,1,0,1,0
29,382,382,40,8,32,4,3
24,386,386,3,3,0,1,0
23,401,401,15,7,8,3,2
3,401,401,3,3,0,1,0
8,404,404,5,5,0,1,0
15,410,410,86,41,45,2,1
2,416,416,3,3,0,1,0
9,434,434,32,32,0,1,0
14,452,452,26,2,24,4,3
25,476,476,240,105,135,4,3

33,101,101,1,1,0,1,0
27,112,112,7,4,3,2,1
35,118,118,13,6,7,2,1
14,129,129,1,1,0,1,0
23,132,132,9,9,0,1,0
29,135,135,9,9,0,1,0
9,140,140,1,1,0,1,0
5,144,144,8,2,6,3,2
15,166,166,9,9,0,1,0
10,187,187,2,2,0,1,0
25,193,193,39,39,0,1,0
6,212,212,15,2,13,2,1
11,219,219,11,11,0,1,0
22,223,223,31,19,12,4,3
30,241,241,42,42,0,1,0
19,279,279,48,35,13,2,1
13,292,292,24,24,0,1,0
4,306,306,63,3,60,4,3
2,330,330,1,1,0,1,0
31,337,337,29,12,17,2,1
32,340,340,46,46,0,1,0
28,346,346,10,4,6,2,1
34,374,374,22,22,0,1,0
24,374,374,80,80,0,1,0
18,388,388,6,1,5,2,1
21,391,391,38,38,0,1,0
3,417,417,40,40,0,1,0
1,436,436,2,2,0,1,0
26,437,437,38,5,33,4,3
8,441,441,38,38,0,1,0
12,450,450,41,41,0,1,0
16,467,467,10,10,0,1,0
17,467,467,9,3,6,2,1
7,468,468,19,3,16,2,1
0,473,473,31,26,5,2,1
20,475,475,69,5,64,3,2

2,104,104,1,1,0,1,0
29,118,118,9,9,0,1,0
4,129,129,22,3,19,2,1
14,132,132,29,15,14,2,1
31,144,144,12,12,0,1,0
23,159,159,64,45,19,2,1
26,161,161,22,6,16,3,2
22,169,169,1,1,0,1,0
16,173,173,9,1,8,2,1
21,174,174,49,16,33,2,1
30,186,186,23,23,0,1,0
11,222,222,19,19,0,1,0
28,232,232,21,9,12,4,3
27,233,233,4,4,0,1,0
1,261,261,2,2,0,1,0
15,289,289,4,4,0,1,0
10,298,298,48,13,35,2,1
3,301,301,57,57,0,1,0
20,303,303,18,12,6,3,2
8,304,304,9,9,0,1,0
32,326,326,4,1,3,2,1
25,331,331,27,5,22,3,2
5,341,341,51,51,0,1,0
0,352,352,1,1,0,1,0
13,359,359,15,2,13,2,1
24,371,371,4,4,0,1,0
7,378,378,6,3,3,2,1
17,418,418,40,16,24,2,1
12,435,435,24,24,0,1,0
19,459,459,22,22,0,1,0
6,464,464,2,2,0,1,0
18,483,483,36,30,6,2,1
9,492,492,11,11,0,1,0

21,105,105,2,2,0,1,0
8,118,118,24,8,16,2,1
12,119,119,21,21,0,1,0
17,124,124,15,1,14,2,1
2,159,159,11,5,6,3,2
11,166,166,1,1,0,1,0
5,175,175,16,1,15,4,3
16,187,187,21,9,12,2,1
20,223,223,3,3,0,1,0
22,225,225,69,33,36,3,2
14,238,238,9,3,6,3,2
23,257,257,6,6,0,1,0
6,297,297,8,8,0,1,0
4,301,301,21,1,20,2,1
0,309,309,86,86,0,1,0
1,318,318,4,4,0,1,0
18,331,331,2,2,0,1,0
25,363,363,5,5,0,1,0
24,364,364,24,24,0,1,0
15,377,377,25,25,0,1,0
10,394,394,72,72,0,1,0
7,394,394,5,5,0,1,0
9,464,464,123,108,15,4,3
3,464,464,85,85,0,1,0
19,469,469,36,14,22,3,2
13,487,487,191,122,69,4,3

27,114,114,10,10,0,1,0
8,128,128,26,26,0,1,0
1,129,129,19,19,0,1,0
10,129,129,3,3,0,1,0
25,140,140,39,22,17,2,1
24,175,175,2,2,0,1,0
11,202,202,1,1,0,1,0
14,263,263,48,48,0,1,0
17,274,274,2,2,0,1,0
22,275,275,8,8,0,1,0
18,282,282,16,1,15,2,1
26,283,283,38,38,0,1,0
9,284,284,90,11,79,4,3
20,319,319,13,7,6,3,2
3,326,326,26,6,20,3,2
7,328,328,16,6,10,3,2
16,334,334,38,38,0,1,0
19,346,346,33,33,0,1,0
4,401,401,5,5,0,1,0
23,440,440,25,25,0,1,0
2,447,447,17,3,14,2,1
12,450,450,39,30,9,2,1
0,470,470,51,9,42,4,3
15,473,473,144,94,50,2,1
21,477,477,15,3,12,2,1
5,480,480,4,1,3,2,1
6,482,482,49,49,0,1,0
13,499,499,110,110,0,1,0

1,112,112,3,3,0,1,0
5,143,143,6,2,4,2,1
26,191,191,25,15,10,2,1
3,191,191,15,15,0,1,0
12,201,201,21,5,16,3,2
2,212,212,8,5,3,2,1
18,216,216,19,19,0,1,0
17,231,231,5,1,4,2,1
0,250,250,163,93,70,3,2
11,269,269,68,33,35,2,1
13,284,284,54,40,14,3,2
14,288,288,8,8,0,1,0
25,289,289,32,22,10,2,1
10,303,303,5,2,3,2,1
20,319,319,45,2,43,2,1
7,351,351,17,17,0,1,0
6,376,376,4,4,0,1,0
24,382,382,51,2,49,2,1
19,388,388,18,18,0,1,0
22,398,398,45,6,39,3,2
21,403,403,1,1,0,1,0
4,407,407,8,8,0,1,0
15,413,413,78,22,56,3,2
23,444,444,51,51,0,1,0
16,465,465,53,47,6,2,1
8,477,477,40,40,0,1,0
9,485,485,13,7,6,3,2

8,103,103,22,2,20,2,1
13,126,126,1,1,0,1,0
5,167,167,16,7,9,4,3
17,171,171,5,1,4,2,1
12,201,201,12,2,10,2,1
6,207,207,38,38,0,1,0
11,212,212,22,1,21,2,1
2,221,221,17,11,6,2,1
10,240,240,2,2,0,1,0
0,240,240,68,23,45,4,3
9,243,243,9,3,6,2,1
7,247,247,13,13,0,1,0
18,266,266,36,36,0,1,0
20,273,273,18,18,0,1,0
4,275,275,9,9,0,1,0
1,303,303,16,6,10,3,2
15,306,306,10,10,0,1,0
14,390,390,116,20,96,3,2
3,406,406,167,65,102,4,3
22,422,422,2,2,0,1,0
19,451,451,103,103,0,1,0
21,458,458,20,20,0,1,0
16,479,479,177,177,0,1,0

12,100,100,1,1,0,1,0
23,104,104,5,5,0,1,0
0,107,107,1,1,0,1,0
26,117,117,54,9,45,4,3
33,131,131,3,3,0,1,0
34,157,157,29,29,0,1,0
17,161,161,7,7,0,1,0
2,163,163,10,10,0,1,0
13,177,177,15,7,8,3,2
24,178,178,49,34,15,2,1
36,193,193,1,1,0,1,0
6,211,211,10,2,8,2,1
11,216,216,10,10,0,1,0
10,243,243,28,28,0,1,0
15,248,248,14,6,8,2,1
1,252,252,23,5,18,2,1
19,264,264,6,3,3,2,1
16,265,265,9,9,0,1,0
35,271,271,9,9,0,1,0
21,321,321,42,42,0,1,0
29,346,346,24,24,0,1,0
28,350,350,12,1,11,2,1
31,354,354,22,3,19,2,1
9,358,358,4,4,0,1,0
3,382,382,14,14,0,1,0
20,405,405,14,14,0,1,0
5,413,413,4,4,0,1,0
4,427,427,42,42,0,1,0
27,441,441,25,25,0,1,0
22,449,449,68,52,16,3,2
30,463,463,32,6,26,2,1
14,466,466,19,19,0,1,0
25,469,469,1,1,0,1,0
8,469,469,42,36,6,3,2
32,478,478,2,2,0,1,0
37,488,488,73,35,38,3,2
18,491,491,12,12,0,1,0
7,495,495,51,51,0,1,0

26,109,109,1,1,0,1,0
25,111,111,24,24,0,1,0
22,128,128,7,1,6,3,2
24,129,129,7,2,5,2,1
12,144,144,1,1,0,1,0
21,154,154,5,5,0,1,0
8,162,162,13,13,0,1,0
18,165,165,6,6,0,1,0
15,172,172,17,17,0,1,0
4,178,178,17,11,6,3,2
7,181,181,2,2,0,1,0
9,192,192,31,31,0,1,0
10,198,198,57,57,0,1,0
20,240,240,24,14,10,2,1
23,247,247,29,29,0,1,0
17,251,251,1,1,0,1,0
2,264,264,65,18,47,3,2
3,303,303,79,48,31,4,3
5,305,305,35,17,18,3,2
13,327,327,70,14,56,3,2
11,347,347,9,6,3,2,1
16,356,356,154,154,0,1,0
0,359,359,17,8,9,2,1
14,405,405,8,8,0,1,0
6,414,414,1,1,0,1,0
19,431,431,19,7,12,2,1
1,469,469,30,30,0,1,0

0,156,156,12,8,4,2,1
2,166,166,24,12,12,4,3
27,170,170,18,2,16,3,2
3,171,171,18,15,3,2,1
5,188,188,5,5,0,1,0
23,189,189,36,36,0,1,0
13,191,191,14,5,9,2,1
28,201,201,23,9,14,2,1
17,202,202,3,3,0,1,0
11,209,209,2,2,0,1,0
25,254,254,27,27,0,1,0
9,260,260,28,28,0,1,0
22,260,260,4,1,3,2,1
24,271,271,8,8,0,1,0
7,295,295,3,3,0,1,0
21,323,323,25,6,19,2,1
26,323,323,65,32,33,4,3
15,339,339,6,6,0,1,0
16,373,373,36,2,34,3,2
31,396,396,74,17,57,4,3
14,405,405,22,13,9,2,1
1,407,407,24,24,0,1,0
8,413,413,35,35,0,1,0
19,414,414,2,2,0,1,0
32,419,419,51,51,0,1,0
29,426,426,21,1,20,2,1
6,457,457,48,48,0,1,0
12,471,471,74,23,51,4,3
20,472,472,49,49,0,1,0
4,483,483,17,1,16,2,1
18,485,485,56,6,50,2,1
10,489,489,52,21,31,3,2
30,493,493,56,5,51,4,3

13,135,135,18,18,0,1,0
5,162,162,14,14,0,1,0
12,174,174,4,4,0,1,0
17,179,179,32,32,0,1,0
16,180,180,2,2,0,1,0
20,208,208,49,49,0,1,0
24,227,227,48,14,34,2,1
10,245,245,2,2,0,1,0
19,269,269,1,1,0,1,0
18,299,299,46,46,0,1,0
22,308,308,19,11,8,2,1
11,316,316,15,15,0,1,0
2,340,340,1,1,0,1,0
27,346,346,31,22,9,4,3
29,350,350,6,6,0,1,0
14,351,351,6,6,0,1,0
0,352,352,30,9,21,4,3
9,354,354,20,20,0,1,0
28,396,396,90,6,84,3,2
6,397,397,15,11,4,2,1
7,398,398,80,65,15,4,3
8,414,414,14,6,8,2,1
25,445,445,2,2,0,1,0
23,456,456,66,2,64,4,3
26,457,457,27,27,0,1,0
1,468,468,128,128,0,1,0
3,472,472,72,72,0,1,0
21,488,488,16,16,0,1,0
15,491,491,98,98,0,1,0
4,496,496,21,21,0,1,0

28,135,135,2,2,0,1,0
24,142,142,43,22,21,2,1
10,146,146,6,3,3,2,1
1,153,153,52,52,0,1,0
12,163,163,1,1,0,1,0
2,167,167,2,2,0,1,0
27,172,172,1,1,0,1,0
4,234,234,24,12,12,2,1
23,237,237,28,22,6,3,2
13,278,278,20,20,0,1,0
18,281,281,48,48,0,1,0
8,291,291,16,1,15,2,1
7,304,304,48,32,16,2,1
0,305,305,18,18,0,1,0
26,321,321,27,15,12,3,2
14,323,323,3,3,0,1,0
17,334,334,5,2,3,2,1
5,343,343,12,12,0,1,0
3,348,348,15,15,0,1,0
20,349,349,10,1,9,2,1
16,362,362,72,6,66,3,2
25,365,365,43,43,0,1,0
6,399,399,155,77,78,4,3
19,463,463,19,7,12,3,2
22,465,465,50,40,10,2,1
9,469,469,36,18,18,2,1
21,472,472,38,35,3,2,1
15,485,485,69,61,8,2,1
11,489,489,2,2,0,1,0

4,119,119,51,25,26,2,1
24,124,124,26,18,8,2,1
8,135,135,12,12,0,1,0
12,148,148,3,3,0,1,0
18,150,150,28,19,9,2,1
1,165,165,28,15,13,2,1
11,172,172,22,22,0,1,0
3,174,174,28,28,0,1,0
21,177,177,11,11,0,1,0
17,233,233,17,17,0,1,0
15,283,283,44,44,0,1,0
9,325,325,7,3,4,2,1
7,329,329,1,1,0,1,0
6,330,330,1,1,0,1,0
0,331,331,24,24,0,1,0
13,347,347,61,28,33,2,1
23,357,357,16,8,8,2,1
20,405,405,18,18,0,1,0
2,418,418,68,68,0,1,0
22,431,431,5,5,0,1,0
19,449,449,39,39,0,1,0
14,454,454,41,41,0,1,0
5,465,465,114,42,72,4,3
16,472,472,65,65,0,1,0
10,483,483,22,10,12,4,3

7,129,129,19,9,10,3,2
12,146,146,17,17,0,1,0
22,146,146,12,12,0,1,0
25,166,166,5,5,0,1,0
30,188,188,26,26,0,1,0
21,218,218,33,33,0,1,0
17,243,243,31,10,21,4,3
14,243,243,23,23,0,1,0
4,253,253,42,42,0,1,0
28,260,260,1,1,0,1,0
29,267,267,13,3,10,2,1
11,268,268,31,31,0,1,0
20,269,269,28,10,18,3,2
1,275,275,1,1,0,1,0
10,285,285,50,50,0,1,0
2,302,302,10,5,5,2,1
15,303,303,18,9,9,2,1
16,310,310,12,12,0,1,0
9,314,314,22,22,0,1,0
5,315,315,4,4,0,1,0
3,323,323,20,20,0,1,0
18,334,334,19,19,0,1,0
26,345,345,16,16,0,1,0
0,350,350,25,10,15,4,3
13,358,358,36,20,16,4,3
8,363,363,1,1,0,1,0
24,385,385,147,147,0,1,0
31,408,408,1,1,0,1,0
27,430,430,129,90,39,4,3
19,453,453,14,14,0,1,0
6,465,465,3,3,0,1,0
23,469,469,21,6,15,2,1

0,100,100,1,1,0,1,0
14,103,103,19,4,15,3,2
5,127,127,16,2,14,3,2
8,134,134,2,2,0,1,0
15,160,160,20,9,11,2,1
26,197,197,50,29,21,2,1
1,214,214,41,41,0,1,0
11,214,214,59,18,41,2,1
22,218,218,5,5,0,1,0
20,237,237,29,11,18,4,3
9,243,243,12,3,9,4,3
25,255,255,18,18,0,1,0
3,260,260,1,1,0,1,0
18,274,274,15,4,11,4,3
19,304,304,91,21,70,3,2
28,333,333,2,2,0,1,0
10,341,341,4,1,3,2,1
6,348,348,21,17,4,2,1
21,356,356,74,74,0,1,0
12,357,357,11,11,0,1,0
2,367,367,6,1,5,2,1
24,368,368,20,8,12,4,3
13,369,369,73,27,46,2,1
4,374,374,5,5,0,1,0
17,383,383,27,7,20,3,2
16,387,387,22,22,0,1,0
27,418,418,40,40,0,1,0
7,457,457,43,37,6,2,1
23,472,472,24,12,12,3,2
29,488,488,32,32,0,1,0

21,121,121,3,3,0,1,0
2,137,137,13,4,9,4,3
34,138,138,15,5,10,3,2
19,164,164,9,1,8,2,1
8,171,171,25,1,24,4,3
35,176,176,17,17,0,1,0
18,188,188,45,45,0,1,0
26,203,203,8,8,0,1,0
20,211,211,1,1,0,1,0
0,215,215,14,10,4,2,1
10,221,221,1,1,0,1,0
16,232,232,12,12,0,1,0
28,247,247,38,15,23,2,1
9,255,255,2,2,0,1,0
31,272,272,56,56,0,1,0
29,284,284,5,1,4,2,1
27,294,294,5,5,0,1,0
32,296,296,5,5,0,1,0
3,299,299,7,7,0,1,0
6,320,320,15,11,4,2,1
12,348,348,12,12,0,1,0
33,355,355,49,3,46,3,2
15,397,397,11,3,8,2,1
14,407,407,6,6,0,1,0
11,409,409,20,20,0,1,0
7,415,415,2,2,0,1,0
4,443,443,12,5,7,2,1
25,446,446,81,81,0,1,0
5,460,460,105,19,86,3,2
17,465,465,50,37,13,2,1
22,469,469,44,44,0,1,0
30,475,475,15,1,14,3,2
24,477,477,67,19,48,4,3
13,489,489,10,1,9,4,3
23,492,492,84,42,42,3,2
1,499,499,61,61,0,1,0

18,120,120,8,8,0,1,0
20,124,124,2,2,0,1,0
30,129,129,2,2,0,1,0
0,131,131,1,1,0,1,0
16,161,161,13,13,0,1,0
12,161,161,1,1,0,1,0
2,167,167,11,11,0,1,0
24,175,175,1,1,0,1,0
33,176,176,3,3,0,1,0
26,179,179,6,6,0,1,0
34,185,185,66,66,0,1,0
29,197,197,55,55,0,1,0
15,199,199,7,7,0,1,0
27,204,204,8,8,0,1,0
9,214,214,32,12,20,3,2
19,218,218,2,2,0,1,0
17,232,232,20,20,0,1,0
31,245,245,56,10,46,2,1
36,268,268,7,7,0,1,0
39,296,296,7,4,3,2,1
5,302,302,35,35,0,1,0
3,304,304,10,1,9,2,1
21,307,307,22,22,0,1,0
11,312,312,1,1,0,1,0
28,318,318,35,35,0,1,0
8,322,322,35,35,0,1,0
25,343,343,6,6,0,1,0
10,353,353,16,4,12,3,2
22,377,377,1,1,0,1,0
1,377,377,20,20,0,1,0
13,396,396,1,1,0,1,0
35,396,396,48,39,9,4,3
38,408,408,8,8,0,1,0
23,426,426,13,4,9,4,3
37,436,436,28,28,0,1,0
6,442,442,155,134,21,4,3
14,454,454,9,9,0,1,0
4,463,463,8,8,0,1,0
7,480,480,1,1,0,1,0
32,488,488,44,6,38,2,1

2,104,104,16,7,9,4,3
12,107,107,5,5,0,1,0
19,109,109,43,15,28,2,1
28,111,111,2,2,0,1,0
20,133,133,6,6,0,1,0
16,134,134,5,5,0,1,0
15,178,178,12,12,0,1,0
7,182,182,22,22,0,1,0
26,202,202,19,13,6,3,2
3,217,217,19,19,0,1,0
0,224,224,12,12,0,1,0
1,231,231,25,17,8,2,1
29,234,234,1,1,0,1,0
24,261,261,6,6,0,1,0
25,277,277,22,1,21,4,3
8,280,280,11,11,0,1,0
9,310,310,37,37,0,1,0
17,310,310,6,2,4,2,1
21,322,322,72,55,17,2,1
4,324,324,15,1,14,3,2
11,351,351,2,2,0,1,0
23,376,376,25,6,19,4,3
10,384,384,95,67,28,2,1
5,389,389,47,14,33,2,1
18,425,425,3,3,0,1,0
6,450,450,7,7,0,1,0
13,453,453,59,29,30,2,1
14,470,470,20,2,18,3,2
22,474,474,175,146,29,2,1
27,495,495,26,4,22,2,1

3,122,122,6,6,0,1,0
0,130,130,3,3,0,1,0
7,139,139,3,3,0,1,0
6,179,179,29,29,0,1,0
17,182,182,6,3,3,2,1
1,187,187,72,72,0,1,0
20,187,187,44,11,33,2,1
4,218,218,7,7,0,1,0
10,220,220,2,2,0,1,0
23,230,230,34,34,0,1,0
16,259,259,8,8,0,1,0
24,260,260,9,3,6,2,1
22,260,260,19,5,14,3,2
25,275,275,40,34,6,2,1
9,303,303,60,40,20,2,1
13,306,306,11,11,0,1,0
15,308,308,33,19,14,3,2
8,318,318,2,2,0,1,0
11,323,323,105,18,87,4,3
5,356,356,48,15,33,4,3
18,395,395,140,46,94,3,2
21,413,413,20,20,0,1,0
2,417,417,6,6,0,1,0
27,421,421,61,49,12,4,3
26,478,478,23,7,16,2,1
19,482,482,6,6,0,1,0
12,489,489,3,3,0,1,0
14,497,497,3,3,0,1,0

20,132,132,14,14,0,1,0
3,132,132,29,29,0,1,0
19,138,138,42,37,5,2,1
18,181,181,4,4,0,1,0
1,189,189,16,16,0,1,0
0,197,197,18,18,0,1,0
4,218,218,16,16,0,1,0
2,225,225,128,14,114,4,3
22,243,243,32,32,0,1,0
8,272,272,59,12,47,2,1
21,275,275,19,19,0,1,0
15,292,292,5,5,0,1,0
9,300,300,64,61,3,2,1
16,367,367,7,7,0,1,0
13,370,370,18,9,9,2,1
11,382,382,28,28,0,1,0
5,390,390,23,11,12,4,3
14,408,408,22,13,9,4,3
12,437,437,19,9,10,2,1
6,439,439,30,30,0,1,0
10,465,465,86,56,30,4,3
17,474,474,66,6,60,3,2
7,487,487,9,9,0,1,0

13,118,118,9,9,0,1,0
27,139,139,1,1,0,1,0
23,148,148,2,2,0,1,0
3,165,165,12,8,4,2,1
18,176,176,13,13,0,1,0
16,177,177,36,36,0,1,0
5,193,193,8,8,0,1,0
8,203,203,3,3,0,1,0
1,229,229,37,37,0,1,0
9,238,238,3,3,0,1,0
19,248,248,12,5,7,2,1
20,273,273,26,26,0,1,0
17,279,279,20,14,6,3,2
28,285,285,86,68,18,3,2
15,288,288,12,12,0,1,0
0,290,290,7,3,4,2,1
29,300,300,46,46,0,1,0
7,300,300,7,7,0,1,0
12,318,318,33,33,0,1,0
2,327,327,40,40,0,1,0
25,381,381,56,56,0,1,0
14,392,392,37,18,19,4,3
10,397,397,3,3,0,1,0
11,406,406,178,136,42,2,1
24,426,426,32,20,12,3,2
26,434,434,53,53,0,1,0
4,441,441,47,47,0,1,0
21,447,447,26,26,0,1,0
6,465,465,28,21,7,2,1
22,488,488,29,11,18,4,3

4,117,117,2,2,0,1,0
2,144,144,8,8,0,1,0
10,146,146,11,2,9,4,3
24,152,152,8,8,0,1,0
3,153,153,5,5,0,1,0
22,179,179,7,3,4,2,1
17,183,183,6,2,4,2,1
11,203,203,18,1,17,4,3
14,217,217,30,2,28,2,1
6,222,222,1,1,0,1,0
12,236,236,2,2,0,1,0
21,246,246,18,18,0,1,0
5,252,252,16,13,3,2,1
7,269,269,57,45,12,4,3
8,289,289,153,153,0,1,0
25,313,313,6,6,0,1,0
23,343,343,33,33,0,1,0
0,346,346,25,25,0,1,0
16,348,348,11,11,0,1,0
18,350,350,1,1,0,1,0
9,411,411,13,1,12,4,3
13,434,434,176,150,26,3,2
20,441,441,34,34,0,1,0
15,465,465,52,24,28,2,1
1,486,486,108,108,0,1,0
19,491,491,168,118,50,3,2

19,120,120,8,8,0,1,0
13,123,123,7,7,0,1,0
14,129,129,26,6,20,3,2
21,145,145,17,17,0,1,0
0,169,169,1,1,0,1,0
3,180,180,63,63,0,1,0
23,191,191,14,14,0,1,0
26,211,211,27,27,0,1,0
20,234,234,5,2,3,2,1
17,240,240,34,34,0,1,0
9,287,287,1,1,0,1,0
16,306,306,9,5,4,2,1
5,313,313,2,2,0,1,0
1,341,341,20,20,0,1,0
6,349,349,67,38,29,2,1
11,351,351,81,60,21,2,1
25,360,360,48,6,42,4,3
24,366,366,113,113,0,1,0
15,372,372,13,13,0,1,0
4,390,390,4,4,0,1,0
10,407,407,168,82,86,3,2
18,415,415,42,30,12,4,3
8,430,430,20,13,7,2,1
22,440,440,10,10,0,1,0
12,450,450,26,26,0,1,0
2,487,487,11,11,0,1,0
7,500,500,2,2,0,1,0

15,143,143,14,14,0,1,0
11,151,151,29,3,26,3,2
23,158,158,34,34,0,1,0
7,163,163,20,20,0,1,0
22,185,185,40,40,0,1,0
8,186,186,3,3,0,1,0
9,192,192,19,11,8,3,2
10,199,199,20,20,0,1,0
18,199,199,26,14,12,2,1
1,230,230,8,8,0,1,0
24,258,258,5,5,0,1,0
17,280,280,3,3,0,1,0
3,288,288,13,7,6,3,2
21,291,291,27,9,18,4,3
5,313,313,113,113,0,1,0
25,336,336,46,46,0,1,0
14,340,340,5,1,4,2,1
2,357,357,90,90,0,1,0
20,362,362,32,32,0,1,0
13,393,393,79,79,0,1,0
19,418,418,16,7,9,2,1
12,421,421,19,19,0,1,0
0,424,424,40,24,16,4,3
16,426,426,52,52,0,1,0
4,439,439,23,23,0,1,0
6,475,475,16,5,11,3,2

6,101,101,2,2,0,1,0
23,106,106,6,6,0,1,0
14,124,124,8,3,5,2,1
7,128,128,41,41,0,1,0
22,128,128,25,4,21,2,1
13,144,144,26,1,25,4,3
25,161,161,10,10,0,1,0
29,173,173,16,7,9,2,1
12,174,174,17,17,0,1,0
31,189,189,2,2,0,1,0
19,209,209,48,21,27,2,1
0,227,227,25,25,0,1,0
15,252,252,1,1,0,1,0
4,257,257,29,4,25,2,1
16,258,258,7,7,0,1,0
9,278,278,12,4,8,3,2
11,293,293,19,19,0,1,0
27,297,297,50,5,45,4,3
26,307,307,6,6,0,1,0
17,318,318,5,5,0,1,0
20,325,325,77,77,0,1,0
1,327,327,9,9,0,1,0
5,328,328,61,19,42,2,1
8,328,328,1,1,0,1,0
24,332,332,52,35,17,4,3
30,420,420,40,6,34,2,1
18,421,421,8,8,0,1,0
21,426,426,30,30,0,1,0
28,427,427,11,11,0,1,0
10,448,448,14,14,0,1,0
2,460,460,21,12,9,2,1
3,499,499,24,20,4,2,1

26,101,101,4,1,3,2,1
7,103,103,10,10,0,1,0
17,113,113,6,6,0,1,0
19,118,118,17,3,14,3,2
16,125,125,32,32,0,1,0
10,136,136,11,5,6,3,2
11,153,153,19,12,7,2,1
18,155,155,1,1,0,1,0
15,195,195,2,2,0,1,0
23,209,209,28,28,0,1,0
12,241,241,2,2,0,1,0
8,244,244,13,13,0,1,0
3,281,281,2,2,0,1,0
0,296,296,95,68,27,4,3
4,300,300,12,12,0,1,0
20,302,302,1,1,0,1,0
6,304,304,89,35,54,4,3
25,324,324,12,12,0,1,0
5,333,333,22,22,0,1,0
2,334,334,14,2,12,2,1
24,338,338,47,8,39,2,1
1,366,366,3,3,0,1,0
27,387,387,55,8,47,2,1
9,399,399,94,94,0,1,0
13,407,407,10,10,0,1,0
14,418,418,66,9,57,4,3
22,420,420,17,1,16,3,2
21,474,474,123,123,0,1,0

13,110,110,1,1,0,1,0
26,158,158,12,12,0,1,0
11,172,172,1,1,0,1,0
0,174,174,30,18,12,2,1
14,192,192,53,23,30,4,3
19,201,201,5,5,0,1,0
18,219,219,12,12,0,1,0
21,226,226,2,2,0,1,0
7,250,250,3,3,0,1,0
24,254,254,19,19,0,1,0
15,256,256,37,1,36,4,3
4,278,278,34,11,23,2,1
10,287,287,6,6,0,1,0
2,321,321,10,10,0,1,0
6,324,324,26,26,0,1,0
20,345,345,25,25,0,1,0
8,353,353,142,107,35,2,1
17,362,362,104,66,38,4,3
9,387,387,17,14,3,2,1
22,412,412,53,5,48,2,1
1,430,430,63,19,44,2,1
5,440,440,77,77,0,1,0
16,441,441,19,19,0,1,0
23,455,455,25,2,23,2,1
12,467,467,47,47,0,1,0
3,480,480,42,10,32,3,2
25,496,496,88,43,45,4,3

2,107,107,7,7,0,1,0
14,109,109,1,1,0,1,0
0,116,116,7,7,0,1,0
23,123,123,2,2,0,1,0
11,125,125,9,1,8,3,2
18,139,139,1,1,0,1,0
8,180,180,7,4,3,2,1
26,195,195,21,21,0,1,0
30,219,219,20,6,14,3,2
22,221,221,9,9,0,1,0
16,226,226,2,2,0,1,0
6,240,240,51,51,0,1,0
20,248,248,35,4,31,2,1
3,257,257,5,5,0,1,0
5,278,278,13,13,0,1,0
19,297,297,34,26,8,3,2
12,305,305,30,30,0,1,0
21,328,328,42,42,0,1,0
25,356,356,16,16,0,1,0
9,375,375,15,3,12,4,3
4,378,378,92,12,80,4,3
24,392,392,22,4,18,4,3
10,394,394,1,1,0,1,0
31,401,401,58,58,0,1,0
15,414,414,49,5,44,4,3
29,437,437,18,18,0,1,0
1,438,438,40,10,30,3,2
28,448,448,130,36,94,3,2
13,453,453,63,29,34,4,3
27,453,453,44,44,0,1,0
32,466,466,51,51,0,1,0
7,474,474,40,22,18,4,3
17,482,482,21,21,0,1,0

11,104,104,1,1,0,1,0
2,126,126,1,1,0,1,0
7,140,140,29,23,6,2,1
27,142,142,11,8,3,2,1
28,147,147,20,16,4,2,1
23,155,155,15,6,9,4,3
1,156,156,19,12,7,2,1
21,160,160,10,2,8,3,2
25,165,165,9,9,0,1,0
18,166,166,3,3,0,1,0
16,193,193,120,120,0,1,0
10,218,218,5,2,3,2,1
3,227,227,53,29,24,3,2
17,231,231,5,5,0,1,0
19,240,240,56,56,0,1,0
5,247,247,2,2,0,1,0
26,249,249,4,4,0,1,0
20,261,261,6,6,0,1,0
4,294,294,9,9,0,1,0
13,313,313,14,4,10,3,2
8,320,320,6,3,3,2,1
22,327,327,16,4,12,3,2
12,348,348,58,58,0,1,0
9,384,384,9,2,7,2,1
15,390,390,47,5,42,2,1
14,407,407,21,21,0,1,0
0,420,420,125,85,40,4,3
24,437,437,7,7,0,1,0
29,476,476,2,2,0,1,0
6,476,476,17,17,0,1,0

18,109,109,7,7,0,1,0
22,118,118,34,34,0,1,0
20,138,138,3,3,0,1,0
12,193,193,68,68,0,1,0
5,197,197,28,4,24,2,1
7,198,198,37,5,32,2,1
1,216,216,38,14,24,4,3
10,280,280,31,14,17,2,1
3,298,298,90,54,36,3,2
16,299,299,21,14,7,2,1
8,325,325,8,2,6,2,1
11,328,328,37,21,16,2,1
6,330,330,46,46,0,1,0
14,349,349,11,1,10,3,2
15,392,392,37,37,0,1,0
0,425,425,53,53,0,1,0
17,443,443,9,9,0,1,0
2,443,443,95,8,87,4,3
9,454,454,14,14,0,1,0
19,456,456,80,80,0,1,0
13,458,458,22,22,0,1,0
4,476,476,44,44,0,1,0
21,484,484,2,2,0,1,0

1,103,103,1,1,0,1,0
12,110,110,8,8,0,1,0
4,155,155,19,7,12,2,1
5,162,162,14,2,12,4,3
8,188,188,31,7,24,3,2
16,235,235,74,74,0,1,0
6,239,239,37,37,0,1,0
17,256,256,53,53,0,1,0
23,284,284,11,11,0,1,0
14,285,285,20,20,0,1,0
19,308,308,20,20,0,1,0
10,315,315,26,23,3,2,1
2,331,331,111,77,34,2,1
21,337,337,19,1,18,2,1
3,340,340,11,2,9,4,3
11,370,370,12,12,0,1,0
13,376,376,22,22,0,1,0
7,376,376,29,29,0,1,0
22,380,380,11,11,0,1,0
20,381,381,27,27,0,1,0
0,384,384,115,69,46,2,1
24,395,395,17,17,0,1,0
25,421,421,6,6,0,1,0
15,436,436,150,150,0,1,0
9,440,440,2,2,0,1,0
18,458,458,19,7,12,3,2

23,105,105,10,10,0,1,0
22,112,112,16,8,8,3,2
7,119,119,27,24,3,2,1
15,120,120,18,2,16,2,1
21,126,126,12,12,0,1,0
0,132,132,12,12,0,1,0
9,133,133,2,2,0,1,0
4,138,138,38,5,33,4,3
13,161,161,4,4,0,1,0
16,164,164,25,7,18,4,3
8,209,209,5,5,0,1,0
24,220,220,12,12,0,1,0
5,231,231,32,6,26,2,1
18,233,233,20,20,0,1,0
11,241,241,33,18,15,4,3
10,294,294,37,37,0,1,0
3,298,298,48,48,0,1,0
19,340,340,91,53,38,4,3
12,350,350,6,6,0,1,0
6,350,350,6,6,0,1,0
17,351,351,30,9,21,4,3
1,354,354,89,19,70,3,2
2,371,371,28,28,0,1,0
20,427,427,53,53,0,1,0
14,445,445,4,4,0,1,0

14,104,104,6,1,5,2,1
0,124,124,7,7,0,1,0
19,169,169,40,2,38,2,1
8,188,188,18,12,6,3,2
10,209,209,4,4,0,1,0
22,219,219,29,19,10,3,2
23,233,233,34,34,0,1,0
2,255,255,49,24,25,2,1
15,261,261,3,3,0,1,0
4,278,278,14,6,8,2,1
3,279,279,18,18,0,1,0
5,301,301,89,68,21,4,3
9,346,346,11,11,0,1,0
16,347,347,10,2,8,3,2
24,357,357,9,1,8,3,2
17,358,358,112,102,10,2,1
20,376,376,27,27,0,1,0
1,391,391,70,70,0,1,0
7,398,398,17,14,3,2,1
6,423,423,122,28,94,3,2
12,458,458,41,25,16,3,2
11,460,460,39,39,0,1,0
13,476,476,42,16,26,3,2
18,480,480,68,46,22,2,1
21,492,492,22,22,0,1,0
25,494,494,17,17,0,1,0

21,100,100,19,19,0,1,0
33,109,109,9,9,0,1,0
28,141,141,6,6,0,1,0
8,153,153,1,1,0,1,0
17,158,158,20,10,10,3,2
26,165,165,39,39,0,1,0
19,171,171,3,3,0,1,0
29,177,177,1,1,0,1,0
27,180,180,8,3,5,2,1
16,199,199,1,1,0,1,0
22,205,205,3,3,0,1,0
20,206,206,12,12,0,1,0
18,225,225,50,2,48,2,1
5,231,231,10,10,0,1,0
7,243,243,25,19,6,2,1
4,264,264,2,2,0,1,0
32,268,268,50,50,0,1,0
9,277,277,11,11,0,1,0
25,283,283,15,15,0,1,0
24,300,300,8,8,0,1,0
1,313,313,9,2,7,2,1
6,316,316,14,14,0,1,0
11,324,324,4,4,0,1,0
30,330,330,50,1,49,2,1
23,364,364,16,4,12,2,1
2,395,395,5,5,0,1,0
3,403,403,7,7,0,1,0
10,407,407,51,51,0,1,0
12,410,410,9,9,0,1,0
15,410,410,66,31,35,2,1
31,434,434,130,97,33,4,3
0,464,464,96,80,16,2,1
14,474,474,60,26,34,2,1
13,485,485,35,26,9,4,3

2,125,125,35,35,0,1,0
5,133,133,7,7,0,1,0
25,148,148,7,1,6,3,2
11,160,160,4,1,3,2,1
9,196,196,23,23,0,1,0
20,206,206,44,44,0,1,0
23,221,221,60,42,18,4,3
24,255,255,22,1,21,3,2
15,261,261,31,31,0,1,0
3,287,287,22,3,19,2,1
7,288,288,3,3,0,1,0
0,289,289,38,20,18,3,2
17,298,298,3,3,0,1,0
10,309,309,30,30,0,1,0
18,323,323,14,14,0,1,0
14,343,343,60,60,0,1,0
21,344,344,36,36,0,1,0
8,363,363,6,6,0,1,0
6,363,363,61,24,37,4,3
12,382,382,92,92,0,1,0
13,424,424,26,11,15,2,1
19,435,435,12,12,0,1,0
22,460,460,35,35,0,1,0
1,468,468,4,4,0,1,0
27,469,469,9,6,3,2,1
26,487,487,88,60,28,4,3
4,490,490,57,10,47,3,2
16,492,492,27,9,18,2,1

18,111,111,12,9,3,2,1
0,124,124,7,7,0,1,0
17,139,139,16,16,0,1,0
23,157,157,23,5,18,4,3
15,175,175,87,43,44,3,2
27,187,187,5,1,4,2,1
4,218,218,7,2,5,2,1
11,228,228,2,2,0,1,0
24,264,264,27,27,0,1,0
5,265,265,27,18,9,4,3
19,270,270,1,1,0,1,0
10,286,286,24,24,0,1,0
3,289,289,42,23,19,2,1
22,297,297,3,3,0,1,0
1,303,303,74,68,6,3,2
26,318,318,19,19,0,1,0
13,325,325,88,4,84,4,3
7,327,327,32,32,0,1,0
14,337,337,35,35,0,1,0
20,359,359,24,24,0,1,0
8,364,364,36,36,0,1,0
2,379,379,7,7,0,1,0
28,398,398,35,3,32,2,1
16,404,404,55,28,27,4,3
25,414,414,13,13,0,1,0
21,429,429,14,2,12,3,2
12,436,436,23,23,0,1,0
9,452,452,16,16,0,1,0
6,479,479,24,1,23,2,1

9,118,118,4,1,3,2,1
19,125,125,1,1,0,1,0
7,136,136,8,2,6,3,2
14,142,142,32,22,10,3,2
6,145,145,25,14,11,2,1
10,154,154,2,2,0,1,0
29,155,155,11,3,8,3,2
12,164,164,9,9,0,1,0
28,167,167,12,12,0,1,0
4,172,172,12,3,9,2,1
2,189,189,18,18,0,1,0
18,230,230,44,4,40,3,2
23,255,255,40,40,0,1,0
25,264,264,7,7,0,1,0
5,290,290,1,1,0,1,0
0,298,298,82,73,9,4,3
26,345,345,55,55,0,1,0
21,364,364,95,74,21,4,3
22,380,380,2,2,0,1,0
1,394,394,29,2,27,4,3
8,418,418,23,19,4,2,1
3,422,422,89,41,48,3,2
16,422,422,7,7,0,1,0
27,433,433,1,1,0,1,0
13,436,436,8,8,0,1,0
11,447,447,7,7,0,1,0
17,460,460,44,44,0,1,0
24,473,473,15,15,0,1,0
15,486,486,12,12,0,1,0
20,499,499,162,118,44,3,2

17,109,109,23,23,0,1,0
19,113,113,39,6,33,4,3
8,133,133,2,2,0,1,0
3,155,155,27,13,14,3,2
23,161,161,5,5,0,1,0
1,167,167,13,13,0,1,0
20,168,168,16,9,7,2,1
29,171,171,7,1,6,2,1
27,176,176,3,3,0,1,0
11,192,192,52,25,27,4,3
4,211,211,2,2,0,1,0
9,216,216,24,16,8,3,2
18,221,221,3,3,0,1,0
16,234,234,31,1,30,4,3
0,255,255,16,16,0,1,0
24,272,272,1,1,0,1,0
6,296,296,5,5,0,1,0
10,333,333,19,10,9,3,2
5,344,344,128,128,0,1,0
2,352,352,28,28,0,1,0
25,376,376,50,30,20,3,2
22,382,382,91,91,0,1,0
15,390,390,12,12,0,1,0
14,439,439,21,12,9,4,3
28,439,439,14,14,0,1,0
12,450,450,8,2,6,2,1
26,456,456,12,12,0,1,0
13,461,461,16,16,0,1,0
21,469,469,52,14,38,3,2
7,497,497,12,12,0,1,0

23,144,144,13,10,3,2,1
5,151,151,2,2,0,1,0
21,162,162,29,29,0,1,0
31,186,186,1,1,0,1,0
10,214,214,3,3,0,1,0
25,216,216,13,8,5,2,1
7,218,218,1,1,0,1,0
27,236,236,20,7,13,2,1
18,269,269,16,4,12,2,1
0,270,270,5,5,0,1,0
11,302,302,28,18,10,2,1
28,309,309,41,41,0,1,0
12,321,321,26,11,15,4,3
29,324,324,13,13,0,1,0
24,335,335,34,13,21,4,3
6,337,337,10,10,0,1,0
22,347,347,16,4,12,2,1
13,363,363,3,3,0,1,0
32,380,380,84,65,19,2,1
26,390,390,71,1,70,3,2
3,391,391,30,30,0,1,0
17,392,392,18,18,0,1,0
8,394,394,1,1,0,1,0
33,406,406,2,2,0,1,0
1,430,430,20,10,10,3,2
16,436,436,100,75,25,2,1
30,441,441,119,119,0,1,0
4,447,447,126,104,22,3,2
9,457,457,86,20,66,3,2
20,461,461,8,1,7,2,1
15,462,462,30,30,0,1,0
2,463,463,35,35,0,1,0
14,471,471,16,10,6,3,2
34,478,478,2,2,0,1,0
19,487,487,8,3,5,2,1

8,103,103,5,5,0,1,0
2,111,111,1,1,0,1,0
3,114,114,13,13,0,1,0
12,117,117,9,2,7,2,1
10,139,139,11,11,0,1,0
5,142,142,2,2,0,1,0
1,145,145,47,47,0,1,0
4,148,148,10,1,9,2,1
22,159,159,1,1,0,1,0
14,176,176,7,7,0,1,0
16,188,188,32,25,7,2,1
7,194,194,1,1,0,1,0
27,194,194,27,5,22,2,1
17,196,196,29,29,0,1,0
21,205,205,8,2,6,3,2
18,212,212,3,3,0,1,0
26,223,223,11,11,0,1,0
13,248,248,37,13,24,4,3
28,257,257,26,26,0,1,0
15,326,326,74,48,26,2,1
19,358,358,22,22,0,1,0
6,379,379,69,69,0,1,0
20,392,392,88,88,0,1,0
9,405,405,29,13,16,2,1
11,434,434,91,67,24,4,3
24,442,442,22,19,3,2,1
23,452,452,53,50,3,2,1
25,463,463,37,27,10,2,1
0,489,489,6,6,0,1,0

21,101,101,4,4,0,1,0
3,110,110,8,1,7,2,1
25,114,114,53,18,35,2,1
1,177,177,5,5,0,1,0
8,179,179,1,1,0,1,0
13,182,182,3,3,0,1,0
12,196,196,36,8,28,2,1
28,215,215,3,3,0,1,0
18,215,215,5,5,0,1,0
7,217,217,6,2,4,2,1
15,220,220,23,23,0,1,0
23,227,227,90,50,40,3,2
17,244,244,6,1,5,2,1
4,247,247,39,5,34,2,1
9,259,259,21,8,13,2,1
16,270,270,14,2,12,2,1
14,277,277,92,92,0,1,0
0,277,277,1,1,0,1,0
27,301,301,8,8,0,1,0
2,313,313,1,1,0,1,0
6,314,314,13,13,0,1,0
20,360,360,31,31,0,1,0
19,371,371,24,24,0,1,0
5,373,373,17,8,9,4,3
11,379,379,107,107,0,1,0
26,386,386,10,2,8,3,2
24,448,448,48,6,42,3,2
22,473,473,4,1,3,2,1
10,487,487,58,15,43,2,1

16,111,111,12,12,0,1,0
3,118,118,15,15,0,1,0
14,121,121,7,7,0,1,0
11,131,131,5,5,0,1,0
5,137,137,2,2,0,1,0
12,144,144,39,39,0,1,0
6,165,165,17,9,8,2,1
7,175,175,3,3,0,1,0
15,188,188,10,10,0,1,0
19,189,189,1,1,0,1,0
21,191,191,5,5,0,1,0
4,227,227,63,63,0,1,0
1,236,236,65,34,31,2,1
10,251,251,43,4,39,4,3
2,264,264,44,44,0,1,0
8,282,282,118,64,54,4,3
13,298,298,7,7,0,1,0
20,414,414,36,36,0,1,0
17,432,432,18,6,12,2,1
22,439,439,34,7,27,2,1
0,474,474,1,1,0,1,0
18,475,475,126,7,119,4,3
9,483,483,98,72,26,2,1

28,103,103,4,1,3,2,1
19,106,106,6,6,0,1,0
12,110,110,9,9,0,1,0
10,147,147,24,24,0,1,0
24,163,163,63,42,21,4,3
22,163,163,13,13,0,1,0
15,168,168,10,10,0,1,0
3,194,194,16,16,0,1,0
23,195,195,9,6,3,2,1
13,211,211,5,5,0,1,0
1,225,225,1,1,0,1,0
21,227,227,19,2,17,2,1
4,231,231,6,6,0,1,0
14,331,331,20,20,0,1,0
8,349,349,7,7,0,1,0
20,353,353,54,54,0,1,0
9,357,357,4,4,0,1,0
16,365,365,60,60,0,1,0
17,384,384,70,28,42,3,2
5,391,391,33,24,9,2,1
7,411,411,128,55,73,4,3
11,414,414,82,82,0,1,0
2,423,423,117,75,42,4,3
0,428,428,21,21,0,1,0
18,431,431,7,7,0,1,0
26,441,441,5,2,3,2,1
27,466,466,28,10,18,3,2
25,471,471,45,7,38,3,2
6,493,493,4,4,0,1,0

19,127,127,35,35,0,1,0
22,132,132,3,3,0,1,0
14,133,133,3,3,0,1,0
16,161,161,3,3,0,1,0
17,171,171,4,4,0,1,0
20,175,175,1,1,0,1,0
24,191,191,11,11,0,1,0
12,197,197,11,8,3,2,1
9,239,239,42,20,22,2,1
21,239,239,6,6,0,1,0
30,246,246,16,16,0,1,0
31,249,249,31,31,0,1,0
15,257,257,43,19,24,2,1
29,273,273,44,35,9,4,3
4,297,297,2,2,0,1,0
5,298,298,24,24,0,1,0
28,307,307,21,3,18,3,2
13,323,323,21,9,12,2,1
3,328,328,12,8,4,2,1
23,352,352,4,4,0,1,0
7,368,368,55,19,36,4,3
1,369,369,63,39,24,2,1
6,375,375,37,37,0,1,0
2,379,379,15,15,0,1,0
25,389,389,8,4,4,2,1
8,391,391,13,13,0,1,0
27,395,395,87,25,62,3,2
26,404,404,71,26,45,4,3
10,457,457,8,8,0,1,0
11,464,464,89,89,0,1,0
18,472,472,90,90,0,1,0
0,488,488,25,22,3,2,1

18,121,121,5,5,0,1,0
25,146,146,16,2,14,3,2
12,151,151,4,4,0,1,0
17,155,155,2,2,0,1,0
6,163,163,58,58,0,1,0
1,168,168,13,1,12,4,3
11,179,179,5,5,0,1,0
2,186,186,18,18,0,1,0
15,213,213,9,9,0,1,0
9,227,227,14,8,6,2,1
3,234,234,1,1,0,1,0
0,238,238,31,7,24,4,3
21,242,242,14,14,0,1,0
14,253,253,30,3,27,4,3
5,285,285,81,81,0,1,0
22,342,342,173,73,100,4,3
24,354,354,64,28,36,4,3
16,364,364,9,9,0,1,0
19,377,377,35,14,21,4,3
13,387,387,8,2,6,2,1
10,442,442,20,20,0,1,0
23,461,461,76,62,14,3,2
8,473,473,12,1,11,2,1
4,475,475,112,112,0,1,0
7,479,479,29,22,7,2,1
20,500,500,11,5,6,2,1

7,102,102,12,3,9,4,3
10,108,108,21,9,12,2,1
13,148,148,2,2,0,1,0
9,162,162,1,1,0,1,0
0,188,188,8,8,0,1,0
22,189,189,80,30,50,4,3
2,190,190,2,2,0,1,0
14,194,194,11,11,0,1,0
6,207,207,87,87,0,1,0
24,208,208,24,24,0,1,0
11,224,224,33,3,30,3,2
20,225,225,12,2,10,3,2
8,241,241,23,23,0,1,0
15,245,245,33,9,24,3,2
3,248,248,36,10,26,2,1
4,297,297,5,5,0,1,0
19,298,298,31,31,0,1,0
1,321,321,16,16,0,1,0
25,335,335,21,21,0,1,0
26,365,365,10,10,0,1,0
17,407,407,78,38,40,2,1
16,421,421,30,25,5,2,1
18,428,428,9,6,3,2,1
21,435,435,10,10,0,1,0
5,455,455,1,1,0,1,0
12,477,477,73,73,0,1,0
23,477,477,61,61,0,1,0

26,107,107,32,14,18,2,1
18,113,113,7,7,0,1,0
22,117,117,10,4,6,3,2
17,127,127,3,3,0,1,0
4,133,133,2,2,0,1,0
11,135,135,17,2,15,2,1
2,204,204,5,5,0,1,0
20,208,208,14,14,0,1,0
0,217,217,9,3,6,2,1
6,226,226,17,8,9,4,3
5,252,252,24,24,0,1,0
19,257,257,9,9,0,1,0
1,260,260,18,6,12,4,3
25,281,281,20,20,0,1,0
14,281,281,10,10,0,1,0
15,349,349,32,32,0,1,0
24,350,350,1,1,0,1,0
8,358,358,23,23,0,1,0
7,360,360,60,21,39,2,1
3,370,370,3,3,0,1,0
23,381,381,143,2,141,4,3
10,415,415,62,37,25,2,1
13,420,420,15,15,0,1,0
16,437,437,101,101,0,1,0
9,469,469,235,202,33,4,3
12,471,471,31,5,26,3,2
21,494,494,10,4,6,3,2

30,106,106,42,42,0,1,0
18,127,127,16,16,0,1,0
21,135,135,8,8,0,1,0
4,148,148,1,1,0,1,0
13,167,167,1,1,0,1,0
9,200,200,15,5,10,2,1
11,206,206,9,9,0,1,0
29,214,214,54,27,27,4,3
2,226,226,6,6,0,1,0
17,229,229,19,2,17,2,1
1,242,242,55,55,0,1,0
5,249,249,1,1,0,1,0
19,253,253,2,2,0,1,0
10,266,266,29,20,9,2,1
14,271,271,3,3,0,1,0
26,286,286,2,2,0,1,0
27,306,306,5,2,3,2,1
8,322,322,5,5,0,1,0
7,381,381,4,4,0,1,0
25,399,399,89,44,45,4,3
23,421,421,42,9,33,4,3
22,428,428,13,13,0,1,0
16,439,439,24,4,20,2,1
12,440,440,41,41,0,1,0
20,441,441,45,45,0,1,0
3,460,460,61,40,21,2,1
24,461,461,9,3,6,3,2
15,464,464,79,79,0,1,0
28,469,469,3,3,0,1,0
0,488,488,6,6,0,1,0
6,489,489,197,147,50,4,3

29,122,122,5,5,0,1,0
0,126,126,52,16,36,4,3
20,126,126,10,6,4,2,1
13,154,154,4,1,3,2,1
23,179,179,18,11,7,2,1
17,181,181,16,16,0,1,0
12,184,184,1,1,0,1,0
24,186,186,8,4,4,2,1
6,192,192,10,10,0,1,0
5,206,206,29,29,0,1,0
14,262,262,5,5,0,1,0
1,264,264,20,20,0,1,0
19,265,265,10,10,0,1,0
28,275,275,33,21,12,2,1
26,280,280,41,41,0,1,0
11,300,300,9,9,0,1,0
25,316,316,64,43,21,4,3
18,333,333,17,10,7,2,1
16,340,340,91,9,82,3,2
15,351,351,2,2,0,1,0
2,359,359,39,17,22,3,2
10,391,391,44,30,14,3,2
27,401,401,33,13,20,3,2
8,405,405,114,114,0,1,0
7,417,417,39,39,0,1,0
3,429,429,4,4,0,1,0
4,432,432,11,8,3,2,1
22,456,456,45,45,0,1,0
9,475,475,2,2,0,1,0
21,500,500,34,12,22,3,2

17,101,101,24,24,0,1,0
15,128,128,2,2,0,1,0
18,130,130,42,42,0,1,0
4,141,141,19,19,0,1,0
5,148,148,41,36,5,2,1
26,148,148,1,1,0,1,0
29,174,174,19,19,0,1,0
22,232,232,21,4,17,3,2
8,247,247,8,8,0,1,0
20,251,251,11,5,6,2,1
12,264,264,75,75,0,1,0
0,271,271,45,45,0,1,0
9,287,287,1,1,0,1,0
25,292,292,14,14,0,1,0
2,299,299,25,6,19,2,1
27,303,303,79,29,50,2,1
7,309,309,28,10,18,3,2
13,315,315,10,1,9,4,3
14,328,328,7,7,0,1,0
6,333,333,10,2,8,2,1
19,338,338,14,2,12,4,3
10,342,342,5,5,0,1,0
16,345,345,1,1,0,1,0
24,346,346,30,23,7,2,1
11,436,436,88,81,7,2,1
28,452,452,25,5,20,4,3
3,455,455,4,1,3,2,1
23,460,460,20,20,0,1,0
1,480,480,3,3,0,1,0
21,481,481,32,32,0,1,0

23,121,121,2,2,0,1,0
15,167,167,19,3,16,2,1
5,174,174,26,2,24,4,3
27,195,195,27,27,0,1,0
2,221,221,8,8,0,1,0
13,232,232,29,9,20,2,1
7,247,247,12,3,9,4,3
26,250,250,7,3,4,2,1
3,269,269,6,6,0,1,0
28,273,273,75,32,43,2,1
25,274,274,15,15,0,1,0
22,274,274,16,6,10,2,1
14,297,297,64,39,25,2,1
1,305,305,65,65,0,1,0
6,310,310,48,48,0,1,0
20,322,322,35,35,0,1,0
17,327,327,6,6,0,1,0
18,342,342,14,14,0,1,0
16,353,353,81,38,43,3,2
21,377,377,6,6,0,1,0
12,384,384,3,3,0,1,0
19,390,390,7,7,0,1,0
10,396,396,12,2,10,2,1
0,397,397,49,46,3,2,1
9,406,406,13,13,0,1,0
4,424,424,2,2,0,1,0
8,435,435,58,58,0,1,0
24,479,479,150,20,130,4,3
11,480,480,51,14,37,4,3

16,144,144,9,9,0,1,0
17,148,148,6,6,0,1,0
0,153,153,1,1,0,1,0
8,178,178,48,1,47,3,2
11,192,192,21,21,0,1,0
7,198,198,1,1,0,1,0
15,218,218,19,9,10,3,2
19,231,231,4,1,3,2,1
20,237,237,40,29,11,2,1
22,239,239,32,4,28,2,1
12,267,267,32,32,0,1,0
13,290,290,27,18,9,2,1
26,294,294,29,29,0,1,0
14,307,307,31,31,0,1,0
25,322,322,50,50,0,1,0
24,333,333,129,48,81,4,3
5,335,335,28,28,0,1,0
10,350,350,31,31,0,1,0
9,363,363,77,20,57,4,3
18,373,373,4,4,0,1,0
1,411,411,28,28,0,1,0
2,422,422,43,39,4,2,1
21,450,450,20,20,0,1,0
23,451,451,10,10,0,1,0
3,460,460,27,27,0,1,0
6,462,462,106,6,100,4,3
4,480,480,23,5,18,2,1

3,146,146,1,1,0,1,0
21,183,183,44,44,0,1,0
20,187,187,2,2,0,1,0
2,218,218,50,22,28,3,2
22,219,219,3,3,0,1,0
4,231,231,4,1,3,2,1
10,261,261,68,8,60,4,3
11,276,276,2,2,0,1,0
8,280,280,16,10,6,3,2
15,283,283,103,91,12,2,1
1,308,308,11,11,0,1,0
0,310,310,48,13,35,4,3
19,312,312,20,5,15,2,1
5,323,323,73,73,0,1,0
16,349,349,21,9,12,4,3
14,351,351,51,51,0,1,0
17,364,364,12,12,0,1,0
23,387,387,1,1,0,1,0
7,420,420,119,53,66,4,3
12,444,444,14,11,3,2,1
13,453,453,39,39,0,1,0
18,454,454,47,13,34,3,2
9,483,483,28,28,0,1,0
6,487,487,162,126,36,2,1

1,112,112,6,3,3,2,1
29,114,114,23,5,18,4,3
28,117,117,12,12,0,1,0
16,119,119,1,1,0,1,0
5,155,155,2,2,0,1,0
22,161,161,2,2,0,1,0
21,169,169,34,19,15,4,3
27,195,195,14,14,0,1,0
24,200,200,20,5,15,2,1
15,207,207,8,8,0,1,0
18,243,243,7,7,0,1,0
13,245,245,11,11,0,1,0
19,248,248,20,20,0,1,0
2,275,275,6,6,0,1,0
26,288,288,19,6,13,2,1
33,290,290,10,1,9,2,1
34,299,299,17,17,0,1,0
30,306,306,3,3,0,1,0
8,309,309,39,39,0,1,0
3,318,318,20,20,0,1,0
23,333,333,29,10,19,2,1
4,337,337,23,23,0,1,0
10,345,345,24,3,21,4,3
7,346,346,10,10,0,1,0
20,364,364,28,8,20,2,1
14,393,393,37,37,0,1,0
32,400,400,54,54,0,1,0
17,411,411,73,13,60,3,2
0,456,456,19,19,0,1,0
31,465,465,106,106,0,1,0
9,468,468,14,2,12,3,2
6,468,468,38,20,18,3,2
25,480,480,59,59,0,1,0
12,487,487,56,56,0,1,0
11,498,498,70,52,18,3,2

25,101,101,1,1,0,1,0
4,102,102,13,13,0,1,0
23,111,111,10,2,8,3,2
12,134,134,17,12,5,2,1
7,146,146,32,5,27,2,1
10,167,167,16,16,0,1,0
0,180,180,22,4,18,2,1
20,203,203,16,4,12,3,2
2,218,218,2,2,0,1,0
29,225,225,3,3,0,1,0
28,226,226,9,1,8,3,2
26,256,256,32,16,16,4,3
17,261,261,13,13,0,1,0
14,280,280,5,5,0,1,0
1,281,281,1,1,0,1,0
9,290,290,72,72,0,1,0
3,337,337,5,1,4,2,1
16,377,377,143,63,80,3,2
5,392,392,6,6,0,1,0
19,402,402,15,5,10,4,3
6,403,403,25,25,0,1,0
11,413,413,43,33,10,3,2
27,424,424,147,98,49,3,2
21,441,441,57,9,48,2,1
18,460,460,44,44,0,1,0
13,466,466,26,20,6,3,2
8,468,468,75,48,27,2,1
22,481,481,5,5,0,1,0
15,482,482,9,1,8,2,1
24,500,500,14,9,5,2,1

4,105,105,22,15,7,2,1
24,115,115,17,7,10,3,2
1,119,119,17,13,4,2,1
25,126,126,2,2,0,1,0
0,131,131,17,17,0,1,0
6,140,140,1,1,0,1,0
28,141,141,46,46,0,1,0
18,155,155,2,2,0,1,0
2,165,165,7,7,0,1,0
8,184,184,2,2,0,1,0
14,226,226,44,27,17,2,1
3,232,232,35,22,13,2,1
17,237,237,23,7,16,3,2
19,250,250,10,10,0,1,0
29,282,282,47,47,0,1,0
22,289,289,1,1,0,1,0
20,293,293,30,15,15,4,3
23,315,315,56,41,15,4,3
16,393,393,19,19,0,1,0
5,393,393,9,2,7,2,1
21,396,396,57,57,0,1,0
7,400,400,68,29,39,2,1
11,405,405,21,21,0,1,0
26,421,421,45,4,41,4,3
10,452,452,19,19,0,1,0
13,455,455,45,45,0,1,0
27,468,468,21,21,0,1,0
9,481,481,19,19,0,1,0
15,484,484,9,9,0,1,0
12,494,494,34,34,0,1,0

25,104,104,5,5,0,1,0
10,105,105,1,1,0,1,0
15,109,109,2,2,0,1,0
22,121,121,12,12,0,1,0
18,128,128,7,2,5,2,1
17,130,130,5,5,0,1,0
28,138,138,29,29,0,1,0
31,150,150,12,6,6,2,1
4,158,158,26,26,0,1,0
1,181,181,6,6,0,1,0
16,191,191,3,3,0,1,0
13,199,199,14,14,0,1,0
27,205,205,17,17,0,1,0
21,217,217,24,2,22,2,1
20,220,220,40,16,24,3,2
29,231,231,25,25,0,1,0
0,262,262,36,2,34,4,3
24,286,286,46,46,0,1,0
26,315,315,45,45,0,1,0
14,335,335,4,1,3,2,1
3,340,340,15,15,0,1,0
9,356,356,3,3,0,1,0
5,389,389,126,114,12,2,1
30,391,391,46,46,0,1,0
6,396,396,64,33,31,3,2
2,397,397,19,9,10,2,1
7,415,415,26,4,22,2,1
11,434,434,59,59,0,1,0
23,453,453,11,5,6,2,1
12,471,471,37,37,0,1,0
8,472,472,19,14,5,2,1
19,473,473,12,2,10,2,1

38,139,139,2,2,0,1,0
17,148,148,2,2,0,1,0
37,150,150,16,1,15,2,1
39,154,154,19,19,0,1,0
26,182,182,4,4,0,1,0
3,191,191,14,14,0,1,0
8,195,195,1,1,0,1,0
35,196,196,19,19,0,1,0
4,197,197,1,1,0,1,0
24,203,203,5,5,0,1,0
33,210,210,5,1,4,2,1
28,220,220,33,33,0,1,0
5,229,229,16,16,0,1,0
29,241,241,56,44,12,2,1
31,246,246,42,6,36,2,1
13,250,250,8,8,0,1,0
1,255,255,61,16,45,4,3
22,258,258,12,12,0,1,0
40,275,275,34,13,21,2,1
2,275,275,1,1,0,1,0
41,282,282,41,3,38,2,1
7,287,287,3,3,0,1,0
30,294,294,14,14,0,1,0
14,301,301,2,2,0,1,0
0,310,310,18,18,0,1,0
16,312,312,19,8,11,2,1
6,315,315,2,2,0,1,0
25,326,326,13,3,10,3,2
21,328,328,42,27,15,2,1
12,328,328,14,14,0,1,0
15,332,332,9,9,0,1,0
34,348,348,14,1,13,2,1
23,349,349,25,13,12,3,2
11,350,350,1,1,0,1,0
27,350,350,36,3,33,4,3
36,377,377,9,9,0,1,0
10,395,395,19,19,0,1,0
32,399,399,53,5,48,3,2
20,404,404,26,14,12,2,1
9,444,444,48,48,0,1,0
19,449,449,14,1,13,2,1
18,486,486,28,28,0,1,0

1,111,111,5,5,0,1,0
13,112,112,8,8,0,1,0
15,128,128,15,7,8,3,2
5,141,141,18,18,0,1,0
10,143,143,12,7,5,2,1
19,150,150,8,8,0,1,0
20,157,157,5,5,0,1,0
18,181,181,33,33,0,1,0
2,201,201,40,2,38,3,2
21,244,244,24,8,16,2,1
14,323,323,9,3,6,2,1
4,331,331,1,1,0,1,0
17,339,339,13,4,9,4,3
9,342,342,50,50,0,1,0
23,346,346,17,17,0,1,0
6,346,346,74,59,15,4,3
12,379,379,119,97,22,2,1
22,380,380,58,36,22,2,1
16,392,392,64,64,0,1,0
8,403,403,212,212,0,1,0
7,425,425,10,10,0,1,0
3,438,438,43,22,21,4,3
0,451,451,9,9,0,1,0
11,464,464,20,2,18,3,2

23,139,139,11,11,0,1,0
24,171,171,9,1,8,2,1
20,174,174,5,5,0,1,0
8,174,174,40,13,27,2,1
18,181,181,1,1,0,1,0
0,187,187,10,4,6,2,1
10,207,207,15,15,0,1,0
33,212,212,23,1,22,2,1
19,218,218,5,5,0,1,0
30,220,220,28,4,24,2,1
11,229,229,52,10,42,3,2
9,241,241,11,3,8,3,2
12,282,282,1,1,0,1,0
7,283,283,6,1,5,2,1
27,283,283,4,4,0,1,0
15,285,285,14,14,0,1,0
22,288,288,20,2,18,2,1
17,310,310,40,40,0,1,0
29,323,323,22,22,0,1,0
5,335,335,19,19,0,1,0
16,336,336,12,12,0,1,0
2,345,345,35,35,0,1,0
35,346,346,44,44,0,1,0
3,359,359,10,1,9,2,1
4,386,386,13,7,6,2,1
6,386,386,65,65,0,1,0
14,403,403,4,4,0,1,0
21,404,404,5,5,0,1,0
1,414,414,4,4,0,1,0
28,424,424,154,13,141,4,3
31,437,437,25,25,0,1,0
32,463,463,5,2,3,2,1
25,465,465,143,123,20,3,2
26,472,472,13,13,0,1,0
13,473,473,27,27,0,1,0
34,475,475,5,2,3,2,1

5,100,100,1,1,0,1,0
0,109,109,1,1,0,1,0
6,117,117,14,14,0,1,0
16,161,161,10,10,0,1,0
28,174,174,17,17,0,1,0
8,176,176,8,8,0,1,0
3,183,183,20,10,10,3,2
27,188,188,5,5,0,1,0
23,207,207,33,7,26,3,2
1,217,217,30,30,0,1,0
15,222,222,19,19,0,1,0
7,233,233,7,7,0,1,0
29,264,264,12,12,0,1,0
10,269,269,9,1,8,3,2
11,307,307,24,24,0,1,0
22,329,329,8,8,0,1,0
12,339,339,34,34,0,1,0
25,369,369,19,19,0,1,0
18,377,377,7,1,6,3,2
17,381,381,14,4,10,2,1
24,386,386,8,8,0,1,0
19,387,387,68,68,0,1,0
9,392,392,10,10,0,1,0
13,401,401,57,2,55,4,3
21,433,433,37,11,26,3,2
4,444,444,105,105,0,1,0
26,463,463,62,2,60,4,3
14,465,465,5,5,0,1,0
2,475,475,108,72,36,3,2
20,486,486,236,161,75,4,3

22,103,103,18,18,0,1,0
20,147,147,7,7,0,1,0
9,163,163,15,5,10,3,2
2,216,216,46,14,32,2,1
19,221,221,14,14,0,1,0
4,224,224,4,1,3,2,1
15,231,231,21,3,18,4,3
23,295,295,7,1,6,3,2
0,297,297,60,60,0,1,0
6,305,305,6,6,0,1,0
8,317,317,101,8,93,4,3
21,318,318,9,9,0,1,0
1,335,335,3,3,0,1,0
5,345,345,140,106,34,2,1
18,361,361,7,2,5,2,1
7,368,368,30,30,0,1,0
12,368,368,145,145,0,1,0
10,388,388,47,1,46,2,1
11,413,413,51,51,0,1,0
17,452,452,30,16,14,3,2
16,455,455,71,21,50,3,2
14,462,462,28,20,8,2,1
13,488,488,24,13,11,2,1
3,491,491,20,2,18,4,3

15,125,125,21,21,0,1,0
12,129,129,11,11,0,1,0
24,133,133,17,17,0,1,0
11,148,148,45,31,14,3,2
23,164,164,9,9,0,1,0
16,187,187,24,19,5,2,1
1,202,202,20,11,9,2,1
4,202,202,44,44,0,1,0
6,204,204,29,29,0,1,0
20,213,213,1,1,0,1,0
9,239,239,3,3,0,1,0
22,252,252,80,61,19,2,1
5,278,278,30,4,26,2,1
17,295,295,4,4,0,1,0
14,312,312,12,12,0,1,0
8,332,332,1,1,0,1,0
2,353,353,29,2,27,4,3
21,360,360,24,2,22,3,2
3,399,399,41,41,0,1,0
0,411,411,68,68,0,1,0
25,431,431,92,76,16,3,2
13,434,434,8,2,6,3,2
7,455,455,49,18,31,2,1
18,470,470,19,10,9,2,1
19,480,480,75,38,37,2,1
10,480,480,28,28,0,1,0

21,180,180,28,28,0,1,0
7,206,206,40,30,10,3,2
2,215,215,58,10,48,2,1
8,215,215,7,7,0,1,0
25,217,217,10,10,0,1,0
14,230,230,12,12,0,1,0
4,232,232,17,17,0,1,0
22,238,238,17,17,0,1,0
0,255,255,11,11,0,1,0
17,273,273,11,11,0,1,0
3,279,279,24,3,21,4,3
13,280,280,60,14,46,3,2
1,287,287,13,13,0,1,0
12,288,288,18,18,0,1,0
15,293,293,18,18,0,1,0
9,318,318,87,87,0,1,0
24,322,322,33,33,0,1,0
23,342,342,10,10,0,1,0
20,348,348,158,158,0,1,0
11,367,367,20,4,16,4,3
16,381,381,21,13,8,3,2
6,396,396,84,27,57,4,3
19,434,434,14,14,0,1,0
5,458,458,45,27,18,2,1
10,459,459,8,8,0,1,0
18,489,489,21,14,7,2,1

25,107,107,21,9,12,3,2
3,118,118,7,4,3,2,1
0,122,122,30,30,0,1,0
12,129,129,15,15,0,1,0
27,139,139,2,2,0,1,0
1,166,166,4,4,0,1,0
16,178,178,30,30,0,1,0
2,182,182,27,27,0,1,0
17,227,227,33,33,0,1,0
4,241,241,34,8,26,2,1
18,244,244,115,115,0,1,0
26,250,250,7,4,3,2,1
6,270,270,7,7,0,1,0
19,278,278,11,11,0,1,0
14,298,298,20,20,0,1,0
24,328,328,29,24,5,2,1
20,371,371,14,6,8,3,2
5,373,373,101,29,72,4,3
7,384,384,1,1,0,1,0
10,390,390,7,1,6,3,2
9,401,401,66,66,0,1,0
11,406,406,22,11,11,3,2
21,406,406,6,3,3,2,1
23,423,423,37,37,0,1,0
8,428,428,19,13,6,3,2
13,442,442,38,38,0,1,0
22,459,459,17,8,9,2,1
15,483,483,20,20,0,1,0

9,118,118,28,10,18,2,1
5,122,122,15,15,0,1,0
20,126,126,15,15,0,1,0
2,140,140,22,22,0,1,0
12,155,155,1,1,0,1,0
7,216,216,16,16,0,1,0
22,224,224,49,49,0,1,0
18,231,231,31,9,22,2,1
17,256,256,71,71,0,1,0
15,262,262,19,19,0,1,0
13,265,265,7,7,0,1,0
11,266,266,8,8,0,1,0
16,267,267,58,7,51,4,3
24,277,277,41,41,0,1,0
14,283,283,15,15,0,1,0
10,285,285,3,3,0,1,0
25,303,303,13,13,0,1,0
23,307,307,32,21,11,2,1
8,308,308,63,63,0,1,0
19,328,328,3,3,0,1,0
3,344,344,52,52,0,1,0
0,349,349,54,35,19,2,1
1,363,363,20,20,0,1,0
21,369,369,3,3,0,1,0
4,452,452,61,61,0,1,0
6,486,486,34,8,26,3,2

6,108,108,1,1,0,1,0
0,110,110,2,2,0,1,0
27,116,116,16,16,0,1,0
25,121,121,7,7,0,1,0
11,136,136,10,10,0,1,0
18,156,156,15,15,0,1,0
14,173,173,30,13,17,2,1
12,184,184,25,25,0,1,0
5,191,191,32,32,0,1,0
23,192,192,11,11,0,1,0
21,194,194,36,4,32,3,2
8,210,210,6,6,0,1,0
24,219,219,18,1,17,2,1
19,242,242,58,26,32,3,2
16,268,268,31,31,0,1,0
22,271,271,14,14,0,1,0
10,276,276,13,3,10,2,1
26,283,283,15,9,6,2,1
3,301,301,27,27,0,1,0
4,304,304,1,1,0,1,0
13,310,310,20,20,0,1,0
28,322,322,32,13,19,2,1
15,326,326,4,1,3,2,1
29,348,348,30,21,9,4,3
17,377,377,16,16,0,1,0
20,406,406,51,21,30,4,3
7,445,445,1,1,0,1,0
9,459,459,54,19,35,3,2
2,472,472,123,99,24,4,3
1,481,481,95,65,30,3,2

9,104,104,10,10,0,1,0
4,122,122,16,9,7,2,1
8,133,133,1,1,0,1,0
14,155,155,12,12,0,1,0
1,172,172,1,1,0,1,0
21,177,177,24,24,0,1,0
15,192,192,11,11,0,1,0
19,198,198,5,5,0,1,0
28,211,211,25,25,0,1,0
11,220,220,38,2,36,3,2
23,228,228,5,1,4,2,1
18,245,245,1,1,0,1,0
20,264,264,70,49,21,4,3
13,275,275,64,16,48,2,1
2,283,283,36,36,0,1,0
5,285,285,19,1,18,4,3
24,300,300,5,2,3,2,1
10,381,381,41,41,0,1,0
25,384,384,10,10,0,1,0
0,387,387,28,28,0,1,0
6,390,390,29,22,7,3,2
3,402,402,64,46,18,3,2
16,442,442,10,10,0,1,0
12,450,450,8,8,0,1,0
7,451,451,25,3,22,2,1
27,458,458,105,105,0,1,0
17,471,471,131,101,30,2,1
26,474,474,46,18,28,3,2
22,494,494,63,54,9,2,1

8,145,145,1,1,0,1,0
6,152,152,2,2,0,1,0
4,192,192,15,15,0,1,0
2,216,216,1,1,0,1,0
17,249,249,4,4,0,1,0
26,256,256,13,13,0,1,0
0,273,273,90,55,35,3,2
13,281,281,72,54,18,4,3
19,283,283,56,56,0,1,0
18,283,283,11,8,3,2,1
10,285,285,84,32,52,3,2
9,288,288,11,7,4,2,1
20,297,297,12,12,0,1,0
12,310,310,51,43,8,3,2
25,346,346,42,14,28,3,2
16,354,354,42,42,0,1,0
7,367,367,67,9,58,3,2
1,412,412,66,66,0,1,0
14,426,426,20,20,0,1,0
11,446,446,4,4,0,1,0
22,456,456,16,16,0,1,0
5,465,465,24,9,15,2,1
15,471,471,9,9,0,1,0
24,471,471,11,11,0,1,0
23,481,481,172,37,135,4,3
21,487,487,47,47,0,1,0
3,493,493,33,33,0,1,0

11,112,112,19,19,0,1,0
1,118,118,1,1,0,1,0
8,136,136,10,10,0,1,0
10,159,159,42,6,36,3,2
24,163,163,19,19,0,1,0
26,197,197,3,3,0,1,0
14,203,203,9,1,8,3,2
15,243,243,40,40,0,1,0
5,251,251,20,10,10,2,1
9,263,263,9,9,0,1,0
3,267,267,14,14,0,1,0
2,304,304,43,29,14,3,2
17,313,313,53,47,6,2,1
0,314,314,39,39,0,1,0
7,319,319,12,12,0,1,0
20,322,322,4,1,3,2,1
22,334,334,37,37,0,1,0
16,336,336,26,19,7,2,1
12,344,344,60,30,30,3,2
18,356,356,1,1,0,1,0
13,374,374,39,11,28,3,2
6,389,389,43,9,34,3,2
25,417,417,158,155,3,2,1
27,432,432,65,65,0,1,0
21,441,441,13,10,3,2,1
23,452,452,36,24,12,3,2
19,479,479,33,2,31,2,1
4,487,487,13,9,4,2,1

25,100,100,1,1,0,1,0
4,125,125,6,6,0,1,0
21,127,127,3,3,0,1,0
11,130,130,3,3,0,1,0
2,143,143,1,1,0,1,0
34,149,149,7,2,5,2,1
28,156,156,4,4,0,1,0
14,159,159,5,2,3,2,1
30,169,169,7,3,4,2,1
27,171,171,1,1,0,1,0
37,172,172,48,48,0,1,0
20,187,187,2,2,0,1,0
10,218,218,10,4,6,3,2
5,234,234,1,1,0,1,0
26,243,243,11,3,8,3,2
16,270,270,21,21,0,1,0
1,292,292,1,1,0,1,0
17,318,318,16,16,0,1,0
31,336,336,8,8,0,1,0
33,336,336,13,10,3,2,1
15,354,354,8,8,0,1,0
6,354,354,12,9,3,2,1
19,383,383,4,4,0,1,0
22,401,401,27,27,0,1,0
32,410,410,5,5,0,1,0
36,418,418,10,4,6,3,2
3,424,424,17,2,15,4,3
7,431,431,60,60,0,1,0
35,437,437,199,199,0,1,0
0,441,441,20,2,18,3,2
23,453,453,51,28,23,3,2
12,455,455,1,1,0,1,0
8,458,458,25,9,16,4,3
29,460,460,25,21,4,2,1
9,466,466,85,75,10,3,2
18,471,471,133,103,30,4,3
24,491,491,174,90,84,4,3
13,498,498,41,41,0,1,0

15,107,107,27,7,20,2,1
9,133,133,2,2,0,1,0
19,148,148,32,32,0,1,0
20,165,165,9,1,8,2,1
17,170,170,7,7,0,1,0
22,171,171,11,7,4,2,1
4,187,187,10,10,0,1,0
10,215,215,13,13,0,1,0
11,229,229,2,2,0,1,0
0,233,233,37,34,3,2,1
21,241,241,29,16,13,2,1
6,246,246,48,6,42,3,2
5,253,253,117,108,9,2,1
16,263,263,43,43,0,1,0
7,277,277,9,2,7,2,1
12,349,349,49,1,48,2,1
18,401,401,23,23,0,1,0
24,416,416,42,42,0,1,0
2,434,434,67,21,46,3,2
1,437,437,44,9,35,3,2
14,447,447,79,79,0,1,0
23,469,469,6,1,5,2,1
8,477,477,18,18,0,1,0
3,477,477,62,36,26,3,2
13,479,479,9,9,0,1,0

7,107,107,5,5,0,1,0
1,108,108,9,9,0,1,0
16,120,120,6,6,0,1,0
8,123,123,2,2,0,1,0
14,138,138,16,9,7,2,1
18,147,147,37,37,0,1,0
29,150,150,4,4,0,1,0
19,162,162,3,3,0,1,0
2,192,192,5,5,0,1,0
28,210,210,34,8,26,4,3
3,215,215,5,1,4,2,1
23,218,218,7,4,3,2,1
17,227,227,52,52,0,1,0
31,234,234,2,2,0,1,0
11,246,246,4,1,3,2,1
15,273,273,11,11,0,1,0
26,274,274,56,45,11,3,2
10,309,309,10,10,0,1,0
9,314,314,64,64,0,1,0
12,326,326,17,17,0,1,0
13,329,329,32,10,22,3,2
30,336,336,32,32,0,1,0
32,343,343,123,101,22,2,1
21,352,352,25,25,0,1,0
5,359,359,13,4,9,4,3
20,372,372,36,36,0,1,0
24,415,415,27,27,0,1,0
27,430,430,17,17,0,1,0
6,440,440,29,29,0,1,0
25,460,460,113,29,84,4,3
22,478,478,3,3,0,1,0
0,488,488,1,1,0,1,0
4,498,498,8,8,0,1,0

27,107,107,9,3,6,2,1
13,107,107,2,2,0,1,0
7,112,112,15,3,12,3,2
0,118,118,27,27,0,1,0
25,130,130,26,26,0,1,0
1,134,134,8,8,0,1,0
20,141,141,12,12,0,1,0
3,193,193,11,11,0,1,0
28,212,212,18,18,0,1,0
5,223,223,11,11,0,1,0
23,231,231,2,2,0,1,0
19,270,270,16,16,0,1,0
6,337,337,14,14,0,1,0
10,337,337,10,2,8,2,1
9,345,345,14,3,11,2,1
17,349,349,2,2,0,1,0
4,362,362,35,10,25,2,1
12,381,381,59,59,0,1,0
11,402,402,1,1,0,1,0
15,403,403,86,23,63,4,3
14,404,404,74,8,66,3,2
21,413,413,8,8,0,1,0
26,432,432,57,57,0,1,0
16,437,437,78,6,72,4,3
2,439,439,128,92,36,4,3
22,453,453,18,18,0,1,0
24,469,469,49,49,0,1,0
8,485,485,7,7,0,1,0
18,494,494,107,20,87,4,3

22,106,106,2,2,0,1,0
0,122,122,23,23,0,1,0
21,126,126,15,15,0,1,0
20,133,133,11,8,3,2,1
16,149,149,12,12,0,1,0
23,164,164,14,6,8,2,1
8,165,165,5,5,0,1,0
27,176,176,21,9,12,2,1
25,184,184,23,23,0,1,0
24,230,230,2,2,0,1,0
9,251,251,9,9,0,1,0
18,264,264,45,45,0,1,0
14,272,272,2,2,0,1,0
2,323,323,55,43,12,2,1
17,332,332,26,26,0,1,0
19,338,338,12,6,6,2,1
11,340,340,11,11,0,1,0
12,346,346,42,18,24,4,3
15,370,370,24,24,0,1,0
6,371,371,167,142,25,2,1
1,391,391,53,1,52,3,2
13,432,432,31,31,0,1,0
26,443,443,200,163,37,2,1
3,451,451,18,18,0,1,0
10,454,454,33,33,0,1,0
5,488,488,8,1,7,2,1
4,489,489,6,3,3,2,1
7,493,493,12,12,0,1,0

7,134,134,7,7,0,1,0
14,137,137,10,10,0,1,0
8,157,157,6,1,5,2,1
15,165,165,20,2,18,4,3
0,169,169,25,6,19,2,1
11,197,197,1,1,0,1,0
19,212,212,23,23,0,1,0
4,216,216,51,29,22,3,2
18,223,223,23,5,18,2,1
24,226,226,92,48,44,3,2
17,257,257,73,25,48,2,1
5,266,266,9,9,0,1,0
6,272,272,9,9,0,1,0
9,319,319,62,62,0,1,0
23,323,323,27,1,26,2,1
13,337,337,34,34,0,1,0
22,355,355,1,1,0,1,0
21,356,356,7,7,0,1,0
16,371,371,18,18,0,1,0
1,390,390,51,51,0,1,0
12,401,401,25,19,6,3,2
3,408,408,82,26,56,3,2
2,440,440,138,43,95,4,3
10,449,449,9,9,0,1,0
20,470,470,3,3,0,1,0

22,115,115,7,2,5,2,1
7,123,123,53,2,51,4,3
18,123,123,31,10,21,4,3
21,126,126,7,7,0,1,0
12,161,161,4,4,0,1,0
1,175,175,39,1,38,3,2
15,194,194,5,5,0,1,0
16,214,214,24,24,0,1,0
11,222,222,25,14,11,2,1
10,234,234,39,39,0,1,0
6,260,260,7,7,0,1,0
19,265,265,54,54,0,1,0
3,267,267,10,3,7,2,1
17,305,305,16,6,10,3,2
14,326,326,14,14,0,1,0
0,367,367,109,105,4,2,1
20,382,382,61,1,60,4,3
5,384,384,107,107,0,1,0
13,397,397,53,6,47,2,1
8,398,398,11,11,0,1,0
4,420,420,31,19,12,2,1
9,454,454,13,13,0,1,0
2,472,472,3,3,0,1,0

9,111,111,1,1,0,1,0
8,118,118,4,4,0,1,0
17,132,132,1,1,0,1,0
15,135,135,11,6,5,2,1
5,153,153,4,1,3,2,1
6,199,199,8,2,6,3,2
22,203,203,1,1,0,1,0
16,226,226,1,1,0,1,0
29,235,235,19,19,0,1,0
7,243,243,34,12,22,2,1
12,243,243,3,3,0,1,0
0,254,254,9,9,0,1,0
25,261,261,30,30,0,1,0
26,281,281,66,66,0,1,0
18,290,290,34,29,5,2,1
11,309,309,18,9,9,2,1
3,312,312,23,23,0,1,0
19,347,347,1,1,0,1,0
31,350,350,24,24,0,1,0
21,352,352,38,38,0,1,0
30,355,355,27,8,19,2,1
13,356,356,61,61,0,1,0
28,360,360,83,37,46,2,1
24,375,375,38,18,20,2,1
27,380,380,9,9,0,1,0
23,388,388,12,7,5,2,1
2,413,413,10,10,0,1,0
14,415,415,65,65,0,1,0
1,420,420,49,49,0,1,0
33,450,450,17,17,0,1,0
4,464,464,23,7,16,2,1
32,481,481,87,37,50,2,1
10,489,489,80,80,0,1,0
34,498,498,60,23,37,3,2
20,499,499,38,6,32,3,2

14,117,117,2,2,0,1,0
2,126,126,19,19,0,1,0
19,155,155,23,23,0,1,0
7,167,167,4,4,0,1,0
22,177,177,50,50,0,1,0
12,194,194,80,80,0,1,0
3,218,218,45,3,42,3,2
1,238,238,23,11,12,2,1
4,262,262,173,60,113,4,3
10,270,270,17,17,0,1,0
16,276,276,6,3,3,2,1
6,312,312,13,1,12,4,3
17,336,336,63,35,28,2,1
8,337,337,4,4,0,1,0
5,342,342,68,39,29,2,1
13,353,353,10,10,0,1,0
23,367,367,11,1,10,2,1
11,369,369,3,3,0,1,0
9,390,390,3,3,0,1,0
21,393,393,38,38,0,1,0
18,398,398,14,4,10,3,2
20,432,432,10,10,0,1,0
15,491,491,35,35,0,1,0
0,499,499,1,1,0,1,0

11,119,119,1,1,0,1,0
7,132,132,21,21,0,1,0
23,166,166,7,4,3,2,1
6,177,177,51,17,34,3,2
0,184,184,35,35,0,1,0
26,198,198,35,35,0,1,0
4,219,219,1,1,0,1,0
14,248,248,1,1,0,1,0
21,255,255,24,24,0,1,0
19,266,266,46,46,0,1,0
1,267,267,5,2,3,2,1
20,292,292,7,1,6,3,2
15,307,307,12,12,0,1,0
25,308,308,10,10,0,1,0
2,343,343,8,8,0,1,0
10,352,352,8,8,0,1,0
5,364,364,31,31,0,1,0
18,364,364,12,12,0,1,0
13,379,379,19,19,0,1,0
22,388,388,48,12,36,4,3
17,398,398,97,67,30,4,3
27,398,398,20,20,0,1,0
12,402,402,28,28,0,1,0
3,402,402,94,15,79,4,3
24,420,420,53,25,28,2,1
16,443,443,113,87,26,2,1
9,446,446,45,21,24,3,2
8,474,474,70,45,25,2,1

25,101,101,17,17,0,1,0
18,120,120,2,2,0,1,0
6,133,133,19,19,0,1,0
11,147,147,20,7,13,4,3
12,172,172,22,22,0,1,0
23,178,178,2,2,0,1,0
4,193,193,10,2,8,3,2
7,238,238,64,23,41,4,3
20,246,246,35,35,0,1,0
0,268,268,21,9,12,2,1
10,278,278,12,12,0,1,0
19,291,291,15,15,0,1,0
2,324,324,52,52,0,1,0
5,356,356,97,97,0,1,0
24,356,356,34,34,0,1,0
1,368,368,14,6,8,2,1
13,394,394,23,11,12,3,2
14,399,399,172,124,48,4,3
22,408,408,2,2,0,1,0
9,431,431,4,4,0,1,0
8,442,442,38,38,0,1,0
17,451,451,89,49,40,3,2
16,452,452,33,24,9,2,1
21,482,482,10,10,0,1,0
3,490,490,56,56,0,1,0
15,500,500,15,5,10,2,1

5,131,131,6,6,0,1,0
6,143,143,3,3,0,1,0
24,148,148,2,2,0,1,0
15,166,166,9,9,0,1,0
10,180,180,9,9,0,1,0
20,180,180,4,4,0,1,0
18,180,180,1,1,0,1,0
22,188,188,7,7,0,1,0
13,205,205,54,25,29,2,1
3,208,208,6,2,4,2,1
17,215,215,73,73,0,1,0
26,228,228,77,14,63,4,3
0,286,286,23,13,10,2,1
7,309,309,13,13,0,1,0
16,312,312,18,18,0,1,0
14,328,328,9,2,7,2,1
8,334,334,123,123,0,1,0
25,337,337,42,30,12,4,3
23,356,356,13,13,0,1,0
11,362,362,146,146,0,1,0
1,366,366,2,2,0,1,0
21,378,378,6,6,0,1,0
2,382,382,10,2,8,3,2
9,390,390,79,59,20,3,2
4,417,417,23,23,0,1,0
12,484,484,35,7,28,4,3
19,494,494,51,13,38,2,1

20,120,120,15,5,10,3,2
25,130,130,11,11,0,1,0
7,152,152,8,2,6,2,1
11,167,167,7,7,0,1,0
14,172,172,6,6,0,1,0
5,204,204,24,16,8,2,1
9,205,205,36,24,12,4,3
23,214,214,15,5,10,2,1
2,219,219,1,1,0,1,0
24,220,220,17,17,0,1,0
34,231,231,43,4,39,4,3
10,231,231,1,1,0,1,0
13,231,231,19,12,7,2,1
8,236,236,1,1,0,1,0
21,264,264,24,11,13,2,1
1,265,265,6,6,0,1,0
12,297,297,9,5,4,2,1
32,297,297,27,27,0,1,0
18,311,311,15,15,0,1,0
6,336,336,116,53,63,4,3
17,349,349,33,3,30,3,2
3,362,362,5,5,0,1,0
33,379,379,69,36,33,2,1
29,381,381,6,1,5,2,1
16,382,382,4,4,0,1,0
0,409,409,38,38,0,1,0
30,409,409,27,27,0,1,0
4,411,411,17,17,0,1,0
31,420,420,12,12,0,1,0
15,426,426,1,1,0,1,0
19,442,442,25,8,17,2,1
28,443,443,112,112,0,1,0
22,466,466,14,3,11,2,1
26,466,466,91,67,24,3,2
27,486,486,26,26,0,1,0

12,106,106,1,1,0,1,0
6,115,115,31,11,20,3,2
20,153,153,3,3,0,1,0
11,177,177,45,45,0,1,0
25,193,193,2,2,0,1,0
16,199,199,3,3,0,1,0
23,202,202,34,34,0,1,0
0,217,217,11,11,0,1,0
14,276,276,70,46,24,2,1
17,286,286,46,9,37,2,1
4,301,301,1,1,0,1,0
24,307,307,62,4,58,3,2
7,315,315,28,28,0,1,0
5,341,341,4,4,0,1,0
3,350,350,5,5,0,1,0
13,365,365,30,30,0,1,0
15,372,372,33,33,0,1,0
2,373,373,62,62,0,1,0
21,373,373,106,70,36,2,1
1,413,413,46,10,36,3,2
9,417,417,48,48,0,1,0
27,433,433,4,4,0,1,0
26,437,437,13,13,0,1,0
8,460,460,51,51,0,1,0
22,464,464,5,1,4,2,1
10,465,465,53,46,7,2,1
19,470,470,68,68,0,1,0
18,487,487,15,15,0,1,0

20,113,113,16,16,0,1,0
14,118,118,5,5,0,1,0
2,148,148,73,73,0,1,0
19,158,158,7,1,6,3,2
12,183,183,38,15,23,2,1
0,208,208,48,48,0,1,0
9,249,249,22,22,0,1,0
18,252,252,58,37,21,2,1
1,294,294,106,98,8,3,2
4,299,299,30,30,0,1,0
10,299,299,99,81,18,2,1
15,302,302,39,21,18,3,2
7,303,303,21,21,0,1,0
17,311,311,14,5,9,2,1
11,321,321,3,3,0,1,0
5,322,322,26,14,12,4,3
8,340,340,5,5,0,1,0
13,350,350,17,17,0,1,0
16,412,412,12,12,0,1,0
6,454,454,26,13,13,3,2
3,487,487,38,20,18,3,2

18,134,134,9,1,8,3,2
10,153,153,3,3,0,1,0
22,180,180,41,3,38,3,2
0,193,193,10,10,0,1,0
2,203,203,23,23,0,1,0
19,209,209,16,16,0,1,0
12,256,256,7,7,0,1,0
4,260,260,9,9,0,1,0
17,267,267,4,4,0,1,0
25,277,277,31,31,0,1,0
20,283,283,36,36,0,1,0
23,286,286,99,60,39,4,3
11,299,299,54,44,10,3,2
8,309,309,1,1,0,1,0
1,309,309,1,1,0,1,0
24,320,320,42,42,0,1,0
21,322,322,3,3,0,1,0
16,348,348,30,6,24,2,1
7,353,353,2,2,0,1,0
5,353,353,46,32,14,3,2
9,442,442,134,117,17,2,1
15,447,447,6,6,0,1,0
6,469,469,77,77,0,1,0
13,490,490,1,1,0,1,0
3,499,499,196,187,9,4,3
14,500,500,89,89,0,1,0

4,104,104,13,1,12,4,3
21,120,120,3,3,0,1,0
11,130,130,9,6,3,2,1
24,133,133,7,7,0,1,0
7,135,135,35,4,31,2,1
20,160,160,8,8,0,1,0
10,168,168,6,2,4,2,1
0,220,220,38,8,30,4,3
19,247,247,32,27,5,2,1
22,281,281,28,28,0,1,0
16,289,289,25,25,0,1,0
14,303,303,49,41,8,2,1
2,338,338,8,3,5,2,1
25,342,342,22,22,0,1,0
23,363,363,58,30,28,3,2
15,364,364,16,16,0,1,0
17,381,381,19,19,0,1,0
18,383,383,89,89,0,1,0
5,383,383,87,15,72,3,2
3,400,400,23,3,20,3,2
8,436,436,70,70,0,1,0
12,446,446,40,26,14,3,2
13,463,463,79,25,54,4,3
6,482,482,7,7,0,1,0
9,488,488,94,94,0,1,0
1,494,494,32,12,20,2,1

14,107,107,15,15,0,1,0
13,109,109,8,5,3,2,1
16,114,114,2,2,0,1,0
15,122,122,21,3,18,4,3
24,146,146,13,7,6,2,1
6,169,169,10,10,0,1,0
2,179,179,57,57,0,1,0
7,191,191,9,3,6,3,2
9,193,193,19,19,0,1,0
12,224,224,21,2,19,2,1
22,240,240,3,3,0,1,0
0,255,255,34,34,0,1,0
11,300,300,6,6,0,1,0
18,300,300,7,7,0,1,0
4,333,333,69,69,0,1,0
21,350,350,33,1,32,2,1
19,382,382,92,32,60,4,3
8,383,383,31,18,13,2,1
20,385,385,145,145,0,1,0
3,408,408,39,39,0,1,0
10,408,408,70,70,0,1,0
1,441,441,59,59,0,1,0
5,449,449,25,22,3,2,1
23,461,461,15,3,12,3,2
17,476,476,25,16,9,2,1

18,115,115,16,6,10,2,1
28,143,143,7,7,0,1,0
14,150,150,18,18,0,1,0
15,172,172,17,17,0,1,0
8,189,189,1,1,0,1,0
6,190,190,5,5,0,1,0
21,200,200,8,8,0,1,0
24,205,205,6,6,0,1,0
23,226,226,26,26,0,1,0
0,234,234,43,43,0,1,0
2,236,236,10,10,0,1,0
4,237,237,34,26,8,3,2
20,269,269,3,3,0,1,0
5,290,290,97,97,0,1,0
1,313,313,18,3,15,2,1
13,330,330,24,2,22,3,2
26,333,333,142,10,132,4,3
27,337,337,125,47,78,4,3
3,343,343,26,14,12,2,1
19,368,368,11,11,0,1,0
9,371,371,14,5,9,4,3
16,372,372,19,19,0,1,0
11,398,398,29,13,16,2,1
29,417,417,2,2,0,1,0
12,418,418,6,2,4,2,1
30,437,437,20,20,0,1,0
10,441,441,11,1,10,3,2
7,448,448,18,18,0,1,0
17,454,454,34,25,9,2,1
25,483,483,37,5,32,3,2
22,497,497,8,8,0,1,0

0,100,100,8,8,0,1,0
29,106,106,20,20,0,1,0
28,107,107,13,13,0,1,0
6,116,116,1,1,0,1,0
27,123,123,29,29,0,1,0
1,137,137,2,2,0,1,0
10,150,150,32,32,0,1,0
23,154,154,8,8,0,1,0
30,172,172,3,3,0,1,0
8,172,172,5,5,0,1,0
21,174,174,21,21,0,1,0
5,189,189,43,13,30,3,2
17,191,191,13,1,12,4,3
14,205,205,43,9,34,3,2
4,234,234,22,22,0,1,0
16,253,253,46,46,0,1,0
12,254,254,13,3,10,4,3
25,260,260,6,6,0,1,0
18,288,288,44,44,0,1,0
11,292,292,21,21,0,1,0
15,292,292,2,2,0,1,0
22,330,330,39,20,19,2,1
19,338,338,50,16,34,2,1
13,339,339,1,1,0,1,0
9,399,399,5,5,0,1,0
24,405,405,30,30,0,1,0
3,448,448,8,8,0,1,0
20,457,457,8,2,6,3,2
7,483,483,52,52,0,1,0
2,488,488,36,36,0,1,0
26,499,499,45,45,0,1,0

8,102,102,9,9,0,1,0
4,111,111,1,1,0,1,0
2,113,113,4,4,0,1,0
25,113,113,15,7,8,2,1
21,114,114,7,1,6,3,2
5,133,133,22,10,12,4,3
13,149,149,7,7,0,1,0
24,155,155,28,28,0,1,0
19,177,177,9,9,0,1,0
20,187,187,1,1,0,1,0
7,217,217,25,25,0,1,0
22,219,219,11,1,10,3,2
1,229,229,7,7,0,1,0
0,234,234,43,43,0,1,0
9,260,260,10,4,6,2,1
23,268,268,58,58,0,1,0
12,269,269,44,20,24,3,2
3,270,270,8,8,0,1,0
15,315,315,42,14,28,2,1
10,324,324,33,1,32,2,1
26,344,344,2,2,0,1,0
14,379,379,77,47,30,4,3
16,413,413,31,10,21,3,2
18,422,422,93,79,14,2,1
6,432,432,106,78,28,3,2
17,487,487,23,23,0,1,0
11,496,496,96,40,56,3,2

9,106,106,5,1,4,2,1
6,118,118,4,1,3,2,1
4,131,131,1,1,0,1,0
25,152,152,17,7,10,2,1
1,155,155,29,7,22,4,3
31,163,163,9,9,0,1,0
10,178,178,36,12,24,3,2
19,193,193,16,3,13,2,1
26,215,215,5,5,0,1,0
33,216,216,56,13,43,2,1
5,246,246,6,6,0,1,0
22,250,250,14,14,0,1,0
21,293,293,14,1,13,2,1
29,298,298,28,10,18,4,3
13,301,301,13,13,0,1,0
14,301,301,12,9,3,2,1
12,308,308,34,1,33,4,3
32,310,310,8,5,3,2,1
27,330,330,96,96,0,1,0
24,330,330,8,2,6,2,1
18,335,335,27,19,8,2,1
0,341,341,11,11,0,1,0
16,368,368,1,1,0,1,0
30,419,419,40,27,13,2,1
11,448,448,33,33,0,1,0
3,450,450,43,34,9,4,3
20,458,458,50,9,41,3,2
7,471,471,65,53,12,4,3
15,473,473,4,4,0,1,0
8,473,473,12,6,6,3,2
17,476,476,56,34,22,2,1
28,484,484,87,43,44,2,1
2,497,497,24,6,18,4,3
23,500,500,28,12,16,2,1

27,106,106,15,15,0,1,0
1,106,106,5,5,0,1,0
25,134,134,17,17,0,1,0
24,137,137,15,12,3,2,1
0,146,146,15,15,0,1,0
26,146,146,3,3,0,1,0
9,151,151,14,14,0,1,0
22,153,153,24,24,0,1,0
30,157,157,20,20,0,1,0
33,158,158,10,10,0,1,0
31,160,160,12,3,9,2,1
15,181,181,2,2,0,1,0
2,203,203,5,1,4,2,1
7,208,208,1,1,0,1,0
17,223,223,1,1,0,1,0
14,224,224,1,1,0,1,0
29,232,232,56,56,0,1,0
4,242,242,4,1,3,2,1
28,285,285,25,25,0,1,0
11,305,305,37,1,36,2,1
12,315,315,10,10,0,1,0
8,326,326,10,10,0,1,0
3,333,333,75,75,0,1,0
32,348,348,11,3,8,3,2
13,365,365,1,1,0,1,0
21,369,369,63,63,0,1,0
18,380,380,94,94,0,1,0
6,384,384,61,33,28,2,1
20,407,407,32,32,0,1,0
19,420,420,23,23,0,1,0
23,421,421,8,8,0,1,0
16,454,454,43,10,33,4,3
5,458,458,50,50,0,1,0
10,468,468,7,7,0,1,0

27,188,188,1,1,0,1,0
21,198,198,27,1,26,2,1
11,201,201,12,3,9,2,1
8,214,214,5,5,0,1,0
5,231,231,19,16,3,2,1
2,234,234,30,30,0,1,0
4,253,253,1,1,0,1,0
25,262,262,114,75,39,2,1
14,266,266,2,2,0,1,0
33,275,275,25,13,12,4,3
16,275,275,10,7,3,2,1
0,276,276,1,1,0,1,0
26,282,282,5,5,0,1,0
15,300,300,16,3,13,2,1
28,301,301,23,23,0,1,0
22,314,314,6,1,5,2,1
3,314,314,10,10,0,1,0
23,324,324,16,16,0,1,0
18,325,325,56,56,0,1,0
9,343,343,1,1,0,1,0
6,347,347,1,1,0,1,0
30,369,369,1,1,0,1,0
12,370,370,63,18,45,2,1
17,374,374,22,5,17,2,1
7,390,390,98,78,20,2,1
19,392,392,16,1,15,2,1
29,403,403,4,4,0,1,0
1,421,421,87,9,78,4,3
10,432,432,20,20,0,1,0
32,450,450,14,14,0,1,0
20,470,470,68,42,26,2,1
13,471,471,9,9,0,1,0
24,475,475,2,2,0,1,0
31,488,488,194,114,80,3,2

24,113,113,10,10,0,1,0
25,132,132,20,20,0,1,0
11,142,142,8,3,5,2,1
7,157,157,9,9,0,1,0
27,169,169,2,2,0,1,0
15,177,177,1,1,0,1,0
26,177,177,50,26,24,2,1
12,178,178,28,28,0,1,0
2,182,182,36,11,25,3,2
3,184,184,24,16,8,2,1
22,206,206,16,5,11,4,3
4,216,216,8,8,0,1,0
28,230,230,41,41,0,1,0
14,231,231,11,11,0,1,0
23,236,236,33,33,0,1,0
30,245,245,5,1,4,2,1
18,252,252,8,8,0,1,0
13,280,280,70,4,66,3,2
31,307,307,55,4,51,4,3
17,348,348,18,10,8,2,1
0,352,352,14,14,0,1,0
21,356,356,27,3,24,4,3
19,371,371,31,31,0,1,0
29,374,374,27,27,0,1,0
8,382,382,2,2,0,1,0
1,407,407,1,1,0,1,0
9,426,426,3,3,0,1,0
10,434,434,36,36,0,1,0
16,458,458,17,10,7,2,1
32,461,461,14,14,0,1,0
5,467,467,88,39,49,2,1
20,471,471,16,16,0,1,0
6,487,487,8,8,0,1,0

4,104,104,20,20,0,1,0
2,112,112,24,8,16,3,2
5,125,125,10,5,5,2,1
19,136,136,8,8,0,1,0
23,137,137,5,5,0,1,0
22,138,138,21,21,0,1,0
0,204,204,12,12,0,1,0
25,217,217,2,2,0,1,0
12,232,232,12,3,9,2,1
14,282,282,15,15,0,1,0
13,306,306,100,53,47,2,1
6,327,327,8,8,0,1,0
18,334,334,31,31,0,1,0
7,334,334,30,30,0,1,0
10,345,345,11,11,0,1,0
8,352,352,36,36,0,1,0
16,353,353,19,13,6,2,1
11,359,359,59,59,0,1,0
21,383,383,13,13,0,1,0
15,394,394,8,5,3,2,1
20,424,424,49,27,22,3,2
9,435,435,142,4,138,4,3
1,440,440,48,48,0,1,0
3,443,443,4,4,0,1,0
17,465,465,73,73,0,1,0
24,491,491,131,131,0,1,0

22,122,122,8,8,0,1,0
3,130,130,1,1,0,1,0
25,173,173,17,17,0,1,0
17,184,184,51,21,30,4,3
26,202,202,3,3,0,1,0
6,210,210,122,17,105,4,3
0,216,216,6,2,4,2,1
24,230,230,42,13,29,2,1
7,231,231,8,3,5,2,1
1,250,250,4,4,0,1,0
12,253,253,43,15,28,2,1
9,258,258,6,6,0,1,0
11,290,290,17,8,9,4,3
16,327,327,49,49,0,1,0
10,328,328,19,7,12,4,3
18,329,329,23,5,18,2,1
5,351,351,6,6,0,1,0
15,359,359,6,6,0,1,0
19,360,360,62,12,50,2,1
20,374,374,42,15,27,2,1
21,383,383,4,4,0,1,0
2,437,437,106,54,52,3,2
4,441,441,41,13,28,2,1
23,446,446,78,38,40,3,2
14,460,460,5,2,3,2,1
8,465,465,34,13,21,4,3
13,471,471,33,33,0,1,0

8,134,134,11,5,6,2,1
1,141,141,20,20,0,1,0
14,162,162,3,3,0,1,0
12,186,186,10,10,0,1,0
0,219,219,6,2,4,2,1
16,224,224,66,66,0,1,0
5,232,232,35,18,17,4,3
9,236,236,35,35,0,1,0
3,246,246,28,8,20,3,2
20,257,257,34,25,9,4,3
4,270,270,12,1,11,2,1
24,307,307,4,4,0,1,0
17,309,309,48,48,0,1,0
18,320,320,1,1,0,1,0
22,320,320,98,35,63,4,3
10,328,328,153,118,35,2,1
15,374,374,64,22,42,2,1
23,383,383,1,1,0,1,0
21,401,401,36,3,33,2,1
13,420,420,48,48,0,1,0
7,455,455,12,2,10,3,2
19,458,458,2,2,0,1,0
6,479,479,23,13,10,3,2
11,479,479,28,28,0,1,0
2,482,482,73,73,0,1,0

15,101,101,17,7,10,3,2
4,103,103,8,3,5,2,1
1,107,107,3,3,0,1,0
16,154,154,12,3,9,2,1
14,172,172,4,1,3,2,1
19,175,175,86,31,55,4,3
0,183,183,8,8,0,1,0
11,186,186,36,15,21,2,1
24,209,209,12,6,6,2,1
22,232,232,53,27,26,2,1
23,240,240,4,1,3,2,1
21,240,240,16,16,0,1,0
17,248,248,12,2,10,3,2
18,254,254,19,11,8,3,2
10,255,255,44,34,10,2,1
8,267,267,15,15,0,1,0
6,268,268,4,4,0,1,0
9,314,314,47,23,24,4,3
7,330,330,32,4,28,3,2
28,345,345,39,13,26,2,1
2,351,351,46,29,17,2,1
13,359,359,56,17,39,4,3
25,386,386,10,10,0,1,0
29,390,390,51,37,14,2,1
5,409,409,13,13,0,1,0
27,426,426,7,1,6,3,2
12,454,454,17,17,0,1,0
20,467,467,3,3,0,1,0
3,474,474,10,1,9,4,3
26,487,487,31,31,0,1,0

11,100,100,20,20,0,1,0
17,120,120,18,10,8,2,1
21,153,153,1,1,0,1,0
25,168,168,22,22,0,1,0
23,173,173,1,1,0,1,0
0,176,176,10,4,6,3,2
14,213,213,14,14,0,1,0
19,224,224,12,12,0,1,0
5,269,269,21,13,8,2,1
4,274,274,1,1,0,1,0
13,301,301,74,65,9,4,3
12,307,307,68,59,9,2,1
3,323,323,18,4,14,3,2
24,344,344,23,23,0,1,0
18,350,350,48,48,0,1,0
22,380,380,48,48,0,1,0
15,384,384,17,4,13,2,1
10,399,399,60,6,54,3,2
2,403,403,73,73,0,1,0
8,408,408,89,25,64,3,2
16,409,409,56,56,0,1,0
1,412,412,48,30,18,4,3
6,455,455,17,17,0,1,0
7,469,469,8,1,7,2,1
20,471,471,18,18,0,1,0
9,476,476,137,114,23,2,1

11,101,101,12,12,0,1,0
3,150,150,18,18,0,1,0
23,153,153,3,3,0,1,0
21,184,184,37,37,0,1,0
25,194,194,21,6,15,4,3
24,217,217,7,7,0,1,0
17,271,271,18,18,0,1,0
2,281,281,40,10,30,3,2
22,298,298,31,13,18,2,1
15,323,323,73,49,24,2,1
16,327,327,8,8,0,1,0
1,329,329,90,84,6,2,1
14,337,337,43,43,0,1,0
9,343,343,121,121,0,1,0
4,349,349,36,20,16,3,2
20,353,353,8,8,0,1,0
12,360,360,94,94,0,1,0
6,362,362,6,2,4,2,1
19,368,368,37,20,17,2,1
8,378,378,14,6,8,2,1
13,390,390,49,49,0,1,0
7,391,391,19,19,0,1,0
10,400,400,11,11,0,1,0
5,400,400,30,8,22,2,1
0,448,448,40,19,21,4,3
18,479,479,3,3,0,1,0

4,114,114,7,7,0,1,0
6,122,122,5,5,0,1,0
24,122,122,2,2,0,1,0
27,140,140,44,44,0,1,0
18,157,157,36,19,17,3,2
7,159,159,19,10,9,2,1
12,165,165,15,1,14,3,2
28,196,196,5,5,0,1,0
20,215,215,10,10,0,1,0
23,230,230,42,42,0,1,0
3,251,251,90,90,0,1,0
19,254,254,9,9,0,1,0
16,257,257,38,38,0,1,0
0,298,298,28,28,0,1,0
14,299,299,16,16,0,1,0
11,345,345,12,12,0,1,0
21,346,346,25,15,10,3,2
15,350,350,3,3,0,1,0
22,353,353,16,16,0,1,0
8,356,356,16,8,8,3,2
5,395,395,37,37,0,1,0
1,408,408,50,2,48,2,1
17,417,417,21,3,18,4,3
25,422,422,24,24,0,1,0
26,431,431,75,65,10,3,2
2,449,449,14,6,8,2,1
29,455,455,12,5,7,2,1
10,471,471,71,71,0,1,0
9,496,496,4,4,0,1,0
13,497,497,44,37,7,2,1

0,105,105,4,4,0,1,0
30,107,107,17,12,5,2,1
5,111,111,1,1,0,1,0
25,119,119,13,13,0,1,0
17,145,145,3,3,0,1,0
29,169,169,30,17,13,2,1
36,197,197,38,38,0,1,0
4,201,201,14,2,12,2,1
2,202,202,4,4,0,1,0
28,221,221,21,3,18,2,1
34,244,244,8,3,5,2,1
33,250,250,10,2,8,2,1
1,277,277,12,4,8,3,2
32,280,280,19,5,14,3,2
20,289,289,16,16,0,1,0
15,304,304,37,37,0,1,0
10,304,304,42,42,0,1,0
26,305,305,61,19,42,2,1
31,308,308,21,4,17,3,2
35,312,312,53,53,0,1,0
13,339,339,36,36,0,1,0
19,349,349,57,23,34,3,2
3,353,353,15,15,0,1,0
7,383,383,41,41,0,1,0
6,405,405,10,10,0,1,0
9,415,415,2,2,0,1,0
24,425,425,19,2,17,3,2
23,430,430,5,1,4,2,1
8,435,435,54,54,0,1,0
14,439,439,10,10,0,1,0
11,439,439,37,22,15,2,1
22,440,440,27,27,0,1,0
16,454,454,4,4,0,1,0
27,469,469,32,32,0,1,0
18,478,478,31,31,0,1,0
12,489,489,9,9,0,1,0
21,496,496,26,17,9,4,3

26,105,105,2,2,0,1,0
7,115,115,3,3,0,1,0
25,151,151,7,4,3,2,1
22,189,189,46,46,0,1,0
13,194,194,24,24,0,1,0
18,213,213,2,2,0,1,0
14,215,215,8,8,0,1,0
19,232,232,4,4,0,1,0
20,236,236,8,8,0,1,0
9,242,242,18,6,12,2,1
21,254,254,32,1,31,2,1
5,257,257,1,1,0,1,0
16,259,259,18,9,9,4,3
10,282,282,73,73,0,1,0
17,296,296,74,26,48,4,3
0,304,304,24,2,22,2,1
11,334,334,2,2,0,1,0
8,361,361,7,7,0,1,0
23,369,369,70,70,0,1,0
3,372,372,21,9,12,4,3
24,408,408,27,17,10,3,2
4,417,417,254,212,42,3,2
12,430,430,14,1,13,2,1
6,465,465,31,8,23,2,1
2,474,474,76,26,50,3,2
15,490,490,96,64,32,3,2
1,499,499,4,1,3,2,1

29,101,101,5,5,0,1,0
27,109,109,6,1,5,2,1
32,137,137,1,1,0,1,0
28,140,140,21,21,0,1,0
20,144,144,48,48,0,1,0
5,148,148,4,1,3,2,1
26,156,156,6,6,0,1,0
16,194,194,1,1,0,1,0
18,204,204,8,8,0,1,0
23,208,208,43,43,0,1,0
31,222,222,20,20,0,1,0
34,238,238,25,2,23,3,2
9,241,241,2,2,0,1,0
1,242,242,1,1,0,1,0
7,248,248,11,8,3,2,1
22,255,255,2,2,0,1,0
14,264,264,53,8,45,2,1
25,273,273,49,49,0,1,0
13,291,291,9,9,0,1,0
8,298,298,14,8,6,3,2
21,303,303,17,6,11,2,1
4,314,314,31,31,0,1,0
2,318,318,18,18,0,1,0
11,325,325,60,19,41,3,2
3,328,328,9,9,0,1,0
6,364,364,4,4,0,1,0
12,368,368,1,1,0,1,0
10,375,375,4,4,0,1,0
30,406,406,16,16,0,1,0
0,415,415,23,23,0,1,0
17,419,419,1,1,0,1,0
35,445,445,17,5,12,3,2
24,447,447,163,100,63,3,2
33,464,464,47,8,39,2,1
19,467,467,13,13,0,1,0
15,487,487,62,4,58,4,3

26,107,107,21,4,17,2,1
23,115,115,18,18,0,1,0
2,115,115,1,1,0,1,0
12,135,135,8,8,0,1,0
1,154,154,3,3,0,1,0
5,170,170,10,10,0,1,0
4,206,206,17,17,0,1,0
21,221,221,9,1,8,2,1
28,222,222,3,3,0,1,0
20,225,225,55,6,49,2,1
19,258,258,23,23,0,1,0
18,316,316,33,15,18,4,3
8,322,322,196,127,69,4,3
11,323,323,4,4,0,1,0
6,330,330,16,16,0,1,0
7,330,330,6,6,0,1,0
16,348,348,128,46,82,4,3
13,369,369,34,34,0,1,0
22,379,379,1,1,0,1,0
0,395,395,3,3,0,1,0
10,399,399,17,5,12,2,1
24,406,406,14,10,4,2,1
9,415,415,7,7,0,1,0
14,417,417,70,70,0,1,0
17,422,422,7,7,0,1,0
3,427,427,34,13,21,4,3
27,457,457,15,3,12,4,3
29,470,470,4,4,0,1,0
25,482,482,56,19,37,4,3
15,490,490,38,38,0,1,0

1,102,102,20,11,9,2,1
10,111,111,7,7,0,1,0
9,114,114,10,10,0,1,0
26,159,159,19,9,10,3,2
27,182,182,8,4,4,2,1
15,190,190,41,41,0,1,0
13,200,200,45,45,0,1,0
18,218,218,19,4,15,4,3
17,231,231,19,5,14,3,2
7,236,236,4,1,3,2,1
25,237,237,20,20,0,1,0
4,271,271,15,15,0,1,0
11,278,278,26,14,12,4,3
6,302,302,32,10,22,3,2
14,318,318,3,3,0,1,0
8,320,320,4,4,0,1,0
16,346,346,49,49,0,1,0
20,366,366,6,6,0,1,0
19,406,406,13,13,0,1,0
12,433,433,47,5,42,4,3
5,434,434,78,16,62,3,2
2,439,439,79,9,70,4,3
21,442,442,133,52,81,3,2
3,448,448,4,4,0,1,0
23,461,461,32,8,24,4,3
0,464,464,33,33,0,1,0
22,484,484,55,47,8,2,1
24,498,498,56,16,40,2,1

32,124,124,34,6,28,3,2
9,131,131,32,3,29,2,1
6,134,134,4,4,0,1,0
11,143,143,2,2,0,1,0
34,146,146,30,30,0,1,0
31,171,171,3,3,0,1,0
7,178,178,6,1,5,2,1
1,182,182,7,1,6,3,2
23,184,184,6,3,3,2,1
29,190,190,22,4,18,2,1
5,191,191,1,1,0,1,0
17,217,217,1,1,0,1,0
25,218,218,4,1,3,2,1
0,236,236,8,8,0,1,0
27,241,241,8,8,0,1,0
15,261,261,14,8,6,2,1
8,266,266,8,8,0,1,0
26,268,268,55,55,0,1,0
33,284,284,4,4,0,1,0
24,295,295,49,43,6,2,1
21,297,297,18,18,0,1,0
30,319,319,22,22,0,1,0
18,321,321,6,1,5,2,1
3,338,338,10,10,0,1,0
13,340,340,28,13,15,4,3
12,344,344,44,20,24,4,3
10,346,346,125,125,0,1,0
28,348,348,51,23,28,2,1
22,354,354,22,22,0,1,0
4,380,380,22,22,0,1,0
20,423,423,52,8,44,4,3
16,447,447,1,1,0,1,0
19,448,448,31,31,0,1,0
14,461,461,2,2,0,1,0
2,478,478,18,9,9,2,1

14,101,101,13,1,12,3,2
9,106,106,9,9,0,1,0
1,115,115,60,26,34,4,3
4,151,151,25,25,0,1,0
16,206,206,23,23,0,1,0
3,209,209,21,21,0,1,0
15,243,243,24,11,13,4,3
0,261,261,72,4,68,3,2
13,262,262,14,14,0,1,0
19,296,296,2,2,0,1,0
20,302,302,10,7,3,2,1
18,334,334,86,86,0,1,0
7,340,340,19,6,13,3,2
21,366,366,45,38,7,2,1
12,400,400,39,32,7,2,1
11,404,404,46,46,0,1,0
8,427,427,89,40,49,3,2
10,445,445,16,16,0,1,0
17,451,451,36,15,21,4,3
5,481,481,20,1,19,2,1
6,492,492,44,24,20,2,1
2,492,492,74,62,12,4,3

22,128,128,7,7,0,1,0
14,137,137,13,13,0,1,0
13,142,142,56,3,53,3,2
4,144,144,9,9,0,1,0
2,169,169,19,16,3,2,1
20,174,174,37,37,0,1,0
0,182,182,8,8,0,1,0
15,233,233,14,5,9,4,3
7,245,245,20,6,14,2,1
19,246,246,24,24,0,1,0
8,253,253,79,79,0,1,0
5,275,275,29,29,0,1,0
16,278,278,14,14,0,1,0
10,288,288,17,17,0,1,0
18,293,293,3,3,0,1,0
12,307,307,1,1,0,1,0
9,323,323,160,91,69,4,3
6,326,326,18,6,12,4,3
21,391,391,18,18,0,1,0
1,416,416,7,7,0,1,0
3,418,418,49,49,0,1,0
17,436,436,21,21,0,1,0
23,481,481,59,36,23,2,1
11,482,482,83,83,0,1,0

27,100,100,3,3,0,1,0
16,107,107,2,2,0,1,0
6,122,122,2,2,0,1,0
25,124,124,17,17,0,1,0
0,129,129,18,18,0,1,0
8,134,134,1,1,0,1,0
17,169,169,13,13,0,1,0
3,182,182,11,2,9,2,1
22,184,184,39,36,3,2,1
24,214,214,6,6,0,1,0
30,224,224,6,1,5,2,1
1,263,263,56,32,24,3,2
9,279,279,7,1,6,3,2
28,284,284,30,18,12,4,3
7,285,285,1,1,0,1,0
15,320,320,3,3,0,1,0
19,334,334,15,9,6,2,1
12,336,336,72,72,0,1,0
21,343,343,46,46,0,1,0
29,345,345,6,6,0,1,0
31,345,345,25,25,0,1,0
13,351,351,1,1,0,1,0
4,354,354,7,7,0,1,0
10,366,366,1,1,0,1,0
18,377,377,42,3,39,2,1
14,394,394,48,24,24,3,2
2,397,397,65,17,48,4,3
5,406,406,116,44,72,4,3
23,425,425,150,150,0,1,0
20,433,433,26,15,11,2,1
11,482,482,10,5,5,2,1
26,500,500,48,20,28,3,2

18,101,101,3,3,0,1,0
15,102,102,5,5,0,1,0
1,114,114,8,8,0,1,0
21,122,122,29,29,0,1,0
20,127,127,33,7,26,2,1
33,129,129,24,3,21,2,1
10,131,131,11,11,0,1,0
26,134,134,5,5,0,1,0
8,146,146,4,1,3,2,1
5,159,159,33,33,0,1,0
17,227,227,8,8,0,1,0
30,240,240,3,3,0,1,0
24,251,251,3,3,0,1,0
27,271,271,5,5,0,1,0
9,289,289,71,71,0,1,0
22,290,290,17,17,0,1,0
7,312,312,34,34,0,1,0
31,327,327,24,24,0,1,0
23,332,332,62,21,41,2,1
4,336,336,43,4,39,4,3
14,336,336,7,3,4,2,1
3,337,337,5,5,0,1,0
11,338,338,44,11,33,2,1
2,346,346,12,12,0,1,0
19,353,353,20,20,0,1,0
16,362,362,1,1,0,1,0
32,415,415,14,4,10,2,1
25,431,431,50,5,45,4,3
29,435,435,44,44,0,1,0
12,436,436,1,1,0,1,0
13,450,450,38,38,0,1,0
28,457,457,42,42,0,1,0
0,462,462,9,9,0,1,0
6,486,486,24,6,18,2,1

23,106,106,12,12,0,1,0
6,127,127,3,3,0,1,0
7,139,139,16,5,11,4,3
9,147,147,53,16,37,2,1
19,156,156,30,30,0,1,0
8,160,160,22,22,0,1,0
1,178,178,3,3,0,1,0
15,182,182,29,29,0,1,0
4,185,185,76,76,0,1,0
5,227,227,10,1,9,2,1
11,270,270,16,5,11,3,2
2,286,286,22,22,0,1,0
14,323,323,89,5,84,4,3
13,324,324,2,2,0,1,0
10,346,346,15,2,13,2,1
18,377,377,40,11,29,2,1
22,385,385,16,16,0,1,0
20,400,400,37,37,0,1,0
16,404,404,103,103,0,1,0
17,405,405,4,4,0,1,0
21,405,405,26,6,20,2,1
12,481,481,1,1,0,1,0
3,485,485,67,55,12,2,1
0,485,485,38,17,21,2,1

22,107,107,7,3,4,2,1
7,121,121,23,23,0,1,0
28,124,124,2,2,0,1,0
14,124,124,6,6,0,1,0
3,140,140,1,1,0,1,0
29,143,143,11,3,8,3,2
1,149,149,9,9,0,1,0
31,161,161,2,2,0,1,0
8,186,186,21,21,0,1,0
6,187,187,2,2,0,1,0
24,187,187,21,21,0,1,0
23,187,187,1,1,0,1,0
26,190,190,5,2,3,2,1
30,191,191,81,63,18,3,2
12,210,210,46,23,23,2,1
17,224,224,17,17,0,1,0
32,228,228,33,33,0,1,0
9,241,241,39,19,20,3,2
4,243,243,3,3,0,1,0
20,249,249,16,2,14,3,2
13,252,252,15,3,12,4,3
18,253,253,11,11,0,1,0
25,277,277,5,5,0,1,0
21,315,315,55,55,0,1,0
2,316,316,54,54,0,1,0
16,340,340,42,3,39,4,3
19,355,355,98,98,0,1,0
0,363,363,4,4,0,1,0
11,388,388,16,10,6,3,2
27,429,429,10,10,0,1,0
5,439,439,2,2,0,1,0
10,439,439,7,4,3,2,1
15,461,461,15,2,13,4,3

12,101,101,25,25,0,1,0
8,110,110,26,26,0,1,0
11,120,120,2,2,0,1,0
7,136,136,46,7,39,4,3
15,141,141,4,4,0,1,0
1,183,183,11,8,3,2,1
13,230,230,7,7,0,1,0
10,285,285,19,19,0,1,0
16,292,292,3,3,0,1,0
9,308,308,86,10,76,3,2
3,328,328,7,7,0,1,0
4,356,356,49,3,46,3,2
5,376,376,8,8,0,1,0
2,379,379,87,42,45,2,1
22,389,389,21,1,20,2,1
21,401,401,68,68,0,1,0
19,427,427,150,66,84,4,3
17,434,434,22,22,0,1,0
14,447,447,7,7,0,1,0
20,469,469,33,33,0,1,0
6,474,474,137,60,77,4,3
0,482,482,36,36,0,1,0
18,494,494,20,6,14,3,2

18,100,100,1,1,0,1,0
2,105,105,2,2,0,1,0
15,130,130,1,1,0,1,0
8,138,138,2,2,0,1,0
19,150,150,1,1,0,1,0
7,170,170,11,1,10,3,2
13,172,172,18,3,15,2,1
3,184,184,9,9,0,1,0
0,195,195,1,1,0,1,0
26,218,218,15,4,11,2,1
28,234,234,30,9,21,2,1
9,244,244,59,9,50,2,1
12,247,247,63,63,0,1,0
22,247,247,29,13,16,2,1
5,250,250,7,7,0,1,0
21,253,253,44,5,39,2,1
16,254,254,2,2,0,1,0
27,277,277,15,5,10,2,1
24,321,321,11,11,0,1,0
23,355,355,28,13,15,4,3
11,368,368,74,24,50,3,2
4,373,373,32,1,31,2,1
1,383,383,9,3,6,3,2
30,393,393,118,46,72,4,3
20,400,400,57,25,32,2,1
17,400,400,78,62,16,2,1
10,406,406,20,20,0,1,0
29,414,414,37,37,0,1,0
6,433,433,79,79,0,1,0
14,440,440,27,27,0,1,0
25,490,490,12,8,4,2,1

23,110,110,16,3,13,2,1
14,117,117,4,1,3,2,1
18,121,121,6,6,0,1,0
0,140,140,31,1,30,3,2
1,145,145,13,13,0,1,0
21,153,153,3,3,0,1,0
26,176,176,14,5,9,2,1
5,209,209,4,4,0,1,0
9,233,233,22,14,8,3,2
22,254,254,18,18,0,1,0
15,257,257,15,3,12,3,2
8,274,274,43,43,0,1,0
25,288,288,9,9,0,1,0
16,289,289,13,13,0,1,0
6,292,292,33,7,26,3,2
17,303,303,17,17,0,1,0
27,306,306,52,52,0,1,0
12,325,325,25,12,13,2,1
7,327,327,118,58,60,3,2
10,346,346,1,1,0,1,0
20,351,351,50,2,48,2,1
4,358,358,14,14,0,1,0
3,358,358,28,28,0,1,0
2,358,358,6,6,0,1,0
19,361,361,196,73,123,4,3
24,374,374,7,3,4,2,1
11,434,434,24,16,8,2,1
28,446,446,2,2,0,1,0
13,460,460,19,11,8,3,2

23,100,100,14,8,6,3,2
21,104,104,2,2,0,1,0
22,138,138,47,47,0,1,0
8,153,153,1,1,0,1,0
18,195,195,26,5,21,2,1
11,199,199,3,3,0,1,0
12,210,210,14,14,0,1,0
13,225,225,14,2,12,4,3
15,225,225,11,2,9,2,1
17,245,245,30,30,0,1,0
25,247,247,4,1,3,2,1
6,252,252,23,1,22,2,1
1,329,329,167,128,39,4,3
10,333,333,20,3,17,2,1
20,343,343,31,31,0,1,0
5,343,343,4,1,3,2,1
2,381,381,20,14,6,3,2
24,390,390,44,44,0,1,0
26,402,402,75,54,21,2,1
9,436,436,79,41,38,4,3
19,447,447,29,13,16,3,2
3,453,453,84,84,0,1,0
4,458,458,83,83,0,1,0
0,471,471,5,5,0,1,0
14,487,487,47,32,15,4,3
7,488,488,16,11,5,2,1
16,493,493,1,1,0,1,0

22,101,101,3,3,0,1,0
0,115,115,7,7,0,1,0
14,136,136,18,18,0,1,0
23,137,137,3,3,0,1,0
6,151,151,5,5,0,1,0
7,168,168,7,1,6,2,1
25,190,190,10,10,0,1,0
26,228,228,5,5,0,1,0
4,256,256,25,19,6,2,1
8,288,288,1,1,0,1,0
21,307,307,8,2,6,3,2
29,311,311,39,8,31,4,3
11,312,312,61,61,0,1,0
10,322,322,36,1,35,3,2
19,326,326,12,12,0,1,0
27,334,334,24,8,16,3,2
5,356,356,27,27,0,1,0
13,381,381,17,7,10,2,1
2,384,384,26,19,7,2,1
12,398,398,34,29,5,2,1
15,407,407,28,7,21,2,1
17,417,417,45,13,32,3,2
30,438,438,58,58,0,1,0
24,458,458,48,20,28,2,1
3,464,464,31,12,19,2,1
1,466,466,19,19,0,1,0
9,471,471,87,43,44,4,3
28,472,472,23,23,0,1,0
18,479,479,1,1,0,1,0
16,485,485,44,44,0,1,0
20,487,487,316,300,16,2,1

10,117,117,1,1,0,1,0
9,134,134,7,7,0,1,0
3,144,144,3,3,0,1,0
5,153,153,1,1,0,1,0
14,156,156,11,11,0,1,0
20,156,156,9,9,0,1,0
19,164,164,12,12,0,1,0
4,177,177,1,1,0,1,0
17,200,200,20,1,19,4,3
6,209,209,2,2,0,1,0
27,217,217,58,14,44,2,1
25,218,218,9,6,3,2,1
21,228,228,25,9,16,3,2
32,247,247,6,6,0,1,0
29,258,258,35,2,33,4,3
1,264,264,9,1,8,3,2
23,264,264,13,9,4,2,1
12,300,300,23,9,14,2,1
22,304,304,21,9,12,3,2
26,307,307,99,99,0,1,0
16,325,325,4,4,0,1,0
7,331,331,58,58,0,1,0
28,341,341,23,23,0,1,0
30,352,352,20,20,0,1,0
8,406,406,73,41,32,3,2
0,432,432,23,12,11,2,1
11,434,434,79,79,0,1,0
2,448,448,8,5,3,2,1
13,456,456,64,61,3,2,1
18,458,458,67,50,17,3,2
31,476,476,47,21,26,2,1
15,489,489,54,38,16,2,1
24,498,498,25,13,12,2,1

27,121,121,18,18,0,1,0
24,122,122,1,1,0,1,0
20,142,142,52,52,0,1,0
10,167,167,6,6,0,1,0
29,198,198,6,6,0,1,0
26,202,202,45,45,0,1,0
31,212,212,15,15,0,1,0
4,264,264,61,55,6,2,1
21,265,265,30,9,21,2,1
25,266,266,34,34,0,1,0
17,275,275,1,1,0,1,0
13,289,289,11,1,10,4,3
28,296,296,11,7,4,2,1
5,297,297,9,9,0,1,0
23,303,303,33,33,0,1,0
0,306,306,46,46,0,1,0
22,327,327,14,5,9,2,1
16,329,329,13,13,0,1,0
30,333,333,15,4,11,2,1
19,343,343,16,4,12,3,2
7,346,346,29,11,18,4,3
18,346,346,21,16,5,2,1
2,348,348,3,3,0,1,0
8,350,350,18,18,0,1,0
6,357,357,54,28,26,2,1
15,358,358,35,35,0,1,0
11,435,435,41,2,39,4,3
12,446,446,21,6,15,2,1
3,479,479,13,5,8,3,2
9,484,484,19,19,0,1,0
14,486,486,69,29,40,2,1
1,494,494,65,65,0,1,0

11,118,118,8,8,0,1,0
14,129,129,20,20,0,1,0
5,146,146,4,4,0,1,0
19,147,147,2,2,0,1,0
13,160,160,1,1,0,1,0
25,160,160,35,4,31,4,3
7,164,164,21,21,0,1,0
2,182,182,7,7,0,1,0
20,200,200,27,2,25,2,1
21,250,250,23,23,0,1,0
29,266,266,7,7,0,1,0
9,279,279,123,42,81,4,3
17,296,296,38,38,0,1,0
23,304,304,34,10,24,2,1
8,319,319,49,49,0,1,0
28,323,323,1,1,0,1,0
6,335,335,21,21,0,1,0
15,336,336,22,22,0,1,0
1,342,342,21,21,0,1,0
27,342,342,5,5,0,1,0
4,352,352,23,5,18,4,3
10,353,353,5,1,4,2,1
18,358,358,40,40,0,1,0
22,452,452,94,14,80,3,2
0,455,455,9,9,0,1,0
24,468,468,94,60,34,3,2
16,472,472,41,3,38,4,3
26,483,483,34,34,0,1,0
3,487,487,1,1,0,1,0
12,488,488,46,46,0,1,0

21,111,111,13,13,0,1,0
9,114,114,4,4,0,1,0
24,126,126,3,3,0,1,0
7,157,157,7,7,0,1,0
11,191,191,11,11,0,1,0
8,202,202,1,1,0,1,0
19,212,212,30,24,6,3,2
15,219,219,18,18,0,1,0
22,223,223,8,8,0,1,0
14,257,257,24,24,0,1,0
2,272,272,100,51,49,2,1
16,289,289,44,6,38,4,3
18,290,290,55,42,13,2,1
6,300,300,167,95,72,4,3
20,308,308,25,25,0,1,0
0,312,312,18,18,0,1,0
1,318,318,26,26,0,1,0
4,330,330,4,4,0,1,0
12,353,353,27,21,6,2,1
23,377,377,13,13,0,1,0
25,379,379,117,85,32,2,1
10,380,380,15,7,8,2,1
13,411,411,24,24,0,1,0
17,428,428,14,14,0,1,0
5,459,459,43,12,31,2,1
3,479,479,24,24,0,1,0

12,116,116,12,12,0,1,0
1,139,139,12,9,3,2,1
10,157,157,5,1,4,2,1
18,161,161,1,1,0,1,0
26,161,161,9,9,0,1,0
34,176,176,45,15,30,4,3
35,206,206,8,8,0,1,0
21,218,218,39,17,22,2,1
13,220,220,11,11,0,1,0
3,240,240,1,1,0,1,0
7,272,272,4,1,3,2,1
28,285,285,53,53,0,1,0
6,288,288,2,2,0,1,0
19,296,296,47,47,0,1,0
25,312,312,8,8,0,1,0
4,321,321,21,21,0,1,0
5,321,321,14,1,13,2,1
9,325,325,60,60,0,1,0
33,326,326,18,18,0,1,0
16,339,339,19,9,10,3,2
23,341,341,17,3,14,2,1
0,342,342,69,19,50,4,3
2,360,360,19,19,0,1,0
30,393,393,133,37,96,3,2
8,403,403,2,2,0,1,0
22,408,408,13,5,8,2,1
17,429,429,30,30,0,1,0
20,453,453,2,2,0,1,0
15,453,453,24,24,0,1,0
14,457,457,2,2,0,1,0
24,468,468,3,3,0,1,0
32,477,477,85,31,54,4,3
29,478,478,29,29,0,1,0
31,486,486,58,1,57,4,3
11,489,489,10,10,0,1,0
27,492,492,10,6,4,2,1

29,106,106,26,26,0,1,0
15,144,144,1,1,0,1,0
3,178,178,22,17,5,2,1
26,178,178,2,2,0,1,0
17,198,198,4,4,0,1,0
24,200,200,23,11,12,3,2
22,211,211,24,2,22,3,2
7,213,213,25,8,17,2,1
4,220,220,4,4,0,1,0
18,231,231,30,23,7,2,1
19,264,264,58,40,18,4,3
13,265,265,11,5,6,3,2
25,265,265,22,2,20,3,2
30,266,266,4,4,0,1,0
16,272,272,34,34,0,1,0
12,281,281,14,6,8,2,1
10,305,305,48,30,18,2,1
28,317,317,13,13,0,1,0
14,322,322,6,6,0,1,0
21,337,337,36,12,24,3,2
0,354,354,28,4,24,3,2
1,354,354,16,1,15,4,3
11,360,360,60,34,26,3,2
2,367,367,30,18,12,4,3
20,379,379,101,101,0,1,0
8,412,412,16,16,0,1,0
23,460,460,25,25,0,1,0
27,469,469,5,5,0,1,0
5,476,476,45,45,0,1,0
6,485,485,9,3,6,3,2
9,495,495,109,109,0,1,0

9,100,100,11,3,8,3,2
21,106,106,38,30,8,3,2
26,153,153,16,7,9,2,1
15,190,190,55,55,0,1,0
24,209,209,11,11,0,1,0
0,214,214,6,6,0,1,0
14,228,228,54,54,0,1,0
16,291,291,37,37,0,1,0
8,315,315,33,12,21,4,3
2,320,320,25,25,0,1,0
28,347,347,47,47,0,1,0
6,353,353,42,42,0,1,0
3,360,360,11,3,8,3,2
13,360,360,4,4,0,1,0
18,380,380,79,57,22,3,2
19,394,394,8,8,0,1,0
12,402,402,46,46,0,1,0
20,408,408,2,2,0,1,0
1,408,408,19,3,16,3,2
22,415,415,5,5,0,1,0
7,429,429,68,2,66,4,3
27,461,461,18,6,12,2,1
5,476,476,39,39,0,1,0
17,484,484,5,2,3,2,1
10,489,489,61,61,0,1,0
25,492,492,32,26,6,2,1
4,496,496,54,36,18,4,3
11,498,498,24,7,17,2,1
23,499,499,1,1,0,1,0

17,127,127,19,19,0,1,0
18,138,138,7,1,6,3,2
20,187,187,4,4,0,1,0
14,189,189,15,15,0,1,0
21,205,205,37,25,12,4,3
9,208,208,7,7,0,1,0
11,219,219,21,21,0,1,0
7,232,232,4,4,0,1,0
16,238,238,35,15,20,3,2
12,241,241,68,4,64,3,2
26,281,281,8,8,0,1,0
1,296,296,55,20,35,3,2
22,311,311,27,27,0,1,0
6,312,312,25,15,10,3,2
4,314,314,23,23,0,1,0
25,345,345,12,12,0,1,0
15,372,372,2,2,0,1,0
0,376,376,19,16,3,2,1
10,381,381,34,12,22,3,2
5,381,381,23,23,0,1,0
24,383,383,13,5,8,3,2
13,395,395,28,7,21,4,3
19,402,402,2,2,0,1,0
23,427,427,26,18,8,3,2
3,432,432,15,15,0,1,0
8,443,443,7,7,0,1,0
29,444,444,59,59,0,1,0
2,451,451,102,42,60,4,3
28,467,467,9,9,0,1,0
27,495,495,235,127,108,4,3

21,146,146,2,2,0,1,0
12,152,152,2,2,0,1,0
14,169,169,7,2,5,2,1
9,175,175,7,7,0,1,0
38,184,184,15,15,0,1,0
5,188,188,18,18,0,1,0
24,220,220,11,11,0,1,0
39,224,224,1,1,0,1,0
11,230,230,4,4,0,1,0
20,244,244,12,12,0,1,0
28,245,245,9,9,0,1,0
32,258,258,39,39,0,1,0
22,272,272,22,14,8,2,1
27,275,275,51,20,31,2,1
2,277,277,11,1,10,2,1
33,283,283,34,25,9,4,3
36,289,289,44,44,0,1,0
30,311,311,67,67,0,1,0
15,316,316,16,16,0,1,0
13,320,320,6,6,0,1,0
4,320,320,1,1,0,1,0
7,332,332,43,4,39,4,3
19,347,347,1,1,0,1,0
23,350,350,12,8,4,2,1
31,372,372,12,1,11,2,1
0,378,378,1,1,0,1,0
29,378,378,39,16,23,2,1
6,415,415,16,8,8,2,1
40,430,430,17,2,15,4,3
18,432,432,9,5,4,2,1
3,435,435,9,9,0,1,0
35,450,450,14,14,0,1,0
8,451,451,8,8,0,1,0
34,466,466,34,34,0,1,0
41,475,475,111,63,48,3,2
25,477,477,47,31,16,2,1
1,478,478,3,3,0,1,0
37,479,479,71,25,46,4,3
26,481,481,14,7,7,2,1
16,483,483,63,63,0,1,0
10,485,485,33,21,12,4,3
17,499,499,51,39,12,4,3

25,108,108,34,8,26,3,2
7,109,109,6,6,0,1,0
16,116,116,19,19,0,1,0
23,134,134,2,2,0,1,0
10,138,138,11,11,0,1,0
0,158,158,14,14,0,1,0
15,160,160,31,12,19,2,1
18,177,177,9,6,3,2,1
4,180,180,49,49,0,1,0
3,246,246,9,3,6,3,2
6,280,280,1,1,0,1,0
29,290,290,8,8,0,1,0
27,305,305,11,11,0,1,0
13,319,319,8,8,0,1,0
8,329,329,29,23,6,2,1
9,344,344,30,30,0,1,0
5,353,353,12,12,0,1,0
19,381,381,4,4,0,1,0
22,384,384,2,2,0,1,0
24,398,398,49,13,36,3,2
12,399,399,44,36,8,3,2
21,424,424,35,35,0,1,0
14,444,444,38,38,0,1,0
17,449,449,103,103,0,1,0
11,464,464,48,48,0,1,0
1,477,477,66,66,0,1,0
28,479,479,2,2,0,1,0
2,480,480,1,1,0,1,0
26,490,490,110,110,0,1,0
20,500,500,72,13,59,4,3

8,110,110,25,25,0,1,0
1,113,113,26,26,0,1,0
11,132,132,17,17,0,1,0
6,140,140,7,1,6,2,1
18,171,171,27,13,14,2,1
5,177,177,27,8,19,2,1
26,180,180,13,13,0,1,0
27,185,185,55,43,12,4,3
15,189,189,11,11,0,1,0
23,199,199,11,11,0,1,0
21,251,251,60,26,34,2,1
9,254,254,3,3,0,1,0
13,289,289,3,3,0,1,0
19,310,310,46,26,20,3,2
24,315,315,50,50,0,1,0
7,321,321,9,9,0,1,0
29,330,330,32,10,22,3,2
10,358,358,7,7,0,1,0
4,359,359,81,24,57,4,3
12,372,372,17,9,8,3,2
14,379,379,31,31,0,1,0
28,396,396,8,4,4,2,1
16,409,409,4,4,0,1,0
3,435,435,32,32,0,1,0
17,445,445,6,3,3,2,1
20,453,453,19,3,16,2,1
25,459,459,27,27,0,1,0
2,466,466,20,20,0,1,0
0,472,472,7,3,4,2,1
22,476,476,27,27,0,1,0

17,103,103,4,4,0,1,0
14,118,118,10,10,0,1,0
25,131,131,26,26,0,1,0
20,132,132,9,3,6,2,1
29,140,140,9,9,0,1,0
21,142,142,12,3,9,4,3
4,178,178,3,3,0,1,0
9,179,179,14,14,0,1,0
8,183,183,9,9,0,1,0
26,225,225,36,4,32,2,1
10,228,228,30,25,5,2,1
30,244,244,24,2,22,3,2
19,265,265,2,2,0,1,0
3,271,271,28,28,0,1,0
24,279,279,12,12,0,1,0
22,302,302,80,6,74,3,2
12,315,315,22,15,7,2,1
6,317,317,11,11,0,1,0
7,328,328,21,21,0,1,0
16,329,329,20,1,19,2,1
1,373,373,64,56,8,2,1
5,381,381,120,109,11,2,1
18,398,398,5,5,0,1,0
13,406,406,36,9,27,4,3
23,428,428,134,41,93,4,3
28,435,435,25,25,0,1,0
0,457,457,6,3,3,2,1
15,461,461,4,4,0,1,0
27,477,477,10,10,0,1,0
2,489,489,27,10,17,2,1
11,492,492,27,27,0,1,0

7,106,106,4,4,0,1,0
27,107,107,1,1,0,1,0
31,116,116,1,1,0,1,0
29,196,196,32,6,26,4,3
32,197,197,26,26,0,1,0
15,199,199,21,21,0,1,0
1,203,203,2,2,0,1,0
2,210,210,40,40,0,1,0
3,218,218,28,8,20,3,2
16,224,224,4,4,0,1,0
6,230,230,50,50,0,1,0
11,233,233,10,10,0,1,0
0,237,237,16,16,0,1,0
9,249,249,5,5,0,1,0
21,257,257,5,2,3,2,1
20,267,267,22,22,0,1,0
25,293,293,21,21,0,1,0
10,322,322,22,22,0,1,0
8,350,350,2,2,0,1,0
23,366,366,56,45,11,2,1
5,392,392,41,38,3,2,1
28,400,400,2,2,0,1,0
13,405,405,32,32,0,1,0
17,420,420,29,11,18,2,1
30,436,436,34,34,0,1,0
4,455,455,8,8,0,1,0
26,459,459,146,44,102,4,3
14,463,463,81,6,75,3,2
18,466,466,20,20,0,1,0
22,470,470,15,7,8,3,2
19,479,479,113,45,68,3,2
24,486,486,61,46,15,4,3
12,500,500,1,1,0,1,0

24,106,106,13,13,0,1,0
11,107,107,36,36,0,1,0
30,110,110,11,2,9,2,1
27,112,112,2,2,0,1,0
23,161,161,29,29,0,1,0
5,190,190,24,6,18,2,1
20,199,199,1,1,0,1,0
26,209,209,34,24,10,2,1
13,250,250,4,4,0,1,0
7,270,270,54,54,0,1,0
17,295,295,11,1,10,2,1
29,307,307,6,6,0,1,0
15,320,320,27,27,0,1,0
28,328,328,11,1,10,3,2
2,334,334,1,1,0,1,0
4,334,334,8,4,4,2,1
9,334,334,20,20,0,1,0
1,347,347,32,4,28,3,2
10,349,349,1,1,0,1,0
8,357,357,36,36,0,1,0
6,360,360,38,38,0,1,0
12,370,370,17,17,0,1,0
19,399,399,2,2,0,1,0
25,407,407,97,10,87,4,3
21,437,437,28,28,0,1,0
0,445,445,2,2,0,1,0
18,446,446,189,189,0,1,0
3,453,453,33,6,27,2,1
22,455,455,9,9,0,1,0
16,460,460,34,12,22,3,2
14,466,466,24,8,16,3,2

23,116,116,1,1,0,1,0
9,138,138,11,11,0,1,0
2,149,149,14,2,12,2,1
13,152,152,35,35,0,1,0
20,175,175,17,4,13,3,2
11,208,208,3,3,0,1,0
6,221,221,93,93,0,1,0
4,223,223,4,4,0,1,0
5,230,230,10,10,0,1,0
17,251,251,176,176,0,1,0
14,263,263,9,9,0,1,0
7,269,269,59,59,0,1,0
22,270,270,9,9,0,1,0
0,282,282,10,10,0,1,0
1,285,285,64,64,0,1,0
10,328,328,16,16,0,1,0
24,341,341,20,20,0,1,0
16,415,415,19,5,14,2,1
19,418,418,26,2,24,3,2
8,436,436,71,71,0,1,0
3,452,452,25,25,0,1,0
12,471,471,21,21,0,1,0
21,475,475,11,11,0,1,0
15,485,485,32,32,0,1,0
18,498,498,5,5,0,1,0

19,101,101,5,1,4,2,1
18,145,145,21,21,0,1,0
23,147,147,8,8,0,1,0
16,152,152,8,8,0,1,0
4,216,216,41,20,21,4,3
10,228,228,13,13,0,1,0
8,254,254,1,1,0,1,0
5,289,289,26,26,0,1,0
26,308,308,6,6,0,1,0
7,316,316,160,72,88,3,2
9,324,324,11,11,0,1,0
14,325,325,72,72,0,1,0
0,338,338,51,51,0,1,0
25,340,340,22,22,0,1,0
2,376,376,16,8,8,2,1
1,377,377,33,33,0,1,0
17,377,377,72,72,0,1,0
12,386,386,27,6,21,4,3
15,398,398,9,3,6,3,2
3,407,407,62,18,44,4,3
21,411,411,16,16,0,1,0
11,416,416,1,1,0,1,0
24,432,432,11,11,0,1,0
13,451,451,22,6,16,2,1
20,469,469,120,120,0,1,0
22,486,486,112,103,9,4,3
6,493,493,7,7,0,1,0

11,159,159,18,7,11,2,1
0,207,207,4,4,0,1,0
1,211,211,44,44,0,1,0
27,228,228,17,17,0,1,0
20,228,228,26,3,23,2,1
22,244,244,9,9,0,1,0
9,260,260,35,35,0,1,0
6,261,261,20,20,0,1,0
28,292,292,22,22,0,1,0
21,299,299,12,7,5,2,1
25,301,301,87,87,0,1,0
12,308,308,2,2,0,1,0
23,324,324,6,6,0,1,0
5,345,345,75,49,26,3,2
17,353,353,36,14,22,2,1
8,355,355,20,20,0,1,0
7,358,358,23,5,18,3,2
19,361,361,136,91,45,4,3
10,361,361,33,18,15,2,1
15,362,362,27,11,16,3,2
4,370,370,66,24,42,4,3
24,390,390,16,11,5,2,1
16,398,398,40,34,6,3,2
26,471,471,26,26,0,1,0
3,472,472,35,8,27,4,3
2,474,474,15,8,7,2,1
13,476,476,1,1,0,1,0
14,478,478,61,61,0,1,0
18,489,489,13,13,0,1,0

21,102,102,1,1,0,1,0
20,113,113,9,1,8,3,2
4,133,133,8,8,0,1,0
0,138,138,1,1,0,1,0
28,141,141,4,4,0,1,0
19,142,142,4,4,0,1,0
31,146,146,25,25,0,1,0
33,149,149,20,20,0,1,0
7,158,158,16,16,0,1,0
29,181,181,15,15,0,1,0
18,198,198,14,14,0,1,0
11,201,201,33,33,0,1,0
6,239,239,5,1,4,2,1
1,261,261,21,21,0,1,0
24,272,272,7,7,0,1,0
2,277,277,23,4,19,2,1
25,282,282,69,19,50,2,1
32,287,287,14,14,0,1,0
22,287,287,65,65,0,1,0
16,314,314,41,19,22,2,1
12,328,328,30,30,0,1,0
10,351,351,27,9,18,4,3
9,369,369,101,38,63,4,3
8,407,407,36,36,0,1,0
30,420,420,65,24,41,4,3
14,430,430,3,3,0,1,0
26,442,442,31,7,24,2,1
27,457,457,61,5,56,3,2
13,457,457,27,27,0,1,0
5,466,466,4,4,0,1,0
15,468,468,3,3,0,1,0
3,474,474,9,9,0,1,0
23,483,483,11,11,0,1,0
17,492,492,14,11,3,2,1

6,105,105,1,1,0,1,0
7,117,117,1,1,0,1,0
2,156,156,19,19,0,1,0
3,166,166,5,5,0,1,0
1,231,231,61,61,0,1,0
18,233,233,1,1,0,1,0
15,237,237,5,5,0,1,0
22,244,244,62,49,13,2,1
20,301,301,13,1,12,2,1
23,336,336,21,21,0,1,0
25,350,350,65,34,31,2,1
24,368,368,9,3,6,2,1
11,369,369,64,56,8,3,2
13,372,372,13,4,9,2,1
19,375,375,2,2,0,1,0
14,380,380,22,4,18,3,2
10,391,391,22,22,0,1,0
21,412,412,29,17,12,2,1
0,447,447,24,24,0,1,0
4,453,453,11,2,9,4,3
5,459,459,38,38,0,1,0
16,476,476,247,220,27,4,3
9,485,485,233,233,0,1,0
8,486,486,47,21,26,3,2
12,486,486,39,39,0,1,0
17,486,486,30,30,0,1,0

18,106,106,1,1,0,1,0
21,118,118,9,9,0,1,0
16,125,125,31,31,0,1,0
2,154,154,9,5,4,2,1
3,159,159,6,6,0,1,0
14,172,172,14,14,0,1,0
17,174,174,10,1,9,4,3
5,177,177,68,68,0,1,0
20,182,182,14,7,7,2,1
12,187,187,18,18,0,1,0
1,193,193,11,11,0,1,0
22,268,268,2,2,0,1,0
10,274,274,19,19,0,1,0
9,283,283,120,92,28,3,2
19,295,295,44,2,42,4,3
15,303,303,17,17,0,1,0
0,307,307,7,3,4,2,1
6,309,309,64,1,63,3,2
7,312,312,46,46,0,1,0
13,324,324,4,4,0,1,0
4,383,383,155,119,36,4,3
8,440,440,36,36,0,1,0
11,456,456,35,14,21,2,1

3,108,108,1,1,0,1,0
25,137,137,6,6,0,1,0
11,139,139,44,44,0,1,0
15,155,155,37,1,36,3,2
1,177,177,55,38,17,2,1
13,181,181,5,2,3,2,1
10,185,185,17,1,16,4,3
20,190,190,8,8,0,1,0
29,196,196,10,6,4,2,1
2,205,205,8,8,0,1,0
0,209,209,1,1,0,1,0
7,209,209,5,5,0,1,0
12,212,212,16,10,6,3,2
17,238,238,41,41,0,1,0
16,238,238,6,6,0,1,0
28,275,275,10,10,0,1,0
8,293,293,3,3,0,1,0
5,300,300,15,15,0,1,0
23,303,303,19,19,0,1,0
19,311,311,66,66,0,1,0
14,317,317,40,25,15,4,3
22,335,335,6,6,0,1,0
18,354,354,39,5,34,3,2
27,380,380,32,27,5,2,1
9,421,421,11,11,0,1,0
4,421,421,22,22,0,1,0
26,437,437,49,49,0,1,0
21,461,461,121,61,60,4,3
6,487,487,1,1,0,1,0
24,496,496,98,30,68,4,3

27,112,112,18,1,17,2,1
13,134,134,8,8,0,1,0
9,147,147,3,3,0,1,0
18,167,167,19,19,0,1,0
12,174,174,34,11,23,2,1
17,181,181,44,44,0,1,0
19,185,185,23,23,0,1,0
29,191,191,3,3,0,1,0
30,224,224,5,5,0,1,0
24,225,225,2,2,0,1,0
4,227,227,1,1,0,1,0
21,228,228,27,27,0,1,0
7,246,246,1,1,0,1,0
8,256,256,22,12,10,2,1
15,270,270,11,6,5,2,1
20,287,287,43,43,0,1,0
25,306,306,25,7,18,3,2
14,326,326,36,28,8,2,1
16,327,327,117,63,54,4,3
5,372,372,65,37,28,2,1
11,373,373,15,15,0,1,0
26,375,375,99,57,42,2,1
10,378,378,85,72,13,3,2
22,390,390,10,10,0,1,0
28,401,401,13,13,0,1,0
1,407,407,1,1,0,1,0
0,424,424,2,2,0,1,0
6,426,426,6,6,0,1,0
2,439,439,12,12,0,1,0
3,451,451,15,10,5,2,1
23,451,451,31,31,0,1,0

32,119,119,8,3,5,2,1
12,128,128,7,7,0,1,0
27,129,129,20,2,18,4,3
7,135,135,5,1,4,2,1
0,136,136,3,3,0,1,0
31,143,143,3,3,0,1,0
28,172,172,46,12,34,2,1
4,177,177,37,37,0,1,0
1,206,206,13,3,10,2,1
20,207,207,12,3,9,4,3
19,210,210,4,4,0,1,0
21,228,228,16,16,0,1,0
29,239,239,57,16,41,3,2
3,240,240,30,4,26,4,3
5,252,252,3,3,0,1,0
16,257,257,22,2,20,4,3
2,259,259,6,6,0,1,0
11,279,279,62,62,0,1,0
6,290,290,5,5,0,1,0
8,292,292,13,8,5,2,1
17,321,321,9,9,0,1,0
26,327,327,8,3,5,2,1
13,331,331,42,42,0,1,0
30,378,378,66,66,0,1,0
14,379,379,22,16,6,2,1
24,405,405,41,1,40,3,2
22,428,428,7,7,0,1,0
9,443,443,76,43,33,4,3
18,447,447,22,22,0,1,0
23,447,447,7,3,4,2,1
33,449,449,21,21,0,1,0
15,467,467,11,11,0,1,0
25,469,469,83,69,14,2,1
10,499,499,5,5,0,1,0

12,100,100,10,4,6,3,2
3,110,110,40,28,12,2,1
22,114,114,2,2,0,1,0
19,130,130,7,3,4,2,1
1,134,134,1,1,0,1,0
18,137,137,3,3,0,1,0
29,143,143,10,1,9,4,3
32,167,167,45,11,34,3,2
16,178,178,10,3,7,2,1
5,185,185,8,8,0,1,0
20,199,199,4,1,3,2,1
31,202,202,4,4,0,1,0
26,208,208,28,28,0,1,0
6,214,214,40,40,0,1,0
23,242,242,2,2,0,1,0
28,246,246,7,1,6,3,2
27,248,248,18,2,16,2,1
7,257,257,4,4,0,1,0
21,260,260,15,2,13,4,3
2,261,261,37,37,0,1,0
8,265,265,17,17,0,1,0
34,312,312,70,26,44,2,1
14,331,331,4,4,0,1,0
15,340,340,5,5,0,1,0
24,367,367,12,2,10,2,1
4,416,416,4,4,0,1,0
9,434,434,8,8,0,1,0
33,434,434,49,49,0,1,0
25,440,440,95,5,90,3,2
0,446,446,3,3,0,1,0
11,450,450,8,8,0,1,0
30,467,467,81,81,0,1,0
17,487,487,21,21,0,1,0
10,487,487,36,36,0,1,0
13,496,496,65,17,48,3,2

2,111,111,14,4,10,3,2
9,127,127,3,3,0,1,0
13,158,158,5,5,0,1,0
1,174,174,17,17,0,1,0
18,192,192,21,21,0,1,0
5,206,206,24,24,0,1,0
21,235,235,16,16,0,1,0
7,243,243,134,74,60,3,2
3,250,250,51,48,3,2,1
11,293,293,64,20,44,3,2
12,298,298,23,23,0,1,0
19,327,327,50,36,14,2,1
14,330,330,33,24,9,2,1
20,341,341,2,2,0,1,0
0,368,368,73,32,41,2,1
16,370,370,67,20,47,3,2
10,405,405,132,111,21,4,3
17,415,415,46,25,21,2,1
4,429,429,20,20,0,1,0
8,433,433,3,3,0,1,0
15,458,458,7,7,0,1,0
6,494,494,30,30,0,1,0

13,125,125,7,1,6,2,1
25,126,126,4,4,0,1,0
23,159,159,19,2,17,2,1
18,165,165,7,7,0,1,0
15,201,201,28,28,0,1,0
5,227,227,47,47,0,1,0
14,303,303,23,23,0,1,0
0,314,314,12,2,10,2,1
16,343,343,15,15,0,1,0
19,344,344,80,36,44,2,1
24,369,369,23,18,5,2,1
10,372,372,26,26,0,1,0
11,377,377,18,18,0,1,0
7,408,408,29,1,28,3,2
22,415,415,4,4,0,1,0
9,419,419,63,63,0,1,0
17,426,426,19,7,12,2,1
8,438,438,139,34,105,4,3
4,440,440,13,4,9,4,3
2,444,444,25,25,0,1,0
21,457,457,65,65,0,1,0
1,462,462,63,53,10,3,2
6,464,464,57,57,0,1,0
12,487,487,43,19,24,2,1
3,495,495,77,68,9,4,3
20,497,497,171,171,0,1,0

11,101,101,1,1,0,1,0
28,115,115,11,2,9,2,1
0,122,122,5,5,0,1,0
17,132,132,2,2,0,1,0
24,138,138,39,6,33,4,3
4,147,147,4,4,0,1,0
13,154,154,27,7,20,2,1
31,161,161,20,20,0,1,0
22,178,178,2,2,0,1,0
8,192,192,8,8,0,1,0
5,240,240,26,26,0,1,0
10,244,244,53,53,0,1,0
30,252,252,67,22,45,2,1
16,261,261,16,7,9,4,3
2,269,269,26,26,0,1,0
7,289,289,9,9,0,1,0
3,291,291,90,90,0,1,0
20,319,319,19,9,10,3,2
32,343,343,9,9,0,1,0
9,344,344,4,4,0,1,0
27,350,350,31,31,0,1,0
15,366,366,7,7,0,1,0
19,388,388,14,14,0,1,0
26,390,390,62,62,0,1,0
12,419,419,7,7,0,1,0
1,421,421,4,1,3,2,1
18,433,433,41,41,0,1,0
14,435,435,34,3,31,4,3
6,441,441,16,16,0,1,0
21,470,470,31,10,21,4,3
29,477,477,3,3,0,1,0
23,478,478,22,2,20,3,2
25,487,487,75,75,0,1,0

29,102,102,5,5,0,1,0
15,105,105,7,3,4,2,1
9,118,118,6,6,0,1,0
12,132,132,1,1,0,1,0
21,137,137,4,4,0,1,0
18,168,168,3,3,0,1,0
5,179,179,23,23,0,1,0
14,187,187,5,5,0,1,0
27,204,204,43,36,7,2,1
16,210,210,11,11,0,1,0
28,215,215,57,12,45,4,3
3,226,226,4,4,0,1,0
26,227,227,1,1,0,1,0
2,264,264,1,1,0,1,0
25,266,266,6,2,4,2,1
0,266,266,40,14,26,2,1
20,273,273,8,8,0,1,0
22,281,281,6,6,0,1,0
10,293,293,130,47,83,4,3
4,295,295,6,3,3,2,1
24,297,297,16,16,0,1,0
19,306,306,120,66,54,4,3
32,309,309,15,15,0,1,0
17,322,322,17,17,0,1,0
7,324,324,28,28,0,1,0
30,413,413,99,99,0,1,0
8,429,429,11,11,0,1,0
1,433,433,46,46,0,1,0
6,452,452,6,6,0,1,0
31,461,461,18,7,11,2,1
11,473,473,58,43,15,4,3
23,484,484,13,13,0,1,0
13,495,495,5,5,0,1,0

5,105,105,3,3,0,1,0
4,158,158,4,4,0,1,0
23,162,162,1,1,0,1,0
11,163,163,53,53,0,1,0
21,174,174,9,9,0,1,0
15,191,191,45,21,24,2,1
19,192,192,2,2,0,1,0
18,203,203,46,46,0,1,0
12,238,238,6,3,3,2,1
2,243,243,15,15,0,1,0
13,264,264,16,2,14,3,2
1,264,264,99,36,63,4,3
16,271,271,43,43,0,1,0
14,275,275,1,1,0,1,0
8,277,277,27,27,0,1,0
0,290,290,8,4,4,2,1
17,298,298,78,78,0,1,0
3,348,348,43,43,0,1,0
6,356,356,2,2,0,1,0
22,401,401,6,6,0,1,0
25,408,408,46,35,11,2,1
9,416,416,30,4,26,2,1
20,450,450,105,95,10,2,1
10,454,454,33,30,3,2,1
24,466,466,16,10,6,2,1
7,485,485,92,92,0,1,0

17,100,100,7,7,0,1,0
11,101,101,13,13,0,1,0
9,101,101,16,16,0,1,0
20,110,110,31,13,18,2,1
19,121,121,17,10,7,2,1
22,134,134,21,9,12,4,3
13,136,136,13,13,0,1,0
24,142,142,18,9,9,2,1
10,163,163,1,1,0,1,0
4,166,166,13,13,0,1,0
18,172,172,1,1,0,1,0
6,190,190,1,1,0,1,0
8,205,205,4,4,0,1,0
2,242,242,49,49,0,1,0
14,255,255,1,1,0,1,0
25,264,264,2,2,0,1,0
0,317,317,28,28,0,1,0
26,318,318,62,62,0,1,0
21,318,318,5,5,0,1,0
16,342,342,45,45,0,1,0
12,344,344,5,1,4,2,1
23,353,353,1,1,0,1,0
28,359,359,17,17,0,1,0
3,398,398,45,11,34,3,2
7,404,404,84,73,11,2,1
5,408,408,25,25,0,1,0
15,414,414,97,97,0,1,0
27,432,432,6,6,0,1,0
1,439,439,96,63,33,4,3

8,151,151,13,3,10,3,2
24,164,164,4,1,3,2,1
25,168,168,8,1,7,2,1
22,168,168,11,11,0,1,0
28,177,177,14,1,13,2,1
0,190,190,1,1,0,1,0
33,204,204,36,36,0,1,0
7,212,212,17,17,0,1,0
30,218,218,44,44,0,1,0
3,257,257,12,12,0,1,0
9,262,262,12,2,10,3,2
16,270,270,42,9,33,4,3
13,273,273,7,7,0,1,0
27,287,287,21,9,12,4,3
20,289,289,95,95,0,1,0
19,291,291,35,35,0,1,0
14,301,301,6,6,0,1,0
2,310,310,2,2,0,1,0
17,317,317,9,9,0,1,0
12,329,329,15,15,0,1,0
4,347,347,36,19,17,4,3
15,352,352,32,32,0,1,0
10,354,354,8,5,3,2,1
23,365,365,31,31,0,1,0
32,368,368,23,2,21,3,2
21,385,385,8,8,0,1,0
6,389,389,63,7,56,3,2
18,417,417,1,1,0,1,0
11,417,417,124,37,87,4,3
26,444,444,61,61,0,1,0
31,450,450,18,18,0,1,0
5,451,451,17,17,0,1,0
29,464,464,37,37,0,1,0
1,469,469,9,4,5,2,1

22,102,102,3,3,0,1,0
8,109,109,2,2,0,1,0
23,110,110,2,2,0,1,0
7,111,111,8,8,0,1,0
26,113,113,32,6,26,2,1
14,121,121,3,3,0,1,0
6,136,136,25,25,0,1,0
2,152,152,23,15,8,2,1
17,171,171,5,5,0,1,0
16,183,183,15,4,11,2,1
11,214,214,16,1,15,2,1
21,243,243,103,103,0,1,0
1,251,251,17,7,10,3,2
12,252,252,2,2,0,1,0
20,278,278,13,13,0,1,0
18,316,316,4,4,0,1,0
10,326,326,17,1,16,4,3
9,349,349,57,46,11,2,1
3,382,382,46,3,43,2,1
25,398,398,24,24,0,1,0
27,403,403,45,45,0,1,0
4,425,425,7,1,6,2,1
13,446,446,38,33,5,2,1
5,453,453,68,68,0,1,0
0,460,460,109,109,0,1,0
19,483,483,9,3,6,3,2
15,497,497,127,13,114,4,3
24,498,498,17,10,7,3,2

15,100,100,3,3,0,1,0
0,110,110,2,2,0,1,0
25,111,111,8,8,0,1,0
27,113,113,11,7,4,2,1
26,149,149,20,5,15,2,1
4,158,158,17,17,0,1,0
12,180,180,21,7,14,3,2
1,208,208,7,1,6,2,1
6,219,219,64,28,36,4,3
24,221,221,14,14,0,1,0
7,222,222,38,28,10,2,1
13,250,250,10,10,0,1,0
19,257,257,46,46,0,1,0
17,273,273,7,7,0,1,0
3,314,314,1,1,0,1,0
8,316,316,46,4,42,4,3
22,318,318,28,21,7,2,1
21,320,320,39,39,0,1,0
18,329,329,33,12,21,2,1
14,333,333,75,36,39,3,2
10,344,344,18,1,17,2,1
2,354,354,38,2,36,4,3
16,362,362,36,22,14,3,2
20,383,383,43,6,37,2,1
23,384,384,33,33,0,1,0
5,398,398,34,7,27,2,1
9,442,442,26,22,4,2,1
11,459,459,78,78,0,1,0

6,103,103,2,2,0,1,0
15,151,151,4,4,0,1,0
12,181,181,39,39,0,1,0
23,195,195,14,4,10,3,2
4,208,208,52,52,0,1,0
18,228,228,10,10,0,1,0
7,235,235,44,44,0,1,0
19,259,259,10,10,0,1,0
21,282,282,42,42,0,1,0
22,312,312,51,37,14,2,1
14,320,320,49,21,28,2,1
8,323,323,22,22,0,1,0
25,342,342,17,4,13,2,1
11,350,350,37,5,32,2,1
17,359,359,32,3,29,2,1
13,386,386,19,19,0,1,0
9,394,394,8,8,0,1,0
1,398,398,40,26,14,2,1
0,434,434,131,94,37,4,3
5,447,447,23,23,0,1,0
3,460,460,28,28,0,1,0
16,473,473,115,83,32,3,2
2,492,492,56,56,0,1,0
20,494,494,1,1,0,1,0
10,496,496,61,38,23,2,1
24,497,497,68,68,0,1,0

0,103,103,3,3,0,1,0
11,103,103,6,3,3,2,1
13,125,125,10,5,5,2,1
30,129,129,7,7,0,1,0
9,139,139,3,3,0,1,0
18,140,140,3,3,0,1,0
3,145,145,30,12,18,3,2
4,160,160,8,1,7,2,1
15,164,164,15,9,6,3,2
23,183,183,27,24,3,2,1
20,187,187,5,5,0,1,0
16,215,215,32,2,30,2,1
19,219,219,14,11,3,2,1
22,278,278,1,1,0,1,0
24,307,307,3,3,0,1,0
17,329,329,32,32,0,1,0
7,331,331,1,1,0,1,0
31,337,337,46,14,32,2,1
26,341,341,49,7,42,3,2
14,346,346,29,23,6,2,1
8,352,352,14,14,0,1,0
25,386,386,53,26,27,2,1
1,403,403,37,3,34,3,2
29,416,416,5,2,3,2,1
10,428,428,12,12,0,1,0
6,433,433,65,65,0,1,0
12,438,438,5,2,3,2,1
2,445,445,29,29,0,1,0
21,450,450,35,11,24,4,3
28,472,472,218,218,0,1,0
27,473,473,60,54,6,3,2
5,480,480,70,10,60,3,2

0,142,142,25,3,22,2,1
12,174,174,11,4,7,2,1
27,193,193,48,10,38,3,2
4,196,196,23,7,16,3,2
23,217,217,24,21,3,2,1
25,232,232,12,12,0,1,0
9,252,252,10,2,8,2,1
1,267,267,71,71,0,1,0
10,309,309,22,22,0,1,0
20,314,314,86,44,42,4,3
5,341,341,24,17,7,2,1
6,357,357,9,1,8,3,2
2,363,363,14,6,8,2,1
24,365,365,16,16,0,1,0
3,385,385,66,66,0,1,0
21,395,395,7,7,0,1,0
7,399,399,7,7,0,1,0
18,404,404,13,2,11,2,1
26,407,407,9,2,7,2,1
22,418,418,15,15,0,1,0
16,419,419,136,136,0,1,0
15,420,420,6,6,0,1,0
19,432,432,43,9,34,3,2
14,433,433,48,48,0,1,0
13,435,435,3,3,0,1,0
11,441,441,41,23,18,3,2
17,446,446,14,7,7,2,1
8,472,472,115,115,0,1,0

8,132,132,10,10,0,1,0
24,144,144,34,30,4,2,1
0,155,155,11,2,9,2,1
21,171,171,4,1,3,2,1
5,172,172,17,17,0,1,0
12,172,172,41,41,0,1,0
31,173,173,5,5,0,1,0
13,183,183,12,12,0,1,0
20,186,186,12,6,6,2,1
7,193,193,4,4,0,1,0
17,193,193,4,4,0,1,0
14,200,200,13,5,8,2,1
26,213,213,90,59,31,4,3
28,270,270,3,3,0,1,0
30,276,276,22,22,0,1,0
16,278,278,1,1,0,1,0
4,292,292,21,21,0,1,0
32,316,316,32,32,0,1,0
27,356,356,13,13,0,1,0
29,377,377,12,3,9,2,1
3,380,380,62,49,13,2,1
1,388,388,75,53,22,2,1
9,394,394,3,3,0,1,0
23,405,405,20,20,0,1,0
25,435,435,71,71,0,1,0
6,437,437,6,2,4,2,1
2,452,452,42,9,33,2,1
10,458,458,3,3,0,1,0
18,476,476,11,11,0,1,0
15,478,478,38,38,0,1,0
11,485,485,43,43,0,1,0
19,487,487,69,69,0,1,0
22,496,496,18,18,0,1,0

9,116,116,14,14,0,1,0
24,147,147,7,1,6,2,1
14,150,150,7,7,0,1,0
23,165,165,14,14,0,1,0
1,167,167,27,15,12,3,2
27,202,202,67,67,0,1,0
6,206,206,22,5,17,4,3
15,224,224,15,15,0,1,0
7,235,235,53,53,0,1,0
25,245,245,2,2,0,1,0
5,271,271,31,3,28,2,1
10,284,284,8,8,0,1,0
13,291,291,13,4,9,4,3
0,312,312,12,1,11,2,1
17,323,323,97,97,0,1,0
8,324,324,6,6,0,1,0
12,326,326,4,4,0,1,0
11,331,331,3,3,0,1,0
26,336,336,3,3,0,1,0
22,339,339,29,26,3,2,1
18,345,345,27,17,10,3,2
28,363,363,43,19,24,3,2
29,366,366,35,11,24,3,2
19,387,387,91,91,0,1,0
3,393,393,2,2,0,1,0
16,408,408,3,3,0,1,0
21,412,412,7,7,0,1,0
20,427,427,4,1,3,2,1
4,444,444,7,2,5,2,1
2,457,457,178,158,20,3,2

7,127,127,6,6,0,1,0
13,167,167,4,4,0,1,0
22,172,172,14,6,8,2,1
11,175,175,54,48,6,3,2
0,179,179,60,28,32,2,1
21,179,179,1,1,0,1,0
18,243,243,10,10,0,1,0
8,244,244,11,11,0,1,0
2,259,259,45,10,35,3,2
12,278,278,40,6,34,3,2
9,289,289,8,8,0,1,0
16,299,299,2,2,0,1,0
1,326,326,31,4,27,4,3
17,344,344,22,22,0,1,0
24,347,347,45,3,42,2,1
15,366,366,67,9,58,3,2
5,379,379,28,2,26,2,1
23,396,396,114,93,21,4,3
3,397,397,131,128,3,2,1
19,410,410,7,7,0,1,0
4,444,444,8,8,0,1,0
20,445,445,8,8,0,1,0
10,491,491,46,46,0,1,0
6,495,495,80,59,21,4,3
14,500,500,59,59,0,1,0

15,117,117,1,1,0,1,0
10,134,134,4,4,0,1,0
24,136,136,17,17,0,1,0
5,139,139,6,6,0,1,0
19,140,140,7,2,5,2,1
33,152,152,15,9,6,2,1
1,169,169,5,5,0,1,0
27,180,180,2,2,0,1,0
32,209,209,1,1,0,1,0
25,228,228,13,10,3,2,1
36,230,230,8,8,0,1,0
35,241,241,84,84,0,1,0
21,245,245,7,7,0,1,0
17,248,248,22,22,0,1,0
38,282,282,43,43,0,1,0
20,298,298,22,7,15,2,1
12,323,323,7,7,0,1,0
28,362,362,23,15,8,2,1
3,377,377,18,18,0,1,0
0,380,380,72,72,0,1,0
16,386,386,19,19,0,1,0
18,412,412,12,2,10,2,1
29,415,415,8,3,5,2,1
2,421,421,19,19,0,1,0
31,422,422,37,37,0,1,0
14,424,424,78,66,12,3,2
13,439,439,14,3,11,2,1
9,452,452,9,9,0,1,0
8,454,454,30,9,21,2,1
6,458,458,9,4,5,2,1
26,467,467,197,140,57,4,3
30,469,469,38,38,0,1,0
22,473,473,9,3,6,3,2
23,474,474,12,9,3,2,1
4,475,475,7,3,4,2,1
37,486,486,5,5,0,1,0
39,489,489,33,15,18,3,2
34,491,491,13,13,0,1,0
7,495,495,26,26,0,1,0
11,497,497,27,10,17,2,1

25,105,105,4,4,0,1,0
12,112,112,7,7,0,1,0
18,136,136,9,9,0,1,0
24,136,136,42,42,0,1,0
22,139,139,43,16,27,2,1
15,183,183,18,11,7,2,1
10,191,191,11,11,0,1,0
16,202,202,3,3,0,1,0
4,214,214,1,1,0,1,0
0,224,224,9,9,0,1,0
14,224,224,4,4,0,1,0
7,235,235,67,67,0,1,0
3,241,241,21,12,9,4,3
28,265,265,17,17,0,1,0
13,279,279,40,12,28,4,3
23,281,281,95,23,72,4,3
21,284,284,17,17,0,1,0
29,288,288,4,1,3,2,1
11,314,314,45,45,0,1,0
1,316,316,16,7,9,2,1
17,320,320,4,4,0,1,0
19,353,353,5,5,0,1,0
9,366,366,39,12,27,2,1
27,373,373,24,24,0,1,0
26,412,412,12,12,0,1,0
8,416,416,6,6,0,1,0
20,427,427,41,5,36,4,3
6,431,431,31,31,0,1,0
5,443,443,16,3,13,2,1
2,460,460,83,83,0,1,0

12,116,116,5,5,0,1,0
20,177,177,7,7,0,1,0
10,182,182,24,24,0,1,0
22,186,186,11,11,0,1,0
15,214,214,13,13,0,1,0
3,216,216,131,105,26,4,3
18,220,220,2,2,0,1,0
11,265,265,12,12,0,1,0
6,266,266,87,39,48,2,1
19,274,274,23,23,0,1,0
17,284,284,36,8,28,2,1
16,319,319,59,59,0,1,0
7,320,320,4,1,3,2,1
2,333,333,12,7,5,2,1
21,348,348,39,39,0,1,0
9,367,367,5,5,0,1,0
5,402,402,10,10,0,1,0
1,404,404,51,51,0,1,0
14,412,412,87,40,47,3,2
4,433,433,24,24,0,1,0
13,447,447,142,115,27,4,3
25,458,458,33,33,0,1,0
23,464,464,32,32,0,1,0
8,480,480,7,7,0,1,0
24,484,484,18,18,0,1,0
0,492,492,4,4,0,1,0

2,115,115,3,3,0,1,0
1,131,131,1,1,0,1,0
8,136,136,8,8,0,1,0
9,145,145,11,11,0,1,0
25,153,153,6,2,4,2,1
5,166,166,4,4,0,1,0
12,170,170,37,37,0,1,0
11,187,187,32,1,31,4,3
18,204,204,7,3,4,2,1
21,211,211,27,1,26,2,1
15,251,251,3,3,0,1,0
23,266,266,13,7,6,2,1
17,267,267,37,5,32,3,2
19,285,285,53,11,42,3,2
4,295,295,79,79,0,1,0
22,297,297,77,77,0,1,0
24,316,316,17,4,13,3,2
16,321,321,49,49,0,1,0
27,357,357,16,4,12,2,1
28,397,397,27,17,10,3,2
7,408,408,102,52,50,4,3
6,418,418,50,14,36,3,2
3,423,423,2,2,0,1,0
20,440,440,101,42,59,4,3
0,444,444,21,21,0,1,0
10,449,449,5,5,0,1,0
26,478,478,14,2,12,4,3
13,489,489,45,45,0,1,0
14,500,500,14,14,0,1,0

20,104,104,8,8,0,1,0
2,124,124,4,4,0,1,0
28,141,141,14,14,0,1,0
1,152,152,6,6,0,1,0
5,161,161,15,4,11,4,3
34,162,162,36,15,21,2,1
24,168,168,16,7,9,3,2
33,172,172,21,12,9,4,3
22,215,215,49,29,20,4,3
9,226,226,22,22,0,1,0
15,226,226,49,49,0,1,0
21,227,227,20,6,14,3,2
31,234,234,10,3,7,2,1
29,237,237,6,6,0,1,0
14,243,243,12,8,4,2,1
6,265,265,1,1,0,1,0
0,270,270,31,13,18,4,3
11,278,278,16,9,7,2,1
8,286,286,32,32,0,1,0
32,289,289,12,12,0,1,0
26,303,303,48,48,0,1,0
19,305,305,21,21,0,1,0
16,308,308,26,11,15,2,1
23,339,339,29,13,16,4,3
12,355,355,51,24,27,2,1
7,387,387,13,13,0,1,0
18,414,414,52,35,17,2,1
13,422,422,1,1,0,1,0
10,426,426,1,1,0,1,0
30,434,434,83,46,37,2,1
4,445,445,2,2,0,1,0
17,445,445,4,4,0,1,0
3,467,467,17,17,0,1,0
27,470,470,7,7,0,1,0
25,478,478,7,1,6,3,2

0,105,105,8,8,0,1,0
25,114,114,37,17,20,3,2
26,135,135,9,9,0,1,0
20,144,144,2,2,0,1,0
8,150,150,3,3,0,1,0
30,155,155,13,1,12,4,3
31,170,170,12,12,0,1,0
21,173,173,2,2,0,1,0
19,190,190,71,37,34,2,1
14,193,193,7,7,0,1,0
4,195,195,5,5,0,1,0
10,200,200,17,8,9,4,3
1,209,209,1,1,0,1,0
24,209,209,1,1,0,1,0
18,238,238,2,2,0,1,0
27,270,270,14,5,9,2,1
7,277,277,16,8,8,2,1
9,298,298,17,17,0,1,0
17,311,311,63,1,62,3,2
23,318,318,19,19,0,1,0
32,329,329,1,1,0,1,0
29,353,353,67,55,12,4,3
15,353,353,6,6,0,1,0
28,387,387,38,38,0,1,0
11,401,401,97,77,20,2,1
16,416,416,40,31,9,2,1
3,437,437,8,1,7,2,1
12,460,460,48,31,17,2,1
13,462,462,63,63,0,1,0
2,476,476,38,10,28,3,2
22,483,483,37,37,0,1,0
5,492,492,39,39,0,1,0
6,499,499,27,13,14,3,2

21,108,108,6,6,0,1,0
0,120,120,9,9,0,1,0
7,160,160,57,57,0,1,0
22,190,190,24,24,0,1,0
5,268,268,3,3,0,1,0
3,272,272,47,41,6,3,2
11,273,273,3,3,0,1,0
17,300,300,93,7,86,4,3
10,301,301,45,45,0,1,0
19,329,329,4,4,0,1,0
8,334,334,59,12,47,2,1
2,335,335,42,3,39,2,1
18,340,340,78,78,0,1,0
1,351,351,49,1,48,3,2
9,370,370,8,2,6,3,2
12,372,372,5,5,0,1,0
16,374,374,14,11,3,2,1
14,377,377,26,8,18,2,1
6,386,386,33,33,0,1,0
15,390,390,62,62,0,1,0
23,392,392,24,24,0,1,0
20,426,426,78,78,0,1,0
4,432,432,34,23,11,2,1
24,438,438,30,9,21,4,3
25,458,458,28,23,5,2,1
13,495,495,15,9,6,3,2

11,112,112,17,17,0,1,0
27,151,151,13,3,10,2,1
7,153,153,67,29,38,3,2
20,157,157,5,5,0,1,0
30,175,175,23,23,0,1,0
5,191,191,30,18,12,4,3
19,215,215,14,14,0,1,0
1,224,224,11,2,9,2,1
14,228,228,9,4,5,2,1
8,248,248,11,4,7,2,1
21,263,263,52,39,13,2,1
31,293,293,101,17,84,4,3
10,300,300,3,3,0,1,0
24,313,313,66,18,48,3,2
26,315,315,2,2,0,1,0
17,327,327,8,8,0,1,0
15,334,334,4,4,0,1,0
25,349,349,12,3,9,2,1
9,356,356,4,1,3,2,1
2,365,365,42,6,36,3,2
22,383,383,44,44,0,1,0
23,391,391,41,20,21,4,3
13,399,399,6,6,0,1,0
4,408,408,19,9,10,3,2
16,409,409,1,1,0,1,0
12,409,409,84,84,0,1,0
3,425,425,30,30,0,1,0
18,433,433,19,19,0,1,0
6,449,449,1,1,0,1,0
29,469,469,24,5,19,4,3
0,473,473,3,3,0,1,0
28,483,483,5,5,0,1,0

32,100,100,10,10,0,1,0
21,120,120,1,1,0,1,0
6,124,124,11,5,6,3,2
33,125,125,4,1,3,2,1
28,126,126,1,1,0,1,0
23,141,141,7,2,5,2,1
24,146,146,7,7,0,1,0
4,180,180,8,1,7,2,1
31,182,182,13,4,9,4,3
12,197,197,35,35,0,1,0
35,199,199,16,16,0,1,0
1,213,213,42,42,0,1,0
7,224,224,1,1,0,1,0
11,227,227,1,1,0,1,0
16,228,228,37,37,0,1,0
18,229,229,3,3,0,1,0
2,240,240,5,5,0,1,0
3,262,262,8,4,4,2,1
36,264,264,50,18,32,4,3
8,264,264,37,37,0,1,0
25,275,275,88,54,34,3,2
29,290,290,5,5,0,1,0
14,316,316,4,4,0,1,0
22,364,364,2,2,0,1,0
19,372,372,38,4,34,3,2
30,377,377,19,19,0,1,0
10,378,378,18,10,8,3,2
15,400,400,35,26,9,4,3
20,402,402,69,58,11,2,1
0,404,404,2,2,0,1,0
34,423,423,84,56,28,2,1
17,426,426,1,1,0,1,0
27,427,427,51,19,32,2,1
26,454,454,64,56,8,3,2
9,477,477,9,9,0,1,0
5,479,479,6,6,0,1,0
13,481,481,21,7,14,2,1

6,126,126,3,3,0,1,0
13,134,134,16,16,0,1,0
10,161,161,8,2,6,3,2
4,178,178,30,18,12,4,3
21,183,183,3,3,0,1,0
3,195,195,4,4,0,1,0
2,203,203,42,15,27,2,1
0,208,208,45,23,22,2,1
17,241,241,37,37,0,1,0
9,298,298,60,41,19,2,1
18,302,302,6,3,3,2,1
7,319,319,44,44,0,1,0
20,325,325,82,45,37,4,3
14,337,337,10,10,0,1,0
1,341,341,204,96,108,4,3
15,344,344,43,43,0,1,0
11,375,375,4,4,0,1,0
5,380,380,8,8,0,1,0
16,420,420,7,7,0,1,0
12,426,426,59,59,0,1,0
19,456,456,108,12,96,3,2
8,472,472,4,4,0,1,0
22,490,490,28,13,15,2,1

0,140,140,16,16,0,1,0
14,163,163,5,1,4,2,1
7,176,176,6,6,0,1,0
19,192,192,3,3,0,1,0
15,193,193,6,6,0,1,0
28,224,224,29,5,24,4,3
36,230,230,42,9,33,4,3
4,271,271,15,15,0,1,0
8,275,275,11,11,0,1,0
30,288,288,74,68,6,3,2
33,292,292,56,19,37,2,1
3,295,295,73,58,15,4,3
9,297,297,6,6,0,1,0
13,298,298,18,18,0,1,0
20,301,301,9,9,0,1,0
25,307,307,9,9,0,1,0
1,310,310,13,13,0,1,0
21,339,339,1,1,0,1,0
23,353,353,43,18,25,4,3
11,353,353,5,5,0,1,0
12,362,362,35,35,0,1,0
10,377,377,11,5,6,3,2
17,379,379,53,31,22,3,2
35,390,390,5,5,0,1,0
6,397,397,36,36,0,1,0
27,397,397,68,38,30,4,3
16,399,399,50,50,0,1,0
22,400,400,35,14,21,2,1
24,402,402,61,61,0,1,0
5,402,402,7,3,4,2,1
32,416,416,17,5,12,2,1
18,425,425,7,7,0,1,0
31,427,427,2,2,0,1,0
34,441,441,8,8,0,1,0
2,451,451,27,27,0,1,0
26,456,456,13,13,0,1,0
29,462,462,39,18,21,4,3

27,128,128,3,3,0,1,0
20,150,150,3,3,0,1,0
25,151,151,6,1,5,2,1
32,197,197,16,6,10,3,2
18,199,199,13,4,9,4,3
22,214,214,8,2,6,2,1
16,232,232,13,13,0,1,0
12,251,251,32,14,18,4,3
36,257,257,8,8,0,1,0
15,277,277,4,4,0,1,0
0,282,282,13,13,0,1,0
11,283,283,3,3,0,1,0
38,285,285,18,18,0,1,0
5,291,291,21,9,12,3,2
3,295,295,4,1,3,2,1
29,305,305,15,4,11,2,1
24,318,318,1,1,0,1,0
9,320,320,2,2,0,1,0
33,327,327,106,19,87,4,3
34,336,336,83,44,39,4,3
17,345,345,34,17,17,2,1
1,346,346,2,2,0,1,0
7,349,349,33,21,12,2,1
19,353,353,25,25,0,1,0
13,372,372,11,4,7,2,1
30,373,373,72,72,0,1,0
37,386,386,30,30,0,1,0
2,391,391,16,13,3,2,1
31,433,433,17,5,12,3,2
14,434,434,61,61,0,1,0
10,435,435,4,1,3,2,1
26,436,436,50,18,32,2,1
6,444,444,2,2,0,1,0
21,446,446,2,2,0,1,0
8,454,454,89,27,62,4,3
23,464,464,76,25,51,4,3
4,468,468,33,33,0,1,0
28,497,497,43,29,14,2,1
35,498,498,28,28,0,1,0

8,147,147,8,2,6,2,1
20,173,173,1,1,0,1,0
6,178,178,39,39,0,1,0
2,181,181,12,12,0,1,0
3,203,203,32,32,0,1,0
0,205,205,18,14,4,2,1
10,226,226,6,6,0,1,0
11,227,227,1,1,0,1,0
23,230,230,43,13,30,4,3
13,234,234,48,48,0,1,0
24,250,250,15,15,0,1,0
25,265,265,1,1,0,1,0
26,308,308,1,1,0,1,0
7,320,320,62,6,56,3,2
5,327,327,1,1,0,1,0
17,336,336,24,24,0,1,0
16,343,343,57,57,0,1,0
12,359,359,127,50,77,4,3
4,371,371,41,41,0,1,0
9,374,374,36,16,20,2,1
18,383,383,37,3,34,2,1
15,407,407,92,6,86,3,2
21,419,419,34,6,28,3,2
19,423,423,38,38,0,1,0
22,444,444,87,87,0,1,0
1,448,448,12,3,9,2,1
14,496,496,15,15,0,1,0

18,104,104,1,1,0,1,0
23,117,117,2,2,0,1,0
8,123,123,15,15,0,1,0
22,134,134,14,2,12,3,2
10,173,173,1,1,0,1,0
17,182,182,3,3,0,1,0
4,184,184,2,2,0,1,0
7,200,200,2,2,0,1,0
19,228,228,7,7,0,1,0
13,229,229,2,2,0,1,0
15,262,262,1,1,0,1,0
11,265,265,35,21,14,2,1
16,268,268,36,36,0,1,0
3,268,268,15,15,0,1,0
6,269,269,108,27,81,4,3
0,282,282,28,13,15,4,3
26,287,287,58,58,0,1,0
34,290,290,29,15,14,2,1
5,323,323,20,5,15,4,3
24,334,334,21,21,0,1,0
25,337,337,57,36,21,4,3
28,338,338,5,5,0,1,0
30,348,348,15,3,12,4,3
12,349,349,53,53,0,1,0
21,358,358,20,16,4,2,1
1,386,386,18,18,0,1,0
27,392,392,112,112,0,1,0
14,401,401,7,7,0,1,0
32,420,420,112,112,0,1,0
31,423,423,3,3,0,1,0
9,434,434,2,2,0,1,0
2,439,439,1,1,0,1,0
33,475,475,27,27,0,1,0
29,492,492,24,24,0,1,0
20,494,494,37,19,18,3,2

3,121,121,22,1,21,2,1
22,132,132,19,15,4,2,1
14,186,186,6,6,0,1,0
1,190,190,4,4,0,1,0
10,205,205,1,1,0,1,0
15,209,209,31,20,11,2,1
5,216,216,25,25,0,1,0
6,219,219,35,35,0,1,0
23,224,224,25,1,24,2,1
2,239,239,38,12,26,2,1
13,246,246,7,7,0,1,0
9,246,246,22,11,11,2,1
21,255,255,33,33,0,1,0
8,257,257,2,2,0,1,0
25,267,267,39,39,0,1,0
12,306,306,87,20,67,4,3
20,307,307,6,1,5,2,1
4,332,332,3,3,0,1,0
16,348,348,14,3,11,2,1
7,363,363,10,1,9,4,3
18,368,368,5,2,3,2,1
24,390,390,93,30,63,4,3
11,402,402,39,28,11,2,1
19,435,435,23,23,0,1,0
0,464,464,114,114,0,1,0
26,471,471,134,93,41,4,3
17,500,500,18,18,0,1,0

21,121,121,1,1,0,1,0
5,138,138,10,10,0,1,0
1,147,147,11,11,0,1,0
15,147,147,3,3,0,1,0
27,163,163,66,29,37,4,3
10,173,173,31,31,0,1,0
12,186,186,18,18,0,1,0
28,190,190,16,16,0,1,0
11,240,240,7,7,0,1,0
26,252,252,11,2,9,4,3
19,255,255,13,4,9,2,1
25,278,278,11,11,0,1,0
4,282,282,37,37,0,1,0
3,284,284,10,10,0,1,0
22,287,287,52,23,29,2,1
9,311,311,11,1,10,3,2
16,329,329,3,3,0,1,0
23,339,339,16,6,10,2,1
17,380,380,9,9,0,1,0
0,381,381,26,26,0,1,0
6,412,412,98,52,46,3,2
8,412,412,57,14,43,4,3
24,417,417,196,164,32,2,1
14,422,422,1,1,0,1,0
2,426,426,36,22,14,2,1
7,430,430,39,3,36,2,1
18,439,439,3,3,0,1,0
13,439,439,55,55,0,1,0
20,462,462,18,10,8,3,2

22,113,113,30,30,0,1,0
13,125,125,17,14,3,2,1
16,130,130,26,21,5,2,1
25,159,159,44,11,33,4,3
0,164,164,39,11,28,4,3
6,182,182,42,42,0,1,0
9,182,182,24,2,22,3,2
27,199,199,7,1,6,2,1
3,212,212,14,14,0,1,0
21,213,213,25,3,22,3,2
17,213,213,18,18,0,1,0
4,219,219,25,4,21,2,1
12,234,234,1,1,0,1,0
2,261,261,7,7,0,1,0
1,281,281,7,7,0,1,0
5,284,284,3,3,0,1,0
10,300,300,55,30,25,2,1
15,336,336,11,11,0,1,0
14,352,352,3,3,0,1,0
19,379,379,12,12,0,1,0
18,382,382,9,9,0,1,0
24,390,390,29,29,0,1,0
8,393,393,47,19,28,3,2
26,403,403,14,1,13,2,1
20,427,427,22,22,0,1,0
11,438,438,4,1,3,2,1
7,438,438,49,49,0,1,0
23,459,459,91,63,28,3,2

8,105,105,8,3,5,2,1
24,125,125,23,23,0,1,0
7,126,126,23,23,0,1,0
17,163,163,7,7,0,1,0
22,170,170,44,44,0,1,0
16,196,196,32,32,0,1,0
6,201,201,32,16,16,2,1
10,217,217,4,4,0,1,0
4,230,230,10,10,0,1,0
20,235,235,32,14,18,4,3
1,240,240,38,11,27,3,2
12,254,254,26,10,16,2,1
2,273,273,27,13,14,2,1
9,296,296,1,1,0,1,0
21,324,324,13,13,0,1,0
13,367,367,21,21,0,1,0
0,383,383,110,110,0,1,0
3,387,387,58,58,0,1,0
23,387,387,20,20,0,1,0
18,406,406,54,54,0,1,0
11,412,412,25,17,8,3,2
25,451,451,21,11,10,3,2
14,461,461,7,1,6,3,2
5,469,469,77,77,0,1,0
19,477,477,53,30,23,2,1
15,494,494,40,23,17,2,1

13,107,107,13,13,0,1,0
15,114,114,10,10,0,1,0
17,120,120,4,4,0,1,0
3,139,139,4,4,0,1,0
20,140,140,46,40,6,2,1
6,156,156,3,3,0,1,0
7,192,192,1,1,0,1,0
23,204,204,26,15,11,2,1
16,222,222,31,31,0,1,0
18,246,246,27,12,15,2,1
24,250,250,7,7,0,1,0
27,265,265,3,3,0,1,0
0,268,268,34,34,0,1,0
8,275,275,4,4,0,1,0
14,294,294,50,50,0,1,0
28,299,299,2,2,0,1,0
25,338,338,99,9,90,3,2
26,349,349,20,8,12,3,2
22,357,357,17,1,16,3,2
9,366,366,6,6,0,1,0
2,366,366,69,69,0,1,0
21,385,385,52,2,50,3,2
19,393,393,6,6,0,1,0
4,396,396,36,14,22,3,2
5,418,418,19,19,0,1,0
12,449,449,142,131,11,2,1
1,456,456,1,1,0,1,0
10,458,458,29,26,3,2,1
11,464,464,90,54,36,3,2

10,152,152,8,8,0,1,0
14,161,161,12,12,0,1,0
0,163,163,24,3,21,4,3
5,168,168,28,28,0,1,0
4,203,203,10,10,0,1,0
1,223,223,20,10,10,2,1
16,231,231,15,15,0,1,0
18,260,260,29,29,0,1,0
19,286,286,14,4,10,3,2
9,303,303,14,14,0,1,0
23,311,311,3,3,0,1,0
6,328,328,5,2,3,2,1
22,342,342,161,161,0,1,0
7,359,359,94,94,0,1,0
15,381,381,140,95,45,2,1
21,390,390,1,1,0,1,0
2,393,393,186,186,0,1,0
13,404,404,2,2,0,1,0
12,405,405,6,6,0,1,0
17,435,435,25,1,24,2,1
3,445,445,6,2,4,2,1
20,447,447,49,40,9,4,3
11,465,465,14,7,7,2,1
8,470,470,65,65,0,1,0

23,110,110,5,5,0,1,0
33,137,137,5,1,4,2,1
17,139,139,10,5,5,2,1
20,165,165,5,5,0,1,0
5,176,176,2,2,0,1,0
25,184,184,10,3,7,2,1
9,187,187,1,1,0,1,0
34,188,188,7,7,0,1,0
30,193,193,22,3,19,2,1
18,211,211,8,2,6,2,1
22,212,212,9,9,0,1,0
16,219,219,23,9,14,2,1
2,224,224,7,1,6,2,1
14,224,224,1,1,0,1,0
6,236,236,12,3,9,2,1
19,265,265,19,19,0,1,0
37,279,279,23,5,18,3,2
35,292,292,11,1,10,2,1
12,293,293,36,36,0,1,0
31,294,294,9,9,0,1,0
4,311,311,39,39,0,1,0
1,317,317,1,1,0,1,0
26,333,333,19,15,4,2,1
36,345,345,61,21,40,2,1
24,346,346,63,3,60,4,3
7,347,347,12,3,9,4,3
13,368,368,102,42,60,4,3
27,383,383,117,117,0,1,0
11,387,387,23,23,0,1,0
10,400,400,8,3,5,2,1
29,430,430,45,45,0,1,0
32,441,441,11,3,8,2,1
0,463,463,12,12,0,1,0
8,479,479,25,1,24,4,3
21,481,481,9,4,5,2,1
3,486,486,35,35,0,1,0
15,492,492,41,41,0,1,0
28,496,496,90,90,0,1,0

22,107,107,8,2,6,2,1
20,116,116,46,46,0,1,0
15,124,124,10,7,3,2,1
8,144,144,8,4,4,2,1
6,152,152,5,5,0,1,0
21,175,175,9,9,0,1,0
3,192,192,100,65,35,4,3
1,223,223,19,7,12,3,2
9,232,232,6,6,0,1,0
5,235,235,60,31,29,2,1
4,253,253,1,1,0,1,0
24,274,274,70,55,15,2,1
12,287,287,4,1,3,2,1
18,305,305,31,31,0,1,0
17,319,319,6,6,0,1,0
10,331,331,82,11,71,4,3
0,343,343,6,6,0,1,0
25,344,344,31,16,15,2,1
2,377,377,13,3,10,3,2
19,390,390,28,4,24,2,1
16,395,395,37,37,0,1,0
7,414,414,28,28,0,1,0
23,423,423,26,4,22,4,3
14,435,435,6,6,0,1,0
13,461,461,51,39,12,4,3
11,484,484,26,8,18,2,1

28,106,106,17,2,15,4,3
31,117,117,5,5,0,1,0
22,149,149,5,5,0,1,0
29,176,176,16,16,0,1,0
32,178,178,17,17,0,1,0
14,209,209,22,22,0,1,0
18,220,220,6,6,0,1,0
5,239,239,19,19,0,1,0
26,248,248,20,20,0,1,0
25,274,274,23,23,0,1,0
24,280,280,59,59,0,1,0
11,281,281,5,5,0,1,0
35,283,283,31,15,16,3,2
4,300,300,11,11,0,1,0
15,304,304,42,42,0,1,0
6,332,332,10,10,0,1,0
23,340,340,15,15,0,1,0
19,345,345,57,57,0,1,0
30,352,352,107,56,51,4,3
21,354,354,6,6,0,1,0
7,356,356,39,39,0,1,0
33,363,363,1,1,0,1,0
2,370,370,2,2,0,1,0
20,401,401,52,52,0,1,0
8,403,403,2,2,0,1,0
17,421,421,23,23,0,1,0
34,421,421,19,19,0,1,0
0,427,427,13,13,0,1,0
12,433,433,18,18,0,1,0
16,441,441,55,43,12,3,2
13,442,442,23,23,0,1,0
3,448,448,11,1,10,3,2
10,455,455,7,1,6,2,1
27,461,461,60,10,50,4,3
1,478,478,10,2,8,3,2
9,498,498,85,31,54,3,2

21,154,154,26,18,8,2,1
16,156,156,18,3,15,4,3
15,163,163,21,6,15,2,1
27,175,175,22,13,9,4,3
30,176,176,5,1,4,2,1
17,192,192,30,6,24,3,2
6,192,192,47,4,43,2,1
0,228,228,10,2,8,3,2
5,236,236,2,2,0,1,0
13,265,265,1,1,0,1,0
28,274,274,38,16,22,2,1
20,293,293,8,8,0,1,0
24,294,294,61,61,0,1,0
11,315,315,8,8,0,1,0
2,346,346,1,1,0,1,0
8,356,356,15,15,0,1,0
14,360,360,36,26,10,2,1
4,363,363,13,9,4,2,1
12,373,373,1,1,0,1,0
1,384,384,112,112,0,1,0
29,385,385,23,7,16,3,2
23,395,395,19,10,9,4,3
19,412,412,94,37,57,4,3
25,430,430,22,22,0,1,0
3,441,441,31,31,0,1,0
10,451,451,11,11,0,1,0
22,452,452,21,21,0,1,0
31,464,464,28,10,18,3,2
26,467,467,35,11,24,4,3
18,475,475,77,57,20,3,2
7,492,492,4,4,0,1,0
9,500,500,48,30,18,4,3

27,100,100,7,7,0,1,0
11,103,103,1,1,0,1,0
1,103,103,11,2,9,4,3
10,114,114,1,1,0,1,0
6,122,122,1,1,0,1,0
4,132,132,1,1,0,1,0
23,169,169,22,22,0,1,0
22,175,175,23,23,0,1,0
29,183,183,1,1,0,1,0
26,186,186,6,6,0,1,0
7,208,208,14,14,0,1,0
24,226,226,31,31,0,1,0
18,241,241,54,4,50,2,1
28,275,275,29,29,0,1,0
0,278,278,15,5,10,3,2
33,292,292,19,7,12,4,3
9,298,298,5,2,3,2,1
5,306,306,20,20,0,1,0
25,312,312,41,32,9,4,3
20,319,319,37,37,0,1,0
31,319,319,14,14,0,1,0
16,323,323,14,4,10,3,2
21,333,333,90,77,13,2,1
12,341,341,34,13,21,2,1
2,362,362,24,16,8,3,2
15,368,368,5,2,3,2,1
8,385,385,67,16,51,3,2
13,412,412,8,3,5,2,1
3,441,441,101,101,0,1,0
32,444,444,15,3,12,4,3
30,459,459,71,44,27,4,3
19,471,471,6,6,0,1,0
14,492,492,54,54,0,1,0
17,493,493,32,32,0,1,0

12,155,155,3,3,0,1,0
8,161,161,7,7,0,1,0
11,162,162,47,47,0,1,0
19,180,180,37,1,36,3,2
18,181,181,17,17,0,1,0
13,189,189,2,2,0,1,0
3,195,195,1,1,0,1,0
7,237,237,13,13,0,1,0
17,246,246,58,17,41,2,1
16,281,281,23,23,0,1,0
5,290,290,127,73,54,4,3
10,351,351,29,29,0,1,0
14,407,407,37,14,23,2,1
15,440,440,20,11,9,2,1
2,448,448,49,13,36,2,1
6,455,455,40,19,21,4,3
1,459,459,109,60,49,2,1
9,492,492,42,31,11,2,1
0,494,494,285,249,36,4,3
4,496,496,18,4,14,2,1

12,106,106,4,4,0,1,0
10,125,125,2,2,0,1,0
22,181,181,30,15,15,2,1
16,189,189,10,10,0,1,0
30,205,205,79,79,0,1,0
6,209,209,12,4,8,2,1
31,209,209,31,31,0,1,0
0,210,210,38,4,34,4,3
24,211,211,4,1,3,2,1
5,212,212,38,4,34,2,1
13,220,220,11,3,8,3,2
23,221,221,1,1,0,1,0
3,228,228,6,6,0,1,0
9,229,229,4,4,0,1,0
32,268,268,11,11,0,1,0
28,272,272,33,15,18,2,1
2,274,274,58,2,56,4,3
20,296,296,15,15,0,1,0
4,300,300,3,3,0,1,0
11,304,304,28,28,0,1,0
21,325,325,27,27,0,1,0
14,367,367,1,1,0,1,0
26,406,406,71,51,20,3,2
15,419,419,46,46,0,1,0
19,431,431,18,13,5,2,1
8,433,433,45,15,30,3,2
7,434,434,62,62,0,1,0
1,435,435,28,28,0,1,0
29,447,447,29,29,0,1,0
27,460,460,51,25,26,2,1
18,469,469,10,1,9,4,3
25,488,488,7,7,0,1,0
17,498,498,12,12,0,1,0

26,112,112,13,5,8,2,1
23,139,139,6,2,4,2,1
15,142,142,8,8,0,1,0
1,151,151,24,6,18,2,1
11,162,162,19,16,3,2,1
27,233,233,10,6,4,2,1
22,235,235,57,48,9,2,1
12,251,251,2,2,0,1,0
0,261,261,9,3,6,3,2
17,274,274,30,30,0,1,0
25,279,279,24,4,20,2,1
9,286,286,28,28,0,1,0
8,299,299,7,7,0,1,0
14,301,301,109,85,24,2,1
21,303,303,29,29,0,1,0
16,316,316,10,10,0,1,0
10,346,346,61,61,0,1,0
19,352,352,11,11,0,1,0
2,379,379,39,39,0,1,0
7,380,380,24,12,12,3,2
18,390,390,33,33,0,1,0
3,397,397,125,125,0,1,0
6,426,426,10,10,0,1,0
20,433,433,25,25,0,1,0
5,445,445,60,18,42,2,1
24,470,470,32,32,0,1,0
4,474,474,32,32,0,1,0
13,481,481,38,38,0,1,0

13,112,112,3,3,0,1,0
17,113,113,4,4,0,1,0
28,120,120,13,13,0,1,0
6,132,132,1,1,0,1,0
24,141,141,6,6,0,1,0
3,150,150,12,12,0,1,0
30,169,169,2,2,0,1,0
2,174,174,16,16,0,1,0
7,196,196,20,11,9,4,3
32,202,202,28,2,26,3,2
19,225,225,6,2,4,2,1
10,229,229,12,12,0,1,0
4,232,232,64,64,0,1,0
9,235,235,9,9,0,1,0
15,252,252,1,1,0,1,0
26,264,264,116,116,0,1,0
23,278,278,56,56,0,1,0
20,289,289,18,7,11,2,1
18,317,317,24,10,14,3,2
0,370,370,5,2,3,2,1
11,373,373,26,26,0,1,0
21,374,374,26,11,15,4,3
14,399,399,59,45,14,2,1
33,406,406,23,4,19,2,1
29,412,412,27,7,20,2,1
25,418,418,1,1,0,1,0
16,425,425,1,1,0,1,0
22,438,438,86,64,22,2,1
1,441,441,46,46,0,1,0
27,444,444,6,6,0,1,0
12,459,459,1,1,0,1,0
31,466,466,10,7,3,2,1
5,492,492,45,45,0,1,0
8,500,500,76,67,9,2,1

19,106,106,5,2,3,2,1
26,108,108,2,2,0,1,0
4,110,110,5,5,0,1,0
0,123,123,3,3,0,1,0
7,147,147,22,22,0,1,0
13,189,189,13,2,11,2,1
6,199,199,30,7,23,4,3
14,220,220,12,7,5,2,1
28,227,227,32,32,0,1,0
25,227,227,38,38,0,1,0
22,234,234,44,7,37,2,1
24,236,236,8,8,0,1,0
9,238,238,4,4,0,1,0
17,249,249,6,6,0,1,0
5,270,270,10,10,0,1,0
10,277,277,15,7,8,3,2
8,279,279,45,45,0,1,0
23,279,279,28,10,18,3,2
18,326,326,73,58,15,2,1
3,326,326,8,8,0,1,0
2,330,330,65,57,8,2,1
12,340,340,36,16,20,4,3
1,389,389,3,3,0,1,0
21,405,405,1,1,0,1,0
27,406,406,111,17,94,3,2
20,418,418,26,17,9,4,3
15,420,420,51,51,0,1,0
16,467,467,15,15,0,1,0
11,480,480,146,88,58,4,3

36,103,103,3,3,0,1,0
21,105,105,13,13,0,1,0
7,106,106,7,7,0,1,0
27,107,107,17,17,0,1,0
31,113,113,12,12,0,1,0
8,113,113,1,1,0,1,0
11,118,118,4,4,0,1,0
28,125,125,6,6,0,1,0
4,135,135,4,4,0,1,0
22,146,146,1,1,0,1,0
10,147,147,4,4,0,1,0
0,246,246,9,9,0,1,0
32,255,255,16,8,8,3,2
6,260,260,2,2,0,1,0
25,265,265,4,4,0,1,0
19,280,280,38,38,0,1,0
26,281,281,31,1,30,4,3
15,285,285,1,1,0,1,0
20,295,295,61,15,46,2,1
23,307,307,1,1,0,1,0
29,326,326,26,11,15,4,3
13,332,332,22,13,9,4,3
3,339,339,21,21,0,1,0
24,341,341,61,61,0,1,0
5,343,343,22,1,21,3,2
16,356,356,1,1,0,1,0
33,366,366,79,69,10,3,2
35,374,374,17,5,12,4,3
12,381,381,17,17,0,1,0
34,383,383,45,3,42,4,3
14,391,391,69,69,0,1,0
30,391,391,78,78,0,1,0
18,391,391,28,13,15,2,1
1,398,398,6,6,0,1,0
17,429,429,47,12,35,3,2
37,463,463,29,15,14,2,1
2,485,485,17,17,0,1,0
9,492,492,32,32,0,1,0

2,103,103,19,19,0,1,0
1,123,123,1,1,0,1,0
13,133,133,6,2,4,2,1
14,160,160,3,3,0,1,0
7,166,166,11,11,0,1,0
22,167,167,6,6,0,1,0
24,178,178,39,39,0,1,0
11,197,197,5,2,3,2,1
15,202,202,1,1,0,1,0
20,203,203,23,9,14,3,2
21,214,214,3,3,0,1,0
0,229,229,12,12,0,1,0
28,253,253,20,20,0,1,0
29,288,288,14,14,0,1,0
3,304,304,6,6,0,1,0
25,305,305,34,7,27,3,2
16,313,313,7,7,0,1,0
18,341,341,82,56,26,2,1
12,344,344,1,1,0,1,0
26,383,383,31,31,0,1,0
9,393,393,6,6,0,1,0
6,395,395,36,27,9,4,3
8,400,400,10,10,0,1,0
4,408,408,171,162,9,4,3
19,409,409,37,2,35,2,1
17,415,415,72,33,39,4,3
27,432,432,13,2,11,2,1
30,474,474,3,3,0,1,0
10,481,481,91,91,0,1,0
23,488,488,92,22,70,4,3
5,496,496,105,56,49,4,3

7,109,109,64,64,0,1,0
18,131,131,14,5,9,4,3
20,154,154,15,15,0,1,0
4,176,176,9,3,6,2,1
17,215,215,23,23,0,1,0
16,222,222,2,2,0,1,0
1,225,225,13,13,0,1,0
12,226,226,1,1,0,1,0
11,245,245,13,4,9,4,3
5,265,265,8,3,5,2,1
0,265,265,18,18,0,1,0
19,268,268,53,53,0,1,0
6,277,277,59,59,0,1,0
21,334,334,24,1,23,2,1
8,365,365,23,23,0,1,0
10,366,366,8,1,7,2,1
15,394,394,102,102,0,1,0
22,401,401,57,57,0,1,0
2,443,443,44,44,0,1,0
3,451,451,46,46,0,1,0
13,453,453,126,126,0,1,0
14,461,461,14,5,9,4,3
9,466,466,60,37,23,2,1
23,493,493,22,13,9,2,1

21,100,100,1,1,0,1,0
32,116,116,4,4,0,1,0
6,123,123,3,3,0,1,0
27,146,146,49,16,33,4,3
38,174,174,6,6,0,1,0
10,177,177,9,9,0,1,0
12,178,178,12,12,0,1,0
11,190,190,1,1,0,1,0
13,198,198,1,1,0,1,0
35,247,247,15,15,0,1,0
31,253,253,36,6,30,2,1
5,256,256,1,1,0,1,0
9,262,262,39,27,12,2,1
0,272,272,12,12,0,1,0
24,272,272,5,5,0,1,0
28,275,275,89,89,0,1,0
7,284,284,11,11,0,1,0
1,291,291,43,43,0,1,0
36,303,303,17,6,11,2,1
22,344,344,21,9,12,4,3
3,356,356,5,5,0,1,0
37,360,360,40,17,23,2,1
26,366,366,76,42,34,2,1
2,373,373,60,60,0,1,0
14,373,373,35,20,15,2,1
18,400,400,9,1,8,3,2
34,401,401,5,5,0,1,0
33,404,404,4,1,3,2,1
23,413,413,6,2,4,2,1
19,427,427,1,1,0,1,0
30,443,443,3,3,0,1,0
20,444,444,17,8,9,4,3
39,448,448,2,2,0,1,0
16,452,452,6,6,0,1,0
8,458,458,39,2,37,3,2
17,465,465,68,20,48,4,3
29,467,467,42,42,0,1,0
25,482,482,44,44,0,1,0
15,486,486,34,13,21,4,3
4,491,491,11,11,0,1,0

2,103,103,14,14,0,1,0
10,107,107,15,1,14,3,2
8,125,125,2,2,0,1,0
21,125,125,13,10,3,2,1
19,128,128,13,13,0,1,0
6,140,140,5,5,0,1,0
18,143,143,21,6,15,2,1
24,160,160,19,1,18,4,3
26,185,185,39,39,0,1,0
25,185,185,29,29,0,1,0
11,200,200,7,1,6,3,2
22,223,223,16,8,8,3,2
7,232,232,3,3,0,1,0
15,258,258,43,43,0,1,0
12,270,270,48,9,39,4,3
1,276,276,13,13,0,1,0
14,280,280,30,21,9,4,3
4,375,375,22,19,3,2,1
3,375,375,35,13,22,3,2
13,377,377,3,3,0,1,0
16,387,387,4,4,0,1,0
0,395,395,125,82,43,4,3
17,398,398,41,8,33,2,1
23,399,399,47,13,34,2,1
9,425,425,51,3,48,3,2
5,430,430,92,92,0,1,0
20,470,470,6,6,0,1,0

25,100,100,3,3,0,1,0
15,112,112,49,2,47,2,1
5,121,121,3,3,0,1,0
1,128,128,4,4,0,1,0
22,145,145,40,4,36,3,2
2,159,159,14,6,8,2,1
23,171,171,9,1,8,3,2
4,178,178,12,3,9,4,3
0,212,212,15,15,0,1,0
9,220,220,64,64,0,1,0
7,239,239,72,72,0,1,0
20,267,267,3,3,0,1,0
27,269,269,8,2,6,3,2
18,272,272,51,9,42,2,1
10,290,290,47,17,30,2,1
6,295,295,4,1,3,2,1
8,298,298,7,7,0,1,0
24,305,305,1,1,0,1,0
12,308,308,12,6,6,3,2
19,309,309,17,9,8,3,2
21,316,316,5,5,0,1,0
11,346,346,8,8,0,1,0
13,374,374,77,77,0,1,0
17,375,375,74,68,6,3,2
14,404,404,17,17,0,1,0
26,441,441,38,38,0,1,0
16,491,491,10,4,6,3,2
3,497,497,30,13,17,2,1

4,103,103,3,3,0,1,0
17,113,113,39,2,37,2,1
21,122,122,3,3,0,1,0
18,165,165,26,26,0,1,0
2,175,175,3,3,0,1,0
20,188,188,11,11,0,1,0
6,197,197,20,2,18,2,1
12,199,199,1,1,0,1,0
26,204,204,11,11,0,1,0
23,224,224,5,5,0,1,0
7,225,225,72,72,0,1,0
22,255,255,1,1,0,1,0
25,259,259,3,3,0,1,0
0,277,277,14,3,11,2,1
9,307,307,59,59,0,1,0
8,326,326,1,1,0,1,0
16,331,331,40,8,32,3,2
1,337,337,87,19,68,3,2
11,381,381,48,15,33,2,1
14,411,411,62,62,0,1,0
3,412,412,2,2,0,1,0
24,420,420,87,45,42,4,3
15,426,426,41,41,0,1,0
5,426,426,91,17,74,3,2
13,452,452,9,9,0,1,0
27,461,461,71,71,0,1,0
10,477,477,29,2,27,2,1
19,482,482,6,6,0,1,0

16,100,100,8,1,7,2,1
27,115,115,15,15,0,1,0
2,137,137,5,5,0,1,0
11,151,151,15,15,0,1,0
7,182,182,55,30,25,2,1
0,200,200,4,4,0,1,0
19,210,210,2,2,0,1,0
6,212,212,69,69,0,1,0
10,213,213,11,2,9,2,1
12,231,231,1,1,0,1,0
21,250,250,18,18,0,1,0
14,253,253,21,21,0,1,0
3,268,268,12,12,0,1,0
26,292,292,43,14,29,2,1
5,315,315,19,19,0,1,0
9,340,340,33,6,27,2,1
15,351,351,99,99,0,1,0
17,364,364,29,29,0,1,0
1,369,369,31,7,24,3,2
20,391,391,9,1,8,3,2
22,394,394,120,105,15,4,3
23,414,414,14,14,0,1,0
25,440,440,41,26,15,2,1
4,443,443,45,9,36,2,1
13,456,456,64,43,21,4,3
18,466,466,23,23,0,1,0
8,483,483,16,16,0,1,0
24,490,490,15,15,0,1,0

1,107,107,7,7,0,1,0
25,116,116,1,1,0,1,0
28,150,150,14,14,0,1,0
29,159,159,5,5,0,1,0
27,169,169,14,5,9,2,1
26,179,179,8,8,0,1,0
24,223,223,45,16,29,2,1
21,232,232,29,5,24,4,3
3,240,240,19,19,0,1,0
0,298,298,3,3,0,1,0
14,309,309,1,1,0,1,0
23,321,321,36,36,0,1,0
12,363,363,6,6,0,1,0
6,375,375,156,156,0,1,0
9,407,407,8,8,0,1,0
20,437,437,142,70,72,4,3
11,441,441,60,39,21,2,1
22,443,443,37,15,22,2,1
17,447,447,42,42,0,1,0
16,448,448,26,10,16,2,1
4,448,448,21,1,20,2,1
15,457,457,3,3,0,1,0
18,464,464,52,52,0,1,0
19,465,465,22,22,0,1,0
7,471,471,27,27,0,1,0
5,471,471,110,101,9,4,3
2,471,471,28,28,0,1,0
13,476,476,96,64,32,3,2
8,491,491,11,1,10,2,1
10,500,500,14,10,4,2,1

5,115,115,13,13,0,1,0
7,134,134,17,17,0,1,0
25,164,164,1,1,0,1,0
16,171,171,22,22,0,1,0
17,176,176,38,38,0,1,0
6,178,178,19,8,11,2,1
20,182,182,33,15,18,4,3
21,208,208,31,31,0,1,0
8,209,209,3,3,0,1,0
13,225,225,12,12,0,1,0
11,239,239,37,37,0,1,0
10,260,260,29,29,0,1,0
23,276,276,32,24,8,3,2
9,286,286,42,42,0,1,0
24,313,313,11,11,0,1,0
1,323,323,46,30,16,3,2
27,341,341,11,11,0,1,0
2,343,343,46,46,0,1,0
14,371,371,18,6,12,3,2
0,388,388,6,6,0,1,0
26,408,408,28,6,22,2,1
22,410,410,22,19,3,2,1
15,420,420,63,63,0,1,0
12,422,422,1,1,0,1,0
3,444,444,14,11,3,2,1
4,456,456,91,63,28,3,2
19,462,462,40,40,0,1,0
18,463,463,30,10,20,2,1
28,476,476,65,65,0,1,0

3,114,114,2,2,0,1,0
18,117,117,11,11,0,1,0
5,130,130,19,19,0,1,0
1,134,134,26,8,18,4,3
11,209,209,28,28,0,1,0
22,214,214,33,24,9,2,1
6,240,240,28,28,0,1,0
12,276,276,38,38,0,1,0
8,303,303,47,6,41,4,3
16,306,306,45,45,0,1,0
17,306,306,13,13,0,1,0
20,306,306,54,54,0,1,0
13,307,307,73,73,0,1,0
2,345,345,14,14,0,1,0
0,346,346,9,9,0,1,0
10,359,359,13,13,0,1,0
19,364,364,47,47,0,1,0
4,371,371,12,12,0,1,0
9,386,386,68,68,0,1,0
7,391,391,194,140,54,4,3
23,413,413,5,5,0,1,0
15,421,421,28,28,0,1,0
21,437,437,1,1,0,1,0
14,458,458,27,17,10,2,1

4,100,100,7,7,0,1,0
32,104,104,39,39,0,1,0
7,110,110,1,1,0,1,0
1,116,116,3,3,0,1,0
14,124,124,10,10,0,1,0
30,131,131,46,6,40,2,1
0,136,136,10,5,5,2,1
12,182,182,21,21,0,1,0
29,186,186,4,4,0,1,0
16,205,205,1,1,0,1,0
25,209,209,9,9,0,1,0
21,211,211,5,5,0,1,0
18,212,212,12,3,9,4,3
19,223,223,22,11,11,2,1
22,248,248,14,8,6,3,2
2,261,261,69,7,62,3,2
17,285,285,7,7,0,1,0
3,302,302,8,8,0,1,0
11,311,311,11,2,9,2,1
33,316,316,19,4,15,3,2
13,317,317,14,14,0,1,0
8,345,345,13,13,0,1,0
26,376,376,8,8,0,1,0
27,376,376,20,20,0,1,0
9,418,418,27,17,10,2,1
28,425,425,16,16,0,1,0
23,430,430,2,2,0,1,0
31,430,430,63,23,40,3,2
6,441,441,59,59,0,1,0
10,448,448,14,14,0,1,0
24,459,459,7,7,0,1,0
35,459,459,88,36,52,4,3
34,461,461,22,1,21,2,1
15,486,486,2,2,0,1,0
20,498,498,45,23,22,3,2
5,500,500,43,11,32,3,2

10,103,103,18,18,0,1,0
31,160,160,6,6,0,1,0
12,165,165,20,7,13,2,1
11,171,171,20,20,0,1,0
19,179,179,4,1,3,2,1
13,180,180,5,5,0,1,0
30,181,181,3,3,0,1,0
20,204,204,66,20,46,2,1
21,215,215,27,27,0,1,0
7,217,217,23,4,19,2,1
1,232,232,24,24,0,1,0
29,243,243,56,56,0,1,0
15,259,259,19,11,8,3,2
5,260,260,46,46,0,1,0
26,260,260,18,18,0,1,0
9,281,281,9,9,0,1,0
2,290,290,2,2,0,1,0
23,299,299,16,6,10,2,1
0,301,301,2,2,0,1,0
17,304,304,7,7,0,1,0
27,307,307,98,98,0,1,0
22,318,318,9,1,8,2,1
28,318,318,8,2,6,3,2
18,330,330,35,35,0,1,0
14,396,396,2,2,0,1,0
24,397,397,13,13,0,1,0
6,412,412,19,19,0,1,0
8,419,419,25,3,22,3,2
25,427,427,14,14,0,1,0
16,432,432,31,31,0,1,0
4,446,446,73,43,30,3,2
3,493,493,42,24,18,2,1

22,111,111,4,1,3,2,1
11,111,111,1,1,0,1,0
20,117,117,9,1,8,3,2
5,129,129,28,28,0,1,0
12,149,149,11,11,0,1,0
19,150,150,12,4,8,2,1
15,163,163,3,3,0,1,0
18,170,170,1,1,0,1,0
6,172,172,17,17,0,1,0
3,200,200,6,6,0,1,0
29,216,216,3,3,0,1,0
16,230,230,2,2,0,1,0
33,256,256,16,16,0,1,0
2,276,276,21,1,20,3,2
8,286,286,16,5,11,2,1
28,294,294,33,33,0,1,0
14,318,318,46,15,31,2,1
1,327,327,15,1,14,4,3
30,329,329,47,47,0,1,0
32,333,333,33,33,0,1,0
13,335,335,9,9,0,1,0
4,356,356,12,3,9,2,1
27,360,360,23,23,0,1,0
17,367,367,37,1,36,4,3
10,379,379,49,49,0,1,0
7,406,406,28,6,22,2,1
9,414,414,41,41,0,1,0
23,418,418,40,40,0,1,0
24,428,428,62,32,30,3,2
25,437,437,46,46,0,1,0
0,447,447,36,3,33,4,3
31,468,468,131,131,0,1,0
26,481,481,43,43,0,1,0
21,484,484,52,52,0,1,0

23,103,103,38,19,19,2,1
28,104,104,4,1,3,2,1
1,107,107,7,7,0,1,0
0,127,127,9,2,7,2,1
24,129,129,12,1,11,2,1
29,190,190,35,35,0,1,0
6,204,204,24,24,0,1,0
22,210,210,4,4,0,1,0
5,226,226,7,7,0,1,0
3,234,234,60,37,23,2,1
14,241,241,3,3,0,1,0
21,244,244,31,31,0,1,0
20,248,248,22,22,0,1,0
16,265,265,18,18,0,1,0
2,267,267,42,20,22,3,2
17,272,272,10,10,0,1,0
10,287,287,28,2,26,3,2
13,303,303,5,2,3,2,1
12,318,318,1,1,0,1,0
8,337,337,60,60,0,1,0
11,347,347,1,1,0,1,0
27,362,362,6,6,0,1,0
7,379,379,1,1,0,1,0
32,400,400,17,5,12,4,3
15,414,414,10,10,0,1,0
19,417,417,2,2,0,1,0
26,421,421,6,3,3,2,1
4,422,422,2,2,0,1,0
30,434,434,7,2,5,2,1
31,440,440,61,25,36,2,1
18,453,453,97,37,60,4,3
9,455,455,19,19,0,1,0
25,495,495,138,96,42,3,2

8,113,113,11,11,0,1,0
2,119,119,23,8,15,2,1
19,159,159,60,42,18,4,3
11,167,167,5,1,4,2,1
5,178,178,15,1,14,3,2
3,194,194,60,53,7,2,1
4,215,215,2,2,0,1,0
21,228,228,12,12,0,1,0
15,266,266,48,20,28,2,1
13,297,297,4,1,3,2,1
17,306,306,19,6,13,2,1
20,340,340,5,2,3,2,1
14,367,367,22,22,0,1,0
10,388,388,23,23,0,1,0
9,415,415,47,47,0,1,0
7,430,430,45,33,12,2,1
16,432,432,55,8,47,4,3
6,444,444,103,103,0,1,0
12,451,451,14,10,4,2,1
18,455,455,96,45,51,3,2
1,458,458,95,66,29,2,1
0,465,465,121,85,36,2,1

30,127,127,4,4,0,1,0
22,128,128,34,34,0,1,0
14,133,133,18,18,0,1,0
10,161,161,3,3,0,1,0
18,183,183,18,18,0,1,0
16,195,195,4,4,0,1,0
15,195,195,28,28,0,1,0
21,195,195,8,8,0,1,0
24,199,199,39,39,0,1,0
4,201,201,3,3,0,1,0
2,203,203,6,1,5,2,1
23,216,216,5,5,0,1,0
25,219,219,25,7,18,2,1
19,248,248,5,5,0,1,0
32,249,249,38,26,12,2,1
11,295,295,1,1,0,1,0
1,313,313,25,25,0,1,0
8,323,323,50,36,14,2,1
7,328,328,2,2,0,1,0
17,336,336,59,59,0,1,0
28,336,336,49,49,0,1,0
29,369,369,23,23,0,1,0
27,376,376,82,82,0,1,0
31,387,387,1,1,0,1,0
6,391,391,69,6,63,4,3
12,432,432,27,7,20,3,2
5,435,435,5,1,4,2,1
26,442,442,45,27,18,2,1
0,444,444,80,80,0,1,0
20,446,446,26,17,9,2,1
13,459,459,22,22,0,1,0
3,466,466,15,10,5,2,1
9,466,466,5,2,3,2,1

10,136,136,10,3,7,2,1
0,162,162,4,4,0,1,0
17,168,168,6,6,0,1,0
15,171,171,2,2,0,1,0
20,184,184,40,24,16,2,1
8,211,211,3,3,0,1,0
28,215,215,6,6,0,1,0
2,227,227,41,17,24,2,1
13,235,235,8,8,0,1,0
27,237,237,6,6,0,1,0
1,241,241,76,76,0,1,0
5,248,248,16,1,15,2,1
12,253,253,3,3,0,1,0
16,262,262,29,29,0,1,0
7,262,262,1,1,0,1,0
21,284,284,11,11,0,1,0
23,300,300,41,41,0,1,0
18,305,305,7,7,0,1,0
22,319,319,75,66,9,2,1
6,320,320,49,49,0,1,0
4,323,323,50,50,0,1,0
3,366,366,15,15,0,1,0
9,386,386,6,3,3,2,1
25,391,391,93,93,0,1,0
24,395,395,22,10,12,4,3
26,421,421,79,64,15,4,3
11,445,445,95,82,13,2,1
14,455,455,46,36,10,2,1
19,488,488,41,7,34,3,2

30,114,114,7,7,0,1,0
6,192,192,54,54,0,1,0
11,231,231,10,6,4,2,1
32,231,231,5,2,3,2,1
19,234,234,19,19,0,1,0
7,244,244,23,5,18,2,1
2,250,250,14,2,12,2,1
31,256,256,50,50,0,1,0
26,257,257,19,3,16,2,1
25,272,272,7,7,0,1,0
18,277,277,60,40,20,3,2
28,303,303,54,15,39,2,1
14,306,306,4,4,0,1,0
16,318,318,3,3,0,1,0
0,320,320,4,4,0,1,0
10,321,321,11,4,7,2,1
3,331,331,7,3,4,2,1
24,345,345,32,11,21,4,3
17,351,351,4,4,0,1,0
27,369,369,29,13,16,2,1
23,375,375,1,1,0,1,0
15,387,387,1,1,0,1,0
8,392,392,15,15,0,1,0
4,395,395,2,2,0,1,0
9,404,404,24,24,0,1,0
12,439,439,2,2,0,1,0
13,439,439,46,19,27,4,3
29,440,440,189,189,0,1,0
1,445,445,41,41,0,1,0
20,455,455,42,42,0,1,0
5,473,473,143,33,110,4,3
21,474,474,41,3,38,2,1
22,490,490,5,5,0,1,0

19,105,105,6,6,0,1,0
16,154,154,33,33,0,1,0
17,174,174,39,30,9,2,1
14,207,207,22,6,16,4,3
5,224,224,16,16,0,1,0
8,241,241,76,12,64,3,2
0,246,246,17,17,0,1,0
11,262,262,8,5,3,2,1
1,280,280,142,67,75,4,3
20,294,294,3,3,0,1,0
10,311,311,5,5,0,1,0
18,312,312,11,3,8,2,1
13,323,323,2,2,0,1,0
2,348,348,23,1,22,2,1
9,397,397,4,1,3,2,1
6,403,403,66,35,31,2,1
12,414,414,39,24,15,2,1
15,416,416,118,67,51,4,3
4,426,426,56,18,38,3,2
7,428,428,30,30,0,1,0
21,443,443,103,4,99,4,3
3,464,464,4,4,0,1,0
22,468,468,54,54,0,1,0

18,103,103,1,1,0,1,0
6,104,104,1,1,0,1,0
3,122,122,21,5,16,2,1
23,122,122,21,21,0,1,0
5,126,126,1,1,0,1,0
20,139,139,22,22,0,1,0
19,153,153,14,14,0,1,0
0,177,177,4,1,3,2,1
12,207,207,2,2,0,1,0
7,208,208,7,7,0,1,0
15,229,229,2,2,0,1,0
28,235,235,27,8,19,2,1
10,237,237,126,23,103,4,3
13,246,246,48,48,0,1,0
22,291,291,35,35,0,1,0
21,314,314,50,38,12,4,3
16,318,318,46,46,0,1,0
26,322,322,53,23,30,3,2
8,340,340,39,5,34,3,2
4,342,342,4,4,0,1,0
1,364,364,8,2,6,3,2
11,381,381,22,22,0,1,0
14,391,391,5,2,3,2,1
17,427,427,65,27,38,3,2
2,429,429,27,17,10,2,1
9,431,431,59,10,49,2,1
27,457,457,43,43,0,1,0
24,459,459,3,3,0,1,0
25,499,499,18,7,11,2,1

23,104,104,19,9,10,3,2
12,107,107,27,19,8,2,1
11,132,132,8,1,7,2,1
27,152,152,2,2,0,1,0
2,154,154,7,4,3,2,1
20,161,161,16,16,0,1,0
17,172,172,10,10,0,1,0
15,179,179,10,10,0,1,0
19,199,199,16,16,0,1,0
22,201,201,31,17,14,3,2
26,203,203,6,6,0,1,0
24,215,215,14,14,0,1,0
1,248,248,5,5,0,1,0
16,256,256,79,29,50,2,1
21,274,274,19,13,6,3,2
3,354,354,9,9,0,1,0
10,362,362,12,12,0,1,0
13,369,369,51,51,0,1,0
6,374,374,4,4,0,1,0
18,374,374,54,54,0,1,0
14,379,379,19,19,0,1,0
28,382,382,68,26,42,2,1
9,395,395,9,9,0,1,0
8,408,408,32,32,0,1,0
4,413,413,57,18,39,4,3
0,422,422,77,77,0,1,0
25,466,466,23,8,15,4,3
5,474,474,14,6,8,3,2
29,480,480,3,3,0,1,0
7,490,490,127,127,0,1,0

8,117,117,18,18,0,1,0
12,127,127,13,13,0,1,0
7,131,131,15,11,4,2,1
22,180,180,31,31,0,1,0
6,183,183,90,90,0,1,0
11,200,200,16,2,14,3,2
2,205,205,2,2,0,1,0
20,207,207,9,9,0,1,0
5,211,211,26,26,0,1,0
9,227,227,16,16,0,1,0
0,237,237,4,4,0,1,0
10,237,237,1,1,0,1,0
15,259,259,10,3,7,2,1
21,268,268,97,5,92,3,2
1,277,277,49,39,10,2,1
19,300,300,94,73,21,2,1
13,319,319,7,1,6,3,2
14,331,331,23,23,0,1,0
16,342,342,17,17,0,1,0
3,358,358,26,26,0,1,0
18,415,415,2,2,0,1,0
23,434,434,66,66,0,1,0
17,474,474,4,4,0,1,0
4,490,490,84,52,32,4,3

6,104,104,5,5,0,1,0
15,149,149,7,7,0,1,0
9,156,156,19,8,11,2,1
1,206,206,16,16,0,1,0
8,218,218,17,17,0,1,0
16,224,224,11,11,0,1,0
18,228,228,4,1,3,2,1
21,255,255,26,26,0,1,0
23,264,264,62,51,11,4,3
28,269,269,44,8,36,4,3
19,280,280,3,3,0,1,0
27,286,286,17,17,0,1,0
7,293,293,28,28,0,1,0
11,299,299,42,24,18,2,1
3,313,313,20,20,0,1,0
13,329,329,12,6,6,3,2
31,334,334,13,13,0,1,0
2,340,340,1,1,0,1,0
26,341,341,20,20,0,1,0
29,343,343,3,3,0,1,0
5,359,359,60,23,37,2,1
22,388,388,26,26,0,1,0
25,395,395,4,4,0,1,0
4,397,397,11,3,8,2,1
30,411,411,32,32,0,1,0
17,411,411,34,19,15,2,1
24,428,428,4,4,0,1,0
20,452,452,218,208,10,3,2
0,453,453,75,75,0,1,0
14,469,469,10,4,6,3,2
32,477,477,46,46,0,1,0
12,485,485,34,3,31,3,2
10,486,486,44,44,0,1,0

18,100,100,12,5,7,2,1
13,133,133,25,25,0,1,0
4,133,133,2,2,0,1,0
25,138,138,1,1,0,1,0
11,160,160,1,1,0,1,0
6,187,187,16,16,0,1,0
15,189,189,9,1,8,3,2
29,190,190,17,17,0,1,0
21,194,194,15,15,0,1,0
3,196,196,32,32,0,1,0
27,198,198,59,59,0,1,0
5,200,200,2,2,0,1,0
20,210,210,42,42,0,1,0
2,214,214,4,4,0,1,0
10,218,218,2,2,0,1,0
12,256,256,10,10,0,1,0
23,270,270,20,10,10,2,1
14,272,272,26,26,0,1,0
17,286,286,37,37,0,1,0
16,330,330,11,8,3,2,1
24,341,341,22,22,0,1,0
0,345,345,25,7,18,4,3
30,348,348,33,20,13,2,1
1,401,401,15,15,0,1,0
22,431,431,15,15,0,1,0
7,446,446,65,65,0,1,0
19,455,455,10,10,0,1,0
26,460,460,63,51,12,2,1
8,463,463,5,5,0,1,0
28,489,489,40,10,30,3,2
9,496,496,210,210,0,1,0

19,115,115,1,1,0,1,0
9,132,132,51,51,0,1,0
16,205,205,19,7,12,2,1
8,221,221,18,5,13,2,1
22,228,228,25,25,0,1,0
13,265,265,13,8,5,2,1
0,275,275,129,102,27,4,3
23,282,282,10,10,0,1,0
1,306,306,19,1,18,2,1
4,321,321,24,24,0,1,0
12,338,338,27,27,0,1,0
15,339,339,26,14,12,3,2
17,340,340,70,52,18,3,2
11,342,342,53,53,0,1,0
7,354,354,9,9,0,1,0
20,356,356,132,18,114,4,3
3,406,406,26,10,16,3,2
18,423,423,68,20,48,4,3
6,430,430,12,12,0,1,0
10,432,432,9,9,0,1,0
14,436,436,18,18,0,1,0
2,446,446,27,24,3,2,1
21,455,455,10,1,9,4,3
5,490,490,73,73,0,1,0

5,107,107,3,3,0,1,0
20,118,118,1,1,0,1,0
14,122,122,12,12,0,1,0
31,144,144,6,6,0,1,0
13,182,182,35,35,0,1,0
18,191,191,5,5,0,1,0
10,213,213,1,1,0,1,0
28,215,215,4,4,0,1,0
12,228,228,19,19,0,1,0
2,231,231,48,48,0,1,0
15,240,240,46,26,20,4,3
4,243,243,3,3,0,1,0
8,243,243,10,1,9,4,3
29,245,245,12,12,0,1,0
22,246,246,33,33,0,1,0
11,265,265,7,3,4,2,1
3,286,286,9,9,0,1,0
30,300,300,33,9,24,3,2
1,330,330,1,1,0,1,0
27,343,343,53,53,0,1,0
17,364,364,59,47,12,4,3
23,367,367,1,1,0,1,0
9,370,370,66,38,28,2,1
6,382,382,9,9,0,1,0
21,398,398,31,10,21,2,1
16,407,407,20,20,0,1,0
19,422,422,100,83,17,2,1
7,439,439,27,27,0,1,0
24,449,449,217,85,132,4,3
25,449,449,9,1,8,2,1
0,467,467,3,3,0,1,0
26,472,472,26,26,0,1,0

1,112,112,5,2,3,2,1
12,130,130,4,1,3,2,1
0,148,148,4,1,3,2,1
4,156,156,45,45,0,1,0
16,161,161,3,3,0,1,0
14,203,203,57,57,0,1,0
7,229,229,12,12,0,1,0
24,237,237,25,25,0,1,0
8,249,249,17,4,13,2,1
23,257,257,3,3,0,1,0
15,264,264,94,74,20,2,1
11,284,284,28,28,0,1,0
21,299,299,20,11,9,4,3
13,300,300,4,4,0,1,0
20,301,301,25,17,8,3,2
22,362,362,14,14,0,1,0
19,365,365,28,28,0,1,0
6,378,378,94,37,57,4,3
10,381,381,34,14,20,3,2
9,397,397,29,22,7,2,1
5,400,400,70,21,49,2,1
3,412,412,75,39,36,2,1
17,421,421,87,67,20,2,1
18,468,468,7,7,0,1,0
25,487,487,58,31,27,2,1
2,489,489,27,1,26,2,1

28,103,103,16,8,8,3,2
27,118,118,6,6,0,1,0
8,119,119,5,5,0,1,0
4,139,139,15,6,9,4,3
7,148,148,18,18,0,1,0
0,153,153,35,35,0,1,0
9,161,161,10,10,0,1,0
25,174,174,10,7,3,2,1
5,177,177,8,3,5,2,1
22,179,179,11,1,10,3,2
19,185,185,36,15,21,4,3
26,218,218,21,21,0,1,0
10,221,221,7,7,0,1,0
15,224,224,21,16,5,2,1
20,234,234,9,2,7,2,1
14,286,286,34,29,5,2,1
13,287,287,1,1,0,1,0
21,313,313,75,55,20,2,1
23,318,318,45,27,18,4,3
6,351,351,28,19,9,4,3
11,363,363,65,65,0,1,0
1,375,375,54,54,0,1,0
16,393,393,9,9,0,1,0
3,409,409,57,57,0,1,0
24,410,410,95,53,42,2,1
17,449,449,8,8,0,1,0
18,449,449,17,17,0,1,0
2,483,483,34,34,0,1,0
12,496,496,13,5,8,3,2

7,103,103,1,1,0,1,0
13,117,117,9,9,0,1,0
17,123,123,14,14,0,1,0
9,133,133,3,3,0,1,0
11,151,151,36,15,21,3,2
8,166,166,9,9,0,1,0
5,169,169,23,23,0,1,0
10,181,181,16,16,0,1,0
0,185,185,40,3,37,2,1
21,191,191,12,3,9,4,3
29,202,202,16,16,0,1,0
1,204,204,41,41,0,1,0
19,208,208,1,1,0,1,0
25,270,270,17,3,14,3,2
6,277,277,26,12,14,2,1
14,278,278,12,12,0,1,0
15,283,283,13,7,6,2,1
4,304,304,36,36,0,1,0
20,341,341,32,20,12,3,2
3,341,341,12,12,0,1,0
23,357,357,3,3,0,1,0
24,364,364,98,70,28,3,2
18,399,399,28,17,11,2,1
26,416,416,84,36,48,2,1
16,423,423,17,17,0,1,0
12,442,442,1,1,0,1,0
27,452,452,77,77,0,1,0
22,458,458,91,91,0,1,0
28,482,482,23,13,10,2,1
2,499,499,9,9,0,1,0

11,133,133,3,3,0,1,0
10,133,133,18,18,0,1,0
17,143,143,10,10,0,1,0
8,145,145,5,5,0,1,0
22,151,151,22,1,21,4,3
5,174,174,2,2,0,1,0
24,186,186,26,26,0,1,0
27,191,191,2,2,0,1,0
23,220,220,6,6,0,1,0
0,257,257,9,9,0,1,0
26,269,269,82,82,0,1,0
34,294,294,16,11,5,2,1
20,299,299,8,8,0,1,0
33,299,299,39,39,0,1,0
28,326,326,24,24,0,1,0
1,341,341,41,23,18,4,3
2,344,344,20,20,0,1,0
25,345,345,70,70,0,1,0
7,346,346,17,5,12,2,1
12,347,347,7,7,0,1,0
18,358,358,2,2,0,1,0
31,377,377,18,12,6,2,1
30,393,393,15,1,14,3,2
6,396,396,33,6,27,4,3
19,396,396,44,15,29,3,2
13,400,400,22,5,17,2,1
29,406,406,8,8,0,1,0
4,414,414,60,51,9,4,3
9,419,419,11,5,6,3,2
32,440,440,20,6,14,3,2
21,452,452,83,83,0,1,0
3,470,470,27,7,20,2,1
14,471,471,30,17,13,2,1
16,487,487,75,63,12,3,2
15,495,495,58,16,42,3,2

1,108,108,1,1,0,1,0
29,112,112,8,8,0,1,0
19,117,117,11,6,5,2,1
30,146,146,3,3,0,1,0
16,159,159,14,14,0,1,0
5,171,171,9,9,0,1,0
7,175,175,3,3,0,1,0
15,209,209,6,6,0,1,0
2,213,213,32,17,15,2,1
22,213,213,1,1,0,1,0
9,219,219,6,6,0,1,0
0,242,242,1,1,0,1,0
4,269,269,16,2,14,2,1
20,276,276,26,26,0,1,0
26,284,284,9,9,0,1,0
21,285,285,11,11,0,1,0
6,294,294,24,24,0,1,0
23,360,360,27,27,0,1,0
3,361,361,1,1,0,1,0
10,361,361,57,23,34,2,1
17,375,375,19,11,8,2,1
12,377,377,41,41,0,1,0
14,378,378,24,12,12,4,3
11,397,397,93,69,24,4,3
27,403,403,112,105,7,2,1
13,420,420,55,19,36,3,2
28,430,430,117,117,0,1,0
24,451,451,10,10,0,1,0
31,453,453,143,143,0,1,0
25,468,468,32,32,0,1,0
8,496,496,67,4,63,4,3
18,499,499,18,4,14,2,1

30,104,104,2,2,0,1,0
27,107,107,2,2,0,1,0
18,144,144,12,3,9,4,3
10,152,152,1,1,0,1,0
23,158,158,11,1,10,3,2
6,179,179,1,1,0,1,0
19,179,179,32,18,14,4,3
11,180,180,20,5,15,2,1
0,194,194,1,1,0,1,0
16,196,196,9,9,0,1,0
25,219,219,32,32,0,1,0
7,232,232,2,2,0,1,0
31,233,233,11,5,6,3,2
9,245,245,121,71,50,3,2
4,247,247,24,24,0,1,0
20,261,261,18,18,0,1,0
14,262,262,4,4,0,1,0
28,285,285,13,13,0,1,0
15,308,308,10,1,9,4,3
1,330,330,13,13,0,1,0
12,341,341,64,64,0,1,0
3,345,345,4,4,0,1,0
21,363,363,107,59,48,4,3
8,365,365,35,31,4,2,1
5,375,375,18,14,4,2,1
13,392,392,12,12,0,1,0
26,419,419,13,10,3,2,1
2,425,425,70,46,24,4,3
24,458,458,19,19,0,1,0
29,460,460,154,113,41,2,1
22,476,476,25,18,7,2,1
17,485,485,1,1,0,1,0

32,101,101,7,7,0,1,0
17,141,141,4,4,0,1,0
27,151,151,4,4,0,1,0
4,153,153,17,17,0,1,0
25,162,162,11,7,4,2,1
14,163,163,18,18,0,1,0
5,183,183,4,4,0,1,0
1,188,188,34,21,13,2,1
8,212,212,7,7,0,1,0
20,219,219,18,7,11,2,1
3,233,233,15,6,9,4,3
10,273,273,1,1,0,1,0
30,275,275,1,1,0,1,0
6,276,276,20,13,7,2,1
22,284,284,1,1,0,1,0
31,310,310,15,3,12,3,2
24,323,323,149,46,103,4,3
0,329,329,43,43,0,1,0
9,338,338,110,64,46,2,1
29,344,344,22,22,0,1,0
18,348,348,43,43,0,1,0
12,352,352,6,6,0,1,0
28,355,355,135,13,122,4,3
26,358,358,4,4,0,1,0
2,381,381,21,21,0,1,0
16,391,391,3,3,0,1,0
15,396,396,11,3,8,3,2
13,423,423,17,8,9,2,1
11,426,426,1,1,0,1,0
23,442,442,45,10,35,4,3
19,462,462,38,19,19,4,3
21,471,471,14,14,0,1,0
7,474,474,22,2,20,3,2

7,104,104,11,2,9,4,3
8,107,107,1,1,0,1,0
19,122,122,6,6,0,1,0
9,144,144,25,7,18,4,3
24,172,172,2,2,0,1,0
0,183,183,21,6,15,2,1
12,192,192,18,2,16,2,1
4,197,197,37,1,36,4,3
1,198,198,49,49,0,1,0
3,226,226,25,25,0,1,0
25,302,302,42,2,40,2,1
13,308,308,22,22,0,1,0
15,314,314,21,21,0,1,0
16,326,326,1,1,0,1,0
10,328,328,19,19,0,1,0
26,333,333,2,2,0,1,0
17,335,335,92,92,0,1,0
11,360,360,98,8,90,4,3
23,373,373,72,72,0,1,0
21,374,374,24,24,0,1,0
22,382,382,25,25,0,1,0
2,410,410,1,1,0,1,0
20,467,467,2,2,0,1,0
18,473,473,53,49,4,2,1
14,475,475,173,173,0,1,0
6,489,489,10,10,0,1,0
5,496,496,4,4,0,1,0

4,112,112,1,1,0,1,0
21,118,118,11,8,3,2,1
3,123,123,16,16,0,1,0
6,123,123,2,2,0,1,0
29,127,127,9,4,5,2,1
0,157,157,11,11,0,1,0
15,161,161,16,3,13,2,1
27,173,173,7,1,6,2,1
30,185,185,10,10,0,1,0
16,191,191,13,13,0,1,0
11,202,202,15,1,14,2,1
1,231,231,6,6,0,1,0
5,269,269,50,2,48,4,3
13,287,287,8,2,6,3,2
7,315,315,1,1,0,1,0
8,336,336,123,112,11,2,1
9,346,346,6,2,4,2,1
28,354,354,20,4,16,3,2
14,355,355,79,23,56,3,2
12,370,370,1,1,0,1,0
19,384,384,95,8,87,4,3
23,398,398,12,12,0,1,0
17,403,403,14,14,0,1,0
18,419,419,46,13,33,2,1
22,442,442,22,22,0,1,0
25,455,455,3,3,0,1,0
2,456,456,31,31,0,1,0
26,487,487,219,141,78,3,2
24,488,488,87,21,66,4,3
10,494,494,8,8,0,1,0
20,497,497,1,1,0,1,0

9,101,101,1,1,0,1,0
3,108,108,40,6,34,3,2
26,120,120,2,2,0,1,0
0,130,130,6,6,0,1,0
8,132,132,17,4,13,2,1
28,138,138,5,5,0,1,0
24,141,141,4,4,0,1,0
25,165,165,31,5,26,2,1
13,168,168,3,3,0,1,0
11,187,187,70,70,0,1,0
16,187,187,32,2,30,3,2
18,209,209,27,27,0,1,0
14,217,217,15,4,11,2,1
10,241,241,30,19,11,2,1
22,271,271,17,10,7,2,1
27,272,272,56,56,0,1,0
2,276,276,10,1,9,4,3
17,277,277,11,11,0,1,0
21,279,279,6,2,4,2,1
1,321,321,1,1,0,1,0
4,331,331,26,26,0,1,0
20,351,351,40,24,16,3,2
15,360,360,14,14,0,1,0
7,412,412,1,1,0,1,0
23,429,429,13,5,8,2,1
6,447,447,24,24,0,1,0
19,448,448,156,143,13,2,1
12,453,453,4,4,0,1,0
5,459,459,35,13,22,3,2

7,102,102,8,8,0,1,0
17,114,114,18,18,0,1,0
5,115,115,25,10,15,2,1
0,136,136,12,12,0,1,0
2,141,141,32,32,0,1,0
19,146,146,31,22,9,2,1
10,164,164,13,4,9,2,1
23,168,168,33,20,13,2,1
22,185,185,12,12,0,1,0
8,217,217,1,1,0,1,0
25,230,230,28,1,27,4,3
14,233,233,22,22,0,1,0
1,335,335,11,6,5,2,1
24,354,354,43,25,18,3,2
13,373,373,14,14,0,1,0
15,383,383,19,19,0,1,0
6,384,384,18,18,0,1,0
9,410,410,52,26,26,3,2
11,415,415,72,50,22,3,2
21,442,442,43,19,24,4,3
4,472,472,24,24,0,1,0
12,483,483,31,31,0,1,0
16,485,485,18,8,10,3,2
3,486,486,134,134,0,1,0
20,487,487,57,25,32,2,1
18,489,489,26,1,25,2,1

22,114,114,8,8,0,1,0
1,122,122,3,3,0,1,0
2,138,138,5,5,0,1,0
7,193,193,40,23,17,2,1
12,196,196,7,7,0,1,0
10,244,244,24,24,0,1,0
3,259,259,30,6,24,3,2
5,264,264,80,43,37,2,1
14,289,289,114,114,0,1,0
26,293,293,20,5,15,4,3
4,298,298,14,7,7,2,1
23,310,310,37,9,28,3,2
6,318,318,35,35,0,1,0
19,346,346,91,4,87,4,3
18,366,366,9,9,0,1,0
11,367,367,34,11,23,4,3
15,396,396,4,4,0,1,0
13,398,398,11,11,0,1,0
0,400,400,35,35,0,1,0
16,408,408,54,14,40,2,1
25,417,417,3,3,0,1,0
20,418,418,24,7,17,2,1
9,439,439,33,33,0,1,0
24,463,463,39,18,21,2,1
8,466,466,79,79,0,1,0
17,474,474,70,36,34,3,2
21,493,493,6,1,5,2,1

11,106,106,5,5,0,1,0
17,127,127,2,2,0,1,0
6,159,159,11,11,0,1,0
12,163,163,14,8,6,3,2
23,177,177,9,9,0,1,0
9,184,184,11,11,0,1,0
18,204,204,23,6,17,2,1
5,219,219,52,7,45,4,3
15,237,237,53,9,44,4,3
13,270,270,6,6,0,1,0
20,284,284,9,2,7,2,1
22,334,334,32,32,0,1,0
16,365,365,162,57,105,4,3
10,385,385,39,39,0,1,0
1,389,389,46,8,38,3,2
7,396,396,18,18,0,1,0
21,401,401,53,8,45,2,1
14,402,402,22,22,0,1,0
24,410,410,14,14,0,1,0
25,424,424,35,35,0,1,0
2,428,428,102,43,59,4,3
4,434,434,34,34,0,1,0
0,451,451,47,23,24,3,2
19,452,452,19,19,0,1,0
8,479,479,92,86,6,3,2
3,485,485,54,54,0,1,0

3,119,119,10,10,0,1,0
12,120,120,21,21,0,1,0
8,122,122,2,2,0,1,0
21,128,128,6,6,0,1,0
11,135,135,28,2,26,3,2
27,177,177,45,35,10,2,1
23,180,180,21,7,14,3,2
6,217,217,19,10,9,4,3
15,227,227,11,11,0,1,0
14,252,252,10,10,0,1,0
16,255,255,23,23,0,1,0
22,287,287,22,8,14,3,2
28,298,298,48,10,38,2,1
0,300,300,2,2,0,1,0
9,318,318,1,1,0,1,0
19,322,322,7,7,0,1,0
13,344,344,27,18,9,4,3
2,385,385,38,38,0,1,0
24,387,387,31,31,0,1,0
1,394,394,115,37,78,4,3
17,416,416,3,3,0,1,0
4,419,419,9,9,0,1,0
10,420,420,16,16,0,1,0
7,420,420,59,59,0,1,0
5,439,439,29,29,0,1,0
20,439,439,108,108,0,1,0
29,440,440,44,44,0,1,0
25,473,473,58,1,57,4,3
26,474,474,32,32,0,1,0
18,484,484,15,15,0,1,0

0,115,115,1,1,0,1,0
25,117,117,19,19,0,1,0
18,125,125,11,11,0,1,0
23,133,133,9,9,0,1,0
6,141,141,31,1,30,4,3
4,175,175,16,16,0,1,0
11,180,180,23,23,0,1,0
9,188,188,12,12,0,1,0
2,190,190,8,2,6,3,2
22,196,196,11,7,4,2,1
20,201,201,14,14,0,1,0
13,247,247,2,2,0,1,0
16,303,303,17,17,0,1,0
24,314,314,75,75,0,1,0
15,317,317,26,26,0,1,0
7,329,329,20,20,0,1,0
1,355,355,4,4,0,1,0
17,357,357,126,126,0,1,0
14,363,363,64,49,15,2,1
5,367,367,49,7,42,3,2
8,418,418,96,68,28,3,2
19,450,450,14,14,0,1,0
3,463,463,11,11,0,1,0
10,482,482,188,176,12,3,2
21,483,483,19,8,11,2,1
12,494,494,6,6,0,1,0

10,113,113,7,7,0,1,0
1,120,120,1,1,0,1,0
19,122,122,14,2,12,2,1
14,138,138,13,13,0,1,0
11,140,140,28,28,0,1,0
13,172,172,70,70,0,1,0
16,191,191,20,20,0,1,0
9,225,225,48,21,27,2,1
7,230,230,41,41,0,1,0
18,274,274,38,7,31,2,1
21,332,332,3,3,0,1,0
6,352,352,33,33,0,1,0
24,356,356,36,36,0,1,0
4,358,358,8,2,6,3,2
25,362,362,32,25,7,2,1
20,366,366,2,2,0,1,0
8,366,366,20,20,0,1,0
15,370,370,16,1,15,4,3
23,380,380,23,13,10,3,2
17,426,426,7,3,4,2,1
5,436,436,43,13,30,3,2
22,447,447,84,84,0,1,0
3,449,449,96,64,32,4,3
0,467,467,3,3,0,1,0
2,469,469,117,36,81,4,3
12,486,486,24,7,17,2,1

19,105,105,3,3,0,1,0
2,106,106,9,6,3,2,1
1,120,120,26,26,0,1,0
20,129,129,8,8,0,1,0
8,146,146,17,17,0,1,0
27,168,168,23,8,15,2,1
18,168,168,7,1,6,2,1
16,175,175,1,1,0,1,0
22,199,199,6,6,0,1,0
15,220,220,26,26,0,1,0
14,221,221,22,9,13,2,1
7,222,222,31,25,6,2,1
9,272,272,9,9,0,1,0
3,297,297,47,22,25,2,1
10,310,310,26,2,24,4,3
4,328,328,63,10,53,3,2
0,333,333,37,37,0,1,0
13,357,357,34,34,0,1,0
5,365,365,26,26,0,1,0
25,380,380,117,90,27,4,3
21,381,381,9,5,4,2,1
6,417,417,1,1,0,1,0
12,431,431,35,35,0,1,0
23,443,443,133,87,46,2,1
17,448,448,10,3,7,2,1
24,450,450,3,3,0,1,0
26,473,473,119,116,3,2,1
11,480,480,7,4,3,2,1

24,103,103,8,8,0,1,0
28,114,114,3,3,0,1,0
21,119,119,1,1,0,1,0
6,153,153,5,5,0,1,0
27,154,154,53,17,36,4,3
7,184,184,32,32,0,1,0
18,188,188,9,5,4,2,1
5,190,190,10,10,0,1,0
25,215,215,15,3,12,3,2
15,222,222,2,2,0,1,0
11,224,224,53,53,0,1,0
16,244,244,11,5,6,2,1
26,255,255,13,7,6,2,1
8,262,262,54,30,24,3,2
10,290,290,68,37,31,2,1
2,293,293,19,16,3,2,1
19,295,295,6,6,0,1,0
4,312,312,33,18,15,2,1
20,318,318,80,28,52,3,2
13,321,321,41,9,32,3,2
17,328,328,19,14,5,2,1
1,378,378,1,1,0,1,0
23,398,398,144,64,80,3,2
0,413,413,4,4,0,1,0
3,417,417,8,8,0,1,0
12,451,451,26,20,6,2,1
9,463,463,22,22,0,1,0
14,498,498,15,5,10,3,2
22,499,499,34,4,30,3,2

15,136,136,15,11,4,2,1
0,138,138,42,11,31,2,1
19,179,179,43,43,0,1,0
7,182,182,22,22,0,1,0
12,186,186,20,20,0,1,0
18,215,215,24,4,20,3,2
1,220,220,2,2,0,1,0
9,235,235,1,1,0,1,0
17,242,242,5,5,0,1,0
3,255,255,50,40,10,3,2
23,263,263,51,12,39,4,3
22,266,266,5,5,0,1,0
20,267,267,3,3,0,1,0
11,301,301,69,22,47,3,2
13,301,301,11,11,0,1,0
16,303,303,24,24,0,1,0
2,308,308,91,82,9,4,3
6,348,348,31,31,0,1,0
4,358,358,33,33,0,1,0
21,389,389,30,30,0,1,0
5,409,409,59,51,8,2,1
8,438,438,65,23,42,4,3
10,459,459,39,39,0,1,0
14,462,462,49,49,0,1,0

5,139,139,5,5,0,1,0
21,200,200,64,19,45,4,3
3,204,204,33,33,0,1,0
17,207,207,3,3,0,1,0
25,220,220,1,1,0,1,0
1,239,239,2,2,0,1,0
23,278,278,5,5,0,1,0
27,295,295,17,5,12,4,3
14,304,304,40,22,18,2,1
24,305,305,10,4,6,3,2
20,316,316,37,29,8,2,1
15,338,338,14,14,0,1,0
22,347,347,39,24,15,4,3
6,359,359,39,6,33,4,3
8,361,361,10,10,0,1,0
4,361,361,16,16,0,1,0
13,363,363,32,32,0,1,0
2,365,365,21,21,0,1,0
0,380,380,20,6,14,2,1
19,381,381,16,16,0,1,0
26,386,386,11,11,0,1,0
12,389,389,79,57,22,2,1
7,408,408,45,45,0,1,0
28,444,444,46,46,0,1,0
11,464,464,2,2,0,1,0
16,481,481,242,191,51,4,3
18,486,486,12,2,10,3,2
9,486,486,46,42,4,2,1
10,491,491,134,87,47,2,1

12,138,138,20,20,0,1,0
19,140,140,15,15,0,1,0
13,143,143,17,17,0,1,0
15,143,143,15,15,0,1,0
9,145,145,1,1,0,1,0
11,156,156,8,8,0,1,0
17,164,164,18,7,11,2,1
8,178,178,20,16,4,2,1
25,180,180,16,16,0,1,0
27,184,184,12,12,0,1,0
5,226,226,49,49,0,1,0
3,236,236,7,1,6,3,2
0,244,244,62,62,0,1,0
22,248,248,3,3,0,1,0
10,259,259,12,12,0,1,0
6,283,283,16,16,0,1,0
7,320,320,27,27,0,1,0
20,326,326,2,2,0,1,0
4,332,332,49,49,0,1,0
16,333,333,29,13,16,4,3
1,345,345,7,7,0,1,0
26,368,368,15,15,0,1,0
21,373,373,38,4,34,3,2
24,394,394,19,19,0,1,0
18,400,400,80,50,30,3,2
2,425,425,47,30,17,2,1
23,447,447,135,135,0,1,0
14,463,463,69,59,10,2,1

30,137,137,13,13,0,1,0
28,156,156,29,5,24,2,1
3,170,170,6,1,5,2,1
0,171,171,5,5,0,1,0
8,179,179,3,3,0,1,0
16,192,192,11,11,0,1,0
6,193,193,19,5,14,3,2
29,203,203,25,18,7,2,1
4,211,211,19,5,14,3,2
1,223,223,7,7,0,1,0
14,227,227,7,7,0,1,0
17,247,247,79,55,24,4,3
15,248,248,26,9,17,2,1
5,258,258,2,2,0,1,0
27,260,260,9,9,0,1,0
12,268,268,2,2,0,1,0
11,282,282,16,16,0,1,0
25,293,293,6,1,5,2,1
19,300,300,183,183,0,1,0
13,304,304,29,7,22,3,2
2,318,318,80,30,50,3,2
20,333,333,25,9,16,2,1
7,397,397,1,1,0,1,0
9,409,409,33,17,16,2,1
21,421,421,44,15,29,2,1
22,446,446,19,5,14,2,1
26,449,449,12,12,0,1,0
24,451,451,10,10,0,1,0
31,453,453,29,29,0,1,0
18,469,469,7,2,5,2,1
10,485,485,41,41,0,1,0
23,489,489,5,5,0,1,0

30,141,141,10,2,8,3,2
13,143,143,7,7,0,1,0
3,146,146,17,3,14,2,1
20,147,147,24,24,0,1,0
16,148,148,1,1,0,1,0
23,155,155,5,1,4,2,1
26,158,158,32,32,0,1,0
24,182,182,34,34,0,1,0
12,184,184,11,2,9,4,3
21,194,194,3,3,0,1,0
5,197,197,7,7,0,1,0
27,215,215,22,22,0,1,0
0,217,217,17,12,5,2,1
6,218,218,13,3,10,2,1
32,255,255,24,24,0,1,0
29,260,260,32,32,0,1,0
25,270,270,56,7,49,2,1
22,278,278,1,1,0,1,0
11,283,283,48,48,0,1,0
2,290,290,1,1,0,1,0
33,333,333,1,1,0,1,0
8,336,336,48,8,40,3,2
17,348,348,11,11,0,1,0
28,357,357,9,9,0,1,0
19,385,385,22,14,8,3,2
14,388,388,7,7,0,1,0
31,391,391,97,97,0,1,0
9,405,405,7,7,0,1,0
18,406,406,2,2,0,1,0
35,409,409,44,44,0,1,0
15,413,413,29,29,0,1,0
10,435,435,44,44,0,1,0
7,447,447,7,3,4,2,1
34,462,462,10,10,0,1,0
1,475,475,30,9,21,2,1
4,475,475,59,59,0,1,0

7,110,110,3,3,0,1,0
5,121,121,4,1,3,2,1
16,165,165,4,4,0,1,0
17,168,168,18,4,14,4,3
15,178,178,6,6,0,1,0
8,179,179,18,18,0,1,0
24,195,195,29,29,0,1,0
11,198,198,17,5,12,2,1
1,206,206,1,1,0,1,0
6,211,211,10,10,0,1,0
22,240,240,84,45,39,4,3
23,245,245,6,6,0,1,0
9,249,249,43,6,37,2,1
20,260,260,105,24,81,4,3
10,295,295,28,22,6,3,2
18,296,296,12,7,5,2,1
21,299,299,4,4,0,1,0
4,305,305,20,20,0,1,0
2,314,314,118,64,54,3,2
12,340,340,56,52,4,2,1
14,348,348,3,3,0,1,0
3,374,374,99,51,48,2,1
19,379,379,16,2,14,2,1
0,395,395,52,21,31,2,1
25,406,406,7,7,0,1,0
13,439,439,20,1,19,2,1

24,109,109,11,11,0,1,0
6,115,115,10,10,0,1,0
4,129,129,7,1,6,3,2
13,151,151,7,7,0,1,0
3,154,154,34,34,0,1,0
7,166,166,14,14,0,1,0
11,168,168,16,5,11,2,1
23,177,177,41,38,3,2,1
22,193,193,18,3,15,4,3
17,243,243,7,7,0,1,0
8,260,260,20,20,0,1,0
1,267,267,54,3,51,3,2
2,305,305,24,24,0,1,0
0,306,306,22,4,18,4,3
19,318,318,43,43,0,1,0
21,349,349,123,123,0,1,0
9,369,369,47,22,25,2,1
14,387,387,6,6,0,1,0
12,392,392,73,73,0,1,0
18,393,393,15,15,0,1,0
20,394,394,17,17,0,1,0
5,403,403,69,69,0,1,0
15,438,438,6,6,0,1,0
16,444,444,23,20,3,2,1
10,500,500,113,53,60,4,3

3,108,108,6,6,0,1,0
15,110,110,5,5,0,1,0
22,113,113,1,1,0,1,0
17,126,126,20,8,12,4,3
11,146,146,1,1,0,1,0
6,164,164,34,34,0,1,0
1,171,171,9,9,0,1,0
14,173,173,57,36,21,4,3
20,286,286,3,3,0,1,0
8,319,319,25,25,0,1,0
0,320,320,73,73,0,1,0
10,324,324,25,1,24,3,2
23,330,330,77,27,50,2,1
13,339,339,51,15,36,4,3
21,346,346,7,1,6,2,1
16,360,360,17,13,4,2,1
4,380,380,148,106,42,3,2
12,411,411,23,7,16,2,1
24,418,418,62,62,0,1,0
19,421,421,17,17,0,1,0
9,449,449,6,6,0,1,0
7,450,450,67,43,24,2,1
2,471,471,12,5,7,2,1
5,484,484,61,61,0,1,0
18,494,494,88,76,12,4,3

25,114,114,21,21,0,1,0
22,116,116,12,8,4,2,1
2,168,168,77,77,0,1,0
4,200,200,7,2,5,2,1
14,216,216,65,65,0,1,0
16,234,234,7,7,0,1,0
9,239,239,19,19,0,1,0
20,241,241,8,8,0,1,0
13,247,247,18,14,4,2,1
5,260,260,23,13,10,2,1
6,280,280,6,6,0,1,0
24,290,290,4,1,3,2,1
0,293,293,13,10,3,2,1
12,309,309,81,12,69,4,3
8,316,316,54,54,0,1,0
23,329,329,14,14,0,1,0
21,403,403,2,2,0,1,0
17,407,407,24,4,20,3,2
11,410,410,46,46,0,1,0
10,428,428,84,84,0,1,0
7,433,433,82,1,81,4,3
19,438,438,125,22,103,4,3
15,459,459,2,2,0,1,0
18,460,460,14,4,10,2,1
1,468,468,1,1,0,1,0
3,479,479,1,1,0,1,0

15,143,143,3,3,0,1,0
13,145,145,1,1,0,1,0
21,170,170,5,5,0,1,0
17,191,191,7,3,4,2,1
19,193,193,5,5,0,1,0
10,208,208,3,3,0,1,0
29,209,209,56,16,40,2,1
6,213,213,56,10,46,2,1
16,221,221,12,12,0,1,0
11,225,225,36,36,0,1,0
5,226,226,17,17,0,1,0
24,239,239,9,9,0,1,0
26,273,273,2,2,0,1,0
14,297,297,66,66,0,1,0
0,303,303,1,1,0,1,0
8,305,305,26,26,0,1,0
7,311,311,6,3,3,2,1
23,321,321,68,68,0,1,0
1,347,347,15,15,0,1,0
4,349,349,3,3,0,1,0
2,362,362,1,1,0,1,0
31,366,366,112,105,7,2,1
22,385,385,57,57,0,1,0
3,393,393,18,13,5,2,1
32,399,399,40,40,0,1,0
30,403,403,23,23,0,1,0
27,406,406,33,9,24,3,2
18,415,415,60,60,0,1,0
9,425,425,72,72,0,1,0
25,446,446,25,25,0,1,0
12,476,476,12,4,8,3,2
28,499,499,26,26,0,1,0
20,500,500,17,13,4,2,1

15,123,123,9,9,0,1,0
13,127,127,3,3,0,1,0
10,135,135,18,4,14,2,1
7,138,138,5,1,4,2,1
26,154,154,4,4,0,1,0
3,164,164,5,1,4,2,1
14,167,167,8,8,0,1,0
12,181,181,1,1,0,1,0
5,201,201,42,15,27,4,3
2,218,218,29,3,26,3,2
1,219,219,4,4,0,1,0
27,233,233,9,3,6,3,2
21,271,271,64,64,0,1,0
19,290,290,128,90,38,3,2
23,295,295,14,14,0,1,0
17,297,297,2,2,0,1,0
6,324,324,46,46,0,1,0
25,327,327,11,5,6,3,2
0,338,338,98,20,78,4,3
20,382,382,15,15,0,1,0
28,393,393,44,8,36,4,3
18,394,394,21,10,11,2,1
11,402,402,45,45,0,1,0
29,425,425,13,13,0,1,0
24,425,425,7,1,6,3,2
22,431,431,61,43,18,3,2
16,463,463,93,27,66,3,2
8,472,472,5,5,0,1,0
4,473,473,31,2,29,3,2
9,499,499,37,37,0,1,0

10,102,102,2,2,0,1,0
13,108,108,12,6,6,3,2
9,121,121,15,15,0,1,0
3,136,136,27,27,0,1,0
5,140,140,41,12,29,2,1
8,152,152,12,12,0,1,0
1,192,192,4,4,0,1,0
16,216,216,20,3,17,4,3
12,231,231,107,95,12,4,3
23,241,241,23,2,21,2,1
22,246,246,27,17,10,2,1
11,269,269,43,25,18,4,3
18,272,272,13,13,0,1,0
20,274,274,6,2,4,2,1
17,285,285,3,3,0,1,0
6,294,294,23,11,12,3,2
15,344,344,42,42,0,1,0
0,358,358,74,54,20,4,3
4,364,364,54,6,48,3,2
7,373,373,54,22,32,2,1
2,421,421,48,48,0,1,0
19,460,460,18,18,0,1,0
14,469,469,48,4,44,2,1
21,471,471,11,11,0,1,0

27,108,108,5,5,0,1,0
24,111,111,12,12,0,1,0
6,119,119,1,1,0,1,0
8,132,132,1,1,0,1,0
25,132,132,25,13,12,2,1
3,133,133,1,1,0,1,0
2,135,135,4,4,0,1,0
14,143,143,15,2,13,2,1
20,207,207,64,16,48,3,2
18,229,229,23,13,10,3,2
22,244,244,46,4,42,3,2
19,270,270,6,6,0,1,0
9,283,283,20,20,0,1,0
13,292,292,33,19,14,3,2
0,309,309,98,98,0,1,0
15,330,330,14,14,0,1,0
16,331,331,46,28,18,3,2
7,333,333,50,50,0,1,0
21,352,352,21,21,0,1,0
17,369,369,26,2,24,3,2
23,381,381,15,3,12,2,1
10,415,415,12,12,0,1,0
4,415,415,12,4,8,3,2
12,432,432,9,9,0,1,0
5,446,446,221,197,24,3,2
11,452,452,27,9,18,2,1
1,467,467,30,30,0,1,0
26,480,480,5,1,4,2,1

24,101,101,10,10,0,1,0
16,103,103,3,3,0,1,0
13,163,163,1,1,0,1,0
4,164,164,13,7,6,2,1
26,181,181,10,10,0,1,0
23,190,190,8,2,6,3,2
9,199,199,13,5,8,3,2
18,207,207,8,8,0,1,0
11,240,240,6,6,0,1,0
25,248,248,87,9,78,3,2
2,288,288,24,6,18,2,1
10,311,311,1,1,0,1,0
22,334,334,11,11,0,1,0
19,334,334,2,2,0,1,0
12,338,338,63,63,0,1,0
8,349,349,38,38,0,1,0
1,349,349,15,6,9,2,1
6,352,352,59,59,0,1,0
15,353,353,115,76,39,2,1
7,359,359,8,8,0,1,0
28,366,366,78,78,0,1,0
21,389,389,23,6,17,2,1
17,389,389,55,36,19,3,2
5,440,440,2,2,0,1,0
3,456,456,47,1,46,3,2
20,470,470,77,77,0,1,0
27,472,472,64,47,17,3,2
0,475,475,83,83,0,1,0
29,484,484,33,33,0,1,0
14,487,487,2,2,0,1,0

10,128,128,2,2,0,1,0
1,131,131,7,7,0,1,0
3,137,137,7,1,6,2,1
29,138,138,1,1,0,1,0
5,144,144,22,11,11,4,3
30,149,149,42,42,0,1,0
17,157,157,10,7,3,2,1
13,161,161,31,31,0,1,0
2,172,172,14,2,12,3,2
0,186,186,9,9,0,1,0
24,190,190,1,1,0,1,0
21,232,232,49,11,38,2,1
6,239,239,4,4,0,1,0
19,281,281,26,4,22,2,1
28,284,284,16,5,11,2,1
4,284,284,93,4,89,4,3
16,286,286,33,6,27,4,3
27,289,289,8,2,6,2,1
26,295,295,18,18,0,1,0
22,327,327,50,50,0,1,0
20,334,334,78,60,18,3,2
18,363,363,4,4,0,1,0
23,402,402,11,11,0,1,0
14,411,411,7,7,0,1,0
9,439,439,45,45,0,1,0
8,454,454,58,10,48,2,1
11,465,465,7,1,6,3,2
7,465,465,10,10,0,1,0
15,472,472,26,11,15,2,1
25,479,479,96,96,0,1,0
12,496,496,4,4,0,1,0

19,110,110,3,3,0,1,0
7,133,133,10,1,9,2,1
5,146,146,9,1,8,2,1
17,170,170,23,23,0,1,0
12,174,174,39,39,0,1,0
11,191,191,49,49,0,1,0
18,223,223,2,2,0,1,0
10,261,261,99,16,83,4,3
14,310,310,12,12,0,1,0
1,359,359,36,36,0,1,0
13,364,364,17,11,6,2,1
16,364,364,16,16,0,1,0
8,375,375,5,5,0,1,0
4,386,386,81,81,0,1,0
20,386,386,12,12,0,1,0
6,399,399,45,45,0,1,0
15,438,438,58,58,0,1,0
9,468,468,8,5,3,2,1
2,479,479,97,77,20,2,1
0,486,486,67,67,0,1,0
3,487,487,281,194,87,4,3

1,106,106,7,7,0,1,0
7,109,109,11,11,0,1,0
33,110,110,1,1,0,1,0
15,111,111,2,2,0,1,0
17,124,124,14,14,0,1,0
22,142,142,1,1,0,1,0
23,149,149,11,11,0,1,0
0,163,163,15,15,0,1,0
4,176,176,16,16,0,1,0
14,179,179,13,3,10,2,1
12,191,191,5,2,3,2,1
29,193,193,19,19,0,1,0
28,196,196,3,3,0,1,0
30,200,200,34,26,8,2,1
34,205,205,5,5,0,1,0
20,216,216,5,1,4,2,1
27,218,218,58,13,45,4,3
13,224,224,19,1,18,4,3
21,225,225,30,30,0,1,0
10,235,235,7,7,0,1,0
16,246,246,10,3,7,2,1
32,248,248,65,43,22,2,1
19,268,268,10,10,0,1,0
6,298,298,14,1,13,2,1
36,300,300,1,1,0,1,0
26,316,316,45,45,0,1,0
3,321,321,24,14,10,3,2
24,329,329,70,31,39,4,3
2,335,335,13,1,12,4,3
31,348,348,6,3,3,2,1
18,367,367,60,60,0,1,0
11,380,380,5,2,3,2,1
9,423,423,13,9,4,2,1
5,436,436,7,3,4,2,1
25,444,444,49,26,23,2,1
8,457,457,39,21,18,3,2
35,482,482,12,12,0,1,0

18,120,120,3,3,0,1,0
6,129,129,9,5,4,2,1
22,144,144,12,12,0,1,0
4,148,148,7,7,0,1,0
1,168,168,23,11,12,2,1
10,179,179,38,33,5,2,1
11,202,202,12,12,0,1,0
13,222,222,2,2,0,1,0
17,237,237,48,8,40,3,2
14,241,241,7,7,0,1,0
21,250,250,98,98,0,1,0
12,287,287,23,23,0,1,0
3,333,333,9,3,6,2,1
8,346,346,12,2,10,2,1
9,368,368,4,4,0,1,0
23,378,378,9,9,0,1,0
19,394,394,24,24,0,1,0
5,397,397,143,40,103,4,3
0,407,407,37,5,32,3,2
15,419,419,3,3,0,1,0
16,435,435,77,29,48,2,1
2,448,448,54,48,6,2,1
7,452,452,228,84,144,4,3
20,482,482,30,10,20,2,1

15,114,114,7,2,5,2,1
1,119,119,4,4,0,1,0
21,136,136,3,3,0,1,0
20,164,164,50,46,4,2,1
12,171,171,18,18,0,1,0
22,175,175,1,1,0,1,0
7,192,192,19,5,14,4,3
2,196,196,13,13,0,1,0
8,264,264,13,13,0,1,0
11,278,278,9,9,0,1,0
16,285,285,42,26,16,3,2
18,316,316,7,7,0,1,0
9,319,319,19,13,6,2,1
10,328,328,23,7,16,3,2
3,359,359,36,10,26,3,2
6,363,363,44,44,0,1,0
14,386,386,56,18,38,2,1
4,394,394,170,154,16,3,2
13,404,404,9,9,0,1,0
19,414,414,115,46,69,4,3
23,458,458,4,4,0,1,0
0,468,468,1,1,0,1,0
17,490,490,100,75,25,2,1
5,494,494,217,217,0,1,0

9,111,111,6,6,0,1,0
1,113,113,5,1,4,2,1
24,161,161,24,4,20,3,2
13,162,162,24,15,9,2,1
17,166,166,14,9,5,2,1
21,216,216,47,47,0,1,0
20,221,221,6,1,5,2,1
4,228,228,11,3,8,2,1
5,248,248,80,80,0,1,0
2,262,262,6,1,5,2,1
3,265,265,6,6,0,1,0
12,267,267,72,40,32,3,2
8,274,274,15,4,11,2,1
16,300,300,21,5,16,3,2
6,334,334,71,47,24,3,2
15,345,345,24,24,0,1,0
23,358,358,35,15,20,2,1
7,363,363,38,38,0,1,0
22,388,388,11,5,6,3,2
0,412,412,37,37,0,1,0
11,425,425,151,63,88,4,3
19,426,426,28,13,15,2,1
10,430,430,30,20,10,2,1
14,459,459,23,18,5,2,1
25,462,462,48,12,36,4,3
18,486,486,21,13,8,3,2

7,119,119,4,4,0,1,0
3,120,120,5,5,0,1,0
19,132,132,13,3,10,2,1
4,142,142,3,3,0,1,0
25,147,147,37,37,0,1,0
18,157,157,8,2,6,3,2
16,157,157,12,12,0,1,0
1,158,158,6,1,5,2,1
28,162,162,8,8,0,1,0
2,170,170,30,30,0,1,0
8,175,175,5,5,0,1,0
17,198,198,53,15,38,3,2
12,215,215,35,26,9,4,3
27,219,219,34,34,0,1,0
5,238,238,16,4,12,4,3
20,249,249,10,10,0,1,0
21,250,250,25,25,0,1,0
9,259,259,25,25,0,1,0
22,323,323,7,7,0,1,0
23,344,344,62,38,24,3,2
13,345,345,13,13,0,1,0
11,356,356,8,3,5,2,1
15,376,376,53,9,44,2,1
6,400,400,11,2,9,4,3
14,423,423,79,31,48,3,2
29,445,445,9,3,6,2,1
0,454,454,18,1,17,2,1
24,455,455,40,19,21,4,3
10,456,456,128,60,68,4,3
26,476,476,15,1,14,3,2

3,125,125,15,15,0,1,0
17,127,127,26,26,0,1,0
26,133,133,5,5,0,1,0
20,163,163,4,4,0,1,0
14,169,169,5,5,0,1,0
21,190,190,31,5,26,3,2
18,197,197,22,13,9,2,1
15,238,238,6,6,0,1,0
7,243,243,19,11,8,2,1
19,244,244,6,2,4,2,1
27,247,247,46,7,39,4,3
16,250,250,84,34,50,2,1
8,250,250,38,20,18,4,3
10,259,259,19,11,8,2,1
12,268,268,7,7,0,1,0
28,269,269,24,24,0,1,0
0,297,297,9,1,8,3,2
25,317,317,44,17,27,4,3
24,329,329,2,2,0,1,0
22,343,343,78,28,50,2,1
9,355,355,12,2,10,2,1
23,387,387,67,67,0,1,0
13,393,393,14,14,0,1,0
4,419,419,14,11,3,2,1
30,437,437,14,14,0,1,0
5,447,447,8,4,4,2,1
6,447,447,68,53,15,2,1
29,450,450,11,11,0,1,0
1,463,463,1,1,0,1,0
2,495,495,104,104,0,1,0
11,500,500,24,24,0,1,0

4,108,108,10,2,8,3,2
24,108,108,33,5,28,3,2
2,121,121,13,13,0,1,0
7,122,122,18,18,0,1,0
27,122,122,15,15,0,1,0
28,130,130,5,2,3,2,1
19,151,151,9,4,5,2,1
10,154,154,5,5,0,1,0
22,220,220,58,58,0,1,0
13,223,223,5,5,0,1,0
16,225,225,9,9,0,1,0
17,232,232,26,26,0,1,0
1,304,304,21,21,0,1,0
23,314,314,1,1,0,1,0
20,319,319,9,9,0,1,0
3,321,321,47,4,43,2,1
11,326,326,11,5,6,2,1
6,365,365,17,17,0,1,0
0,367,367,42,21,21,2,1
30,369,369,4,4,0,1,0
8,376,376,1,1,0,1,0
9,383,383,30,6,24,4,3
18,393,393,30,7,23,3,2
29,399,399,49,49,0,1,0
25,402,402,49,19,30,2,1
5,420,420,36,27,9,4,3
21,462,462,15,5,10,2,1
15,481,481,20,20,0,1,0
14,485,485,64,32,32,2,1
26,488,488,66,66,0,1,0
12,497,497,103,10,93,4,3

20,101,101,19,10,9,2,1
15,115,115,6,6,0,1,0
6,123,123,8,8,0,1,0
7,127,127,6,6,0,1,0
5,133,133,40,12,28,2,1
14,150,150,7,7,0,1,0
11,160,160,15,5,10,3,2
1,177,177,66,7,59,3,2
12,201,201,14,3,11,2,1
19,230,230,83,30,53,4,3
9,261,261,21,10,11,3,2
3,267,267,42,42,0,1,0
18,323,323,63,18,45,4,3
21,349,349,14,14,0,1,0
4,350,350,10,4,6,3,2
16,366,366,21,15,6,2,1
10,380,380,7,7,0,1,0
13,405,405,4,4,0,1,0
17,416,416,3,3,0,1,0
8,425,425,90,90,0,1,0
2,463,463,164,75,89,4,3
0,494,494,39,29,10,2,1

7,115,115,5,5,0,1,0
9,115,115,36,2,34,3,2
3,133,133,1,1,0,1,0
2,157,157,27,14,13,2,1
15,168,168,11,3,8,3,2
6,176,176,5,5,0,1,0
22,180,180,33,33,0,1,0
1,184,184,25,25,0,1,0
24,230,230,90,74,16,3,2
11,233,233,1,1,0,1,0
27,241,241,2,2,0,1,0
16,248,248,18,3,15,4,3
0,255,255,9,2,7,2,1
18,261,261,42,4,38,2,1
25,265,265,12,12,0,1,0
21,279,279,3,3,0,1,0
4,298,298,33,33,0,1,0
26,357,357,27,3,24,3,2
17,391,391,18,18,0,1,0
8,401,401,51,51,0,1,0
20,421,421,42,42,0,1,0
13,431,431,67,44,23,2,1
5,455,455,91,33,58,3,2
12,463,463,9,9,0,1,0
10,464,464,23,9,14,3,2
23,478,478,53,5,48,4,3
14,481,481,37,37,0,1,0
19,482,482,36,36,0,1,0

10,114,114,7,7,0,1,0
19,125,125,10,2,8,3,2
8,218,218,49,3,46,2,1
16,224,224,11,1,10,3,2
9,235,235,19,5,14,2,1
11,256,256,26,26,0,1,0
6,263,263,19,2,17,4,3
2,264,264,35,11,24,2,1
7,283,283,33,33,0,1,0
12,302,302,65,65,0,1,0
23,304,304,3,3,0,1,0
3,305,305,16,16,0,1,0
0,314,314,69,23,46,3,2
15,330,330,4,4,0,1,0
18,398,398,41,41,0,1,0
13,430,430,56,6,50,2,1
17,440,440,6,6,0,1,0
4,449,449,47,20,27,4,3
5,456,456,123,74,49,3,2
14,457,457,183,136,47,2,1
1,458,458,58,22,36,2,1
20,468,468,10,2,8,3,2
22,472,472,71,52,19,2,1
21,484,484,39,22,17,2,1

19,101,101,12,12,0,1,0
10,114,114,10,3,7,3,2
1,115,115,11,1,10,3,2
11,156,156,9,9,0,1,0
23,174,174,26,4,22,3,2
21,178,178,15,15,0,1,0
18,213,213,21,21,0,1,0
13,246,246,43,39,4,2,1
2,266,266,54,42,12,4,3
16,270,270,55,55,0,1,0
15,294,294,11,1,10,2,1
3,301,301,82,61,21,2,1
26,317,317,32,32,0,1,0
4,347,347,22,22,0,1,0
9,355,355,7,1,6,3,2
27,359,359,64,23,41,2,1
24,369,369,3,3,0,1,0
20,374,374,41,19,22,2,1
17,393,393,15,15,0,1,0
6,410,410,5,2,3,2,1
0,427,427,9,5,4,2,1
22,428,428,25,16,9,2,1
12,428,428,35,17,18,3,2
25,448,448,26,10,16,2,1
8,474,474,11,11,0,1,0
14,479,479,82,35,47,2,1
5,482,482,5,1,4,2,1
7,497,497,139,92,47,2,1

13,124,124,10,10,0,1,0
20,136,136,5,5,0,1,0
4,138,138,1,1,0,1,0
8,149,149,15,15,0,1,0
16,164,164,18,18,0,1,0
6,179,179,1,1,0,1,0
5,183,183,1,1,0,1,0
21,226,226,13,13,0,1,0
12,237,237,15,1,14,2,1
1,281,281,65,65,0,1,0
9,295,295,21,21,0,1,0
19,305,305,28,28,0,1,0
15,319,319,17,17,0,1,0
14,364,364,88,88,0,1,0
3,388,388,284,284,0,1,0
7,412,412,3,3,0,1,0
22,438,438,28,1,27,3,2
0,443,443,34,19,15,4,3
11,445,445,128,96,32,2,1
2,449,449,73,53,20,3,2
10,464,464,6,1,5,2,1
18,469,469,47,35,12,4,3
23,479,479,103,103,0,1,0
17,483,483,4,1,3,2,1

14,120,120,11,11,0,1,0
20,179,179,14,5,9,2,1
15,193,193,17,17,0,1,0
0,197,197,49,15,34,2,1
21,203,203,47,47,0,1,0
5,249,249,5,2,3,2,1
2,262,262,28,28,0,1,0
12,319,319,10,4,6,3,2
19,363,363,20,20,0,1,0
1,372,372,120,67,53,4,3
8,387,387,30,30,0,1,0
16,389,389,44,44,0,1,0
17,393,393,30,5,25,2,1
18,394,394,20,20,0,1,0
13,430,430,13,13,0,1,0
9,442,442,8,2,6,2,1
6,451,451,95,44,51,4,3
11,454,454,41,11,30,4,3
23,456,456,52,52,0,1,0
10,463,463,136,109,27,4,3
3,466,466,6,6,0,1,0
22,467,467,37,37,0,1,0
4,492,492,173,89,84,4,3
7,498,498,16,3,13,4,3

2,120,120,9,2,7,2,1
1,123,123,27,7,20,3,2
13,139,139,11,1,10,2,1
8,144,144,12,12,0,1,0
0,149,149,2,2,0,1,0
14,158,158,23,7,16,2,1
28,163,163,57,30,27,2,1
29,181,181,1,1,0,1,0
15,185,185,5,5,0,1,0
30,197,197,14,14,0,1,0
5,208,208,26,26,0,1,0
12,212,212,1,1,0,1,0
16,218,218,5,1,4,2,1
3,229,229,2,2,0,1,0
9,239,239,15,2,13,2,1
18,239,239,22,7,15,2,1
33,242,242,18,4,14,2,1
17,288,288,26,26,0,1,0
31,292,292,56,30,26,2,1
11,303,303,7,1,6,2,1
4,334,334,1,1,0,1,0
10,347,347,22,13,9,4,3
27,369,369,63,63,0,1,0
20,387,387,3,3,0,1,0
32,389,389,35,20,15,4,3
19,389,389,3,3,0,1,0
21,396,396,19,19,0,1,0
23,413,413,9,5,4,2,1
26,421,421,89,71,18,4,3
6,453,453,8,4,4,2,1
25,465,465,2,2,0,1,0
34,473,473,48,4,44,3,2
24,480,480,2,2,0,1,0
22,497,497,40,40,0,1,0
7,500,500,114,64,50,2,1

10,107,107,10,10,0,1,0
0,123,123,1,1,0,1,0
16,136,136,20,20,0,1,0
21,142,142,4,4,0,1,0
13,153,153,23,7,16,4,3
12,154,154,7,3,4,2,1
19,155,155,21,3,18,3,2
14,186,186,26,19,7,2,1
22,198,198,36,36,0,1,0
1,223,223,58,58,0,1,0
9,235,235,2,2,0,1,0
3,238,238,84,69,15,4,3
11,260,260,8,8,0,1,0
23,276,276,27,27,0,1,0
2,282,282,83,35,48,3,2
20,289,289,26,10,16,2,1
17,295,295,52,20,32,2,1
6,296,296,3,3,0,1,0
4,314,314,37,23,14,3,2
8,350,350,29,29,0,1,0
24,351,351,11,4,7,2,1
15,449,449,3,3,0,1,0
18,474,474,84,55,29,2,1
7,488,488,1,1,0,1,0
5,490,490,87,87,0,1,0

0,102,102,34,7,27,2,1
9,131,131,2,2,0,1,0
17,141,141,4,4,0,1,0
18,168,168,10,2,8,3,2
23,193,193,42,42,0,1,0
14,287,287,28,28,0,1,0
3,295,295,1,1,0,1,0
10,299,299,19,19,0,1,0
11,314,314,23,9,14,3,2
12,324,324,28,28,0,1,0
13,332,332,115,35,80,3,2
15,350,350,34,7,27,2,1
20,352,352,5,5,0,1,0
5,355,355,49,19,30,3,2
7,359,359,51,51,0,1,0
4,411,411,76,41,35,2,1
16,416,416,5,5,0,1,0
22,425,425,32,2,30,3,2
1,427,427,108,70,38,2,1
8,455,455,121,121,0,1,0
19,473,473,50,50,0,1,0
21,483,483,70,49,21,2,1
6,486,486,5,5,0,1,0
2,494,494,29,2,27,3,2

0,113,113,6,2,4,2,1
12,113,113,1,1,0,1,0
16,116,116,5,2,3,2,1
20,121,121,6,2,4,2,1
19,128,128,47,12,35,2,1
8,138,138,15,15,0,1,0
9,184,184,3,3,0,1,0
5,185,185,19,19,0,1,0
18,194,194,53,38,15,2,1
10,199,199,18,18,0,1,0
7,202,202,17,14,3,2,1
21,210,210,61,61,0,1,0
23,222,222,6,6,0,1,0
27,256,256,1,1,0,1,0
3,312,312,10,10,0,1,0
26,316,316,15,4,11,2,1
4,320,320,89,41,48,4,3
15,342,342,31,25,6,3,2
11,343,343,71,23,48,2,1
25,352,352,6,6,0,1,0
29,362,362,12,12,0,1,0
13,391,391,22,22,0,1,0
17,394,394,22,4,18,2,1
24,412,412,14,14,0,1,0
1,429,429,28,28,0,1,0
6,438,438,47,3,44,3,2
22,442,442,72,72,0,1,0
2,477,477,32,32,0,1,0
28,477,477,14,14,0,1,0
14,485,485,16,4,12,2,1

5,106,106,5,5,0,1,0
16,109,109,2,2,0,1,0
10,121,121,10,6,4,2,1
29,132,132,6,3,3,2,1
23,141,141,16,2,14,3,2
3,147,147,4,4,0,1,0
1,177,177,4,4,0,1,0
2,214,214,4,4,0,1,0
25,224,224,8,8,0,1,0
14,267,267,29,8,21,4,3
26,269,269,11,11,0,1,0
0,294,294,36,12,24,3,2
9,301,301,62,62,0,1,0
11,316,316,43,43,0,1,0
6,325,325,69,69,0,1,0
7,325,325,21,5,16,3,2
20,343,343,108,12,96,4,3
15,362,362,40,24,16,3,2
28,372,372,1,1,0,1,0
21,381,381,24,24,0,1,0
12,389,389,7,7,0,1,0
19,421,421,120,63,57,4,3
4,423,423,21,21,0,1,0
17,439,439,3,3,0,1,0
22,456,456,23,17,6,3,2
13,464,464,12,12,0,1,0
24,465,465,17,7,10,2,1
27,470,470,141,99,42,3,2
8,480,480,72,72,0,1,0
18,490,490,52,15,37,2,1

19,114,114,28,14,14,3,2
24,126,126,26,1,25,2,1
23,128,128,8,8,0,1,0
9,153,153,10,10,0,1,0
4,161,161,3,3,0,1,0
2,169,169,10,5,5,2,1
25,191,191,8,8,0,1,0
26,205,205,41,1,40,3,2
13,212,212,48,9,39,4,3
20,230,230,13,10,3,2,1
29,235,235,32,32,0,1,0
14,272,272,7,2,5,2,1
7,284,284,12,7,5,2,1
10,318,318,45,45,0,1,0
17,322,322,2,2,0,1,0
8,324,324,4,1,3,2,1
1,342,342,57,57,0,1,0
27,378,378,98,98,0,1,0
3,378,378,20,20,0,1,0
16,413,413,10,10,0,1,0
0,419,419,91,13,78,3,2
31,431,431,18,12,6,3,2
18,434,434,15,10,5,2,1
28,436,436,35,35,0,1,0
11,438,438,2,2,0,1,0
30,445,445,3,3,0,1,0
6,446,446,137,29,108,4,3
12,449,449,8,8,0,1,0
22,490,490,17,5,12,3,2
21,493,493,16,16,0,1,0
5,496,496,6,6,0,1,0
15,500,500,1,1,0,1,0

28,119,119,23,23,0,1,0
30,130,130,3,3,0,1,0
9,148,148,7,7,0,1,0
26,152,152,65,47,18,3,2
19,169,169,4,1,3,2,1
7,181,181,16,16,0,1,0
2,183,183,3,3,0,1,0
18,191,191,2,2,0,1,0
8,194,194,3,3,0,1,0
23,197,197,2,2,0,1,0
27,212,212,67,67,0,1,0
24,218,218,4,4,0,1,0
17,231,231,15,5,10,2,1
16,237,237,14,4,10,3,2
10,257,257,15,15,0,1,0
5,263,263,22,22,0,1,0
22,300,300,15,15,0,1,0
0,315,315,52,52,0,1,0
15,360,360,61,24,37,2,1
13,367,367,1,1,0,1,0
29,389,389,10,10,0,1,0
21,399,399,14,8,6,2,1
3,409,409,37,37,0,1,0
11,412,412,77,77,0,1,0
12,433,433,28,6,22,2,1
1,447,447,14,10,4,2,1
31,452,452,5,5,0,1,0
20,457,457,118,42,76,4,3
14,461,461,2,2,0,1,0
25,474,474,12,12,0,1,0
6,477,477,105,64,41,4,3
4,478,478,15,15,0,1,0

26,100,100,10,10,0,1,0
17,134,134,3,3,0,1,0
15,140,140,3,3,0,1,0
0,142,142,10,1,9,4,3
11,202,202,4,4,0,1,0
6,226,226,15,15,0,1,0
4,241,241,28,7,21,4,3
8,249,249,47,21,26,4,3
1,256,256,53,21,32,3,2
27,257,257,10,4,6,3,2
12,263,263,31,7,24,2,1
19,277,277,88,48,40,2,1
20,287,287,8,8,0,1,0
3,290,290,29,29,0,1,0
2,302,302,7,1,6,3,2
22,321,321,56,30,26,4,3
5,340,340,41,20,21,4,3
18,351,351,40,18,22,2,1
10,374,374,80,80,0,1,0
23,412,412,25,5,20,3,2
24,438,438,44,18,26,3,2
9,438,438,45,14,31,4,3
21,449,449,101,2,99,4,3
25,451,451,65,65,0,1,0
16,465,465,39,16,23,2,1
7,471,471,24,21,3,2,1
13,482,482,2,2,0,1,0
14,494,494,2,2,0,1,0

22,103,103,1,1,0,1,0
16,118,118,16,16,0,1,0
19,139,139,7,7,0,1,0
24,139,139,7,7,0,1,0
6,141,141,16,6,10,3,2
27,155,155,10,2,8,3,2
14,167,167,5,5,0,1,0
8,183,183,1,1,0,1,0
12,186,186,2,2,0,1,0
25,200,200,3,3,0,1,0
5,200,200,15,15,0,1,0
18,236,236,50,2,48,2,1
31,269,269,29,29,0,1,0
1,273,273,1,1,0,1,0
33,281,281,19,4,15,4,3
21,288,288,4,4,0,1,0
3,289,289,4,4,0,1,0
17,299,299,4,4,0,1,0
4,323,323,11,2,9,4,3
32,339,339,96,18,78,4,3
20,349,349,53,53,0,1,0
28,354,354,91,91,0,1,0
23,357,357,43,43,0,1,0
2,367,367,37,11,26,2,1
30,370,370,15,15,0,1,0
34,384,384,14,14,0,1,0
26,386,386,12,12,0,1,0
0,388,388,88,14,74,3,2
7,390,390,33,18,15,4,3
13,409,409,19,19,0,1,0
11,414,414,7,7,0,1,0
15,430,430,11,11,0,1,0
29,441,441,147,61,86,3,2
9,494,494,8,5,3,2,1
10,498,498,18,18,0,1,0

16,100,100,2,2,0,1,0
18,136,136,2,2,0,1,0
25,156,156,2,2,0,1,0
8,157,157,17,17,0,1,0
9,163,163,3,3,0,1,0
0,165,165,16,16,0,1,0
6,172,172,8,8,0,1,0
14,190,190,18,18,0,1,0
10,198,198,8,8,0,1,0
20,221,221,7,7,0,1,0
2,230,230,31,31,0,1,0
24,231,231,36,36,0,1,0
4,285,285,57,57,0,1,0
7,291,291,59,35,24,4,3
17,297,297,5,5,0,1,0
1,317,317,88,88,0,1,0
21,332,332,14,4,10,2,1
12,340,340,15,15,0,1,0
11,347,347,14,14,0,1,0
3,367,367,46,46,0,1,0
19,377,377,28,28,0,1,0
13,390,390,13,13,0,1,0
5,403,403,44,44,0,1,0
22,427,427,63,63,0,1,0
15,476,476,306,192,114,4,3
23,482,482,52,52,0,1,0

22,108,108,3,3,0,1,0
4,112,112,14,4,10,2,1
19,152,152,14,14,0,1,0
25,158,158,42,42,0,1,0
16,167,167,9,1,8,2,1
5,184,184,19,19,0,1,0
14,190,190,32,19,13,2,1
8,196,196,13,8,5,2,1
11,209,209,53,1,52,3,2
10,239,239,25,25,0,1,0
24,252,252,11,8,3,2,1
23,295,295,27,27,0,1,0
30,298,298,34,1,33,4,3
2,298,298,2,2,0,1,0
28,308,308,13,5,8,2,1
15,322,322,17,17,0,1,0
17,349,349,13,4,9,2,1
29,358,358,132,123,9,2,1
0,368,368,30,23,7,2,1
3,376,376,28,9,19,4,3
12,384,384,50,35,15,4,3
27,394,394,9,1,8,2,1
13,399,399,35,15,20,2,1
26,431,431,72,72,0,1,0
9,432,432,4,4,0,1,0
20,454,454,11,1,10,2,1
1,459,459,17,8,9,4,3
18,467,467,50,50,0,1,0
21,481,481,8,8,0,1,0
6,487,487,15,5,10,2,1
7,488,488,8,8,0,1,0

1,118,118,13,7,6,3,2
20,124,124,4,4,0,1,0
19,125,125,10,5,5,2,1
27,126,126,20,8,12,4,3
10,127,127,4,4,0,1,0
22,148,148,13,4,9,2,1
8,160,160,27,15,12,4,3
9,164,164,6,6,0,1,0
5,195,195,65,65,0,1,0
0,230,230,2,2,0,1,0
14,247,247,1,1,0,1,0
15,259,259,12,9,3,2,1
4,261,261,25,25,0,1,0
28,264,264,12,12,0,1,0
3,284,284,14,14,0,1,0
24,342,342,14,2,12,3,2
18,343,343,43,3,40,4,3
6,377,377,111,54,57,4,3
25,390,390,65,11,54,4,3
11,402,402,26,1,25,4,3
21,415,415,127,49,78,4,3
12,426,426,20,20,0,1,0
13,436,436,20,20,0,1,0
16,453,453,4,4,0,1,0
17,458,458,122,38,84,3,2
23,471,471,10,10,0,1,0
26,476,476,20,20,0,1,0
2,480,480,1,1,0,1,0
7,499,499,54,54,0,1,0

16,112,112,41,17,24,4,3
2,132,132,20,2,18,2,1
5,143,143,13,13,0,1,0
1,165,165,24,24,0,1,0
21,180,180,1,1,0,1,0
13,189,189,17,1,16,3,2
14,223,223,31,31,0,1,0
8,228,228,17,17,0,1,0
11,249,249,49,49,0,1,0
6,251,251,65,65,0,1,0
17,261,261,52,8,44,4,3
3,279,279,21,13,8,3,2
0,279,279,75,23,52,3,2
22,288,288,22,5,17,2,1
15,290,290,6,3,3,2,1
19,305,305,62,16,46,3,2
20,356,356,6,3,3,2,1
24,396,396,9,9,0,1,0
23,413,413,16,16,0,1,0
18,443,443,1,1,0,1,0
4,443,443,8,8,0,1,0
7,464,464,35,35,0,1,0
10,476,476,102,20,82,3,2
9,477,477,13,13,0,1,0
12,493,493,26,10,16,2,1

12,119,119,2,2,0,1,0
3,127,127,6,6,0,1,0
7,144,144,10,10,0,1,0
19,154,154,29,11,18,4,3
0,191,191,83,83,0,1,0
10,197,197,31,31,0,1,0
21,218,218,15,15,0,1,0
2,226,226,58,58,0,1,0
1,239,239,43,1,42,2,1
20,244,244,2,2,0,1,0
22,251,251,7,7,0,1,0
8,269,269,28,28,0,1,0
14,278,278,14,14,0,1,0
15,337,337,30,30,0,1,0
4,345,345,24,24,0,1,0
16,353,353,43,43,0,1,0
6,363,363,15,15,0,1,0
23,364,364,182,134,48,3,2
17,439,439,49,43,6,2,1
9,448,448,17,17,0,1,0
5,464,464,74,5,69,4,3
13,480,480,21,6,15,4,3
11,481,481,4,1,3,2,1
18,497,497,19,19,0,1,0

21,103,103,3,3,0,1,0
29,152,152,4,1,3,2,1
15,165,165,1,1,0,1,0
13,169,169,10,4,6,2,1
11,176,176,11,11,0,1,0
4,199,199,2,2,0,1,0
14,210,210,1,1,0,1,0
32,222,222,27,27,0,1,0
18,225,225,11,11,0,1,0
30,227,227,2,2,0,1,0
5,229,229,14,3,11,2,1
28,229,229,101,49,52,3,2
23,234,234,2,2,0,1,0
7,248,248,1,1,0,1,0
2,256,256,37,37,0,1,0
31,258,258,52,17,35,2,1
1,299,299,56,14,42,3,2
16,314,314,28,2,26,2,1
22,337,337,39,11,28,4,3
12,347,347,24,24,0,1,0
3,359,359,58,31,27,2,1
10,360,360,10,10,0,1,0
33,363,363,15,6,9,2,1
34,369,369,43,43,0,1,0
26,371,371,3,3,0,1,0
6,376,376,20,20,0,1,0
17,394,394,15,15,0,1,0
0,422,422,23,23,0,1,0
19,438,438,26,26,0,1,0
27,441,441,16,16,0,1,0
25,441,441,12,12,0,1,0
35,451,451,35,35,0,1,0
36,453,453,111,111,0,1,0
20,459,459,10,1,9,2,1
37,467,467,6,6,0,1,0
24,487,487,26,7,19,2,1
9,491,491,38,14,24,3,2
8,495,495,4,4,0,1,0

26,131,131,7,7,0,1,0
7,135,135,20,2,18,3,2
16,135,135,1,1,0,1,0
25,144,144,22,16,6,3,2
15,160,160,18,18,0,1,0
1,175,175,2,2,0,1,0
23,178,178,25,1,24,3,2
27,182,182,5,5,0,1,0
22,189,189,14,14,0,1,0
10,191,191,41,2,39,2,1
20,207,207,37,37,0,1,0
21,226,226,38,18,20,3,2
19,256,256,9,3,6,3,2
5,269,269,18,5,13,2,1
8,299,299,1,1,0,1,0
0,303,303,25,16,9,4,3
6,317,317,4,4,0,1,0
12,323,323,1,1,0,1,0
4,327,327,1,1,0,1,0
17,350,350,12,12,0,1,0
2,357,357,113,77,36,4,3
14,373,373,80,38,42,3,2
18,383,383,94,94,0,1,0
9,388,388,19,3,16,2,1
13,396,396,7,1,6,3,2
24,407,407,16,2,14,3,2
28,423,423,69,47,22,3,2
3,429,429,81,81,0,1,0
11,495,495,34,34,0,1,0

9,101,101,11,7,4,2,1
33,117,117,9,9,0,1,0
12,126,126,5,5,0,1,0
21,130,130,23,23,0,1,0
6,135,135,2,2,0,1,0
3,165,165,32,12,20,4,3
30,190,190,16,6,10,2,1
18,214,214,22,22,0,1,0
5,217,217,17,8,9,2,1
29,218,218,4,4,0,1,0
16,219,219,27,3,24,3,2
17,222,222,31,7,24,3,2
19,227,227,12,12,0,1,0
2,237,237,11,11,0,1,0
7,243,243,10,10,0,1,0
13,253,253,17,17,0,1,0
4,256,256,9,9,0,1,0
24,258,258,14,1,13,3,2
1,266,266,4,4,0,1,0
32,267,267,58,37,21,2,1
8,275,275,18,6,12,2,1
20,281,281,35,35,0,1,0
22,315,315,5,5,0,1,0
27,322,322,67,19,48,3,2
11,340,340,4,4,0,1,0
15,368,368,7,7,0,1,0
14,369,369,15,3,12,2,1
34,374,374,13,7,6,3,2
10,375,375,12,12,0,1,0
26,382,382,85,27,58,4,3
25,408,408,22,11,11,2,1
31,412,412,67,67,0,1,0
23,413,413,16,8,8,3,2
28,461,461,26,26,0,1,0
0,483,483,24,11,13,2,1

8,103,103,3,3,0,1,0
17,116,116,5,5,0,1,0
13,117,117,10,1,9,3,2
21,155,155,10,10,0,1,0
7,171,171,1,1,0,1,0
22,171,171,28,19,9,4,3
26,187,187,8,8,0,1,0
24,207,207,15,15,0,1,0
11,213,213,1,1,0,1,0
6,216,216,4,1,3,2,1
18,251,251,19,19,0,1,0
20,273,273,15,15,0,1,0
25,289,289,30,27,3,2,1
19,300,300,85,79,6,2,1
4,300,300,28,13,15,4,3
2,304,304,11,11,0,1,0
3,304,304,32,4,28,3,2
5,335,335,1,1,0,1,0
27,344,344,6,6,0,1,0
10,360,360,38,38,0,1,0
23,369,369,10,10,0,1,0
1,374,374,66,66,0,1,0
14,376,376,5,5,0,1,0
15,385,385,158,128,30,4,3
9,431,431,156,77,79,4,3
12,459,459,45,45,0,1,0
16,464,464,23,6,17,2,1
0,474,474,132,75,57,3,2

5,116,116,16,2,14,3,2
17,126,126,3,3,0,1,0
18,174,174,22,22,0,1,0
22,178,178,27,27,0,1,0
7,213,213,30,10,20,2,1
4,214,214,3,3,0,1,0
12,222,222,34,34,0,1,0
13,264,264,19,1,18,4,3
14,291,291,18,12,6,3,2
20,310,310,74,74,0,1,0
3,352,352,98,98,0,1,0
10,355,355,5,5,0,1,0
0,395,395,36,6,30,3,2
1,399,399,64,29,35,2,1
16,414,414,59,12,47,2,1
15,444,444,118,118,0,1,0
21,451,451,15,5,10,2,1
19,480,480,25,25,0,1,0
2,483,483,191,174,17,2,1
11,488,488,27,3,24,2,1
6,492,492,52,10,42,3,2
8,495,495,38,34,4,2,1
9,498,498,15,6,9,2,1

1,100,100,2,2,0,1,0
8,126,126,12,12,0,1,0
23,198,198,28,13,15,4,3
24,211,211,29,11,18,4,3
10,242,242,1,1,0,1,0
0,251,251,12,3,9,4,3
16,258,258,22,22,0,1,0
9,261,261,5,1,4,2,1
15,285,285,4,4,0,1,0
17,292,292,16,7,9,2,1
18,297,297,39,39,0,1,0
4,317,317,26,21,5,2,1
11,334,334,97,97,0,1,0
7,337,337,13,4,9,2,1
13,341,341,18,1,17,3,2
22,346,346,40,40,0,1,0
21,381,381,20,20,0,1,0
20,383,383,12,5,7,2,1
19,387,387,7,4,3,2,1
3,394,394,1,1,0,1,0
5,401,401,92,24,68,3,2
6,402,402,46,34,12,4,3
12,426,426,74,74,0,1,0
14,490,490,202,156,46,3,2
2,492,492,140,2,138,4,3
26,497,497,6,6,0,1,0
25,498,498,84,84,0,1,0

26,105,105,1,1,0,1,0
16,198,198,17,17,0,1,0
28,199,199,23,23,0,1,0
8,256,256,47,47,0,1,0
18,256,256,21,21,0,1,0
19,272,272,51,1,50,3,2
7,273,273,39,30,9,4,3
23,319,319,3,3,0,1,0
1,331,331,29,17,12,4,3
3,331,331,49,7,42,3,2
15,338,338,19,19,0,1,0
21,344,344,1,1,0,1,0
6,348,348,8,8,0,1,0
27,368,368,74,74,0,1,0
25,376,376,28,28,0,1,0
2,377,377,16,6,10,3,2
4,383,383,60,27,33,4,3
11,391,391,99,12,87,4,3
24,405,405,95,47,48,2,1
12,414,414,18,18,0,1,0
14,424,424,47,20,27,4,3
10,428,428,49,31,18,4,3
13,431,431,10,10,0,1,0
17,454,454,93,1,92,4,3
0,466,466,18,18,0,1,0
22,471,471,46,24,22,3,2
5,476,476,13,13,0,1,0
20,491,491,33,5,28,2,1
9,495,495,3,3,0,1,0

33,159,159,1,1,0,1,0
15,159,159,5,5,0,1,0
20,160,160,13,13,0,1,0
16,162,162,16,16,0,1,0
23,164,164,25,15,10,3,2
7,180,180,12,12,0,1,0
18,192,192,16,10,6,3,2
34,205,205,18,18,0,1,0
14,212,212,10,10,0,1,0
13,223,223,25,22,3,2,1
17,227,227,4,4,0,1,0
11,243,243,27,27,0,1,0
4,254,254,6,6,0,1,0
10,270,270,11,11,0,1,0
5,270,270,27,27,0,1,0
21,271,271,11,11,0,1,0
1,274,274,88,88,0,1,0
6,284,284,34,34,0,1,0
22,300,300,7,7,0,1,0
32,319,319,111,105,6,2,1
28,340,340,27,19,8,3,2
27,348,348,19,4,15,4,3
30,352,352,58,58,0,1,0
25,360,360,26,23,3,2,1
0,372,372,1,1,0,1,0
31,372,372,35,17,18,4,3
12,385,385,4,4,0,1,0
2,420,420,15,2,13,2,1
24,425,425,16,2,14,2,1
9,433,433,2,2,0,1,0
26,439,439,13,13,0,1,0
3,445,445,10,10,0,1,0
19,467,467,19,19,0,1,0
29,478,478,111,98,13,2,1
8,499,499,15,15,0,1,0

14,111,111,12,12,0,1,0
24,114,114,27,6,21,2,1
1,116,116,1,1,0,1,0
22,160,160,6,1,5,2,1
26,187,187,11,11,0,1,0
7,192,192,5,5,0,1,0
5,215,215,11,4,7,2,1
27,216,216,32,26,6,3,2
11,217,217,15,15,0,1,0
13,218,218,1,1,0,1,0
29,251,251,1,1,0,1,0
8,256,256,78,48,30,3,2
17,273,273,30,30,0,1,0
21,285,285,5,5,0,1,0
2,305,305,37,37,0,1,0
0,315,315,18,18,0,1,0
28,321,321,23,23,0,1,0
25,321,321,9,4,5,2,1
18,325,325,60,60,0,1,0
19,342,342,24,24,0,1,0
10,348,348,57,57,0,1,0
4,362,362,11,5,6,3,2
3,374,374,57,57,0,1,0
23,400,400,15,15,0,1,0
12,407,407,14,14,0,1,0
16,435,435,106,34,72,4,3
20,449,449,83,83,0,1,0
6,473,473,70,16,54,4,3
9,484,484,4,4,0,1,0
15,497,497,56,22,34,2,1

23,107,107,10,10,0,1,0
25,113,113,4,4,0,1,0
22,125,125,5,5,0,1,0
9,132,132,2,2,0,1,0
21,139,139,3,3,0,1,0
17,166,166,46,46,0,1,0
27,167,167,1,1,0,1,0
18,230,230,16,7,9,4,3
6,254,254,24,24,0,1,0
24,284,284,97,43,54,3,2
26,302,302,78,30,48,2,1
14,308,308,81,81,0,1,0
11,309,309,12,3,9,4,3
12,315,315,18,18,0,1,0
15,331,331,17,17,0,1,0
30,348,348,17,4,13,2,1
28,355,355,10,2,8,2,1
0,356,356,40,40,0,1,0
2,369,369,8,3,5,2,1
10,370,370,50,50,0,1,0
7,376,376,8,5,3,2,1
16,394,394,11,1,10,3,2
4,400,400,52,52,0,1,0
8,433,433,83,51,32,2,1
3,435,435,1,1,0,1,0
5,446,446,76,76,0,1,0
19,460,460,45,6,39,3,2
29,465,465,46,17,29,4,3
13,478,478,7,7,0,1,0
20,486,486,2,2,0,1,0
1,499,499,27,15,12,4,3

2,100,100,1,1,0,1,0
3,136,136,24,24,0,1,0
6,144,144,51,51,0,1,0
19,151,151,7,7,0,1,0
26,161,161,1,1,0,1,0
25,176,176,9,9,0,1,0
8,179,179,13,1,12,2,1
15,212,212,28,28,0,1,0
10,214,214,12,3,9,3,2
13,263,263,5,5,0,1,0
9,272,272,3,3,0,1,0
27,281,281,22,1,21,2,1
5,308,308,10,10,0,1,0
16,312,312,44,20,24,2,1
4,312,312,3,3,0,1,0
7,360,360,22,22,0,1,0
14,364,364,44,11,33,2,1
24,364,364,12,8,4,2,1
30,392,392,79,73,6,2,1
18,399,399,38,38,0,1,0
11,399,399,30,30,0,1,0
22,401,401,76,62,14,3,2
20,404,404,65,18,47,2,1
23,405,405,90,90,0,1,0
17,413,413,21,21,0,1,0
21,425,425,112,90,22,3,2
0,432,432,8,8,0,1,0
28,433,433,9,9,0,1,0
1,467,467,32,28,4,2,1
12,478,478,21,21,0,1,0
29,485,485,3,3,0,1,0

24,117,117,1,1,0,1,0
21,132,132,4,4,0,1,0
20,153,153,4,4,0,1,0
16,160,160,74,8,66,3,2
3,164,164,1,1,0,1,0
26,171,171,20,20,0,1,0
0,181,181,1,1,0,1,0
5,181,181,2,2,0,1,0
28,200,200,79,79,0,1,0
15,205,205,4,1,3,2,1
25,206,206,1,1,0,1,0
4,210,210,10,2,8,3,2
18,226,226,3,3,0,1,0
10,244,244,10,1,9,4,3
13,253,253,48,20,28,3,2
22,264,264,12,3,9,2,1
12,315,315,98,20,78,4,3
23,324,324,10,10,0,1,0
6,325,325,36,36,0,1,0
19,370,370,30,30,0,1,0
9,388,388,120,72,48,2,1
8,393,393,3,3,0,1,0
17,397,397,32,16,16,2,1
27,412,412,51,39,12,4,3
29,415,415,8,8,0,1,0
2,455,455,60,36,24,2,1
11,474,474,1,1,0,1,0
14,488,488,1,1,0,1,0
7,488,488,35,4,31,2,1
1,494,494,66,18,48,2,1

0,113,113,1,1,0,1,0
17,114,114,7,4,3,2,1
15,117,117,2,2,0,1,0
21,122,122,2,2,0,1,0
8,130,130,3,3,0,1,0
4,175,175,42,42,0,1,0
11,203,203,18,18,0,1,0
13,209,209,26,14,12,4,3
9,242,242,12,2,10,3,2
12,258,258,2,2,0,1,0
25,279,279,67,67,0,1,0
5,291,291,17,3,14,2,1
18,297,297,46,32,14,3,2
20,322,322,2,2,0,1,0
1,350,350,13,13,0,1,0
2,363,363,27,6,21,4,3
10,386,386,114,114,0,1,0
24,404,404,26,2,24,4,3
14,426,426,13,13,0,1,0
19,431,431,216,187,29,2,1
3,445,445,10,10,0,1,0
6,459,459,71,7,64,4,3
7,463,463,162,162,0,1,0
23,476,476,42,3,39,3,2
16,480,480,20,2,18,4,3
22,489,489,34,13,21,4,3

12,108,108,14,14,0,1,0
5,159,159,1,1,0,1,0
24,161,161,14,14,0,1,0
1,164,164,31,5,26,3,2
17,171,171,68,56,12,2,1
10,187,187,1,1,0,1,0
13,199,199,20,20,0,1,0
7,199,199,27,27,0,1,0
22,205,205,41,41,0,1,0
28,237,237,25,11,14,4,3
16,260,260,21,13,8,3,2
25,281,281,9,6,3,2,1
3,309,309,27,18,9,2,1
18,322,322,3,3,0,1,0
20,328,328,18,1,17,2,1
11,330,330,16,16,0,1,0
14,340,340,6,3,3,2,1
15,343,343,122,84,38,3,2
19,345,345,4,4,0,1,0
26,366,366,20,20,0,1,0
6,377,377,2,2,0,1,0
8,380,380,30,30,0,1,0
9,412,412,29,29,0,1,0
21,420,420,96,96,0,1,0
4,425,425,19,6,13,2,1
27,429,429,21,21,0,1,0
29,462,462,3,3,0,1,0
0,469,469,11,11,0,1,0
2,478,478,11,11,0,1,0
23,486,486,46,46,0,1,0
30,493,493,44,35,9,2,1

1,106,106,9,9,0,1,0
21,148,148,43,13,30,3,2
9,154,154,24,24,0,1,0
6,159,159,26,26,0,1,0
19,159,159,5,5,0,1,0
0,223,223,1,1,0,1,0
30,228,228,24,24,0,1,0
23,242,242,8,8,0,1,0
17,260,260,3,3,0,1,0
24,261,261,5,5,0,1,0
18,264,264,2,2,0,1,0
14,289,289,26,26,0,1,0
34,301,301,41,3,38,3,2
22,304,304,57,39,18,3,2
3,305,305,3,3,0,1,0
28,309,309,51,25,26,2,1
5,326,326,24,24,0,1,0
15,340,340,39,39,0,1,0
26,340,340,17,2,15,2,1
25,351,351,86,78,8,2,1
2,364,364,8,2,6,2,1
32,366,366,52,40,12,4,3
27,372,372,2,2,0,1,0
29,373,373,3,3,0,1,0
20,384,384,20,13,7,2,1
8,392,392,17,5,12,3,2
13,403,403,19,16,3,2,1
12,415,415,77,5,72,4,3
7,428,428,27,3,24,3,2
31,439,439,12,12,0,1,0
33,442,442,1,1,0,1,0
11,464,464,11,11,0,1,0
16,492,492,57,57,0,1,0
10,497,497,48,48,0,1,0
4,500,500,2,2,0,1,0

20,112,112,2,2,0,1,0
13,121,121,5,5,0,1,0
21,144,144,6,6,0,1,0
3,160,160,9,4,5,2,1
17,181,181,6,1,5,2,1
23,206,206,14,14,0,1,0
15,209,209,29,29,0,1,0
7,236,236,23,23,0,1,0
11,264,264,23,13,10,3,2
9,284,284,28,28,0,1,0
4,288,288,40,30,10,2,1
26,289,289,37,1,36,4,3
6,297,297,15,15,0,1,0
19,318,318,6,6,0,1,0
27,320,320,9,9,0,1,0
25,337,337,66,33,33,4,3
2,351,351,79,55,24,2,1
5,371,371,20,20,0,1,0
8,378,378,83,83,0,1,0
18,385,385,45,45,0,1,0
1,389,389,4,4,0,1,0
22,411,411,29,29,0,1,0
12,421,421,15,15,0,1,0
10,435,435,106,1,105,4,3
28,450,450,83,40,43,2,1
14,450,450,18,2,16,2,1
0,451,451,1,1,0,1,0
24,466,466,101,9,92,3,2
16,480,480,82,31,51,4,3

28,103,103,10,1,9,2,1
21,113,113,17,8,9,4,3
10,133,133,6,6,0,1,0
27,134,134,4,4,0,1,0
2,172,172,10,10,0,1,0
18,226,226,1,1,0,1,0
19,227,227,5,1,4,2,1
26,264,264,52,52,0,1,0
15,268,268,5,5,0,1,0
12,269,269,7,7,0,1,0
20,272,272,92,38,54,3,2
24,276,276,6,6,0,1,0
7,280,280,6,1,5,2,1
25,307,307,14,2,12,3,2
17,309,309,13,8,5,2,1
14,321,321,4,4,0,1,0
23,326,326,26,26,0,1,0
1,327,327,12,12,0,1,0
8,338,338,217,196,21,2,1
22,352,352,99,99,0,1,0
5,358,358,26,17,9,2,1
13,364,364,69,57,12,3,2
4,408,408,1,1,0,1,0
6,418,418,9,9,0,1,0
16,427,427,43,43,0,1,0
11,428,428,19,19,0,1,0
3,440,440,18,18,0,1,0
9,451,451,29,29,0,1,0
0,453,453,56,26,30,4,3

24,105,105,7,7,0,1,0
10,145,145,9,9,0,1,0
1,165,165,5,2,3,2,1
17,174,174,2,2,0,1,0
23,174,174,20,20,0,1,0
29,181,181,10,10,0,1,0
6,211,211,6,6,0,1,0
5,226,226,36,24,12,4,3
16,235,235,12,4,8,3,2
3,238,238,34,34,0,1,0
27,238,238,21,5,16,3,2
12,253,253,10,10,0,1,0
32,259,259,39,24,15,4,3
7,275,275,90,80,10,2,1
14,358,358,10,2,8,2,1
13,366,366,5,5,0,1,0
30,367,367,40,40,0,1,0
8,375,375,9,9,0,1,0
4,380,380,49,49,0,1,0
26,388,388,55,55,0,1,0
15,391,391,40,23,17,2,1
0,397,397,1,1,0,1,0
20,410,410,43,43,0,1,0
9,417,417,8,8,0,1,0
2,422,422,9,9,0,1,0
25,422,422,19,4,15,2,1
19,425,425,16,8,8,3,2
31,426,426,135,117,18,4,3
18,428,428,67,48,19,2,1
11,452,452,7,7,0,1,0
21,467,467,25,10,15,2,1
28,481,481,3,3,0,1,0
33,492,492,14,14,0,1,0
22,499,499,70,1,69,4,3

3,133,133,22,22,0,1,0
20,138,138,16,10,6,2,1
5,141,141,11,11,0,1,0
11,165,165,2,2,0,1,0
0,182,182,2,2,0,1,0
4,204,204,20,20,0,1,0
26,216,216,15,6,9,4,3
17,223,223,66,12,54,4,3
7,252,252,13,7,6,2,1
25,252,252,14,10,4,2,1
15,253,253,1,1,0,1,0
6,261,261,27,27,0,1,0
27,263,263,23,23,0,1,0
18,269,269,18,18,0,1,0
22,298,298,39,39,0,1,0
12,300,300,11,8,3,2,1
9,325,325,19,19,0,1,0
8,346,346,41,19,22,2,1
24,393,393,18,6,12,3,2
19,398,398,73,73,0,1,0
14,408,408,10,10,0,1,0
28,420,420,8,8,0,1,0
1,422,422,36,20,16,2,1
23,436,436,32,2,30,3,2
13,456,456,98,92,6,3,2
21,467,467,50,26,24,4,3
2,471,471,103,103,0,1,0
16,487,487,81,60,21,4,3
10,493,493,61,61,0,1,0

16,138,138,8,4,4,2,1
12,147,147,14,14,0,1,0
7,155,155,1,1,0,1,0
8,192,192,16,16,0,1,0
14,204,204,29,21,8,2,1
19,216,216,13,2,11,3,2
26,217,217,9,9,0,1,0
22,235,235,19,19,0,1,0
25,243,243,11,11,0,1,0
1,258,258,16,4,12,2,1
3,274,274,21,21,0,1,0
10,279,279,38,38,0,1,0
0,286,286,14,14,0,1,0
2,301,301,127,123,4,2,1
4,305,305,34,17,17,2,1
27,320,320,147,64,83,4,3
18,331,331,1,1,0,1,0
20,331,331,7,1,6,2,1
5,334,334,8,8,0,1,0
21,367,367,72,3,69,4,3
24,371,371,9,9,0,1,0
6,372,372,53,7,46,4,3
13,395,395,39,24,15,4,3
15,406,406,82,32,50,2,1
9,414,414,38,20,18,2,1
11,430,430,1,1,0,1,0
23,489,489,20,20,0,1,0
17,496,496,26,26,0,1,0

21,115,115,7,7,0,1,0
8,116,116,18,18,0,1,0
12,117,117,4,4,0,1,0
20,135,135,12,12,0,1,0
7,144,144,18,6,12,2,1
15,147,147,32,6,26,2,1
6,153,153,8,3,5,2,1
22,160,160,32,24,8,2,1
1,168,168,51,51,0,1,0
13,169,169,10,2,8,3,2
17,179,179,11,3,8,2,1
19,221,221,13,13,0,1,0
2,243,243,14,14,0,1,0
11,247,247,25,25,0,1,0
3,283,283,4,4,0,1,0
16,311,311,73,73,0,1,0
23,331,331,51,11,40,2,1
4,334,334,10,4,6,3,2
9,351,351,115,59,56,4,3
14,373,373,13,1,12,3,2
18,385,385,40,18,22,3,2
10,393,393,10,3,7,3,2
0,408,408,111,72,39,4,3
5,485,485,31,31,0,1,0

28,101,101,7,7,0,1,0
10,101,101,15,6,9,4,3
12,111,111,3,3,0,1,0
33,112,112,8,8,0,1,0
15,117,117,3,3,0,1,0
7,129,129,14,14,0,1,0
30,135,135,2,2,0,1,0
6,155,155,32,9,23,2,1
19,157,157,24,13,11,2,1
5,164,164,2,2,0,1,0
21,177,177,13,13,0,1,0
16,199,199,1,1,0,1,0
17,227,227,5,2,3,2,1
1,228,228,8,8,0,1,0
0,230,230,22,22,0,1,0
9,241,241,15,15,0,1,0
26,245,245,49,49,0,1,0
23,254,254,5,2,3,2,1
13,257,257,32,32,0,1,0
22,261,261,60,60,0,1,0
18,265,265,21,21,0,1,0
29,266,266,28,16,12,4,3
20,275,275,71,17,54,3,2
14,292,292,6,6,0,1,0
25,311,311,25,2,23,2,1
4,314,314,12,4,8,2,1
24,315,315,15,1,14,4,3
3,328,328,11,11,0,1,0
8,328,328,29,15,14,3,2
32,335,335,1,1,0,1,0
31,380,380,55,25,30,4,3
27,382,382,45,45,0,1,0
11,405,405,1,1,0,1,0
2,416,416,47,29,18,2,1

39,112,112,14,10,4,2,1
22,113,113,5,5,0,1,0
37,115,115,9,9,0,1,0
8,115,115,2,2,0,1,0
15,122,122,1,1,0,1,0
0,124,124,6,6,0,1,0
30,126,126,9,9,0,1,0
24,130,130,1,1,0,1,0
6,145,145,1,1,0,1,0
19,150,150,6,6,0,1,0
28,188,188,6,3,3,2,1
14,200,200,3,3,0,1,0
27,212,212,29,1,28,3,2
36,238,238,56,24,32,3,2
18,242,242,12,12,0,1,0
7,244,244,1,1,0,1,0
9,258,258,12,1,11,2,1
2,263,263,15,15,0,1,0
4,275,275,9,3,6,3,2
34,291,291,6,2,4,2,1
1,300,300,36,36,0,1,0
41,308,308,3,3,0,1,0
38,311,311,2,2,0,1,0
16,316,316,34,34,0,1,0
31,322,322,6,6,0,1,0
5,332,332,22,12,10,3,2
10,336,336,1,1,0,1,0
32,341,341,64,28,36,2,1
23,347,347,3,3,0,1,0
42,353,353,41,16,25,4,3
17,360,360,26,5,21,4,3
43,362,362,79,79,0,1,0
20,371,371,37,30,7,2,1
3,399,399,24,24,0,1,0
26,401,401,18,18,0,1,0
11,411,411,17,8,9,4,3
33,421,421,117,75,42,4,3
40,423,423,12,12,0,1,0
12,433,433,47,5,42,3,2
29,435,435,8,3,5,2,1
25,438,438,41,41,0,1,0
13,453,453,4,1,3,2,1
35,468,468,16,4,12,3,2
21,470,470,1,1,0,1,0

20,110,110,12,3,9,4,3
1,133,133,6,3,3,2,1
15,181,181,18,18,0,1,0
4,205,205,46,20,26,2,1
0,206,206,25,12,13,2,1
12,221,221,3,3,0,1,0
5,241,241,5,5,0,1,0
14,245,245,22,16,6,2,1
23,283,283,32,3,29,2,1
22,311,311,2,2,0,1,0
6,311,311,34,34,0,1,0
17,315,315,33,9,24,2,1
7,328,328,93,93,0,1,0
18,363,363,98,14,84,4,3
11,365,365,34,34,0,1,0
16,369,369,43,43,0,1,0
10,379,379,71,9,62,3,2
24,382,382,2,2,0,1,0
8,404,404,9,1,8,2,1
13,431,431,125,103,22,2,1
9,446,446,55,35,20,3,2
19,456,456,9,4,5,2,1
21,472,472,45,27,18,3,2
3,497,497,96,9,87,4,3
2,499,499,35,35,0,1,0

13,106,106,1,1,0,1,0
5,118,118,5,1,4,2,1
23,141,141,8,2,6,2,1
11,170,170,2,2,0,1,0
7,171,171,26,20,6,3,2
2,174,174,9,9,0,1,0
26,174,174,2,2,0,1,0
29,184,184,19,9,10,2,1
25,194,194,5,5,0,1,0
28,225,225,17,17,0,1,0
16,228,228,14,14,0,1,0
12,241,241,21,6,15,4,3
0,264,264,24,9,15,4,3
20,269,269,60,60,0,1,0
15,299,299,28,13,15,2,1
17,310,310,32,32,0,1,0
19,312,312,36,36,0,1,0
9,380,380,94,61,33,4,3
21,386,386,10,10,0,1,0
4,393,393,34,34,0,1,0
14,411,411,1,1,0,1,0
27,416,416,24,24,0,1,0
3,421,421,60,60,0,1,0
18,424,424,54,54,0,1,0
24,425,425,124,79,45,4,3
22,426,426,62,62,0,1,0
8,437,437,4,4,0,1,0
6,444,444,3,3,0,1,0
1,445,445,115,87,28,4,3
10,466,466,51,27,24,3,2

22,114,114,5,1,4,2,1
20,155,155,3,3,0,1,0
33,184,184,10,10,0,1,0
32,186,186,7,1,6,2,1
7,190,190,7,7,0,1,0
6,219,219,1,1,0,1,0
36,222,222,14,14,0,1,0
24,237,237,3,3,0,1,0
0,238,238,35,35,0,1,0
12,246,246,2,2,0,1,0
25,255,255,2,2,0,1,0
23,262,262,23,8,15,4,3
29,277,277,16,16,0,1,0
15,295,295,5,5,0,1,0
31,302,302,3,3,0,1,0
2,309,309,29,1,28,3,2
4,312,312,7,7,0,1,0
21,335,335,29,29,0,1,0
18,339,339,1,1,0,1,0
30,340,340,37,37,0,1,0
10,354,354,6,6,0,1,0
34,355,355,63,12,51,4,3
19,368,368,105,75,30,2,1
16,394,394,31,1,30,3,2
17,397,397,50,38,12,3,2
27,405,405,33,33,0,1,0
26,407,407,36,10,26,3,2
28,416,416,112,112,0,1,0
3,432,432,33,18,15,4,3
5,440,440,1,1,0,1,0
13,475,475,15,15,0,1,0
14,476,476,92,92,0,1,0
8,480,480,1,1,0,1,0
35,487,487,179,166,13,2,1
9,488,488,6,6,0,1,0
1,491,491,2,2,0,1,0
11,492,492,45,45,0,1,0

29,105,105,8,8,0,1,0
22,118,118,11,11,0,1,0
18,147,147,15,15,0,1,0
9,186,186,4,1,3,2,1
25,194,194,8,1,7,2,1
14,195,195,24,24,0,1,0
4,201,201,1,1,0,1,0
2,206,206,19,11,8,3,2
10,219,219,11,11,0,1,0
5,221,221,27,15,12,2,1
1,229,229,1,1,0,1,0
19,230,230,5,5,0,1,0
23,231,231,4,4,0,1,0
11,245,245,76,76,0,1,0
16,263,263,23,23,0,1,0
20,275,275,54,34,20,3,2
8,288,288,12,12,0,1,0
21,294,294,23,23,0,1,0
0,300,300,78,78,0,1,0
13,315,315,19,19,0,1,0
6,320,320,19,19,0,1,0
12,324,324,11,11,0,1,0
24,328,328,1,1,0,1,0
28,349,349,8,8,0,1,0
26,354,354,37,16,21,4,3
7,370,370,56,8,48,4,3
17,387,387,11,11,0,1,0
15,398,398,15,3,12,4,3
3,408,408,11,3,8,3,2
27,450,450,253,193,60,3,2

5,104,104,4,4,0,1,0
9,109,109,2,2,0,1,0
2,135,135,10,4,6,3,2
21,169,169,31,28,3,2,1
16,193,193,2,2,0,1,0
26,219,219,2,2,0,1,0
7,232,232,15,15,0,1,0
6,257,257,61,61,0,1,0
4,261,261,49,40,9,4,3
25,271,271,7,1,6,3,2
29,299,299,17,6,11,2,1
8,317,317,4,4,0,1,0
22,331,331,12,12,0,1,0
28,337,337,84,78,6,2,1
12,348,348,51,46,5,2,1
27,353,353,78,7,71,4,3
20,358,358,49,49,0,1,0
1,410,410,34,34,0,1,0
18,420,420,25,25,0,1,0
23,431,431,70,55,15,2,1
15,433,433,17,8,9,4,3
17,439,439,19,19,0,1,0
11,450,450,2,2,0,1,0
3,451,451,101,50,51,4,3
24,455,455,59,3,56,3,2
10,467,467,44,44,0,1,0
14,484,484,36,36,0,1,0
13,488,488,3,3,0,1,0
0,499,499,48,48,0,1,0
19,500,500,51,51,0,1,0

26,111,111,18,18,0,1,0
5,118,118,17,17,0,1,0
25,133,133,11,2,9,2,1
9,134,134,11,11,0,1,0
17,165,165,2,2,0,1,0
7,179,179,16,1,15,2,1
30,187,187,10,10,0,1,0
31,211,211,5,1,4,2,1
13,224,224,39,39,0,1,0
28,229,229,33,33,0,1,0
21,256,256,130,25,105,4,3
10,259,259,1,1,0,1,0
3,287,287,37,1,36,2,1
24,312,312,60,15,45,2,1
0,323,323,55,7,48,2,1
14,325,325,19,19,0,1,0
29,341,341,22,10,12,4,3
11,346,346,8,8,0,1,0
22,353,353,1,1,0,1,0
23,361,361,6,6,0,1,0
8,365,365,1,1,0,1,0
4,381,381,32,32,0,1,0
6,384,384,1,1,0,1,0
20,386,386,16,4,12,4,3
15,393,393,48,48,0,1,0
16,402,402,19,13,6,3,2
19,406,406,10,10,0,1,0
2,425,425,4,4,0,1,0
27,449,449,28,28,0,1,0
18,463,463,25,25,0,1,0
12,470,470,45,28,17,2,1
1,495,495,77,32,45,2,1

28,110,110,9,1,8,2,1
17,121,121,18,18,0,1,0
8,126,126,14,3,11,3,2
1,133,133,23,5,18,4,3
30,157,157,32,6,26,3,2
24,172,172,17,17,0,1,0
13,180,180,13,1,12,2,1
29,189,189,4,4,0,1,0
23,192,192,15,15,0,1,0
11,206,206,21,21,0,1,0
4,225,225,22,22,0,1,0
7,249,249,21,3,18,2,1
19,263,263,35,8,27,2,1
6,269,269,28,28,0,1,0
22,273,273,22,22,0,1,0
18,275,275,35,35,0,1,0
2,276,276,7,7,0,1,0
12,319,319,2,2,0,1,0
27,325,325,81,81,0,1,0
15,329,329,26,26,0,1,0
16,332,332,28,28,0,1,0
0,336,336,40,17,23,2,1
10,363,363,25,25,0,1,0
26,365,365,23,10,13,2,1
9,376,376,58,58,0,1,0
21,394,394,7,7,0,1,0
20,413,413,9,9,0,1,0
5,443,443,4,4,0,1,0
25,476,476,49,49,0,1,0
14,477,477,38,38,0,1,0
3,486,486,15,15,0,1,0

20,100,100,22,10,12,4,3
12,110,110,14,2,12,3,2
22,112,112,4,4,0,1,0
4,141,141,14,7,7,2,1
14,151,151,15,15,0,1,0
18,177,177,4,4,0,1,0
11,200,200,36,36,0,1,0
17,203,203,17,17,0,1,0
19,213,213,19,11,8,3,2
16,243,243,20,8,12,3,2
21,250,250,2,2,0,1,0
10,255,255,25,13,12,4,3
26,271,271,11,11,0,1,0
25,282,282,9,4,5,2,1
13,292,292,117,96,21,4,3
3,292,292,2,2,0,1,0
15,295,295,14,14,0,1,0
5,307,307,4,4,0,1,0
9,309,309,7,7,0,1,0
8,334,334,40,40,0,1,0
24,335,335,69,61,8,2,1
7,348,348,8,8,0,1,0
1,388,388,86,74,12,2,1
0,404,404,123,123,0,1,0
2,434,434,80,8,72,4,3
23,472,472,32,16,16,2,1
6,478,478,3,3,0,1,0

12,135,135,29,9,20,3,2
22,142,142,8,8,0,1,0
5,166,166,5,5,0,1,0
23,168,168,43,8,35,2,1
15,198,198,7,2,5,2,1
16,203,203,10,10,0,1,0
7,231,231,2,2,0,1,0
27,233,233,1,1,0,1,0
29,244,244,3,3,0,1,0
0,286,286,10,3,7,2,1
14,289,289,31,13,18,2,1
10,290,290,19,14,5,2,1
24,295,295,2,2,0,1,0
1,299,299,2,2,0,1,0
13,318,318,1,1,0,1,0
8,322,322,97,97,0,1,0
26,324,324,17,5,12,4,3
21,381,381,19,13,6,2,1
9,381,381,9,9,0,1,0
11,388,388,37,4,33,3,2
6,395,395,59,54,5,2,1
30,403,403,37,19,18,3,2
28,416,416,44,44,0,1,0
2,423,423,48,16,32,2,1
3,428,428,42,42,0,1,0
19,440,440,148,56,92,3,2
18,444,444,4,4,0,1,0
17,444,444,48,6,42,4,3
20,456,456,119,16,103,4,3
4,480,480,32,17,15,4,3
25,500,500,38,38,0,1,0

5,103,103,3,3,0,1,0
21,107,107,4,4,0,1,0
19,169,169,4,4,0,1,0
18,177,177,41,20,21,4,3
0,179,179,13,9,4,2,1
11,187,187,22,10,12,3,2
10,188,188,19,19,0,1,0
9,192,192,34,34,0,1,0
17,209,209,46,46,0,1,0
8,229,229,56,2,54,4,3
7,237,237,46,20,26,2,1
3,273,273,7,1,6,2,1
1,290,290,61,61,0,1,0
12,292,292,31,31,0,1,0
4,292,292,8,8,0,1,0
22,294,294,35,20,15,2,1
24,358,358,41,41,0,1,0
26,363,363,17,17,0,1,0
6,395,395,17,4,13,2,1
2,428,428,11,11,0,1,0
25,448,448,86,86,0,1,0
16,449,449,22,22,0,1,0
23,462,462,37,37,0,1,0
14,466,466,5,5,0,1,0
15,469,469,46,46,0,1,0
27,472,472,62,62,0,1,0
13,477,477,8,8,0,1,0
20,497,497,35,22,13,4,3
28,499,499,9,9,0,1,0

4,118,118,36,26,10,3,2
24,131,131,52,19,33,4,3
7,145,145,4,4,0,1,0
3,155,155,3,3,0,1,0
18,195,195,1,1,0,1,0
21,252,252,10,2,8,3,2
2,268,268,3,3,0,1,0
15,269,269,11,11,0,1,0
1,278,278,19,19,0,1,0
26,279,279,57,57,0,1,0
5,281,281,7,7,0,1,0
19,292,292,33,33,0,1,0
11,303,303,12,12,0,1,0
16,304,304,40,40,0,1,0
22,304,304,5,5,0,1,0
10,306,306,25,5,20,2,1
25,325,325,71,71,0,1,0
13,325,325,1,1,0,1,0
14,333,333,24,14,10,2,1
8,388,388,31,27,4,2,1
12,409,409,34,7,27,4,3
0,409,409,132,86,46,2,1
20,424,424,11,5,6,2,1
9,430,430,84,84,0,1,0
17,438,438,42,6,36,2,1
6,439,439,62,2,60,3,2
23,479,479,30,30,0,1,0

22,103,103,7,7,0,1,0
14,105,105,8,3,5,2,1
1,135,135,5,5,0,1,0
24,137,137,1,1,0,1,0
8,181,181,13,13,0,1,0
25,184,184,7,7,0,1,0
6,189,189,25,25,0,1,0
15,280,280,58,6,52,3,2
16,286,286,21,21,0,1,0
19,320,320,68,59,9,4,3
2,325,325,38,14,24,3,2
9,325,325,1,1,0,1,0
23,329,329,43,43,0,1,0
13,349,349,57,43,14,2,1
0,350,350,11,11,0,1,0
11,379,379,102,102,0,1,0
4,392,392,41,2,39,2,1
7,410,410,12,8,4,2,1
26,412,412,6,6,0,1,0
10,420,420,21,7,14,2,1
5,427,427,99,38,61,4,3
20,449,449,1,1,0,1,0
3,455,455,94,70,24,2,1
12,457,457,54,21,33,4,3
17,465,465,73,55,18,4,3
18,479,479,93,80,13,3,2
21,498,498,46,14,32,3,2

7,106,106,21,7,14,3,2
12,107,107,4,4,0,1,0
15,137,137,5,5,0,1,0
0,157,157,1,1,0,1,0
25,166,166,12,7,5,2,1
5,188,188,1,1,0,1,0
23,206,206,13,13,0,1,0
22,223,223,49,37,12,2,1
17,225,225,4,1,3,2,1
4,229,229,69,64,5,2,1
16,253,253,46,46,0,1,0
2,320,320,1,1,0,1,0
6,322,322,23,1,22,3,2
18,342,342,25,21,4,2,1
21,368,368,17,11,6,2,1
19,390,390,17,17,0,1,0
13,393,393,57,20,37,4,3
11,393,393,26,26,0,1,0
14,404,404,111,60,51,4,3
3,421,421,103,103,0,1,0
24,435,435,43,43,0,1,0
8,436,436,47,15,32,4,3
20,440,440,53,53,0,1,0
1,463,463,15,15,0,1,0
10,471,471,15,9,6,2,1
9,472,472,157,143,14,3,2

13,119,119,1,1,0,1,0
21,124,124,18,6,12,4,3
27,136,136,12,4,8,2,1
14,198,198,21,21,0,1,0
3,200,200,15,15,0,1,0
9,206,206,35,6,29,3,2
29,213,213,17,17,0,1,0
16,231,231,33,33,0,1,0
25,231,231,1,1,0,1,0
4,233,233,1,1,0,1,0
6,237,237,14,14,0,1,0
23,248,248,17,17,0,1,0
2,255,255,7,7,0,1,0
5,255,255,3,3,0,1,0
10,258,258,54,54,0,1,0
1,265,265,1,1,0,1,0
17,277,277,11,2,9,4,3
30,329,329,33,7,26,2,1
7,359,359,5,2,3,2,1
18,361,361,34,19,15,2,1
24,377,377,51,5,46,3,2
26,380,380,54,54,0,1,0
12,392,392,131,111,20,2,1
20,403,403,84,84,0,1,0
0,425,425,22,22,0,1,0
11,431,431,14,14,0,1,0
19,442,442,63,27,36,2,1
28,455,455,75,19,56,3,2
22,463,463,8,5,3,2,1
15,479,479,15,15,0,1,0
8,493,493,59,59,0,1,0

15,125,125,4,1,3,2,1
16,160,160,1,1,0,1,0
28,167,167,22,22,0,1,0
22,168,168,25,25,0,1,0
13,199,199,3,3,0,1,0
12,204,204,7,7,0,1,0
17,213,213,2,2,0,1,0
2,214,214,1,1,0,1,0
30,217,217,3,3,0,1,0
20,229,229,21,16,5,2,1
29,230,230,28,4,24,2,1
1,245,245,4,4,0,1,0
25,253,253,41,31,10,2,1
14,253,253,15,15,0,1,0
7,258,258,62,20,42,2,1
9,276,276,17,17,0,1,0
21,327,327,35,5,30,3,2
6,333,333,31,31,0,1,0
11,339,339,7,7,0,1,0
19,357,357,18,18,0,1,0
4,366,366,13,1,12,4,3
10,372,372,21,7,14,3,2
27,388,388,5,5,0,1,0
5,389,389,101,5,96,4,3
32,410,410,38,38,0,1,0
31,418,418,113,86,27,4,3
3,419,419,48,42,6,2,1
26,448,448,44,23,21,4,3
0,453,453,66,45,21,4,3
8,458,458,16,6,10,3,2
24,462,462,19,3,16,2,1
23,481,481,41,41,0,1,0
18,488,488,79,39,40,3,2

11,104,104,6,6,0,1,0
18,161,161,3,3,0,1,0
15,174,174,5,1,4,2,1
3,186,186,38,20,18,3,2
8,192,192,1,1,0,1,0
24,199,199,48,4,44,2,1
16,226,226,5,5,0,1,0
13,265,265,2,2,0,1,0
20,285,285,47,25,22,3,2
14,297,297,11,11,0,1,0
1,331,331,105,68,37,4,3
9,341,341,53,11,42,2,1
23,349,349,3,3,0,1,0
22,351,351,23,23,0,1,0
4,370,370,18,18,0,1,0
10,384,384,78,21,57,4,3
2,393,393,19,1,18,3,2
21,415,415,204,139,65,4,3
25,422,422,70,6,64,3,2
0,425,425,15,15,0,1,0
7,433,433,72,72,0,1,0
6,474,474,21,21,0,1,0
12,483,483,17,7,10,3,2
17,485,485,42,20,22,2,1
19,487,487,22,4,18,4,3
5,492,492,60,30,30,4,3

19,111,111,13,4,9,2,1
2,113,113,7,7,0,1,0
9,121,121,1,1,0,1,0
16,123,123,1,1,0,1,0
28,134,134,14,4,10,3,2
14,137,137,5,5,0,1,0
27,140,140,19,3,16,2,1
34,151,151,9,1,8,2,1
12,152,152,21,4,17,2,1
24,168,168,11,7,4,2,1
7,188,188,8,8,0,1,0
4,192,192,6,6,0,1,0
26,194,194,2,2,0,1,0
29,204,204,58,48,10,2,1
11,219,219,12,12,0,1,0
21,222,222,21,13,8,3,2
23,260,260,29,29,0,1,0
3,292,292,5,2,3,2,1
20,308,308,56,24,32,4,3
0,309,309,14,14,0,1,0
6,311,311,109,1,108,4,3
18,327,327,2,2,0,1,0
32,345,345,124,52,72,4,3
15,382,382,47,47,0,1,0
17,385,385,10,2,8,2,1
33,394,394,1,1,0,1,0
5,400,400,1,1,0,1,0
13,415,415,1,1,0,1,0
8,423,423,3,3,0,1,0
30,436,436,48,18,30,4,3
25,438,438,2,2,0,1,0
10,460,460,19,19,0,1,0
31,463,463,12,12,0,1,0
22,467,467,30,10,20,3,2
1,470,470,47,18,29,2,1

13,125,125,1,1,0,1,0
14,131,131,5,2,3,2,1
18,132,132,1,1,0,1,0
20,134,134,26,26,0,1,0
15,136,136,6,6,0,1,0
8,140,140,21,21,0,1,0
17,149,149,14,5,9,4,3
21,158,158,86,3,83,4,3
26,162,162,35,28,7,2,1
2,168,168,9,9,0,1,0
9,194,194,16,13,3,2,1
22,241,241,4,4,0,1,0
7,273,273,18,18,0,1,0
6,277,277,13,13,0,1,0
11,317,317,51,51,0,1,0
25,323,323,15,7,8,3,2
5,336,336,57,3,54,3,2
4,358,358,24,24,0,1,0
19,381,381,4,4,0,1,0
23,405,405,75,75,0,1,0
3,411,411,42,42,0,1,0
0,437,437,146,104,42,4,3
24,445,445,15,15,0,1,0
1,464,464,11,11,0,1,0
12,488,488,5,5,0,1,0
10,491,491,66,66,0,1,0
16,497,497,2,2,0,1,0

18,100,100,3,3,0,1,0
27,115,115,19,19,0,1,0
4,122,122,1,1,0,1,0
2,122,122,1,1,0,1,0
15,131,131,1,1,0,1,0
19,143,143,3,3,0,1,0
7,180,180,33,9,24,4,3
12,186,186,26,2,24,2,1
14,195,195,23,2,21,2,1
21,201,201,29,5,24,3,2
9,221,221,11,11,0,1,0
24,227,227,31,31,0,1,0
6,248,248,11,4,7,2,1
23,276,276,8,1,7,2,1
5,277,277,16,16,0,1,0
20,292,292,45,41,4,2,1
8,299,299,28,18,10,3,2
17,310,310,40,7,33,2,1
11,315,315,29,29,0,1,0
10,317,317,5,5,0,1,0
25,376,376,50,50,0,1,0
3,405,405,206,206,0,1,0
16,419,419,98,57,41,2,1
26,471,471,17,17,0,1,0
13,479,479,31,31,0,1,0
22,483,483,49,25,24,4,3
1,485,485,22,22,0,1,0
0,499,499,45,29,16,3,2

19,101,101,14,14,0,1,0
12,129,129,11,11,0,1,0
22,148,148,16,3,13,2,1
25,168,168,4,4,0,1,0
13,172,172,24,24,0,1,0
10,183,183,6,6,0,1,0
21,218,218,28,28,0,1,0
20,272,272,2,2,0,1,0
5,276,276,42,8,34,3,2
26,284,284,20,12,8,3,2
2,291,291,58,58,0,1,0
9,298,298,26,26,0,1,0
8,304,304,14,14,0,1,0
15,323,323,23,23,0,1,0
11,326,326,39,39,0,1,0
3,332,332,4,4,0,1,0
14,352,352,11,11,0,1,0
6,417,417,16,10,6,2,1
18,419,419,45,45,0,1,0
1,454,454,4,4,0,1,0
17,470,470,13,5,8,3,2
24,472,472,110,110,0,1,0
0,482,482,83,11,72,3,2
16,484,484,21,3,18,3,2
7,484,484,96,96,0,1,0
4,486,486,121,121,0,1,0
23,492,492,144,88,56,3,2

5,148,148,25,25,0,1,0
13,165,165,9,3,6,2,1
8,167,167,11,5,6,2,1
9,173,173,12,12,0,1,0
6,179,179,5,5,0,1,0
25,228,228,6,6,0,1,0
1,231,231,13,13,0,1,0
17,267,267,50,44,6,3,2
10,303,303,5,5,0,1,0
16,314,314,8,5,3,2,1
18,317,317,14,1,13,2,1
21,346,346,17,5,12,4,3
14,353,353,20,17,3,2,1
7,379,379,28,28,0,1,0
20,380,380,51,42,9,4,3
26,412,412,1,1,0,1,0
15,434,434,2,2,0,1,0
4,435,435,27,4,23,2,1
12,439,439,30,30,0,1,0
19,439,439,154,124,30,2,1
11,442,442,75,25,50,2,1
2,445,445,25,25,0,1,0
27,445,445,53,38,15,2,1
22,452,452,39,39,0,1,0
0,468,468,10,10,0,1,0
23,476,476,86,86,0,1,0
24,487,487,75,23,52,3,2
3,489,489,241,94,147,4,3

8,114,114,8,8,0,1,0
31,127,127,1,1,0,1,0
29,131,131,10,10,0,1,0
23,157,157,6,6,0,1,0
16,160,160,3,3,0,1,0
18,163,163,1,1,0,1,0
10,205,205,24,24,0,1,0
12,210,210,4,1,3,2,1
28,228,228,32,32,0,1,0
34,240,240,4,4,0,1,0
19,243,243,5,5,0,1,0
6,258,258,15,15,0,1,0
36,281,281,6,6,0,1,0
2,282,282,13,1,12,3,2
5,284,284,6,6,0,1,0
21,285,285,29,29,0,1,0
17,291,291,28,2,26,2,1
22,291,291,12,12,0,1,0
14,293,293,12,12,0,1,0
33,295,295,57,35,22,2,1
26,317,317,88,18,70,3,2
24,320,320,13,1,12,4,3
30,322,322,9,6,3,2,1
4,364,364,24,4,20,2,1
37,374,374,6,6,0,1,0
25,382,382,65,41,24,4,3
20,385,385,2,2,0,1,0
0,403,403,3,3,0,1,0
27,414,414,70,70,0,1,0
11,431,431,3,3,0,1,0
35,440,440,22,12,10,2,1
13,449,449,70,70,0,1,0
15,452,452,8,8,0,1,0
32,479,479,102,85,17,4,3
7,481,481,18,18,0,1,0
9,485,485,50,30,20,3,2
1,488,488,94,26,68,4,3
3,489,489,55,7,48,4,3

9,141,141,13,13,0,1,0
3,149,149,12,9,3,2,1
23,157,157,4,4,0,1,0
17,164,164,6,6,0,1,0
7,183,183,23,23,0,1,0
15,184,184,2,2,0,1,0
24,215,215,8,8,0,1,0
18,243,243,10,3,7,2,1
13,258,258,7,1,6,3,2
10,285,285,10,10,0,1,0
0,300,300,29,29,0,1,0
5,301,301,8,4,4,2,1
8,302,302,1,1,0,1,0
20,334,334,20,12,8,2,1
16,337,337,19,14,5,2,1
6,342,342,52,52,0,1,0
26,359,359,71,26,45,4,3
19,374,374,56,56,0,1,0
14,374,374,1,1,0,1,0
2,380,380,9,3,6,2,1
25,387,387,50,16,34,4,3
1,390,390,16,16,0,1,0
27,393,393,156,82,74,3,2
21,401,401,94,94,0,1,0
22,408,408,20,20,0,1,0
12,435,435,61,21,40,4,3
4,450,450,185,83,102,4,3
11,500,500,73,17,56,3,2

25,121,121,16,4,12,4,3
26,132,132,11,11,0,1,0
4,137,137,35,20,15,2,1
23,150,150,23,23,0,1,0
22,163,163,27,15,12,3,2
0,164,164,17,13,4,2,1
2,203,203,1,1,0,1,0
14,209,209,32,20,12,2,1
13,218,218,4,4,0,1,0
1,233,233,15,3,12,2,1
12,241,241,9,1,8,2,1
11,260,260,21,21,0,1,0
16,273,273,67,25,42,2,1
3,279,279,177,177,0,1,0
18,280,280,25,15,10,3,2
20,280,280,5,5,0,1,0
10,314,314,1,1,0,1,0
21,366,366,35,2,33,2,1
6,369,369,39,25,14,2,1
7,394,394,4,4,0,1,0
9,419,419,14,14,0,1,0
24,426,426,28,28,0,1,0
15,427,427,8,8,0,1,0
19,435,435,5,5,0,1,0
5,441,441,19,19,0,1,0
17,445,445,79,29,50,2,1
8,467,467,12,3,9,2,1

23,100,100,13,13,0,1,0
19,108,108,7,1,6,2,1
3,118,118,37,3,34,2,1
17,119,119,9,3,6,2,1
9,119,119,8,8,0,1,0
14,158,158,13,13,0,1,0
2,164,164,15,1,14,3,2
13,166,166,28,12,16,3,2
10,168,168,34,11,23,2,1
4,192,192,19,19,0,1,0
11,196,196,11,5,6,2,1
8,248,248,37,2,35,2,1
7,285,285,37,2,35,4,3
22,285,285,13,13,0,1,0
21,320,320,99,28,71,4,3
0,376,376,34,34,0,1,0
1,380,380,61,13,48,2,1
24,418,418,14,14,0,1,0
12,432,432,6,6,0,1,0
20,443,443,14,14,0,1,0
15,447,447,49,49,0,1,0
16,460,460,116,116,0,1,0
6,495,495,33,33,0,1,0
5,496,496,16,16,0,1,0
18,498,498,30,17,13,2,1

8,101,101,16,11,5,2,1
18,114,114,6,6,0,1,0
7,128,128,25,2,23,2,1
4,176,176,20,20,0,1,0
24,200,200,13,13,0,1,0
5,201,201,6,6,0,1,0
2,205,205,1,1,0,1,0
6,221,221,68,50,18,4,3
10,227,227,4,4,0,1,0
22,229,229,19,13,6,3,2
15,231,231,11,3,8,2,1
9,234,234,33,33,0,1,0
21,253,253,39,12,27,4,3
16,267,267,71,7,64,4,3
0,297,297,55,40,15,4,3
14,317,317,7,7,0,1,0
13,352,352,14,14,0,1,0
3,356,356,43,22,21,4,3
19,380,380,54,54,0,1,0
12,446,446,32,2,30,4,3
20,448,448,18,18,0,1,0
23,449,449,34,10,24,3,2
11,470,470,13,13,0,1,0
1,490,490,63,15,48,2,1
17,494,494,165,165,0,1,0

4,106,106,41,23,18,4,3
1,136,136,11,8,3,2,1
10,147,147,1,1,0,1,0
21,155,155,1,1,0,1,0
15,219,219,22,22,0,1,0
9,241,241,37,7,30,3,2
13,241,241,60,60,0,1,0
17,251,251,21,8,13,2,1
19,307,307,14,4,10,2,1
11,311,311,23,7,16,2,1
20,343,343,60,15,45,2,1
12,344,344,58,58,0,1,0
5,357,357,36,20,16,3,2
7,378,378,68,59,9,4,3
6,412,412,23,23,0,1,0
14,415,415,84,84,0,1,0
18,439,439,13,13,0,1,0
2,465,465,39,18,21,2,1
8,468,468,45,45,0,1,0
3,474,474,57,57,0,1,0
16,487,487,16,3,13,2,1
0,499,499,196,73,123,4,3

28,102,102,9,9,0,1,0
5,104,104,14,10,4,2,1
10,115,115,16,16,0,1,0
24,136,136,2,2,0,1,0
15,153,153,12,7,5,2,1
1,169,169,6,6,0,1,0
26,187,187,4,4,0,1,0
27,200,200,4,4,0,1,0
25,224,224,3,3,0,1,0
8,242,242,39,7,32,3,2
11,252,252,59,27,32,2,1
3,285,285,3,3,0,1,0
22,291,291,63,29,34,3,2
18,312,312,150,96,54,4,3
7,322,322,21,21,0,1,0
4,331,331,31,31,0,1,0
13,336,336,13,13,0,1,0
23,336,336,27,11,16,3,2
9,344,344,1,1,0,1,0
17,350,350,5,5,0,1,0
12,354,354,18,12,6,2,1
21,360,360,26,26,0,1,0
29,364,364,41,41,0,1,0
2,365,365,38,38,0,1,0
20,418,418,69,69,0,1,0
0,419,419,27,8,19,4,3
6,444,444,24,15,9,2,1
19,452,452,15,15,0,1,0
16,457,457,46,46,0,1,0
14,495,495,67,67,0,1,0

27,103,103,6,6,0,1,0
9,124,124,1,1,0,1,0
20,133,133,12,2,10,3,2
18,148,148,17,17,0,1,0
28,158,158,35,35,0,1,0
14,179,179,18,18,0,1,0
36,188,188,6,6,0,1,0
0,190,190,29,20,9,4,3
29,190,190,27,27,0,1,0
13,201,201,24,10,14,2,1
25,207,207,7,7,0,1,0
10,208,208,1,1,0,1,0
5,222,222,14,14,0,1,0
3,233,233,3,3,0,1,0
34,268,268,39,39,0,1,0
7,291,291,16,2,14,2,1
4,302,302,31,10,21,2,1
26,322,322,85,85,0,1,0
1,324,324,2,2,0,1,0
31,328,328,2,2,0,1,0
37,338,338,3,3,0,1,0
12,339,339,53,32,21,4,3
2,373,373,18,18,0,1,0
23,385,385,41,5,36,4,3
30,398,398,110,53,57,4,3
15,402,402,5,5,0,1,0
19,406,406,34,34,0,1,0
8,407,407,15,9,6,2,1
32,407,407,12,12,0,1,0
21,413,413,17,2,15,2,1
33,422,422,66,66,0,1,0
16,424,424,7,7,0,1,0
24,431,431,5,5,0,1,0
6,444,444,7,1,6,3,2
11,452,452,1,1,0,1,0
35,462,462,19,19,0,1,0
17,477,477,20,11,9,2,1
22,488,488,5,5,0,1,0

0,124,124,1,1,0,1,0
4,144,144,13,1,12,2,1
18,168,168,13,13,0,1,0
3,178,178,11,11,0,1,0
8,181,181,10,2,8,2,1
1,187,187,1,1,0,1,0
17,187,187,33,33,0,1,0
23,203,203,1,1,0,1,0
14,222,222,36,36,0,1,0
15,231,231,1,1,0,1,0
24,262,262,8,2,6,2,1
16,267,267,7,2,5,2,1
6,292,292,37,37,0,1,0
13,310,310,74,17,57,4,3
12,321,321,5,5,0,1,0
20,361,361,2,2,0,1,0
11,365,365,1,1,0,1,0
5,382,382,107,64,43,4,3
19,384,384,56,10,46,3,2
22,397,397,97,63,34,3,2
7,422,422,56,29,27,2,1
2,439,439,2,2,0,1,0
9,445,445,130,130,0,1,0
25,445,445,19,19,0,1,0
21,492,492,154,46,108,4,3
10,494,494,44,44,0,1,0
26,498,498,83,70,13,2,1
27,498,498,15,15,0,1,0

19,114,114,8,1,7,2,1
20,122,122,27,2,25,3,2
10,136,136,24,24,0,1,0
26,143,143,18,18,0,1,0
18,165,165,7,7,0,1,0
6,185,185,22,22,0,1,0
4,203,203,11,5,6,2,1
16,233,233,35,35,0,1,0
11,246,246,33,9,24,3,2
0,319,319,74,37,37,2,1
25,320,320,5,1,4,2,1
15,341,341,28,9,19,2,1
8,353,353,26,26,0,1,0
5,390,390,71,71,0,1,0
17,392,392,28,28,0,1,0
13,398,398,38,38,0,1,0
14,400,400,17,5,12,2,1
22,415,415,8,8,0,1,0
9,423,423,8,5,3,2,1
2,429,429,41,7,34,2,1
1,436,436,6,6,0,1,0
7,446,446,68,36,32,2,1
24,447,447,79,79,0,1,0
12,468,468,21,21,0,1,0
3,496,496,52,19,33,4,3
23,498,498,25,11,14,3,2
21,500,500,128,34,94,4,3

16,100,100,18,10,8,3,2
26,101,101,28,28,0,1,0
14,102,102,14,14,0,1,0
18,159,159,5,5,0,1,0
10,179,179,28,18,10,2,1
28,180,180,2,2,0,1,0
5,198,198,21,21,0,1,0
15,221,221,14,14,0,1,0
11,229,229,1,1,0,1,0
19,249,249,7,7,0,1,0
9,257,257,30,30,0,1,0
21,263,263,82,50,32,2,1
1,266,266,20,2,18,4,3
12,268,268,6,1,5,2,1
7,285,285,20,2,18,4,3
30,285,285,33,1,32,2,1
17,303,303,2,2,0,1,0
24,318,318,5,5,0,1,0
2,324,324,73,73,0,1,0
6,331,331,20,7,13,3,2
3,349,349,15,15,0,1,0
27,357,357,24,12,12,4,3
20,360,360,59,15,44,3,2
31,382,382,11,3,8,3,2
8,384,384,2,2,0,1,0
25,390,390,19,1,18,3,2
22,391,391,102,102,0,1,0
23,398,398,7,3,4,2,1
0,423,423,47,1,46,2,1
4,448,448,2,2,0,1,0
13,471,471,7,4,3,2,1
29,491,491,21,7,14,2,1

25,126,126,7,7,0,1,0
19,152,152,3,3,0,1,0
1,169,169,10,10,0,1,0
2,214,214,20,10,10,2,1
8,225,225,12,12,0,1,0
4,226,226,12,12,0,1,0
15,239,239,4,1,3,2,1
5,241,241,25,25,0,1,0
12,249,249,116,59,57,4,3
7,264,264,10,10,0,1,0
24,267,267,1,1,0,1,0
0,272,272,15,15,0,1,0
23,293,293,10,10,0,1,0
22,329,329,1,1,0,1,0
14,336,336,1,1,0,1,0
6,343,343,47,47,0,1,0
3,360,360,48,48,0,1,0
10,366,366,41,38,3,2,1
21,372,372,166,139,27,2,1
16,379,379,9,9,0,1,0
11,389,389,16,4,12,4,3
9,422,422,24,24,0,1,0
26,456,456,24,14,10,2,1
17,456,456,135,135,0,1,0
13,459,459,24,2,22,3,2
18,478,478,76,76,0,1,0
20,479,479,126,40,86,3,2

2,119,119,12,4,8,3,2
3,136,136,20,10,10,3,2
17,138,138,14,2,12,2,1
10,143,143,2,2,0,1,0
13,153,153,27,27,0,1,0
18,181,181,51,51,0,1,0
23,185,185,5,2,3,2,1
8,261,261,34,19,15,2,1
4,280,280,86,59,27,4,3
9,285,285,6,6,0,1,0
15,301,301,10,10,0,1,0
6,313,313,44,11,33,2,1
11,316,316,34,8,26,2,1
20,321,321,26,26,0,1,0
7,357,357,41,32,9,4,3
19,359,359,44,1,43,2,1
14,361,361,13,9,4,2,1
5,362,362,25,25,0,1,0
12,370,370,38,38,0,1,0
22,404,404,61,51,10,3,2
21,413,413,32,2,30,3,2
1,441,441,53,53,0,1,0
16,455,455,52,12,40,3,2
0,487,487,122,122,0,1,0

12,100,100,28,28,0,1,0
8,120,120,6,1,5,2,1
13,143,143,4,4,0,1,0
20,198,198,81,46,35,2,1
11,241,241,1,1,0,1,0
15,248,248,20,13,7,2,1
7,268,268,10,10,0,1,0
21,276,276,2,2,0,1,0
5,282,282,2,2,0,1,0
25,309,309,13,13,0,1,0
6,319,319,5,5,0,1,0
24,328,328,26,4,22,3,2
10,330,330,29,29,0,1,0
16,345,345,65,65,0,1,0
14,375,375,13,6,7,2,1
4,417,417,18,18,0,1,0
0,427,427,88,88,0,1,0
3,430,430,156,156,0,1,0
1,431,431,1,1,0,1,0
26,431,431,38,30,8,3,2
23,431,431,7,1,6,2,1
17,450,450,67,38,29,2,1
2,455,455,120,120,0,1,0
19,461,461,37,37,0,1,0
9,469,469,23,13,10,2,1
22,479,479,91,64,27,4,3
18,486,486,15,15,0,1,0

3,120,120,5,5,0,1,0
13,135,135,37,37,0,1,0
15,152,152,2,2,0,1,0
22,172,172,27,27,0,1,0
20,172,172,26,26,0,1,0
8,197,197,3,3,0,1,0
12,198,198,2,2,0,1,0
4,202,202,20,2,18,2,1
18,226,226,4,4,0,1,0
11,237,237,64,52,12,3,2
25,240,240,34,12,22,3,2
17,249,249,26,26,0,1,0
24,252,252,41,41,0,1,0
23,293,293,10,10,0,1,0
5,298,298,2,2,0,1,0
14,331,331,10,10,0,1,0
16,331,331,57,57,0,1,0
2,338,338,13,13,0,1,0
9,346,346,17,17,0,1,0
21,373,373,36,3,33,4,3
0,423,423,29,29,0,1,0
1,427,427,116,90,26,2,1
19,453,453,17,17,0,1,0
6,463,463,1,1,0,1,0
10,486,486,171,171,0,1,0
7,491,491,87,69,18,2,1
26,493,493,20,10,10,3,2

16,105,105,14,14,0,1,0
20,107,107,2,2,0,1,0
24,124,124,3,3,0,1,0
4,141,141,19,6,13,2,1
22,150,150,1,1,0,1,0
8,165,165,26,26,0,1,0
1,167,167,40,23,17,2,1
5,179,179,16,4,12,4,3
14,185,185,31,31,0,1,0
11,237,237,16,13,3,2,1
21,240,240,40,8,32,2,1
15,254,254,61,21,40,3,2
12,264,264,2,2,0,1,0
13,304,304,49,23,26,3,2
7,312,312,40,40,0,1,0
6,317,317,50,50,0,1,0
2,321,321,19,7,12,3,2
0,332,332,34,34,0,1,0
23,347,347,28,10,18,4,3
17,349,349,9,9,0,1,0
3,351,351,2,2,0,1,0
19,385,385,64,64,0,1,0
10,452,452,55,38,17,4,3
18,489,489,84,30,54,4,3
9,500,500,103,47,56,3,2

3,107,107,18,8,10,2,1
23,107,107,12,4,8,3,2
16,110,110,25,12,13,2,1
5,111,111,8,8,0,1,0
24,130,130,17,17,0,1,0
25,146,146,8,8,0,1,0
20,165,165,3,3,0,1,0
8,167,167,1,1,0,1,0
11,177,177,27,27,0,1,0
27,183,183,9,9,0,1,0
14,214,214,3,3,0,1,0
15,215,215,27,7,20,3,2
6,218,218,4,1,3,2,1
12,222,222,11,4,7,2,1
22,224,224,21,9,12,3,2
9,238,238,2,2,0,1,0
29,258,258,10,10,0,1,0
4,292,292,8,8,0,1,0
13,302,302,9,9,0,1,0
1,309,309,34,14,20,3,2
21,309,309,5,2,3,2,1
0,312,312,25,25,0,1,0
28,334,334,60,60,0,1,0
19,334,334,46,46,0,1,0
7,359,359,39,13,26,2,1
10,374,374,16,16,0,1,0
2,385,385,59,50,9,4,3
26,394,394,68,32,36,4,3
17,395,395,3,3,0,1,0
18,438,438,45,45,0,1,0
30,490,490,85,38,47,4,3
31,492,492,75,64,11,2,1

21,147,147,12,12,0,1,0
10,148,148,6,6,0,1,0
17,151,151,11,11,0,1,0
8,162,162,16,5,11,2,1
4,186,186,20,20,0,1,0
16,222,222,4,4,0,1,0
28,238,238,26,26,0,1,0
23,249,249,26,16,10,2,1
13,262,262,60,60,0,1,0
15,284,284,13,5,8,3,2
26,289,289,35,35,0,1,0
7,293,293,4,4,0,1,0
34,294,294,52,52,0,1,0
3,295,295,10,10,0,1,0
11,311,311,13,2,11,2,1
6,323,323,2,2,0,1,0
5,333,333,29,29,0,1,0
2,334,334,11,2,9,4,3
12,337,337,53,53,0,1,0
33,338,338,76,19,57,4,3
24,341,341,19,2,17,2,1
29,342,342,13,13,0,1,0
22,345,345,5,1,4,2,1
19,368,368,4,4,0,1,0
0,375,375,22,22,0,1,0
1,381,381,54,8,46,4,3
31,393,393,68,29,39,2,1
27,395,395,14,14,0,1,0
20,398,398,21,15,6,3,2
30,402,402,33,33,0,1,0
32,416,416,31,31,0,1,0
14,431,431,1,1,0,1,0
9,464,464,68,68,0,1,0
18,475,475,2,2,0,1,0
25,498,498,68,64,4,2,1

26,113,113,21,21,0,1,0
8,115,115,12,2,10,3,2
28,118,118,8,8,0,1,0
7,122,122,1,1,0,1,0
2,138,138,1,1,0,1,0
24,145,145,4,4,0,1,0
21,152,152,2,2,0,1,0
27,197,197,37,11,26,3,2
25,226,226,46,46,0,1,0
0,262,262,14,8,6,2,1
6,267,267,29,16,13,2,1
16,287,287,7,7,0,1,0
5,292,292,44,11,33,4,3
29,300,300,26,21,5,2,1
9,301,301,5,5,0,1,0
3,307,307,3,3,0,1,0
10,325,325,14,1,13,4,3
11,357,357,1,1,0,1,0
23,372,372,22,22,0,1,0
31,385,385,7,1,6,2,1
4,419,419,33,33,0,1,0
1,419,419,17,9,8,2,1
19,422,422,42,13,29,3,2
15,434,434,20,6,14,4,3
17,435,435,52,11,41,2,1
13,437,437,29,2,27,4,3
14,445,445,92,92,0,1,0
30,465,465,21,4,17,2,1
22,470,470,8,8,0,1,0
20,478,478,179,117,62,3,2
12,484,484,152,121,31,3,2
18,486,486,24,16,8,3,2

20,122,122,33,33,0,1,0
14,127,127,4,4,0,1,0
6,135,135,11,11,0,1,0
23,179,179,16,16,0,1,0
1,184,184,48,48,0,1,0
5,213,213,23,23,0,1,0
7,247,247,27,10,17,2,1
11,298,298,3,3,0,1,0
8,318,318,98,52,46,4,3
17,318,318,1,1,0,1,0
16,320,320,58,58,0,1,0
18,321,321,64,56,8,2,1
21,348,348,26,26,0,1,0
19,366,366,1,1,0,1,0
12,368,368,29,7,22,2,1
10,378,378,7,7,0,1,0
13,385,385,32,32,0,1,0
0,446,446,8,4,4,2,1
4,449,449,3,3,0,1,0
2,451,451,89,89,0,1,0
22,459,459,22,11,11,2,1
3,474,474,108,108,0,1,0
15,486,486,164,104,60,4,3
9,494,494,41,33,8,2,1

16,119,119,12,12,0,1,0
1,125,125,11,2,9,4,3
21,128,128,17,17,0,1,0
26,129,129,12,3,9,4,3
9,168,168,29,19,10,3,2
24,197,197,4,4,0,1,0
25,199,199,37,37,0,1,0
12,217,217,6,6,0,1,0
5,220,220,3,3,0,1,0
2,221,221,73,7,66,4,3
15,247,247,45,31,14,3,2
20,271,271,53,6,47,4,3
19,290,290,3,3,0,1,0
18,307,307,95,8,87,4,3
28,325,325,14,1,13,2,1
0,330,330,7,2,5,2,1
10,339,339,18,6,12,3,2
8,339,339,57,17,40,3,2
17,347,347,5,5,0,1,0
4,367,367,8,8,0,1,0
3,401,401,46,3,43,2,1
22,404,404,20,20,0,1,0
14,414,414,29,15,14,3,2
27,417,417,33,21,12,4,3
6,419,419,33,1,32,4,3
7,428,428,31,7,24,4,3
11,452,452,54,35,19,2,1
13,490,490,24,12,12,4,3
23,500,500,7,7,0,1,0

18,108,108,7,7,0,1,0
20,111,111,2,2,0,1,0
14,113,113,1,1,0,1,0
5,115,115,1,1,0,1,0
11,124,124,39,39,0,1,0
1,134,134,19,19,0,1,0
10,163,163,1,1,0,1,0
9,179,179,6,6,0,1,0
0,194,194,20,20,0,1,0
19,194,194,6,1,5,2,1
6,215,215,26,26,0,1,0
8,228,228,40,10,30,3,2
12,243,243,13,13,0,1,0
3,249,249,17,17,0,1,0
27,254,254,45,3,42,3,2
25,271,271,44,21,23,4,3
23,280,280,5,5,0,1,0
16,283,283,11,5,6,2,1
15,284,284,24,17,7,2,1
17,306,306,31,31,0,1,0
4,308,308,20,10,10,2,1
2,315,315,47,21,26,2,1
24,357,357,123,95,28,3,2
28,394,394,16,16,0,1,0
22,433,433,4,4,0,1,0
13,440,440,50,50,0,1,0
21,441,441,113,31,82,3,2
7,473,473,18,7,11,2,1
26,500,500,43,43,0,1,0

20,108,108,18,18,0,1,0
32,113,113,26,26,0,1,0
3,119,119,13,13,0,1,0
7,126,126,34,6,28,2,1
31,131,131,17,5,12,2,1
33,141,141,16,13,3,2,1
5,149,149,1,1,0,1,0
2,161,161,4,4,0,1,0
30,165,165,7,1,6,2,1
11,170,170,1,1,0,1,0
28,184,184,3,3,0,1,0
14,192,192,26,18,8,2,1
22,219,219,5,5,0,1,0
24,223,223,5,5,0,1,0
25,226,226,20,20,0,1,0
23,226,226,42,42,0,1,0
27,232,232,48,48,0,1,0
26,278,278,19,8,11,3,2
0,281,281,8,8,0,1,0
15,283,283,18,3,15,3,2
17,316,316,2,2,0,1,0
8,316,316,5,1,4,2,1
10,323,323,8,8,0,1,0
12,347,347,11,6,5,2,1
6,348,348,33,33,0,1,0
4,351,351,39,39,0,1,0
9,396,396,43,21,22,3,2
1,401,401,16,16,0,1,0
29,429,429,36,36,0,1,0
19,434,434,17,17,0,1,0
16,469,469,33,33,0,1,0
13,480,480,43,28,15,4,3
21,496,496,27,6,21,2,1
18,500,500,63,63,0,1,0

20,118,118,1,1,0,1,0
3,126,126,1,1,0,1,0
8,137,137,2,2,0,1,0
31,151,151,25,25,0,1,0
28,162,162,15,15,0,1,0
5,167,167,25,25,0,1,0
23,173,173,21,7,14,3,2
0,177,177,40,40,0,1,0
35,189,189,5,1,4,2,1
21,189,189,16,16,0,1,0
1,192,192,27,8,19,2,1
26,193,193,23,23,0,1,0
4,200,200,10,10,0,1,0
32,268,268,66,18,48,2,1
22,280,280,12,12,0,1,0
33,280,280,19,1,18,3,2
14,288,288,14,14,0,1,0
30,309,309,41,27,14,3,2
16,316,316,5,5,0,1,0
29,322,322,11,11,0,1,0
19,337,337,8,2,6,3,2
24,338,338,18,18,0,1,0
11,341,341,21,21,0,1,0
7,351,351,10,10,0,1,0
10,370,370,2,2,0,1,0
9,420,420,76,61,15,4,3
34,429,429,99,99,0,1,0
27,436,436,17,9,8,2,1
6,452,452,20,5,15,2,1
15,457,457,6,6,0,1,0
2,457,457,49,19,30,3,2
25,475,475,26,16,10,2,1
18,483,483,38,25,13,2,1
17,484,484,4,1,3,2,1
13,495,495,52,18,34,2,1
12,499,499,1,1,0,1,0

26,142,142,18,5,13,2,1
16,148,148,28,28,0,1,0
10,156,156,1,1,0,1,0
14,162,162,59,38,21,2,1
0,164,164,39,33,6,3,2
22,172,172,17,5,12,3,2
13,172,172,14,14,0,1,0
8,178,178,14,8,6,3,2
17,219,219,13,3,10,3,2
9,256,256,34,1,33,4,3
23,265,265,3,3,0,1,0
19,272,272,23,1,22,2,1
15,272,272,38,2,36,2,1
4,292,292,7,7,0,1,0
3,297,297,48,45,3,2,1
18,332,332,1,1,0,1,0
25,334,334,4,4,0,1,0
1,347,347,1,1,0,1,0
6,348,348,18,18,0,1,0
7,362,362,35,35,0,1,0
24,364,364,39,5,34,3,2
20,391,391,19,9,10,3,2
11,399,399,126,126,0,1,0
5,406,406,104,104,0,1,0
2,416,416,2,2,0,1,0
21,426,426,45,18,27,4,3
12,470,470,15,9,6,3,2

7,102,102,8,8,0,1,0
13,102,102,18,7,11,2,1
5,108,108,3,3,0,1,0
27,120,120,14,7,7,2,1
6,121,121,11,11,0,1,0
29,124,124,7,7,0,1,0
12,152,152,17,17,0,1,0
17,153,153,3,3,0,1,0
3,163,163,4,4,0,1,0
2,166,166,20,20,0,1,0
28,178,178,49,43,6,2,1
10,194,194,10,6,4,2,1
23,229,229,19,19,0,1,0
4,241,241,12,6,6,3,2
18,258,258,32,11,21,4,3
15,288,288,89,41,48,4,3
8,292,292,12,6,6,3,2
9,299,299,51,15,36,3,2
14,309,309,16,16,0,1,0
1,336,336,9,9,0,1,0
24,348,348,2,2,0,1,0
22,383,383,6,2,4,2,1
30,420,420,1,1,0,1,0
25,439,439,114,103,11,2,1
0,441,441,22,22,0,1,0
21,463,463,60,60,0,1,0
16,468,468,3,3,0,1,0
26,472,472,140,140,0,1,0
19,478,478,9,9,0,1,0
11,488,488,7,7,0,1,0
20,493,493,14,4,10,3,2

15,100,100,19,10,9,4,3
6,158,158,6,1,5,2,1
11,180,180,2,2,0,1,0
8,195,195,12,12,0,1,0
19,201,201,37,37,0,1,0
13,260,260,14,2,12,4,3
10,276,276,1,1,0,1,0
14,278,278,45,23,22,2,1
21,286,286,33,8,25,2,1
5,295,295,77,27,50,3,2
9,300,300,21,10,11,4,3
2,306,306,28,25,3,2,1
1,351,351,109,109,0,1,0
0,357,357,109,77,32,3,2
3,371,371,93,93,0,1,0
16,374,374,82,37,45,2,1
20,374,374,31,20,11,2,1
7,389,389,9,9,0,1,0
17,404,404,35,35,0,1,0
18,422,422,72,58,14,2,1
4,458,458,55,55,0,1,0
12,494,494,9,9,0,1,0

13,104,104,29,21,8,3,2
21,119,119,8,8,0,1,0
25,134,134,3,3,0,1,0
20,138,138,42,37,5,2,1
8,159,159,5,5,0,1,0
12,161,161,28,13,15,4,3
11,166,166,15,15,0,1,0
28,188,188,9,9,0,1,0
24,199,199,56,18,38,2,1
17,205,205,24,20,4,2,1
15,209,209,4,4,0,1,0
6,210,210,1,1,0,1,0
2,216,216,8,8,0,1,0
3,230,230,5,5,0,1,0
9,231,231,20,20,0,1,0
18,240,240,8,8,0,1,0
7,247,247,12,4,8,3,2
22,248,248,9,9,0,1,0
1,350,350,40,40,0,1,0
26,388,388,18,3,15,2,1
23,407,407,126,15,111,4,3
5,424,424,10,10,0,1,0
27,428,428,27,27,0,1,0
4,438,438,69,60,9,4,3
0,449,449,70,16,54,4,3
14,467,467,42,18,24,2,1
16,473,473,2,2,0,1,0
10,488,488,42,42,0,1,0
19,495,495,36,22,14,2,1

3,115,115,44,44,0,1,0
2,132,132,5,5,0,1,0
16,134,134,12,12,0,1,0
18,139,139,13,5,8,3,2
20,157,157,1,1,0,1,0
10,175,175,2,2,0,1,0
1,184,184,11,3,8,2,1
5,204,204,41,41,0,1,0
4,207,207,1,1,0,1,0
0,235,235,19,7,12,3,2
17,302,302,49,16,33,4,3
22,305,305,18,18,0,1,0
11,336,336,5,2,3,2,1
14,368,368,93,57,36,4,3
19,369,369,31,31,0,1,0
7,380,380,40,40,0,1,0
9,397,397,33,12,21,4,3
8,406,406,117,50,67,3,2
13,419,419,8,2,6,2,1
6,437,437,105,17,88,4,3
21,437,437,14,2,12,4,3
12,471,471,170,170,0,1,0
15,486,486,79,79,0,1,0

24,112,112,2,2,0,1,0
15,121,121,22,22,0,1,0
0,129,129,20,20,0,1,0
4,144,144,5,5,0,1,0
26,153,153,14,2,12,3,2
17,153,153,13,8,5,2,1
23,156,156,28,3,25,2,1
29,157,157,25,5,20,3,2
22,163,163,5,5,0,1,0
12,167,167,32,32,0,1,0
19,196,196,98,76,22,3,2
6,200,200,18,18,0,1,0
28,211,211,3,3,0,1,0
10,256,256,30,30,0,1,0
13,271,271,17,17,0,1,0
9,289,289,13,13,0,1,0
7,307,307,61,61,0,1,0
2,308,308,27,15,12,4,3
5,330,330,9,1,8,2,1
20,336,336,6,6,0,1,0
25,336,336,20,20,0,1,0
14,370,370,11,1,10,3,2
8,381,381,7,7,0,1,0
3,391,391,27,27,0,1,0
11,394,394,33,17,16,3,2
18,459,459,28,28,0,1,0
27,482,482,60,60,0,1,0
1,484,484,4,1,3,2,1
21,494,494,7,7,0,1,0
16,497,497,41,11,30,4,3

3,104,104,2,2,0,1,0
10,106,106,6,6,0,1,0
24,130,130,9,9,0,1,0
5,137,137,26,2,24,3,2
26,178,178,19,6,13,2,1
19,178,178,2,2,0,1,0
20,179,179,15,15,0,1,0
27,218,218,40,16,24,3,2
15,239,239,12,12,0,1,0
4,242,242,2,2,0,1,0
22,285,285,49,25,24,4,3
23,289,289,89,89,0,1,0
14,298,298,34,25,9,4,3
6,311,311,25,14,11,3,2
25,331,331,7,7,0,1,0
11,337,337,46,6,40,2,1
0,351,351,89,89,0,1,0
8,372,372,11,11,0,1,0
13,377,377,6,6,0,1,0
2,388,388,154,62,92,3,2
7,393,393,4,4,0,1,0
12,413,413,14,3,11,3,2
16,432,432,18,18,0,1,0
21,438,438,68,29,39,2,1
9,445,445,60,60,0,1,0
1,448,448,16,16,0,1,0
17,490,490,33,17,16,3,2
18,495,495,20,20,0,1,0

11,107,107,10,10,0,1,0
16,110,110,9,9,0,1,0
6,128,128,6,6,0,1,0
7,140,140,4,4,0,1,0
18,143,143,17,5,12,4,3
29,144,144,3,3,0,1,0
13,159,159,5,5,0,1,0
17,166,166,19,19,0,1,0
12,168,168,8,8,0,1,0
9,180,180,5,5,0,1,0
22,191,191,6,6,0,1,0
27,262,262,25,7,18,4,3
26,267,267,20,20,0,1,0
21,279,279,30,30,0,1,0
0,287,287,13,4,9,2,1
2,287,287,31,3,28,2,1
19,294,294,6,6,0,1,0
1,294,294,4,4,0,1,0
15,331,331,45,32,13,2,1
5,362,362,35,4,31,3,2
8,410,410,12,5,7,2,1
3,418,418,12,12,0,1,0
24,432,432,160,160,0,1,0
28,443,443,23,15,8,2,1
10,450,450,192,184,8,3,2
23,469,469,70,11,59,4,3
14,478,478,18,18,0,1,0
25,492,492,5,5,0,1,0
4,497,497,102,78,24,3,2
20,499,499,91,47,44,3,2

19,122,122,12,12,0,1,0
17,154,154,16,5,11,2,1
11,158,158,1,1,0,1,0
14,171,171,109,97,12,4,3
12,197,197,4,4,0,1,0
16,202,202,2,2,0,1,0
3,205,205,14,14,0,1,0
1,212,212,29,29,0,1,0
8,230,230,85,85,0,1,0
18,242,242,20,10,10,2,1
0,251,251,2,2,0,1,0
6,259,259,4,4,0,1,0
9,267,267,4,4,0,1,0
2,267,267,23,2,21,4,3
21,284,284,38,38,0,1,0
4,300,300,103,56,47,2,1
15,316,316,21,2,19,2,1
20,361,361,6,6,0,1,0
24,362,362,21,21,0,1,0
7,395,395,28,8,20,2,1
10,402,402,30,15,15,4,3
5,407,407,87,87,0,1,0
23,412,412,45,45,0,1,0
13,466,466,36,36,0,1,0
22,481,481,2,2,0,1,0

24,130,130,1,1,0,1,0
25,137,137,13,7,6,2,1
23,162,162,11,2,9,4,3
10,163,163,23,11,12,2,1
1,179,179,29,3,26,2,1
9,216,216,24,6,18,2,1
20,218,218,4,4,0,1,0
3,220,220,9,9,0,1,0
8,232,232,35,35,0,1,0
22,240,240,5,5,0,1,0
19,245,245,43,43,0,1,0
13,276,276,2,2,0,1,0
7,278,278,6,3,3,2,1
11,310,310,1,1,0,1,0
18,345,345,69,69,0,1,0
21,349,349,33,33,0,1,0
16,362,362,28,28,0,1,0
4,394,394,144,111,33,4,3
14,406,406,150,54,96,4,3
12,410,410,40,40,0,1,0
17,412,412,36,36,0,1,0
6,420,420,1,1,0,1,0
15,427,427,4,4,0,1,0
0,438,438,52,31,21,2,1
2,441,441,15,15,0,1,0
5,462,462,70,27,43,3,2
26,497,497,98,98,0,1,0

18,118,118,1,1,0,1,0
9,120,120,3,3,0,1,0
21,130,130,8,8,0,1,0
17,130,130,23,12,11,2,1
22,135,135,7,7,0,1,0
10,189,189,3,3,0,1,0
13,210,210,1,1,0,1,0
12,210,210,31,9,22,2,1
5,214,214,27,18,9,2,1
2,259,259,7,7,0,1,0
16,273,273,136,116,20,2,1
1,301,301,17,17,0,1,0
11,310,310,22,22,0,1,0
24,331,331,12,7,5,2,1
3,332,332,24,24,0,1,0
19,335,335,60,42,18,4,3
20,354,354,6,6,0,1,0
25,362,362,8,3,5,2,1
6,409,409,62,62,0,1,0
0,410,410,31,10,21,2,1
4,420,420,84,27,57,4,3
8,431,431,82,64,18,3,2
23,445,445,10,2,8,2,1
26,445,445,61,61,0,1,0
15,459,459,11,11,0,1,0
14,473,473,88,28,60,4,3
7,486,486,119,88,31,4,3

4,101,101,11,11,0,1,0
0,123,123,12,1,11,2,1
31,126,126,14,8,6,3,2
16,134,134,5,1,4,2,1
29,136,136,3,3,0,1,0
17,138,138,1,1,0,1,0
24,146,146,16,3,13,3,2
15,155,155,11,5,6,2,1
11,155,155,4,4,0,1,0
19,161,161,1,1,0,1,0
1,164,164,8,4,4,2,1
21,169,169,19,5,14,3,2
27,186,186,7,4,3,2,1
7,220,220,5,5,0,1,0
6,220,220,32,32,0,1,0
10,251,251,28,6,22,3,2
34,252,252,45,45,0,1,0
12,259,259,1,1,0,1,0
14,265,265,21,18,3,2,1
18,271,271,53,53,0,1,0
23,277,277,5,5,0,1,0
13,286,286,12,12,0,1,0
22,287,287,21,21,0,1,0
20,291,291,14,9,5,2,1
33,308,308,15,15,0,1,0
8,309,309,7,1,6,2,1
32,310,310,87,39,48,4,3
25,338,338,32,32,0,1,0
9,379,379,55,55,0,1,0
3,384,384,9,1,8,2,1
30,419,419,30,30,0,1,0
28,433,433,48,48,0,1,0
5,448,448,11,1,10,2,1
2,464,464,63,63,0,1,0
26,499,499,80,38,42,4,3

22,131,131,4,4,0,1,0
7,137,137,1,1,0,1,0
16,145,145,20,5,15,4,3
1,148,148,11,3,8,3,2
23,179,179,16,4,12,4,3
11,188,188,35,35,0,1,0
17,192,192,5,2,3,2,1
20,199,199,20,20,0,1,0
10,219,219,39,39,0,1,0
15,226,226,1,1,0,1,0
5,261,261,45,11,34,3,2
0,318,318,13,13,0,1,0
3,349,349,78,18,60,4,3
19,356,356,148,130,18,2,1
4,374,374,83,27,56,3,2
13,374,374,18,18,0,1,0
12,389,389,19,19,0,1,0
21,407,407,21,13,8,2,1
18,408,408,33,33,0,1,0
9,447,447,203,71,132,4,3
8,459,459,44,12,32,3,2
6,483,483,1,1,0,1,0
2,486,486,53,26,27,4,3
14,492,492,18,3,15,4,3

14,100,100,9,3,6,2,1
21,117,117,14,14,0,1,0
4,131,131,17,13,4,2,1
19,154,154,27,27,0,1,0
13,155,155,7,1,6,2,1
24,160,160,20,2,18,4,3
25,183,183,10,10,0,1,0
20,185,185,3,3,0,1,0
6,199,199,37,37,0,1,0
23,210,210,9,9,0,1,0
11,210,210,34,34,0,1,0
0,215,215,13,1,12,2,1
1,234,234,14,4,10,2,1
12,257,257,24,9,15,3,2
22,281,281,13,5,8,3,2
7,284,284,4,1,3,2,1
15,296,296,12,12,0,1,0
9,303,303,7,3,4,2,1
3,315,315,21,16,5,2,1
29,319,319,23,23,0,1,0
18,321,321,60,52,8,3,2
26,325,325,21,21,0,1,0
30,333,333,7,7,0,1,0
16,349,349,14,7,7,2,1
10,361,361,57,57,0,1,0
2,376,376,15,15,0,1,0
28,379,379,20,6,14,3,2
5,410,410,49,49,0,1,0
8,422,422,14,11,3,2,1
27,431,431,85,66,19,2,1
31,445,445,112,12,100,3,2
17,480,480,19,9,10,3,2

28,104,104,8,8,0,1,0
13,118,118,1,1,0,1,0
2,121,121,20,20,0,1,0
26,136,136,40,22,18,2,1
12,139,139,10,2,8,3,2
9,149,149,31,17,14,2,1
27,175,175,13,13,0,1,0
1,178,178,1,1,0,1,0
18,178,178,18,8,10,2,1
16,198,198,33,9,24,4,3
22,200,200,8,4,4,2,1
0,208,208,6,6,0,1,0
4,224,224,1,1,0,1,0
11,229,229,15,12,3,2,1
24,237,237,22,22,0,1,0
19,243,243,3,3,0,1,0
14,294,294,1,1,0,1,0
8,308,308,17,17,0,1,0
33,320,320,48,48,0,1,0
29,326,326,37,13,24,2,1
32,330,330,3,3,0,1,0
23,354,354,28,28,0,1,0
6,354,354,16,4,12,3,2
21,356,356,22,1,21,4,3
25,370,370,2,2,0,1,0
3,387,387,4,1,3,2,1
15,388,388,47,47,0,1,0
30,398,398,88,54,34,3,2
17,402,402,34,34,0,1,0
10,470,470,7,1,6,3,2
7,477,477,2,2,0,1,0
31,478,478,83,36,47,2,1
5,480,480,107,89,18,2,1
20,500,500,24,9,15,4,3

6,108,108,1,1,0,1,0
5,109,109,10,10,0,1,0
17,146,146,13,13,0,1,0
7,162,162,26,26,0,1,0
9,164,164,11,11,0,1,0
8,179,179,9,1,8,2,1
10,179,179,7,7,0,1,0
4,201,201,60,14,46,2,1
1,239,239,5,5,0,1,0
21,247,247,34,34,0,1,0
25,252,252,9,9,0,1,0
15,271,271,62,62,0,1,0
23,283,283,31,31,0,1,0
11,288,288,18,18,0,1,0
19,291,291,18,2,16,4,3
22,314,314,8,8,0,1,0
2,339,339,83,39,44,3,2
0,345,345,47,47,0,1,0
12,368,368,5,1,4,2,1
18,371,371,140,129,11,2,1
14,390,390,28,1,27,3,2
16,391,391,37,37,0,1,0
13,457,457,71,50,21,2,1
20,464,464,1,1,0,1,0
3,470,470,103,51,52,4,3
24,471,471,9,1,8,2,1

20,104,104,26,14,12,2,1
16,123,123,9,3,6,3,2
22,145,145,45,45,0,1,0
23,163,163,30,8,22,2,1
3,179,179,35,17,18,3,2
13,216,216,18,18,0,1,0
11,229,229,15,15,0,1,0
10,273,273,51,33,18,2,1
4,282,282,19,6,13,2,1
9,295,295,33,2,31,4,3
8,302,302,64,31,33,4,3
2,302,302,10,10,0,1,0
0,310,310,18,18,0,1,0
1,339,339,49,49,0,1,0
17,344,344,1,1,0,1,0
21,350,350,44,10,34,3,2
5,364,364,42,42,0,1,0
24,370,370,13,5,8,3,2
15,389,389,9,9,0,1,0
18,401,401,17,8,9,2,1
6,418,418,26,1,25,2,1
14,449,449,4,4,0,1,0
7,452,452,98,98,0,1,0
12,490,490,101,50,51,4,3
19,493,493,8,5,3,2,1

13,110,110,1,1,0,1,0
7,141,141,8,8,0,1,0
31,145,145,17,17,0,1,0
18,155,155,5,5,0,1,0
29,159,159,28,4,24,3,2
3,184,184,5,5,0,1,0
17,185,185,28,28,0,1,0
4,189,189,9,3,6,3,2
12,216,216,12,12,0,1,0
9,221,221,28,28,0,1,0
28,222,222,8,3,5,2,1
10,231,231,33,14,19,2,1
0,237,237,1,1,0,1,0
15,268,268,2,2,0,1,0
8,269,269,11,11,0,1,0
1,294,294,17,9,8,3,2
22,318,318,75,75,0,1,0
33,341,341,12,12,0,1,0
2,358,358,38,4,34,4,3
30,366,366,24,24,0,1,0
21,401,401,5,5,0,1,0
26,404,404,90,90,0,1,0
5,404,404,41,41,0,1,0
24,416,416,84,84,0,1,0
16,416,416,90,6,84,4,3
19,417,417,29,29,0,1,0
20,439,439,10,10,0,1,0
25,447,447,53,53,0,1,0
27,453,453,9,9,0,1,0
11,457,457,21,8,13,2,1
32,460,460,31,31,0,1,0
23,474,474,47,7,40,2,1
6,479,479,24,24,0,1,0
14,480,480,25,13,12,3,2

20,103,103,2,2,0,1,0
1,126,126,1,1,0,1,0
26,135,135,7,7,0,1,0
8,136,136,30,30,0,1,0
5,143,143,2,2,0,1,0
17,221,221,13,7,6,3,2
12,225,225,1,1,0,1,0
11,228,228,16,6,10,4,3
16,232,232,46,46,0,1,0
9,261,261,33,11,22,2,1
19,298,298,116,110,6,3,2
14,300,300,3,3,0,1,0
4,335,335,49,49,0,1,0
2,364,364,6,6,0,1,0
13,369,369,3,3,0,1,0
22,376,376,93,1,92,4,3
25,380,380,10,7,3,2,1
3,419,419,54,8,46,2,1
7,423,423,83,17,66,4,3
0,437,437,40,40,0,1,0
6,438,438,106,81,25,2,1
18,441,441,14,8,6,2,1
24,445,445,14,10,4,2,1
21,449,449,26,5,21,4,3
23,460,460,95,8,87,4,3
10,476,476,65,35,30,4,3
15,488,488,42,25,17,2,1

37,120,120,2,2,0,1,0
8,122,122,3,3,0,1,0
33,133,133,36,20,16,2,1
14,140,140,1,1,0,1,0
13,146,146,18,18,0,1,0
28,149,149,5,5,0,1,0
17,161,161,12,6,6,2,1
2,168,168,1,1,0,1,0
25,179,179,20,20,0,1,0
1,196,196,20,20,0,1,0
16,200,200,18,18,0,1,0
30,201,201,15,2,13,2,1
22,204,204,5,1,4,2,1
21,215,215,2,2,0,1,0
34,230,230,35,35,0,1,0
32,231,231,27,15,12,4,3
15,249,249,31,27,4,2,1
3,256,256,10,10,0,1,0
27,258,258,62,62,0,1,0
4,268,268,6,3,3,2,1
18,287,287,2,2,0,1,0
5,298,298,18,18,0,1,0
31,325,325,1,1,0,1,0
35,338,338,19,5,14,3,2
20,348,348,7,2,5,2,1
23,353,353,23,12,11,2,1
7,358,358,1,1,0,1,0
9,406,406,12,12,0,1,0
11,425,425,36,16,20,2,1
19,435,435,2,2,0,1,0
12,436,436,66,24,42,3,2
36,436,436,48,4,44,4,3
10,440,440,38,38,0,1,0
0,450,450,77,20,57,3,2
29,458,458,20,20,0,1,0
6,468,468,33,33,0,1,0
26,470,470,47,47,0,1,0
24,473,473,46,46,0,1,0

5,145,145,13,13,0,1,0
7,146,146,2,2,0,1,0
21,199,199,4,4,0,1,0
24,217,217,16,7,9,4,3
13,223,223,2,2,0,1,0
12,226,226,86,70,16,2,1
25,254,254,11,11,0,1,0
11,256,256,31,16,15,3,2
1,270,270,1,1,0,1,0
17,270,270,28,28,0,1,0
10,272,272,4,4,0,1,0
22,282,282,34,34,0,1,0
26,288,288,5,2,3,2,1
18,317,317,53,53,0,1,0
20,321,321,19,15,4,2,1
23,323,323,43,43,0,1,0
19,334,334,153,102,51,4,3
0,351,351,82,51,31,3,2
16,361,361,2,2,0,1,0
8,376,376,32,32,0,1,0
6,388,388,57,50,7,2,1
4,388,388,9,1,8,2,1
14,394,394,31,31,0,1,0
2,407,407,85,85,0,1,0
3,432,432,3,3,0,1,0
9,462,462,35,35,0,1,0
15,463,463,62,62,0,1,0

1,105,105,3,3,0,1,0
18,112,112,2,2,0,1,0
9,114,114,11,3,8,2,1
16,118,118,5,5,0,1,0
21,166,166,4,4,0,1,0
7,174,174,3,3,0,1,0
23,232,232,5,5,0,1,0
22,233,233,72,56,16,3,2
10,238,238,13,13,0,1,0
12,249,249,7,7,0,1,0
14,258,258,138,76,62,4,3
11,273,273,11,11,0,1,0
26,280,280,7,7,0,1,0
8,294,294,4,1,3,2,1
27,297,297,76,76,0,1,0
4,300,300,28,28,0,1,0
24,305,305,13,13,0,1,0
19,322,322,60,16,44,3,2
25,389,389,12,12,0,1,0
0,412,412,1,1,0,1,0
2,420,420,1,1,0,1,0
13,431,431,32,32,0,1,0
6,433,433,58,58,0,1,0
20,440,440,33,7,26,4,3
5,446,446,117,74,43,4,3
28,464,464,32,22,10,2,1
15,471,471,123,123,0,1,0
17,482,482,33,27,6,2,1
3,496,496,10,10,0,1,0

8,107,107,30,16,14,2,1
5,107,107,1,1,0,1,0
24,108,108,5,2,3,2,1
31,110,110,4,4,0,1,0
29,116,116,7,4,3,2,1
7,170,170,27,27,0,1,0
16,176,176,11,5,6,2,1
12,189,189,18,18,0,1,0
27,193,193,51,24,27,4,3
30,199,199,46,4,42,2,1
13,222,222,19,19,0,1,0
11,234,234,38,38,0,1,0
14,234,234,16,16,0,1,0
15,241,241,9,4,5,2,1
0,283,283,16,12,4,2,1
2,289,289,1,1,0,1,0
10,322,322,11,11,0,1,0
28,328,328,43,43,0,1,0
20,330,330,93,42,51,4,3
19,332,332,6,1,5,2,1
25,345,345,19,19,0,1,0
21,365,365,44,16,28,2,1
3,373,373,4,4,0,1,0
6,378,378,17,9,8,3,2
1,414,414,48,6,42,2,1
4,415,415,4,4,0,1,0
17,425,425,2,2,0,1,0
18,428,428,72,72,0,1,0
26,440,440,9,9,0,1,0
22,460,460,1,1,0,1,0
9,474,474,76,32,44,2,1
23,493,493,2,2,0,1,0

27,119,119,2,2,0,1,0
15,131,131,17,3,14,2,1
13,158,158,10,10,0,1,0
28,181,181,2,2,0,1,0
0,189,189,1,1,0,1,0
8,210,210,8,8,0,1,0
25,234,234,19,9,10,3,2
21,239,239,8,8,0,1,0
20,240,240,34,10,24,2,1
3,248,248,32,14,18,3,2
17,256,256,122,122,0,1,0
9,272,272,27,3,24,4,3
10,275,275,58,58,0,1,0
12,281,281,25,2,23,2,1
19,304,304,10,1,9,2,1
5,314,314,9,2,7,2,1
22,327,327,19,5,14,2,1
4,346,346,42,16,26,3,2
2,373,373,75,12,63,4,3
1,389,389,3,3,0,1,0
16,397,397,22,22,0,1,0
18,399,399,53,35,18,3,2
26,400,400,14,10,4,2,1
14,458,458,36,8,28,2,1
11,462,462,23,23,0,1,0
6,487,487,106,12,94,3,2
23,491,491,75,75,0,1,0
7,498,498,31,15,16,3,2
24,500,500,33,33,0,1,0

18,116,116,7,7,0,1,0
20,118,118,7,7,0,1,0
0,146,146,1,1,0,1,0
24,151,151,50,50,0,1,0
3,156,156,8,8,0,1,0
19,158,158,13,4,9,4,3
17,167,167,2,2,0,1,0
6,169,169,22,22,0,1,0
27,174,174,1,1,0,1,0
2,177,177,6,3,3,2,1
13,178,178,10,10,0,1,0
8,202,202,73,73,0,1,0
11,205,205,7,7,0,1,0
12,236,236,4,1,3,2,1
4,237,237,24,24,0,1,0
23,245,245,11,2,9,4,3
7,253,253,27,23,4,2,1
28,256,256,24,7,17,4,3
26,274,274,11,11,0,1,0
21,281,281,25,25,0,1,0
5,303,303,63,33,30,4,3
14,304,304,32,24,8,3,2
15,326,326,147,87,60,4,3
10,408,408,24,12,12,2,1
1,443,443,9,1,8,2,1
16,447,447,12,4,8,3,2
9,484,484,54,54,0,1,0
25,484,484,7,7,0,1,0
22,499,499,59,59,0,1,0

21,143,143,4,1,3,2,1
9,150,150,23,23,0,1,0
25,163,163,7,7,0,1,0
14,164,164,29,21,8,3,2
8,173,173,14,14,0,1,0
29,176,176,26,6,20,4,3
10,190,190,6,6,0,1,0
31,200,200,33,33,0,1,0
20,206,206,15,10,5,2,1
3,213,213,35,23,12,2,1
26,223,223,48,14,34,2,1
6,225,225,33,33,0,1,0
15,248,248,9,9,0,1,0
5,258,258,4,4,0,1,0
12,262,262,45,45,0,1,0
17,263,263,10,4,6,3,2
0,267,267,11,11,0,1,0
27,269,269,42,33,9,2,1
28,277,277,29,29,0,1,0
4,278,278,3,3,0,1,0
18,290,290,22,7,15,3,2
2,344,344,7,7,0,1,0
7,367,367,1,1,0,1,0
16,394,394,3,3,0,1,0
1,398,398,11,11,0,1,0
23,407,407,68,50,18,3,2
22,423,423,2,2,0,1,0
30,426,426,50,8,42,2,1
24,428,428,31,8,23,2,1
19,435,435,21,4,17,2,1
11,456,456,38,2,36,3,2
13,459,459,88,79,9,2,1

17,110,110,12,4,8,3,2
25,135,135,2,2,0,1,0
19,157,157,14,14,0,1,0
14,181,181,23,23,0,1,0
13,193,193,29,29,0,1,0
18,224,224,6,6,0,1,0
0,229,229,10,7,3,2,1
5,242,242,54,54,0,1,0
15,257,257,35,27,8,2,1
12,267,267,6,2,4,2,1
16,282,282,6,6,0,1,0
2,288,288,65,65,0,1,0
1,294,294,95,59,36,2,1
22,303,303,11,1,10,3,2
8,311,311,6,2,4,2,1
7,325,325,26,26,0,1,0
4,336,336,78,78,0,1,0
24,359,359,73,73,0,1,0
10,400,400,4,4,0,1,0
9,403,403,3,3,0,1,0
20,407,407,110,56,54,3,2
26,407,407,14,14,0,1,0
6,414,414,7,4,3,2,1
3,426,426,27,18,9,2,1
11,451,451,60,60,0,1,0
23,455,455,68,68,0,1,0
21,476,476,31,21,10,2,1

18,103,103,5,5,0,1,0
28,109,109,43,43,0,1,0
10,145,145,1,1,0,1,0
14,150,150,34,1,33,4,3
3,152,152,1,1,0,1,0
27,153,153,8,3,5,2,1
5,184,184,35,35,0,1,0
19,195,195,14,1,13,2,1
25,207,207,7,7,0,1,0
21,207,207,15,15,0,1,0
24,245,245,29,21,8,2,1
11,308,308,12,6,6,2,1
2,317,317,6,1,5,2,1
15,318,318,14,2,12,4,3
0,324,324,34,26,8,2,1
6,342,342,2,2,0,1,0
8,344,344,39,39,0,1,0
1,357,357,57,57,0,1,0
20,364,364,23,1,22,3,2
9,365,365,66,58,8,3,2
17,370,370,54,22,32,4,3
16,379,379,58,42,16,2,1
7,422,422,62,23,39,3,2
12,424,424,28,10,18,3,2
23,428,428,64,64,0,1,0
13,429,429,14,14,0,1,0
4,431,431,44,44,0,1,0
22,465,465,2,2,0,1,0
26,482,482,37,37,0,1,0

14,111,111,1,1,0,1,0
38,131,131,1,1,0,1,0
3,132,132,6,6,0,1,0
16,137,137,1,1,0,1,0
18,141,141,2,2,0,1,0
32,144,144,13,13,0,1,0
35,146,146,7,7,0,1,0
22,154,154,17,4,13,2,1
7,192,192,18,8,10,2,1
1,200,200,28,11,17,2,1
4,213,213,5,5,0,1,0
25,222,222,10,2,8,2,1
34,224,224,5,1,4,2,1
15,241,241,1,1,0,1,0
10,242,242,22,8,14,4,3
24,247,247,19,19,0,1,0
8,268,268,18,4,14,2,1
19,269,269,48,10,38,3,2
13,275,275,8,8,0,1,0
31,276,276,17,8,9,4,3
29,281,281,10,10,0,1,0
2,291,291,25,25,0,1,0
27,309,309,24,10,14,3,2
9,322,322,14,14,0,1,0
21,342,342,8,8,0,1,0
23,348,348,28,4,24,3,2
37,359,359,27,12,15,4,3
26,381,381,183,116,67,3,2
12,391,391,8,5,3,2,1
5,397,397,22,3,19,2,1
28,402,402,77,77,0,1,0
33,407,407,111,6,105,4,3
30,420,420,7,1,6,3,2
20,438,438,2,2,0,1,0
6,442,442,58,43,15,4,3
36,453,453,2,2,0,1,0
11,480,480,17,5,12,2,1
0,483,483,12,12,0,1,0
17,486,486,4,4,0,1,0

4,117,117,1,1,0,1,0
7,125,125,15,15,0,1,0
18,157,157,14,6,8,3,2
13,167,167,10,7,3,2,1
23,179,179,9,9,0,1,0
8,181,181,3,3,0,1,0
20,195,195,19,10,9,2,1
6,205,205,27,27,0,1,0
2,207,207,29,29,0,1,0
19,216,216,25,25,0,1,0
24,238,238,86,86,0,1,0
15,245,245,20,20,0,1,0
1,255,255,3,3,0,1,0
17,292,292,15,6,9,2,1
22,339,339,31,31,0,1,0
16,341,341,23,23,0,1,0
0,370,370,15,15,0,1,0
14,373,373,26,26,0,1,0
5,378,378,117,53,64,4,3
11,383,383,8,3,5,2,1
25,414,414,88,76,12,3,2
3,417,417,128,128,0,1,0
12,432,432,22,4,18,3,2
9,437,437,19,19,0,1,0
10,488,488,122,122,0,1,0
21,491,491,16,16,0,1,0

21,149,149,7,4,3,2,1
16,150,150,6,6,0,1,0
13,164,164,29,29,0,1,0
0,193,193,1,1,0,1,0
9,207,207,26,11,15,4,3
25,207,207,22,22,0,1,0
7,208,208,10,10,0,1,0
10,210,210,92,92,0,1,0
18,212,212,7,4,3,2,1
15,218,218,14,4,10,2,1
12,248,248,27,27,0,1,0
14,276,276,28,28,0,1,0
3,304,304,11,8,3,2,1
5,312,312,15,1,14,2,1
19,348,348,96,96,0,1,0
11,363,363,8,3,5,2,1
26,378,378,23,3,20,3,2
2,387,387,102,15,87,4,3
17,399,399,62,62,0,1,0
6,409,409,1,1,0,1,0
22,437,437,112,24,88,4,3
24,456,456,25,25,0,1,0
1,463,463,12,12,0,1,0
23,466,466,13,13,0,1,0
8,478,478,115,68,47,2,1
20,478,478,15,7,8,3,2
4,496,496,19,19,0,1,0

32,100,100,24,24,0,1,0
12,108,108,6,6,0,1,0
33,117,117,9,9,0,1,0
7,118,118,15,2,13,2,1
31,128,128,15,2,13,2,1
21,154,154,38,26,12,4,3
17,162,162,45,9,36,4,3
29,163,163,10,10,0,1,0
6,205,205,1,1,0,1,0
13,225,225,35,1,34,2,1
27,242,242,15,15,0,1,0
25,245,245,17,11,6,2,1
11,250,250,1,1,0,1,0
28,268,268,8,8,0,1,0
15,274,274,13,3,10,2,1
24,275,275,4,4,0,1,0
20,275,275,1,1,0,1,0
2,289,289,5,5,0,1,0
5,316,316,10,10,0,1,0
8,319,319,8,8,0,1,0
26,328,328,78,78,0,1,0
22,340,340,32,12,20,3,2
19,379,379,7,7,0,1,0
0,382,382,1,1,0,1,0
10,385,385,30,30,0,1,0
3,402,402,29,29,0,1,0
4,410,410,21,21,0,1,0
23,415,415,18,18,0,1,0
14,426,426,62,62,0,1,0
1,440,440,48,2,46,2,1
18,449,449,3,3,0,1,0
30,461,461,24,17,7,2,1
9,467,467,55,29,26,2,1
34,469,469,37,37,0,1,0
16,471,471,23,23,0,1,0

7,118,118,3,3,0,1,0
4,163,163,8,8,0,1,0
22,205,205,31,16,15,4,3
11,208,208,13,4,9,2,1
23,241,241,10,4,6,2,1
19,268,268,18,18,0,1,0
5,283,283,18,4,14,2,1
14,297,297,22,22,0,1,0
0,303,303,78,78,0,1,0
10,309,309,1,1,0,1,0
18,363,363,25,9,16,4,3
3,366,366,70,58,12,2,1
2,377,377,35,35,0,1,0
24,381,381,85,85,0,1,0
15,387,387,31,23,8,2,1
17,388,388,14,8,6,2,1
1,388,388,8,8,0,1,0
20,392,392,17,3,14,3,2
21,409,409,37,21,16,2,1
6,412,412,143,130,13,4,3
13,467,467,84,84,0,1,0
8,467,467,115,77,38,3,2
25,468,468,98,93,5,2,1
12,472,472,72,72,0,1,0
9,486,486,22,1,21,4,3
16,496,496,3,3,0,1,0

1,111,111,5,1,4,2,1
6,118,118,1,1,0,1,0
4,119,119,3,3,0,1,0
23,124,124,3,3,0,1,0
13,149,149,9,9,0,1,0
18,157,157,26,26,0,1,0
21,174,174,22,3,19,4,3
19,176,176,10,10,0,1,0
17,178,178,7,7,0,1,0
5,179,179,7,7,0,1,0
28,194,194,50,38,12,2,1
14,208,208,50,50,0,1,0
25,213,213,22,22,0,1,0
11,220,220,16,6,10,3,2
22,262,262,47,47,0,1,0
7,270,270,66,66,0,1,0
12,280,280,62,47,15,2,1
20,294,294,4,1,3,2,1
27,346,346,66,66,0,1,0
0,394,394,12,12,0,1,0
16,395,395,10,10,0,1,0
3,408,408,33,24,9,4,3
2,411,411,21,1,20,3,2
9,423,423,5,5,0,1,0
24,435,435,31,31,0,1,0
15,444,444,31,31,0,1,0
10,455,455,79,79,0,1,0
8,469,469,45,45,0,1,0
26,483,483,55,55,0,1,0

22,115,115,3,3,0,1,0
17,128,128,10,10,0,1,0
7,139,139,14,14,0,1,0
0,141,141,19,1,18,4,3
26,149,149,9,9,0,1,0
2,161,161,4,4,0,1,0
15,168,168,3,3,0,1,0
14,205,205,13,13,0,1,0
23,251,251,27,27,0,1,0
10,260,260,33,21,12,3,2
3,295,295,14,14,0,1,0
8,300,300,57,27,30,4,3
24,304,304,51,51,0,1,0
16,310,310,29,1,28,3,2
18,325,325,135,97,38,3,2
9,330,330,63,55,8,2,1
19,352,352,3,3,0,1,0
1,371,371,46,6,40,2,1
4,372,372,46,46,0,1,0
21,380,380,51,13,38,2,1
6,399,399,73,32,41,4,3
11,414,414,7,7,0,1,0
12,422,422,3,3,0,1,0
5,427,427,56,33,23,2,1
25,445,445,18,18,0,1,0
13,473,473,56,35,21,2,1
20,496,496,53,53,0,1,0

2,104,104,4,4,0,1,0
24,112,112,10,10,0,1,0
18,112,112,15,15,0,1,0
8,136,136,1,1,0,1,0
7,195,195,17,17,0,1,0
15,204,204,1,1,0,1,0
5,224,224,84,38,46,2,1
17,247,247,1,1,0,1,0
1,255,255,50,21,29,2,1
9,283,283,37,37,0,1,0
3,293,293,18,18,0,1,0
25,342,342,9,9,0,1,0
22,357,357,12,12,0,1,0
0,364,364,28,10,18,2,1
27,366,366,46,24,22,2,1
23,397,397,23,23,0,1,0
10,402,402,45,3,42,2,1
13,425,425,17,4,13,4,3
14,428,428,23,11,12,4,3
26,438,438,40,31,9,2,1
12,450,450,9,3,6,2,1
11,456,456,66,66,0,1,0
20,459,459,8,8,0,1,0
4,464,464,36,36,0,1,0
21,465,465,88,74,14,2,1
16,496,496,154,123,31,2,1
6,497,497,17,7,10,3,2
19,499,499,141,65,76,4,3

13,111,111,8,8,0,1,0
7,136,136,1,1,0,1,0
10,139,139,1,1,0,1,0
9,140,140,25,2,23,2,1
23,140,140,39,39,0,1,0
4,153,153,1,1,0,1,0
27,156,156,11,11,0,1,0
3,195,195,7,7,0,1,0
16,206,206,7,1,6,2,1
20,229,229,26,20,6,3,2
26,233,233,35,35,0,1,0
22,255,255,9,9,0,1,0
14,256,256,36,15,21,4,3
30,256,256,13,1,12,4,3
19,264,264,2,2,0,1,0
8,280,280,2,2,0,1,0
18,291,291,1,1,0,1,0
15,357,357,20,1,19,2,1
29,362,362,38,9,29,2,1
5,405,405,17,17,0,1,0
2,408,408,45,30,15,3,2
28,409,409,109,95,14,2,1
21,425,425,10,10,0,1,0
1,440,440,31,31,0,1,0
24,448,448,14,4,10,3,2
6,452,452,27,18,9,4,3
25,455,455,32,24,8,3,2
17,465,465,48,12,36,2,1
12,477,477,26,26,0,1,0
11,482,482,75,2,73,4,3
31,488,488,109,109,0,1,0
0,500,500,130,28,102,4,3

2,120,120,17,3,14,2,1
14,121,121,5,2,3,2,1
6,177,177,2,2,0,1,0
30,198,198,6,1,5,2,1
23,202,202,45,45,0,1,0
20,253,253,24,24,0,1,0
4,270,270,4,4,0,1,0
15,290,290,8,2,6,2,1
3,292,292,12,12,0,1,0
22,308,308,41,41,0,1,0
17,316,316,18,9,9,4,3
21,333,333,37,37,0,1,0
5,334,334,5,5,0,1,0
32,338,338,80,80,0,1,0
11,345,345,46,46,0,1,0
0,347,347,18,6,12,2,1
29,349,349,12,2,10,2,1
19,354,354,60,22,38,3,2
13,359,359,3,3,0,1,0
1,372,372,35,23,12,2,1
7,383,383,9,9,0,1,0
12,385,385,112,46,66,3,2
24,393,393,16,6,10,3,2
18,429,429,19,9,10,3,2
9,440,440,5,5,0,1,0
28,441,441,12,12,0,1,0
8,472,472,25,25,0,1,0
27,473,473,78,78,0,1,0
25,482,482,51,36,15,2,1
10,489,489,74,20,54,3,2
31,491,491,13,13,0,1,0
26,495,495,10,6,4,2,1
16,499,499,94,94,0,1,0

9,131,131,2,2,0,1,0
12,146,146,3,3,0,1,0
27,156,156,6,6,0,1,0
23,157,157,3,3,0,1,0
4,201,201,17,11,6,2,1
29,227,227,20,20,0,1,0
6,241,241,60,27,33,4,3
19,278,278,63,37,26,3,2
10,305,305,23,3,20,2,1
20,305,305,71,71,0,1,0
28,312,312,27,27,0,1,0
13,314,314,5,1,4,2,1
25,327,327,20,20,0,1,0
18,330,330,66,66,0,1,0
1,337,337,1,1,0,1,0
5,359,359,52,9,43,2,1
14,360,360,15,7,8,2,1
7,382,382,45,21,24,4,3
21,384,384,47,47,0,1,0
26,390,390,9,4,5,2,1
3,403,403,71,71,0,1,0
2,412,412,40,16,24,4,3
17,416,416,65,14,51,4,3
8,436,436,51,51,0,1,0
15,448,448,14,14,0,1,0
24,479,479,17,17,0,1,0
16,480,480,35,9,26,3,2
22,493,493,30,8,22,3,2
11,494,494,55,55,0,1,0
0,495,495,50,20,30,3,2

22,108,108,1,1,0,1,0
41,108,108,53,53,0,1,0
33,110,110,7,7,0,1,0
40,123,123,21,21,0,1,0
8,126,126,10,2,8,2,1
9,145,145,6,6,0,1,0
19,167,167,4,4,0,1,0
17,178,178,4,4,0,1,0
29,178,178,3,3,0,1,0
39,184,184,7,7,0,1,0
1,185,185,6,6,0,1,0
5,209,209,26,2,24,4,3
34,214,214,15,15,0,1,0
35,214,214,25,11,14,3,2
32,217,217,35,21,14,3,2
13,253,253,1,1,0,1,0
10,254,254,2,2,0,1,0
30,257,257,2,2,0,1,0
4,270,270,19,19,0,1,0
14,275,275,30,8,22,3,2
25,288,288,12,5,7,2,1
20,314,314,6,6,0,1,0
12,317,317,2,2,0,1,0
11,318,318,30,22,8,2,1
7,327,327,46,46,0,1,0
21,338,338,3,3,0,1,0
15,339,339,2,2,0,1,0
31,342,342,2,2,0,1,0
6,348,348,19,11,8,3,2
16,349,349,17,17,0,1,0
2,356,356,29,29,0,1,0
37,370,370,7,2,5,2,1
3,372,372,15,8,7,2,1
26,388,388,6,1,5,2,1
36,407,407,69,69,0,1,0
38,416,416,11,3,8,3,2
0,443,443,9,4,5,2,1
24,445,445,31,14,17,2,1
28,450,450,4,4,0,1,0
42,458,458,39,39,0,1,0
23,461,461,35,26,9,2,1
27,465,465,17,17,0,1,0
18,492,492,53,26,27,4,3

12,115,115,4,4,0,1,0
23,149,149,3,3,0,1,0
16,152,152,21,21,0,1,0
24,223,223,17,17,0,1,0
5,235,235,1,1,0,1,0
20,243,243,67,67,0,1,0
7,247,247,7,7,0,1,0
13,250,250,84,20,64,4,3
14,259,259,5,5,0,1,0
25,265,265,36,36,0,1,0
26,272,272,12,2,10,2,1
0,300,300,38,38,0,1,0
10,346,346,93,54,39,4,3
9,360,360,33,17,16,2,1
21,363,363,60,51,9,2,1
19,367,367,2,2,0,1,0
17,371,371,41,41,0,1,0
1,372,372,7,7,0,1,0
8,380,380,1,1,0,1,0
15,394,394,29,21,8,3,2
6,402,402,18,18,0,1,0
18,406,406,2,2,0,1,0
27,440,440,137,109,28,2,1
4,440,440,2,2,0,1,0
3,446,446,12,12,0,1,0
28,447,447,28,10,18,4,3
22,447,447,1,1,0,1,0
2,458,458,162,68,94,4,3
11,487,487,20,20,0,1,0

20,103,103,2,2,0,1,0
23,111,111,20,10,10,2,1
19,114,114,12,4,8,3,2
10,146,146,15,11,4,2,1
25,179,179,16,16,0,1,0
18,189,189,23,17,6,3,2
9,192,192,21,6,15,2,1
13,197,197,49,49,0,1,0
15,245,245,15,6,9,4,3
2,269,269,5,5,0,1,0
29,276,276,32,32,0,1,0
28,277,277,50,50,0,1,0
17,293,293,4,4,0,1,0
14,295,295,44,20,24,2,1
7,298,298,59,20,39,4,3
27,301,301,40,40,0,1,0
1,303,303,5,2,3,2,1
4,350,350,16,4,12,4,3
24,358,358,2,2,0,1,0
0,367,367,78,78,0,1,0
6,379,379,5,5,0,1,0
12,380,380,4,4,0,1,0
3,393,393,21,9,12,2,1
26,401,401,98,98,0,1,0
5,454,454,32,32,0,1,0
11,462,462,1,1,0,1,0
21,479,479,24,12,12,2,1
16,491,491,3,3,0,1,0
22,495,495,81,73,8,2,1
8,497,497,45,45,0,1,0

26,103,103,5,5,0,1,0
12,105,105,19,1,18,4,3
2,142,142,9,9,0,1,0
10,145,145,18,18,0,1,0
17,146,146,10,10,0,1,0
8,159,159,14,3,11,2,1
23,165,165,7,7,0,1,0
7,184,184,16,8,8,2,1
1,214,214,1,1,0,1,0
5,251,251,55,55,0,1,0
16,260,260,53,23,30,4,3
15,268,268,4,4,0,1,0
9,277,277,8,2,6,2,1
20,330,330,31,31,0,1,0
21,342,342,123,99,24,4,3
24,368,368,7,7,0,1,0
18,369,369,44,44,0,1,0
14,394,394,38,3,35,4,3
13,412,412,138,108,30,2,1
3,412,412,42,42,0,1,0
0,438,438,11,1,10,2,1
6,448,448,7,2,5,2,1
11,458,458,53,5,48,2,1
22,462,462,62,17,45,4,3
25,462,462,45,45,0,1,0
27,464,464,55,55,0,1,0
19,476,476,5,5,0,1,0
4,494,494,6,6,0,1,0

21,127,127,57,57,0,1,0
23,133,133,8,8,0,1,0
13,153,153,1,1,0,1,0
24,171,171,6,6,0,1,0
16,172,172,7,7,0,1,0
9,185,185,4,4,0,1,0
17,188,188,36,26,10,3,2
4,220,220,4,4,0,1,0
10,229,229,29,8,21,4,3
18,237,237,24,7,17,2,1
20,262,262,1,1,0,1,0
3,278,278,83,83,0,1,0
25,293,293,22,10,12,4,3
22,298,298,2,2,0,1,0
11,298,298,85,85,0,1,0
2,312,312,26,2,24,4,3
19,333,333,52,52,0,1,0
14,352,352,30,30,0,1,0
0,372,372,8,4,4,2,1
5,413,413,128,40,88,3,2
8,419,419,14,7,7,2,1
7,439,439,52,44,8,2,1
6,450,450,24,3,21,4,3
12,478,478,91,49,42,4,3
1,487,487,16,16,0,1,0
15,490,490,17,17,0,1,0

20,107,107,17,17,0,1,0
3,113,113,7,7,0,1,0
15,125,125,28,11,17,3,2
5,141,141,4,4,0,1,0
17,147,147,1,1,0,1,0
25,181,181,10,10,0,1,0
4,190,190,34,12,22,2,1
9,199,199,22,22,0,1,0
23,200,200,51,30,21,4,3
8,206,206,24,1,23,2,1
24,220,220,24,18,6,3,2
0,228,228,30,30,0,1,0
12,232,232,26,18,8,2,1
21,252,252,2,2,0,1,0
14,257,257,10,10,0,1,0
2,264,264,11,1,10,3,2
19,287,287,1,1,0,1,0
16,305,305,22,2,20,3,2
1,328,328,5,5,0,1,0
13,329,329,2,2,0,1,0
6,333,333,87,50,37,2,1
26,333,333,85,41,44,2,1
10,356,356,86,86,0,1,0
22,372,372,38,38,0,1,0
7,384,384,11,11,0,1,0
11,406,406,30,30,0,1,0
18,455,455,62,62,0,1,0

4,102,102,1,1,0,1,0
9,115,115,4,4,0,1,0
23,135,135,22,7,15,4,3
15,162,162,9,5,4,2,1
25,179,179,67,5,62,3,2
3,230,230,55,55,0,1,0
19,235,235,33,33,0,1,0
14,235,235,46,43,3,2,1
12,242,242,16,5,11,2,1
20,254,254,5,5,0,1,0
13,276,276,23,12,11,4,3
6,278,278,18,18,0,1,0
8,304,304,73,73,0,1,0
26,307,307,37,37,0,1,0
11,322,322,42,42,0,1,0
18,324,324,39,31,8,2,1
2,362,362,36,36,0,1,0
10,366,366,44,15,29,3,2
1,386,386,22,22,0,1,0
16,389,389,1,1,0,1,0
21,409,409,4,1,3,2,1
17,447,447,26,11,15,4,3
24,469,469,16,16,0,1,0
7,483,483,43,39,4,2,1
22,483,483,24,2,22,3,2
0,489,489,75,69,6,2,1
5,492,492,48,48,0,1,0

31,129,129,15,6,9,2,1
6,138,138,8,1,7,2,1
14,164,164,8,8,0,1,0
27,171,171,61,19,42,2,1
20,184,184,21,21,0,1,0
12,188,188,25,25,0,1,0
7,214,214,1,1,0,1,0
13,217,217,43,9,34,2,1
15,221,221,4,4,0,1,0
19,230,230,7,1,6,2,1
29,257,257,3,3,0,1,0
24,279,279,24,20,4,2,1
28,282,282,90,50,40,4,3
17,286,286,23,23,0,1,0
23,296,296,8,4,4,2,1
2,302,302,2,2,0,1,0
11,304,304,31,31,0,1,0
26,319,319,34,34,0,1,0
3,347,347,5,5,0,1,0
9,348,348,71,71,0,1,0
30,372,372,7,1,6,3,2
21,404,404,13,1,12,2,1
18,417,417,13,3,10,2,1
22,427,427,74,11,63,4,3
25,434,434,4,4,0,1,0
1,440,440,5,5,0,1,0
16,448,448,28,6,22,3,2
10,452,452,57,57,0,1,0
4,458,458,60,52,8,3,2
0,473,473,12,12,0,1,0
8,474,474,42,42,0,1,0
5,489,489,44,44,0,1,0

0,108,108,18,18,0,1,0
24,133,133,9,9,0,1,0
25,135,135,7,7,0,1,0
2,177,177,3,3,0,1,0
19,180,180,45,3,42,3,2
18,191,191,16,11,5,2,1
17,197,197,8,8,0,1,0
4,201,201,7,7,0,1,0
20,244,244,13,9,4,2,1
5,251,251,2,2,0,1,0
3,254,254,31,22,9,4,3
6,261,261,16,16,0,1,0
26,273,273,3,3,0,1,0
21,286,286,86,16,70,3,2
22,287,287,7,7,0,1,0
13,289,289,6,6,0,1,0
8,336,336,37,37,0,1,0
16,340,340,27,10,17,2,1
12,363,363,37,17,20,3,2
28,379,379,101,101,0,1,0
27,426,426,16,16,0,1,0
1,427,427,97,77,20,3,2
15,448,448,5,5,0,1,0
14,453,453,35,35,0,1,0
9,471,471,37,37,0,1,0
23,481,481,73,73,0,1,0
11,485,485,20,11,9,4,3
10,488,488,135,135,0,1,0
7,498,498,29,17,12,4,3

17,108,108,8,8,0,1,0
14,116,116,2,2,0,1,0
5,118,118,5,1,4,2,1
2,120,120,5,5,0,1,0
21,180,180,16,16,0,1,0
18,187,187,8,8,0,1,0
3,209,209,4,4,0,1,0
7,210,210,14,14,0,1,0
23,246,246,29,29,0,1,0
16,247,247,84,34,50,2,1
11,290,290,7,7,0,1,0
13,296,296,22,22,0,1,0
1,350,350,54,4,50,2,1
6,374,374,2,2,0,1,0
20,399,399,141,78,63,4,3
0,422,422,224,224,0,1,0
19,423,423,39,39,0,1,0
15,426,426,65,36,29,2,1
9,430,430,27,8,19,2,1
8,433,433,61,35,26,2,1
4,438,438,106,102,4,2,1
10,479,479,46,6,40,3,2
22,485,485,2,2,0,1,0
12,494,494,3,3,0,1,0
24,496,496,22,22,0,1,0

21,130,130,3,3,0,1,0
0,178,178,5,5,0,1,0
24,202,202,2,2,0,1,0
20,208,208,43,43,0,1,0
3,217,217,1,1,0,1,0
5,225,225,17,2,15,4,3
12,226,226,10,10,0,1,0
14,226,226,28,28,0,1,0
7,239,239,19,13,6,2,1
22,248,248,2,2,0,1,0
16,261,261,18,18,0,1,0
11,264,264,33,16,17,2,1
17,269,269,20,20,0,1,0
13,274,274,38,38,0,1,0
25,276,276,37,37,0,1,0
23,327,327,12,3,9,2,1
10,353,353,184,160,24,4,3
4,378,378,89,76,13,2,1
9,398,398,52,37,15,2,1
19,405,405,39,9,30,3,2
2,423,423,13,13,0,1,0
15,430,430,55,55,0,1,0
8,437,437,37,37,0,1,0
18,467,467,175,36,139,4,3
6,468,468,14,14,0,1,0
1,481,481,6,2,4,2,1
26,495,495,2,2,0,1,0

38,110,110,12,12,0,1,0
21,115,115,9,9,0,1,0
15,122,122,1,1,0,1,0
31,123,123,32,6,26,3,2
8,157,157,2,2,0,1,0
10,162,162,14,11,3,2,1
0,175,175,9,9,0,1,0
17,180,180,2,2,0,1,0
14,187,187,2,2,0,1,0
30,210,210,14,14,0,1,0
12,217,217,15,5,10,2,1
24,227,227,13,7,6,2,1
33,229,229,40,40,0,1,0
13,232,232,4,4,0,1,0
2,237,237,6,6,0,1,0
5,245,245,22,3,19,2,1
23,268,268,18,9,9,2,1
22,272,272,13,13,0,1,0
25,275,275,2,2,0,1,0
1,279,279,3,3,0,1,0
28,280,280,12,12,0,1,0
29,283,283,37,28,9,4,3
37,295,295,22,16,6,2,1
9,306,306,8,1,7,2,1
7,338,338,1,1,0,1,0
34,339,339,11,4,7,2,1
6,344,344,48,27,21,3,2
35,345,345,19,19,0,1,0
18,346,346,55,2,53,4,3
19,353,353,39,6,33,4,3
32,355,355,13,7,6,3,2
4,356,356,7,3,4,2,1
16,370,370,29,15,14,2,1
26,382,382,37,11,26,3,2
11,424,424,26,26,0,1,0
27,451,451,26,26,0,1,0
3,464,464,18,18,0,1,0
36,476,476,42,5,37,2,1
39,490,490,99,72,27,4,3
20,491,491,56,56,0,1,0

3,102,102,3,3,0,1,0
25,125,125,15,3,12,2,1
24,146,146,6,6,0,1,0
14,163,163,13,7,6,2,1
0,181,181,1,1,0,1,0
2,203,203,17,17,0,1,0
8,211,211,9,9,0,1,0
16,236,236,52,37,15,4,3
21,255,255,6,2,4,2,1
7,266,266,61,61,0,1,0
22,272,272,31,31,0,1,0
6,290,290,1,1,0,1,0
13,292,292,43,6,37,2,1
20,302,302,86,86,0,1,0
26,337,337,25,7,18,4,3
12,345,345,29,29,0,1,0
1,356,356,23,23,0,1,0
19,386,386,52,6,46,2,1
4,391,391,68,38,30,4,3
17,392,392,25,25,0,1,0
23,421,421,1,1,0,1,0
10,437,437,78,70,8,2,1
9,438,438,168,81,87,4,3
11,441,441,9,9,0,1,0
15,450,450,4,4,0,1,0
18,462,462,53,10,43,4,3
5,493,493,51,51,0,1,0

23,130,130,12,12,0,1,0
22,138,138,4,1,3,2,1
5,153,153,6,3,3,2,1
9,161,161,7,7,0,1,0
7,177,177,13,13,0,1,0
14,199,199,7,7,0,1,0
32,200,200,44,7,37,2,1
0,206,206,5,5,0,1,0
11,230,230,16,12,4,2,1
19,250,250,52,52,0,1,0
10,251,251,2,2,0,1,0
6,266,266,28,7,21,2,1
25,274,274,2,2,0,1,0
27,285,285,23,23,0,1,0
2,323,323,72,1,71,4,3
12,323,323,12,4,8,2,1
3,352,352,13,13,0,1,0
24,356,356,9,9,0,1,0
18,358,358,121,88,33,4,3
13,359,359,16,16,0,1,0
21,382,382,16,16,0,1,0
1,391,391,8,4,4,2,1
26,401,401,96,72,24,4,3
15,405,405,49,49,0,1,0
4,421,421,1,1,0,1,0
8,425,425,23,4,19,2,1
17,439,439,11,11,0,1,0
16,439,439,44,19,25,2,1
28,441,441,71,71,0,1,0
30,445,445,13,13,0,1,0
31,449,449,13,9,4,2,1
20,453,453,109,109,0,1,0
29,465,465,11,11,0,1,0

19,100,100,5,5,0,1,0
26,139,139,5,5,0,1,0
23,161,161,16,16,0,1,0
20,164,164,13,5,8,2,1
30,173,173,67,67,0,1,0
22,182,182,13,7,6,3,2
9,183,183,54,25,29,2,1
1,184,184,10,7,3,2,1
29,187,187,81,21,60,4,3
15,188,188,11,11,0,1,0
28,225,225,24,18,6,2,1
5,227,227,1,1,0,1,0
4,228,228,54,27,27,3,2
14,228,228,8,4,4,2,1
6,246,246,5,5,0,1,0
12,251,251,18,12,6,3,2
31,258,258,3,3,0,1,0
24,270,270,2,2,0,1,0
3,270,270,8,3,5,2,1
18,278,278,65,4,61,4,3
8,283,283,7,7,0,1,0
21,303,303,7,3,4,2,1
17,310,310,26,26,0,1,0
7,316,316,2,2,0,1,0
0,324,324,21,21,0,1,0
11,327,327,1,1,0,1,0
10,330,330,30,11,19,2,1
13,350,350,8,8,0,1,0
32,388,388,37,13,24,3,2
27,414,414,6,6,0,1,0
2,417,417,26,26,0,1,0
25,430,430,11,11,0,1,0
16,439,439,1,1,0,1,0

22,113,113,6,1,5,2,1
8,117,117,15,9,6,2,1
21,157,157,29,17,12,2,1
23,176,176,5,5,0,1,0
15,198,198,1,1,0,1,0
19,205,205,8,8,0,1,0
11,213,213,18,8,10,3,2
17,218,218,68,14,54,4,3
2,257,257,29,29,0,1,0
9,298,298,25,25,0,1,0
3,311,311,97,19,78,4,3
10,325,325,59,51,8,2,1
18,326,326,110,13,97,4,3
5,335,335,53,4,49,2,1
12,346,346,8,2,6,2,1
0,347,347,20,20,0,1,0
14,352,352,27,9,18,2,1
6,375,375,8,8,0,1,0
24,385,385,18,18,0,1,0
20,411,411,27,27,0,1,0
25,426,426,3,3,0,1,0
7,471,471,111,77,34,3,2
16,473,473,78,20,58,3,2
13,475,475,38,38,0,1,0
4,475,475,3,3,0,1,0
1,487,487,11,4,7,2,1

13,119,119,3,3,0,1,0
18,125,125,4,4,0,1,0
9,131,131,12,4,8,3,2
24,141,141,7,7,0,1,0
27,143,143,26,16,10,2,1
16,150,150,2,2,0,1,0
17,169,169,2,2,0,1,0
14,171,171,10,10,0,1,0
25,233,233,30,9,21,4,3
2,245,245,10,10,0,1,0
12,247,247,7,2,5,2,1
3,265,265,3,3,0,1,0
0,310,310,8,1,7,2,1
21,311,311,52,39,13,2,1
5,317,317,91,91,0,1,0
19,338,338,61,56,5,2,1
10,344,344,6,6,0,1,0
8,363,363,21,21,0,1,0
6,370,370,115,39,76,4,3
1,386,386,42,18,24,2,1
22,427,427,18,18,0,1,0
11,435,435,60,60,0,1,0
23,442,442,16,7,9,4,3
4,451,451,63,39,24,4,3
20,452,452,15,5,10,3,2
7,471,471,58,30,28,2,1
15,477,477,223,73,150,4,3
26,479,479,12,12,0,1,0

28,101,101,7,7,0,1,0
19,102,102,14,2,12,4,3
26,105,105,7,7,0,1,0
17,116,116,13,1,12,2,1
15,120,120,12,12,0,1,0
4,131,131,17,17,0,1,0
11,151,151,7,7,0,1,0
22,167,167,58,32,26,2,1
2,185,185,20,1,19,3,2
1,200,200,33,33,0,1,0
0,215,215,23,10,13,4,3
20,224,224,14,9,5,2,1
8,237,237,64,64,0,1,0
9,243,243,2,2,0,1,0
16,248,248,47,11,36,3,2
18,261,261,39,1,38,3,2
21,265,265,63,63,0,1,0
13,266,266,2,2,0,1,0
27,322,322,3,3,0,1,0
24,380,380,47,34,13,2,1
6,380,380,16,16,0,1,0
5,390,390,33,33,0,1,0
10,397,397,10,10,0,1,0
25,424,424,12,12,0,1,0
30,424,424,19,19,0,1,0
23,427,427,12,12,0,1,0
14,460,460,13,1,12,3,2
7,469,469,11,3,8,3,2
3,489,489,25,6,19,4,3
12,493,493,8,4,4,2,1
29,499,499,11,1,10,2,1

18,164,164,4,4,0,1,0
1,167,167,7,1,6,3,2
15,181,181,33,33,0,1,0
5,193,193,2,2,0,1,0
8,205,205,35,35,0,1,0
13,220,220,10,10,0,1,0
23,251,251,20,20,0,1,0
9,253,253,40,22,18,4,3
10,256,256,79,56,23,2,1
26,261,261,34,26,8,2,1
16,262,262,81,81,0,1,0
7,264,264,13,1,12,4,3
20,271,271,2,2,0,1,0
12,283,283,20,20,0,1,0
22,304,304,59,30,29,2,1
17,334,334,2,2,0,1,0
2,345,345,32,5,27,4,3
0,346,346,45,6,39,2,1
14,373,373,33,19,14,2,1
6,386,386,89,81,8,2,1
4,399,399,1,1,0,1,0
19,442,442,3,3,0,1,0
11,447,447,38,38,0,1,0
21,455,455,75,21,54,3,2
24,465,465,45,21,24,4,3
3,466,466,24,16,8,2,1
25,468,468,43,28,15,2,1

16,104,104,6,6,0,1,0
8,108,108,3,3,0,1,0
6,116,116,10,10,0,1,0
15,128,128,23,15,8,3,2
19,135,135,4,4,0,1,0
3,140,140,3,3,0,1,0
28,140,140,4,1,3,2,1
0,158,158,11,2,9,2,1
1,182,182,1,1,0,1,0
11,190,190,29,25,4,2,1
18,212,212,3,3,0,1,0
31,233,233,38,38,0,1,0
14,263,263,20,4,16,2,1
4,268,268,9,2,7,3,2
13,273,273,84,45,39,4,3
25,292,292,3,3,0,1,0
29,307,307,3,3,0,1,0
30,324,324,16,6,10,2,1
26,327,327,4,4,0,1,0
22,360,360,36,36,0,1,0
27,361,361,24,2,22,2,1
9,362,362,2,2,0,1,0
23,369,369,140,140,0,1,0
5,389,389,37,37,0,1,0
24,414,414,59,59,0,1,0
7,418,418,8,3,5,2,1
17,444,444,93,93,0,1,0
2,446,446,6,6,0,1,0
32,449,449,5,2,3,2,1
21,465,465,66,66,0,1,0
12,470,470,10,4,6,3,2
20,486,486,135,132,3,2,1
10,494,494,2,2,0,1,0

20,138,138,24,24,0,1,0
2,169,169,31,31,0,1,0
10,193,193,27,27,0,1,0
11,194,194,21,13,8,3,2
22,199,199,9,9,0,1,0
19,222,222,16,9,7,2,1
16,231,231,45,45,0,1,0
18,242,242,19,10,9,4,3
21,249,249,51,15,36,3,2
6,257,257,64,64,0,1,0
9,303,303,8,8,0,1,0
15,307,307,5,5,0,1,0
5,313,313,69,69,0,1,0
13,323,323,1,1,0,1,0
23,333,333,50,50,0,1,0
14,355,355,1,1,0,1,0
17,363,363,59,59,0,1,0
0,379,379,53,43,10,2,1
4,380,380,39,7,32,4,3
3,401,401,39,21,18,3,2
8,403,403,43,13,30,2,1
7,422,422,59,38,21,4,3
1,452,452,62,36,26,3,2
12,461,461,33,33,0,1,0

34,100,100,4,4,0,1,0
9,105,105,4,4,0,1,0
17,107,107,16,7,9,4,3
6,109,109,6,6,0,1,0
5,125,125,4,4,0,1,0
29,142,142,10,1,9,2,1
33,150,150,12,4,8,3,2
10,190,190,5,5,0,1,0
30,193,193,40,40,0,1,0
1,197,197,23,23,0,1,0
22,199,199,15,15,0,1,0
20,203,203,12,12,0,1,0
13,216,216,12,12,0,1,0
23,218,218,6,1,5,2,1
2,222,222,2,2,0,1,0
18,229,229,1,1,0,1,0
21,244,244,33,10,23,2,1
25,257,257,19,11,8,2,1
8,267,267,30,30,0,1,0
28,281,281,43,43,0,1,0
32,293,293,18,18,0,1,0
11,300,300,57,57,0,1,0
4,301,301,1,1,0,1,0
26,320,320,9,9,0,1,0
15,328,328,16,16,0,1,0
31,336,336,62,62,0,1,0
0,367,367,7,1,6,2,1
14,382,382,6,6,0,1,0
19,389,389,11,11,0,1,0
27,396,396,58,24,34,3,2
24,414,414,58,58,0,1,0
3,424,424,60,60,0,1,0
16,435,435,96,2,94,3,2
12,454,454,8,8,0,1,0
7,464,464,28,28,0,1,0

3,104,104,2,2,0,1,0
12,110,110,2,2,0,1,0
22,116,116,2,2,0,1,0
19,140,140,12,12,0,1,0
4,147,147,38,1,37,2,1
13,161,161,4,4,0,1,0
16,165,165,4,1,3,2,1
8,172,172,16,12,4,2,1
15,214,214,80,80,0,1,0
17,234,234,9,9,0,1,0
25,235,235,28,14,14,3,2
11,244,244,37,19,18,3,2
5,245,245,9,9,0,1,0
2,248,248,109,95,14,3,2
9,270,270,16,8,8,3,2
18,289,289,10,6,4,2,1
23,301,301,46,24,22,2,1
27,323,323,38,8,30,4,3
7,325,325,6,6,0,1,0
6,331,331,50,50,0,1,0
0,335,335,3,3,0,1,0
14,380,380,5,1,4,2,1
26,388,388,100,100,0,1,0
1,405,405,6,6,0,1,0
10,414,414,39,19,20,2,1
20,440,440,30,10,20,2,1
28,451,451,13,2,11,2,1
24,455,455,24,9,15,2,1
21,494,494,26,26,0,1,0

9,114,114,5,5,0,1,0
14,130,130,1,1,0,1,0
20,139,139,6,6,0,1,0
7,145,145,6,6,0,1,0
5,180,180,28,28,0,1,0
10,209,209,16,3,13,2,1
2,239,239,8,8,0,1,0
0,279,279,59,17,42,3,2
17,292,292,89,71,18,4,3
1,296,296,90,12,78,3,2
16,297,297,24,24,0,1,0
13,303,303,16,16,0,1,0
19,306,306,16,16,0,1,0
4,324,324,72,34,38,3,2
21,345,345,38,18,20,2,1
15,348,348,1,1,0,1,0
11,355,355,41,26,15,2,1
12,364,364,111,111,0,1,0
6,383,383,133,133,0,1,0
8,435,435,2,2,0,1,0
18,445,445,93,44,49,2,1
3,446,446,36,36,0,1,0
22,448,448,14,2,12,4,3

7,117,117,1,1,0,1,0
12,127,127,11,11,0,1,0
2,141,141,25,25,0,1,0
4,141,141,7,7,0,1,0
0,147,147,2,2,0,1,0
19,158,158,9,2,7,2,1
11,192,192,54,54,0,1,0
16,224,224,4,4,0,1,0
15,263,263,56,56,0,1,0
14,266,266,8,8,0,1,0
17,286,286,13,13,0,1,0
9,313,313,28,19,9,4,3
10,325,325,31,31,0,1,0
22,349,349,26,26,0,1,0
6,365,365,7,7,0,1,0
3,375,375,40,8,32,2,1
18,389,389,142,52,90,4,3
5,420,420,68,68,0,1,0
8,439,439,337,337,0,1,0
23,441,441,1,1,0,1,0
20,444,444,53,21,32,2,1
21,462,462,13,1,12,3,2
1,470,470,3,3,0,1,0
13,481,481,2,2,0,1,0

11,100,100,5,5,0,1,0
19,103,103,6,6,0,1,0
9,108,108,6,3,3,2,1
23,133,133,10,10,0,1,0
3,135,135,21,21,0,1,0
1,144,144,3,3,0,1,0
21,163,163,5,5,0,1,0
13,168,168,6,1,5,2,1
25,170,170,4,4,0,1,0
20,181,181,21,21,0,1,0
7,190,190,75,75,0,1,0
28,193,193,73,73,0,1,0
12,213,213,45,45,0,1,0
14,227,227,15,15,0,1,0
0,242,242,1,1,0,1,0
24,259,259,2,2,0,1,0
10,271,271,1,1,0,1,0
8,291,291,4,4,0,1,0
5,314,314,28,28,0,1,0
16,331,331,8,8,0,1,0
27,334,334,42,42,0,1,0
30,371,371,45,21,24,4,3
2,380,380,9,9,0,1,0
26,388,388,75,14,61,3,2
6,394,394,31,31,0,1,0
29,409,409,2,2,0,1,0
15,435,435,51,51,0,1,0
17,439,439,80,38,42,3,2
22,458,458,17,14,3,2,1
18,486,486,37,28,9,2,1
4,500,500,28,2,26,3,2

21,109,109,1,1,0,1,0
12,125,125,6,6,0,1,0
17,165,165,51,51,0,1,0
13,188,188,1,1,0,1,0
23,195,195,29,5,24,2,1
18,195,195,1,1,0,1,0
22,200,200,11,11,0,1,0
6,202,202,1,1,0,1,0
7,207,207,31,4,27,3,2
29,217,217,27,27,0,1,0
28,274,274,32,32,0,1,0
10,288,288,7,1,6,3,2
20,289,289,33,33,0,1,0
3,297,297,58,16,42,2,1
9,301,301,18,18,0,1,0
11,357,357,37,7,30,3,2
26,362,362,13,13,0,1,0
24,375,375,25,7,18,4,3
19,376,376,106,99,7,2,1
4,385,385,5,5,0,1,0
1,387,387,30,2,28,2,1
8,389,389,12,12,0,1,0
2,400,400,61,46,15,4,3
14,402,402,59,18,41,4,3
27,404,404,8,4,4,2,1
16,410,410,31,31,0,1,0
25,440,440,32,12,20,3,2
15,447,447,27,13,14,2,1
0,451,451,102,102,0,1,0
5,462,462,48,38,10,2,1

17,132,132,11,11,0,1,0
16,142,142,8,8,0,1,0
7,160,160,22,22,0,1,0
4,186,186,7,7,0,1,0
10,197,197,5,5,0,1,0
21,198,198,20,20,0,1,0
6,199,199,42,42,0,1,0
8,203,203,80,36,44,2,1
22,250,250,16,16,0,1,0
18,304,304,24,21,3,2,1
23,307,307,23,23,0,1,0
15,307,307,40,40,0,1,0
13,308,308,48,4,44,3,2
19,312,312,16,6,10,3,2
12,335,335,77,7,70,4,3
1,347,347,42,42,0,1,0
0,354,354,1,1,0,1,0
9,394,394,2,2,0,1,0
3,423,423,19,3,16,3,2
14,424,424,18,8,10,2,1
11,441,441,69,69,0,1,0
5,459,459,47,47,0,1,0
2,468,468,161,122,39,2,1
20,497,497,92,55,37,2,1

19,113,113,2,2,0,1,0
6,155,155,12,12,0,1,0
2,171,171,6,6,0,1,0
33,181,181,14,14,0,1,0
9,193,193,1,1,0,1,0
32,195,195,26,26,0,1,0
35,197,197,9,3,6,3,2
14,203,203,23,17,6,3,2
21,204,204,8,8,0,1,0
28,219,219,76,76,0,1,0
3,223,223,8,8,0,1,0
13,230,230,3,3,0,1,0
31,233,233,74,74,0,1,0
12,241,241,7,1,6,2,1
0,247,247,14,14,0,1,0
5,256,256,22,8,14,2,1
20,266,266,2,2,0,1,0
4,290,290,72,42,30,2,1
23,291,291,7,7,0,1,0
16,293,293,2,2,0,1,0
11,330,330,1,1,0,1,0
1,334,334,34,34,0,1,0
24,350,350,26,2,24,4,3
30,365,365,22,1,21,2,1
25,366,366,1,1,0,1,0
15,403,403,35,9,26,3,2
34,431,431,8,8,0,1,0
18,432,432,36,9,27,2,1
29,451,451,18,18,0,1,0
22,454,454,86,86,0,1,0
26,456,456,16,7,9,2,1
8,462,462,65,65,0,1,0
10,468,468,54,54,0,1,0
7,470,470,14,6,8,2,1
17,473,473,34,22,12,4,3
27,474,474,29,29,0,1,0

21,108,108,13,13,0,1,0
10,109,109,3,3,0,1,0
22,111,111,8,5,3,2,1
15,112,112,36,36,0,1,0
2,127,127,18,18,0,1,0
20,148,148,4,4,0,1,0
9,162,162,1,1,0,1,0
1,204,204,2,2,0,1,0
27,211,211,36,36,0,1,0
4,227,227,37,37,0,1,0
26,230,230,3,3,0,1,0
23,231,231,13,5,8,2,1
19,269,269,8,8,0,1,0
6,273,273,13,3,10,2,1
17,274,274,18,18,0,1,0
8,331,331,38,10,28,2,1
24,335,335,26,16,10,2,1
12,346,346,75,75,0,1,0
3,355,355,16,16,0,1,0
11,383,383,90,6,84,4,3
14,395,395,39,23,16,3,2
0,402,402,1,1,0,1,0
13,403,403,53,17,36,3,2
16,441,441,79,18,61,3,2
18,458,458,17,1,16,3,2
25,469,469,80,8,72,3,2
7,469,469,37,37,0,1,0
5,480,480,87,87,0,1,0

27,100,100,23,13,10,2,1
11,114,114,34,14,20,2,1
13,120,120,13,1,12,3,2
20,141,141,37,37,0,1,0
8,142,142,9,5,4,2,1
25,164,164,5,5,0,1,0
28,196,196,7,7,0,1,0
1,202,202,5,1,4,2,1
4,203,203,30,6,24,2,1
0,206,206,8,8,0,1,0
22,229,229,6,6,0,1,0
5,237,237,15,7,8,2,1
15,244,244,10,10,0,1,0
24,256,256,43,43,0,1,0
7,257,257,5,1,4,2,1
6,266,266,10,2,8,3,2
12,273,273,57,57,0,1,0
17,277,277,12,5,7,2,1
21,286,286,2,2,0,1,0
23,336,336,95,54,41,2,1
16,349,349,71,65,6,2,1
9,387,387,13,13,0,1,0
3,408,408,7,7,0,1,0
19,420,420,7,7,0,1,0
10,442,442,78,78,0,1,0
18,443,443,28,28,0,1,0
2,460,460,59,49,10,3,2
26,463,463,12,3,9,4,3
14,468,468,16,16,0,1,0

13,108,108,25,21,4,2,1
21,117,117,12,4,8,2,1
27,132,132,15,12,3,2,1
18,142,142,5,5,0,1,0
20,166,166,17,17,0,1,0
4,169,169,9,9,0,1,0
12,178,178,1,1,0,1,0
5,186,186,11,1,10,2,1
0,194,194,2,2,0,1,0
7,217,217,6,2,4,2,1
14,222,222,106,106,0,1,0
16,240,240,18,18,0,1,0
2,254,254,5,5,0,1,0
6,255,255,1,1,0,1,0
29,258,258,14,7,7,2,1
1,265,265,25,25,0,1,0
8,280,280,3,3,0,1,0
25,282,282,46,46,0,1,0
3,350,350,32,32,0,1,0
15,368,368,17,7,10,2,1
17,369,369,59,5,54,4,3
23,389,389,1,1,0,1,0
9,391,391,37,37,0,1,0
22,407,407,32,32,0,1,0
24,419,419,70,70,0,1,0
19,424,424,24,1,23,3,2
11,450,450,39,39,0,1,0
28,468,468,119,119,0,1,0
10,478,478,43,3,40,3,2
26,494,494,31,31,0,1,0

19,121,121,2,2,0,1,0
8,125,125,3,3,0,1,0
2,127,127,1,1,0,1,0
9,129,129,26,2,24,3,2
20,144,144,12,2,10,2,1
10,157,157,36,8,28,3,2
11,163,163,11,11,0,1,0
16,168,168,56,42,14,3,2
1,180,180,8,2,6,3,2
13,184,184,27,17,10,3,2
14,202,202,19,19,0,1,0
12,243,243,58,58,0,1,0
15,270,270,10,10,0,1,0
22,284,284,34,34,0,1,0
0,287,287,15,6,9,4,3
25,312,312,24,3,21,2,1
24,317,317,9,9,0,1,0
3,345,345,136,61,75,4,3
4,376,376,78,78,0,1,0
5,383,383,36,32,4,2,1
21,400,400,41,41,0,1,0
17,403,403,23,5,18,4,3
7,428,428,2,2,0,1,0
23,452,452,2,2,0,1,0
6,466,466,34,13,21,2,1
18,475,475,46,2,44,3,2

13,103,103,4,4,0,1,0
17,110,110,2,2,0,1,0
14,111,111,3,3,0,1,0
22,115,115,36,36,0,1,0
18,137,137,1,1,0,1,0
20,169,169,3,3,0,1,0
12,180,180,10,4,6,3,2
16,183,183,19,7,12,3,2
21,214,214,4,4,0,1,0
1,224,224,55,55,0,1,0
5,236,236,35,23,12,4,3
26,248,248,1,1,0,1,0
15,256,256,57,20,37,3,2
4,265,265,40,40,0,1,0
7,277,277,39,3,36,3,2
11,293,293,39,39,0,1,0
0,313,313,1,1,0,1,0
25,317,317,24,1,23,3,2
6,360,360,3,3,0,1,0
19,388,388,31,20,11,2,1
8,391,391,52,52,0,1,0
9,392,392,81,81,0,1,0
23,392,392,74,44,30,4,3
10,400,400,8,2,6,3,2
24,409,409,132,46,86,4,3
2,432,432,44,44,0,1,0
3,491,491,27,11,16,3,2

18,111,111,6,6,0,1,0
19,125,125,1,1,0,1,0
24,177,177,41,17,24,4,3
5,178,178,10,6,4,2,1
23,184,184,12,6,6,2,1
21,200,200,8,8,0,1,0
16,228,228,20,20,0,1,0
20,233,233,5,5,0,1,0
11,247,247,22,22,0,1,0
7,271,271,27,9,18,3,2
13,276,276,44,6,38,2,1
2,343,343,238,201,37,4,3
14,350,350,40,40,0,1,0
9,362,362,49,49,0,1,0
12,375,375,113,113,0,1,0
0,380,380,24,24,0,1,0
15,386,386,36,36,0,1,0
8,402,402,11,11,0,1,0
22,411,411,3,3,0,1,0
10,434,434,62,11,51,4,3
6,445,445,14,1,13,2,1
4,445,445,24,12,12,2,1
1,466,466,27,5,22,2,1
3,468,468,18,18,0,1,0
17,469,469,73,73,0,1,0

8,106,106,22,8,14,3,2
20,121,121,2,2,0,1,0
22,131,131,7,7,0,1,0
18,154,154,6,6,0,1,0
21,168,168,48,6,42,3,2
9,207,207,9,4,5,2,1
10,221,221,8,8,0,1,0
6,225,225,17,17,0,1,0
11,239,239,8,8,0,1,0
24,245,245,26,1,25,2,1
13,245,245,17,11,6,2,1
26,254,254,60,60,0,1,0
1,281,281,19,19,0,1,0
14,303,303,45,45,0,1,0
5,303,303,44,4,40,2,1
17,306,306,42,34,8,3,2
12,309,309,68,68,0,1,0
27,357,357,10,10,0,1,0
15,376,376,33,33,0,1,0
2,382,382,30,6,24,4,3
3,386,386,30,30,0,1,0
16,390,390,28,19,9,4,3
28,400,400,45,3,42,2,1
0,414,414,23,9,14,2,1
7,452,452,13,13,0,1,0
4,453,453,51,42,9,2,1
19,478,478,23,3,20,3,2
25,489,489,86,86,0,1,0
23,490,490,13,5,8,3,2

22,151,151,11,2,9,4,3
26,162,162,10,10,0,1,0
11,176,176,49,49,0,1,0
1,181,181,9,3,6,3,2
25,189,189,10,10,0,1,0
7,193,193,6,6,0,1,0
15,210,210,18,18,0,1,0
21,211,211,6,6,0,1,0
8,221,221,51,1,50,2,1
18,227,227,19,9,10,2,1
13,231,231,24,5,19,2,1
2,240,240,3,3,0,1,0
10,244,244,53,53,0,1,0
19,245,245,1,1,0,1,0
0,261,261,14,4,10,2,1
5,262,262,24,24,0,1,0
4,279,279,23,23,0,1,0
16,280,280,11,11,0,1,0
3,284,284,5,2,3,2,1
6,319,319,44,15,29,3,2
27,351,351,26,26,0,1,0
20,355,355,47,20,27,4,3
14,358,358,120,120,0,1,0
23,447,447,156,156,0,1,0
17,459,459,32,17,15,2,1
9,462,462,25,25,0,1,0
24,466,466,22,2,20,2,1
12,497,497,21,21,0,1,0

17,110,110,12,12,0,1,0
6,116,116,2,2,0,1,0
23,116,116,18,18,0,1,0
26,122,122,32,32,0,1,0
4,134,134,24,2,22,2,1
11,149,149,34,9,25,2,1
12,173,173,30,30,0,1,0
18,183,183,6,1,5,2,1
19,184,184,1,1,0,1,0
9,193,193,32,14,18,2,1
24,232,232,120,55,65,3,2
15,244,244,24,2,22,3,2
16,262,262,22,8,14,3,2
22,280,280,2,2,0,1,0
0,282,282,26,22,4,2,1
21,300,300,9,6,3,2,1
10,323,323,26,3,23,2,1
5,344,344,4,4,0,1,0
2,361,361,53,53,0,1,0
25,389,389,12,12,0,1,0
8,402,402,14,8,6,2,1
7,438,438,4,4,0,1,0
1,438,438,23,23,0,1,0
27,480,480,10,4,6,2,1
14,487,487,15,11,4,2,1
13,487,487,78,69,9,2,1
20,494,494,23,14,9,4,3
3,494,494,24,14,10,2,1

6,100,100,9,9,0,1,0
8,104,104,8,8,0,1,0
17,123,123,15,15,0,1,0
22,143,143,35,35,0,1,0
24,145,145,4,4,0,1,0
7,154,154,1,1,0,1,0
4,179,179,35,11,24,4,3
11,231,231,10,10,0,1,0
16,257,257,9,9,0,1,0
15,259,259,27,9,18,2,1
5,280,280,58,58,0,1,0
1,309,309,3,3,0,1,0
20,313,313,64,25,39,3,2
13,338,338,63,63,0,1,0
12,345,345,27,17,10,2,1
3,352,352,97,53,44,3,2
2,358,358,46,46,0,1,0
21,376,376,2,2,0,1,0
23,396,396,31,20,11,2,1
18,399,399,11,11,0,1,0
10,421,421,136,17,119,4,3
9,423,423,10,10,0,1,0
14,431,431,12,12,0,1,0
0,493,493,12,2,10,3,2
19,497,497,1,1,0,1,0
25,499,499,147,147,0,1,0

1,109,109,10,10,0,1,0
4,110,110,2,2,0,1,0
12,133,133,1,1,0,1,0
10,134,134,17,1,16,2,1
20,175,175,21,21,0,1,0
0,216,216,29,2,27,4,3
6,248,248,11,11,0,1,0
24,268,268,31,31,0,1,0
14,271,271,25,16,9,2,1
2,328,328,98,43,55,4,3
3,331,331,27,1,26,2,1
7,334,334,49,26,23,3,2
21,345,345,1,1,0,1,0
13,357,357,120,120,0,1,0
18,359,359,57,57,0,1,0
8,370,370,36,36,0,1,0
17,394,394,40,2,38,3,2
25,402,402,17,13,4,2,1
19,421,421,35,11,24,3,2
22,421,421,20,4,16,2,1
26,427,427,91,91,0,1,0
23,446,446,15,15,0,1,0
11,449,449,60,6,54,4,3
5,451,451,77,56,21,4,3
9,466,466,24,12,12,2,1
15,468,468,20,20,0,1,0
16,474,474,13,4,9,4,3

1,114,114,1,1,0,1,0
21,114,114,3,3,0,1,0
9,140,140,22,5,17,2,1
29,141,141,3,3,0,1,0
25,150,150,8,2,6,3,2
17,186,186,14,14,0,1,0
3,218,218,6,6,0,1,0
14,219,219,6,6,0,1,0
22,222,222,10,2,8,3,2
6,230,230,30,1,29,2,1
8,267,267,25,11,14,3,2
34,276,276,90,90,0,1,0
16,286,286,13,13,0,1,0
33,293,293,20,8,12,4,3
2,298,298,7,4,3,2,1
32,303,303,40,33,7,2,1
26,316,316,71,9,62,3,2
5,322,322,15,5,10,3,2
24,323,323,100,86,14,3,2
20,330,330,1,1,0,1,0
11,341,341,3,3,0,1,0
35,345,345,24,5,19,2,1
0,345,345,10,10,0,1,0
19,348,348,72,72,0,1,0
12,352,352,63,26,37,4,3
13,368,368,47,47,0,1,0
18,383,383,1,1,0,1,0
28,399,399,6,3,3,2,1
36,426,426,8,8,0,1,0
15,437,437,8,8,0,1,0
23,456,456,9,9,0,1,0
10,464,464,15,6,9,2,1
30,473,473,63,33,30,2,1
31,473,473,10,10,0,1,0
27,478,478,3,3,0,1,0
7,479,479,27,3,24,3,2
4,480,480,15,15,0,1,0

7,107,107,7,7,0,1,0
27,119,119,9,6,3,2,1
13,120,120,3,3,0,1,0
1,123,123,19,19,0,1,0
17,151,151,14,2,12,3,2
25,164,164,1,1,0,1,0
2,167,167,16,16,0,1,0
22,181,181,11,11,0,1,0
24,219,219,13,10,3,2,1
28,219,219,67,67,0,1,0
3,250,250,3,3,0,1,0
20,252,252,2,2,0,1,0
4,289,289,119,119,0,1,0
12,300,300,12,12,0,1,0
0,305,305,28,28,0,1,0
6,307,307,5,5,0,1,0
5,317,317,16,7,9,2,1
21,317,317,1,1,0,1,0
29,322,322,50,50,0,1,0
10,323,323,1,1,0,1,0
9,351,351,25,8,17,2,1
23,373,373,27,19,8,3,2
15,434,434,52,52,0,1,0
8,445,445,37,23,14,4,3
18,450,450,95,62,33,4,3
14,452,452,30,30,0,1,0
19,460,460,20,11,9,2,1
11,486,486,46,46,0,1,0
26,489,489,159,107,52,3,2
16,500,500,5,5,0,1,0

29,135,135,20,20,0,1,0
30,136,136,8,8,0,1,0
18,146,146,3,3,0,1,0
21,167,167,13,5,8,3,2
16,178,178,6,6,0,1,0
3,181,181,2,2,0,1,0
19,199,199,11,11,0,1,0
26,201,201,7,7,0,1,0
11,203,203,1,1,0,1,0
13,216,216,3,3,0,1,0
10,271,271,18,18,0,1,0
6,279,279,4,4,0,1,0
20,284,284,65,21,44,2,1
12,298,298,23,23,0,1,0
28,299,299,72,64,8,3,2
7,308,308,69,69,0,1,0
31,329,329,46,24,22,4,3
23,329,329,12,4,8,3,2
17,352,352,42,42,0,1,0
15,362,362,5,5,0,1,0
25,380,380,17,17,0,1,0
14,386,386,63,13,50,4,3
9,390,390,110,74,36,3,2
1,413,413,37,1,36,4,3
5,414,414,61,61,0,1,0
24,421,421,14,14,0,1,0
2,423,423,1,1,0,1,0
32,427,427,55,55,0,1,0
4,439,439,33,14,19,2,1
27,454,454,76,26,50,2,1
0,456,456,1,1,0,1,0
8,473,473,19,13,6,3,2
22,498,498,15,15,0,1,0

9,104,104,24,24,0,1,0
15,135,135,17,9,8,3,2
8,138,138,4,1,3,2,1
23,155,155,32,32,0,1,0
22,159,159,27,27,0,1,0
10,177,177,6,6,0,1,0
30,178,178,4,1,3,2,1
5,199,199,2,2,0,1,0
32,200,200,18,5,13,2,1
4,206,206,18,18,0,1,0
27,227,227,3,3,0,1,0
20,231,231,5,5,0,1,0
3,245,245,21,3,18,4,3
14,249,249,29,10,19,2,1
11,256,256,32,24,8,2,1
18,271,271,8,8,0,1,0
0,290,290,39,7,32,3,2
28,294,294,77,23,54,4,3
16,296,296,4,4,0,1,0
13,318,318,25,25,0,1,0
12,329,329,5,5,0,1,0
21,345,345,17,17,0,1,0
29,358,358,23,20,3,2,1
6,367,367,12,12,0,1,0
25,379,379,56,56,0,1,0
33,391,391,61,28,33,2,1
7,391,391,15,9,6,3,2
26,422,422,30,15,15,4,3
1,438,438,16,4,12,2,1
2,448,448,31,31,0,1,0
24,459,459,56,39,17,2,1
19,481,481,3,3,0,1,0
31,496,496,14,14,0,1,0
17,500,500,51,16,35,2,1

0,100,100,1,1,0,1,0
21,104,104,24,24,0,1,0
15,116,116,1,1,0,1,0
14,123,123,5,1,4,2,1
18,133,133,10,10,0,1,0
24,139,139,15,6,9,2,1
20,159,159,6,6,0,1,0
7,164,164,28,28,0,1,0
19,186,186,19,19,0,1,0
30,187,187,49,49,0,1,0
12,195,195,2,2,0,1,0
2,231,231,3,3,0,1,0
1,243,243,6,3,3,2,1
13,248,248,31,31,0,1,0
9,263,263,66,66,0,1,0
28,268,268,3,3,0,1,0
5,286,286,7,7,0,1,0
16,304,304,20,5,15,4,3
10,346,346,42,42,0,1,0
3,355,355,32,32,0,1,0
25,355,355,17,17,0,1,0
29,362,362,66,10,56,4,3
17,370,370,7,1,6,2,1
11,373,373,36,36,0,1,0
6,420,420,46,46,0,1,0
8,421,421,63,63,0,1,0
4,425,425,38,7,31,2,1
26,445,445,47,47,0,1,0
23,446,446,78,21,57,4,3
22,467,467,2,2,0,1,0
27,499,499,36,2,34,3,2

2,100,100,1,1,0,1,0
6,106,106,3,3,0,1,0
24,151,151,6,6,0,1,0
3,153,153,81,54,27,2,1
9,157,157,8,8,0,1,0
20,158,158,29,16,13,2,1
11,229,229,50,17,33,4,3
5,233,233,1,1,0,1,0
17,249,249,26,10,16,3,2
16,273,273,8,1,7,2,1
18,299,299,10,10,0,1,0
10,300,300,75,75,0,1,0
15,332,332,2,2,0,1,0
19,338,338,20,20,0,1,0
1,372,372,3,3,0,1,0
22,374,374,4,4,0,1,0
23,388,388,24,24,0,1,0
8,413,413,7,2,5,2,1
12,429,429,101,101,0,1,0
14,432,432,52,52,0,1,0
0,449,449,5,5,0,1,0
7,453,453,185,165,20,2,1
13,462,462,62,62,0,1,0
21,487,487,92,49,43,2,1
4,494,494,41,41,0,1,0

7,108,108,2,2,0,1,0
15,110,110,10,10,0,1,0
21,117,117,1,1,0,1,0
18,145,145,16,1,15,2,1
12,149,149,7,7,0,1,0
13,164,164,23,8,15,2,1
6,174,174,23,23,0,1,0
20,178,178,6,6,0,1,0
8,188,188,3,3,0,1,0
9,202,202,5,5,0,1,0
5,211,211,36,12,24,4,3
1,214,214,24,14,10,2,1
14,223,223,76,54,22,2,1
3,246,246,13,13,0,1,0
22,254,254,23,23,0,1,0
25,285,285,6,6,0,1,0
10,295,295,45,33,12,3,2
24,299,299,5,5,0,1,0
23,299,299,21,6,15,2,1
4,323,323,94,2,92,3,2
17,327,327,73,73,0,1,0
26,330,330,6,3,3,2,1
2,380,380,68,50,18,4,3
16,381,381,68,30,38,2,1
0,428,428,24,24,0,1,0
11,471,471,70,14,56,3,2
19,492,492,44,24,20,4,3

23,102,102,1,1,0,1,0
0,128,128,10,1,9,2,1
19,133,133,1,1,0,1,0
6,137,137,28,28,0,1,0
8,138,138,26,14,12,2,1
12,167,167,8,8,0,1,0
4,190,190,48,48,0,1,0
16,196,196,1,1,0,1,0
13,210,210,3,3,0,1,0
22,217,217,41,18,23,2,1
1,240,240,34,34,0,1,0
10,246,246,41,41,0,1,0
3,252,252,8,2,6,2,1
25,259,259,24,6,18,3,2
24,268,268,12,4,8,3,2
21,276,276,68,68,0,1,0
20,306,306,48,40,8,3,2
9,338,338,32,5,27,4,3
2,348,348,4,4,0,1,0
18,348,348,56,6,50,4,3
17,352,352,106,106,0,1,0
7,379,379,24,24,0,1,0
15,379,379,12,4,8,3,2
11,391,391,13,13,0,1,0
5,406,406,55,29,26,2,1
14,425,425,56,56,0,1,0

0,125,125,14,14,0,1,0
22,147,147,13,4,9,4,3
12,150,150,3,3,0,1,0
5,155,155,2,2,0,1,0
6,180,180,12,12,0,1,0
16,182,182,3,3,0,1,0
11,184,184,27,27,0,1,0
1,185,185,82,62,20,3,2
2,217,217,5,5,0,1,0
32,231,231,17,1,16,3,2
31,248,248,21,21,0,1,0
18,259,259,16,13,3,2,1
15,265,265,8,1,7,2,1
21,275,275,26,26,0,1,0
3,278,278,1,1,0,1,0
30,281,281,7,2,5,2,1
25,283,283,51,51,0,1,0
10,288,288,6,6,0,1,0
20,292,292,25,18,7,2,1
19,314,314,25,15,10,2,1
14,321,321,12,12,0,1,0
17,321,321,23,23,0,1,0
27,322,322,53,23,30,3,2
24,335,335,54,54,0,1,0
23,390,390,50,22,28,2,1
13,392,392,55,55,0,1,0
9,408,408,13,13,0,1,0
29,409,409,17,1,16,3,2
8,436,436,27,9,18,3,2
28,448,448,65,65,0,1,0
26,459,459,35,35,0,1,0
4,467,467,46,46,0,1,0
7,476,476,1,1,0,1,0

11,109,109,4,4,0,1,0
10,146,146,4,4,0,1,0
8,162,162,28,23,5,2,1
19,179,179,4,4,0,1,0
17,194,194,13,7,6,3,2
5,198,198,10,1,9,2,1
14,231,231,39,12,27,2,1
23,232,232,1,1,0,1,0
3,249,249,31,31,0,1,0
18,283,283,19,11,8,3,2
21,289,289,11,4,7,2,1
25,297,297,59,7,52,3,2
9,310,310,24,24,0,1,0
22,317,317,6,6,0,1,0
15,323,323,16,16,0,1,0
7,324,324,48,3,45,2,1
24,330,330,3,3,0,1,0
2,351,351,14,4,10,2,1
12,352,352,52,43,9,2,1
4,371,371,48,25,23,2,1
20,374,374,91,63,28,2,1
6,393,393,82,40,42,4,3
13,406,406,179,32,147,4,3
16,426,426,19,3,16,2,1
0,455,455,96,14,82,3,2
1,483,483,13,5,8,3,2
26,491,491,24,16,8,2,1

26,110,110,23,23,0,1,0
18,138,138,13,9,4,2,1
32,152,152,15,15,0,1,0
17,157,157,14,14,0,1,0
23,174,174,11,5,6,3,2
12,178,178,10,10,0,1,0
6,202,202,10,7,3,2,1
10,207,207,4,4,0,1,0
30,213,213,31,31,0,1,0
3,234,234,33,19,14,2,1
22,234,234,45,31,14,3,2
25,249,249,19,19,0,1,0
4,249,249,21,21,0,1,0
33,250,250,9,9,0,1,0
29,250,250,9,9,0,1,0
16,253,253,28,28,0,1,0
20,276,276,16,2,14,3,2
28,280,280,1,1,0,1,0
13,293,293,33,33,0,1,0
8,299,299,2,2,0,1,0
27,319,319,25,25,0,1,0
24,348,348,58,52,6,3,2
19,361,361,70,70,0,1,0
15,366,366,2,2,0,1,0
14,367,367,1,1,0,1,0
34,395,395,50,26,24,2,1
1,405,405,9,9,0,1,0
31,418,418,70,70,0,1,0
7,435,435,19,19,0,1,0
11,442,442,24,24,0,1,0
5,452,452,1,1,0,1,0
2,472,472,21,21,0,1,0
21,476,476,15,5,10,2,1
0,491,491,3,3,0,1,0
9,500,500,102,102,0,1,0

1,119,119,5,5,0,1,0
11,128,128,2,2,0,1,0
24,137,137,8,2,6,3,2
17,150,150,24,24,0,1,0
5,153,153,16,16,0,1,0
8,162,162,14,14,0,1,0
0,172,172,12,12,0,1,0
13,173,173,68,68,0,1,0
19,211,211,16,16,0,1,0
9,213,213,71,71,0,1,0
20,276,276,6,6,0,1,0
22,289,289,45,45,0,1,0
6,295,295,8,2,6,3,2
7,338,338,6,3,3,2,1
15,346,346,2,2,0,1,0
23,352,352,16,16,0,1,0
21,354,354,1,1,0,1,0
2,362,362,121,28,93,4,3
4,374,374,1,1,0,1,0
3,377,377,141,27,114,4,3
18,400,400,82,28,54,4,3
12,401,401,27,27,0,1,0
14,403,403,61,13,48,3,2
16,428,428,31,31,0,1,0
10,497,497,5,5,0,1,0

3,117,117,1,1,0,1,0
29,125,125,12,12,0,1,0
13,132,132,39,12,27,4,3
8,135,135,1,1,0,1,0
14,138,138,30,15,15,4,3
11,138,138,1,1,0,1,0
25,148,148,14,14,0,1,0
10,157,157,5,5,0,1,0
6,167,167,1,1,0,1,0
7,184,184,26,26,0,1,0
12,184,184,14,14,0,1,0
27,201,201,53,44,9,4,3
22,222,222,12,12,0,1,0
16,228,228,30,30,0,1,0
17,245,245,3,3,0,1,0
21,271,271,16,16,0,1,0
24,276,276,8,1,7,3,2
15,289,289,3,3,0,1,0
9,331,331,50,50,0,1,0
23,338,338,31,31,0,1,0
20,348,348,12,12,0,1,0
5,358,358,6,6,0,1,0
28,414,414,8,2,6,2,1
19,415,415,52,52,0,1,0
0,442,442,29,6,23,2,1
4,446,446,16,16,0,1,0
1,450,450,56,16,40,3,2
18,452,452,175,175,0,1,0
2,467,467,96,6,90,4,3
26,487,487,10,4,6,2,1

1,103,103,9,4,5,2,1
19,111,111,1,1,0,1,0
23,119,119,4,4,0,1,0
5,152,152,12,3,9,4,3
20,157,157,15,3,12,3,2
22,162,162,41,20,21,4,3
9,172,172,4,1,3,2,1
4,199,199,10,10,0,1,0
15,199,199,8,8,0,1,0
24,206,206,30,30,0,1,0
11,219,219,40,40,0,1,0
12,228,228,26,26,0,1,0
7,255,255,2,2,0,1,0
16,296,296,13,13,0,1,0
6,325,325,17,4,13,2,1
3,328,328,90,32,58,3,2
2,334,334,69,69,0,1,0
25,361,361,25,25,0,1,0
0,362,362,19,1,18,2,1
27,375,375,7,7,0,1,0
21,393,393,27,27,0,1,0
28,401,401,27,9,18,2,1
18,425,425,46,26,20,3,2
13,431,431,75,75,0,1,0
8,459,459,1,1,0,1,0
17,466,466,128,128,0,1,0
26,480,480,94,37,57,4,3
10,482,482,25,16,9,4,3
14,485,485,21,3,18,2,1

16,110,110,7,7,0,1,0
27,135,135,5,2,3,2,1
26,147,147,1,1,0,1,0
8,151,151,23,23,0,1,0
9,158,158,17,17,0,1,0
4,179,179,5,2,3,2,1
25,185,185,25,10,15,2,1
22,194,194,24,24,0,1,0
0,196,196,1,1,0,1,0
20,206,206,26,26,0,1,0
2,213,213,23,23,0,1,0
13,230,230,23,6,17,2,1
19,233,233,43,43,0,1,0
15,233,233,54,42,12,4,3
7,261,261,33,28,5,2,1
3,318,318,16,4,12,2,1
21,340,340,69,30,39,2,1
18,350,350,2,2,0,1,0
11,350,350,26,26,0,1,0
5,358,358,15,9,6,3,2
24,361,361,24,17,7,2,1
10,410,410,25,25,0,1,0
12,424,424,18,18,0,1,0
14,437,437,29,29,0,1,0
23,439,439,11,4,7,2,1
1,452,452,125,125,0,1,0
6,470,470,108,12,96,4,3
17,491,491,74,32,42,4,3

7,103,103,2,2,0,1,0
1,106,106,1,1,0,1,0
8,116,116,16,16,0,1,0
18,116,116,5,5,0,1,0
14,124,124,1,1,0,1,0
25,143,143,12,5,7,2,1
11,162,162,14,4,10,2,1
6,173,173,4,4,0,1,0
19,175,175,23,3,20,2,1
4,179,179,18,18,0,1,0
3,185,185,7,4,3,2,1
29,210,210,24,10,14,3,2
22,215,215,25,25,0,1,0
13,267,267,39,22,17,2,1
15,289,289,46,46,0,1,0
0,296,296,106,34,72,3,2
23,314,314,33,33,0,1,0
28,319,319,128,61,67,4,3
21,321,321,6,1,5,2,1
26,354,354,16,16,0,1,0
16,374,374,36,4,32,3,2
17,390,390,1,1,0,1,0
12,394,394,26,15,11,3,2
2,398,398,6,6,0,1,0
24,402,402,61,48,13,2,1
10,417,417,37,37,0,1,0
9,437,437,50,31,19,2,1
20,450,450,41,24,17,2,1
5,454,454,14,14,0,1,0
27,463,463,12,5,7,2,1

13,136,136,14,14,0,1,0
3,159,159,11,2,9,2,1
4,159,159,1,1,0,1,0
27,170,170,18,18,0,1,0
1,192,192,17,17,0,1,0
9,194,194,10,10,0,1,0
15,202,202,2,2,0,1,0
25,207,207,12,12,0,1,0
10,209,209,3,3,0,1,0
18,215,215,12,6,6,2,1
22,245,245,21,10,11,2,1
24,261,261,132,16,116,4,3
7,264,264,50,50,0,1,0
30,276,276,9,9,0,1,0
14,278,278,33,33,0,1,0
23,284,284,42,11,31,2,1
0,287,287,18,18,0,1,0
11,309,309,7,7,0,1,0
17,311,311,14,7,7,2,1
19,328,328,66,66,0,1,0
5,329,329,41,41,0,1,0
8,339,339,53,53,0,1,0
28,348,348,5,5,0,1,0
21,379,379,25,11,14,2,1
16,381,381,13,13,0,1,0
26,411,411,6,6,0,1,0
12,430,430,103,77,26,2,1
6,449,449,14,14,0,1,0
29,462,462,6,6,0,1,0
2,473,473,37,37,0,1,0
20,479,479,36,36,0,1,0

2,102,102,6,6,0,1,0
31,121,121,3,3,0,1,0
29,133,133,2,2,0,1,0
25,150,150,22,15,7,2,1
28,155,155,37,14,23,2,1
7,159,159,8,3,5,2,1
34,168,168,4,4,0,1,0
19,181,181,1,1,0,1,0
5,182,182,26,2,24,4,3
35,189,189,54,54,0,1,0
30,196,196,12,5,7,2,1
15,198,198,13,13,0,1,0
20,206,206,13,4,9,4,3
26,213,213,23,23,0,1,0
12,222,222,8,4,4,2,1
9,222,222,12,2,10,2,1
17,227,227,11,11,0,1,0
22,228,228,30,30,0,1,0
1,253,253,16,16,0,1,0
8,255,255,2,2,0,1,0
0,262,262,20,20,0,1,0
18,266,266,24,24,0,1,0
16,316,316,28,4,24,3,2
6,323,323,24,24,0,1,0
13,330,330,42,42,0,1,0
3,333,333,20,14,6,3,2
24,358,358,15,3,12,4,3
33,362,362,49,18,31,4,3
4,385,385,10,10,0,1,0
21,404,404,40,40,0,1,0
27,414,414,25,16,9,2,1
32,428,428,56,56,0,1,0
11,437,437,42,16,26,3,2
23,444,444,12,12,0,1,0
14,455,455,14,14,0,1,0
10,460,460,17,17,0,1,0

1,119,119,12,12,0,1,0
22,155,155,6,6,0,1,0
2,177,177,29,29,0,1,0
10,188,188,5,5,0,1,0
13,193,193,8,2,6,2,1
23,202,202,43,43,0,1,0
9,242,242,6,6,0,1,0
3,248,248,13,4,9,3,2
16,251,251,23,23,0,1,0
7,254,254,1,1,0,1,0
20,255,255,21,3,18,2,1
5,283,283,4,4,0,1,0
8,302,302,17,17,0,1,0
11,327,327,21,21,0,1,0
4,362,362,50,34,16,3,2
24,364,364,2,2,0,1,0
17,384,384,85,38,47,2,1
15,394,394,7,2,5,2,1
6,411,411,252,242,10,3,2
18,421,421,1,1,0,1,0
21,421,421,77,47,30,4,3
12,433,433,67,67,0,1,0
0,438,438,91,79,12,4,3
14,439,439,30,30,0,1,0
19,488,488,118,70,48,4,3

4,134,134,19,19,0,1,0
3,142,142,3,3,0,1,0
21,156,156,40,40,0,1,0
8,168,168,7,7,0,1,0
5,186,186,7,4,3,2,1
17,199,199,9,9,0,1,0
13,235,235,12,2,10,2,1
18,235,235,40,40,0,1,0
16,263,263,15,1,14,3,2
12,275,275,19,10,9,4,3
20,300,300,27,12,15,4,3
2,317,317,152,95,57,3,2
14,320,320,23,23,0,1,0
25,349,349,8,8,0,1,0
0,349,349,50,50,0,1,0
19,374,374,26,18,8,3,2
22,381,381,20,5,15,2,1
24,387,387,35,9,26,2,1
10,405,405,32,4,28,3,2
23,416,416,110,62,48,2,1
1,423,423,52,35,17,2,1
7,424,424,31,24,7,2,1
11,424,424,26,26,0,1,0
6,435,435,42,42,0,1,0
15,446,446,50,50,0,1,0
9,459,459,47,47,0,1,0

19,108,108,8,2,6,3,2
8,145,145,23,23,0,1,0
13,152,152,5,5,0,1,0
6,161,161,12,6,6,3,2
25,180,180,5,5,0,1,0
18,194,194,31,6,25,2,1
23,228,228,28,5,23,2,1
3,239,239,99,30,69,4,3
1,250,250,3,3,0,1,0
11,253,253,8,8,0,1,0
9,262,262,48,10,38,2,1
15,265,265,57,57,0,1,0
10,272,272,2,2,0,1,0
7,273,273,24,24,0,1,0
17,287,287,54,54,0,1,0
22,294,294,59,59,0,1,0
12,306,306,3,3,0,1,0
21,323,323,36,21,15,2,1
2,339,339,9,9,0,1,0
20,339,339,40,13,27,4,3
14,383,383,21,3,18,2,1
16,389,389,4,4,0,1,0
26,397,397,14,14,0,1,0
0,398,398,39,14,25,2,1
5,451,451,58,46,12,4,3
24,454,454,33,27,6,3,2
4,483,483,81,63,18,4,3

25,109,109,4,4,0,1,0
1,140,140,51,7,44,2,1
30,148,148,6,6,0,1,0
27,164,164,4,4,0,1,0
4,195,195,18,18,0,1,0
31,230,230,5,5,0,1,0
11,243,243,7,7,0,1,0
28,248,248,10,4,6,3,2
20,250,250,28,28,0,1,0
22,253,253,7,1,6,2,1
23,257,257,46,34,12,2,1
21,257,257,111,111,0,1,0
18,259,259,12,12,0,1,0
5,273,273,20,20,0,1,0
6,284,284,49,49,0,1,0
16,315,315,4,4,0,1,0
26,333,333,2,2,0,1,0
9,340,340,47,25,22,4,3
24,340,340,130,55,75,4,3
17,348,348,26,9,17,4,3
10,383,383,11,2,9,2,1
29,387,387,19,2,17,4,3
0,392,392,12,12,0,1,0
8,392,392,1,1,0,1,0
7,403,403,33,3,30,2,1
15,419,419,25,16,9,4,3
19,436,436,12,12,0,1,0
2,439,439,6,3,3,2,1
14,440,440,33,2,31,2,1
13,454,454,29,13,16,3,2
3,470,470,36,18,18,2,1
12,482,482,6,2,4,2,1

23,104,104,23,17,6,2,1
12,117,117,15,15,0,1,0
6,134,134,11,11,0,1,0
10,137,137,1,1,0,1,0
28,210,210,12,12,0,1,0
19,239,239,16,16,0,1,0
16,241,241,30,30,0,1,0
8,248,248,7,7,0,1,0
25,284,284,96,96,0,1,0
26,295,295,24,24,0,1,0
3,311,311,24,21,3,2,1
27,313,313,11,11,0,1,0
2,331,331,83,27,56,4,3
22,346,346,30,5,25,4,3
15,360,360,9,5,4,2,1
7,374,374,3,3,0,1,0
18,376,376,5,5,0,1,0
14,396,396,25,5,20,3,2
9,403,403,39,15,24,2,1
11,406,406,1,1,0,1,0
20,432,432,49,49,0,1,0
4,432,432,1,1,0,1,0
17,468,468,49,49,0,1,0
24,471,471,10,4,6,3,2
5,477,477,46,46,0,1,0
21,478,478,67,46,21,2,1
1,480,480,27,4,23,4,3
0,485,485,225,96,129,4,3
13,499,499,19,19,0,1,0

18,102,102,2,2,0,1,0
10,105,105,28,6,22,3,2
34,111,111,15,4,11,3,2
6,116,116,4,4,0,1,0
30,123,123,16,16,0,1,0
23,132,132,15,10,5,2,1
5,146,146,4,4,0,1,0
8,155,155,2,2,0,1,0
29,171,171,40,6,34,2,1
27,188,188,23,12,11,2,1
19,190,190,12,3,9,4,3
7,200,200,2,2,0,1,0
0,210,210,1,1,0,1,0
13,222,222,1,1,0,1,0
32,237,237,19,13,6,2,1
14,261,261,25,25,0,1,0
3,271,271,23,23,0,1,0
33,273,273,19,1,18,3,2
26,279,279,3,3,0,1,0
21,280,280,28,28,0,1,0
15,291,291,13,7,6,2,1
1,298,298,1,1,0,1,0
11,310,310,1,1,0,1,0
25,320,320,24,24,0,1,0
17,366,366,5,5,0,1,0
28,372,372,11,8,3,2,1
12,372,372,43,43,0,1,0
9,373,373,4,1,3,2,1
16,445,445,183,183,0,1,0
4,446,446,53,53,0,1,0
20,455,455,4,4,0,1,0
22,458,458,138,3,135,4,3
31,463,463,13,3,10,3,2
2,469,469,22,22,0,1,0
24,474,474,2,2,0,1,0

8,124,124,32,4,28,3,2
18,140,140,14,6,8,2,1
16,173,173,1,1,0,1,0
2,179,179,73,73,0,1,0
15,205,205,83,34,49,4,3
22,207,207,6,6,0,1,0
14,230,230,28,1,27,4,3
19,253,253,11,11,0,1,0
6,265,265,25,25,0,1,0
23,277,277,32,32,0,1,0
10,348,348,20,14,6,2,1
7,372,372,68,2,66,3,2
0,382,382,18,6,12,4,3
13,383,383,59,59,0,1,0
12,402,402,75,25,50,2,1
17,402,402,30,12,18,4,3
4,403,403,96,60,36,2,1
21,420,420,20,2,18,2,1
1,424,424,31,4,27,4,3
9,445,445,6,6,0,1,0
3,445,445,36,10,26,3,2
11,480,480,34,34,0,1,0
20,488,488,6,6,0,1,0
5,496,496,3,3,0,1,0

20,113,113,13,10,3,2,1
4,132,132,10,5,5,2,1
13,137,137,12,12,0,1,0
12,141,141,1,1,0,1,0
15,180,180,8,8,0,1,0
17,186,186,22,11,11,2,1
18,191,191,26,26,0,1,0
27,194,194,11,5,6,2,1
5,203,203,2,2,0,1,0
3,216,216,102,22,80,3,2
0,259,259,8,8,0,1,0
19,301,301,7,3,4,2,1
16,308,308,83,19,64,3,2
11,311,311,46,37,9,4,3
24,318,318,17,17,0,1,0
1,333,333,12,12,0,1,0
26,337,337,18,18,0,1,0
6,341,341,39,4,35,4,3
2,354,354,8,8,0,1,0
7,361,361,49,49,0,1,0
21,380,380,14,7,7,2,1
22,381,381,34,34,0,1,0
25,395,395,23,23,0,1,0
23,435,435,131,34,97,4,3
14,438,438,31,7,24,3,2
8,448,448,96,66,30,4,3
10,480,480,23,23,0,1,0
9,497,497,2,2,0,1,0

32,131,131,43,26,17,2,1
2,156,156,24,24,0,1,0
28,157,157,13,13,0,1,0
24,177,177,1,1,0,1,0
6,179,179,17,8,9,2,1
20,179,179,9,1,8,2,1
22,183,183,52,35,17,3,2
19,195,195,3,3,0,1,0
14,204,204,22,22,0,1,0
29,208,208,11,11,0,1,0
25,231,231,9,9,0,1,0
4,232,232,8,8,0,1,0
11,234,234,3,3,0,1,0
17,244,244,27,27,0,1,0
7,251,251,5,5,0,1,0
18,255,255,6,6,0,1,0
21,264,264,29,29,0,1,0
10,264,264,18,12,6,3,2
31,273,273,10,1,9,4,3
8,309,309,12,12,0,1,0
13,313,313,10,4,6,3,2
0,320,320,14,14,0,1,0
33,357,357,44,44,0,1,0
9,368,368,26,26,0,1,0
3,377,377,74,74,0,1,0
16,378,378,49,25,24,2,1
12,408,408,33,15,18,4,3
15,424,424,56,4,52,3,2
30,430,430,10,1,9,2,1
5,452,452,1,1,0,1,0
1,457,457,15,1,14,2,1
23,484,484,77,77,0,1,0
27,488,488,1,1,0,1,0
26,494,494,67,67,0,1,0

13,105,105,1,1,0,1,0
3,147,147,6,6,0,1,0
15,193,193,4,4,0,1,0
7,196,196,1,1,0,1,0
20,205,205,50,50,0,1,0
4,208,208,51,24,27,2,1
0,245,245,68,31,37,2,1
14,249,249,4,1,3,2,1
10,251,251,1,1,0,1,0
19,261,261,76,76,0,1,0
9,270,270,77,47,30,4,3
18,286,286,23,23,0,1,0
11,296,296,3,3,0,1,0
16,316,316,13,2,11,2,1
5,336,336,71,25,46,3,2
12,354,354,8,8,0,1,0
21,363,363,3,3,0,1,0
17,387,387,132,100,32,3,2
8,408,408,20,15,5,2,1
2,419,419,110,35,75,4,3
1,427,427,127,76,51,4,3
6,447,447,6,6,0,1,0
22,450,450,25,25,0,1,0

2,116,116,24,24,0,1,0
9,129,129,1,1,0,1,0
1,135,135,1,1,0,1,0
28,145,145,16,16,0,1,0
25,221,221,12,6,6,3,2
22,242,242,13,13,0,1,0
17,252,252,1,1,0,1,0
8,259,259,22,22,0,1,0
14,268,268,52,30,22,3,2
11,272,272,33,33,0,1,0
13,272,272,47,1,46,4,3
21,290,290,26,26,0,1,0
27,299,299,38,26,12,3,2
12,301,301,19,3,16,2,1
6,322,322,35,15,20,3,2
4,351,351,35,5,30,3,2
26,375,375,66,1,65,3,2
7,386,386,28,28,0,1,0
15,393,393,64,64,0,1,0
23,402,402,17,10,7,2,1
19,419,419,103,68,35,2,1
3,420,420,15,15,0,1,0
16,432,432,90,27,63,4,3
20,433,433,19,19,0,1,0
18,442,442,14,2,12,2,1
10,445,445,85,4,81,4,3
5,462,462,12,12,0,1,0
0,478,478,4,4,0,1,0
24,480,480,36,36,0,1,0

21,113,113,3,3,0,1,0
0,116,116,6,3,3,2,1
2,122,122,8,8,0,1,0
25,124,124,9,1,8,3,2
17,125,125,7,3,4,2,1
23,134,134,1,1,0,1,0
27,172,172,24,21,3,2,1
11,177,177,1,1,0,1,0
12,181,181,40,40,0,1,0
24,205,205,37,37,0,1,0
13,206,206,28,28,0,1,0
15,222,222,23,1,22,3,2
4,231,231,23,23,0,1,0
16,234,234,17,17,0,1,0
6,239,239,1,1,0,1,0
5,246,246,28,5,23,2,1
20,254,254,25,8,17,2,1
19,266,266,27,13,14,3,2
8,307,307,47,47,0,1,0
7,332,332,50,50,0,1,0
1,336,336,31,31,0,1,0
3,356,356,42,18,24,3,2
9,373,373,4,4,0,1,0
28,400,400,64,64,0,1,0
18,400,400,2,2,0,1,0
10,408,408,26,26,0,1,0
14,414,414,48,48,0,1,0
26,458,458,116,25,91,4,3
22,470,470,73,5,68,3,2

34,114,114,6,6,0,1,0
17,126,126,3,3,0,1,0
4,145,145,7,7,0,1,0
33,159,159,25,25,0,1,0
26,175,175,6,1,5,2,1
16,191,191,21,5,16,2,1
2,214,214,7,7,0,1,0
11,219,219,8,8,0,1,0
23,225,225,1,1,0,1,0
21,238,238,1,1,0,1,0
15,252,252,12,12,0,1,0
32,258,258,43,25,18,3,2
25,264,264,2,2,0,1,0
7,268,268,3,3,0,1,0
12,287,287,6,1,5,2,1
30,291,291,2,2,0,1,0
13,295,295,37,33,4,2,1
24,310,310,18,18,0,1,0
3,312,312,49,49,0,1,0
10,315,315,22,1,21,2,1
18,317,317,9,1,8,3,2
1,318,318,6,6,0,1,0
35,318,318,25,25,0,1,0
19,331,331,8,8,0,1,0
22,345,345,21,21,0,1,0
28,347,347,58,19,39,2,1
20,365,365,34,34,0,1,0
0,393,393,39,39,0,1,0
36,399,399,60,33,27,2,1
5,411,411,12,5,7,2,1
29,417,417,12,12,0,1,0
27,424,424,184,184,0,1,0
14,462,462,5,5,0,1,0
31,466,466,38,8,30,2,1
6,467,467,8,8,0,1,0
8,485,485,67,21,46,2,1
9,499,499,97,45,52,3,2

10,114,114,6,3,3,2,1
2,116,116,21,21,0,1,0
17,119,119,13,3,10,2,1
7,125,125,10,5,5,2,1
22,127,127,10,10,0,1,0
5,153,153,9,9,0,1,0
12,163,163,3,3,0,1,0
27,210,210,45,45,0,1,0
25,215,215,52,40,12,2,1
9,217,217,1,1,0,1,0
13,235,235,16,16,0,1,0
23,247,247,3,3,0,1,0
24,252,252,31,31,0,1,0
3,281,281,57,18,39,2,1
8,296,296,66,24,42,4,3
26,321,321,5,1,4,2,1
4,323,323,22,1,21,4,3
0,328,328,24,24,0,1,0
21,331,331,1,1,0,1,0
15,333,333,8,8,0,1,0
11,399,399,24,3,21,2,1
1,406,406,109,17,92,3,2
19,409,409,17,17,0,1,0
14,422,422,19,6,13,2,1
20,468,468,97,54,43,4,3
6,474,474,21,21,0,1,0
18,478,478,84,84,0,1,0
16,489,489,60,44,16,3,2

19,113,113,23,5,18,4,3
1,119,119,6,3,3,2,1
29,127,127,16,16,0,1,0
2,137,137,4,4,0,1,0
20,141,141,12,9,3,2,1
3,172,172,6,6,0,1,0
25,176,176,26,16,10,3,2
6,202,202,1,1,0,1,0
23,216,216,9,1,8,2,1
30,252,252,21,21,0,1,0
17,272,272,7,1,6,3,2
0,307,307,14,14,0,1,0
15,317,317,38,38,0,1,0
16,317,317,1,1,0,1,0
8,323,323,29,26,3,2,1
4,331,331,73,1,72,4,3
21,339,339,12,12,0,1,0
5,344,344,27,6,21,4,3
13,345,345,116,76,40,3,2
11,347,347,8,1,7,2,1
10,348,348,3,3,0,1,0
18,349,349,16,16,0,1,0
28,371,371,19,19,0,1,0
24,394,394,35,35,0,1,0
14,405,405,42,42,0,1,0
9,412,412,68,38,30,4,3
12,432,432,22,16,6,2,1
27,432,432,66,32,34,2,1
7,441,441,5,1,4,2,1
26,465,465,49,49,0,1,0
31,495,495,1,1,0,1,0
22,499,499,134,134,0,1,0

16,102,102,1,1,0,1,0
25,112,112,1,1,0,1,0
21,121,121,11,7,4,2,1
12,129,129,1,1,0,1,0
20,135,135,35,35,0,1,0
13,162,162,20,20,0,1,0
2,174,174,7,1,6,2,1
19,182,182,14,14,0,1,0
24,188,188,1,1,0,1,0
1,204,204,30,30,0,1,0
14,221,221,5,5,0,1,0
10,239,239,55,55,0,1,0
17,255,255,17,17,0,1,0
9,269,269,44,44,0,1,0
22,280,280,3,3,0,1,0
7,305,305,9,9,0,1,0
6,320,320,64,64,0,1,0
8,329,329,52,52,0,1,0
4,347,347,19,2,17,2,1
15,353,353,1,1,0,1,0
23,356,356,132,132,0,1,0
5,361,361,11,11,0,1,0
0,379,379,34,20,14,2,1
3,452,452,41,2,39,2,1
18,452,452,11,11,0,1,0
27,458,458,208,178,30,3,2
28,462,462,1,1,0,1,0
11,487,487,6,6,0,1,0
26,496,496,25,25,0,1,0

0,114,114,31,31,0,1,0
3,115,115,3,3,0,1,0
18,120,120,26,26,0,1,0
27,130,130,11,11,0,1,0
7,144,144,2,2,0,1,0
15,173,173,24,20,4,2,1
21,175,175,2,2,0,1,0
10,178,178,8,3,5,2,1
2,183,183,6,6,0,1,0
5,198,198,8,8,0,1,0
11,199,199,15,12,3,2,1
12,240,240,8,1,7,2,1
1,242,242,26,9,17,2,1
9,253,253,50,29,21,2,1
25,273,273,61,61,0,1,0
26,275,275,76,7,69,4,3
4,348,348,8,3,5,2,1
17,352,352,56,47,9,4,3
20,353,353,36,22,14,2,1
19,368,368,4,1,3,2,1
24,408,408,3,3,0,1,0
8,411,411,23,12,11,2,1
16,413,413,33,7,26,2,1
23,452,452,21,21,0,1,0
22,464,464,5,2,3,2,1
14,477,477,26,15,11,2,1
13,494,494,42,11,31,2,1
6,494,494,194,159,35,2,1

10,134,134,27,3,24,3,2
14,157,157,3,3,0,1,0
6,164,164,10,4,6,2,1
20,164,164,22,22,0,1,0
13,175,175,17,13,4,2,1
16,219,219,19,19,0,1,0
17,248,248,26,2,24,4,3
18,271,271,86,86,0,1,0
9,278,278,6,6,0,1,0
24,288,288,23,14,9,4,3
22,288,288,7,7,0,1,0
5,288,288,40,40,0,1,0
21,371,371,51,24,27,4,3
15,378,378,54,54,0,1,0
12,379,379,86,66,20,3,2
2,383,383,96,12,84,3,2
23,384,384,11,11,0,1,0
3,426,426,185,171,14,2,1
8,437,437,52,6,46,3,2
11,450,450,8,8,0,1,0
19,478,478,2,2,0,1,0
1,486,486,13,7,6,2,1
0,487,487,50,33,17,2,1
4,494,494,22,16,6,2,1
7,497,497,2,2,0,1,0

1,112,112,4,4,0,1,0
3,114,114,1,1,0,1,0
26,122,122,4,4,0,1,0
7,135,135,2,2,0,1,0
4,141,141,16,4,12,3,2
17,149,149,15,6,9,4,3
29,156,156,31,15,16,4,3
23,177,177,62,2,60,4,3
6,213,213,42,33,9,4,3
5,230,230,9,9,0,1,0
24,257,257,24,24,0,1,0
13,279,279,52,12,40,2,1
27,280,280,14,14,0,1,0
15,281,281,32,32,0,1,0
9,289,289,43,43,0,1,0
25,291,291,24,24,0,1,0
22,294,294,22,22,0,1,0
2,329,329,11,11,0,1,0
30,341,341,5,5,0,1,0
20,351,351,37,11,26,2,1
14,364,364,16,4,12,2,1
11,370,370,1,1,0,1,0
21,379,379,38,5,33,4,3
16,384,384,6,6,0,1,0
28,411,411,44,6,38,3,2
18,417,417,43,43,0,1,0
19,428,428,9,9,0,1,0
12,442,442,52,1,51,4,3
8,455,455,72,43,29,4,3
0,465,465,17,8,9,4,3
10,486,486,65,17,48,4,3

17,116,116,1,1,0,1,0
24,121,121,8,8,0,1,0
23,140,140,76,76,0,1,0
12,147,147,4,4,0,1,0
28,161,161,1,1,0,1,0
0,176,176,27,27,0,1,0
11,209,209,2,2,0,1,0
5,213,213,7,7,0,1,0
21,219,219,34,34,0,1,0
22,231,231,17,17,0,1,0
13,232,232,5,5,0,1,0
14,240,240,23,10,13,3,2
10,251,251,13,13,0,1,0
30,264,264,58,58,0,1,0
18,273,273,24,24,0,1,0
9,274,274,16,2,14,2,1
26,300,300,14,14,0,1,0
29,303,303,5,5,0,1,0
27,307,307,20,1,19,2,1
20,320,320,8,8,0,1,0
19,342,342,16,16,0,1,0
15,343,343,21,12,9,2,1
7,343,343,20,10,10,2,1
6,356,356,44,44,0,1,0
1,367,367,14,14,0,1,0
16,383,383,17,17,0,1,0
8,400,400,54,54,0,1,0
25,401,401,3,3,0,1,0
4,405,405,88,33,55,4,3
2,409,409,22,22,0,1,0
31,467,467,34,11,23,4,3
3,474,474,102,81,21,2,1

22,118,118,14,14,0,1,0
15,131,131,2,2,0,1,0
13,142,142,1,1,0,1,0
17,162,162,8,3,5,2,1
10,217,217,10,5,5,2,1
14,226,226,2,2,0,1,0
7,259,259,29,29,0,1,0
4,270,270,3,3,0,1,0
16,298,298,9,5,4,2,1
12,324,324,37,5,32,3,2
6,326,326,152,115,37,2,1
8,327,327,34,34,0,1,0
18,338,338,189,117,72,4,3
21,375,375,49,31,18,2,1
5,385,385,136,136,0,1,0
3,400,400,39,39,0,1,0
1,427,427,1,1,0,1,0
9,441,441,38,38,0,1,0
11,464,464,5,5,0,1,0
2,478,478,67,17,50,3,2
0,488,488,56,56,0,1,0
20,488,488,60,60,0,1,0
19,493,493,60,27,33,3,2

22,106,106,3,3,0,1,0
23,127,127,2,2,0,1,0
0,153,153,17,1,16,3,2
17,174,174,1,1,0,1,0
13,194,194,97,52,45,3,2
18,214,214,5,1,4,2,1
19,221,221,24,6,18,4,3
11,225,225,10,3,7,2,1
9,238,238,78,78,0,1,0
14,241,241,29,6,23,2,1
26,244,244,31,6,25,4,3
4,271,271,2,2,0,1,0
7,274,274,55,9,46,3,2
12,293,293,1,1,0,1,0
10,363,363,89,23,66,4,3
6,385,385,6,6,0,1,0
3,403,403,75,60,15,2,1
15,419,419,102,102,0,1,0
16,430,430,54,10,44,2,1
2,432,432,71,28,43,2,1
8,440,440,1,1,0,1,0
24,444,444,9,9,0,1,0
5,473,473,22,2,20,3,2
20,480,480,37,19,18,3,2
25,481,481,4,4,0,1,0
21,482,482,8,8,0,1,0
1,483,483,22,22,0,1,0

21,116,116,4,4,0,1,0
7,149,149,10,2,8,3,2
18,149,149,3,3,0,1,0
23,163,163,7,7,0,1,0
19,166,166,30,30,0,1,0
8,169,169,1,1,0,1,0
11,198,198,35,35,0,1,0
22,232,232,86,86,0,1,0
14,233,233,40,40,0,1,0
9,241,241,9,6,3,2,1
1,272,272,37,17,20,2,1
16,306,306,7,2,5,2,1
4,324,324,40,27,13,2,1
24,326,326,1,1,0,1,0
15,329,329,13,13,0,1,0
2,331,331,81,81,0,1,0
10,342,342,92,8,84,3,2
12,361,361,93,84,9,4,3
20,370,370,3,3,0,1,0
17,371,371,20,8,12,2,1
0,373,373,26,13,13,2,1
5,405,405,92,27,65,4,3
6,417,417,48,2,46,2,1
13,468,468,24,24,0,1,0
3,480,480,51,51,0,1,0

11,131,131,7,3,4,2,1
22,151,151,21,5,16,2,1
10,151,151,3,3,0,1,0
17,161,161,25,25,0,1,0
6,161,161,11,3,8,3,2
9,163,163,29,29,0,1,0
31,180,180,4,4,0,1,0
33,231,231,31,31,0,1,0
29,233,233,5,5,0,1,0
21,239,239,7,1,6,3,2
15,242,242,7,7,0,1,0
14,250,250,18,18,0,1,0
19,267,267,10,10,0,1,0
3,279,279,4,4,0,1,0
36,281,281,1,1,0,1,0
32,290,290,2,2,0,1,0
25,313,313,74,62,12,2,1
27,322,322,69,69,0,1,0
28,322,322,60,20,40,3,2
1,328,328,20,20,0,1,0
0,345,345,5,5,0,1,0
23,353,353,35,35,0,1,0
7,356,356,43,27,16,3,2
35,358,358,55,27,28,2,1
20,373,373,8,8,0,1,0
16,380,380,7,1,6,2,1
34,404,404,106,106,0,1,0
5,424,424,47,35,12,4,3
18,426,426,29,2,27,4,3
30,428,428,4,4,0,1,0
2,433,433,5,1,4,2,1
4,436,436,28,7,21,2,1
13,444,444,5,2,3,2,1
12,451,451,17,17,0,1,0
8,468,468,33,33,0,1,0
24,469,469,19,7,12,4,3
26,473,473,18,18,0,1,0

4,100,100,1,1,0,1,0
21,101,101,6,6,0,1,0
10,103,103,10,10,0,1,0
6,126,126,25,25,0,1,0
26,140,140,9,1,8,3,2
16,142,142,17,17,0,1,0
31,149,149,5,2,3,2,1
0,164,164,6,6,0,1,0
5,174,174,10,2,8,2,1
36,178,178,25,22,3,2,1
3,195,195,8,8,0,1,0
15,207,207,6,6,0,1,0
18,223,223,8,1,7,2,1
28,228,228,106,80,26,2,1
7,231,231,4,4,0,1,0
29,250,250,16,11,5,2,1
13,262,262,4,4,0,1,0
38,270,270,9,9,0,1,0
25,285,285,17,14,3,2,1
35,320,320,39,39,0,1,0
20,324,324,50,20,30,4,3
34,324,324,24,14,10,2,1
37,330,330,10,4,6,3,2
19,334,334,5,2,3,2,1
30,339,339,28,28,0,1,0
39,345,345,32,8,24,2,1
17,355,355,2,2,0,1,0
14,355,355,1,1,0,1,0
27,361,361,10,10,0,1,0
9,371,371,34,11,23,2,1
8,371,371,19,4,15,2,1
11,374,374,2,2,0,1,0
2,384,384,16,16,0,1,0
33,387,387,28,18,10,2,1
1,415,415,14,8,6,2,1
22,420,420,62,8,54,4,3
12,422,422,28,28,0,1,0
24,458,458,3,3,0,1,0
23,477,477,1,1,0,1,0
32,481,481,61,19,42,2,1

13,106,106,6,2,4,2,1
18,146,146,21,1,20,3,2
15,150,150,16,8,8,2,1
25,153,153,2,2,0,1,0
16,179,179,12,5,7,2,1
26,183,183,13,13,0,1,0
3,194,194,27,27,0,1,0
19,194,194,15,15,0,1,0
1,195,195,12,8,4,2,1
7,196,196,11,3,8,2,1
24,214,214,31,31,0,1,0
23,246,246,19,19,0,1,0
10,277,277,28,28,0,1,0
4,278,278,5,5,0,1,0
22,293,293,130,130,0,1,0
5,300,300,90,4,86,3,2
21,304,304,15,8,7,2,1
12,318,318,5,5,0,1,0
17,345,345,8,8,0,1,0
2,377,377,54,23,31,2,1
14,386,386,36,36,0,1,0
20,405,405,26,2,24,3,2
8,443,443,31,31,0,1,0
6,454,454,3,3,0,1,0
9,466,466,1,1,0,1,0
11,473,473,52,38,14,3,2
0,487,487,184,158,26,3,2

4,117,117,11,11,0,1,0
16,146,146,18,18,0,1,0
7,147,147,1,1,0,1,0
18,153,153,12,2,10,2,1
2,165,165,5,1,4,2,1
8,186,186,5,5,0,1,0
22,197,197,23,23,0,1,0
26,206,206,49,23,26,2,1
17,207,207,16,16,0,1,0
23,239,239,57,37,20,3,2
19,241,241,6,6,0,1,0
28,267,267,4,4,0,1,0
21,282,282,43,36,7,2,1
24,286,286,31,13,18,2,1
20,288,288,14,14,0,1,0
11,300,300,111,96,15,4,3
14,320,320,75,3,72,4,3
27,385,385,20,20,0,1,0
25,395,395,21,21,0,1,0
10,410,410,13,13,0,1,0
15,420,420,120,11,109,4,3
12,422,422,38,38,0,1,0
29,430,430,44,44,0,1,0
1,433,433,1,1,0,1,0
3,434,434,4,4,0,1,0
6,440,440,25,15,10,2,1
0,451,451,21,21,0,1,0
5,481,481,2,2,0,1,0
9,484,484,14,14,0,1,0
13,490,490,41,20,21,4,3

3,104,104,8,8,0,1,0
10,120,120,6,3,3,2,1
7,165,165,39,4,35,3,2
28,193,193,23,14,9,4,3
5,228,228,9,9,0,1,0
13,266,266,5,5,0,1,0
19,271,271,23,23,0,1,0
20,282,282,29,29,0,1,0
4,284,284,40,14,26,3,2
22,287,287,36,36,0,1,0
0,316,316,10,10,0,1,0
16,316,316,23,6,17,3,2
15,318,318,56,56,0,1,0
27,331,331,28,28,0,1,0
21,340,340,45,45,0,1,0
1,343,343,45,12,33,2,1
11,345,345,80,42,38,3,2
26,348,348,26,5,21,4,3
17,369,369,2,2,0,1,0
12,379,379,59,32,27,2,1
23,385,385,8,8,0,1,0
25,401,401,90,90,0,1,0
9,411,411,56,56,0,1,0
14,426,426,3,3,0,1,0
24,451,451,78,46,32,3,2
18,461,461,10,10,0,1,0
6,486,486,17,17,0,1,0
2,488,488,5,5,0,1,0
8,496,496,50,50,0,1,0

10,101,101,1,1,0,1,0
6,106,106,2,2,0,1,0
13,134,134,40,26,14,2,1
19,154,154,9,3,6,3,2
2,155,155,6,6,0,1,0
5,162,162,13,10,3,2,1
0,175,175,64,4,60,4,3
14,189,189,24,24,0,1,0
21,246,246,5,5,0,1,0
8,270,270,110,110,0,1,0
16,309,309,27,6,21,2,1
7,313,313,1,1,0,1,0
9,337,337,50,11,39,2,1
20,342,342,41,41,0,1,0
12,374,374,68,68,0,1,0
18,377,377,61,61,0,1,0
17,396,396,11,2,9,2,1
11,400,400,11,8,3,2,1
3,405,405,44,44,0,1,0
22,413,413,45,45,0,1,0
4,422,422,68,68,0,1,0
1,458,458,30,3,27,4,3
24,464,464,13,13,0,1,0
15,494,494,74,74,0,1,0
23,496,496,14,14,0,1,0

16,127,127,2,2,0,1,0
6,130,130,2,2,0,1,0
13,133,133,36,8,28,3,2
18,139,139,4,4,0,1,0
22,140,140,25,25,0,1,0
19,146,146,6,6,0,1,0
26,155,155,33,25,8,3,2
10,156,156,2,2,0,1,0
17,157,157,41,41,0,1,0
5,167,167,11,5,6,2,1
32,185,185,20,8,12,2,1
28,186,186,19,19,0,1,0
20,216,216,18,6,12,4,3
2,217,217,1,1,0,1,0
7,221,221,26,26,0,1,0
29,261,261,27,27,0,1,0
4,292,292,85,1,84,4,3
11,309,309,16,4,12,3,2
9,313,313,5,5,0,1,0
0,328,328,1,1,0,1,0
30,328,328,19,5,14,2,1
15,342,342,5,2,3,2,1
27,352,352,30,5,25,2,1
25,356,356,14,5,9,4,3
23,363,363,3,3,0,1,0
1,391,391,1,1,0,1,0
14,408,408,7,7,0,1,0
8,421,421,72,20,52,3,2
24,422,422,50,13,37,3,2
21,431,431,43,43,0,1,0
12,437,437,1,1,0,1,0
3,441,441,1,1,0,1,0
33,449,449,22,7,15,2,1
31,467,467,85,85,0,1,0

24,117,117,13,5,8,3,2
12,119,119,12,12,0,1,0
3,124,124,5,5,0,1,0
25,156,156,10,3,7,2,1
9,175,175,6,6,0,1,0
19,176,176,14,7,7,2,1
16,187,187,7,7,0,1,0
22,219,219,21,6,15,4,3
18,222,222,5,5,0,1,0
2,230,230,5,5,0,1,0
21,244,244,17,5,12,2,1
0,285,285,6,6,0,1,0
4,287,287,85,28,57,4,3
7,295,295,1,1,0,1,0
11,320,320,162,111,51,4,3
5,322,322,26,26,0,1,0
23,345,345,36,36,0,1,0
14,346,346,83,45,38,2,1
20,346,346,43,8,35,4,3
1,402,402,33,33,0,1,0
13,417,417,25,8,17,4,3
17,458,458,109,95,14,2,1
15,469,469,39,39,0,1,0
6,473,473,19,19,0,1,0
8,479,479,27,27,0,1,0
10,494,494,108,68,40,3,2

16,105,105,2,2,0,1,0
0,147,147,18,18,0,1,0
2,162,162,6,6,0,1,0
12,175,175,25,4,21,2,1
3,186,186,84,3,81,4,3
22,202,202,69,64,5,2,1
11,204,204,60,60,0,1,0
5,207,207,41,20,21,4,3
23,219,219,1,1,0,1,0
15,223,223,19,19,0,1,0
19,226,226,12,12,0,1,0
1,228,228,26,3,23,2,1
14,249,249,16,16,0,1,0
7,267,267,4,4,0,1,0
18,281,281,14,14,0,1,0
21,285,285,16,16,0,1,0
4,292,292,53,53,0,1,0
8,324,324,6,6,0,1,0
24,377,377,15,8,7,2,1
20,383,383,75,31,44,3,2
13,412,412,4,4,0,1,0
10,434,434,99,72,27,2,1
17,436,436,32,32,0,1,0
9,445,445,2,2,0,1,0
6,458,458,14,14,0,1,0

5,105,105,17,17,0,1,0
11,204,204,12,12,0,1,0
6,215,215,20,5,15,4,3
16,227,227,27,27,0,1,0
4,235,235,16,16,0,1,0
22,236,236,7,7,0,1,0
21,239,239,19,4,15,4,3
28,253,253,17,7,10,2,1
18,259,259,27,14,13,2,1
7,263,263,72,72,0,1,0
27,267,267,64,64,0,1,0
26,278,278,30,30,0,1,0
20,295,295,22,2,20,3,2
23,295,295,31,4,27,4,3
15,297,297,28,23,5,2,1
8,321,321,4,4,0,1,0
24,325,325,14,7,7,2,1
10,327,327,10,10,0,1,0
9,344,344,9,1,8,3,2
1,353,353,36,36,0,1,0
25,387,387,49,49,0,1,0
14,399,399,44,44,0,1,0
13,422,422,81,47,34,2,1
2,423,423,41,41,0,1,0
3,448,448,35,35,0,1,0
0,448,448,16,16,0,1,0
12,463,463,28,28,0,1,0
19,487,487,52,52,0,1,0
17,494,494,62,62,0,1,0

13,134,134,2,2,0,1,0
8,141,141,10,10,0,1,0
30,143,143,1,1,0,1,0
23,147,147,24,10,14,3,2
0,174,174,23,4,19,2,1
19,199,199,19,19,0,1,0
14,204,204,2,2,0,1,0
16,220,220,14,9,5,2,1
26,228,228,37,31,6,3,2
7,228,228,15,15,0,1,0
11,229,229,7,7,0,1,0
17,235,235,49,37,12,4,3
21,265,265,5,5,0,1,0
2,278,278,12,12,0,1,0
15,302,302,6,1,5,2,1
25,314,314,43,43,0,1,0
3,314,314,26,26,0,1,0
4,351,351,31,15,16,2,1
6,361,361,29,21,8,2,1
27,368,368,18,5,13,2,1
12,390,390,43,5,38,2,1
10,415,415,55,16,39,4,3
20,417,417,84,84,0,1,0
18,419,419,19,19,0,1,0
22,419,419,182,170,12,3,2
9,423,423,3,3,0,1,0
31,435,435,3,3,0,1,0
5,441,441,61,61,0,1,0
1,442,442,45,8,37,4,3
28,449,449,4,4,0,1,0
29,487,487,23,11,12,4,3
24,488,488,25,7,18,3,2

17,102,102,2,2,0,1,0
13,114,114,7,7,0,1,0
25,134,134,11,2,9,2,1
28,135,135,35,35,0,1,0
6,156,156,1,1,0,1,0
2,179,179,10,10,0,1,0
7,183,183,21,21,0,1,0
27,184,184,5,5,0,1,0
21,197,197,6,6,0,1,0
3,230,230,13,1,12,2,1
29,259,259,27,1,26,3,2
30,262,262,35,20,15,2,1
10,265,265,17,12,5,2,1
15,274,274,42,42,0,1,0
9,295,295,25,10,15,2,1
11,299,299,2,2,0,1,0
20,307,307,2,2,0,1,0
1,309,309,9,9,0,1,0
0,326,326,8,8,0,1,0
26,328,328,21,21,0,1,0
19,332,332,33,33,0,1,0
32,348,348,22,7,15,4,3
14,349,349,48,12,36,2,1
16,357,357,29,29,0,1,0
22,361,361,18,9,9,2,1
18,371,371,13,13,0,1,0
31,392,392,24,24,0,1,0
4,396,396,135,45,90,4,3
12,402,402,30,30,0,1,0
24,428,428,152,65,87,4,3
23,440,440,41,17,24,4,3
8,486,486,14,14,0,1,0
5,494,494,13,2,11,2,1

1,111,111,1,1,0,1,0
23,122,122,28,21,7,2,1
2,163,163,7,3,4,2,1
10,201,201,89,89,0,1,0
0,206,206,13,13,0,1,0
3,210,210,41,41,0,1,0
17,222,222,16,7,9,4,3
5,223,223,9,1,8,3,2
16,225,225,15,15,0,1,0
22,237,237,16,1,15,4,3
7,258,258,20,20,0,1,0
21,267,267,36,36,0,1,0
8,273,273,10,2,8,3,2
19,282,282,76,76,0,1,0
4,316,316,30,30,0,1,0
12,321,321,16,7,9,2,1
13,334,334,6,6,0,1,0
14,343,343,22,22,0,1,0
9,349,349,96,91,5,2,1
24,406,406,10,10,0,1,0
11,413,413,41,11,30,4,3
6,436,436,11,1,10,2,1
15,452,452,75,75,0,1,0
18,477,477,4,1,3,2,1
20,482,482,35,25,10,2,1
25,489,489,89,89,0,1,0

7,115,115,25,7,18,2,1
22,120,120,12,6,6,2,1
8,166,166,28,28,0,1,0
4,175,175,14,7,7,2,1
1,229,229,36,22,14,3,2
5,241,241,54,6,48,3,2
20,292,292,13,13,0,1,0
6,302,302,37,17,20,2,1
18,312,312,26,26,0,1,0
2,319,319,2,2,0,1,0
15,330,330,31,23,8,2,1
23,332,332,104,52,52,4,3
12,351,351,35,29,6,2,1
0,359,359,20,8,12,3,2
17,367,367,41,41,0,1,0
13,405,405,21,11,10,2,1
16,406,406,12,4,8,3,2
9,407,407,10,10,0,1,0
14,409,409,33,12,21,2,1
24,421,421,85,1,84,4,3
3,422,422,75,65,10,2,1
21,425,425,43,43,0,1,0
10,441,441,74,74,0,1,0
19,485,485,28,20,8,2,1
11,489,489,25,1,24,4,3

3,106,106,8,8,0,1,0
21,127,127,4,4,0,1,0
17,128,128,6,6,0,1,0
13,134,134,5,5,0,1,0
25,152,152,19,14,5,2,1
27,159,159,15,6,9,4,3
29,160,160,16,2,14,2,1
23,163,163,9,9,0,1,0
28,174,174,4,4,0,1,0
10,189,189,2,2,0,1,0
6,200,200,9,9,0,1,0
2,201,201,1,1,0,1,0
11,206,206,65,56,9,2,1
22,243,243,52,52,0,1,0
16,253,253,15,15,0,1,0
24,265,265,3,3,0,1,0
7,288,288,15,4,11,2,1
12,295,295,41,29,12,3,2
20,305,305,66,59,7,2,1
19,323,323,12,12,0,1,0
9,344,344,36,24,12,4,3
8,353,353,21,21,0,1,0
14,383,383,1,1,0,1,0
5,412,412,59,17,42,4,3
4,439,439,24,24,0,1,0
1,449,449,7,7,0,1,0
30,462,462,89,89,0,1,0
18,462,462,94,13,81,4,3
15,465,465,96,96,0,1,0
0,483,483,36,10,26,3,2
26,492,492,38,1,37,4,3

13,107,107,10,10,0,1,0
16,110,110,5,5,0,1,0
20,184,184,69,69,0,1,0
1,202,202,9,9,0,1,0
9,207,207,40,40,0,1,0
22,215,215,6,6,0,1,0
18,220,220,9,9,0,1,0
15,223,223,3,3,0,1,0
14,238,238,27,5,22,3,2
3,242,242,10,10,0,1,0
17,254,254,28,28,0,1,0
7,307,307,9,9,0,1,0
11,315,315,14,6,8,3,2
2,333,333,52,52,0,1,0
10,335,335,11,11,0,1,0
6,347,347,80,4,76,4,3
0,364,364,77,77,0,1,0
19,380,380,96,89,7,2,1
5,381,381,118,92,26,3,2
8,402,402,18,2,16,3,2
23,431,431,34,34,0,1,0
12,475,475,45,45,0,1,0
4,482,482,68,68,0,1,0
21,489,489,51,21,30,4,3

25,117,117,18,18,0,1,0
8,139,139,8,8,0,1,0
18,140,140,4,1,3,2,1
4,141,141,5,5,0,1,0
14,154,154,3,3,0,1,0
15,165,165,9,9,0,1,0
3,195,195,28,6,22,2,1
28,220,220,64,54,10,2,1
0,224,224,1,1,0,1,0
22,249,249,13,13,0,1,0
1,263,263,9,9,0,1,0
21,282,282,25,25,0,1,0
9,283,283,13,13,0,1,0
12,296,296,3,3,0,1,0
31,312,312,24,7,17,2,1
7,312,312,10,10,0,1,0
20,324,324,37,37,0,1,0
17,332,332,36,17,19,3,2
30,340,340,130,38,92,3,2
23,351,351,10,10,0,1,0
29,363,363,3,3,0,1,0
10,407,407,43,43,0,1,0
13,424,424,12,12,0,1,0
6,425,425,80,6,74,3,2
16,428,428,163,43,120,4,3
19,456,456,46,37,9,2,1
26,463,463,7,1,6,2,1
5,469,469,37,31,6,2,1
11,483,483,14,14,0,1,0
27,488,488,22,18,4,2,1
2,497,497,22,22,0,1,0
24,499,499,21,21,0,1,0

31,112,112,23,5,18,2,1
16,115,115,4,4,0,1,0
5,125,125,1,1,0,1,0
2,156,156,1,1,0,1,0
11,184,184,4,4,0,1,0
25,189,189,31,9,22,2,1
20,196,196,7,7,0,1,0
30,232,232,13,9,4,2,1
0,234,234,64,40,24,4,3
22,261,261,22,4,18,3,2
3,277,277,16,3,13,2,1
28,282,282,12,12,0,1,0
33,290,290,47,47,0,1,0
13,291,291,41,35,6,2,1
27,299,299,26,26,0,1,0
9,327,327,29,29,0,1,0
8,343,343,18,8,10,2,1
17,345,345,20,20,0,1,0
7,352,352,4,4,0,1,0
15,360,360,54,27,27,2,1
1,364,364,1,1,0,1,0
29,376,376,30,21,9,4,3
4,392,392,7,1,6,3,2
26,401,401,18,18,0,1,0
14,415,415,77,77,0,1,0
12,419,419,23,7,16,3,2
32,425,425,46,37,9,3,2
18,426,426,16,7,9,4,3
6,429,429,51,51,0,1,0
34,439,439,40,40,0,1,0
23,445,445,57,46,11,2,1
19,445,445,6,2,4,2,1
24,484,484,20,20,0,1,0
10,486,486,15,9,6,2,1
21,492,492,64,4,60,4,3

0,107,107,10,7,3,2,1
15,126,126,20,20,0,1,0
12,135,135,19,15,4,2,1
19,142,142,21,21,0,1,0
20,152,152,2,2,0,1,0
21,157,157,4,4,0,1,0
13,204,204,3,3,0,1,0
17,205,205,24,24,0,1,0
2,206,206,58,37,21,2,1
10,209,209,2,2,0,1,0
16,298,298,35,35,0,1,0
6,303,303,33,33,0,1,0
24,317,317,1,1,0,1,0
8,357,357,2,2,0,1,0
7,365,365,138,138,0,1,0
5,369,369,22,5,17,2,1
1,372,372,120,104,16,3,2
18,376,376,59,59,0,1,0
3,377,377,23,23,0,1,0
9,392,392,21,2,19,2,1
11,399,399,95,95,0,1,0
4,416,416,12,7,5,2,1
14,421,421,75,63,12,4,3
22,453,453,29,29,0,1,0
23,462,462,24,24,0,1,0

0,115,115,35,35,0,1,0
9,115,115,1,1,0,1,0
11,138,138,27,16,11,2,1
15,153,153,12,3,9,2,1
25,155,155,49,49,0,1,0
21,184,184,4,4,0,1,0
3,189,189,15,15,0,1,0
1,195,195,4,1,3,2,1
16,195,195,33,33,0,1,0
10,240,240,49,37,12,4,3
5,254,254,57,16,41,2,1
2,270,270,16,16,0,1,0
6,281,281,28,7,21,4,3
22,313,313,63,63,0,1,0
4,318,318,23,5,18,4,3
24,323,323,9,3,6,3,2
8,328,328,41,24,17,2,1
18,348,348,20,20,0,1,0
19,393,393,2,2,0,1,0
14,393,393,86,4,82,4,3
12,394,394,1,1,0,1,0
23,417,417,13,13,0,1,0
13,425,425,15,11,4,2,1
20,444,444,44,20,24,4,3
17,448,448,74,54,20,3,2
7,482,482,5,5,0,1,0

26,109,109,19,19,0,1,0
20,137,137,29,29,0,1,0
31,144,144,10,2,8,2,1
15,155,155,12,4,8,3,2
21,167,167,4,4,0,1,0
5,171,171,7,7,0,1,0
33,173,173,5,5,0,1,0
2,183,183,5,1,4,2,1
7,194,194,23,1,22,4,3
8,233,233,3,3,0,1,0
19,239,239,17,4,13,2,1
10,239,239,9,4,5,2,1
4,239,239,7,2,5,2,1
17,251,251,7,4,3,2,1
30,261,261,1,1,0,1,0
32,264,264,29,29,0,1,0
13,280,280,22,6,16,3,2
23,303,303,6,6,0,1,0
0,307,307,6,1,5,2,1
9,312,312,76,32,44,4,3
27,335,335,11,5,6,3,2
1,338,338,32,32,0,1,0
25,354,354,118,80,38,4,3
11,376,376,42,42,0,1,0
18,389,389,11,11,0,1,0
28,392,392,53,35,18,2,1
14,431,431,127,52,75,4,3
22,434,434,3,3,0,1,0
16,443,443,5,5,0,1,0
6,447,447,9,5,4,2,1
24,463,463,58,32,26,4,3
29,471,471,75,53,22,3,2
3,480,480,27,27,0,1,0
12,489,489,1,1,0,1,0

21,108,108,1,1,0,1,0
14,109,109,6,6,0,1,0
10,141,141,21,21,0,1,0
2,159,159,2,2,0,1,0
9,171,171,22,22,0,1,0
18,175,175,49,49,0,1,0
5,185,185,2,2,0,1,0
1,190,190,11,4,7,2,1
13,208,208,4,4,0,1,0
7,213,213,15,15,0,1,0
23,216,216,9,1,8,2,1
11,256,256,78,66,12,4,3
6,289,289,27,27,0,1,0
8,303,303,26,14,12,4,3
4,331,331,86,48,38,2,1
12,351,351,2,2,0,1,0
22,353,353,16,5,11,2,1
15,355,355,88,88,0,1,0
20,361,361,23,23,0,1,0
0,396,396,3,3,0,1,0
25,398,398,52,18,34,2,1
17,404,404,39,39,0,1,0
16,441,441,31,1,30,3,2
3,443,443,98,50,48,4,3
19,452,452,58,58,0,1,0
24,478,478,112,105,7,2,1

24,124,124,6,3,3,2,1
7,126,126,11,11,0,1,0
23,140,140,40,40,0,1,0
6,164,164,8,8,0,1,0
11,175,175,9,3,6,2,1
4,180,180,7,1,6,3,2
22,193,193,25,25,0,1,0
18,210,210,43,7,36,3,2
25,242,242,24,24,0,1,0
8,260,260,10,7,3,2,1
26,263,263,4,4,0,1,0
12,270,270,1,1,0,1,0
21,277,277,9,3,6,2,1
10,278,278,50,50,0,1,0
3,284,284,37,7,30,4,3
27,298,298,50,50,0,1,0
16,316,316,51,51,0,1,0
13,335,335,41,27,14,2,1
28,339,339,16,16,0,1,0
0,352,352,18,7,11,2,1
5,377,377,100,100,0,1,0
19,381,381,25,13,12,2,1
9,408,408,1,1,0,1,0
2,410,410,15,15,0,1,0
1,423,423,93,24,69,4,3
29,433,433,10,10,0,1,0
17,437,437,25,10,15,4,3
15,448,448,46,46,0,1,0
14,487,487,11,11,0,1,0
20,488,488,45,6,39,4,3

16,151,151,18,18,0,1,0
11,159,159,6,6,0,1,0
14,176,176,72,4,68,3,2
2,191,191,42,42,0,1,0
4,192,192,70,52,18,4,3
17,207,207,34,34,0,1,0
6,211,211,87,44,43,3,2
1,225,225,8,8,0,1,0
20,241,241,12,3,9,2,1
23,242,242,22,16,6,2,1
15,274,274,37,37,0,1,0
5,319,319,39,39,0,1,0
9,321,321,34,8,26,2,1
10,337,337,1,1,0,1,0
12,362,362,22,8,14,2,1
0,390,390,17,17,0,1,0
18,400,400,78,78,0,1,0
19,413,413,47,47,0,1,0
8,422,422,1,1,0,1,0
22,431,431,1,1,0,1,0
21,441,441,8,2,6,3,2
13,466,466,13,13,0,1,0
7,480,480,42,42,0,1,0
3,491,491,4,4,0,1,0

0,120,120,4,4,0,1,0
13,135,135,13,13,0,1,0
24,137,137,3,3,0,1,0
34,140,140,13,13,0,1,0
16,150,150,4,4,0,1,0
19,150,150,5,5,0,1,0
3,181,181,15,15,0,1,0
4,182,182,14,14,0,1,0
10,182,182,1,1,0,1,0
18,186,186,19,4,15,2,1
15,200,200,17,17,0,1,0
23,203,203,20,5,15,3,2
33,205,205,6,6,0,1,0
29,211,211,4,4,0,1,0
30,227,227,18,3,15,2,1
7,237,237,9,9,0,1,0
14,245,245,1,1,0,1,0
17,247,247,33,18,15,2,1
32,267,267,51,13,38,3,2
6,308,308,60,45,15,2,1
2,308,308,6,3,3,2,1
27,309,309,17,17,0,1,0
21,311,311,11,1,10,2,1
5,323,323,1,1,0,1,0
22,328,328,43,7,36,3,2
12,393,393,43,8,35,2,1
20,402,402,25,25,0,1,0
28,430,430,167,61,106,4,3
1,442,442,35,35,0,1,0
26,459,459,32,11,21,2,1
9,464,464,12,12,0,1,0
8,465,465,70,70,0,1,0
25,494,494,64,40,24,2,1
11,495,495,19,19,0,1,0
31,499,499,43,6,37,2,1

0,108,108,12,12,0,1,0
15,125,125,8,5,3,2,1
21,127,127,21,21,0,1,0
1,137,137,21,13,8,3,2
5,154,154,30,30,0,1,0
18,187,187,7,1,6,2,1
17,192,192,1,1,0,1,0
8,234,234,22,3,19,4,3
10,234,234,7,7,0,1,0
11,246,246,2,2,0,1,0
23,250,250,7,7,0,1,0
9,267,267,34,20,14,3,2
24,293,293,26,2,24,2,1
6,298,298,8,1,7,2,1
20,312,312,15,5,10,2,1
14,358,358,5,5,0,1,0
7,379,379,75,75,0,1,0
3,388,388,39,30,9,4,3
26,397,397,89,55,34,4,3
13,406,406,18,15,3,2,1
19,411,411,79,16,63,4,3
12,412,412,7,7,0,1,0
22,422,422,149,149,0,1,0
25,430,430,18,10,8,2,1
16,436,436,31,11,20,3,2
4,440,440,111,5,106,4,3
2,471,471,21,11,10,3,2
27,494,494,45,45,0,1,0

23,107,107,7,3,4,2,1
12,129,129,14,14,0,1,0
16,141,141,30,30,0,1,0
2,149,149,16,2,14,2,1
11,156,156,1,1,0,1,0
10,157,157,20,2,18,2,1
20,166,166,21,13,8,2,1
3,185,185,20,6,14,3,2
14,211,211,4,4,0,1,0
13,223,223,13,3,10,3,2
25,223,223,43,43,0,1,0
19,233,233,22,22,0,1,0
8,234,234,4,4,0,1,0
6,264,264,27,12,15,2,1
18,294,294,12,5,7,2,1
32,307,307,25,25,0,1,0
17,316,316,57,57,0,1,0
30,324,324,33,33,0,1,0
9,328,328,11,11,0,1,0
0,340,340,19,6,13,3,2
7,344,344,3,3,0,1,0
1,345,345,15,15,0,1,0
27,351,351,17,4,13,2,1
28,360,360,5,5,0,1,0
29,430,430,36,36,0,1,0
21,456,456,41,38,3,2,1
4,457,457,26,11,15,2,1
31,461,461,52,52,0,1,0
15,470,470,8,8,0,1,0
5,477,477,47,13,34,4,3
22,492,492,113,43,70,4,3
24,495,495,43,43,0,1,0
26,498,498,47,47,0,1,0

16,107,107,6,1,5,2,1
11,124,124,7,4,3,2,1
30,126,126,10,10,0,1,0
23,139,139,15,15,0,1,0
12,149,149,6,6,0,1,0
6,154,154,18,8,10,2,1
33,162,162,13,5,8,2,1
0,168,168,15,1,14,3,2
5,170,170,8,8,0,1,0
15,187,187,6,6,0,1,0
9,209,209,1,1,0,1,0
10,210,210,7,7,0,1,0
1,221,221,38,13,25,4,3
19,223,223,40,9,31,2,1
25,262,262,94,94,0,1,0
14,264,264,11,4,7,2,1
31,268,268,31,31,0,1,0
22,278,278,13,13,0,1,0
3,285,285,5,5,0,1,0
20,293,293,19,9,10,3,2
4,302,302,18,18,0,1,0
26,308,308,56,20,36,4,3
27,312,312,29,29,0,1,0
18,317,317,31,31,0,1,0
21,360,360,7,3,4,2,1
28,378,378,16,13,3,2,1
7,383,383,8,8,0,1,0
8,448,448,47,47,0,1,0
2,448,448,5,5,0,1,0
32,455,455,64,4,60,4,3
29,481,481,23,8,15,2,1
24,488,488,28,10,18,4,3
17,491,491,73,35,38,3,2
13,494,494,36,4,32,3,2

7,139,139,4,4,0,1,0
16,210,210,47,21,26,3,2
15,227,227,8,8,0,1,0
3,236,236,80,4,76,3,2
6,245,245,6,3,3,2,1
14,332,332,30,30,0,1,0
17,381,381,49,49,0,1,0
9,383,383,13,6,7,2,1
11,384,384,17,3,14,2,1
4,387,387,164,55,109,4,3
2,392,392,15,15,0,1,0
19,401,401,31,1,30,3,2
8,411,411,49,24,25,3,2
10,414,414,59,59,0,1,0
1,431,431,32,32,0,1,0
0,460,460,156,105,51,4,3
18,460,460,167,140,27,2,1
12,471,471,47,47,0,1,0
13,481,481,4,4,0,1,0
5,494,494,92,71,21,4,3

4,126,126,7,7,0,1,0
3,146,146,7,1,6,2,1
19,148,148,29,14,15,3,2
11,166,166,29,29,0,1,0
13,170,170,27,6,21,2,1
16,175,175,16,16,0,1,0
21,181,181,4,4,0,1,0
2,190,190,52,52,0,1,0
24,194,194,46,3,43,2,1
22,209,209,19,19,0,1,0
17,212,212,17,3,14,3,2
18,213,213,1,1,0,1,0
6,231,231,79,79,0,1,0
0,238,238,29,29,0,1,0
20,244,244,23,15,8,2,1
1,282,282,11,11,0,1,0
14,282,282,12,12,0,1,0
23,365,365,5,1,4,2,1
15,382,382,87,51,36,4,3
5,390,390,45,35,10,2,1
10,392,392,34,7,27,4,3
8,395,395,27,3,24,3,2
9,417,417,16,3,13,2,1
25,442,442,55,22,33,3,2
7,463,463,17,5,12,4,3
12,494,494,22,22,0,1,0

21,109,109,3,3,0,1,0
10,156,156,15,3,12,4,3
17,170,170,1,1,0,1,0
18,175,175,2,2,0,1,0
11,193,193,29,6,23,2,1
29,198,198,37,37,0,1,0
2,201,201,3,3,0,1,0
19,223,223,5,5,0,1,0
31,223,223,10,10,0,1,0
30,225,225,97,97,0,1,0
25,231,231,36,14,22,2,1
22,232,232,31,19,12,4,3
12,234,234,1,1,0,1,0
8,240,240,28,28,0,1,0
24,240,240,18,18,0,1,0
5,242,242,2,2,0,1,0
27,247,247,2,2,0,1,0
23,263,263,4,4,0,1,0
1,299,299,1,1,0,1,0
4,311,311,7,7,0,1,0
7,337,337,1,1,0,1,0
20,344,344,28,28,0,1,0
26,356,356,13,13,0,1,0
0,358,358,2,2,0,1,0
32,388,388,46,24,22,2,1
16,397,397,76,76,0,1,0
3,432,432,74,49,25,4,3
9,465,465,3,3,0,1,0
13,476,476,65,33,32,3,2
14,483,483,38,38,0,1,0
28,486,486,45,16,29,2,1
6,487,487,106,82,24,4,3
15,491,491,77,47,30,2,1

14,109,109,21,21,0,1,0
16,111,111,2,2,0,1,0
13,160,160,14,14,0,1,0
23,164,164,20,20,0,1,0
4,169,169,13,7,6,3,2
0,181,181,39,28,11,2,1
19,192,192,15,5,10,3,2
12,194,194,16,16,0,1,0
1,206,206,39,31,8,2,1
27,223,223,55,3,52,3,2
15,250,250,8,3,5,2,1
17,251,251,9,9,0,1,0
22,289,289,2,2,0,1,0
2,292,292,41,41,0,1,0
21,302,302,59,16,43,2,1
7,316,316,13,13,0,1,0
8,344,344,8,8,0,1,0
20,369,369,75,75,0,1,0
3,384,384,15,2,13,2,1
28,392,392,14,14,0,1,0
24,399,399,42,42,0,1,0
26,425,425,22,7,15,2,1
5,435,435,19,19,0,1,0
18,445,445,55,30,25,2,1
25,461,461,82,66,16,3,2
6,469,469,12,12,0,1,0
9,473,473,19,13,6,3,2
11,479,479,44,29,15,4,3
10,494,494,59,59,0,1,0

21,105,105,7,7,0,1,0
15,110,110,13,13,0,1,0
1,131,131,48,18,30,2,1
2,151,151,21,21,0,1,0
26,155,155,6,2,4,2,1
13,167,167,21,21,0,1,0
3,176,176,13,4,9,2,1
8,190,190,5,5,0,1,0
22,200,200,30,30,0,1,0
29,202,202,4,4,0,1,0
24,209,209,29,29,0,1,0
12,218,218,26,26,0,1,0
14,223,223,11,11,0,1,0
0,234,234,1,1,0,1,0
4,272,272,12,12,0,1,0
23,290,290,60,52,8,2,1
28,291,291,8,8,0,1,0
11,294,294,1,1,0,1,0
10,301,301,8,8,0,1,0
20,322,322,61,61,0,1,0
9,325,325,2,2,0,1,0
27,358,358,48,48,0,1,0
18,379,379,91,42,49,2,1
7,394,394,16,16,0,1,0
16,411,411,20,7,13,2,1
6,414,414,79,16,63,3,2
25,420,420,2,2,0,1,0
5,443,443,33,33,0,1,0
17,451,451,60,18,42,2,1
19,493,493,16,16,0,1,0

5,101,101,2,2,0,1,0
21,107,107,20,9,11,2,1
12,109,109,1,1,0,1,0
1,113,113,1,1,0,1,0
6,115,115,1,1,0,1,0
15,115,115,14,7,7,2,1
4,132,132,31,22,9,4,3
11,151,151,4,4,0,1,0
3,162,162,134,68,66,4,3
0,168,168,17,17,0,1,0
10,235,235,39,19,20,2,1
9,239,239,40,28,12,2,1
8,239,239,24,5,19,2,1
18,282,282,101,101,0,1,0
14,300,300,15,15,0,1,0
17,323,323,39,39,0,1,0
13,356,356,8,8,0,1,0
16,369,369,3,3,0,1,0
19,372,372,35,18,17,2,1
2,382,382,62,10,52,3,2
7,414,414,16,9,7,2,1
20,466,466,6,6,0,1,0

4,108,108,10,5,5,2,1
23,120,120,1,1,0,1,0
15,140,140,31,31,0,1,0
6,192,192,8,5,3,2,1
14,197,197,2,2,0,1,0
0,198,198,4,4,0,1,0
19,207,207,31,15,16,2,1
10,208,208,1,1,0,1,0
11,232,232,40,7,33,3,2
22,233,233,18,18,0,1,0
20,252,252,25,19,6,3,2
1,260,260,11,11,0,1,0
18,263,263,11,11,0,1,0
5,270,270,1,1,0,1,0
25,281,281,35,35,0,1,0
16,286,286,4,4,0,1,0
26,290,290,61,61,0,1,0
13,333,333,30,30,0,1,0
29,336,336,41,34,7,2,1
17,385,385,33,33,0,1,0
7,385,385,44,44,0,1,0
27,406,406,6,6,0,1,0
12,411,411,67,26,41,2,1
8,412,412,34,22,12,3,2
28,424,424,94,94,0,1,0
3,439,439,13,5,8,3,2
2,442,442,99,99,0,1,0
21,470,470,92,19,73,4,3
24,470,470,26,26,0,1,0
9,473,473,44,44,0,1,0

10,110,110,17,17,0,1,0
29,137,137,27,1,26,2,1
5,151,151,1,1,0,1,0
12,157,157,4,4,0,1,0
31,157,157,1,1,0,1,0
30,177,177,1,1,0,1,0
4,191,191,57,57,0,1,0
13,196,196,4,4,0,1,0
16,201,201,30,30,0,1,0
2,223,223,17,3,14,2,1
21,224,224,16,16,0,1,0
9,232,232,24,12,12,4,3
8,271,271,11,1,10,3,2
26,276,276,7,1,6,3,2
32,282,282,35,35,0,1,0
7,292,292,7,7,0,1,0
15,303,303,26,26,0,1,0
25,318,318,4,1,3,2,1
27,319,319,81,81,0,1,0
6,333,333,51,21,30,3,2
20,349,349,56,56,0,1,0
17,361,361,2,2,0,1,0
0,372,372,39,39,0,1,0
24,378,378,3,3,0,1,0
18,393,393,23,19,4,2,1
14,408,408,17,17,0,1,0
11,408,408,1,1,0,1,0
22,431,431,46,13,33,4,3
23,451,451,69,39,30,4,3
3,452,452,17,1,16,2,1
28,473,473,67,67,0,1,0
1,486,486,6,3,3,2,1
19,488,488,76,23,53,4,3

4,102,102,20,12,8,3,2
16,106,106,13,13,0,1,0
3,115,115,9,3,6,2,1
26,149,149,29,29,0,1,0
29,152,152,13,1,12,4,3
19,167,167,37,37,0,1,0
14,181,181,1,1,0,1,0
20,188,188,7,3,4,2,1
9,191,191,3,3,0,1,0
24,195,195,7,7,0,1,0
10,203,203,60,60,0,1,0
18,207,207,22,22,0,1,0
27,222,222,5,2,3,2,1
15,234,234,14,14,0,1,0
21,243,243,20,6,14,3,2
1,260,260,18,8,10,3,2
22,279,279,18,18,0,1,0
0,290,290,1,1,0,1,0
28,320,320,20,20,0,1,0
5,330,330,78,7,71,3,2
25,375,375,87,45,42,2,1
8,383,383,7,2,5,2,1
2,398,398,2,2,0,1,0
11,417,417,25,16,9,2,1
23,429,429,59,34,25,3,2
17,433,433,16,16,0,1,0
12,445,445,4,4,0,1,0
13,446,446,71,71,0,1,0
7,450,450,79,41,38,3,2
6,460,460,6,3,3,2,1

9,109,109,4,4,0,1,0
1,137,137,1,1,0,1,0
6,138,138,6,6,0,1,0
3,175,175,4,4,0,1,0
18,189,189,16,16,0,1,0
15,213,213,21,21,0,1,0
28,215,215,46,46,0,1,0
12,217,217,12,12,0,1,0
14,235,235,34,34,0,1,0
4,251,251,50,10,40,2,1
21,252,252,10,1,9,2,1
23,263,263,8,8,0,1,0
8,287,287,26,16,10,3,2
29,311,311,14,5,9,4,3
13,312,312,12,9,3,2,1
20,313,313,6,6,0,1,0
32,326,326,50,32,18,4,3
5,334,334,3,3,0,1,0
2,338,338,81,81,0,1,0
24,365,365,109,109,0,1,0
10,368,368,10,5,5,2,1
7,388,388,10,10,0,1,0
25,389,389,39,27,12,2,1
19,397,397,35,31,4,2,1
11,402,402,55,55,0,1,0
27,422,422,14,14,0,1,0
17,444,444,16,16,0,1,0
0,452,452,28,1,27,4,3
30,465,465,20,7,13,3,2
26,468,468,146,123,23,2,1
31,472,472,1,1,0,1,0
22,473,473,20,9,11,2,1
16,498,498,23,23,0,1,0

30,112,112,3,3,0,1,0
14,158,158,14,14,0,1,0
9,167,167,2,2,0,1,0
11,184,184,64,64,0,1,0
18,203,203,22,22,0,1,0
17,206,206,10,10,0,1,0
27,206,206,9,9,0,1,0
0,243,243,19,13,6,3,2
7,249,249,41,15,26,3,2
8,263,263,21,21,0,1,0
12,272,272,1,1,0,1,0
6,273,273,19,11,8,3,2
10,284,284,16,16,0,1,0
4,287,287,6,6,0,1,0
28,310,310,87,48,39,2,1
19,341,341,41,41,0,1,0
3,341,341,23,7,16,4,3
13,351,351,20,20,0,1,0
5,363,363,8,8,0,1,0
20,367,367,83,2,81,4,3
15,392,392,10,10,0,1,0
23,401,401,4,4,0,1,0
2,406,406,65,11,54,3,2
29,416,416,14,1,13,2,1
22,422,422,72,57,15,4,3
16,422,422,20,5,15,2,1
1,425,425,43,34,9,4,3
25,432,432,15,15,0,1,0
24,468,468,50,9,41,2,1
21,498,498,51,51,0,1,0
26,499,499,55,55,0,1,0

12,101,101,3,3,0,1,0
13,110,110,3,3,0,1,0
17,110,110,11,11,0,1,0
34,123,123,7,7,0,1,0
18,130,130,5,5,0,1,0
33,130,130,10,10,0,1,0
6,132,132,21,3,18,2,1
14,134,134,4,4,0,1,0
15,147,147,17,17,0,1,0
11,149,149,4,4,0,1,0
10,186,186,1,1,0,1,0
23,225,225,18,10,8,2,1
20,227,227,11,11,0,1,0
16,237,237,10,1,9,2,1
25,241,241,28,15,13,2,1
24,272,272,64,8,56,3,2
32,290,290,59,59,0,1,0
8,312,312,22,2,20,2,1
36,327,327,25,15,10,2,1
4,329,329,61,61,0,1,0
28,335,335,6,6,0,1,0
3,353,353,20,20,0,1,0
5,376,376,6,1,5,2,1
2,401,401,10,10,0,1,0
35,402,402,11,5,6,2,1
27,423,423,6,6,0,1,0
29,430,430,10,10,0,1,0
0,439,439,25,25,0,1,0
30,440,440,47,47,0,1,0
19,442,442,41,15,26,4,3
21,455,455,2,2,0,1,0
1,458,458,51,51,0,1,0
9,465,465,18,18,0,1,0
7,478,478,15,1,14,2,1
31,479,479,116,89,27,4,3
26,483,483,72,48,24,2,1
22,492,492,44,44,0,1,0

0,101,101,35,35,0,1,0
2,122,122,4,4,0,1,0
19,195,195,1,1,0,1,0
13,205,205,20,4,16,2,1
6,219,219,1,1,0,1,0
14,220,220,50,50,0,1,0
4,222,222,40,8,32,3,2
5,223,223,2,2,0,1,0
10,237,237,22,22,0,1,0
3,285,285,126,126,0,1,0
9,311,311,2,2,0,1,0
8,314,314,66,66,0,1,0
20,334,334,3,3,0,1,0
22,348,348,27,9,18,3,2
15,366,366,31,21,10,3,2
11,375,375,31,18,13,2,1
18,385,385,122,83,39,4,3
21,393,393,84,30,54,3,2
12,410,410,29,29,0,1,0
7,431,431,39,39,0,1,0
17,446,446,27,27,0,1,0
1,451,451,38,38,0,1,0
16,468,468,34,2,32,3,2

10,127,127,7,7,0,1,0
4,146,146,31,5,26,3,2
12,147,147,9,2,7,2,1
18,203,203,7,7,0,1,0
9,226,226,25,9,16,2,1
11,239,239,17,17,0,1,0
16,267,267,14,14,0,1,0
17,276,276,94,34,60,3,2
15,280,280,15,15,0,1,0
22,286,286,39,15,24,4,3
0,307,307,1,1,0,1,0
20,314,314,151,31,120,4,3
8,341,341,124,124,0,1,0
1,369,369,1,1,0,1,0
14,397,397,2,2,0,1,0
21,400,400,4,1,3,2,1
5,406,406,71,71,0,1,0
6,410,410,3,3,0,1,0
19,427,427,4,4,0,1,0
7,450,450,76,76,0,1,0
3,458,458,51,51,0,1,0
2,472,472,169,142,27,3,2
13,491,491,1,1,0,1,0

31,100,100,27,3,24,4,3
9,112,112,3,3,0,1,0
1,116,116,1,1,0,1,0
10,130,130,13,7,6,3,2
32,157,157,4,4,0,1,0
18,163,163,2,2,0,1,0
15,179,179,4,1,3,2,1
21,222,222,10,10,0,1,0
14,234,234,1,1,0,1,0
20,248,248,11,3,8,2,1
16,265,265,2,2,0,1,0
17,281,281,1,1,0,1,0
19,282,282,44,44,0,1,0
22,302,302,17,17,0,1,0
11,314,314,43,25,18,4,3
3,334,334,20,20,0,1,0
24,348,348,73,73,0,1,0
0,374,374,40,1,39,4,3
12,391,391,1,1,0,1,0
27,404,404,35,35,0,1,0
8,410,410,76,1,75,4,3
4,412,412,54,54,0,1,0
28,417,417,4,1,3,2,1
6,419,419,36,30,6,3,2
13,420,420,19,19,0,1,0
25,431,431,4,4,0,1,0
2,449,449,5,5,0,1,0
29,461,461,51,51,0,1,0
30,464,464,28,4,24,3,2
23,471,471,114,79,35,2,1
26,473,473,85,85,0,1,0
7,477,477,39,39,0,1,0
33,490,490,38,22,16,2,1
5,500,500,107,107,0,1,0

1,113,113,14,2,12,3,2
5,114,114,7,1,6,2,1
13,115,115,5,5,0,1,0
9,122,122,13,1,12,4,3
2,131,131,32,32,0,1,0
8,150,150,25,25,0,1,0
15,154,154,37,37,0,1,0
16,172,172,23,13,10,2,1
3,215,215,14,2,12,4,3
23,240,240,3,3,0,1,0
22,244,244,38,19,19,2,1
6,275,275,21,21,0,1,0
10,284,284,23,20,3,2,1
14,287,287,16,6,10,2,1
7,289,289,41,41,0,1,0
17,300,300,5,5,0,1,0
0,340,340,25,5,20,2,1
25,349,349,65,5,60,4,3
18,404,404,6,6,0,1,0
21,406,406,40,10,30,4,3
4,425,425,3,3,0,1,0
24,437,437,23,16,7,3,2
12,448,448,74,32,42,3,2
11,452,452,115,115,0,1,0
19,490,490,32,5,27,2,1
20,492,492,88,88,0,1,0

18,102,102,23,9,14,3,2
25,111,111,6,6,0,1,0
26,114,114,13,13,0,1,0
30,126,126,9,3,6,3,2
23,139,139,24,20,4,2,1
9,149,149,1,1,0,1,0
2,164,164,21,4,17,2,1
1,181,181,13,13,0,1,0
21,207,207,21,4,17,2,1
13,250,250,30,30,0,1,0
22,253,253,7,7,0,1,0
4,262,262,43,9,34,2,1
15,273,273,1,1,0,1,0
27,274,274,3,3,0,1,0
11,275,275,7,1,6,2,1
3,294,294,24,24,0,1,0
19,303,303,25,9,16,3,2
24,306,306,69,69,0,1,0
7,307,307,21,21,0,1,0
10,319,319,1,1,0,1,0
20,320,320,19,19,0,1,0
31,326,326,73,58,15,4,3
17,328,328,59,59,0,1,0
0,329,329,3,3,0,1,0
16,335,335,61,12,49,4,3
6,339,339,21,21,0,1,0
28,370,370,26,26,0,1,0
8,416,416,43,43,0,1,0
5,419,419,12,2,10,2,1
12,435,435,66,66,0,1,0
14,445,445,5,5,0,1,0
29,477,477,3,3,0,1,0

7,112,112,2,2,0,1,0
5,172,172,1,1,0,1,0
3,198,198,13,5,8,3,2
21,202,202,5,5,0,1,0
0,207,207,8,4,4,2,1
4,221,221,11,2,9,2,1
12,248,248,11,11,0,1,0
20,260,260,10,10,0,1,0
16,269,269,103,91,12,4,3
19,281,281,29,29,0,1,0
1,283,283,9,9,0,1,0
13,292,292,35,19,16,2,1
8,294,294,4,4,0,1,0
15,297,297,7,7,0,1,0
25,299,299,31,31,0,1,0
17,318,318,11,8,3,2,1
6,347,347,190,67,123,4,3
2,353,353,22,22,0,1,0
10,359,359,31,31,0,1,0
11,366,366,4,4,0,1,0
14,366,366,112,71,41,4,3
22,392,392,21,12,9,4,3
9,405,405,191,183,8,2,1
24,408,408,69,69,0,1,0
18,443,443,1,1,0,1,0
23,482,482,9,3,6,2,1

19,107,107,1,1,0,1,0
31,115,115,6,1,5,2,1
32,117,117,8,3,5,2,1
13,145,145,6,6,0,1,0
8,154,154,7,7,0,1,0
18,159,159,14,2,12,2,1
27,198,198,7,7,0,1,0
30,205,205,31,31,0,1,0
9,208,208,40,10,30,3,2
7,221,221,19,19,0,1,0
10,229,229,59,59,0,1,0
24,234,234,22,12,10,3,2
20,251,251,77,17,60,3,2
26,281,281,2,2,0,1,0
0,287,287,12,12,0,1,0
14,289,289,10,3,7,2,1
23,294,294,19,19,0,1,0
12,321,321,21,21,0,1,0
16,321,321,1,1,0,1,0
15,332,332,12,12,0,1,0
4,339,339,9,9,0,1,0
1,341,341,12,12,0,1,0
17,346,346,55,24,31,2,1
3,350,350,2,2,0,1,0
21,356,356,35,35,0,1,0
29,382,382,23,7,16,2,1
25,386,386,7,7,0,1,0
2,386,386,5,5,0,1,0
6,428,428,23,23,0,1,0
5,468,468,11,11,0,1,0
28,487,487,117,111,6,2,1
11,490,490,94,94,0,1,0
22,494,494,109,109,0,1,0

15,110,110,35,35,0,1,0
30,123,123,14,14,0,1,0
16,127,127,10,10,0,1,0
18,130,130,4,4,0,1,0
26,154,154,26,26,0,1,0
0,158,158,6,6,0,1,0
2,179,179,9,3,6,3,2
24,216,216,9,9,0,1,0
19,244,244,8,8,0,1,0
13,255,255,6,6,0,1,0
23,261,261,7,7,0,1,0
21,263,263,6,6,0,1,0
5,282,282,12,3,9,4,3
20,283,283,19,19,0,1,0
29,289,289,64,64,0,1,0
4,291,291,4,4,0,1,0
7,306,306,18,3,15,2,1
22,310,310,45,45,0,1,0
12,320,320,27,18,9,4,3
10,333,333,1,1,0,1,0
25,338,338,113,73,40,3,2
32,341,341,31,31,0,1,0
27,373,373,17,17,0,1,0
14,410,410,6,1,5,2,1
1,428,428,44,1,43,2,1
8,441,441,26,8,18,4,3
11,453,453,32,32,0,1,0
3,463,463,26,26,0,1,0
17,475,475,69,69,0,1,0
9,478,478,16,4,12,4,3
31,481,481,34,34,0,1,0
28,499,499,22,2,20,2,1
6,500,500,91,36,55,4,3

1,106,106,9,2,7,2,1
20,111,111,4,4,0,1,0
4,113,113,5,2,3,2,1
14,118,118,7,3,4,2,1
8,131,131,3,3,0,1,0
18,147,147,7,7,0,1,0
30,213,213,1,1,0,1,0
13,218,218,17,17,0,1,0
5,222,222,3,3,0,1,0
33,230,230,32,15,17,4,3
19,231,231,7,7,0,1,0
11,235,235,22,22,0,1,0
23,249,249,117,97,20,3,2
7,252,252,34,34,0,1,0
6,282,282,3,3,0,1,0
29,298,298,16,16,0,1,0
24,325,325,3,3,0,1,0
3,334,334,4,1,3,2,1
0,336,336,7,1,6,3,2
28,340,340,8,8,0,1,0
15,352,352,13,13,0,1,0
32,370,370,88,88,0,1,0
25,404,404,10,1,9,3,2
17,410,410,29,29,0,1,0
22,424,424,41,29,12,3,2
12,427,427,208,176,32,4,3
9,432,432,43,19,24,2,1
21,438,438,9,9,0,1,0
16,448,448,22,10,12,3,2
27,449,449,10,10,0,1,0
26,454,454,93,31,62,3,2
2,480,480,1,1,0,1,0
31,496,496,43,2,41,4,3
10,497,497,1,1,0,1,0

6,100,100,2,2,0,1,0
3,125,125,4,1,3,2,1
0,203,203,8,2,6,3,2
4,210,210,1,1,0,1,0
8,252,252,16,16,0,1,0
21,255,255,9,9,0,1,0
10,256,256,70,52,18,4,3
19,258,258,35,2,33,4,3
15,270,270,14,14,0,1,0
14,299,299,27,27,0,1,0
9,349,349,110,4,106,4,3
1,351,351,105,54,51,4,3
16,353,353,20,20,0,1,0
12,365,365,49,1,48,4,3
5,373,373,104,8,96,3,2
17,399,399,20,20,0,1,0
20,406,406,18,9,9,2,1
7,411,411,183,183,0,1,0
13,421,421,21,21,0,1,0
11,426,426,23,14,9,3,2
2,430,430,121,58,63,4,3
18,456,456,31,31,0,1,0

8,153,153,25,15,10,2,1
7,177,177,9,3,6,2,1
3,204,204,23,2,21,4,3
21,209,209,13,13,0,1,0
24,215,215,19,11,8,3,2
9,220,220,8,8,0,1,0
11,237,237,4,4,0,1,0
19,240,240,30,10,20,2,1
23,250,250,5,5,0,1,0
22,281,281,6,6,0,1,0
17,287,287,51,51,0,1,0
1,296,296,16,4,12,3,2
15,316,316,2,2,0,1,0
25,319,319,38,14,24,3,2
14,337,337,6,1,5,2,1
26,341,341,54,20,34,2,1
5,343,343,3,3,0,1,0
0,347,347,33,33,0,1,0
12,349,349,35,8,27,4,3
18,388,388,45,25,20,3,2
28,390,390,122,116,6,2,1
6,391,391,56,50,6,2,1
13,413,413,102,51,51,4,3
10,420,420,38,3,35,2,1
16,445,445,48,16,32,2,1
20,449,449,14,10,4,2,1
2,465,465,6,6,0,1,0
4,472,472,119,119,0,1,0
27,497,497,39,39,0,1,0

15,109,109,11,1,10,2,1
6,129,129,23,13,10,2,1
2,132,132,16,6,10,3,2
9,137,137,11,11,0,1,0
20,146,146,4,4,0,1,0
5,162,162,3,3,0,1,0
8,176,176,5,5,0,1,0
14,219,219,42,22,20,3,2
25,219,219,11,8,3,2,1
4,221,221,1,1,0,1,0
21,221,221,57,57,0,1,0
1,242,242,9,9,0,1,0
23,256,256,113,21,92,3,2
24,277,277,1,1,0,1,0
7,305,305,6,6,0,1,0
17,307,307,11,1,10,2,1
3,317,317,24,24,0,1,0
11,323,323,77,5,72,3,2
26,370,370,11,6,5,2,1
19,413,413,28,4,24,3,2
16,424,424,23,17,6,3,2
13,437,437,19,3,16,3,2
18,447,447,34,4,30,4,3
0,451,451,107,19,88,3,2
12,460,460,100,42,58,4,3
27,479,479,5,5,0,1,0
22,481,481,38,38,0,1,0
10,488,488,49,49,0,1,0

13,101,101,4,4,0,1,0
16,125,125,21,21,0,1,0
22,149,149,4,4,0,1,0
24,150,150,21,21,0,1,0
7,172,172,7,7,0,1,0
3,196,196,77,77,0,1,0
17,196,196,55,55,0,1,0
14,226,226,24,5,19,2,1
23,228,228,10,10,0,1,0
4,253,253,12,7,5,2,1
20,262,262,18,6,12,2,1
25,280,280,10,10,0,1,0
18,290,290,11,11,0,1,0
1,303,303,1,1,0,1,0
2,348,348,102,76,26,2,1
11,362,362,6,6,0,1,0
9,369,369,56,56,0,1,0
15,371,371,31,31,0,1,0
5,393,393,69,45,24,4,3
12,402,402,26,5,21,4,3
8,413,413,6,6,0,1,0
6,422,422,43,9,34,3,2
26,440,440,48,48,0,1,0
10,448,448,15,6,9,4,3
19,454,454,1,1,0,1,0
27,457,457,104,78,26,3,2
21,459,459,45,9,36,2,1
0,462,462,13,6,7,2,1

24,107,107,18,18,0,1,0
9,116,116,52,36,16,3,2
15,142,142,17,17,0,1,0
2,143,143,1,1,0,1,0
20,174,174,6,6,0,1,0
0,175,175,13,9,4,2,1
23,181,181,2,2,0,1,0
17,218,218,4,4,0,1,0
21,229,229,2,2,0,1,0
10,233,233,12,12,0,1,0
7,235,235,29,23,6,2,1
11,274,274,25,25,0,1,0
18,276,276,49,49,0,1,0
8,310,310,10,10,0,1,0
12,334,334,11,11,0,1,0
14,345,345,33,3,30,2,1
19,390,390,46,13,33,4,3
1,415,415,71,41,30,3,2
4,445,445,121,53,68,3,2
16,454,454,22,22,0,1,0
3,454,454,38,19,19,2,1
13,464,464,129,62,67,4,3
22,476,476,110,20,90,3,2
5,496,496,23,14,9,4,3
6,497,497,46,32,14,3,2

0,107,107,1,1,0,1,0
8,119,119,39,39,0,1,0
15,137,137,7,1,6,2,1
4,148,148,33,33,0,1,0
18,149,149,14,2,12,4,3
2,158,158,59,32,27,4,3
21,161,161,2,2,0,1,0
11,177,177,12,12,0,1,0
9,207,207,31,25,6,2,1
17,215,215,3,3,0,1,0
14,239,239,43,13,30,4,3
12,261,261,16,6,10,2,1
5,275,275,43,43,0,1,0
10,277,277,18,18,0,1,0
16,322,322,120,42,78,4,3
19,331,331,13,13,0,1,0
22,357,357,99,41,58,3,2
1,372,372,30,9,21,2,1
13,390,390,46,14,32,2,1
3,409,409,18,18,0,1,0
6,428,428,11,11,0,1,0
20,428,428,20,20,0,1,0
7,454,454,6,6,0,1,0
23,465,465,13,2,11,2,1

4,109,109,7,2,5,2,1
10,128,128,21,21,0,1,0
15,131,131,4,1,3,2,1
1,145,145,11,1,10,2,1
21,164,164,16,16,0,1,0
28,187,187,1,1,0,1,0
7,195,195,4,4,0,1,0
23,218,218,87,87,0,1,0
25,236,236,21,21,0,1,0
22,257,257,14,7,7,2,1
0,262,262,7,7,0,1,0
14,284,284,37,21,16,3,2
8,301,301,66,21,45,4,3
18,302,302,7,7,0,1,0
24,316,316,139,113,26,3,2
20,335,335,7,7,0,1,0
26,342,342,1,1,0,1,0
9,354,354,15,1,14,2,1
3,357,357,28,16,12,3,2
6,360,360,60,60,0,1,0
2,368,368,40,40,0,1,0
19,382,382,7,7,0,1,0
13,409,409,4,4,0,1,0
11,413,413,48,42,6,2,1
12,414,414,43,5,38,3,2
17,447,447,60,16,44,3,2
5,460,460,35,35,0,1,0
16,480,480,15,3,12,2,1
27,486,486,40,40,0,1,0

15,105,105,1,1,0,1,0
10,133,133,1,1,0,1,0
16,134,134,43,34,9,4,3
3,149,149,19,7,12,3,2
14,150,150,3,3,0,1,0
23,154,154,2,2,0,1,0
21,179,179,12,12,0,1,0
11,185,185,20,20,0,1,0
1,196,196,37,37,0,1,0
18,229,229,91,91,0,1,0
7,241,241,5,5,0,1,0
5,269,269,64,64,0,1,0
19,281,281,3,3,0,1,0
20,294,294,5,2,3,2,1
0,302,302,21,5,16,3,2
2,340,340,133,76,57,4,3
22,352,352,14,5,9,4,3
9,359,359,32,9,23,2,1
12,388,388,8,2,6,3,2
17,389,389,60,60,0,1,0
13,413,413,48,48,0,1,0
8,429,429,7,7,0,1,0
25,451,451,68,68,0,1,0
26,460,460,12,12,0,1,0
24,475,475,43,26,17,2,1
6,483,483,22,17,5,2,1
4,500,500,39,6,33,4,3

4,100,100,9,9,0,1,0
3,109,109,7,4,3,2,1
23,181,181,24,24,0,1,0
28,186,186,52,11,41,4,3
0,209,209,36,36,0,1,0
6,215,215,4,4,0,1,0
1,226,226,6,2,4,2,1
16,233,233,1,1,0,1,0
29,234,234,13,13,0,1,0
17,243,243,37,37,0,1,0
7,259,259,4,4,0,1,0
21,318,318,50,50,0,1,0
27,328,328,20,20,0,1,0
15,330,330,5,1,4,2,1
11,341,341,12,12,0,1,0
22,341,341,1,1,0,1,0
14,357,357,56,32,24,4,3
25,385,385,8,8,0,1,0
12,391,391,76,76,0,1,0
13,413,413,51,51,0,1,0
20,416,416,70,70,0,1,0
9,430,430,57,43,14,2,1
18,433,433,57,57,0,1,0
8,438,438,21,21,0,1,0
30,439,439,12,12,0,1,0
26,440,440,70,70,0,1,0
5,447,447,16,6,10,3,2
24,459,459,61,61,0,1,0
31,461,461,29,29,0,1,0
10,461,461,6,6,0,1,0
19,482,482,13,4,9,4,3
2,491,491,51,51,0,1,0

12,120,120,1,1,0,1,0
1,129,129,18,10,8,2,1
6,171,171,42,42,0,1,0
13,176,176,38,38,0,1,0
24,197,197,30,30,0,1,0
21,197,197,4,4,0,1,0
18,232,232,8,5,3,2,1
20,236,236,10,10,0,1,0
10,238,238,2,2,0,1,0
19,254,254,17,17,0,1,0
16,254,254,16,16,0,1,0
22,272,272,14,14,0,1,0
9,274,274,3,3,0,1,0
15,323,323,10,3,7,2,1
3,336,336,70,46,24,4,3
0,366,366,45,9,36,4,3
5,391,391,77,77,0,1,0
4,395,395,11,11,0,1,0
2,405,405,138,132,6,3,2
8,430,430,37,37,0,1,0
7,435,435,6,6,0,1,0
17,452,452,126,40,86,3,2
23,473,473,56,38,18,3,2
11,480,480,105,105,0,1,0
14,494,494,60,60,0,1,0

24,105,105,1,1,0,1,0
23,107,107,16,16,0,1,0
21,120,120,2,2,0,1,0
14,121,121,2,2,0,1,0
19,122,122,1,1,0,1,0
3,132,132,1,1,0,1,0
11,151,151,35,10,25,2,1
8,200,200,7,7,0,1,0
9,207,207,7,7,0,1,0
26,208,208,19,9,10,2,1
18,215,215,13,7,6,2,1
25,227,227,53,53,0,1,0
10,228,228,9,4,5,2,1
0,247,247,9,6,3,2,1
20,253,253,1,1,0,1,0
22,254,254,11,8,3,2,1
2,261,261,49,28,21,2,1
33,268,268,65,19,46,2,1
31,275,275,64,64,0,1,0
7,287,287,17,3,14,2,1
17,295,295,60,13,47,2,1
4,302,302,14,14,0,1,0
29,306,306,23,7,16,2,1
16,307,307,57,57,0,1,0
15,320,320,9,3,6,3,2
6,326,326,7,7,0,1,0
13,355,355,43,11,32,2,1
28,400,400,35,16,19,2,1
5,416,416,3,3,0,1,0
1,422,422,16,16,0,1,0
30,430,430,47,3,44,2,1
27,451,451,38,31,7,2,1
32,459,459,17,6,11,2,1
34,473,473,8,8,0,1,0
12,498,498,15,10,5,2,1

3,102,102,5,1,4,2,1
7,104,104,9,9,0,1,0
14,105,105,10,7,3,2,1
31,127,127,6,6,0,1,0
10,132,132,38,8,30,3,2
28,132,132,15,15,0,1,0
23,134,134,39,39,0,1,0
1,150,150,9,1,8,2,1
5,154,154,5,5,0,1,0
9,154,154,18,2,16,2,1
17,159,159,9,9,0,1,0
30,198,198,41,33,8,3,2
22,235,235,44,44,0,1,0
4,239,239,17,17,0,1,0
11,242,242,3,3,0,1,0
19,275,275,18,18,0,1,0
20,303,303,40,40,0,1,0
16,339,339,68,47,21,2,1
12,351,351,11,11,0,1,0
24,373,373,23,23,0,1,0
33,375,375,12,6,6,2,1
32,377,377,5,5,0,1,0
8,380,380,39,39,0,1,0
27,381,381,13,8,5,2,1
18,389,389,5,2,3,2,1
21,403,403,80,80,0,1,0
2,403,403,6,6,0,1,0
6,409,409,1,1,0,1,0
25,421,421,22,22,0,1,0
13,431,431,21,21,0,1,0
15,466,466,21,18,3,2,1
26,469,469,8,8,0,1,0
29,483,483,19,19,0,1,0
0,500,500,4,4,0,1,0

4,102,102,6,6,0,1,0
29,127,127,3,3,0,1,0
15,129,129,19,19,0,1,0
8,140,140,8,2,6,3,2
28,145,145,1,1,0,1,0
21,150,150,17,9,8,3,2
33,157,157,34,13,21,2,1
10,160,160,1,1,0,1,0
19,165,165,5,5,0,1,0
27,172,172,42,15,27,4,3
6,189,189,17,17,0,1,0
34,195,195,6,2,4,2,1
25,225,225,1,1,0,1,0
9,239,239,20,15,5,2,1
22,248,248,31,31,0,1,0
0,259,259,10,10,0,1,0
12,260,260,39,39,0,1,0
11,273,273,1,1,0,1,0
2,276,276,2,2,0,1,0
18,283,283,1,1,0,1,0
30,306,306,15,6,9,4,3
13,309,309,29,12,17,2,1
1,316,316,22,22,0,1,0
14,324,324,1,1,0,1,0
20,337,337,80,18,62,3,2
16,345,345,44,44,0,1,0
23,375,375,36,36,0,1,0
7,387,387,26,23,3,2,1
3,408,408,2,2,0,1,0
32,409,409,10,10,0,1,0
31,432,432,72,72,0,1,0
24,439,439,25,25,0,1,0
5,439,439,5,5,0,1,0
17,440,440,48,48,0,1,0
26,463,463,124,51,73,4,3

19,112,112,10,10,0,1,0
15,126,126,3,3,0,1,0
7,133,133,8,8,0,1,0
26,169,169,7,4,3,2,1
23,184,184,33,33,0,1,0
8,200,200,1,1,0,1,0
5,202,202,61,61,0,1,0
14,217,217,34,34,0,1,0
20,225,225,7,4,3,2,1
1,231,231,20,20,0,1,0
16,233,233,14,2,12,3,2
0,237,237,1,1,0,1,0
22,248,248,4,4,0,1,0
25,251,251,7,7,0,1,0
4,256,256,16,5,11,2,1
24,264,264,44,44,0,1,0
12,272,272,31,1,30,3,2
10,275,275,19,1,18,4,3
28,287,287,12,2,10,3,2
29,307,307,76,48,28,2,1
2,317,317,2,2,0,1,0
27,323,323,41,41,0,1,0
21,327,327,16,2,14,3,2
11,330,330,16,8,8,2,1
13,340,340,1,1,0,1,0
17,348,348,5,5,0,1,0
30,405,405,65,47,18,4,3
18,407,407,100,100,0,1,0
6,424,424,94,94,0,1,0
3,426,426,16,16,0,1,0
9,496,496,69,37,32,2,1

6,119,119,11,2,9,2,1
5,147,147,4,4,0,1,0
22,152,152,9,3,6,2,1
8,154,154,10,6,4,2,1
13,174,174,3,3,0,1,0
3,177,177,9,9,0,1,0
2,180,180,8,8,0,1,0
17,197,197,6,6,0,1,0
16,203,203,11,11,0,1,0
1,211,211,10,10,0,1,0
26,257,257,60,46,14,2,1
7,266,266,5,5,0,1,0
9,267,267,15,15,0,1,0
19,288,288,1,1,0,1,0
11,308,308,7,7,0,1,0
4,320,320,81,81,0,1,0
21,320,320,89,43,46,3,2
12,333,333,90,30,60,3,2
25,339,339,23,3,20,2,1
18,367,367,51,51,0,1,0
14,391,391,120,56,64,3,2
24,407,407,10,4,6,3,2
15,420,420,28,28,0,1,0
0,460,460,72,26,46,3,2
10,464,464,137,79,58,3,2
20,472,472,16,16,0,1,0
23,487,487,51,3,48,2,1

1,161,161,12,7,5,2,1
11,168,168,9,3,6,2,1
10,204,204,3,3,0,1,0
16,242,242,26,8,18,3,2
15,260,260,54,40,14,2,1
12,277,277,32,6,26,3,2
25,295,295,15,9,6,3,2
26,297,297,19,16,3,2,1
18,314,314,48,48,0,1,0
21,331,331,33,21,12,4,3
3,335,335,41,41,0,1,0
23,335,335,90,32,58,3,2
5,354,354,55,20,35,2,1
4,367,367,47,47,0,1,0
19,383,383,19,1,18,3,2
6,389,389,74,74,0,1,0
8,428,428,22,22,0,1,0
2,450,450,109,23,86,3,2
22,455,455,19,19,0,1,0
7,461,461,80,53,27,4,3
0,465,465,17,17,0,1,0
14,467,467,4,1,3,2,1
20,470,470,53,53,0,1,0
24,474,474,19,19,0,1,0
9,475,475,20,20,0,1,0
17,492,492,39,5,34,2,1
13,495,495,67,67,0,1,0

16,103,103,7,7,0,1,0
15,110,110,19,15,4,2,1
4,158,158,20,10,10,3,2
2,158,158,15,15,0,1,0
26,175,175,19,19,0,1,0
22,185,185,38,14,24,2,1
28,195,195,33,5,28,3,2
18,196,196,1,1,0,1,0
24,217,217,13,13,0,1,0
7,239,239,2,2,0,1,0
27,242,242,6,6,0,1,0
14,266,266,2,2,0,1,0
5,276,276,1,1,0,1,0
8,280,280,31,31,0,1,0
3,292,292,24,24,0,1,0
0,328,328,22,5,17,3,2
21,341,341,1,1,0,1,0
10,374,374,58,58,0,1,0
13,374,374,2,2,0,1,0
19,406,406,8,3,5,2,1
1,413,413,111,30,81,3,2
12,418,418,53,44,9,4,3
11,429,429,54,33,21,4,3
25,441,441,24,21,3,2,1
9,468,468,44,2,42,2,1
17,489,489,46,46,0,1,0
23,491,491,25,10,15,4,3
20,493,493,194,149,45,2,1
6,499,499,63,27,36,3,2

5,133,133,18,18,0,1,0
25,166,166,8,8,0,1,0
16,170,170,1,1,0,1,0
3,185,185,18,13,5,2,1
1,188,188,21,1,20,3,2
10,198,198,41,5,36,3,2
11,229,229,16,13,3,2,1
9,241,241,8,8,0,1,0
7,252,252,62,62,0,1,0
2,259,259,3,3,0,1,0
22,263,263,13,13,0,1,0
26,318,318,41,29,12,4,3
0,320,320,21,21,0,1,0
18,321,321,82,17,65,4,3
19,345,345,52,6,46,3,2
15,377,377,51,39,12,2,1
4,378,378,46,46,0,1,0
21,400,400,95,3,92,4,3
17,401,401,30,30,0,1,0
27,402,402,9,4,5,2,1
12,407,407,23,23,0,1,0
14,423,423,8,2,6,2,1
23,428,428,28,19,9,4,3
6,433,433,11,1,10,2,1
20,436,436,62,62,0,1,0
8,449,449,63,21,42,4,3
13,483,483,38,29,9,4,3
24,487,487,41,41,0,1,0

12,102,102,19,19,0,1,0
26,115,115,2,2,0,1,0
2,133,133,13,13,0,1,0
23,158,158,8,8,0,1,0
25,169,169,11,11,0,1,0
16,190,190,2,2,0,1,0
22,249,249,48,48,0,1,0
11,256,256,4,4,0,1,0
6,258,258,1,1,0,1,0
21,264,264,63,36,27,4,3
3,284,284,1,1,0,1,0
15,296,296,17,8,9,2,1
17,297,297,30,30,0,1,0
20,305,305,90,78,12,4,3
24,312,312,3,3,0,1,0
14,320,320,24,24,0,1,0
4,327,327,26,26,0,1,0
7,346,346,6,6,0,1,0
18,399,399,43,43,0,1,0
8,407,407,143,29,114,4,3
19,447,447,30,3,27,4,3
5,447,447,37,8,29,2,1
1,447,447,80,62,18,2,1
13,472,472,64,20,44,2,1
0,479,479,46,46,0,1,0
10,499,499,13,3,10,2,1
9,500,500,133,133,0,1,0

23,106,106,1,1,0,1,0
16,108,108,10,7,3,2,1
22,115,115,6,6,0,1,0
10,164,164,27,27,0,1,0
13,165,165,14,11,3,2,1
24,167,167,12,6,6,2,1
8,221,221,14,6,8,3,2
18,225,225,3,3,0,1,0
19,253,253,5,1,4,2,1
17,273,273,35,5,30,2,1
14,331,331,52,52,0,1,0
1,350,350,66,50,16,3,2
21,359,359,16,16,0,1,0
4,359,359,30,15,15,2,1
2,362,362,59,21,38,3,2
5,370,370,28,28,0,1,0
11,387,387,17,17,0,1,0
6,402,402,58,10,48,2,1
15,405,405,3,3,0,1,0
3,408,408,89,64,25,2,1
0,419,419,9,1,8,2,1
12,420,420,33,19,14,2,1
25,457,457,53,53,0,1,0
9,464,464,66,44,22,3,2
7,492,492,45,22,23,2,1
20,498,498,278,234,44,2,1

1,116,116,10,10,0,1,0
14,125,125,8,2,6,3,2
5,152,152,21,21,0,1,0
12,167,167,1,1,0,1,0
19,197,197,19,19,0,1,0
8,225,225,46,46,0,1,0
17,233,233,61,61,0,1,0
2,259,259,7,7,0,1,0
4,261,261,22,4,18,2,1
13,265,265,5,5,0,1,0
23,277,277,42,34,8,3,2
16,304,304,55,55,0,1,0
10,370,370,21,21,0,1,0
15,373,373,21,7,14,2,1
6,384,384,197,197,0,1,0
0,384,384,39,39,0,1,0
11,392,392,47,40,7,2,1
24,401,401,46,46,0,1,0
9,446,446,25,25,0,1,0
21,467,467,6,6,0,1,0
7,470,470,54,54,0,1,0
3,470,470,9,3,6,3,2
20,477,477,77,5,72,4,3
22,479,479,34,34,0,1,0
18,488,488,49,1,48,4,3

9,121,121,19,14,5,2,1
21,145,145,9,9,0,1,0
24,162,162,70,70,0,1,0
0,206,206,2,2,0,1,0
26,233,233,33,4,29,2,1
8,235,235,53,11,42,3,2
3,250,250,11,11,0,1,0
2,264,264,31,31,0,1,0
19,275,275,13,10,3,2,1
18,277,277,12,12,0,1,0
5,284,284,25,16,9,2,1
23,285,285,20,20,0,1,0
7,298,298,77,77,0,1,0
16,315,315,27,27,0,1,0
4,317,317,19,19,0,1,0
28,325,325,8,1,7,2,1
11,325,325,1,1,0,1,0
13,334,334,18,5,13,4,3
1,358,358,24,2,22,2,1
17,362,362,39,4,35,2,1
27,362,362,3,3,0,1,0
15,367,367,21,21,0,1,0
12,387,387,32,32,0,1,0
20,390,390,59,59,0,1,0
25,409,409,34,34,0,1,0
6,417,417,30,10,20,3,2
22,435,435,6,3,3,2,1
29,436,436,64,64,0,1,0
14,441,441,32,32,0,1,0
10,468,468,16,16,0,1,0

21,109,109,33,33,0,1,0
22,140,140,6,6,0,1,0
5,149,149,20,5,15,4,3
18,151,151,2,2,0,1,0
12,168,168,43,43,0,1,0
16,180,180,4,4,0,1,0
9,205,205,1,1,0,1,0
14,208,208,21,21,0,1,0
7,266,266,21,12,9,4,3
10,283,283,51,3,48,4,3
11,285,285,34,9,25,2,1
0,316,316,17,17,0,1,0
4,325,325,35,5,30,2,1
13,344,344,33,13,20,2,1
24,345,345,55,28,27,4,3
6,349,349,56,29,27,4,3
3,358,358,46,5,41,2,1
15,382,382,1,1,0,1,0
1,395,395,17,17,0,1,0
20,403,403,52,52,0,1,0
2,407,407,89,74,15,4,3
19,409,409,36,3,33,4,3
17,410,410,41,41,0,1,0
25,436,436,24,7,17,2,1
8,444,444,77,29,48,4,3
23,454,454,27,27,0,1,0

23,127,127,2,2,0,1,0
4,131,131,11,11,0,1,0
9,136,136,31,1,30,4,3
5,146,146,1,1,0,1,0
19,163,163,53,9,44,3,2
18,186,186,1,1,0,1,0
17,195,195,46,26,20,3,2
13,199,199,4,4,0,1,0
7,210,210,41,11,30,2,1
3,247,247,23,5,18,3,2
11,260,260,22,22,0,1,0
10,266,266,42,42,0,1,0
6,268,268,1,1,0,1,0
0,292,292,36,36,0,1,0
21,299,299,21,14,7,2,1
24,337,337,28,28,0,1,0
25,348,348,108,21,87,4,3
22,363,363,29,17,12,3,2
8,386,386,90,90,0,1,0
12,407,407,9,9,0,1,0
16,410,410,11,11,0,1,0
14,440,440,13,13,0,1,0
20,444,444,65,65,0,1,0
1,451,451,36,12,24,3,2
2,453,453,51,28,23,3,2
15,482,482,24,5,19,2,1

3,107,107,21,21,0,1,0
17,115,115,18,18,0,1,0
23,127,127,8,8,0,1,0
4,133,133,4,4,0,1,0
9,144,144,17,17,0,1,0
10,157,157,13,5,8,2,1
22,178,178,6,2,4,2,1
0,201,201,23,15,8,3,2
13,206,206,14,14,0,1,0
6,225,225,23,23,0,1,0
26,253,253,10,6,4,2,1
1,263,263,19,19,0,1,0
11,268,268,10,7,3,2,1
15,285,285,25,1,24,2,1
25,305,305,21,7,14,2,1
18,333,333,75,7,68,4,3
24,344,344,2,2,0,1,0
16,404,404,21,3,18,4,3
5,410,410,3,3,0,1,0
14,413,413,2,2,0,1,0
20,423,423,33,33,0,1,0
12,426,426,54,14,40,2,1
19,435,435,87,87,0,1,0
21,443,443,153,130,23,2,1
8,443,443,30,30,0,1,0
2,487,487,98,39,59,4,3
7,497,497,122,54,68,3,2

22,112,112,8,2,6,3,2
12,124,124,7,7,0,1,0
6,126,126,13,8,5,2,1
11,139,139,7,7,0,1,0
28,145,145,30,22,8,3,2
29,157,157,10,10,0,1,0
2,172,172,1,1,0,1,0
10,173,173,1,1,0,1,0
18,195,195,9,1,8,3,2
19,209,209,45,45,0,1,0
5,215,215,10,3,7,2,1
23,223,223,17,17,0,1,0
0,236,236,2,2,0,1,0
3,238,238,19,7,12,3,2
16,254,254,14,6,8,3,2
30,265,265,17,17,0,1,0
26,267,267,46,13,33,4,3
7,276,276,4,4,0,1,0
4,279,279,26,1,25,2,1
20,299,299,4,4,0,1,0
15,321,321,19,15,4,2,1
17,322,322,6,3,3,2,1
14,394,394,82,16,66,3,2
24,397,397,13,4,9,2,1
8,411,411,94,73,21,4,3
13,436,436,24,11,13,3,2
1,450,450,84,59,25,4,3
9,457,457,66,57,9,4,3
21,461,461,13,13,0,1,0
27,468,468,142,81,61,4,3
25,475,475,54,54,0,1,0

15,101,101,8,8,0,1,0
5,128,128,24,24,0,1,0
20,139,139,6,6,0,1,0
18,148,148,1,1,0,1,0
4,184,184,29,7,22,4,3
2,192,192,12,12,0,1,0
19,194,194,16,16,0,1,0
12,218,218,19,10,9,2,1
21,221,221,8,8,0,1,0
14,265,265,10,10,0,1,0
24,288,288,1,1,0,1,0
6,291,291,25,25,0,1,0
3,315,315,1,1,0,1,0
0,327,327,54,8,46,3,2
17,349,349,111,39,72,4,3
23,358,358,24,12,12,4,3
1,384,384,29,8,21,4,3
10,387,387,16,16,0,1,0
22,394,394,36,26,10,2,1
8,401,401,123,96,27,4,3
13,427,427,24,12,12,3,2
16,440,440,195,123,72,4,3
7,463,463,73,73,0,1,0
9,471,471,74,41,33,4,3
11,498,498,42,42,0,1,0

20,100,100,17,1,16,2,1
19,102,102,12,4,8,3,2
6,110,110,1,1,0,1,0
25,116,116,2,2,0,1,0
22,117,117,8,8,0,1,0
27,134,134,3,3,0,1,0
17,139,139,3,3,0,1,0
11,161,161,12,2,10,2,1
5,166,166,21,15,6,2,1
21,199,199,50,50,0,1,0
0,206,206,5,2,3,2,1
26,213,213,9,9,0,1,0
7,215,215,44,44,0,1,0
14,220,220,7,4,3,2,1
9,220,220,1,1,0,1,0
2,233,233,42,42,0,1,0
29,286,286,70,52,18,4,3
1,292,292,70,20,50,4,3
3,293,293,25,15,10,3,2
28,313,313,3,3,0,1,0
18,315,315,35,35,0,1,0
8,315,315,65,57,8,3,2
24,318,318,4,4,0,1,0
13,344,344,4,4,0,1,0
10,364,364,30,30,0,1,0
12,369,369,32,10,22,3,2
23,401,401,88,88,0,1,0
15,411,411,11,11,0,1,0
16,482,482,60,24,36,4,3
4,498,498,3,3,0,1,0

14,101,101,19,7,12,2,1
30,120,120,2,2,0,1,0
18,155,155,14,14,0,1,0
16,181,181,9,9,0,1,0
11,181,181,4,4,0,1,0
26,182,182,33,33,0,1,0
23,204,204,12,12,0,1,0
19,219,219,5,5,0,1,0
15,233,233,1,1,0,1,0
25,273,273,53,27,26,2,1
13,276,276,24,24,0,1,0
1,295,295,26,4,22,3,2
7,304,304,2,2,0,1,0
24,306,306,25,7,18,3,2
21,320,320,21,12,9,2,1
5,378,378,14,11,3,2,1
29,378,378,31,31,0,1,0
0,381,381,1,1,0,1,0
6,382,382,22,22,0,1,0
22,398,398,34,34,0,1,0
27,402,402,51,3,48,3,2
10,425,425,13,13,0,1,0
3,428,428,173,173,0,1,0
12,434,434,19,7,12,4,3
17,452,452,15,15,0,1,0
28,468,468,93,60,33,2,1
4,469,469,16,16,0,1,0
8,472,472,3,3,0,1,0
2,476,476,65,65,0,1,0
20,477,477,91,91,0,1,0
9,479,479,98,60,38,3,2

13,107,107,9,9,0,1,0
12,108,108,6,6,0,1,0
4,113,113,33,33,0,1,0
19,122,122,18,13,5,2,1
17,150,150,1,1,0,1,0
27,164,164,7,7,0,1,0
6,174,174,14,6,8,3,2
9,257,257,40,40,0,1,0
8,261,261,41,4,37,3,2
11,286,286,11,11,0,1,0
14,287,287,16,2,14,2,1
1,308,308,6,1,5,2,1
3,313,313,14,4,10,3,2
22,337,337,63,63,0,1,0
2,354,354,29,19,10,3,2
10,361,361,15,15,0,1,0
15,363,363,48,48,0,1,0
5,372,372,72,72,0,1,0
26,373,373,47,14,33,4,3
23,377,377,108,72,36,2,1
16,397,397,24,4,20,3,2
7,413,413,52,52,0,1,0
25,445,445,29,29,0,1,0
21,458,458,61,27,34,2,1
0,483,483,15,15,0,1,0
20,488,488,18,10,8,3,2
18,490,490,61,61,0,1,0
24,499,499,7,7,0,1,0

12,103,103,9,9,0,1,0
4,106,106,14,2,12,2,1
21,134,134,1,1,0,1,0
0,143,143,7,7,0,1,0
17,155,155,2,2,0,1,0
3,163,163,20,4,16,3,2
10,163,163,22,22,0,1,0
23,176,176,16,16,0,1,0
1,196,196,1,1,0,1,0
18,203,203,12,12,0,1,0
13,217,217,19,3,16,2,1
6,229,229,110,70,40,2,1
11,230,230,16,9,7,2,1
22,285,285,111,49,62,4,3
7,312,312,10,10,0,1,0
2,318,318,8,8,0,1,0
24,364,364,38,1,37,3,2
16,372,372,84,84,0,1,0
8,373,373,71,29,42,4,3
5,380,380,10,10,0,1,0
25,396,396,46,1,45,4,3
9,422,422,57,43,14,3,2
15,431,431,14,8,6,2,1
19,457,457,48,1,47,2,1
20,469,469,5,5,0,1,0
14,477,477,48,22,26,2,1

4,105,105,23,17,6,2,1
21,109,109,3,3,0,1,0
20,112,112,4,4,0,1,0
23,119,119,17,4,13,3,2
14,124,124,53,53,0,1,0
13,125,125,9,3,6,3,2
0,132,132,21,21,0,1,0
2,200,200,10,1,9,4,3
11,205,205,22,22,0,1,0
6,212,212,39,18,21,4,3
16,215,215,6,6,0,1,0
19,218,218,7,7,0,1,0
7,221,221,34,12,22,3,2
5,249,249,13,13,0,1,0
18,250,250,18,12,6,3,2
24,294,294,21,21,0,1,0
8,296,296,9,9,0,1,0
15,331,331,16,16,0,1,0
3,339,339,132,132,0,1,0
12,362,362,91,91,0,1,0
22,372,372,8,2,6,2,1
25,377,377,3,3,0,1,0
9,457,457,6,6,0,1,0
1,457,457,13,7,6,3,2
17,482,482,93,87,6,2,1
10,499,499,7,3,4,2,1

23,103,103,18,18,0,1,0
12,118,118,1,1,0,1,0
17,124,124,17,1,16,2,1
8,132,132,53,2,51,3,2
15,153,153,1,1,0,1,0
28,167,167,14,14,0,1,0
9,218,218,9,9,0,1,0
2,245,245,5,5,0,1,0
13,262,262,38,38,0,1,0
0,263,263,9,1,8,2,1
20,267,267,25,25,0,1,0
22,274,274,15,5,10,3,2
5,281,281,27,27,0,1,0
27,302,302,36,36,0,1,0
6,327,327,17,5,12,2,1
26,351,351,27,27,0,1,0
10,361,361,1,1,0,1,0
1,394,394,123,81,42,4,3
25,420,420,41,19,22,2,1
11,429,429,14,14,0,1,0
19,430,430,76,8,68,3,2
16,449,449,28,28,0,1,0
14,456,456,95,43,52,4,3
24,475,475,67,67,0,1,0
18,482,482,55,46,9,4,3
3,482,482,12,12,0,1,0
7,489,489,1,1,0,1,0
21,497,497,48,48,0,1,0
4,498,498,10,4,6,3,2

32,119,119,32,29,3,2,1
25,121,121,11,1,10,3,2
19,123,123,1,1,0,1,0
18,142,142,7,3,4,2,1
29,150,150,14,14,0,1,0
21,158,158,2,2,0,1,0
11,158,158,12,3,9,4,3
6,188,188,11,11,0,1,0
27,206,206,6,2,4,2,1
26,211,211,34,16,18,2,1
15,218,218,8,2,6,3,2
17,228,228,4,4,0,1,0
24,233,233,43,31,12,3,2
4,239,239,10,6,4,2,1
13,243,243,18,18,0,1,0
5,245,245,6,6,0,1,0
16,247,247,1,1,0,1,0
20,249,249,2,2,0,1,0
23,257,257,7,7,0,1,0
10,258,258,20,14,6,3,2
12,313,313,13,3,10,2,1
33,313,313,10,10,0,1,0
31,339,339,9,1,8,2,1
34,341,341,64,10,54,4,3
0,356,356,71,19,52,4,3
22,364,364,11,11,0,1,0
28,396,396,37,2,35,2,1
2,404,404,2,2,0,1,0
8,430,430,4,4,0,1,0
3,444,444,18,1,17,2,1
9,447,447,50,50,0,1,0
30,462,462,72,72,0,1,0
1,466,466,2,2,0,1,0
14,474,474,194,124,70,3,2
35,486,486,26,10,16,3,2
7,500,500,46,17,29,2,1

3,101,101,1,1,0,1,0
26,115,115,1,1,0,1,0
0,126,126,29,21,8,2,1
7,150,150,2,2,0,1,0
9,170,170,17,17,0,1,0
27,196,196,4,1,3,2,1
6,197,197,1,1,0,1,0
29,245,245,22,22,0,1,0
15,271,271,46,46,0,1,0
16,285,285,50,40,10,3,2
28,304,304,14,14,0,1,0
17,322,322,11,11,0,1,0
14,331,331,30,30,0,1,0
23,337,337,40,40,0,1,0
5,337,337,16,7,9,4,3
19,347,347,15,15,0,1,0
24,353,353,82,6,76,4,3
4,354,354,7,7,0,1,0
10,359,359,12,1,11,2,1
21,373,373,121,97,24,2,1
30,407,407,26,26,0,1,0
18,417,417,10,7,3,2,1
25,430,430,72,72,0,1,0
13,431,431,55,26,29,3,2
2,431,431,52,11,41,4,3
11,440,440,31,22,9,4,3
1,441,441,16,16,0,1,0
8,484,484,63,43,20,3,2
20,485,485,19,19,0,1,0
12,487,487,11,11,0,1,0
22,489,489,102,102,0,1,0

12,101,101,2,2,0,1,0
8,103,103,4,4,0,1,0
17,111,111,31,31,0,1,0
2,139,139,12,8,4,2,1
9,146,146,3,3,0,1,0
26,158,158,3,3,0,1,0
19,166,166,4,4,0,1,0
25,168,168,25,25,0,1,0
11,186,186,5,5,0,1,0
10,189,189,14,2,12,4,3
13,194,194,13,13,0,1,0
24,198,198,3,3,0,1,0
16,225,225,6,2,4,2,1
23,236,236,23,15,8,2,1
4,261,261,9,6,3,2,1
5,301,301,6,6,0,1,0
7,330,330,1,1,0,1,0
22,376,376,91,47,44,2,1
28,384,384,31,31,0,1,0
20,388,388,11,5,6,2,1
1,405,405,3,3,0,1,0
18,419,419,48,1,47,2,1
6,435,435,13,1,12,3,2
15,436,436,66,17,49,4,3
3,437,437,71,38,33,4,3
27,473,473,20,20,0,1,0
14,475,475,91,38,53,4,3
0,488,488,302,302,0,1,0
21,496,496,80,56,24,3,2

0,116,116,45,27,18,2,1
20,139,139,58,2,56,3,2
13,167,167,25,25,0,1,0
19,181,181,5,5,0,1,0
16,202,202,11,6,5,2,1
10,213,213,8,8,0,1,0
18,215,215,5,1,4,2,1
14,234,234,9,2,7,2,1
22,251,251,41,41,0,1,0
12,252,252,11,11,0,1,0
1,281,281,3,3,0,1,0
11,289,289,2,2,0,1,0
6,290,290,99,64,35,2,1
2,294,294,5,1,4,2,1
5,316,316,44,30,14,3,2
21,321,321,22,3,19,4,3
15,357,357,26,6,20,3,2
8,412,412,11,4,7,2,1
24,413,413,67,7,60,4,3
9,430,430,16,16,0,1,0
17,455,455,86,86,0,1,0
7,468,468,11,3,8,2,1
4,473,473,32,17,15,2,1
3,481,481,150,150,0,1,0
23,487,487,8,2,6,3,2

22,103,103,59,59,0,1,0
9,112,112,3,3,0,1,0
3,117,117,15,1,14,3,2
14,133,133,19,19,0,1,0
24,153,153,6,1,5,2,1
6,159,159,1,1,0,1,0
21,166,166,10,1,9,4,3
25,172,172,2,2,0,1,0
17,209,209,7,7,0,1,0
1,211,211,2,2,0,1,0
26,215,215,3,3,0,1,0
16,221,221,7,7,0,1,0
18,232,232,1,1,0,1,0
12,234,234,3,3,0,1,0
10,261,261,37,5,32,2,1
13,276,276,39,39,0,1,0
11,286,286,37,3,34,3,2
15,351,351,12,12,0,1,0
27,360,360,10,3,7,2,1
19,363,363,18,12,6,2,1
2,369,369,67,67,0,1,0
8,375,375,88,49,39,4,3
23,383,383,87,54,33,4,3
5,405,405,58,18,40,4,3
20,413,413,78,34,44,2,1
4,458,458,69,69,0,1,0
0,471,471,14,14,0,1,0
7,479,479,32,12,20,3,2

0,119,119,11,4,7,2,1
14,167,167,67,24,43,2,1
5,168,168,6,3,3,2,1
11,186,186,21,12,9,4,3
22,187,187,2,2,0,1,0
19,196,196,3,3,0,1,0
24,198,198,38,38,0,1,0
10,202,202,14,14,0,1,0
21,233,233,13,13,0,1,0
15,254,254,21,21,0,1,0
6,272,272,42,42,0,1,0
2,282,282,25,1,24,4,3
3,307,307,16,1,15,2,1
18,339,339,9,9,0,1,0
16,360,360,44,44,0,1,0
7,364,364,23,18,5,2,1
13,369,369,81,53,28,2,1
20,373,373,22,22,0,1,0
8,403,403,1,1,0,1,0
9,411,411,220,220,0,1,0
17,432,432,65,47,18,3,2
12,435,435,21,4,17,3,2
23,436,436,5,5,0,1,0
25,439,439,13,6,7,2,1
1,454,454,78,28,50,2,1
4,459,459,10,7,3,2,1

30,105,105,2,2,0,1,0
17,129,129,18,18,0,1,0
9,141,141,13,3,10,2,1
14,142,142,13,13,0,1,0
4,143,143,1,1,0,1,0
10,152,152,15,6,9,4,3
26,167,167,9,9,0,1,0
11,181,181,5,5,0,1,0
6,188,188,48,40,8,3,2
24,208,208,30,8,22,2,1
23,230,230,6,2,4,2,1
20,246,246,40,19,21,4,3
8,258,258,6,6,0,1,0
31,263,263,87,23,64,3,2
2,263,263,10,10,0,1,0
3,264,264,11,11,0,1,0
5,266,266,23,13,10,2,1
22,269,269,29,29,0,1,0
16,285,285,52,52,0,1,0
15,288,288,11,11,0,1,0
12,305,305,26,1,25,2,1
13,305,305,4,4,0,1,0
19,313,313,38,10,28,2,1
18,348,348,13,7,6,2,1
1,351,351,13,13,0,1,0
21,386,386,61,11,50,3,2
28,414,414,9,9,0,1,0
29,425,425,2,2,0,1,0
0,450,450,15,15,0,1,0
25,489,489,39,39,0,1,0
27,490,490,82,54,28,4,3
7,500,500,58,7,51,4,3

17,103,103,3,3,0,1,0
6,124,124,31,31,0,1,0
22,166,166,11,11,0,1,0
25,194,194,16,16,0,1,0
9,206,206,13,4,9,2,1
12,213,213,3,3,0,1,0
13,232,232,2,2,0,1,0
20,232,232,19,11,8,3,2
7,251,251,44,44,0,1,0
15,251,251,19,19,0,1,0
26,264,264,17,1,16,2,1
11,272,272,8,5,3,2,1
16,276,276,59,59,0,1,0
0,281,281,4,4,0,1,0
23,300,300,17,8,9,2,1
19,320,320,100,75,25,4,3
24,338,338,7,3,4,2,1
1,344,344,55,55,0,1,0
14,351,351,94,47,47,2,1
10,364,364,122,122,0,1,0
8,368,368,2,2,0,1,0
2,371,371,32,2,30,4,3
4,405,405,31,31,0,1,0
21,426,426,7,1,6,3,2
3,432,432,43,33,10,2,1
5,496,496,46,7,39,3,2
18,498,498,67,49,18,3,2

9,111,111,1,1,0,1,0
11,115,115,2,2,0,1,0
20,125,125,7,7,0,1,0
30,126,126,14,14,0,1,0
15,144,144,1,1,0,1,0
7,153,153,16,16,0,1,0
25,165,165,4,4,0,1,0
32,171,171,7,7,0,1,0
13,179,179,29,9,20,2,1
1,201,201,17,5,12,4,3
3,202,202,5,5,0,1,0
6,215,215,25,5,20,3,2
10,215,215,19,6,13,2,1
33,226,226,11,11,0,1,0
2,230,230,30,15,15,4,3
26,234,234,72,26,46,3,2
16,268,268,8,8,0,1,0
12,275,275,13,13,0,1,0
5,291,291,1,1,0,1,0
0,295,295,8,8,0,1,0
17,296,296,35,13,22,2,1
8,316,316,9,9,0,1,0
23,342,342,10,10,0,1,0
19,355,355,13,13,0,1,0
21,372,372,83,83,0,1,0
18,382,382,5,5,0,1,0
28,382,382,56,56,0,1,0
22,395,395,90,60,30,4,3
31,446,446,12,4,8,3,2
34,455,455,36,25,11,2,1
29,462,462,56,39,17,2,1
27,491,491,9,9,0,1,0
4,491,491,90,42,48,4,3
24,494,494,6,6,0,1,0
14,495,495,57,10,47,2,1

14,120,120,3,3,0,1,0
27,134,134,28,28,0,1,0
28,135,135,18,6,12,2,1
24,141,141,3,3,0,1,0
4,158,158,1,1,0,1,0
12,160,160,9,6,3,2,1
21,161,161,21,13,8,2,1
0,179,179,5,5,0,1,0
16,188,188,49,10,39,2,1
25,199,199,2,2,0,1,0
30,202,202,33,33,0,1,0
13,232,232,12,12,0,1,0
1,277,277,68,26,42,4,3
10,277,277,8,8,0,1,0
17,279,279,39,2,37,2,1
29,287,287,72,46,26,3,2
9,289,289,9,9,0,1,0
6,291,291,9,6,3,2,1
2,301,301,11,2,9,4,3
23,301,301,3,3,0,1,0
5,307,307,1,1,0,1,0
3,353,353,4,4,0,1,0
20,365,365,13,5,8,2,1
15,402,402,16,16,0,1,0
26,403,403,87,87,0,1,0
22,419,419,13,13,0,1,0
11,440,440,126,80,46,2,1
7,442,442,85,76,9,4,3
19,456,456,15,7,8,2,1
8,466,466,32,32,0,1,0
18,490,490,19,3,16,3,2

20,138,138,9,9,0,1,0
16,143,143,29,29,0,1,0
6,155,155,27,27,0,1,0
10,164,164,12,1,11,2,1
0,175,175,22,2,20,3,2
11,180,180,10,7,3,2,1
7,200,200,24,9,15,2,1
1,211,211,29,15,14,3,2
26,216,216,26,26,0,1,0
23,248,248,2,2,0,1,0
24,253,253,1,1,0,1,0
28,256,256,10,10,0,1,0
15,266,266,65,7,58,3,2
12,269,269,22,14,8,3,2
17,270,270,18,5,13,2,1
14,274,274,7,7,0,1,0
3,300,300,2,2,0,1,0
30,349,349,150,42,108,4,3
9,350,350,8,3,5,2,1
29,369,369,52,32,20,3,2
2,387,387,25,7,18,2,1
4,396,396,14,14,0,1,0
19,407,407,66,66,0,1,0
18,414,414,35,3,32,3,2
25,417,417,15,15,0,1,0
8,420,420,2,2,0,1,0
13,454,454,1,1,0,1,0
5,458,458,11,11,0,1,0
27,478,478,63,21,42,2,1
22,489,489,53,53,0,1,0
21,492,492,13,6,7,2,1

10,148,148,5,5,0,1,0
1,170,170,3,3,0,1,0
13,204,204,2,2,0,1,0
23,240,240,16,16,0,1,0
20,246,246,53,53,0,1,0
9,275,275,15,15,0,1,0
22,278,278,27,18,9,4,3
4,294,294,134,130,4,2,1
25,306,306,32,32,0,1,0
18,310,310,48,22,26,3,2
14,314,314,24,9,15,4,3
6,347,347,6,6,0,1,0
16,404,404,29,9,20,2,1
2,413,413,88,4,84,4,3
12,419,419,23,2,21,4,3
7,427,427,18,18,0,1,0
17,437,437,24,12,12,4,3
24,438,438,61,45,16,3,2
5,440,440,162,33,129,4,3
19,444,444,96,96,0,1,0
11,447,447,38,38,0,1,0
8,451,451,10,10,0,1,0
3,461,461,23,3,20,3,2
21,465,465,27,1,26,2,1
15,474,474,49,38,11,2,1
0,498,498,21,5,16,3,2

27,106,106,5,1,4,2,1
11,124,124,29,29,0,1,0
20,152,152,1,1,0,1,0
6,167,167,11,11,0,1,0
19,167,167,40,40,0,1,0
14,171,171,28,8,20,4,3
17,183,183,6,1,5,2,1
18,198,198,39,20,19,2,1
13,211,211,12,12,0,1,0
7,225,225,5,5,0,1,0
29,245,245,6,6,0,1,0
30,249,249,17,11,6,3,2
22,251,251,86,86,0,1,0
5,275,275,1,1,0,1,0
12,282,282,4,4,0,1,0
0,282,282,27,7,20,3,2
2,287,287,10,10,0,1,0
15,294,294,23,3,20,3,2
9,351,351,15,15,0,1,0
28,370,370,24,24,0,1,0
4,410,410,1,1,0,1,0
23,412,412,46,5,41,4,3
25,412,412,5,5,0,1,0
8,414,414,62,17,45,4,3
1,444,444,61,37,24,4,3
10,446,446,99,90,9,4,3
21,448,448,17,1,16,2,1
26,451,451,108,108,0,1,0
24,462,462,3,3,0,1,0
16,463,463,34,34,0,1,0
3,468,468,2,2,0,1,0

17,113,113,24,24,0,1,0
3,191,191,33,33,0,1,0
15,198,198,34,26,8,2,1
20,227,227,71,71,0,1,0
24,231,231,11,11,0,1,0
6,235,235,31,4,27,2,1
2,245,245,23,15,8,3,2
21,264,264,5,5,0,1,0
0,294,294,54,54,0,1,0
16,307,307,15,15,0,1,0
19,308,308,9,3,6,2,1
5,310,310,9,3,6,2,1
9,321,321,4,4,0,1,0
26,326,326,14,14,0,1,0
14,338,338,22,22,0,1,0
22,360,360,25,25,0,1,0
27,366,366,46,46,0,1,0
11,383,383,1,1,0,1,0
13,386,386,7,2,5,2,1
25,390,390,90,30,60,4,3
7,434,434,16,2,14,3,2
4,437,437,20,20,0,1,0
10,439,439,31,31,0,1,0
1,452,452,23,15,8,3,2
28,454,454,40,10,30,4,3
23,457,457,5,1,4,2,1
18,464,464,5,5,0,1,0
8,485,485,186,144,42,4,3
12,498,498,52,52,0,1,0

13,105,105,13,5,8,2,1
11,109,109,9,5,4,2,1
4,146,146,16,16,0,1,0
16,158,158,28,28,0,1,0
10,191,191,20,10,10,2,1
20,194,194,21,8,13,2,1
1,238,238,20,7,13,2,1
18,243,243,23,11,12,2,1
17,245,245,50,50,0,1,0
6,248,248,32,16,16,3,2
5,251,251,42,42,0,1,0
8,257,257,1,1,0,1,0
12,263,263,2,2,0,1,0
19,302,302,1,1,0,1,0
15,308,308,27,9,18,4,3
2,327,327,110,110,0,1,0
26,337,337,2,2,0,1,0
9,343,343,5,5,0,1,0
14,371,371,20,20,0,1,0
21,431,431,29,9,20,2,1
25,431,431,31,31,0,1,0
23,432,432,123,84,39,4,3
24,464,464,42,20,22,3,2
0,472,472,111,105,6,3,2
22,486,486,25,8,17,2,1
7,493,493,35,35,0,1,0
3,499,499,28,28,0,1,0

20,102,102,12,3,9,2,1
1,103,103,6,1,5,2,1
10,132,132,10,2,8,3,2
29,139,139,20,10,10,2,1
7,147,147,4,4,0,1,0
28,198,198,33,1,32,2,1
21,201,201,47,19,28,4,3
6,210,210,29,29,0,1,0
22,214,214,23,23,0,1,0
13,225,225,8,5,3,2,1
2,243,243,29,29,0,1,0
27,255,255,1,1,0,1,0
24,269,269,58,44,14,2,1
0,282,282,9,4,5,2,1
15,288,288,5,5,0,1,0
25,312,312,58,58,0,1,0
18,330,330,19,4,15,4,3
26,332,332,11,8,3,2,1
5,333,333,11,2,9,4,3
3,360,360,31,7,24,2,1
4,380,380,29,6,23,4,3
11,397,397,15,15,0,1,0
12,409,409,42,9,33,4,3
9,410,410,47,3,44,3,2
23,434,434,32,32,0,1,0
19,446,446,4,4,0,1,0
16,451,451,9,5,4,2,1
8,472,472,135,135,0,1,0
14,479,479,78,62,16,3,2
17,482,482,31,31,0,1,0

10,126,126,2,2,0,1,0
14,171,171,9,9,0,1,0
16,185,185,13,13,0,1,0
8,216,216,11,11,0,1,0
20,251,251,36,12,24,3,2
1,255,255,65,20,45,4,3
7,261,261,11,1,10,2,1
0,264,264,1,1,0,1,0
24,266,266,1,1,0,1,0
19,281,281,21,9,12,4,3
22,285,285,2,2,0,1,0
21,290,290,33,33,0,1,0
15,314,314,61,61,0,1,0
25,325,325,31,16,15,3,2
5,335,335,1,1,0,1,0
6,344,344,34,12,22,2,1
9,364,364,7,7,0,1,0
4,369,369,21,2,19,2,1
11,373,373,86,86,0,1,0
17,385,385,135,41,94,3,2
26,400,400,57,31,26,2,1
23,420,420,2,2,0,1,0
18,426,426,6,2,4,2,1
3,436,436,59,35,24,3,2
12,479,479,146,96,50,4,3
13,495,495,76,55,21,4,3
2,495,495,91,82,9,4,3

13,161,161,24,21,3,2,1
4,183,183,1,1,0,1,0
14,245,245,37,20,17,3,2
7,265,265,30,30,0,1,0
22,293,293,29,2,27,2,1
10,295,295,4,4,0,1,0
2,307,307,70,70,0,1,0
20,316,316,17,11,6,2,1
3,318,318,73,57,16,2,1
18,337,337,89,89,0,1,0
15,338,338,104,44,60,4,3
9,353,353,19,19,0,1,0
0,369,369,1,1,0,1,0
21,382,382,5,5,0,1,0
12,385,385,55,39,16,3,2
11,397,397,14,8,6,2,1
16,411,411,2,2,0,1,0
17,412,412,52,32,20,2,1
8,423,423,61,11,50,3,2
19,434,434,5,5,0,1,0
1,492,492,120,120,0,1,0
6,495,495,31,31,0,1,0
5,497,497,185,106,79,4,3

22,132,132,4,4,0,1,0
3,141,141,9,3,6,2,1
21,146,146,47,47,0,1,0
9,151,151,4,4,0,1,0
17,169,169,8,8,0,1,0
19,171,171,2,2,0,1,0
7,180,180,14,14,0,1,0
28,201,201,5,5,0,1,0
11,246,246,108,108,0,1,0
24,247,247,38,38,0,1,0
2,247,247,18,18,0,1,0
27,286,286,3,3,0,1,0
23,317,317,21,2,19,4,3
25,326,326,61,61,0,1,0
20,336,336,2,2,0,1,0
15,359,359,38,17,21,4,3
8,359,359,60,60,0,1,0
1,373,373,44,2,42,2,1
6,388,388,24,6,18,4,3
16,389,389,78,2,76,3,2
18,390,390,91,23,68,4,3
13,393,393,83,49,34,3,2
5,415,415,1,1,0,1,0
0,417,417,8,8,0,1,0
14,428,428,11,8,3,2,1
26,431,431,14,6,8,2,1
12,469,469,36,4,32,3,2
10,474,474,12,1,11,2,1
4,474,474,6,6,0,1,0

20,101,101,8,8,0,1,0
19,110,110,1,1,0,1,0
3,115,115,1,1,0,1,0
31,118,118,51,51,0,1,0
30,124,124,11,11,0,1,0
0,133,133,8,8,0,1,0
12,145,145,5,5,0,1,0
23,148,148,3,3,0,1,0
21,162,162,3,3,0,1,0
27,173,173,8,8,0,1,0
4,211,211,9,9,0,1,0
26,214,214,14,14,0,1,0
34,219,219,48,11,37,2,1
22,222,222,13,7,6,2,1
16,233,233,37,17,20,3,2
29,234,234,6,6,0,1,0
25,261,261,13,13,0,1,0
1,265,265,35,10,25,2,1
2,267,267,1,1,0,1,0
10,280,280,10,10,0,1,0
5,282,282,44,14,30,2,1
11,284,284,17,17,0,1,0
14,299,299,1,1,0,1,0
13,310,310,19,19,0,1,0
17,328,328,10,10,0,1,0
8,382,382,14,14,0,1,0
32,386,386,7,7,0,1,0
15,391,391,91,55,36,3,2
18,395,395,19,19,0,1,0
33,410,410,10,10,0,1,0
6,414,414,48,48,0,1,0
7,464,464,24,17,7,2,1
28,466,466,105,32,73,3,2
9,475,475,10,10,0,1,0
24,489,489,68,68,0,1,0
35,493,493,9,9,0,1,0

11,125,125,33,33,0,1,0
18,186,186,13,7,6,3,2
1,200,200,27,2,25,2,1
21,200,200,17,2,15,4,3
4,204,204,86,78,8,2,1
20,248,248,5,2,3,2,1
19,253,253,65,44,21,4,3
8,264,264,16,16,0,1,0
24,274,274,32,20,12,2,1
3,280,280,36,20,16,2,1
0,307,307,19,3,16,2,1
7,329,329,37,37,0,1,0
22,339,339,21,21,0,1,0
17,344,344,11,2,9,2,1
23,369,369,62,62,0,1,0
12,386,386,46,4,42,3,2
10,394,394,40,4,36,3,2
5,403,403,20,8,12,4,3
9,415,415,58,42,16,2,1
14,419,419,44,1,43,2,1
13,437,437,29,29,0,1,0
6,462,462,35,25,10,3,2
15,472,472,24,8,16,3,2
2,481,481,55,42,13,2,1
16,492,492,3,3,0,1,0

17,129,129,5,5,0,1,0
15,144,144,1,1,0,1,0
0,152,152,2,2,0,1,0
35,154,154,38,38,0,1,0
5,160,160,5,2,3,2,1
11,176,176,17,3,14,2,1
7,186,186,15,1,14,2,1
1,214,214,15,15,0,1,0
26,233,233,61,61,0,1,0
27,239,239,45,45,0,1,0
34,247,247,12,12,0,1,0
13,251,251,4,4,0,1,0
33,258,258,69,69,0,1,0
9,277,277,37,37,0,1,0
23,299,299,2,2,0,1,0
29,305,305,1,1,0,1,0
19,315,315,28,18,10,2,1
12,319,319,5,5,0,1,0
28,327,327,19,1,18,2,1
36,338,338,21,6,15,4,3
2,350,350,40,40,0,1,0
32,367,367,6,2,4,2,1
25,372,372,4,1,3,2,1
16,380,380,16,16,0,1,0
4,392,392,7,7,0,1,0
8,420,420,5,5,0,1,0
21,433,433,117,57,60,3,2
31,437,437,26,16,10,3,2
18,447,447,15,15,0,1,0
22,454,454,92,92,0,1,0
30,460,460,10,1,9,2,1
14,464,464,24,24,0,1,0
3,464,464,3,3,0,1,0
10,476,476,14,14,0,1,0
24,482,482,83,6,77,4,3
20,493,493,13,13,0,1,0
6,494,494,2,2,0,1,0

3,101,101,1,1,0,1,0
27,124,124,11,8,3,2,1
0,137,137,7,1,6,3,2
26,144,144,18,4,14,2,1
31,151,151,75,11,64,4,3
9,159,159,20,11,9,4,3
32,168,168,18,18,0,1,0
4,174,174,1,1,0,1,0
19,191,191,7,7,0,1,0
8,203,203,27,11,16,3,2
25,203,203,9,9,0,1,0
14,213,213,31,10,21,2,1
11,241,241,18,18,0,1,0
22,245,245,10,10,0,1,0
7,270,270,55,2,53,4,3
13,277,277,12,12,0,1,0
17,278,278,3,3,0,1,0
20,280,280,9,9,0,1,0
33,287,287,5,2,3,2,1
29,297,297,25,25,0,1,0
2,324,324,22,22,0,1,0
21,328,328,20,9,11,2,1
16,346,346,52,22,30,3,2
24,349,349,75,41,34,3,2
23,350,350,30,30,0,1,0
18,352,352,30,18,12,4,3
10,373,373,1,1,0,1,0
28,387,387,9,1,8,2,1
6,403,403,6,6,0,1,0
1,418,418,6,6,0,1,0
12,422,422,80,23,57,4,3
5,447,447,16,16,0,1,0
15,470,470,1,1,0,1,0
30,498,498,4,4,0,1,0

18,100,100,30,30,0,1,0
14,111,111,19,14,5,2,1
10,119,119,3,3,0,1,0
7,187,187,1,1,0,1,0
12,190,190,2,2,0,1,0
4,199,199,1,1,0,1,0
16,215,215,29,19,10,2,1
19,229,229,19,19,0,1,0
3,240,240,61,6,55,4,3
0,289,289,20,20,0,1,0
6,353,353,235,153,82,4,3
22,358,358,4,1,3,2,1
9,397,397,32,32,0,1,0
20,400,400,13,2,11,2,1
2,400,400,51,51,0,1,0
17,401,401,59,43,16,2,1
13,422,422,61,3,58,3,2
8,452,452,5,5,0,1,0
21,455,455,24,2,22,2,1
5,463,463,83,83,0,1,0
1,465,465,39,21,18,4,3
11,477,477,64,6,58,3,2
15,483,483,52,24,28,3,2

24,100,100,3,3,0,1,0
11,123,123,24,3,21,2,1
15,128,128,11,11,0,1,0
28,131,131,5,1,4,2,1
1,148,148,10,10,0,1,0
10,149,149,1,1,0,1,0
14,189,189,2,2,0,1,0
23,212,212,76,38,38,3,2
32,213,213,10,10,0,1,0
29,236,236,28,28,0,1,0
7,261,261,24,24,0,1,0
16,268,268,20,20,0,1,0
19,274,274,12,12,0,1,0
6,275,275,8,8,0,1,0
8,282,282,1,1,0,1,0
17,315,315,55,39,16,4,3
30,325,325,38,2,36,3,2
25,328,328,133,82,51,4,3
13,338,338,1,1,0,1,0
2,363,363,20,2,18,4,3
12,390,390,16,2,14,3,2
18,391,391,28,28,0,1,0
20,402,402,19,19,0,1,0
0,408,408,65,30,35,4,3
4,411,411,44,44,0,1,0
5,414,414,71,71,0,1,0
3,424,424,1,1,0,1,0
26,443,443,8,2,6,2,1
27,459,459,21,21,0,1,0
31,464,464,53,53,0,1,0
22,470,470,11,11,0,1,0
9,484,484,25,25,0,1,0
21,497,497,11,5,6,3,2

3,110,110,22,13,9,4,3
23,111,111,19,7,12,3,2
20,122,122,2,2,0,1,0
6,127,127,17,6,11,2,1
5,144,144,9,9,0,1,0
21,146,146,23,13,10,2,1
12,151,151,1,1,0,1,0
1,161,161,14,11,3,2,1
2,170,170,1,1,0,1,0
10,176,176,9,3,6,2,1
16,188,188,33,33,0,1,0
4,224,224,89,6,83,4,3
19,239,239,33,3,30,3,2
22,265,265,13,13,0,1,0
17,274,274,50,38,12,4,3
8,282,282,6,6,0,1,0
15,307,307,38,38,0,1,0
14,349,349,60,51,9,4,3
11,379,379,58,58,0,1,0
9,421,421,58,44,14,3,2
7,436,436,105,36,69,4,3
0,456,456,52,36,16,2,1
13,474,474,12,12,0,1,0
18,491,491,4,4,0,1,0

9,119,119,37,37,0,1,0
4,128,128,40,3,37,2,1
22,149,149,19,19,0,1,0
6,161,161,1,1,0,1,0
0,184,184,11,1,10,2,1
15,186,186,4,1,3,2,1
17,187,187,9,9,0,1,0
16,200,200,24,24,0,1,0
7,238,238,8,8,0,1,0
1,247,247,41,41,0,1,0
5,248,248,29,22,7,2,1
23,250,250,40,40,0,1,0
3,266,266,33,16,17,2,1
18,283,283,12,7,5,2,1
12,295,295,62,28,34,3,2
11,297,297,12,8,4,2,1
2,310,310,68,68,0,1,0
21,325,325,51,22,29,4,3
19,402,402,43,7,36,2,1
14,418,418,82,82,0,1,0
8,435,435,23,23,0,1,0
13,441,441,34,6,28,2,1
20,469,469,34,34,0,1,0
10,495,495,24,5,19,2,1

14,122,122,15,15,0,1,0
12,124,124,1,1,0,1,0
1,130,130,2,2,0,1,0
6,160,160,43,37,6,2,1
25,163,163,23,18,5,2,1
22,178,178,27,27,0,1,0
21,187,187,26,17,9,2,1
18,207,207,2,2,0,1,0
8,215,215,29,15,14,2,1
20,218,218,4,4,0,1,0
17,224,224,8,8,0,1,0
29,232,232,9,1,8,2,1
26,234,234,92,29,63,4,3
11,240,240,12,12,0,1,0
2,259,259,9,2,7,2,1
4,275,275,11,11,0,1,0
0,308,308,54,54,0,1,0
16,326,326,21,6,15,4,3
7,358,358,8,8,0,1,0
9,365,365,5,5,0,1,0
19,389,389,16,16,0,1,0
3,405,405,10,1,9,2,1
5,423,423,11,2,9,4,3
13,427,427,77,77,0,1,0
24,428,428,4,4,0,1,0
15,440,440,121,121,0,1,0
27,441,441,92,83,9,4,3
28,453,453,33,33,0,1,0
10,470,470,4,4,0,1,0
23,495,495,50,15,35,2,1

24,147,147,5,5,0,1,0
25,160,160,41,33,8,2,1
8,177,177,7,7,0,1,0
17,187,187,16,16,0,1,0
21,198,198,3,3,0,1,0
23,212,212,23,23,0,1,0
18,220,220,26,26,0,1,0
10,274,274,40,4,36,3,2
13,288,288,5,5,0,1,0
6,304,304,85,15,70,3,2
1,311,311,26,10,16,3,2
12,321,321,1,1,0,1,0
11,360,360,71,43,28,2,1
20,369,369,104,20,84,4,3
3,380,380,5,5,0,1,0
22,393,393,33,33,0,1,0
15,396,396,16,12,4,2,1
0,412,412,143,36,107,4,3
7,417,417,18,18,0,1,0
9,421,421,23,23,0,1,0
4,424,424,1,1,0,1,0
5,439,439,70,70,0,1,0
16,455,455,3,3,0,1,0
2,459,459,16,10,6,3,2
14,467,467,117,103,14,2,1
19,496,496,66,6,60,4,3

8,103,103,9,1,8,2,1
31,106,106,9,3,6,3,2
4,112,112,8,8,0,1,0
25,136,136,4,4,0,1,0
30,142,142,11,11,0,1,0
9,196,196,5,5,0,1,0
5,211,211,1,1,0,1,0
27,219,219,12,12,0,1,0
16,231,231,5,5,0,1,0
21,249,249,6,6,0,1,0
24,269,269,76,2,74,3,2
15,271,271,37,4,33,4,3
11,284,284,15,3,12,3,2
0,289,289,4,1,3,2,1
26,312,312,77,37,40,3,2
22,313,313,98,72,26,3,2
12,316,316,5,5,0,1,0
28,322,322,5,5,0,1,0
7,339,339,11,11,0,1,0
20,360,360,34,34,0,1,0
14,368,368,122,122,0,1,0
1,372,372,1,1,0,1,0
23,392,392,20,17,3,2,1
2,402,402,26,6,20,3,2
17,409,409,28,28,0,1,0
3,425,425,121,13,108,4,3
6,427,427,22,19,3,2,1
29,441,441,15,15,0,1,0
19,445,445,17,17,0,1,0
10,465,465,30,30,0,1,0
13,479,479,34,2,32,2,1
18,489,489,44,44,0,1,0

4,106,106,7,7,0,1,0
25,109,109,5,1,4,2,1
23,120,120,8,1,7,2,1
19,135,135,22,22,0,1,0
26,139,139,10,5,5,2,1
3,157,157,13,13,0,1,0
24,165,165,31,6,25,2,1
6,167,167,1,1,0,1,0
16,174,174,18,18,0,1,0
13,197,197,6,6,0,1,0
12,229,229,32,14,18,4,3
21,237,237,13,13,0,1,0
22,293,293,91,43,48,4,3
1,306,306,30,19,11,2,1
9,321,321,51,23,28,3,2
0,332,332,76,76,0,1,0
8,352,352,62,29,33,2,1
11,352,352,54,19,35,2,1
20,372,372,16,16,0,1,0
7,378,378,28,16,12,4,3
18,391,391,7,7,0,1,0
15,433,433,9,9,0,1,0
17,434,434,116,5,111,4,3
5,436,436,5,5,0,1,0
2,444,444,74,5,69,4,3
14,454,454,27,18,9,4,3
10,475,475,19,19,0,1,0

17,112,112,11,11,0,1,0
25,123,123,1,1,0,1,0
5,142,142,7,1,6,3,2
8,152,152,1,1,0,1,0
23,156,156,16,16,0,1,0
7,162,162,20,20,0,1,0
1,169,169,8,5,3,2,1
10,180,180,11,11,0,1,0
26,187,187,47,4,43,4,3
19,191,191,3,3,0,1,0
12,231,231,1,1,0,1,0
20,239,239,3,3,0,1,0
14,260,260,6,6,0,1,0
18,292,292,11,11,0,1,0
9,337,337,23,13,10,2,1
11,353,353,89,89,0,1,0
4,361,361,2,2,0,1,0
24,372,372,83,73,10,3,2
22,374,374,6,6,0,1,0
6,383,383,40,9,31,2,1
3,393,393,211,165,46,3,2
2,396,396,41,41,0,1,0
21,407,407,60,60,0,1,0
0,424,424,17,3,14,2,1
13,446,446,23,9,14,2,1
16,464,464,164,104,60,3,2
15,481,481,41,36,5,2,1

10,101,101,5,5,0,1,0
4,107,107,35,26,9,2,1
27,147,147,60,60,0,1,0
28,149,149,22,2,20,3,2
20,156,156,17,17,0,1,0
26,162,162,4,1,3,2,1
25,182,182,2,2,0,1,0
7,185,185,6,6,0,1,0
24,195,195,13,1,12,2,1
29,209,209,17,2,15,2,1
11,214,214,3,3,0,1,0
15,245,245,1,1,0,1,0
13,262,262,31,31,0,1,0
22,262,262,8,8,0,1,0
18,276,276,15,15,0,1,0
16,293,293,24,9,15,4,3
19,315,315,3,3,0,1,0
3,335,335,20,20,0,1,0
23,344,344,24,2,22,3,2
1,361,361,2,2,0,1,0
8,363,363,17,17,0,1,0
0,368,368,8,5,3,2,1
21,376,376,8,2,6,2,1
17,388,388,103,91,12,3,2
9,393,393,18,6,12,2,1
12,402,402,15,3,12,4,3
14,419,419,22,22,0,1,0
2,427,427,15,15,0,1,0
31,448,448,53,53,0,1,0
5,453,453,72,65,7,2,1
6,480,480,21,6,15,4,3
30,487,487,132,75,57,4,3

23,109,109,43,38,5,2,1
19,124,124,7,1,6,3,2
4,139,139,11,3,8,2,1
13,147,147,10,10,0,1,0
3,151,151,3,3,0,1,0
1,157,157,10,1,9,4,3
6,158,158,2,2,0,1,0
8,163,163,20,10,10,3,2
5,174,174,12,2,10,3,2
21,183,183,28,28,0,1,0
27,262,262,74,74,0,1,0
29,267,267,12,12,0,1,0
17,297,297,30,30,0,1,0
25,332,332,37,19,18,2,1
16,364,364,12,4,8,3,2
2,375,375,11,11,0,1,0
12,378,378,3,3,0,1,0
0,389,389,29,12,17,2,1
18,414,414,9,4,5,2,1
9,416,416,62,15,47,4,3
24,425,425,7,4,3,2,1
7,439,439,8,8,0,1,0
14,444,444,91,91,0,1,0
15,455,455,3,3,0,1,0
10,464,464,193,79,114,4,3
28,471,471,75,75,0,1,0
22,485,485,2,2,0,1,0
11,486,486,29,23,6,3,2
20,490,490,8,1,7,2,1
26,494,494,16,16,0,1,0

15,100,100,6,6,0,1,0
25,126,126,20,6,14,2,1
7,132,132,15,15,0,1,0
11,136,136,33,1,32,3,2
6,150,150,22,5,17,2,1
17,169,169,26,6,20,3,2
18,174,174,24,24,0,1,0
24,176,176,7,7,0,1,0
12,202,202,48,41,7,2,1
20,202,202,21,21,0,1,0
2,210,210,3,3,0,1,0
23,212,212,14,3,11,2,1
13,268,268,13,7,6,2,1
8,285,285,2,2,0,1,0
4,304,304,7,7,0,1,0
5,314,314,24,24,0,1,0
26,320,320,37,37,0,1,0
9,324,324,40,11,29,2,1
22,350,350,76,76,0,1,0
10,352,352,33,33,0,1,0
0,354,354,1,1,0,1,0
1,370,370,116,22,94,3,2
19,385,385,49,49,0,1,0
21,440,440,23,23,0,1,0
14,443,443,46,39,7,2,1
3,448,448,4,4,0,1,0
16,482,482,21,16,5,2,1

27,115,115,17,17,0,1,0
19,121,121,41,4,37,2,1
29,134,134,9,9,0,1,0
24,143,143,1,1,0,1,0
5,148,148,9,9,0,1,0
25,148,148,13,4,9,4,3
20,171,171,14,14,0,1,0
6,181,181,2,2,0,1,0
23,200,200,3,3,0,1,0
0,213,213,29,29,0,1,0
9,238,238,24,15,9,4,3
13,248,248,8,8,0,1,0
26,249,249,3,3,0,1,0
14,261,261,25,1,24,2,1
11,263,263,30,30,0,1,0
16,272,272,7,7,0,1,0
21,275,275,39,39,0,1,0
22,282,282,23,1,22,4,3
28,300,300,12,8,4,2,1
10,302,302,107,93,14,3,2
18,329,329,88,28,60,4,3
12,353,353,1,1,0,1,0
7,362,362,32,23,9,2,1
17,367,367,46,28,18,4,3
1,399,399,21,21,0,1,0
15,419,419,29,29,0,1,0
8,426,426,57,4,53,4,3
3,437,437,12,12,0,1,0
4,453,453,24,24,0,1,0
2,480,480,33,33,0,1,0

18,107,107,3,3,0,1,0
25,124,124,3,3,0,1,0
17,124,124,2,2,0,1,0
20,127,127,1,1,0,1,0
24,153,153,4,4,0,1,0
6,166,166,36,22,14,2,1
5,178,178,2,2,0,1,0
7,183,183,9,9,0,1,0
11,223,223,27,27,0,1,0
19,237,237,35,3,32,3,2
16,270,270,128,128,0,1,0
0,289,289,97,61,36,3,2
15,312,312,20,20,0,1,0
13,321,321,143,143,0,1,0
10,323,323,100,52,48,2,1
3,332,332,14,8,6,2,1
14,333,333,2,2,0,1,0
9,370,370,27,2,25,2,1
22,422,422,29,29,0,1,0
12,427,427,27,27,0,1,0
2,433,433,5,5,0,1,0
4,442,442,96,2,94,3,2
8,445,445,5,5,0,1,0
1,479,479,1,1,0,1,0
21,496,496,28,28,0,1,0
23,497,497,5,5,0,1,0

18,104,104,16,16,0,1,0
19,104,104,6,6,0,1,0
26,143,143,30,11,19,2,1
8,210,210,4,4,0,1,0
0,219,219,17,17,0,1,0
25,274,274,5,2,3,2,1
7,283,283,5,5,0,1,0
20,288,288,34,29,5,2,1
5,288,288,82,82,0,1,0
15,288,288,36,26,10,2,1
14,310,310,39,39,0,1,0
12,317,317,26,22,4,2,1
16,320,320,4,4,0,1,0
13,322,322,22,13,9,4,3
4,325,325,33,13,20,3,2
6,327,327,64,3,61,4,3
24,328,328,40,40,0,1,0
17,350,350,5,2,3,2,1
11,369,369,25,3,22,2,1
10,375,375,28,28,0,1,0
2,375,375,62,55,7,2,1
9,376,376,38,14,24,3,2
1,416,416,85,85,0,1,0
23,433,433,62,34,28,3,2
21,456,456,21,21,0,1,0
3,462,462,4,4,0,1,0
22,485,485,101,30,71,4,3

2,103,103,13,4,9,4,3
22,123,123,2,2,0,1,0
14,124,124,13,4,9,4,3
30,124,124,3,3,0,1,0
17,129,129,9,9,0,1,0
8,133,133,4,4,0,1,0
29,144,144,7,7,0,1,0
18,190,190,45,29,16,2,1
26,195,195,39,39,0,1,0
21,201,201,14,11,3,2,1
15,207,207,5,5,0,1,0
7,207,207,16,16,0,1,0
10,236,236,27,27,0,1,0
16,246,246,27,27,0,1,0
1,246,246,5,1,4,2,1
19,252,252,22,22,0,1,0
13,274,274,1,1,0,1,0
5,282,282,30,27,3,2,1
6,302,302,27,2,25,3,2
24,306,306,83,1,82,3,2
20,306,306,38,28,10,3,2
28,309,309,13,2,11,2,1
32,315,315,30,30,0,1,0
31,324,324,80,80,0,1,0
23,358,358,15,5,10,3,2
12,376,376,2,2,0,1,0
0,391,391,12,4,8,2,1
25,393,393,6,6,0,1,0
4,414,414,51,51,0,1,0
11,473,473,19,3,16,3,2
3,475,475,14,14,0,1,0
27,489,489,67,67,0,1,0
9,494,494,29,24,5,2,1

9,103,103,2,2,0,1,0
22,139,139,40,40,0,1,0
0,161,161,4,4,0,1,0
21,195,195,11,1,10,3,2
8,196,196,17,17,0,1,0
20,215,215,48,42,6,3,2
15,220,220,44,8,36,2,1
1,221,221,28,4,24,4,3
6,277,277,68,68,0,1,0
19,334,334,62,25,37,2,1
23,348,348,23,23,0,1,0
17,349,349,16,12,4,2,1
13,355,355,43,16,27,4,3
2,357,357,107,3,104,4,3
14,376,376,14,3,11,3,2
26,380,380,6,6,0,1,0
4,384,384,36,36,0,1,0
18,407,407,17,17,0,1,0
12,410,410,13,13,0,1,0
11,419,419,56,20,36,3,2
7,440,440,50,50,0,1,0
24,443,443,12,12,0,1,0
3,447,447,16,2,14,3,2
25,453,453,17,9,8,3,2
5,462,462,56,14,42,2,1
16,470,470,38,38,0,1,0
10,488,488,34,12,22,3,2

14,150,150,18,2,16,2,1
3,160,160,31,31,0,1,0
10,187,187,9,3,6,2,1
16,204,204,42,24,18,3,2
15,209,209,17,17,0,1,0
12,223,223,10,10,0,1,0
0,234,234,5,1,4,2,1
22,239,239,12,3,9,3,2
19,262,262,47,47,0,1,0
7,293,293,24,17,7,2,1
18,297,297,7,7,0,1,0
6,297,297,41,41,0,1,0
1,310,310,11,11,0,1,0
17,356,356,23,23,0,1,0
8,363,363,107,26,81,4,3
23,377,377,44,44,0,1,0
13,384,384,56,44,12,3,2
11,393,393,51,51,0,1,0
20,413,413,39,3,36,3,2
21,416,416,48,48,0,1,0
2,427,427,133,133,0,1,0
5,433,433,116,116,0,1,0
9,467,467,14,4,10,3,2
4,473,473,12,6,6,3,2

16,135,135,8,8,0,1,0
7,145,145,10,4,6,2,1
17,147,147,29,29,0,1,0
19,157,157,25,25,0,1,0
11,174,174,18,8,10,2,1
6,194,194,102,34,68,4,3
15,236,236,4,4,0,1,0
4,237,237,3,3,0,1,0
9,247,247,1,1,0,1,0
2,252,252,7,1,6,3,2
20,262,262,20,8,12,2,1
13,269,269,22,22,0,1,0
10,271,271,41,41,0,1,0
0,320,320,48,48,0,1,0
12,352,352,12,12,0,1,0
18,364,364,42,8,34,3,2
23,383,383,91,91,0,1,0
5,401,401,40,40,0,1,0
3,413,413,68,30,38,2,1
14,422,422,40,30,10,2,1
24,435,435,29,7,22,2,1
21,467,467,18,18,0,1,0
22,485,485,71,8,63,4,3
8,490,490,27,13,14,2,1
1,491,491,69,3,66,3,2

2,121,121,2,2,0,1,0
23,127,127,7,7,0,1,0
27,143,143,14,2,12,4,3
28,150,150,18,10,8,2,1
22,172,172,1,1,0,1,0
0,203,203,9,9,0,1,0
3,206,206,86,47,39,2,1
24,249,249,73,25,48,4,3
8,276,276,34,10,24,4,3
13,286,286,13,13,0,1,0
18,320,320,60,60,0,1,0
19,334,334,29,29,0,1,0
25,338,338,32,32,0,1,0
7,339,339,39,39,0,1,0
1,353,353,20,14,6,3,2
12,359,359,2,2,0,1,0
5,372,372,1,1,0,1,0
17,377,377,41,41,0,1,0
26,393,393,9,9,0,1,0
9,408,408,25,25,0,1,0
6,418,418,67,63,4,2,1
20,419,419,65,26,39,2,1
11,438,438,7,7,0,1,0
21,444,444,47,47,0,1,0
15,450,450,7,7,0,1,0
14,457,457,106,13,93,4,3
4,467,467,18,18,0,1,0
10,481,481,32,2,30,4,3
16,494,494,42,10,32,3,2

11,133,133,18,11,7,2,1
12,144,144,39,25,14,2,1
9,155,155,7,7,0,1,0
27,174,174,6,1,5,2,1
16,189,189,1,1,0,1,0
21,190,190,23,8,15,2,1
18,201,201,29,29,0,1,0
23,202,202,48,21,27,4,3
4,203,203,8,8,0,1,0
19,227,227,2,2,0,1,0
13,245,245,23,23,0,1,0
14,251,251,7,7,0,1,0
3,253,253,4,4,0,1,0
6,285,285,54,54,0,1,0
22,314,314,145,63,82,4,3
2,335,335,46,46,0,1,0
8,338,338,7,7,0,1,0
10,351,351,24,6,18,4,3
20,362,362,28,22,6,2,1
17,367,367,38,8,30,3,2
7,370,370,5,2,3,2,1
0,378,378,7,4,3,2,1
25,381,381,10,10,0,1,0
24,395,395,26,14,12,2,1
28,414,414,14,14,0,1,0
26,458,458,23,23,0,1,0
1,462,462,63,21,42,4,3
5,476,476,90,44,46,3,2
15,491,491,25,3,22,2,1

27,122,122,2,2,0,1,0
28,128,128,5,5,0,1,0
17,165,165,16,16,0,1,0
2,170,170,3,3,0,1,0
25,196,196,18,3,15,4,3
4,236,236,13,6,7,2,1
13,237,237,41,41,0,1,0
26,249,249,27,13,14,3,2
11,273,273,35,26,9,2,1
24,287,287,100,1,99,4,3
1,299,299,36,36,0,1,0
9,329,329,9,9,0,1,0
20,357,357,42,42,0,1,0
6,366,366,9,1,8,3,2
18,369,369,70,70,0,1,0
5,370,370,18,18,0,1,0
12,375,375,57,57,0,1,0
22,377,377,24,4,20,3,2
7,378,378,1,1,0,1,0
16,378,378,6,6,0,1,0
0,380,380,113,45,68,4,3
23,398,398,33,29,4,2,1
3,410,410,3,3,0,1,0
30,427,427,18,18,0,1,0
29,428,428,21,21,0,1,0
19,434,434,18,4,14,4,3
14,438,438,34,6,28,3,2
21,441,441,61,61,0,1,0
15,473,473,51,33,18,2,1
8,477,477,2,2,0,1,0
10,490,490,70,28,42,4,3

13,104,104,1,1,0,1,0
9,136,136,29,29,0,1,0
15,166,166,9,3,6,2,1
14,190,190,7,7,0,1,0
17,200,200,21,12,9,2,1
2,201,201,14,14,0,1,0
0,219,219,21,9,12,4,3
8,266,266,81,55,26,3,2
6,335,335,16,16,0,1,0
22,336,336,74,74,0,1,0
12,349,349,138,60,78,4,3
1,369,369,22,22,0,1,0
23,397,397,23,23,0,1,0
11,403,403,88,67,21,4,3
7,403,403,44,16,28,2,1
16,419,419,23,23,0,1,0
20,435,435,35,26,9,2,1
4,442,442,40,6,34,4,3
19,446,446,3,3,0,1,0
21,446,446,19,3,16,4,3
24,452,452,46,46,0,1,0
25,456,456,94,36,58,3,2
3,472,472,6,6,0,1,0
10,473,473,1,1,0,1,0
5,481,481,86,1,85,4,3
18,489,489,29,29,0,1,0

25,144,144,15,7,8,3,2
23,173,173,10,10,0,1,0
14,176,176,66,39,27,4,3
19,179,179,4,4,0,1,0
2,188,188,9,9,0,1,0
4,190,190,28,7,21,4,3
24,198,198,20,6,14,2,1
0,260,260,39,5,34,2,1
27,275,275,6,6,0,1,0
26,277,277,85,38,47,2,1
18,286,286,21,11,10,2,1
15,317,317,57,20,37,2,1
17,337,337,36,36,0,1,0
6,338,338,20,20,0,1,0
5,339,339,7,3,4,2,1
11,370,370,3,3,0,1,0
3,390,390,89,2,87,4,3
22,420,420,21,21,0,1,0
16,440,440,44,2,42,4,3
8,441,441,14,1,13,4,3
20,443,443,86,11,75,4,3
12,456,456,1,1,0,1,0
9,457,457,13,13,0,1,0
21,458,458,7,7,0,1,0
13,460,460,32,32,0,1,0
28,462,462,40,40,0,1,0
1,468,468,22,22,0,1,0
10,476,476,6,6,0,1,0
7,498,498,86,86,0,1,0

23,115,115,11,11,0,1,0
1,119,119,11,3,8,2,1
14,141,141,3,3,0,1,0
22,162,162,1,1,0,1,0
4,168,168,11,2,9,2,1
24,169,169,19,9,10,2,1
15,199,199,12,12,0,1,0
17,232,232,15,15,0,1,0
5,279,279,69,69,0,1,0
18,305,305,42,42,0,1,0
26,319,319,29,29,0,1,0
7,322,322,47,47,0,1,0
6,349,349,91,39,52,3,2
9,354,354,32,13,19,2,1
12,374,374,8,8,0,1,0
21,380,380,44,39,5,2,1
2,381,381,57,57,0,1,0
10,405,405,6,6,0,1,0
16,413,413,11,11,0,1,0
11,432,432,58,58,0,1,0
8,456,456,14,14,0,1,0
20,459,459,156,108,48,3,2
0,465,465,23,20,3,2,1
3,468,468,46,46,0,1,0
19,479,479,38,38,0,1,0
13,495,495,117,35,82,3,2
25,498,498,23,23,0,1,0

2,161,161,24,11,13,2,1
20,168,168,51,51,0,1,0
21,170,170,7,7,0,1,0
0,217,217,4,4,0,1,0
15,227,227,12,12,0,1,0
14,259,259,10,10,0,1,0
23,280,280,44,36,8,2,1
4,282,282,10,6,4,2,1
6,285,285,76,76,0,1,0
3,298,298,69,69,0,1,0
13,302,302,78,40,38,3,2
18,344,344,12,12,0,1,0
7,345,345,85,41,44,2,1
1,370,370,23,23,0,1,0
11,370,370,17,17,0,1,0
19,381,381,23,23,0,1,0
5,414,414,25,25,0,1,0
17,418,418,30,30,0,1,0
10,428,428,19,19,0,1,0
16,438,438,79,37,42,3,2
22,454,454,51,51,0,1,0
12,465,465,8,5,3,2,1
8,477,477,23,13,10,2,1
9,500,500,141,127,14,2,1

20,100,100,10,10,0,1,0
7,128,128,20,7,13,2,1
12,129,129,8,3,5,2,1
1,133,133,9,9,0,1,0
8,166,166,3,3,0,1,0
10,169,169,32,14,18,4,3
25,182,182,3,3,0,1,0
26,209,209,44,9,35,2,1
14,245,245,31,31,0,1,0
21,245,245,32,32,0,1,0
9,264,264,8,8,0,1,0
5,319,319,117,21,96,4,3
24,328,328,133,49,84,3,2
3,330,330,26,3,23,2,1
6,343,343,37,29,8,3,2
19,344,344,83,83,0,1,0
22,348,348,8,8,0,1,0
18,365,365,5,2,3,2,1
4,403,403,19,19,0,1,0
13,409,409,2,2,0,1,0
2,413,413,65,48,17,2,1
17,431,431,7,7,0,1,0
16,448,448,33,33,0,1,0
0,458,458,17,4,13,2,1
15,460,460,3,3,0,1,0
11,476,476,41,41,0,1,0
23,480,480,31,31,0,1,0

9,126,126,1,1,0,1,0
8,130,130,17,7,10,2,1
6,147,147,24,24,0,1,0
26,153,153,39,39,0,1,0
15,167,167,23,23,0,1,0
22,173,173,17,8,9,2,1
13,181,181,4,4,0,1,0
25,182,182,23,2,21,2,1
17,188,188,10,10,0,1,0
3,192,192,23,11,12,2,1
18,193,193,42,8,34,2,1
21,201,201,63,63,0,1,0
11,213,213,7,7,0,1,0
24,222,222,11,11,0,1,0
10,243,243,24,2,22,4,3
1,243,243,10,2,8,2,1
19,287,287,3,3,0,1,0
14,325,325,19,3,16,4,3
20,327,327,6,6,0,1,0
23,343,343,15,6,9,2,1
7,380,380,21,4,17,2,1
5,412,412,70,70,0,1,0
2,441,441,89,68,21,4,3
4,441,441,62,52,10,3,2
16,456,456,12,12,0,1,0
0,473,473,24,10,14,2,1
12,495,495,93,93,0,1,0

3,108,108,10,10,0,1,0
23,122,122,4,1,3,2,1
29,124,124,37,37,0,1,0
2,144,144,1,1,0,1,0
7,147,147,30,30,0,1,0
19,156,156,10,10,0,1,0
26,164,164,6,6,0,1,0
14,167,167,43,31,12,3,2
13,179,179,7,7,0,1,0
30,180,180,34,34,0,1,0
25,194,194,20,20,0,1,0
15,206,206,1,1,0,1,0
18,207,207,14,14,0,1,0
16,217,217,3,3,0,1,0
20,250,250,1,1,0,1,0
8,254,254,10,10,0,1,0
12,290,290,33,33,0,1,0
10,297,297,23,23,0,1,0
11,311,311,10,10,0,1,0
27,313,313,24,14,10,3,2
21,322,322,62,14,48,2,1
1,336,336,51,51,0,1,0
22,353,353,13,13,0,1,0
28,353,353,29,6,23,2,1
24,362,362,18,18,0,1,0
17,372,372,73,54,19,2,1
5,412,412,47,31,16,2,1
9,412,412,2,2,0,1,0
4,414,414,39,39,0,1,0
6,414,414,26,26,0,1,0
0,419,419,38,34,4,2,1

1,121,121,10,10,0,1,0
5,129,129,16,16,0,1,0
17,141,141,3,3,0,1,0
8,152,152,7,4,3,2,1
21,199,199,11,2,9,2,1
23,246,246,11,11,0,1,0
2,252,252,23,23,0,1,0
26,263,263,34,34,0,1,0
13,265,265,24,24,0,1,0
6,283,283,7,7,0,1,0
4,327,327,45,16,29,2,1
27,333,333,12,12,0,1,0
14,352,352,4,1,3,2,1
20,373,373,8,2,6,2,1
9,375,375,81,81,0,1,0
10,385,385,70,30,40,3,2
16,395,395,79,55,24,4,3
15,415,415,136,81,55,4,3
11,424,424,78,42,36,4,3
24,432,432,47,43,4,2,1
3,445,445,1,1,0,1,0
12,449,449,37,15,22,3,2
0,453,453,53,53,0,1,0
19,457,457,29,29,0,1,0
7,460,460,10,10,0,1,0
18,462,462,113,77,36,4,3
22,465,465,26,5,21,4,3
25,482,482,47,47,0,1,0

6,105,105,32,20,12,3,2
2,112,112,16,10,6,2,1
12,114,114,29,29,0,1,0
1,126,126,1,1,0,1,0
19,131,131,22,13,9,2,1
0,141,141,14,14,0,1,0
20,154,154,18,3,15,4,3
14,165,165,7,3,4,2,1
4,173,173,3,3,0,1,0
8,179,179,16,11,5,2,1
18,191,191,20,20,0,1,0
25,194,194,25,25,0,1,0
26,196,196,11,11,0,1,0
13,196,196,4,4,0,1,0
16,229,229,1,1,0,1,0
10,262,262,19,19,0,1,0
21,302,302,22,12,10,2,1
22,363,363,42,42,0,1,0
3,393,393,6,6,0,1,0
11,406,406,33,33,0,1,0
24,441,441,130,99,31,2,1
15,459,459,61,61,0,1,0
5,468,468,75,75,0,1,0
27,476,476,53,6,47,2,1
7,479,479,35,7,28,3,2
23,480,480,7,1,6,2,1
9,487,487,31,31,0,1,0
17,494,494,32,23,9,4,3

3,131,131,2,2,0,1,0
15,138,138,11,11,0,1,0
10,139,139,4,4,0,1,0
19,156,156,1,1,0,1,0
17,159,159,13,5,8,2,1
11,204,204,10,1,9,2,1
8,222,222,32,2,30,3,2
27,226,226,17,17,0,1,0
0,228,228,24,19,5,2,1
18,231,231,43,3,40,2,1
26,260,260,1,1,0,1,0
22,286,286,40,13,27,2,1
16,292,292,7,7,0,1,0
1,306,306,6,1,5,2,1
25,312,312,112,46,66,4,3
9,319,319,49,43,6,2,1
5,325,325,74,74,0,1,0
23,334,334,44,13,31,2,1
14,374,374,8,8,0,1,0
7,393,393,44,44,0,1,0
6,402,402,59,31,28,3,2
13,413,413,89,89,0,1,0
24,432,432,46,2,44,3,2
20,436,436,79,27,52,3,2
12,437,437,28,28,0,1,0
2,471,471,14,14,0,1,0
21,474,474,17,7,10,2,1
4,482,482,43,28,15,4,3

0,110,110,15,10,5,2,1
24,124,124,10,1,9,2,1
20,130,130,4,4,0,1,0
30,133,133,31,31,0,1,0
18,140,140,10,10,0,1,0
29,142,142,1,1,0,1,0
17,151,151,19,19,0,1,0
27,158,158,1,1,0,1,0
11,184,184,17,17,0,1,0
5,206,206,3,3,0,1,0
19,226,226,4,4,0,1,0
21,252,252,1,1,0,1,0
8,258,258,28,6,22,2,1
1,274,274,32,32,0,1,0
6,306,306,13,8,5,2,1
13,308,308,24,24,0,1,0
15,324,324,30,30,0,1,0
3,325,325,18,9,9,4,3
26,348,348,87,59,28,2,1
9,349,349,30,30,0,1,0
14,361,361,22,22,0,1,0
28,376,376,97,38,59,3,2
25,397,397,14,4,10,3,2
12,398,398,55,50,5,2,1
31,399,399,61,11,50,2,1
4,408,408,16,9,7,2,1
10,433,433,6,2,4,2,1
2,445,445,23,18,5,2,1
23,466,466,27,27,0,1,0
7,482,482,60,36,24,2,1
16,484,484,14,14,0,1,0
22,487,487,112,112,0,1,0

21,115,115,13,13,0,1,0
23,117,117,4,4,0,1,0
1,123,123,49,49,0,1,0
14,158,158,2,2,0,1,0
22,174,174,19,9,10,3,2
12,190,190,27,7,20,2,1
24,193,193,18,8,10,3,2
13,205,205,2,2,0,1,0
16,261,261,9,3,6,2,1
19,271,271,22,2,20,2,1
0,273,273,7,7,0,1,0
2,290,290,74,74,0,1,0
9,307,307,11,5,6,2,1
5,312,312,11,11,0,1,0
20,337,337,7,7,0,1,0
17,363,363,34,34,0,1,0
4,373,373,121,102,19,2,1
3,373,373,9,9,0,1,0
15,374,374,37,17,20,2,1
6,405,405,5,5,0,1,0
8,430,430,2,2,0,1,0
25,433,433,200,188,12,4,3
7,438,438,2,2,0,1,0
10,457,457,30,30,0,1,0
11,465,465,100,70,30,3,2
18,473,473,61,58,3,2,1

12,121,121,10,1,9,4,3
19,138,138,23,23,0,1,0
24,147,147,22,22,0,1,0
5,188,188,4,4,0,1,0
23,221,221,17,17,0,1,0
20,226,226,5,5,0,1,0
4,240,240,13,4,9,2,1
17,242,242,18,2,16,4,3
27,247,247,29,14,15,4,3
26,272,272,7,3,4,2,1
16,282,282,3,3,0,1,0
13,293,293,17,17,0,1,0
29,294,294,35,35,0,1,0
21,294,294,56,10,46,3,2
1,307,307,29,14,15,4,3
22,318,318,48,8,40,3,2
8,318,318,39,12,27,4,3
9,335,335,4,4,0,1,0
2,354,354,29,29,0,1,0
28,360,360,66,17,49,2,1
0,393,393,21,21,0,1,0
15,399,399,20,2,18,2,1
7,429,429,149,59,90,4,3
10,442,442,14,14,0,1,0
11,453,453,63,52,11,2,1
25,455,455,9,9,0,1,0
18,457,457,53,53,0,1,0
3,462,462,9,9,0,1,0
6,467,467,46,32,14,3,2
14,491,491,66,33,33,2,1

2,104,104,5,2,3,2,1
21,105,105,9,9,0,1,0
22,133,133,9,9,0,1,0
24,134,134,6,6,0,1,0
18,137,137,5,5,0,1,0
7,165,165,22,10,12,4,3
8,191,191,18,7,11,3,2
19,228,228,9,9,0,1,0
17,240,240,33,33,0,1,0
23,270,270,164,88,76,3,2
15,272,272,16,16,0,1,0
6,276,276,1,1,0,1,0
0,285,285,15,15,0,1,0
1,288,288,69,19,50,2,1
10,295,295,14,14,0,1,0
13,334,334,11,11,0,1,0
16,336,336,8,5,3,2,1
14,338,338,15,15,0,1,0
20,340,340,48,14,34,2,1
3,351,351,2,2,0,1,0
12,361,361,8,8,0,1,0
9,374,374,229,193,36,2,1
5,401,401,35,35,0,1,0
11,444,444,38,8,30,4,3
4,446,446,34,21,13,2,1

24,112,112,5,5,0,1,0
18,140,140,1,1,0,1,0
9,140,140,25,17,8,3,2
6,151,151,32,32,0,1,0
4,154,154,17,11,6,3,2
16,161,161,13,13,0,1,0
11,240,240,33,33,0,1,0
13,262,262,17,17,0,1,0
20,276,276,12,12,0,1,0
8,291,291,43,7,36,4,3
10,299,299,4,4,0,1,0
0,316,316,1,1,0,1,0
12,331,331,21,9,12,4,3
19,348,348,70,70,0,1,0
21,386,386,31,21,10,2,1
23,394,394,68,68,0,1,0
15,407,407,6,6,0,1,0
5,438,438,15,2,13,2,1
14,463,463,73,28,45,4,3
3,465,465,98,22,76,3,2
17,466,466,82,46,36,4,3
7,467,467,159,159,0,1,0
25,480,480,149,117,32,2,1
2,486,486,2,2,0,1,0
22,488,488,5,5,0,1,0
1,494,494,4,4,0,1,0

10,120,120,24,11,13,2,1
6,165,165,31,19,12,4,3
17,166,166,15,6,9,2,1
12,166,166,6,6,0,1,0
15,179,179,15,15,0,1,0
0,205,205,64,26,38,4,3
11,225,225,27,27,0,1,0
13,230,230,29,7,22,4,3
3,239,239,13,13,0,1,0
16,268,268,68,38,30,3,2
1,304,304,73,73,0,1,0
5,328,328,9,9,0,1,0
2,336,336,38,14,24,4,3
21,336,336,15,9,6,2,1
9,341,341,23,11,12,3,2
8,368,368,67,67,0,1,0
7,376,376,22,22,0,1,0
4,388,388,88,88,0,1,0
14,393,393,33,33,0,1,0
18,432,432,34,34,0,1,0
19,443,443,35,35,0,1,0
22,479,479,3,3,0,1,0
20,490,490,75,48,27,4,3

22,105,105,5,5,0,1,0
17,109,109,14,14,0,1,0
4,110,110,1,1,0,1,0
10,125,125,7,7,0,1,0
15,145,145,46,46,0,1,0
1,180,180,19,7,12,4,3
18,187,187,21,21,0,1,0
2,191,191,25,7,18,4,3
16,199,199,21,21,0,1,0
7,200,200,13,1,12,3,2
14,208,208,31,31,0,1,0
13,284,284,64,58,6,2,1
6,294,294,6,6,0,1,0
0,302,302,1,1,0,1,0
11,302,302,12,4,8,3,2
24,309,309,16,2,14,3,2
5,334,334,91,91,0,1,0
26,342,342,21,21,0,1,0
12,369,369,85,75,10,3,2
23,375,375,9,4,5,2,1
20,394,394,37,3,34,3,2
21,394,394,15,15,0,1,0
8,399,399,12,12,0,1,0
3,455,455,94,94,0,1,0
9,467,467,3,3,0,1,0
27,474,474,61,20,41,2,1
19,476,476,42,36,6,3,2
25,487,487,46,46,0,1,0

17,143,143,7,1,6,3,2
11,150,150,1,1,0,1,0
18,165,165,7,3,4,2,1
15,173,173,1,1,0,1,0
0,229,229,7,3,4,2,1
10,253,253,60,60,0,1,0
7,286,286,4,4,0,1,0
23,289,289,12,12,0,1,0
4,289,289,9,4,5,2,1
14,303,303,22,6,16,2,1
20,327,327,191,95,96,3,2
8,334,334,219,219,0,1,0
16,334,334,21,21,0,1,0
3,355,355,1,1,0,1,0
22,367,367,44,5,39,2,1
1,388,388,55,52,3,2,1
21,388,388,1,1,0,1,0
2,391,391,44,44,0,1,0
6,425,425,53,53,0,1,0
19,426,426,55,22,33,4,3
13,439,439,14,14,0,1,0
9,477,477,30,30,0,1,0
5,486,486,109,109,0,1,0
12,489,489,19,19,0,1,0

16,104,104,1,1,0,1,0
7,121,121,11,3,8,2,1
8,129,129,5,5,0,1,0
0,157,157,5,5,0,1,0
21,159,159,4,4,0,1,0
9,161,161,5,5,0,1,0
25,163,163,7,7,0,1,0
2,178,178,3,3,0,1,0
15,187,187,9,3,6,3,2
29,190,190,5,5,0,1,0
28,202,202,11,2,9,4,3
18,215,215,12,1,11,2,1
11,232,232,74,74,0,1,0
26,252,252,9,3,6,3,2
17,274,274,102,69,33,4,3
30,290,290,94,94,0,1,0
22,295,295,3,3,0,1,0
19,298,298,18,18,0,1,0
1,300,300,9,9,0,1,0
14,301,301,30,30,0,1,0
27,322,322,9,9,0,1,0
20,324,324,32,17,15,2,1
13,342,342,15,9,6,3,2
10,356,356,104,31,73,4,3
5,372,372,26,2,24,4,3
24,403,403,68,36,32,2,1
6,428,428,1,1,0,1,0
12,436,436,62,44,18,2,1
4,445,445,1,1,0,1,0
3,496,496,68,6,62,3,2
23,496,496,63,63,0,1,0

32,105,105,6,6,0,1,0
18,124,124,6,6,0,1,0
5,137,137,13,5,8,3,2
31,145,145,2,2,0,1,0
12,146,146,8,8,0,1,0
26,170,170,29,5,24,2,1
0,173,173,30,4,26,2,1
3,178,178,56,14,42,3,2
8,180,180,3,3,0,1,0
17,184,184,13,13,0,1,0
10,211,211,26,5,21,4,3
27,212,212,16,4,12,4,3
29,213,213,70,70,0,1,0
11,269,269,23,23,0,1,0
22,271,271,2,2,0,1,0
30,317,317,26,5,21,2,1
1,329,329,9,9,0,1,0
4,349,349,5,5,0,1,0
15,356,356,12,12,0,1,0
14,357,357,5,1,4,2,1
23,379,379,12,12,0,1,0
28,381,381,11,2,9,4,3
25,383,383,29,29,0,1,0
2,422,422,31,19,12,4,3
16,427,427,15,3,12,2,1
20,429,429,101,12,89,4,3
7,444,444,17,2,15,4,3
24,453,453,83,83,0,1,0
9,465,465,13,13,0,1,0
13,471,471,9,4,5,2,1
6,477,477,66,66,0,1,0
19,479,479,58,58,0,1,0
21,489,489,8,8,0,1,0

24,102,102,1,1,0,1,0
5,124,124,1,1,0,1,0
6,130,130,7,7,0,1,0
12,130,130,3,3,0,1,0
20,133,133,29,29,0,1,0
3,139,139,11,11,0,1,0
25,148,148,36,36,0,1,0
11,160,160,2,2,0,1,0
26,174,174,16,11,5,2,1
22,176,176,3,3,0,1,0
10,181,181,14,3,11,2,1
8,182,182,15,7,8,2,1
7,183,183,3,3,0,1,0
16,196,196,44,44,0,1,0
19,196,196,4,4,0,1,0
23,204,204,13,13,0,1,0
14,213,213,7,7,0,1,0
0,214,214,82,78,4,2,1
15,242,242,46,18,28,2,1
21,244,244,12,12,0,1,0
13,246,246,48,48,0,1,0
18,291,291,14,4,10,3,2
2,311,311,91,37,54,4,3
4,331,331,31,11,20,2,1
9,408,408,38,38,0,1,0
1,422,422,79,58,21,4,3
17,494,494,17,17,0,1,0

13,100,100,9,9,0,1,0
15,104,104,2,2,0,1,0
24,107,107,36,36,0,1,0
14,111,111,3,3,0,1,0
32,113,113,16,16,0,1,0
21,120,120,7,7,0,1,0
2,133,133,14,5,9,3,2
0,159,159,10,10,0,1,0
3,180,180,8,1,7,2,1
23,182,182,9,3,6,3,2
7,186,186,5,5,0,1,0
11,205,205,6,6,0,1,0
30,207,207,24,10,14,2,1
18,212,212,41,41,0,1,0
4,215,215,5,5,0,1,0
28,221,221,37,37,0,1,0
31,227,227,24,15,9,4,3
27,266,266,8,8,0,1,0
6,268,268,34,24,10,3,2
9,325,325,4,1,3,2,1
16,344,344,44,11,33,2,1
25,349,349,23,15,8,3,2
29,362,362,4,1,3,2,1
10,364,364,22,22,0,1,0
1,383,383,62,14,48,3,2
19,393,393,18,18,0,1,0
20,429,429,74,74,0,1,0
5,431,431,64,28,36,4,3
26,443,443,18,4,14,2,1
22,447,447,39,39,0,1,0
12,448,448,37,37,0,1,0
17,453,453,15,7,8,2,1
8,479,479,13,4,9,2,1

12,100,100,1,1,0,1,0
11,103,103,9,4,5,2,1
8,125,125,3,3,0,1,0
22,138,138,10,4,6,3,2
28,144,144,2,2,0,1,0
13,160,160,34,1,33,4,3
7,171,171,18,18,0,1,0
0,200,200,6,6,0,1,0
2,203,203,22,1,21,4,3
17,223,223,29,29,0,1,0
18,226,226,11,11,0,1,0
9,256,256,1,1,0,1,0
4,275,275,38,38,0,1,0
23,277,277,14,2,12,4,3
10,285,285,5,5,0,1,0
14,290,290,5,5,0,1,0
29,310,310,31,14,17,2,1
25,315,315,1,1,0,1,0
24,340,340,7,7,0,1,0
21,342,342,6,6,0,1,0
5,351,351,51,29,22,3,2
16,371,371,38,2,36,2,1
27,409,409,49,49,0,1,0
3,434,434,155,77,78,4,3
19,436,436,99,10,89,4,3
20,451,451,143,51,92,4,3
6,457,457,31,31,0,1,0
1,470,470,1,1,0,1,0
26,485,485,100,8,92,3,2
15,493,493,37,10,27,2,1

24,108,108,13,4,9,2,1
21,135,135,11,11,0,1,0
17,140,140,1,1,0,1,0
2,145,145,15,9,6,2,1
31,155,155,12,12,0,1,0
10,163,163,11,11,0,1,0
4,205,205,19,19,0,1,0
30,223,223,9,2,7,3,2
32,229,229,14,14,0,1,0
11,232,232,7,4,3,2,1
16,233,233,5,5,0,1,0
5,239,239,43,5,38,3,2
20,244,244,15,15,0,1,0
12,255,255,43,43,0,1,0
0,255,255,8,8,0,1,0
19,269,269,12,6,6,3,2
14,271,271,17,17,0,1,0
29,272,272,1,1,0,1,0
7,279,279,28,7,21,2,1
26,281,281,4,4,0,1,0
15,317,317,25,11,14,2,1
6,328,328,18,5,13,2,1
13,366,366,2,2,0,1,0
18,371,371,62,16,46,4,3
3,399,399,27,27,0,1,0
1,409,409,65,21,44,4,3
22,413,413,19,5,14,2,1
28,420,420,45,13,32,4,3
27,432,432,17,3,14,3,2
8,476,476,1,1,0,1,0
25,488,488,351,315,36,2,1
23,489,489,6,6,0,1,0
9,493,493,1,1,0,1,0

30,102,102,9,4,5,2,1
5,110,110,1,1,0,1,0
21,121,121,22,22,0,1,0
8,131,131,1,1,0,1,0
6,140,140,4,1,3,2,1
16,143,143,3,3,0,1,0
12,155,155,1,1,0,1,0
29,174,174,2,2,0,1,0
25,174,174,24,2,22,3,2
17,177,177,13,3,10,2,1
10,177,177,1,1,0,1,0
23,194,194,35,15,20,4,3
11,198,198,18,9,9,4,3
13,209,209,15,10,5,2,1
15,227,227,27,27,0,1,0
26,243,243,47,47,0,1,0
28,244,244,12,5,7,2,1
22,256,256,4,4,0,1,0
19,296,296,14,14,0,1,0
1,317,317,14,14,0,1,0
2,335,335,57,57,0,1,0
20,378,378,2,2,0,1,0
0,385,385,69,69,0,1,0
27,392,392,2,2,0,1,0
3,397,397,25,20,5,2,1
4,407,407,85,73,12,3,2
9,435,435,11,11,0,1,0
18,441,441,113,83,30,4,3
24,452,452,82,36,46,3,2
14,465,465,11,8,3,2,1
7,476,476,158,78,80,3,2

4,104,104,23,8,15,2,1
15,105,105,1,1,0,1,0
24,109,109,44,44,0,1,0
12,123,123,12,12,0,1,0
1,126,126,3,3,0,1,0
13,141,141,2,2,0,1,0
14,154,154,6,6,0,1,0
8,159,159,21,10,11,2,1
29,177,177,2,2,0,1,0
28,202,202,34,10,24,3,2
17,205,205,1,1,0,1,0
27,219,219,11,6,5,2,1
5,227,227,7,7,0,1,0
23,232,232,15,15,0,1,0
2,240,240,40,10,30,4,3
3,243,243,12,9,3,2,1
16,262,262,17,11,6,3,2
20,329,329,17,5,12,2,1
30,342,342,10,10,0,1,0
22,345,345,26,26,0,1,0
11,359,359,92,92,0,1,0
25,369,369,106,88,18,2,1
0,373,373,7,7,0,1,0
7,387,387,1,1,0,1,0
6,390,390,15,15,0,1,0
19,410,410,13,13,0,1,0
31,414,414,31,31,0,1,0
26,452,452,21,21,0,1,0
9,472,472,23,12,11,2,1
18,483,483,33,33,0,1,0
21,486,486,31,31,0,1,0
10,500,500,93,93,0,1,0

4,105,105,2,2,0,1,0
26,133,133,1,1,0,1,0
24,163,163,1,1,0,1,0
13,170,170,9,9,0,1,0
11,201,201,10,10,0,1,0
3,210,210,10,7,3,2,1
21,223,223,1,1,0,1,0
23,224,224,82,47,35,2,1
1,228,228,81,81,0,1,0
20,230,230,4,4,0,1,0
9,238,238,86,78,8,3,2
2,279,279,8,1,7,2,1
17,280,280,4,4,0,1,0
8,330,330,28,7,21,3,2
10,344,344,13,13,0,1,0
18,346,346,8,8,0,1,0
7,368,368,65,65,0,1,0
12,428,428,11,11,0,1,0
14,448,448,136,40,96,4,3
5,454,454,22,18,4,2,1
25,461,461,33,33,0,1,0
19,464,464,146,137,9,2,1
16,467,467,35,9,26,2,1
15,480,480,6,1,5,2,1
6,482,482,10,3,7,2,1
0,482,482,70,55,15,4,3
22,495,495,79,8,71,4,3

19,120,120,5,2,3,2,1
0,124,124,3,3,0,1,0
23,125,125,20,20,0,1,0
21,128,128,1,1,0,1,0
18,146,146,10,4,6,2,1
4,150,150,5,5,0,1,0
20,158,158,9,9,0,1,0
25,169,169,41,36,5,2,1
7,175,175,15,9,6,2,1
13,207,207,25,1,24,2,1
6,215,215,11,11,0,1,0
24,224,224,26,26,0,1,0
10,241,241,37,37,0,1,0
9,256,256,2,2,0,1,0
11,256,256,9,9,0,1,0
16,290,290,43,43,0,1,0
17,312,312,20,15,5,2,1
12,313,313,17,17,0,1,0
2,352,352,14,2,12,2,1
15,371,371,11,11,0,1,0
5,375,375,128,85,43,2,1
14,380,380,21,21,0,1,0
22,397,397,108,108,0,1,0
1,408,408,110,110,0,1,0
8,450,450,50,50,0,1,0
3,464,464,115,76,39,2,1

9,117,117,14,2,12,4,3
0,121,121,4,4,0,1,0
18,135,135,8,8,0,1,0
1,170,170,40,22,18,3,2
3,181,181,3,3,0,1,0
22,190,190,52,15,37,2,1
8,206,206,62,62,0,1,0
17,221,221,50,26,24,3,2
2,238,238,8,5,3,2,1
6,287,287,32,32,0,1,0
12,300,300,6,6,0,1,0
7,303,303,23,8,15,2,1
19,327,327,23,5,18,4,3
10,332,332,39,39,0,1,0
23,334,334,5,5,0,1,0
5,361,361,120,120,0,1,0
16,381,381,76,62,14,4,3
21,401,401,12,5,7,2,1
15,415,415,74,64,10,3,2
20,438,438,5,5,0,1,0
4,444,444,65,14,51,4,3
11,456,456,58,48,10,3,2
14,490,490,44,16,28,3,2
13,499,499,1,1,0,1,0

15,106,106,2,2,0,1,0
26,122,122,4,4,0,1,0
24,133,133,3,3,0,1,0
1,176,176,5,1,4,2,1
0,210,210,22,13,9,4,3
12,219,219,33,5,28,4,3
3,223,223,10,10,0,1,0
17,256,256,26,17,9,4,3
8,281,281,2,2,0,1,0
20,310,310,15,3,12,3,2
25,320,320,39,39,0,1,0
11,323,323,91,91,0,1,0
4,335,335,1,1,0,1,0
2,346,346,19,19,0,1,0
9,346,346,15,15,0,1,0
7,351,351,36,26,10,2,1
21,373,373,30,30,0,1,0
14,374,374,36,16,20,3,2
10,386,386,21,21,0,1,0
19,403,403,21,21,0,1,0
6,412,412,60,7,53,4,3
13,419,419,54,36,18,2,1
18,426,426,130,96,34,2,1
22,434,434,2,2,0,1,0
27,441,441,160,118,42,2,1
28,453,453,61,61,0,1,0
23,461,461,24,24,0,1,0
5,463,463,72,27,45,2,1
16,472,472,42,42,0,1,0

1,136,136,1,1,0,1,0
17,172,172,8,8,0,1,0
2,182,182,71,71,0,1,0
16,189,189,22,12,10,3,2
20,196,196,40,40,0,1,0
11,200,200,52,24,28,2,1
21,202,202,58,58,0,1,0
15,221,221,30,30,0,1,0
9,268,268,71,71,0,1,0
12,270,270,25,25,0,1,0
8,273,273,68,32,36,4,3
19,278,278,19,19,0,1,0
22,297,297,14,14,0,1,0
14,310,310,1,1,0,1,0
5,313,313,19,1,18,2,1
6,334,334,30,15,15,4,3
3,368,368,1,1,0,1,0
13,374,374,8,8,0,1,0
18,385,385,42,33,9,2,1
7,386,386,22,22,0,1,0
0,397,397,21,21,0,1,0
23,402,402,2,2,0,1,0
4,419,419,18,18,0,1,0
10,435,435,80,80,0,1,0
24,453,453,13,9,4,2,1

7,100,100,11,11,0,1,0
12,102,102,24,16,8,3,2
19,124,124,11,2,9,2,1
22,147,147,3,3,0,1,0
3,158,158,20,5,15,4,3
14,191,191,69,69,0,1,0
8,194,194,3,3,0,1,0
23,197,197,2,2,0,1,0
6,210,210,13,13,0,1,0
24,216,216,14,4,10,3,2
13,229,229,10,10,0,1,0
20,238,238,19,19,0,1,0
4,252,252,48,48,0,1,0
5,270,270,6,3,3,2,1
15,278,278,35,35,0,1,0
26,288,288,52,3,49,4,3
11,311,311,45,6,39,4,3
25,317,317,15,15,0,1,0
0,363,363,30,30,0,1,0
18,370,370,27,27,0,1,0
9,394,394,115,70,45,2,1
1,410,410,11,11,0,1,0
10,421,421,4,4,0,1,0
17,467,467,40,40,0,1,0
2,478,478,43,43,0,1,0
21,478,478,79,79,0,1,0
16,500,500,38,38,0,1,0

10,114,114,4,1,3,2,1
6,129,129,27,27,0,1,0
11,135,135,6,6,0,1,0
14,144,144,10,1,9,2,1
13,182,182,13,4,9,2,1
26,188,188,44,13,31,2,1
24,194,194,6,2,4,2,1
4,213,213,25,6,19,2,1
18,241,241,20,20,0,1,0
7,254,254,55,40,15,2,1
19,260,260,15,1,14,2,1
12,272,272,16,16,0,1,0
9,272,272,2,2,0,1,0
25,318,318,29,29,0,1,0
5,336,336,20,6,14,3,2
1,350,350,7,4,3,2,1
21,366,366,79,49,30,4,3
16,376,376,39,20,19,4,3
23,399,399,60,48,12,2,1
20,400,400,61,14,47,2,1
2,411,411,115,115,0,1,0
3,420,420,36,9,27,2,1
22,423,423,15,5,10,2,1
8,437,437,93,93,0,1,0
15,441,441,16,16,0,1,0
17,474,474,44,26,18,2,1
0,489,489,27,27,0,1,0

28,110,110,6,2,4,2,1
26,122,122,14,11,3,2,1
19,124,124,12,12,0,1,0
21,132,132,15,15,0,1,0
30,141,141,30,30,0,1,0
22,143,143,4,4,0,1,0
13,149,149,6,1,5,2,1
14,159,159,13,13,0,1,0
33,189,189,31,31,0,1,0
10,191,191,14,5,9,2,1
23,202,202,8,8,0,1,0
27,217,217,41,8,33,4,3
17,225,225,38,18,20,3,2
4,257,257,4,4,0,1,0
2,259,259,6,6,0,1,0
15,274,274,30,2,28,2,1
31,296,296,40,36,4,2,1
5,299,299,25,6,19,2,1
18,307,307,12,12,0,1,0
3,316,316,75,21,54,4,3
7,319,319,23,23,0,1,0
16,346,346,15,7,8,2,1
6,364,364,3,3,0,1,0
32,389,389,58,58,0,1,0
8,394,394,43,3,40,3,2
29,396,396,4,1,3,2,1
11,398,398,7,7,0,1,0
1,422,422,15,15,0,1,0
20,427,427,52,52,0,1,0
9,438,438,42,18,24,4,3
25,440,440,38,13,25,2,1
24,455,455,8,1,7,2,1
0,459,459,17,17,0,1,0
12,461,461,8,8,0,1,0

27,165,165,25,4,21,2,1
21,189,189,8,8,0,1,0
15,206,206,4,4,0,1,0
7,214,214,28,28,0,1,0
17,222,222,11,11,0,1,0
1,233,233,3,3,0,1,0
5,245,245,8,8,0,1,0
19,250,250,55,42,13,2,1
24,258,258,37,37,0,1,0
11,271,271,36,36,0,1,0
16,278,278,91,15,76,3,2
0,284,284,8,8,0,1,0
28,313,313,59,25,34,3,2
13,329,329,50,50,0,1,0
14,348,348,32,32,0,1,0
2,350,350,8,3,5,2,1
12,378,378,20,20,0,1,0
10,380,380,30,30,0,1,0
8,382,382,45,45,0,1,0
26,396,396,22,9,13,2,1
29,408,408,66,19,47,3,2
30,408,408,11,11,0,1,0
23,414,414,2,2,0,1,0
18,420,420,59,32,27,2,1
20,429,429,43,27,16,3,2
9,436,436,23,19,4,2,1
3,452,452,59,6,53,4,3
4,460,460,4,4,0,1,0
22,487,487,38,38,0,1,0
25,490,490,29,3,26,2,1
6,499,499,4,4,0,1,0

27,110,110,5,5,0,1,0
1,130,130,1,1,0,1,0
15,141,141,4,4,0,1,0
25,153,153,35,24,11,2,1
30,167,167,29,29,0,1,0
8,173,173,7,7,0,1,0
13,178,178,25,3,22,3,2
7,189,189,21,6,15,4,3
19,208,208,2,2,0,1,0
20,223,223,22,22,0,1,0
24,225,225,1,1,0,1,0
29,226,226,8,8,0,1,0
28,227,227,7,7,0,1,0
22,230,230,33,1,32,3,2
6,236,236,3,3,0,1,0
10,247,247,14,14,0,1,0
0,278,278,21,18,3,2,1
4,282,282,54,54,0,1,0
16,299,299,29,29,0,1,0
11,313,313,9,4,5,2,1
26,335,335,7,7,0,1,0
3,381,381,56,30,26,2,1
9,383,383,15,5,10,2,1
17,408,408,11,11,0,1,0
2,410,410,24,24,0,1,0
5,413,413,38,22,16,3,2
18,422,422,39,1,38,3,2
14,426,426,29,29,0,1,0
31,451,451,25,25,0,1,0
21,466,466,68,68,0,1,0
12,474,474,85,28,57,4,3
23,480,480,163,85,78,3,2

10,103,103,4,1,3,2,1
4,124,124,29,12,17,3,2
7,141,141,11,11,0,1,0
24,209,209,17,5,12,2,1
22,234,234,81,52,29,2,1
9,260,260,106,61,45,4,3
17,270,270,24,24,0,1,0
13,292,292,17,11,6,3,2
16,315,315,13,13,0,1,0
2,327,327,42,42,0,1,0
27,344,344,12,4,8,3,2
5,354,354,30,30,0,1,0
8,365,365,6,1,5,2,1
14,389,389,40,24,16,2,1
21,393,393,72,49,23,2,1
0,395,395,5,1,4,2,1
15,410,410,96,72,24,4,3
3,415,415,18,3,15,2,1
18,416,416,20,8,12,4,3
23,422,422,38,9,29,3,2
12,438,438,1,1,0,1,0
6,458,458,1,1,0,1,0
19,458,458,18,3,15,4,3
20,470,470,61,61,0,1,0
28,473,473,17,2,15,4,3
25,478,478,25,2,23,2,1
26,479,479,10,10,0,1,0
1,483,483,92,56,36,4,3
11,500,500,1,1,0,1,0

12,104,104,12,12,0,1,0
7,119,119,1,1,0,1,0
8,161,161,3,3,0,1,0
6,185,185,27,27,0,1,0
14,203,203,19,1,18,4,3
0,217,217,8,8,0,1,0
1,249,249,12,6,6,2,1
4,286,286,10,4,6,3,2
19,299,299,22,22,0,1,0
9,326,326,58,22,36,4,3
3,327,327,111,102,9,2,1
18,345,345,6,6,0,1,0
2,345,345,44,17,27,4,3
20,379,379,64,4,60,3,2
5,403,403,187,187,0,1,0
13,420,420,6,6,0,1,0
10,422,422,26,26,0,1,0
16,431,431,33,12,21,4,3
21,445,445,29,9,20,3,2
17,451,451,14,14,0,1,0
22,477,477,105,49,56,3,2
23,482,482,135,94,41,4,3
11,494,494,38,16,22,2,1
15,499,499,65,57,8,3,2

14,119,119,24,24,0,1,0
5,137,137,50,17,33,4,3
15,157,157,8,8,0,1,0
19,189,189,28,28,0,1,0
10,200,200,5,1,4,2,1
6,221,221,23,23,0,1,0
23,222,222,6,6,0,1,0
18,230,230,47,11,36,2,1
24,249,249,24,24,0,1,0
3,249,249,11,3,8,2,1
1,271,271,45,45,0,1,0
4,284,284,17,17,0,1,0
12,288,288,38,2,36,4,3
22,289,289,30,30,0,1,0
17,311,311,7,4,3,2,1
21,329,329,5,5,0,1,0
11,366,366,13,4,9,2,1
13,386,386,32,32,0,1,0
7,386,386,1,1,0,1,0
8,402,402,2,2,0,1,0
0,434,434,50,3,47,2,1
16,448,448,14,14,0,1,0
2,449,449,130,120,10,3,2
9,452,452,103,57,46,3,2
20,469,469,129,15,114,4,3

23,111,111,24,24,0,1,0
18,121,121,8,8,0,1,0
6,127,127,28,7,21,4,3
21,129,129,2,2,0,1,0
17,129,129,26,26,0,1,0
13,138,138,21,21,0,1,0
1,149,149,17,1,16,3,2
8,198,198,2,2,0,1,0
20,200,200,39,21,18,2,1
19,200,200,3,3,0,1,0
15,250,250,25,25,0,1,0
9,279,279,60,20,40,2,1
12,300,300,5,5,0,1,0
10,323,323,10,4,6,3,2
5,323,323,15,15,0,1,0
16,354,354,16,16,0,1,0
2,383,383,10,10,0,1,0
11,388,388,44,44,0,1,0
3,389,389,84,60,24,4,3
24,403,403,65,34,31,2,1
4,418,418,56,14,42,3,2
7,444,444,72,34,38,3,2
14,449,449,31,13,18,4,3
0,453,453,51,40,11,2,1
22,454,454,75,7,68,4,3
25,500,500,5,5,0,1,0

23,129,129,1,1,0,1,0
2,148,148,24,6,18,4,3
22,165,165,2,2,0,1,0
18,187,187,3,3,0,1,0
8,193,193,16,11,5,2,1
4,220,220,5,1,4,2,1
25,225,225,24,2,22,2,1
7,236,236,10,10,0,1,0
17,268,268,44,41,3,2,1
3,273,273,48,10,38,2,1
15,277,277,33,14,19,2,1
13,306,306,39,39,0,1,0
12,313,313,29,11,18,3,2
19,318,318,12,12,0,1,0
24,319,319,157,157,0,1,0
10,328,328,39,12,27,4,3
20,348,348,1,1,0,1,0
21,375,375,21,21,0,1,0
0,401,401,124,72,52,4,3
9,465,465,72,17,55,3,2
6,476,476,60,28,32,3,2
16,479,479,68,68,0,1,0
14,492,492,28,6,22,2,1
1,493,493,82,82,0,1,0
5,498,498,6,6,0,1,0
11,500,500,14,6,8,3,2

16,100,100,30,21,9,4,3
6,123,123,6,6,0,1,0
5,125,125,10,10,0,1,0
12,142,142,20,20,0,1,0
15,148,148,11,1,10,3,2
21,168,168,27,27,0,1,0
20,171,171,23,19,4,2,1
7,207,207,48,48,0,1,0
0,244,244,16,16,0,1,0
17,259,259,10,1,9,4,3
18,267,267,11,2,9,4,3
2,296,296,37,1,36,2,1
19,328,328,15,7,8,3,2
9,346,346,61,29,32,3,2
14,347,347,34,28,6,2,1
22,357,357,50,50,0,1,0
8,367,367,108,84,24,2,1
3,416,416,4,1,3,2,1
1,422,422,190,171,19,2,1
10,451,451,8,8,0,1,0
4,452,452,44,16,28,3,2
11,492,492,1,1,0,1,0
13,495,495,32,14,18,4,3

23,125,125,8,8,0,1,0
3,133,133,42,23,19,3,2
2,137,137,7,2,5,2,1
0,142,142,23,23,0,1,0
30,161,161,8,8,0,1,0
27,175,175,20,14,6,3,2
32,178,178,36,36,0,1,0
17,183,183,14,14,0,1,0
4,199,199,3,3,0,1,0
26,216,216,6,3,3,2,1
9,222,222,2,2,0,1,0
5,241,241,25,18,7,2,1
29,245,245,31,31,0,1,0
25,275,275,16,16,0,1,0
18,276,276,5,5,0,1,0
14,279,279,2,2,0,1,0
24,284,284,39,19,20,4,3
22,285,285,9,9,0,1,0
11,300,300,36,22,14,3,2
10,317,317,41,8,33,2,1
1,322,322,4,4,0,1,0
20,332,332,39,39,0,1,0
33,367,367,92,92,0,1,0
15,395,395,6,6,0,1,0
19,402,402,3,3,0,1,0
6,403,403,28,28,0,1,0
21,422,422,30,15,15,4,3
12,430,430,5,5,0,1,0
16,456,456,11,11,0,1,0
28,458,458,53,53,0,1,0
7,471,471,45,45,0,1,0
13,475,475,60,42,18,2,1
31,476,476,32,27,5,2,1
8,490,490,15,5,10,2,1

12,124,124,1,1,0,1,0
9,135,135,19,3,16,2,1
14,175,175,3,3,0,1,0
1,178,178,119,108,11,2,1
20,225,225,17,17,0,1,0
22,232,232,26,26,0,1,0
3,241,241,9,6,3,2,1
19,273,273,128,101,27,2,1
15,305,305,39,28,11,2,1
8,313,313,28,28,0,1,0
2,315,315,74,26,48,4,3
7,324,324,6,6,0,1,0
5,343,343,23,4,19,2,1
0,362,362,11,11,0,1,0
16,364,364,43,43,0,1,0
17,413,413,4,4,0,1,0
6,414,414,29,7,22,2,1
11,443,443,30,16,14,3,2
23,449,449,67,31,36,4,3
13,473,473,8,8,0,1,0
4,476,476,22,22,0,1,0
18,483,483,22,22,0,1,0
10,487,487,62,62,0,1,0
21,499,499,43,43,0,1,0

17,122,122,12,1,11,2,1
20,127,127,66,52,14,2,1
26,153,153,2,2,0,1,0
13,161,161,10,10,0,1,0
11,162,162,1,1,0,1,0
10,175,175,10,10,0,1,0
0,182,182,1,1,0,1,0
22,191,191,17,9,8,2,1
19,194,194,6,6,0,1,0
7,198,198,15,15,0,1,0
25,211,211,14,10,4,2,1
8,293,293,84,84,0,1,0
12,295,295,16,9,7,2,1
16,296,296,25,3,22,2,1
1,305,305,124,124,0,1,0
18,313,313,6,6,0,1,0
14,322,322,45,45,0,1,0
15,335,335,21,21,0,1,0
2,337,337,34,13,21,4,3
3,348,348,6,6,0,1,0
9,360,360,14,3,11,2,1
6,367,367,86,86,0,1,0
23,372,372,81,63,18,4,3
24,424,424,5,1,4,2,1
4,452,452,51,51,0,1,0
5,469,469,2,2,0,1,0
21,483,483,10,7,3,2,1

13,103,103,18,18,0,1,0
9,117,117,17,10,7,2,1
22,132,132,2,2,0,1,0
14,133,133,25,11,14,2,1
20,137,137,2,2,0,1,0
12,151,151,34,1,33,3,2
16,154,154,6,6,0,1,0
1,159,159,11,6,5,2,1
2,177,177,4,1,3,2,1
15,209,209,13,9,4,2,1
10,211,211,15,15,0,1,0
0,244,244,102,87,15,2,1
17,247,247,13,13,0,1,0
21,247,247,27,11,16,2,1
8,258,258,51,51,0,1,0
23,261,261,55,55,0,1,0
4,271,271,9,9,0,1,0
11,282,282,3,3,0,1,0
6,353,353,8,2,6,3,2
5,362,362,81,48,33,4,3
19,365,365,79,31,48,4,3
18,373,373,14,14,0,1,0
3,438,438,46,46,0,1,0
7,456,456,76,68,8,3,2

20,100,100,11,11,0,1,0
13,117,117,11,11,0,1,0
21,128,128,6,6,0,1,0
22,132,132,9,1,8,2,1
5,134,134,1,1,0,1,0
6,135,135,10,10,0,1,0
15,135,135,2,2,0,1,0
27,172,172,21,21,0,1,0
9,186,186,2,2,0,1,0
17,197,197,4,4,0,1,0
4,213,213,18,12,6,3,2
12,213,213,1,1,0,1,0
14,225,225,3,3,0,1,0
26,268,268,45,45,0,1,0
24,269,269,28,1,27,2,1
0,287,287,17,17,0,1,0
7,313,313,9,9,0,1,0
18,318,318,39,39,0,1,0
23,323,323,1,1,0,1,0
19,341,341,92,44,48,3,2
8,386,386,29,8,21,4,3
1,389,389,12,5,7,2,1
2,392,392,219,168,51,4,3
29,395,395,23,20,3,2,1
3,429,429,37,37,0,1,0
16,434,434,22,10,12,3,2
10,436,436,60,60,0,1,0
11,445,445,56,56,0,1,0
28,447,447,123,72,51,4,3
25,490,490,3,3,0,1,0

8,119,119,9,9,0,1,0
1,139,139,20,20,0,1,0
27,150,150,16,7,9,2,1
19,176,176,8,8,0,1,0
21,205,205,1,1,0,1,0
12,219,219,46,8,38,2,1
0,257,257,40,40,0,1,0
2,260,260,13,2,11,3,2
24,288,288,11,11,0,1,0
4,300,300,78,18,60,3,2
14,309,309,74,14,60,3,2
9,317,317,19,8,11,2,1
5,325,325,22,3,19,4,3
6,337,337,5,5,0,1,0
7,358,358,12,12,0,1,0
22,373,373,11,5,6,2,1
3,381,381,12,9,3,2,1
11,391,391,20,3,17,2,1
16,409,409,47,47,0,1,0
18,418,418,113,113,0,1,0
25,419,419,66,66,0,1,0
13,431,431,32,32,0,1,0
20,441,441,90,54,36,3,2
10,463,463,80,59,21,2,1
17,473,473,46,46,0,1,0
23,487,487,33,33,0,1,0
15,493,493,20,20,0,1,0
26,494,494,1,1,0,1,0

12,115,115,3,3,0,1,0
3,123,123,12,12,0,1,0
34,144,144,15,15,0,1,0
29,151,151,13,13,0,1,0
6,152,152,6,6,0,1,0
0,157,157,1,1,0,1,0
15,158,158,1,1,0,1,0
14,161,161,4,4,0,1,0
19,165,165,3,3,0,1,0
2,170,170,18,18,0,1,0
26,192,192,5,5,0,1,0
4,212,212,37,26,11,2,1
1,233,233,21,21,0,1,0
7,240,240,1,1,0,1,0
31,243,243,16,16,0,1,0
21,257,257,7,2,5,2,1
36,264,264,4,4,0,1,0
28,284,284,84,24,60,3,2
30,289,289,16,3,13,2,1
32,298,298,14,14,0,1,0
10,318,318,4,4,0,1,0
22,333,333,1,1,0,1,0
23,333,333,16,10,6,2,1
11,340,340,4,4,0,1,0
33,350,350,37,5,32,3,2
9,362,362,25,25,0,1,0
5,371,371,110,110,0,1,0
35,376,376,3,3,0,1,0
8,381,381,14,10,4,2,1
20,403,403,26,26,0,1,0
27,410,410,14,14,0,1,0
18,429,429,31,13,18,4,3
13,431,431,36,12,24,2,1
16,437,437,22,22,0,1,0
37,473,473,25,19,6,3,2
17,485,485,15,2,13,2,1
25,487,487,49,49,0,1,0
24,492,492,206,98,108,4,3

16,101,101,4,4,0,1,0
29,136,136,50,30,20,2,1
27,140,140,5,5,0,1,0
19,145,145,28,28,0,1,0
25,152,152,6,6,0,1,0
7,158,158,15,15,0,1,0
11,161,161,13,13,0,1,0
28,162,162,6,1,5,2,1
10,169,169,17,17,0,1,0
1,180,180,4,4,0,1,0
17,209,209,7,2,5,2,1
21,216,216,4,4,0,1,0
14,272,272,8,8,0,1,0
24,276,276,7,1,6,2,1
3,283,283,52,15,37,2,1
20,303,303,7,7,0,1,0
8,307,307,33,33,0,1,0
6,314,314,45,45,0,1,0
9,316,316,17,17,0,1,0
5,326,326,13,13,0,1,0
2,331,331,26,26,0,1,0
0,334,334,39,19,20,3,2
13,370,370,36,8,28,2,1
23,374,374,183,109,74,3,2
26,374,374,17,5,12,4,3
15,413,413,54,12,42,4,3
30,450,450,6,3,3,2,1
31,466,466,15,15,0,1,0
4,469,469,19,9,10,3,2
12,472,472,3,3,0,1,0
22,482,482,52,2,50,3,2
32,489,489,4,1,3,2,1
18,500,500,1,1,0,1,0

22,101,101,25,25,0,1,0
20,105,105,14,14,0,1,0
8,122,122,9,1,8,2,1
6,145,145,3,3,0,1,0
21,177,177,4,4,0,1,0
15,185,185,3,3,0,1,0
1,190,190,8,8,0,1,0
19,199,199,30,10,20,3,2
5,202,202,13,13,0,1,0
12,205,205,6,6,0,1,0
4,207,207,23,23,0,1,0
23,211,211,31,31,0,1,0
18,247,247,24,4,20,3,2
11,268,268,19,9,10,3,2
16,307,307,1,1,0,1,0
17,325,325,33,26,7,2,1
26,358,358,23,23,0,1,0
0,368,368,15,3,12,2,1
14,369,369,9,4,5,2,1
28,371,371,17,17,0,1,0
24,375,375,53,53,0,1,0
10,387,387,54,24,30,2,1
29,411,411,4,4,0,1,0
9,427,427,81,48,33,4,3
3,445,445,42,14,28,3,2
25,452,452,1,1,0,1,0
7,460,460,160,160,0,1,0
13,466,466,29,29,0,1,0
27,466,466,124,40,84,4,3
2,467,467,36,36,0,1,0

20,102,102,5,5,0,1,0
1,126,126,3,3,0,1,0
28,132,132,5,5,0,1,0
10,142,142,4,4,0,1,0
9,145,145,5,5,0,1,0
11,147,147,2,2,0,1,0
7,172,172,5,5,0,1,0
17,174,174,26,26,0,1,0
5,183,183,14,14,0,1,0
23,185,185,20,20,0,1,0
26,202,202,8,8,0,1,0
12,207,207,27,27,0,1,0
19,218,218,47,1,46,2,1
3,223,223,19,3,16,2,1
15,240,240,62,34,28,2,1
29,257,257,18,6,12,4,3
13,263,263,54,54,0,1,0
18,282,282,19,19,0,1,0
16,285,285,5,5,0,1,0
0,289,289,10,10,0,1,0
27,342,342,89,54,35,2,1
21,353,353,57,57,0,1,0
14,364,364,37,8,29,2,1
4,389,389,6,6,0,1,0
24,406,406,34,11,23,3,2
2,408,408,44,8,36,4,3
6,437,437,79,50,29,2,1
8,440,440,34,34,0,1,0
25,495,495,30,3,27,4,3
22,499,499,54,54,0,1,0

1,101,101,1,1,0,1,0
15,109,109,8,8,0,1,0
0,156,156,28,28,0,1,0
18,174,174,12,12,0,1,0
19,185,185,14,14,0,1,0
25,210,210,2,2,0,1,0
5,212,212,16,4,12,4,3
26,212,212,26,4,22,3,2
14,227,227,22,22,0,1,0
22,229,229,87,11,76,3,2
16,237,237,1,1,0,1,0
30,250,250,11,11,0,1,0
9,266,266,11,5,6,2,1
21,281,281,18,18,0,1,0
4,293,293,44,21,23,2,1
13,299,299,33,25,8,2,1
28,311,311,9,4,5,2,1
6,322,322,4,4,0,1,0
31,334,334,47,2,45,4,3
27,336,336,52,44,8,2,1
29,349,349,30,3,27,2,1
2,352,352,52,52,0,1,0
10,355,355,20,5,15,4,3
7,377,377,24,2,22,2,1
24,388,388,8,8,0,1,0
11,391,391,35,5,30,3,2
23,426,426,25,25,0,1,0
8,426,426,12,12,0,1,0
12,430,430,36,25,11,4,3
3,433,433,17,2,15,2,1
20,449,449,80,36,44,2,1
17,461,461,64,23,41,3,2

0,111,111,1,1,0,1,0
6,115,115,30,30,0,1,0
13,134,134,7,7,0,1,0
10,141,141,12,12,0,1,0
5,165,165,17,17,0,1,0
16,179,179,1,1,0,1,0
2,181,181,2,2,0,1,0
18,189,189,24,8,16,2,1
23,190,190,3,3,0,1,0
20,197,197,32,32,0,1,0
21,198,198,46,46,0,1,0
22,243,243,74,74,0,1,0
24,273,273,19,19,0,1,0
7,290,290,1,1,0,1,0
19,294,294,79,56,23,2,1
9,297,297,16,1,15,4,3
12,328,328,19,1,18,4,3
17,329,329,24,24,0,1,0
15,340,340,7,7,0,1,0
11,371,371,1,1,0,1,0
3,405,405,1,1,0,1,0
1,405,405,26,19,7,2,1
14,421,421,18,18,0,1,0
4,425,425,54,54,0,1,0
8,443,443,304,265,39,4,3

8,102,102,11,1,10,3,2
32,103,103,23,23,0,1,0
12,109,109,10,10,0,1,0
19,111,111,4,1,3,2,1
22,128,128,12,8,4,2,1
16,182,182,20,20,0,1,0
31,188,188,7,7,0,1,0
25,190,190,2,2,0,1,0
18,196,196,6,6,0,1,0
5,198,198,17,5,12,2,1
13,202,202,10,10,0,1,0
17,204,204,97,88,9,2,1
1,206,206,2,2,0,1,0
28,208,208,11,11,0,1,0
10,228,228,8,8,0,1,0
27,257,257,23,18,5,2,1
3,292,292,3,3,0,1,0
14,342,342,28,14,14,2,1
2,351,351,3,3,0,1,0
21,369,369,42,42,0,1,0
4,370,370,23,2,21,4,3
29,378,378,103,103,0,1,0
24,385,385,28,12,16,2,1
30,396,396,32,23,9,2,1
6,398,398,19,3,16,3,2
11,403,403,48,2,46,2,1
23,428,428,102,102,0,1,0
26,433,433,31,31,0,1,0
0,437,437,8,8,0,1,0
20,460,460,13,9,4,2,1
7,472,472,5,5,0,1,0
9,490,490,17,5,12,4,3
15,493,493,7,7,0,1,0

2,103,103,3,3,0,1,0
6,141,141,1,1,0,1,0
4,161,161,30,2,28,3,2
8,180,180,20,20,0,1,0
10,182,182,30,30,0,1,0
3,187,187,15,15,0,1,0
15,191,191,8,8,0,1,0
0,207,207,7,7,0,1,0
5,208,208,13,13,0,1,0
1,235,235,64,46,18,3,2
25,246,246,8,1,7,2,1
18,281,281,8,1,7,2,1
17,281,281,18,8,10,3,2
7,295,295,21,15,6,2,1
11,297,297,3,3,0,1,0
26,307,307,36,23,13,2,1
22,326,326,42,30,12,4,3
12,327,327,58,43,15,4,3
21,351,351,94,62,32,2,1
24,367,367,45,45,0,1,0
19,384,384,28,28,0,1,0
20,413,413,20,20,0,1,0
14,420,420,55,11,44,4,3
27,424,424,19,13,6,2,1
28,439,439,12,12,0,1,0
16,455,455,39,28,11,2,1
13,457,457,6,6,0,1,0
9,460,460,6,6,0,1,0
29,478,478,172,172,0,1,0
23,483,483,10,7,3,2,1

3,119,119,6,6,0,1,0
27,119,119,3,3,0,1,0
2,123,123,6,6,0,1,0
28,147,147,13,8,5,2,1
31,148,148,15,15,0,1,0
0,153,153,22,22,0,1,0
13,153,153,3,3,0,1,0
16,154,154,1,1,0,1,0
23,168,168,4,4,0,1,0
30,186,186,11,2,9,4,3
22,188,188,35,26,9,2,1
32,197,197,62,7,55,4,3
18,197,197,7,1,6,3,2
1,204,204,15,9,6,2,1
26,274,274,3,3,0,1,0
29,286,286,60,5,55,3,2
15,286,286,14,14,0,1,0
19,300,300,19,19,0,1,0
25,303,303,10,2,8,2,1
17,333,333,14,14,0,1,0
9,339,339,2,2,0,1,0
6,345,345,54,50,4,2,1
10,352,352,39,39,0,1,0
8,381,381,16,7,9,4,3
5,386,386,16,16,0,1,0
7,386,386,90,90,0,1,0
11,392,392,30,30,0,1,0
4,401,401,39,13,26,4,3
21,405,405,17,17,0,1,0
33,415,415,34,34,0,1,0
20,417,417,75,30,45,2,1
12,429,429,13,13,0,1,0
14,445,445,33,33,0,1,0
24,451,451,34,34,0,1,0

22,107,107,4,4,0,1,0
10,112,112,4,1,3,2,1
15,126,126,11,11,0,1,0
11,167,167,24,11,13,2,1
14,190,190,23,4,19,2,1
0,196,196,13,13,0,1,0
18,200,200,11,1,10,2,1
2,210,210,45,25,20,3,2
12,212,212,3,3,0,1,0
4,230,230,48,48,0,1,0
13,230,230,10,10,0,1,0
5,256,256,26,26,0,1,0
3,269,269,53,9,44,3,2
19,304,304,41,29,12,3,2
25,372,372,84,80,4,2,1
20,380,380,60,60,0,1,0
23,384,384,45,8,37,2,1
21,386,386,73,28,45,4,3
9,389,389,10,10,0,1,0
6,390,390,40,40,0,1,0
16,393,393,3,3,0,1,0
24,411,411,12,12,0,1,0
7,417,417,13,13,0,1,0
8,419,419,26,26,0,1,0
1,433,433,16,16,0,1,0
27,447,447,109,109,0,1,0
28,451,451,21,21,0,1,0
17,468,468,39,14,25,2,1
26,485,485,4,1,3,2,1

11,100,100,1,1,0,1,0
18,106,106,6,6,0,1,0
25,128,128,16,1,15,4,3
29,136,136,27,1,26,2,1
31,154,154,5,5,0,1,0
3,163,163,15,1,14,2,1
5,175,175,35,35,0,1,0
20,190,190,7,3,4,2,1
9,209,209,1,1,0,1,0
19,220,220,7,7,0,1,0
14,247,247,16,16,0,1,0
28,255,255,9,9,0,1,0
10,280,280,19,7,12,3,2
23,297,297,61,61,0,1,0
15,301,301,1,1,0,1,0
2,329,329,8,8,0,1,0
4,331,331,51,48,3,2,1
22,345,345,8,2,6,3,2
24,359,359,34,5,29,2,1
6,390,390,34,13,21,4,3
26,417,417,75,1,74,4,3
12,420,420,102,27,75,4,3
17,420,420,36,36,0,1,0
30,427,427,102,102,0,1,0
7,436,436,10,2,8,2,1
27,451,451,47,20,27,4,3
8,451,451,26,26,0,1,0
13,459,459,1,1,0,1,0
16,462,462,42,12,30,3,2
0,470,470,61,21,40,3,2
1,483,483,29,29,0,1,0
21,484,484,32,15,17,2,1

2,108,108,9,5,4,2,1
1,113,113,20,20,0,1,0
4,130,130,46,46,0,1,0
5,165,165,11,11,0,1,0
21,165,165,5,5,0,1,0
15,182,182,15,15,0,1,0
26,196,196,8,8,0,1,0
17,201,201,2,2,0,1,0
13,208,208,15,15,0,1,0
0,217,217,8,3,5,2,1
10,219,219,5,1,4,2,1
16,232,232,16,5,11,3,2
19,236,236,59,59,0,1,0
14,242,242,61,23,38,3,2
11,304,304,38,38,0,1,0
9,308,308,26,21,5,2,1
24,327,327,20,8,12,4,3
20,328,328,1,1,0,1,0
12,354,354,52,1,51,4,3
8,362,362,7,4,3,2,1
3,366,366,41,41,0,1,0
23,366,366,136,11,125,4,3
18,373,373,14,14,0,1,0
7,378,378,29,13,16,3,2
6,423,423,41,8,33,4,3
25,468,468,28,28,0,1,0
22,485,485,44,44,0,1,0

5,100,100,35,4,31,2,1
2,110,110,8,8,0,1,0
18,115,115,28,8,20,2,1
20,119,119,15,15,0,1,0
27,127,127,6,6,0,1,0
21,161,161,11,11,0,1,0
8,180,180,80,41,39,4,3
13,182,182,7,7,0,1,0
14,212,212,6,3,3,2,1
17,218,218,3,3,0,1,0
4,230,230,18,18,0,1,0
28,231,231,5,5,0,1,0
7,236,236,2,2,0,1,0
19,236,236,62,62,0,1,0
12,237,237,10,3,7,2,1
9,253,253,4,1,3,2,1
0,323,323,1,1,0,1,0
6,333,333,31,11,20,3,2
22,342,342,59,55,4,2,1
24,342,342,36,11,25,2,1
26,374,374,31,31,0,1,0
1,395,395,21,21,0,1,0
3,398,398,3,3,0,1,0
15,413,413,6,6,0,1,0
11,419,419,46,46,0,1,0
23,440,440,84,12,72,3,2
16,453,453,30,30,0,1,0
25,487,487,10,10,0,1,0
10,494,494,27,5,22,2,1

1,119,119,11,11,0,1,0
23,122,122,35,35,0,1,0
18,141,141,5,1,4,2,1
24,163,163,16,16,0,1,0
6,182,182,4,4,0,1,0
20,193,193,9,3,6,3,2
3,198,198,18,5,13,2,1
5,208,208,23,5,18,4,3
28,213,213,68,68,0,1,0
7,215,215,5,1,4,2,1
26,253,253,3,3,0,1,0
16,255,255,26,21,5,2,1
14,265,265,13,4,9,4,3
11,281,281,22,14,8,3,2
19,325,325,45,45,0,1,0
13,328,328,52,1,51,4,3
21,330,330,30,3,27,4,3
10,341,341,1,1,0,1,0
12,343,343,58,31,27,4,3
8,356,356,15,8,7,2,1
27,393,393,34,34,0,1,0
29,449,449,7,7,0,1,0
22,451,451,35,35,0,1,0
15,455,455,13,13,0,1,0
0,455,455,69,10,59,4,3
17,458,458,40,30,10,2,1
9,470,470,3,3,0,1,0
2,471,471,42,42,0,1,0
4,480,480,137,44,93,4,3
25,493,493,12,3,9,4,3

9,110,110,2,2,0,1,0
23,113,113,10,2,8,3,2
30,127,127,16,16,0,1,0
5,153,153,22,5,17,3,2
8,157,157,10,2,8,3,2
14,174,174,4,4,0,1,0
15,199,199,4,4,0,1,0
19,201,201,7,7,0,1,0
6,223,223,7,2,5,2,1
20,226,226,21,21,0,1,0
27,236,236,58,58,0,1,0
18,255,255,10,10,0,1,0
13,262,262,91,91,0,1,0
1,274,274,45,42,3,2,1
26,281,281,21,1,20,2,1
25,286,286,47,47,0,1,0
29,306,306,75,75,0,1,0
28,312,312,1,1,0,1,0
24,313,313,8,8,0,1,0
2,355,355,8,8,0,1,0
21,366,366,63,15,48,3,2
3,371,371,18,10,8,3,2
0,378,378,26,1,25,2,1
7,382,382,66,16,50,2,1
17,413,413,18,18,0,1,0
10,425,425,46,46,0,1,0
11,442,442,49,49,0,1,0
12,453,453,17,7,10,2,1
4,465,465,8,8,0,1,0
22,482,482,33,30,3,2,1
16,498,498,1,1,0,1,0

1,104,104,6,6,0,1,0
16,109,109,8,5,3,2,1
30,111,111,1,1,0,1,0
3,162,162,25,25,0,1,0
18,181,181,2,2,0,1,0
32,223,223,36,36,0,1,0
31,224,224,15,15,0,1,0
20,237,237,11,8,3,2,1
0,266,266,31,31,0,1,0
2,276,276,6,6,0,1,0
21,292,292,46,17,29,2,1
19,297,297,3,3,0,1,0
15,310,310,43,43,0,1,0
7,321,321,1,1,0,1,0
26,323,323,36,36,0,1,0
8,331,331,35,20,15,4,3
28,359,359,73,73,0,1,0
29,425,425,38,29,9,4,3
14,432,432,37,15,22,3,2
6,448,448,55,15,40,3,2
13,450,450,48,48,0,1,0
23,453,453,12,12,0,1,0
5,455,455,12,7,5,2,1
17,459,459,30,30,0,1,0
12,460,460,6,6,0,1,0
9,467,467,50,18,32,4,3
22,469,469,98,82,16,2,1
27,477,477,14,4,10,2,1
25,478,478,95,15,80,3,2
11,478,478,66,40,26,3,2
10,478,478,6,2,4,2,1
24,486,486,52,25,27,4,3
4,494,494,22,22,0,1,0

2,111,111,2,2,0,1,0
14,131,131,21,21,0,1,0
8,159,159,20,20,0,1,0
23,170,170,44,16,28,3,2
15,170,170,21,21,0,1,0
20,171,171,46,9,37,4,3
19,234,234,7,7,0,1,0
5,240,240,48,7,41,2,1
24,249,249,30,16,14,3,2
11,255,255,14,14,0,1,0
1,271,271,25,25,0,1,0
6,281,281,25,14,11,2,1
10,294,294,4,4,0,1,0
16,316,316,1,1,0,1,0
3,330,330,19,5,14,3,2
4,350,350,16,4,12,4,3
7,360,360,42,24,18,4,3
0,427,427,77,77,0,1,0
12,435,435,55,26,29,2,1
22,444,444,31,21,10,2,1
9,448,448,126,84,42,4,3
13,454,454,33,33,0,1,0
25,463,463,20,20,0,1,0
21,473,473,1,1,0,1,0
26,479,479,65,65,0,1,0
17,495,495,2,2,0,1,0
18,496,496,65,18,47,2,1

19,106,106,8,3,5,2,1
22,110,110,3,3,0,1,0
9,151,151,3,3,0,1,0
30,153,153,41,41,0,1,0
2,159,159,10,10,0,1,0
31,171,171,8,2,6,3,2
11,175,175,1,1,0,1,0
18,187,187,20,14,6,2,1
5,232,232,16,4,12,4,3
7,274,274,7,7,0,1,0
26,291,291,48,36,12,4,3
12,303,303,8,8,0,1,0
0,305,305,30,18,12,4,3
20,321,321,15,3,12,4,3
1,323,323,4,4,0,1,0
4,327,327,36,4,32,3,2
28,329,329,52,52,0,1,0
15,345,345,20,20,0,1,0
16,365,365,87,21,66,4,3
32,401,401,22,9,13,2,1
23,414,414,74,38,36,2,1
6,415,415,9,9,0,1,0
8,418,418,4,1,3,2,1
24,422,422,18,18,0,1,0
3,430,430,1,1,0,1,0
21,433,433,8,5,3,2,1
13,471,471,44,44,0,1,0
25,474,474,5,2,3,2,1
10,477,477,59,32,27,4,3
17,483,483,94,58,36,3,2
14,488,488,60,60,0,1,0
27,490,490,18,18,0,1,0
29,496,496,147,126,21,4,3

15,108,108,5,2,3,2,1
13,109,109,12,12,0,1,0
3,124,124,9,9,0,1,0
7,125,125,4,4,0,1,0
5,126,126,1,1,0,1,0
18,129,129,3,3,0,1,0
21,156,156,4,4,0,1,0
10,174,174,39,39,0,1,0
11,189,189,5,5,0,1,0
28,189,189,35,4,31,4,3
8,198,198,9,9,0,1,0
2,238,238,12,12,0,1,0
0,240,240,1,1,0,1,0
23,264,264,48,22,26,3,2
27,286,286,65,17,48,2,1
12,296,296,10,3,7,2,1
14,314,314,60,60,0,1,0
4,316,316,56,40,16,2,1
24,340,340,123,51,72,3,2
16,356,356,47,7,40,2,1
29,392,392,33,3,30,3,2
20,401,401,9,9,0,1,0
22,408,408,32,11,21,4,3
26,408,408,11,1,10,2,1
19,409,409,24,24,0,1,0
6,412,412,31,31,0,1,0
1,427,427,60,60,0,1,0
9,438,438,75,75,0,1,0
17,456,456,4,4,0,1,0
25,472,472,6,2,4,2,1

20,106,106,3,3,0,1,0
8,107,107,35,35,0,1,0
1,109,109,4,4,0,1,0
26,115,115,17,17,0,1,0
14,116,116,3,3,0,1,0
4,142,142,6,6,0,1,0
23,185,185,8,2,6,3,2
5,187,187,5,5,0,1,0
11,194,194,1,1,0,1,0
3,214,214,38,38,0,1,0
7,214,214,9,6,3,2,1
24,228,228,10,1,9,4,3
21,230,230,8,8,0,1,0
16,256,256,28,28,0,1,0
13,260,260,48,25,23,2,1
10,279,279,53,21,32,3,2
15,284,284,87,87,0,1,0
27,301,301,1,1,0,1,0
17,314,314,37,25,12,4,3
0,314,314,39,17,22,3,2
6,325,325,16,16,0,1,0
12,361,361,25,18,7,2,1
22,409,409,67,36,31,2,1
25,411,411,8,8,0,1,0
28,416,416,85,1,84,4,3
9,423,423,24,24,0,1,0
18,438,438,89,89,0,1,0
2,442,442,22,22,0,1,0
19,497,497,2,2,0,1,0

11,160,160,4,4,0,1,0
7,168,168,33,33,0,1,0
17,173,173,31,31,0,1,0
0,181,181,40,40,0,1,0
8,188,188,8,1,7,2,1
9,191,191,3,3,0,1,0
2,201,201,56,6,50,2,1
18,204,204,3,3,0,1,0
13,205,205,8,5,3,2,1
22,213,213,27,27,0,1,0
6,253,253,59,59,0,1,0
14,273,273,1,1,0,1,0
24,281,281,21,21,0,1,0
1,332,332,16,16,0,1,0
21,358,358,5,5,0,1,0
16,361,361,72,32,40,3,2
15,366,366,33,12,21,2,1
3,385,385,10,2,8,2,1
23,403,403,115,69,46,2,1
25,427,427,78,36,42,4,3
4,427,427,5,5,0,1,0
12,427,427,6,6,0,1,0
5,427,427,69,69,0,1,0
20,469,469,31,18,13,2,1
19,490,490,67,67,0,1,0
10,495,495,72,60,12,4,3

7,102,102,1,1,0,1,0
24,110,110,8,8,0,1,0
11,113,113,45,45,0,1,0
29,121,121,14,14,0,1,0
6,124,124,6,6,0,1,0
3,145,145,17,17,0,1,0
18,145,145,2,2,0,1,0
15,174,174,5,5,0,1,0
21,178,178,53,50,3,2,1
8,208,208,2,2,0,1,0
14,211,211,17,17,0,1,0
17,221,221,13,4,9,4,3
27,227,227,9,9,0,1,0
19,244,244,17,17,0,1,0
28,260,260,5,5,0,1,0
0,278,278,40,27,13,3,2
9,280,280,49,16,33,4,3
16,301,301,24,3,21,2,1
5,324,324,28,28,0,1,0
2,352,352,3,3,0,1,0
4,358,358,4,4,0,1,0
12,393,393,33,7,26,4,3
22,395,395,16,6,10,2,1
23,395,395,117,117,0,1,0
20,400,400,91,34,57,4,3
10,409,409,54,19,35,4,3
26,418,418,7,3,4,2,1
1,461,461,26,26,0,1,0
13,467,467,6,6,0,1,0
25,473,473,40,13,27,4,3

3,120,120,28,10,18,4,3
11,124,124,3,3,0,1,0
12,158,158,18,18,0,1,0
25,172,172,3,3,0,1,0
20,184,184,12,12,0,1,0
18,200,200,13,5,8,3,2
21,220,220,5,1,4,2,1
10,244,244,28,28,0,1,0
23,246,246,31,31,0,1,0
16,256,256,22,1,21,2,1
4,257,257,49,27,22,3,2
24,266,266,3,3,0,1,0
19,294,294,29,6,23,2,1
1,322,322,69,36,33,4,3
17,322,322,22,22,0,1,0
14,336,336,78,78,0,1,0
0,351,351,7,7,0,1,0
15,362,362,15,15,0,1,0
8,378,378,63,63,0,1,0
9,413,413,53,33,20,2,1
5,417,417,6,6,0,1,0
2,419,419,17,17,0,1,0
6,455,455,112,53,59,4,3
13,459,459,79,79,0,1,0
22,484,484,149,138,11,2,1
7,493,493,6,6,0,1,0

12,100,100,3,3,0,1,0
22,162,162,7,7,0,1,0
24,170,170,12,12,0,1,0
23,178,178,17,1,16,2,1
14,193,193,1,1,0,1,0
3,259,259,50,50,0,1,0
7,293,293,20,8,12,2,1
2,315,315,35,4,31,2,1
20,325,325,35,35,0,1,0
19,327,327,138,111,27,2,1
0,346,346,13,1,12,4,3
10,350,350,64,32,32,2,1
21,362,362,1,1,0,1,0
9,365,365,59,38,21,4,3
6,376,376,21,21,0,1,0
4,395,395,24,14,10,2,1
15,402,402,20,8,12,3,2
17,403,403,38,13,25,2,1
8,447,447,38,4,34,3,2
18,448,448,84,84,0,1,0
1,460,460,32,10,22,3,2
16,460,460,15,15,0,1,0
25,463,463,53,29,24,2,1
11,468,468,141,102,39,4,3
13,484,484,85,37,48,4,3
5,495,495,37,37,0,1,0

25,116,116,8,8,0,1,0
11,135,135,1,1,0,1,0
7,145,145,15,15,0,1,0
9,154,154,4,4,0,1,0
31,156,156,12,2,10,2,1
26,164,164,3,3,0,1,0
3,195,195,3,3,0,1,0
16,206,206,11,6,5,2,1
18,209,209,10,5,5,2,1
8,238,238,19,19,0,1,0
1,244,244,1,1,0,1,0
4,246,246,44,44,0,1,0
12,254,254,8,8,0,1,0
0,262,262,23,23,0,1,0
32,281,281,12,6,6,3,2
13,312,312,8,8,0,1,0
21,314,314,11,11,0,1,0
24,319,319,88,62,26,3,2
5,325,325,13,3,10,3,2
27,330,330,5,5,0,1,0
22,333,333,1,1,0,1,0
20,336,336,74,62,12,4,3
2,339,339,28,28,0,1,0
17,354,354,56,52,4,2,1
10,354,354,51,7,44,3,2
29,371,371,31,31,0,1,0
15,375,375,7,7,0,1,0
30,380,380,3,3,0,1,0
28,382,382,69,6,63,4,3
23,392,392,108,69,39,4,3
14,417,417,34,34,0,1,0
6,440,440,96,30,66,4,3
19,450,450,60,60,0,1,0

17,102,102,9,1,8,2,1
27,108,108,25,4,21,4,3
18,124,124,4,4,0,1,0
12,133,133,10,7,3,2,1
3,141,141,19,19,0,1,0
15,156,156,6,6,0,1,0
24,157,157,4,4,0,1,0
22,167,167,27,27,0,1,0
21,175,175,7,1,6,3,2
4,199,199,11,1,10,3,2
20,232,232,70,65,5,2,1
19,245,245,2,2,0,1,0
13,251,251,17,4,13,2,1
2,255,255,72,39,33,2,1
0,305,305,7,7,0,1,0
29,338,338,12,1,11,4,3
5,352,352,34,26,8,2,1
9,370,370,1,1,0,1,0
7,372,372,3,3,0,1,0
10,383,383,57,57,0,1,0
8,398,398,59,47,12,4,3
6,405,405,14,10,4,2,1
11,407,407,9,9,0,1,0
1,408,408,6,6,0,1,0
16,412,412,75,75,0,1,0
25,429,429,51,51,0,1,0
28,435,435,52,7,45,3,2
26,466,466,31,7,24,2,1
14,467,467,31,3,28,3,2
30,477,477,32,32,0,1,0
23,492,492,67,25,42,3,2

1,108,108,4,4,0,1,0
14,116,116,1,1,0,1,0
17,157,157,43,43,0,1,0
10,172,172,2,2,0,1,0
22,175,175,16,16,0,1,0
11,205,205,9,9,0,1,0
12,206,206,1,1,0,1,0
2,210,210,45,45,0,1,0
4,210,210,18,18,0,1,0
27,215,215,21,21,0,1,0
23,233,233,2,2,0,1,0
25,270,270,25,3,22,2,1
15,282,282,12,9,3,2,1
13,282,282,6,6,0,1,0
19,283,283,4,1,3,2,1
7,288,288,29,29,0,1,0
6,320,320,26,6,20,2,1
30,329,329,84,41,43,2,1
3,355,355,108,22,86,3,2
24,361,361,24,24,0,1,0
21,367,367,6,6,0,1,0
28,368,368,14,2,12,4,3
20,389,389,29,29,0,1,0
29,401,401,36,36,0,1,0
26,416,416,36,2,34,2,1
8,422,422,129,129,0,1,0
5,428,428,18,3,15,4,3
0,428,428,16,2,14,3,2
18,435,435,96,10,86,3,2
9,464,464,19,5,14,2,1
16,492,492,9,3,6,3,2

12,123,123,12,12,0,1,0
2,126,126,26,14,12,3,2
8,132,132,15,7,8,3,2
16,144,144,1,1,0,1,0
7,156,156,46,46,0,1,0
0,171,171,60,60,0,1,0
9,222,222,30,24,6,3,2
10,228,228,80,41,39,2,1
15,241,241,17,2,15,4,3
21,247,247,8,2,6,2,1
20,261,261,6,6,0,1,0
19,290,290,29,19,10,2,1
3,299,299,36,7,29,2,1
11,313,313,25,12,13,2,1
5,322,322,5,2,3,2,1
18,333,333,85,19,66,4,3
4,352,352,66,66,0,1,0
14,361,361,50,44,6,2,1
13,430,430,11,8,3,2,1
6,454,454,29,20,9,4,3
1,469,469,24,7,17,2,1
22,483,483,33,19,14,2,1
17,484,484,19,19,0,1,0

23,101,101,12,12,0,1,0
16,103,103,4,1,3,2,1
26,112,112,2,2,0,1,0
22,121,121,19,19,0,1,0
5,138,138,6,6,0,1,0
19,184,184,3,3,0,1,0
1,197,197,67,43,24,4,3
18,201,201,2,2,0,1,0
20,209,209,5,5,0,1,0
14,210,210,50,32,18,3,2
25,241,241,5,5,0,1,0
3,251,251,1,1,0,1,0
4,269,269,36,36,0,1,0
7,279,279,28,10,18,4,3
11,321,321,83,80,3,2,1
2,369,369,10,10,0,1,0
17,372,372,38,14,24,2,1
9,407,407,19,19,0,1,0
27,410,410,153,153,0,1,0
24,410,410,26,26,0,1,0
8,420,420,4,4,0,1,0
21,423,423,26,26,0,1,0
6,441,441,7,7,0,1,0
10,459,459,55,16,39,2,1
0,462,462,44,1,43,2,1
15,470,470,93,93,0,1,0
12,470,470,49,49,0,1,0
13,493,493,50,5,45,4,3

17,103,103,1,1,0,1,0
19,106,106,8,8,0,1,0
23,107,107,23,23,0,1,0
27,109,109,4,4,0,1,0
3,113,113,24,24,0,1,0
2,136,136,40,40,0,1,0
10,158,158,11,11,0,1,0
22,170,170,12,1,11,2,1
8,179,179,10,1,9,4,3
6,181,181,4,4,0,1,0
5,201,201,9,2,7,2,1
0,255,255,9,5,4,2,1
12,260,260,5,5,0,1,0
20,272,272,6,6,0,1,0
11,289,289,24,24,0,1,0
18,316,316,95,95,0,1,0
16,340,340,55,55,0,1,0
14,342,342,7,2,5,2,1
1,351,351,1,1,0,1,0
4,395,395,9,6,3,2,1
15,396,396,66,22,44,3,2
26,398,398,63,27,36,4,3
24,401,401,44,44,0,1,0
13,434,434,23,23,0,1,0
21,440,440,26,26,0,1,0
9,445,445,8,4,4,2,1
7,471,471,221,148,73,4,3
25,498,498,17,17,0,1,0

31,128,128,25,19,6,3,2
3,133,133,1,1,0,1,0
16,181,181,16,16,0,1,0
15,183,183,56,56,0,1,0
28,188,188,12,12,0,1,0
13,211,211,8,8,0,1,0
2,226,226,1,1,0,1,0
29,251,251,40,40,0,1,0
5,268,268,12,12,0,1,0
25,273,273,51,31,20,3,2
17,293,293,7,7,0,1,0
26,332,332,26,26,0,1,0
14,333,333,58,58,0,1,0
19,337,337,14,14,0,1,0
20,364,364,14,14,0,1,0
6,367,367,2,2,0,1,0
24,373,373,9,9,0,1,0
9,377,377,1,1,0,1,0
4,387,387,6,3,3,2,1
10,391,391,30,4,26,2,1
18,397,397,13,13,0,1,0
12,410,410,46,46,0,1,0
30,412,412,17,17,0,1,0
8,425,425,108,54,54,4,3
22,429,429,41,17,24,3,2
7,434,434,5,5,0,1,0
27,435,435,32,6,26,3,2
21,453,453,167,88,79,4,3
1,472,472,69,69,0,1,0
11,477,477,23,9,14,3,2
0,481,481,21,21,0,1,0
23,497,497,13,4,9,4,3

15,102,102,4,4,0,1,0
2,142,142,21,21,0,1,0
18,148,148,2,2,0,1,0
4,151,151,34,34,0,1,0
16,157,157,8,8,0,1,0
14,183,183,39,19,20,2,1
21,198,198,30,30,0,1,0
0,226,226,40,40,0,1,0
12,236,236,13,8,5,2,1
10,279,279,72,22,50,3,2
17,295,295,12,6,6,3,2
6,304,304,25,7,18,2,1
13,342,342,19,19,0,1,0
11,347,347,54,54,0,1,0
20,353,353,8,8,0,1,0
8,357,357,79,79,0,1,0
7,383,383,114,114,0,1,0
19,389,389,67,67,0,1,0
1,430,430,92,77,15,4,3
9,444,444,19,13,6,2,1
5,471,471,3,3,0,1,0
22,476,476,78,64,14,2,1
3,479,479,14,3,11,2,1

11,100,100,1,1,0,1,0
9,103,103,37,37,0,1,0
4,116,116,1,1,0,1,0
14,117,117,5,5,0,1,0
13,129,129,8,8,0,1,0
5,129,129,29,6,23,2,1
8,144,144,2,2,0,1,0
17,180,180,11,11,0,1,0
15,187,187,9,9,0,1,0
23,199,199,56,23,33,4,3
21,220,220,3,3,0,1,0
24,233,233,105,51,54,3,2
12,237,237,25,25,0,1,0
7,254,254,15,3,12,2,1
2,271,271,14,14,0,1,0
25,328,328,23,23,0,1,0
1,340,340,120,36,84,4,3
0,360,360,2,2,0,1,0
20,383,383,7,4,3,2,1
18,416,416,10,10,0,1,0
22,427,427,40,7,33,4,3
6,435,435,17,17,0,1,0
3,448,448,13,9,4,2,1
16,473,473,47,35,12,4,3
10,480,480,121,17,104,4,3
19,486,486,28,18,10,2,1

25,106,106,6,2,4,2,1
16,132,132,4,1,3,2,1
26,134,134,36,24,12,2,1
20,158,158,15,15,0,1,0
21,180,180,5,5,0,1,0
19,191,191,5,5,0,1,0
3,204,204,1,1,0,1,0
8,223,223,38,38,0,1,0
24,227,227,14,14,0,1,0
12,256,256,20,16,4,2,1
0,285,285,19,9,10,3,2
22,286,286,6,6,0,1,0
10,292,292,22,7,15,2,1
15,298,298,14,7,7,2,1
6,309,309,19,19,0,1,0
14,332,332,5,5,0,1,0
27,334,334,106,97,9,4,3
5,337,337,10,10,0,1,0
18,350,350,80,30,50,2,1
4,363,363,137,60,77,4,3
28,370,370,7,1,6,2,1
23,374,374,7,7,0,1,0
2,382,382,8,8,0,1,0
17,394,394,39,39,0,1,0
1,394,394,16,16,0,1,0
7,411,411,2,2,0,1,0
29,428,428,67,67,0,1,0
13,430,430,46,32,14,2,1
11,455,455,77,77,0,1,0
9,464,464,61,39,22,3,2

4,116,116,12,12,0,1,0
1,121,121,8,8,0,1,0
6,158,158,46,46,0,1,0
15,193,193,20,17,3,2,1
21,201,201,31,8,23,2,1
16,211,211,30,12,18,3,2
9,223,223,3,3,0,1,0
22,231,231,26,6,20,3,2
24,242,242,4,4,0,1,0
8,259,259,3,3,0,1,0
2,272,272,26,1,25,2,1
7,282,282,2,2,0,1,0
14,287,287,1,1,0,1,0
11,308,308,69,53,16,4,3
17,336,336,57,11,46,3,2
5,346,346,59,59,0,1,0
25,348,348,45,8,37,2,1
19,373,373,28,19,9,2,1
12,398,398,16,16,0,1,0
20,408,408,90,36,54,3,2
3,415,415,77,2,75,4,3
18,430,430,22,22,0,1,0
13,449,449,76,76,0,1,0
23,468,468,17,17,0,1,0
10,473,473,53,29,24,4,3
0,482,482,58,15,43,4,3

1,100,100,24,16,8,3,2
2,111,111,31,22,9,2,1
3,118,118,1,1,0,1,0
7,132,132,3,3,0,1,0
13,135,135,12,12,0,1,0
0,147,147,21,21,0,1,0
17,148,148,4,4,0,1,0
9,167,167,47,47,0,1,0
20,186,186,3,3,0,1,0
18,196,196,10,10,0,1,0
21,213,213,17,5,12,2,1
6,215,215,1,1,0,1,0
11,220,220,31,31,0,1,0
22,225,225,12,12,0,1,0
25,255,255,24,6,18,4,3
10,257,257,9,4,5,2,1
15,271,271,90,27,63,4,3
19,281,281,86,86,0,1,0
16,293,293,52,44,8,3,2
23,329,329,5,5,0,1,0
5,337,337,2,2,0,1,0
8,434,434,37,37,0,1,0
24,476,476,55,4,51,4,3
12,495,495,14,14,0,1,0
14,499,499,23,23,0,1,0
4,499,499,78,32,46,3,2

18,101,101,10,10,0,1,0
6,104,104,1,1,0,1,0
15,104,104,1,1,0,1,0
7,109,109,6,6,0,1,0
28,123,123,10,10,0,1,0
17,133,133,3,3,0,1,0
4,136,136,4,4,0,1,0
25,144,144,6,6,0,1,0
16,163,163,3,3,0,1,0
13,201,201,1,1,0,1,0
11,210,210,12,12,0,1,0
12,210,210,23,23,0,1,0
8,229,229,36,36,0,1,0
5,245,245,1,1,0,1,0
21,252,252,44,44,0,1,0
3,289,289,68,18,50,3,2
24,289,289,37,7,30,3,2
19,296,296,1,1,0,1,0
2,307,307,56,56,0,1,0
22,319,319,36,36,0,1,0
29,327,327,5,2,3,2,1
23,344,344,29,29,0,1,0
14,348,348,1,1,0,1,0
32,350,350,4,4,0,1,0
27,397,397,21,5,16,2,1
31,399,399,96,96,0,1,0
9,406,406,57,33,24,2,1
26,414,414,5,5,0,1,0
10,418,418,83,17,66,3,2
30,424,424,46,1,45,4,3
20,434,434,155,80,75,4,3
0,446,446,6,6,0,1,0
1,498,498,28,28,0,1,0

1,145,145,15,15,0,1,0
22,162,162,5,2,3,2,1
10,167,167,11,11,0,1,0
18,201,201,9,4,5,2,1
3,224,224,1,1,0,1,0
6,224,224,35,23,12,3,2
19,224,224,3,3,0,1,0
9,234,234,45,18,27,2,1
7,248,248,5,5,0,1,0
25,259,259,19,11,8,2,1
2,284,284,5,5,0,1,0
0,295,295,16,16,0,1,0
16,297,297,118,112,6,2,1
23,303,303,6,6,0,1,0
24,313,313,39,39,0,1,0
8,368,368,2,2,0,1,0
4,409,409,72,11,61,4,3
5,413,413,158,126,32,3,2
15,423,423,99,63,36,4,3
12,434,434,14,14,0,1,0
20,449,449,24,3,21,2,1
11,455,455,101,61,40,2,1
17,462,462,100,100,0,1,0
13,479,479,20,2,18,4,3
21,486,486,68,20,48,2,1
14,491,491,4,4,0,1,0

2,102,102,2,2,0,1,0
18,135,135,4,4,0,1,0
12,143,143,7,7,0,1,0
8,148,148,21,21,0,1,0
0,185,185,18,7,11,2,1
15,210,210,6,6,0,1,0
7,213,213,15,1,14,3,2
29,218,218,6,6,0,1,0
3,238,238,2,2,0,1,0
10,241,241,6,6,0,1,0
16,261,261,13,13,0,1,0
17,275,275,96,96,0,1,0
11,284,284,28,28,0,1,0
23,286,286,10,5,5,2,1
14,297,297,53,33,20,3,2
5,298,298,16,4,12,3,2
24,317,317,26,16,10,2,1
21,325,325,28,16,12,2,1
1,331,331,8,2,6,3,2
22,340,340,37,37,0,1,0
9,360,360,19,19,0,1,0
20,369,369,114,87,27,4,3
4,382,382,39,22,17,2,1
25,384,384,105,81,24,4,3
19,386,386,15,15,0,1,0
28,415,415,1,1,0,1,0
13,424,424,93,11,82,3,2
26,456,456,18,18,0,1,0
30,475,475,16,16,0,1,0
27,477,477,1,1,0,1,0
6,480,480,88,10,78,3,2

19,101,101,2,2,0,1,0
11,111,111,40,3,37,2,1
21,117,117,9,9,0,1,0
6,121,121,8,8,0,1,0
22,162,162,13,1,12,4,3
13,173,173,25,5,20,3,2
10,184,184,33,33,0,1,0
24,214,214,20,12,8,3,2
8,258,258,94,84,10,2,1
2,287,287,43,3,40,3,2
12,287,287,1,1,0,1,0
3,291,291,1,1,0,1,0
15,303,303,15,3,12,2,1
20,339,339,2,2,0,1,0
23,346,346,17,5,12,4,3
18,349,349,69,69,0,1,0
5,350,350,2,2,0,1,0
7,405,405,48,30,18,3,2
16,411,411,66,44,22,2,1
1,428,428,77,77,0,1,0
17,429,429,10,10,0,1,0
0,441,441,25,25,0,1,0
9,479,479,64,64,0,1,0
4,481,481,70,16,54,4,3
14,490,490,89,10,79,4,3

12,104,104,14,14,0,1,0
10,113,113,1,1,0,1,0
22,119,119,2,2,0,1,0
1,125,125,11,7,4,2,1
17,225,225,74,11,63,4,3
23,226,226,56,15,41,2,1
14,256,256,12,12,0,1,0
5,260,260,117,69,48,4,3
16,264,264,31,27,4,2,1
7,270,270,44,14,30,4,3
18,275,275,26,18,8,2,1
0,290,290,1,1,0,1,0
9,302,302,56,11,45,4,3
8,304,304,10,2,8,3,2
15,312,312,9,6,3,2,1
2,328,328,53,53,0,1,0
24,336,336,27,1,26,3,2
11,346,346,4,4,0,1,0
4,394,394,29,12,17,2,1
13,417,417,24,3,21,2,1
6,420,420,49,40,9,2,1
20,423,423,53,53,0,1,0
3,460,460,56,56,0,1,0
21,490,490,49,14,35,2,1
19,498,498,18,18,0,1,0

3,129,129,8,8,0,1,0
6,145,145,6,6,0,1,0
24,145,145,6,6,0,1,0
7,148,148,1,1,0,1,0
25,179,179,11,11,0,1,0
22,181,181,5,5,0,1,0
32,185,185,13,13,0,1,0
30,192,192,31,11,20,4,3
21,198,198,41,11,30,4,3
19,218,218,2,2,0,1,0
33,220,220,40,32,8,2,1
15,254,254,1,1,0,1,0
18,257,257,50,34,16,2,1
16,259,259,23,23,0,1,0
23,259,259,10,10,0,1,0
27,298,298,27,27,0,1,0
17,312,312,131,131,0,1,0
12,323,323,13,13,0,1,0
13,332,332,15,15,0,1,0
1,349,349,9,3,6,2,1
0,353,353,19,9,10,2,1
10,398,398,48,48,0,1,0
9,409,409,1,1,0,1,0
5,425,425,30,30,0,1,0
8,431,431,16,1,15,4,3
31,438,438,2,2,0,1,0
14,439,439,12,12,0,1,0
4,449,449,22,3,19,2,1
26,465,465,46,46,0,1,0
29,471,471,99,81,18,3,2
11,482,482,6,6,0,1,0
2,486,486,45,45,0,1,0
20,486,486,9,9,0,1,0
28,497,497,107,107,0,1,0

25,116,116,1,1,0,1,0
24,134,134,2,2,0,1,0
7,135,135,4,4,0,1,0
22,137,137,10,1,9,3,2
3,146,146,2,2,0,1,0
6,154,154,10,1,9,2,1
32,157,157,12,12,0,1,0
26,159,159,25,25,0,1,0
5,165,165,21,4,17,2,1
23,194,194,61,29,32,4,3
12,214,214,1,1,0,1,0
17,222,222,2,2,0,1,0
1,243,243,38,38,0,1,0
14,253,253,3,3,0,1,0
28,257,257,52,52,0,1,0
0,263,263,67,67,0,1,0
29,279,279,32,9,23,2,1
9,302,302,20,2,18,3,2
31,310,310,62,62,0,1,0
4,314,314,1,1,0,1,0
11,340,340,5,5,0,1,0
13,355,355,19,7,12,3,2
2,367,367,1,1,0,1,0
34,377,377,40,16,24,4,3
15,386,386,41,41,0,1,0
33,389,389,30,30,0,1,0
16,391,391,49,7,42,4,3
18,405,405,18,18,0,1,0
30,421,421,18,18,0,1,0
27,427,427,5,5,0,1,0
21,448,448,16,1,15,4,3
10,480,480,103,103,0,1,0
20,488,488,19,19,0,1,0
8,488,488,24,14,10,3,2
19,493,493,5,2,3,2,1

8,110,110,22,22,0,1,0
16,131,131,14,14,0,1,0
17,173,173,5,5,0,1,0
19,200,200,25,25,0,1,0
27,209,209,20,5,15,4,3
13,221,221,2,2,0,1,0
26,258,258,12,12,0,1,0
11,260,260,7,7,0,1,0
9,268,268,6,6,0,1,0
25,271,271,11,11,0,1,0
23,273,273,48,17,31,2,1
15,274,274,33,33,0,1,0
22,280,280,11,11,0,1,0
20,316,316,1,1,0,1,0
12,318,318,1,1,0,1,0
29,322,322,49,40,9,4,3
18,337,337,22,22,0,1,0
5,348,348,1,1,0,1,0
1,348,348,81,1,80,3,2
7,365,365,26,26,0,1,0
6,371,371,94,87,7,3,2
2,379,379,119,86,33,4,3
10,398,398,23,3,20,2,1
4,399,399,18,18,0,1,0
3,401,401,5,5,0,1,0
14,411,411,8,8,0,1,0
28,430,430,125,39,86,3,2
24,448,448,38,6,32,2,1
0,452,452,5,5,0,1,0
21,461,461,78,57,21,3,2

27,101,101,2,2,0,1,0
3,105,105,8,8,0,1,0
12,109,109,3,3,0,1,0
24,112,112,97,92,5,2,1
21,134,134,3,3,0,1,0
28,140,140,7,7,0,1,0
16,149,149,1,1,0,1,0
11,170,170,21,21,0,1,0
2,202,202,6,3,3,2,1
5,215,215,7,7,0,1,0
8,218,218,11,3,8,3,2
26,224,224,8,8,0,1,0
20,242,242,44,12,32,2,1
25,243,243,11,11,0,1,0
22,252,252,2,2,0,1,0
0,278,278,28,28,0,1,0
4,308,308,40,17,23,2,1
13,356,356,30,30,0,1,0
10,369,369,31,20,11,2,1
18,370,370,18,18,0,1,0
19,395,395,8,8,0,1,0
15,405,405,1,1,0,1,0
29,408,408,30,12,18,3,2
14,419,419,136,54,82,4,3
9,437,437,74,74,0,1,0
7,448,448,11,11,0,1,0
23,457,457,9,9,0,1,0
6,466,466,54,54,0,1,0
1,469,469,12,8,4,2,1
17,473,473,15,15,0,1,0

26,120,120,2,2,0,1,0
9,138,138,23,19,4,2,1
14,199,199,11,3,8,3,2
3,209,209,9,5,4,2,1
11,218,218,11,6,5,2,1
27,232,232,8,8,0,1,0
1,233,233,69,23,46,3,2
20,247,247,23,23,0,1,0
2,256,256,1,1,0,1,0
4,269,269,12,1,11,2,1
5,277,277,44,10,34,2,1
18,293,293,17,5,12,4,3
24,309,309,47,47,0,1,0
0,339,339,36,36,0,1,0
12,353,353,69,41,28,2,1
19,357,357,32,10,22,2,1
8,358,358,47,47,0,1,0
25,374,374,90,55,35,4,3
22,381,381,47,47,0,1,0
6,391,391,5,5,0,1,0
21,392,392,94,54,40,2,1
13,422,422,13,13,0,1,0
28,436,436,26,10,16,2,1
17,456,456,70,16,54,4,3
16,472,472,54,19,35,2,1
10,486,486,17,17,0,1,0
15,487,487,20,4,16,2,1
23,491,491,2,2,0,1,0
7,497,497,37,12,25,2,1

23,118,118,16,7,9,4,3
26,123,123,15,15,0,1,0
24,128,128,5,5,0,1,0
20,134,134,2,2,0,1,0
14,141,141,29,29,0,1,0
6,143,143,4,4,0,1,0
7,173,173,15,5,10,3,2
22,173,173,12,12,0,1,0
15,179,179,26,26,0,1,0
9,239,239,18,2,16,2,1
28,249,249,2,2,0,1,0
13,277,277,13,13,0,1,0
10,286,286,70,55,15,4,3
19,310,310,36,13,23,2,1
25,319,319,3,3,0,1,0
5,319,319,54,19,35,2,1
1,324,324,11,2,9,4,3
4,325,325,49,34,15,4,3
18,326,326,3,3,0,1,0
27,327,327,7,1,6,2,1
2,332,332,38,5,33,4,3
0,356,356,47,47,0,1,0
11,379,379,1,1,0,1,0
8,411,411,3,3,0,1,0
16,415,415,127,40,87,4,3
17,425,425,127,112,15,2,1
12,467,467,44,28,16,3,2
3,475,475,6,6,0,1,0
21,489,489,68,17,51,4,3

4,140,140,3,3,0,1,0
27,148,148,7,2,5,2,1
25,180,180,4,4,0,1,0
3,189,189,18,18,0,1,0
20,197,197,16,16,0,1,0
15,203,203,12,12,0,1,0
12,243,243,20,11,9,4,3
0,244,244,8,8,0,1,0
23,269,269,9,2,7,2,1
1,295,295,18,12,6,3,2
28,300,300,75,37,38,2,1
22,317,317,12,12,0,1,0
30,320,320,39,39,0,1,0
10,323,323,102,102,0,1,0
7,324,324,9,4,5,2,1
29,330,330,77,77,0,1,0
21,344,344,6,6,0,1,0
31,358,358,5,2,3,2,1
5,370,370,7,4,3,2,1
24,372,372,45,27,18,2,1
26,390,390,108,108,0,1,0
11,394,394,28,14,14,2,1
19,402,402,10,4,6,3,2
32,416,416,57,16,41,2,1
18,437,437,48,34,14,2,1
16,443,443,1,1,0,1,0
8,452,452,23,23,0,1,0
17,461,461,19,4,15,4,3
14,465,465,82,82,0,1,0
9,472,472,60,60,0,1,0
13,480,480,29,29,0,1,0
6,481,481,15,3,12,3,2
2,482,482,8,8,0,1,0

28,103,103,8,8,0,1,0
19,130,130,4,4,0,1,0
16,150,150,14,14,0,1,0
22,170,170,12,4,8,3,2
15,182,182,17,17,0,1,0
23,200,200,2,2,0,1,0
12,218,218,33,24,9,4,3
11,249,249,18,5,13,2,1
1,259,259,28,4,24,3,2
17,266,266,79,31,48,3,2
4,283,283,3,3,0,1,0
24,284,284,30,8,22,3,2
8,287,287,20,20,0,1,0
26,292,292,87,39,48,4,3
2,295,295,62,62,0,1,0
13,300,300,3,3,0,1,0
25,306,306,11,11,0,1,0
0,309,309,26,4,22,3,2
3,330,330,32,32,0,1,0
6,356,356,61,11,50,3,2
10,405,405,53,12,41,2,1
18,410,410,80,80,0,1,0
27,417,417,1,1,0,1,0
9,419,419,31,31,0,1,0
7,422,422,86,16,70,3,2
14,440,440,3,3,0,1,0
20,467,467,30,12,18,2,1
5,492,492,1,1,0,1,0
21,498,498,29,2,27,4,3

3,143,143,23,23,0,1,0
24,148,148,14,14,0,1,0
9,154,154,34,17,17,2,1
23,180,180,29,22,7,2,1
8,188,188,4,4,0,1,0
12,251,251,6,6,0,1,0
7,272,272,42,20,22,4,3
5,285,285,50,50,0,1,0
0,289,289,40,40,0,1,0
14,307,307,21,21,0,1,0
20,311,311,4,1,3,2,1
11,312,312,57,17,40,4,3
19,321,321,6,6,0,1,0
6,339,339,1,1,0,1,0
21,366,366,44,44,0,1,0
22,368,368,52,52,0,1,0
10,376,376,20,14,6,2,1
1,381,381,29,8,21,4,3
4,396,396,118,60,58,3,2
15,406,406,39,39,0,1,0
2,429,429,43,43,0,1,0
18,436,436,48,48,0,1,0
17,436,436,3,3,0,1,0
16,436,436,98,60,38,2,1
13,459,459,72,5,67,4,3

25,116,116,7,1,6,2,1
6,116,116,10,10,0,1,0
22,133,133,37,27,10,2,1
23,155,155,65,65,0,1,0
10,184,184,56,2,54,3,2
29,196,196,5,2,3,2,1
26,197,197,20,20,0,1,0
2,204,204,31,22,9,2,1
21,204,204,6,6,0,1,0
11,206,206,1,1,0,1,0
19,228,228,9,1,8,2,1
32,244,244,77,46,31,2,1
17,255,255,1,1,0,1,0
12,259,259,1,1,0,1,0
33,278,278,2,2,0,1,0
13,280,280,32,32,0,1,0
28,283,283,10,10,0,1,0
20,297,297,8,8,0,1,0
15,299,299,17,8,9,4,3
31,320,320,11,3,8,2,1
16,322,322,14,14,0,1,0
0,350,350,16,16,0,1,0
5,352,352,20,20,0,1,0
14,356,356,29,15,14,3,2
9,360,360,18,18,0,1,0
27,363,363,2,2,0,1,0
18,376,376,49,49,0,1,0
1,385,385,19,19,0,1,0
3,393,393,5,5,0,1,0
30,415,415,17,4,13,2,1
8,453,453,1,1,0,1,0
4,464,464,32,32,0,1,0
24,470,470,25,9,16,3,2
7,492,492,46,2,44,3,2

18,101,101,15,3,12,2,1
17,150,150,3,3,0,1,0
2,159,159,2,2,0,1,0
0,159,159,2,2,0,1,0
9,169,169,4,4,0,1,0
25,172,172,5,5,0,1,0
24,172,172,16,16,0,1,0
23,183,183,24,24,0,1,0
6,220,220,32,12,20,2,1
19,235,235,10,10,0,1,0
4,278,278,21,4,17,2,1
11,289,289,36,6,30,4,3
16,312,312,1,1,0,1,0
20,313,313,2,2,0,1,0
5,342,342,57,3,54,4,3
1,368,368,63,35,28,3,2
3,398,398,39,39,0,1,0
22,419,419,75,75,0,1,0
15,435,435,82,26,56,3,2
13,436,436,4,4,0,1,0
8,454,454,18,3,15,4,3
14,462,462,158,17,141,4,3
10,465,465,127,59,68,3,2
21,468,468,30,30,0,1,0
7,477,477,124,124,0,1,0
12,480,480,82,82,0,1,0

28,106,106,6,6,0,1,0
1,155,155,13,13,0,1,0
9,177,177,17,8,9,4,3
25,178,178,5,5,0,1,0
5,182,182,6,6,0,1,0
11,182,182,15,1,14,3,2
3,245,245,65,65,0,1,0
13,246,246,10,7,3,2,1
19,265,265,30,3,27,4,3
6,288,288,37,28,9,4,3
12,301,301,5,5,0,1,0
18,324,324,74,74,0,1,0
27,335,335,47,35,12,2,1
21,341,341,11,6,5,2,1
14,344,344,51,33,18,2,1
7,350,350,13,13,0,1,0
30,351,351,42,42,0,1,0
16,375,375,67,43,24,3,2
10,377,377,11,11,0,1,0
2,399,399,17,8,9,4,3
24,405,405,18,2,16,4,3
17,406,406,1,1,0,1,0
0,411,411,1,1,0,1,0
15,436,436,57,24,33,2,1
29,440,440,24,11,13,2,1
8,441,441,32,4,28,3,2
23,449,449,16,8,8,2,1
4,466,466,6,6,0,1,0
22,474,474,18,18,0,1,0
26,476,476,154,14,140,4,3
20,497,497,104,104,0,1,0

7,121,121,11,11,0,1,0
5,145,145,4,4,0,1,0
11,163,163,14,2,12,3,2
21,165,165,8,1,7,2,1
8,197,197,16,13,3,2,1
23,220,220,21,21,0,1,0
17,228,228,15,15,0,1,0
13,238,238,8,8,0,1,0
18,263,263,27,16,11,2,1
9,279,279,10,10,0,1,0
16,282,282,68,39,29,2,1
19,314,314,40,40,0,1,0
6,314,314,35,35,0,1,0
14,316,316,27,27,0,1,0
1,332,332,23,19,4,2,1
0,351,351,71,53,18,4,3
15,353,353,106,37,69,3,2
10,364,364,9,9,0,1,0
22,380,380,11,11,0,1,0
3,384,384,68,12,56,3,2
4,428,428,60,22,38,3,2
12,444,444,32,8,24,2,1
2,482,482,225,75,150,4,3
20,484,484,56,56,0,1,0

5,101,101,16,16,0,1,0
20,102,102,1,1,0,1,0
14,105,105,1,1,0,1,0
23,117,117,33,33,0,1,0
7,138,138,14,4,10,2,1
8,147,147,5,5,0,1,0
33,155,155,23,17,6,3,2
31,157,157,4,4,0,1,0
4,191,191,9,3,6,3,2
27,192,192,11,6,5,2,1
28,202,202,14,14,0,1,0
12,231,231,3,3,0,1,0
0,231,231,6,6,0,1,0
22,238,238,7,7,0,1,0
32,261,261,47,31,16,2,1
26,287,287,3,3,0,1,0
17,302,302,18,6,12,3,2
19,303,303,2,2,0,1,0
13,305,305,27,27,0,1,0
11,308,308,15,15,0,1,0
21,320,320,71,71,0,1,0
6,322,322,16,6,10,2,1
36,325,325,14,2,12,3,2
29,342,342,8,4,4,2,1
9,348,348,1,1,0,1,0
16,350,350,15,15,0,1,0
3,354,354,13,13,0,1,0
18,361,361,14,14,0,1,0
24,362,362,17,5,12,4,3
10,366,366,44,32,12,4,3
34,397,397,46,46,0,1,0
30,409,409,34,34,0,1,0
15,413,413,42,11,31,2,1
35,440,440,126,126,0,1,0
2,444,444,45,29,16,3,2
1,480,480,25,5,20,2,1
25,490,490,26,14,12,3,2

18,107,107,6,6,0,1,0
24,134,134,5,5,0,1,0
9,153,153,8,8,0,1,0
15,166,166,49,35,14,2,1
20,196,196,11,11,0,1,0
6,208,208,1,1,0,1,0
13,252,252,33,9,24,4,3
1,269,269,1,1,0,1,0
17,269,269,6,2,4,2,1
22,271,271,13,13,0,1,0
2,277,277,29,29,0,1,0
8,277,277,20,16,4,2,1
3,282,282,23,8,15,2,1
19,290,290,6,6,0,1,0
27,293,293,15,15,0,1,0
31,297,297,3,3,0,1,0
16,304,304,2,2,0,1,0
25,336,336,73,73,0,1,0
11,352,352,10,10,0,1,0
14,353,353,31,15,16,2,1
29,353,353,16,16,0,1,0
34,356,356,61,61,0,1,0
30,363,363,24,24,0,1,0
7,378,378,65,65,0,1,0
4,388,388,3,3,0,1,0
28,389,389,20,20,0,1,0
33,399,399,10,2,8,3,2
12,420,420,6,6,0,1,0
32,461,461,124,47,77,4,3
0,469,469,67,67,0,1,0
23,481,481,41,41,0,1,0
21,491,491,54,36,18,3,2
26,492,492,116,40,76,3,2
10,496,496,11,1,10,3,2
5,498,498,11,2,9,4,3

10,103,103,8,4,4,2,1
18,105,105,2,2,0,1,0
9,116,116,3,3,0,1,0
24,122,122,25,10,15,2,1
32,167,167,7,7,0,1,0
15,204,204,2,2,0,1,0
13,221,221,3,3,0,1,0
4,223,223,26,26,0,1,0
27,233,233,20,17,3,2,1
2,262,262,13,13,0,1,0
25,263,263,15,9,6,3,2
6,268,268,19,19,0,1,0
23,275,275,68,47,21,4,3
14,288,288,3,3,0,1,0
12,301,301,29,29,0,1,0
30,302,302,1,1,0,1,0
11,317,317,1,1,0,1,0
29,320,320,7,4,3,2,1
3,323,323,12,12,0,1,0
7,327,327,26,6,20,2,1
0,333,333,27,10,17,2,1
8,344,344,16,8,8,2,1
34,345,345,8,1,7,2,1
26,365,365,14,14,0,1,0
20,376,376,15,7,8,2,1
19,395,395,37,37,0,1,0
1,397,397,35,35,0,1,0
16,412,412,132,105,27,4,3
33,424,424,1,1,0,1,0
5,430,430,18,2,16,2,1
31,445,445,88,88,0,1,0
22,459,459,44,20,24,3,2
21,466,466,89,89,0,1,0
17,475,475,38,38,0,1,0
28,495,495,108,108,0,1,0

2,109,109,18,18,0,1,0
5,110,110,25,25,0,1,0
30,120,120,12,12,0,1,0
18,121,121,1,1,0,1,0
11,126,126,1,1,0,1,0
29,131,131,16,3,13,3,2
1,136,136,1,1,0,1,0
32,142,142,10,2,8,2,1
0,142,142,2,2,0,1,0
24,152,152,13,2,11,2,1
15,167,167,7,1,6,2,1
25,177,177,52,52,0,1,0
3,179,179,4,1,3,2,1
17,193,193,2,2,0,1,0
14,201,201,18,18,0,1,0
23,208,208,13,13,0,1,0
7,220,220,15,15,0,1,0
31,235,235,3,3,0,1,0
9,244,244,58,27,31,2,1
13,265,265,5,5,0,1,0
8,271,271,40,40,0,1,0
26,276,276,19,19,0,1,0
10,277,277,16,10,6,2,1
6,283,283,8,8,0,1,0
16,318,318,22,8,14,4,3
19,328,328,45,12,33,4,3
28,343,343,31,20,11,2,1
22,361,361,10,6,4,2,1
21,386,386,3,3,0,1,0
20,403,403,53,10,43,3,2
4,418,418,47,47,0,1,0
27,465,465,103,15,88,4,3
12,493,493,34,34,0,1,0

6,101,101,8,2,6,2,1
3,111,111,46,46,0,1,0
25,115,115,9,3,6,3,2
0,134,134,13,4,9,4,3
12,134,134,11,11,0,1,0
1,190,190,12,12,0,1,0
19,206,206,22,22,0,1,0
18,211,211,1,1,0,1,0
23,214,214,2,2,0,1,0
22,215,215,79,43,36,4,3
10,216,216,35,31,4,2,1
9,221,221,8,8,0,1,0
14,227,227,11,11,0,1,0
17,239,239,48,48,0,1,0
13,247,247,35,1,34,3,2
20,267,267,11,11,0,1,0
4,296,296,9,2,7,2,1
11,326,326,19,19,0,1,0
24,329,329,81,81,0,1,0
16,363,363,34,24,10,2,1
5,368,368,60,60,0,1,0
15,413,413,15,15,0,1,0
21,424,424,21,4,17,4,3
26,431,431,2,2,0,1,0
2,433,433,22,13,9,4,3
8,452,452,7,7,0,1,0
7,459,459,70,28,42,2,1

8,116,116,17,17,0,1,0
1,122,122,6,3,3,2,1
23,142,142,6,6,0,1,0
6,142,142,2,2,0,1,0
19,143,143,18,8,10,2,1
24,196,196,91,13,78,4,3
4,209,209,42,42,0,1,0
29,219,219,8,8,0,1,0
22,219,219,14,7,7,2,1
25,227,227,6,6,0,1,0
11,239,239,28,18,10,3,2
16,244,244,3,3,0,1,0
5,256,256,44,44,0,1,0
27,268,268,20,20,0,1,0
13,280,280,2,2,0,1,0
12,314,314,68,68,0,1,0
15,327,327,7,2,5,2,1
21,332,332,12,12,0,1,0
9,357,357,49,49,0,1,0
28,364,364,4,4,0,1,0
31,385,385,11,2,9,4,3
17,397,397,13,13,0,1,0
10,413,413,56,56,0,1,0
0,417,417,9,9,0,1,0
2,423,423,3,3,0,1,0
26,424,424,63,63,0,1,0
7,457,457,17,17,0,1,0
20,460,460,124,13,111,4,3
30,473,473,38,38,0,1,0
14,481,481,7,7,0,1,0
3,491,491,29,29,0,1,0
18,497,497,10,4,6,3,2

4,109,109,4,1,3,2,1
6,118,118,1,1,0,1,0
19,125,125,1,1,0,1,0
7,133,133,2,2,0,1,0
26,151,151,8,3,5,2,1
15,156,156,3,3,0,1,0
3,188,188,1,1,0,1,0
2,209,209,22,12,10,2,1
22,216,216,8,8,0,1,0
0,219,219,79,79,0,1,0
14,225,225,16,4,12,4,3
29,230,230,36,12,24,4,3
27,250,250,4,4,0,1,0
28,251,251,15,9,6,3,2
20,259,259,24,19,5,2,1
16,284,284,111,75,36,2,1
24,287,287,7,7,0,1,0
23,304,304,38,38,0,1,0
18,320,320,5,5,0,1,0
8,342,342,56,26,30,2,1
11,346,346,4,1,3,2,1
1,389,389,10,2,8,3,2
9,396,396,28,18,10,2,1
25,419,419,3,3,0,1,0
5,420,420,100,34,66,4,3
21,432,432,86,65,21,4,3
10,453,453,44,15,29,3,2
12,457,457,63,63,0,1,0
13,474,474,16,16,0,1,0
17,491,491,122,122,0,1,0

26,119,119,7,7,0,1,0
4,129,129,3,3,0,1,0
25,137,137,19,19,0,1,0
13,145,145,22,22,0,1,0
3,145,145,1,1,0,1,0
1,151,151,9,6,3,2,1
17,152,152,6,1,5,2,1
11,173,173,3,3,0,1,0
16,174,174,6,2,4,2,1
7,189,189,34,28,6,2,1
24,203,203,6,6,0,1,0
2,210,210,24,10,14,3,2
5,213,213,25,25,0,1,0
15,221,221,22,22,0,1,0
18,240,240,25,7,18,2,1
9,288,288,3,3,0,1,0
8,319,319,1,1,0,1,0
14,353,353,26,26,0,1,0
23,373,373,13,13,0,1,0
30,390,390,90,48,42,3,2
20,391,391,9,9,0,1,0
31,394,394,47,21,26,3,2
28,395,395,115,35,80,3,2
0,416,416,87,87,0,1,0
6,416,416,30,30,0,1,0
27,442,442,15,6,9,2,1
29,458,458,103,103,0,1,0
19,470,470,3,3,0,1,0
21,479,479,47,39,8,2,1
22,481,481,13,1,12,4,3
12,482,482,91,91,0,1,0
10,493,493,1,1,0,1,0

20,112,112,8,5,3,2,1
19,116,116,31,31,0,1,0
14,116,116,15,15,0,1,0
26,119,119,18,8,10,2,1
7,132,132,26,26,0,1,0
4,138,138,35,35,0,1,0
13,138,138,1,1,0,1,0
21,144,144,6,6,0,1,0
16,169,169,40,14,26,4,3
23,173,173,2,2,0,1,0
1,173,173,2,2,0,1,0
15,212,212,2,2,0,1,0
5,243,243,7,7,0,1,0
2,243,243,14,9,5,2,1
25,250,250,43,43,0,1,0
17,255,255,2,2,0,1,0
18,266,266,7,7,0,1,0
12,309,309,27,16,11,2,1
9,313,313,6,6,0,1,0
8,323,323,15,6,9,2,1
10,368,368,14,6,8,3,2
27,373,373,79,79,0,1,0
0,389,389,170,138,32,3,2
24,389,389,52,4,48,3,2
28,433,433,20,20,0,1,0
6,448,448,9,9,0,1,0
3,454,454,23,23,0,1,0
11,468,468,9,3,6,2,1
22,483,483,20,1,19,2,1

1,110,110,15,5,10,2,1
19,116,116,2,2,0,1,0
26,135,135,2,2,0,1,0
21,155,155,4,4,0,1,0
20,169,169,2,2,0,1,0
24,172,172,14,4,10,3,2
14,184,184,43,43,0,1,0
18,229,229,50,18,32,3,2
17,246,246,2,2,0,1,0
2,258,258,26,26,0,1,0
7,265,265,26,5,21,2,1
10,272,272,6,6,0,1,0
16,289,289,159,109,50,4,3
13,304,304,14,14,0,1,0
23,318,318,15,3,12,2,1
15,358,358,10,10,0,1,0
5,360,360,2,2,0,1,0
0,363,363,115,41,74,3,2
4,364,364,30,30,0,1,0
22,396,396,40,40,0,1,0
11,411,411,54,54,0,1,0
9,437,437,63,19,44,2,1
12,469,469,15,15,0,1,0
3,476,476,12,12,0,1,0
28,482,482,3,3,0,1,0
8,484,484,2,2,0,1,0
25,495,495,131,120,11,2,1
27,497,497,26,16,10,2,1
6,499,499,13,13,0,1,0

5,103,103,1,1,0,1,0
22,126,126,13,13,0,1,0
13,135,135,15,1,14,3,2
11,146,146,8,8,0,1,0
14,152,152,7,7,0,1,0
20,174,174,2,2,0,1,0
9,210,210,65,65,0,1,0
12,251,251,29,20,9,2,1
17,282,282,30,3,27,3,2
7,296,296,82,82,0,1,0
6,315,315,156,96,60,3,2
25,315,315,109,85,24,4,3
21,332,332,4,4,0,1,0
23,333,333,6,6,0,1,0
19,352,352,1,1,0,1,0
24,354,354,106,70,36,3,2
16,369,369,32,18,14,2,1
1,373,373,7,7,0,1,0
4,375,375,9,9,0,1,0
18,382,382,48,48,0,1,0
3,400,400,2,2,0,1,0
0,424,424,3,3,0,1,0
2,435,435,1,1,0,1,0
10,437,437,63,52,11,2,1
15,441,441,20,6,14,3,2
8,470,470,27,27,0,1,0

4,118,118,1,1,0,1,0
10,143,143,37,6,31,4,3
0,147,147,13,13,0,1,0
19,176,176,5,2,3,2,1
5,201,201,1,1,0,1,0
27,208,208,16,2,14,3,2
18,215,215,13,13,0,1,0
28,236,236,55,55,0,1,0
2,242,242,4,4,0,1,0
15,244,244,34,34,0,1,0
26,261,261,28,5,23,2,1
1,285,285,58,58,0,1,0
6,285,285,3,3,0,1,0
23,327,327,68,47,21,4,3
24,330,330,52,52,0,1,0
25,345,345,4,4,0,1,0
12,348,348,5,5,0,1,0
8,362,362,35,35,0,1,0
14,373,373,24,24,0,1,0
11,373,373,37,4,33,4,3
16,382,382,50,31,19,4,3
17,389,389,15,15,0,1,0
7,444,444,162,162,0,1,0
20,453,453,37,30,7,2,1
21,462,462,34,7,27,4,3
22,467,467,36,36,0,1,0
3,473,473,12,4,8,2,1
9,486,486,6,6,0,1,0
13,493,493,65,21,44,3,2

9,126,126,1,1,0,1,0
25,130,130,5,1,4,2,1
16,136,136,1,1,0,1,0
10,140,140,7,3,4,2,1
0,167,167,18,5,13,2,1
19,185,185,2,2,0,1,0
14,186,186,1,1,0,1,0
11,193,193,9,9,0,1,0
8,197,197,1,1,0,1,0
6,205,205,87,3,84,4,3
15,233,233,15,1,14,4,3
2,249,249,38,4,34,2,1
24,280,280,75,75,0,1,0
26,300,300,22,22,0,1,0
13,313,313,11,5,6,3,2
17,320,320,48,48,0,1,0
28,334,334,11,11,0,1,0
29,343,343,26,2,24,3,2
18,349,349,24,3,21,2,1
31,375,375,58,1,57,4,3
20,379,379,96,30,66,4,3
23,380,380,10,10,0,1,0
1,391,391,33,9,24,4,3
22,415,415,37,37,0,1,0
5,418,418,16,4,12,3,2
30,443,443,10,4,6,2,1
21,448,448,135,12,123,4,3
7,451,451,38,38,0,1,0
27,464,464,5,2,3,2,1
3,478,478,19,19,0,1,0
12,485,485,29,26,3,2,1
4,491,491,19,19,0,1,0

20,107,107,1,1,0,1,0
27,126,126,15,15,0,1,0
18,131,131,18,6,12,4,3
4,154,154,1,1,0,1,0
7,170,170,1,1,0,1,0
15,171,171,1,1,0,1,0
1,220,220,10,10,0,1,0
0,221,221,28,2,26,3,2
17,233,233,10,10,0,1,0
9,252,252,1,1,0,1,0
12,256,256,5,2,3,2,1
29,262,262,2,2,0,1,0
6,272,272,33,21,12,2,1
28,285,285,7,1,6,3,2
16,296,296,45,9,36,3,2
5,316,316,56,44,12,2,1
8,322,322,46,46,0,1,0
2,353,353,44,44,0,1,0
24,362,362,76,76,0,1,0
21,381,381,6,6,0,1,0
26,390,390,28,28,0,1,0
10,397,397,18,18,0,1,0
19,401,401,167,131,36,4,3
25,419,419,58,10,48,2,1
13,447,447,106,66,40,3,2
30,448,448,15,4,11,2,1
14,450,450,15,1,14,2,1
3,455,455,12,2,10,3,2
23,457,457,8,2,6,3,2
11,473,473,60,42,18,4,3
22,489,489,94,94,0,1,0

7,100,100,7,7,0,1,0
14,106,106,13,4,9,2,1
16,131,131,9,6,3,2,1
19,167,167,6,6,0,1,0
17,184,184,10,2,8,2,1
10,191,191,2,2,0,1,0
1,193,193,60,60,0,1,0
11,209,209,21,12,9,2,1
4,222,222,4,4,0,1,0
24,238,238,18,13,5,2,1
13,290,290,65,38,27,4,3
3,295,295,6,3,3,2,1
25,320,320,15,1,14,3,2
20,357,357,6,6,0,1,0
8,408,408,33,33,0,1,0
23,413,413,41,21,20,3,2
18,422,422,140,140,0,1,0
22,424,424,42,42,0,1,0
21,430,430,10,5,5,2,1
15,436,436,88,84,4,2,1
12,438,438,13,1,12,4,3
0,470,470,2,2,0,1,0
5,481,481,272,272,0,1,0
9,490,490,58,58,0,1,0
2,493,493,36,36,0,1,0
6,497,497,15,15,0,1,0

8,103,103,2,2,0,1,0
21,120,120,4,1,3,2,1
0,122,122,9,9,0,1,0
1,135,135,41,41,0,1,0
16,138,138,10,10,0,1,0
6,143,143,4,4,0,1,0
12,155,155,34,4,30,2,1
22,159,159,13,8,5,2,1
11,161,161,1,1,0,1,0
19,213,213,18,13,5,2,1
18,219,219,21,21,0,1,0
3,219,219,13,13,0,1,0
17,243,243,23,8,15,2,1
24,243,243,97,97,0,1,0
2,259,259,1,1,0,1,0
14,310,310,42,32,10,3,2
4,325,325,53,53,0,1,0
23,354,354,19,3,16,3,2
25,361,361,24,24,0,1,0
7,384,384,101,54,47,2,1
13,392,392,7,7,0,1,0
9,410,410,99,1,98,3,2
20,414,414,19,5,14,3,2
15,453,453,17,9,8,2,1
10,486,486,87,78,9,2,1
5,498,498,30,2,28,2,1

10,105,105,13,2,11,2,1
23,132,132,1,1,0,1,0
27,152,152,10,10,0,1,0
25,155,155,36,36,0,1,0
18,181,181,18,18,0,1,0
7,211,211,11,11,0,1,0
1,214,214,17,17,0,1,0
21,215,215,8,4,4,2,1
2,217,217,20,13,7,2,1
3,259,259,28,28,0,1,0
11,259,259,1,1,0,1,0
19,259,259,22,22,0,1,0
4,283,283,10,1,9,4,3
6,283,283,23,23,0,1,0
29,290,290,8,8,0,1,0
28,298,298,44,28,16,2,1
17,300,300,71,51,20,2,1
8,310,310,3,3,0,1,0
5,315,315,36,14,22,2,1
13,341,341,1,1,0,1,0
26,360,360,22,4,18,4,3
15,393,393,36,36,0,1,0
22,463,463,13,13,0,1,0
24,465,465,43,25,18,4,3
9,466,466,180,180,0,1,0
16,469,469,47,47,0,1,0
0,473,473,59,11,48,4,3
20,481,481,97,97,0,1,0
12,482,482,27,4,23,2,1
14,489,489,20,8,12,3,2

23,132,132,53,14,39,2,1
0,150,150,2,2,0,1,0
2,152,152,32,5,27,4,3
18,153,153,27,23,4,2,1
5,165,165,10,10,0,1,0
16,177,177,24,24,0,1,0
30,181,181,2,2,0,1,0
22,192,192,29,29,0,1,0
9,200,200,9,3,6,3,2
12,205,205,1,1,0,1,0
19,244,244,12,6,6,3,2
29,252,252,25,25,0,1,0
17,266,266,24,3,21,2,1
26,283,283,63,54,9,4,3
7,285,285,48,22,26,3,2
14,288,288,25,7,18,2,1
28,289,289,14,14,0,1,0
21,302,302,7,7,0,1,0
13,311,311,54,18,36,4,3
1,325,325,1,1,0,1,0
24,343,343,30,16,14,2,1
8,353,353,14,14,0,1,0
3,379,379,4,1,3,2,1
27,387,387,8,8,0,1,0
6,396,396,74,12,62,3,2
4,399,399,71,71,0,1,0
11,421,421,2,2,0,1,0
25,438,438,14,4,10,3,2
10,456,456,4,4,0,1,0
15,460,460,34,34,0,1,0
20,487,487,10,10,0,1,0

25,119,119,22,22,0,1,0
12,127,127,1,1,0,1,0
4,129,129,1,1,0,1,0
20,134,134,3,3,0,1,0
16,153,153,4,1,3,2,1
14,165,165,27,12,15,4,3
19,183,183,12,2,10,2,1
18,216,216,10,5,5,2,1
6,236,236,10,3,7,2,1
22,240,240,22,22,0,1,0
29,249,249,33,11,22,2,1
23,275,275,35,17,18,3,2
8,285,285,8,8,0,1,0
1,294,294,69,35,34,4,3
24,310,310,6,6,0,1,0
10,335,335,45,8,37,3,2
26,340,340,11,2,9,2,1
3,354,354,85,47,38,2,1
15,369,369,13,13,0,1,0
9,418,418,15,15,0,1,0
2,421,421,74,74,0,1,0
7,442,442,71,50,21,2,1
21,442,442,11,11,0,1,0
27,442,442,36,36,0,1,0
17,443,443,178,163,15,3,2
5,443,443,5,5,0,1,0
11,457,457,38,16,22,3,2
13,481,481,10,10,0,1,0
0,496,496,10,10,0,1,0
28,499,499,87,37,50,4,3

10,106,106,1,1,0,1,0
17,127,127,35,35,0,1,0
9,136,136,1,1,0,1,0
6,150,150,2,2,0,1,0
0,171,171,25,13,12,4,3
21,175,175,5,5,0,1,0
20,189,189,23,23,0,1,0
26,204,204,33,33,0,1,0
2,219,219,5,5,0,1,0
22,239,239,64,13,51,4,3
7,239,239,44,23,21,4,3
24,268,268,16,16,0,1,0
13,294,294,7,2,5,2,1
5,312,312,1,1,0,1,0
3,334,334,102,78,24,4,3
4,350,350,11,11,0,1,0
15,356,356,35,35,0,1,0
19,384,384,54,45,9,2,1
1,387,387,69,2,67,4,3
16,416,416,10,10,0,1,0
18,416,416,16,4,12,4,3
23,433,433,32,6,26,2,1
11,466,466,3,3,0,1,0
25,471,471,26,5,21,4,3
8,472,472,12,2,10,3,2
12,476,476,223,134,89,4,3
14,483,483,27,27,0,1,0

6,122,122,1,1,0,1,0
23,122,122,7,7,0,1,0
1,145,145,16,4,12,2,1
10,153,153,12,5,7,2,1
5,184,184,32,32,0,1,0
15,196,196,8,4,4,2,1
12,213,213,11,11,0,1,0
22,215,215,20,9,11,4,3
17,217,217,17,17,0,1,0
18,239,239,21,2,19,2,1
7,239,239,53,31,22,2,1
9,307,307,5,5,0,1,0
11,319,319,28,28,0,1,0
21,327,327,98,61,37,3,2
3,333,333,30,6,24,2,1
8,345,345,8,1,7,2,1
27,352,352,47,3,44,3,2
2,364,364,23,2,21,4,3
16,374,374,46,13,33,4,3
25,391,391,11,11,0,1,0
26,392,392,7,7,0,1,0
14,396,396,45,37,8,2,1
24,408,408,26,26,0,1,0
20,423,423,53,53,0,1,0
0,435,435,64,34,30,2,1
13,466,466,90,76,14,2,1
19,475,475,81,43,38,3,2
4,494,494,67,67,0,1,0

9,105,105,23,23,0,1,0
24,113,113,5,5,0,1,0
34,173,173,4,4,0,1,0
18,188,188,1,1,0,1,0
12,201,201,4,4,0,1,0
35,204,204,22,22,0,1,0
30,206,206,1,1,0,1,0
1,231,231,10,2,8,2,1
2,250,250,8,8,0,1,0
23,259,259,40,15,25,2,1
32,273,273,2,2,0,1,0
20,278,278,7,7,0,1,0
21,285,285,4,4,0,1,0
22,296,296,20,20,0,1,0
6,300,300,29,29,0,1,0
31,312,312,32,32,0,1,0
0,317,317,8,8,0,1,0
28,318,318,41,35,6,2,1
5,326,326,73,43,30,3,2
3,358,358,5,5,0,1,0
15,374,374,2,2,0,1,0
14,387,387,23,23,0,1,0
36,395,395,3,3,0,1,0
11,398,398,9,9,0,1,0
19,399,399,13,4,9,4,3
29,405,405,23,23,0,1,0
26,407,407,4,4,0,1,0
17,430,430,4,4,0,1,0
33,440,440,233,233,0,1,0
27,443,443,22,22,0,1,0
4,452,452,3,3,0,1,0
25,468,468,95,41,54,4,3
10,472,472,13,2,11,2,1
13,473,473,41,21,20,2,1
8,482,482,63,38,25,2,1
16,484,484,110,61,49,4,3
7,486,486,4,4,0,1,0

3,130,130,11,4,7,2,1
25,188,188,10,10,0,1,0
0,195,195,51,51,0,1,0
15,209,209,24,16,8,2,1
20,210,210,5,5,0,1,0
21,288,288,69,27,42,3,2
9,289,289,31,31,0,1,0
14,291,291,43,4,39,4,3
6,298,298,26,16,10,2,1
11,307,307,5,5,0,1,0
7,311,311,2,2,0,1,0
10,339,339,20,1,19,2,1
2,355,355,42,42,0,1,0
22,357,357,5,5,0,1,0
17,367,367,7,7,0,1,0
5,373,373,75,30,45,4,3
16,400,400,44,44,0,1,0
24,409,409,59,59,0,1,0
13,410,410,19,4,15,2,1
12,431,431,48,48,0,1,0
1,433,433,62,50,12,3,2
19,436,436,120,120,0,1,0
8,462,462,90,22,68,3,2
18,493,493,41,41,0,1,0
4,495,495,61,41,20,3,2
23,498,498,21,21,0,1,0

17,131,131,2,2,0,1,0
0,135,135,5,5,0,1,0
10,151,151,14,14,0,1,0
11,193,193,28,21,7,2,1
12,210,210,9,9,0,1,0
23,246,246,8,2,6,2,1
26,248,248,6,6,0,1,0
16,256,256,18,18,0,1,0
5,297,297,14,6,8,3,2
19,316,316,11,4,7,2,1
9,316,316,69,41,28,3,2
6,324,324,51,51,0,1,0
1,333,333,48,27,21,2,1
18,344,344,168,66,102,4,3
27,344,344,28,8,20,3,2
15,355,355,40,36,4,2,1
2,363,363,5,2,3,2,1
21,374,374,37,37,0,1,0
20,389,389,10,6,4,2,1
4,390,390,10,10,0,1,0
8,411,411,36,4,32,2,1
7,422,422,69,49,20,2,1
25,427,427,7,7,0,1,0
28,455,455,24,21,3,2,1
14,456,456,42,42,0,1,0
3,461,461,23,23,0,1,0
24,462,462,23,7,16,2,1
22,473,473,150,53,97,4,3
13,499,499,42,42,0,1,0

22,117,117,5,5,0,1,0
2,129,129,6,2,4,2,1
33,132,132,10,10,0,1,0
14,143,143,2,2,0,1,0
23,143,143,4,4,0,1,0
20,145,145,2,2,0,1,0
30,156,156,29,2,27,4,3
6,182,182,16,2,14,2,1
15,182,182,8,8,0,1,0
24,187,187,16,1,15,2,1
18,199,199,69,49,20,2,1
4,210,210,21,18,3,2,1
27,256,256,9,4,5,2,1
17,276,276,1,1,0,1,0
21,290,290,15,10,5,2,1
29,307,307,28,9,19,2,1
3,308,308,8,4,4,2,1
12,314,314,22,22,0,1,0
32,318,318,28,28,0,1,0
5,323,323,36,36,0,1,0
26,331,331,40,40,0,1,0
7,355,355,9,9,0,1,0
13,357,357,7,7,0,1,0
8,371,371,21,14,7,2,1
19,380,380,12,5,7,2,1
31,383,383,131,89,42,4,3
1,403,403,35,35,0,1,0
28,414,414,94,48,46,3,2
0,426,426,41,41,0,1,0
10,433,433,54,6,48,3,2
16,462,462,27,27,0,1,0
11,478,478,2,2,0,1,0
25,483,483,21,21,0,1,0
9,493,493,24,24,0,1,0

4,117,117,2,2,0,1,0
11,123,123,19,19,0,1,0
22,137,137,3,3,0,1,0
8,176,176,14,4,10,2,1
19,177,177,1,1,0,1,0
0,217,217,27,3,24,3,2
1,232,232,9,3,6,2,1
24,236,236,24,12,12,3,2
20,238,238,3,3,0,1,0
18,242,242,5,5,0,1,0
5,246,246,1,1,0,1,0
2,247,247,19,19,0,1,0
12,253,253,79,71,8,2,1
15,287,287,51,33,18,4,3
6,330,330,18,18,0,1,0
13,354,354,58,58,0,1,0
3,363,363,24,24,0,1,0
9,375,375,116,103,13,2,1
10,377,377,46,6,40,3,2
14,388,388,12,7,5,2,1
16,433,433,7,4,3,2,1
17,433,433,46,5,41,2,1
23,443,443,33,33,0,1,0
25,462,462,145,49,96,4,3
7,467,467,166,126,40,2,1
21,467,467,31,21,10,3,2

15,113,113,16,8,8,2,1
5,134,134,4,4,0,1,0
26,167,167,4,4,0,1,0
17,175,175,26,4,22,2,1
24,187,187,26,16,10,3,2
10,192,192,10,10,0,1,0
0,217,217,53,21,32,3,2
13,221,221,19,10,9,4,3
2,222,222,15,2,13,2,1
16,222,222,20,4,16,3,2
7,254,254,20,20,0,1,0
3,254,254,2,2,0,1,0
1,272,272,6,6,0,1,0
12,284,284,54,33,21,2,1
11,302,302,66,66,0,1,0
21,308,308,4,4,0,1,0
25,312,312,59,21,38,3,2
28,315,315,11,11,0,1,0
9,321,321,64,24,40,2,1
19,344,344,4,4,0,1,0
18,363,363,30,30,0,1,0
6,366,366,35,11,24,2,1
4,377,377,16,16,0,1,0
20,388,388,33,33,0,1,0
27,399,399,65,65,0,1,0
8,401,401,5,2,3,2,1
14,403,403,22,18,4,2,1
22,410,410,9,1,8,2,1
23,422,422,121,39,82,3,2

9,104,104,4,1,3,2,1
8,119,119,22,22,0,1,0
14,134,134,22,22,0,1,0
23,136,136,7,2,5,2,1
15,138,138,10,10,0,1,0
3,141,141,8,8,0,1,0
6,194,194,24,24,0,1,0
17,210,210,38,38,0,1,0
19,219,219,3,3,0,1,0
25,256,256,7,4,3,2,1
12,256,256,28,16,12,2,1
11,272,272,18,18,0,1,0
4,287,287,3,3,0,1,0
24,297,297,35,35,0,1,0
1,317,317,38,38,0,1,0
20,325,325,53,50,3,2,1
13,362,362,3,3,0,1,0
5,370,370,79,79,0,1,0
22,374,374,36,36,0,1,0
26,390,390,67,37,30,4,3
21,392,392,45,26,19,2,1
18,395,395,72,18,54,3,2
16,410,410,28,28,0,1,0
2,418,418,15,3,12,3,2
10,443,443,11,11,0,1,0
7,464,464,164,164,0,1,0
0,496,496,33,33,0,1,0

13,101,101,2,2,0,1,0
9,108,108,4,4,0,1,0
7,109,109,1,1,0,1,0
17,111,111,8,8,0,1,0
6,144,144,36,36,0,1,0
1,159,159,12,12,0,1,0
14,172,172,70,70,0,1,0
19,178,178,10,10,0,1,0
4,189,189,16,10,6,3,2
16,229,229,7,7,0,1,0
12,269,269,36,24,12,2,1
10,289,289,55,13,42,4,3
11,350,350,15,2,13,3,2
3,350,350,95,56,39,3,2
15,350,350,42,42,0,1,0
2,363,363,171,124,47,2,1
8,378,378,11,6,5,2,1
18,380,380,24,10,14,3,2
23,432,432,39,1,38,3,2
20,439,439,79,6,73,4,3
21,451,451,8,1,7,2,1
5,469,469,29,29,0,1,0
0,488,488,57,31,26,2,1
22,499,499,2,2,0,1,0

18,125,125,9,9,0,1,0
19,141,141,25,22,3,2,1
1,163,163,24,24,0,1,0
10,191,191,38,38,0,1,0
3,219,219,8,8,0,1,0
0,227,227,14,14,0,1,0
8,234,234,8,8,0,1,0
9,253,253,17,17,0,1,0
16,253,253,34,26,8,3,2
15,290,290,14,14,0,1,0
4,308,308,53,22,31,3,2
11,357,357,38,5,33,4,3
17,405,405,122,44,78,4,3
14,417,417,25,3,22,3,2
6,450,450,19,4,15,2,1
5,454,454,407,393,14,2,1
12,454,454,54,54,0,1,0
7,481,481,6,6,0,1,0
2,488,488,43,43,0,1,0
13,488,488,26,6,20,2,1

0,108,108,29,18,11,2,1
12,111,111,13,4,9,2,1
19,117,117,1,1,0,1,0
25,141,141,10,10,0,1,0
4,152,152,20,20,0,1,0
16,177,177,30,30,0,1,0
8,233,233,11,11,0,1,0
26,244,244,35,14,21,4,3
2,254,254,12,5,7,2,1
7,257,257,70,44,26,2,1
18,266,266,6,6,0,1,0
21,284,284,19,16,3,2,1
20,295,295,32,5,27,4,3
1,301,301,35,5,30,3,2
3,322,322,31,31,0,1,0
24,338,338,14,14,0,1,0
17,352,352,83,83,0,1,0
11,376,376,13,7,6,3,2
23,377,377,12,12,0,1,0
9,383,383,21,21,0,1,0
6,417,417,10,2,8,2,1
13,429,429,11,11,0,1,0
5,437,437,79,79,0,1,0
14,443,443,13,1,12,2,1
10,445,445,5,5,0,1,0
15,460,460,149,149,0,1,0
22,500,500,74,54,20,3,2

13,103,103,2,2,0,1,0
7,134,134,5,1,4,2,1
26,143,143,4,4,0,1,0
29,160,160,8,8,0,1,0
16,164,164,8,8,0,1,0
2,218,218,6,6,0,1,0
11,231,231,13,4,9,4,3
31,241,241,9,9,0,1,0
1,248,248,1,1,0,1,0
17,255,255,17,10,7,2,1
6,257,257,5,2,3,2,1
15,260,260,25,3,22,3,2
5,261,261,15,15,0,1,0
14,268,268,70,52,18,4,3
0,271,271,25,25,0,1,0
4,295,295,10,10,0,1,0
25,304,304,2,2,0,1,0
27,308,308,91,91,0,1,0
22,313,313,11,5,6,2,1
23,314,314,9,9,0,1,0
21,341,341,5,5,0,1,0
8,343,343,7,7,0,1,0
28,379,379,56,56,0,1,0
3,400,400,73,26,47,2,1
20,405,405,90,90,0,1,0
30,408,408,7,7,0,1,0
19,417,417,109,43,66,4,3
18,421,421,71,68,3,2,1
12,423,423,122,46,76,3,2
10,425,425,32,16,16,3,2
9,447,447,6,6,0,1,0
24,466,466,52,8,44,3,2

21,123,123,14,14,0,1,0
1,126,126,6,6,0,1,0
10,129,129,19,5,14,2,1
17,132,132,10,10,0,1,0
14,133,133,10,10,0,1,0
2,139,139,6,6,0,1,0
4,156,156,18,1,17,2,1
6,159,159,19,19,0,1,0
11,173,173,1,1,0,1,0
28,174,174,23,23,0,1,0
25,185,185,107,73,34,2,1
26,189,189,9,9,0,1,0
0,197,197,16,11,5,2,1
20,217,217,45,45,0,1,0
16,228,228,10,10,0,1,0
12,244,244,4,4,0,1,0
27,265,265,2,2,0,1,0
9,293,293,115,54,61,4,3
7,301,301,15,3,12,2,1
13,347,347,11,4,7,3,2
3,359,359,7,7,0,1,0
19,363,363,7,1,6,2,1
5,379,379,95,23,72,3,2
15,385,385,11,3,8,3,2
24,409,409,24,9,15,4,3
23,437,437,14,10,4,2,1
8,453,453,5,5,0,1,0
22,457,457,23,23,0,1,0
18,493,493,22,17,5,2,1

7,105,105,1,1,0,1,0
1,138,138,18,18,0,1,0
3,140,140,31,31,0,1,0
20,171,171,6,6,0,1,0
26,189,189,12,3,9,4,3
24,189,189,52,52,0,1,0
2,198,198,27,22,5,2,1
17,221,221,1,1,0,1,0
4,224,224,1,1,0,1,0
18,226,226,5,5,0,1,0
14,232,232,51,16,35,2,1
27,234,234,1,1,0,1,0
9,242,242,15,15,0,1,0
25,248,248,31,31,0,1,0
22,287,287,22,7,15,2,1
16,290,290,15,15,0,1,0
6,317,317,3,3,0,1,0
8,320,320,1,1,0,1,0
0,328,328,14,1,13,3,2
11,341,341,77,11,66,4,3
19,364,364,47,23,24,2,1
5,367,367,18,12,6,3,2
21,429,429,72,62,10,2,1
23,456,456,62,62,0,1,0
13,463,463,171,105,66,4,3
10,482,482,37,37,0,1,0
12,487,487,30,4,26,3,2
15,500,500,58,58,0,1,0

17,106,106,3,3,0,1,0
31,145,145,2,2,0,1,0
27,158,158,2,2,0,1,0
0,164,164,4,1,3,2,1
19,168,168,3,3,0,1,0
4,186,186,23,11,12,3,2
28,209,209,12,1,11,2,1
12,219,219,9,9,0,1,0
3,224,224,5,5,0,1,0
33,249,249,19,19,0,1,0
26,253,253,58,23,35,4,3
21,263,263,70,49,21,4,3
2,279,279,63,63,0,1,0
9,280,280,42,22,20,3,2
1,301,301,61,34,27,4,3
30,323,323,74,6,68,3,2
25,323,323,52,52,0,1,0
32,327,327,21,21,0,1,0
10,328,328,4,4,0,1,0
23,332,332,4,4,0,1,0
22,337,337,43,12,31,2,1
5,342,342,5,1,4,2,1
6,387,387,57,33,24,3,2
16,391,391,17,2,15,4,3
29,393,393,5,5,0,1,0
13,399,399,35,35,0,1,0
14,402,402,7,7,0,1,0
15,447,447,21,21,0,1,0
24,450,450,67,67,0,1,0
8,452,452,20,16,4,2,1
11,456,456,4,4,0,1,0
20,488,488,5,5,0,1,0
7,491,491,58,54,4,2,1
18,497,497,14,14,0,1,0

18,126,126,51,29,22,2,1
17,127,127,14,8,6,3,2
19,132,132,1,1,0,1,0
6,137,137,2,2,0,1,0
9,144,144,2,2,0,1,0
11,203,203,1,1,0,1,0
26,214,214,21,21,0,1,0
28,232,232,29,29,0,1,0
5,245,245,16,4,12,2,1
16,271,271,8,5,3,2,1
29,279,279,18,18,0,1,0
1,286,286,9,9,0,1,0
13,286,286,31,31,0,1,0
3,298,298,1,1,0,1,0
21,302,302,12,12,0,1,0
27,308,308,23,23,0,1,0
10,323,323,23,11,12,3,2
23,357,357,11,11,0,1,0
30,374,374,96,96,0,1,0
2,375,375,47,47,0,1,0
15,382,382,162,113,49,4,3
24,423,423,33,33,0,1,0
22,427,427,9,9,0,1,0
4,429,429,17,17,0,1,0
20,452,452,13,13,0,1,0
7,452,452,37,6,31,2,1
25,461,461,36,36,0,1,0
12,461,461,33,9,24,4,3
8,462,462,40,40,0,1,0
0,491,491,81,63,18,2,1
14,500,500,32,26,6,3,2

4,112,112,7,7,0,1,0
27,113,113,2,2,0,1,0
23,128,128,9,9,0,1,0
7,132,132,15,15,0,1,0
3,134,134,4,4,0,1,0
24,146,146,16,10,6,2,1
22,155,155,17,1,16,3,2
9,161,161,12,9,3,2,1
5,181,181,19,19,0,1,0
32,184,184,1,1,0,1,0
15,187,187,20,20,0,1,0
31,206,206,13,13,0,1,0
25,218,218,42,26,16,2,1
35,241,241,8,2,6,3,2
17,249,249,1,1,0,1,0
11,286,286,11,11,0,1,0
6,294,294,1,1,0,1,0
30,345,345,7,1,6,3,2
29,346,346,45,10,35,2,1
21,347,347,29,29,0,1,0
2,361,361,29,29,0,1,0
34,391,391,6,6,0,1,0
33,395,395,37,10,27,4,3
16,395,395,2,2,0,1,0
0,397,397,17,9,8,2,1
26,408,408,6,6,0,1,0
14,419,419,8,8,0,1,0
13,428,428,12,9,3,2,1
8,438,438,4,4,0,1,0
10,441,441,32,7,25,2,1
20,443,443,31,31,0,1,0
19,444,444,38,10,28,2,1
28,446,446,64,4,60,3,2
36,452,452,143,86,57,4,3
12,461,461,58,58,0,1,0
18,472,472,13,4,9,4,3
1,499,499,17,17,0,1,0
37,499,499,135,101,34,3,2

16,156,156,1,1,0,1,0
21,157,157,18,18,0,1,0
2,175,175,23,4,19,4,3
12,176,176,4,4,0,1,0
24,190,190,23,23,0,1,0
19,228,228,76,76,0,1,0
7,250,250,77,11,66,3,2
6,253,253,17,17,0,1,0
11,257,257,10,4,6,2,1
0,267,267,76,28,48,4,3
14,268,268,6,6,0,1,0
18,277,277,25,19,6,2,1
9,281,281,24,24,0,1,0
20,302,302,60,45,15,4,3
5,306,306,12,12,0,1,0
1,310,310,38,38,0,1,0
15,330,330,1,1,0,1,0
10,362,362,17,17,0,1,0
22,372,372,21,8,13,2,1
4,397,397,64,38,26,2,1
8,425,425,3,3,0,1,0
17,439,439,137,137,0,1,0
23,471,471,1,1,0,1,0
13,472,472,47,35,12,3,2
3,490,490,73,73,0,1,0

29,101,101,22,3,19,2,1
28,103,103,3,3,0,1,0
2,112,112,10,10,0,1,0
33,119,119,2,2,0,1,0
22,147,147,3,3,0,1,0
23,184,184,24,24,0,1,0
3,208,208,10,7,3,2,1
18,218,218,6,6,0,1,0
8,255,255,2,2,0,1,0
7,261,261,28,28,0,1,0
15,265,265,3,3,0,1,0
4,265,265,20,2,18,3,2
17,267,267,7,7,0,1,0
19,307,307,24,7,17,2,1
32,313,313,45,20,25,2,1
10,320,320,16,2,14,3,2
25,320,320,75,75,0,1,0
14,332,332,69,69,0,1,0
0,333,333,47,47,0,1,0
31,336,336,14,2,12,4,3
16,349,349,4,4,0,1,0
11,357,357,36,3,33,4,3
34,366,366,12,12,0,1,0
30,369,369,12,2,10,3,2
6,374,374,23,1,22,4,3
20,383,383,71,71,0,1,0
24,384,384,10,1,9,4,3
27,395,395,28,10,18,4,3
13,419,419,37,37,0,1,0
26,421,421,96,96,0,1,0
9,442,442,1,1,0,1,0
1,444,444,1,1,0,1,0
5,444,444,2,2,0,1,0
21,461,461,95,81,14,2,1
12,465,465,35,35,0,1,0

18,111,111,6,6,0,1,0
31,111,111,24,24,0,1,0
32,113,113,9,9,0,1,0
12,122,122,3,3,0,1,0
23,125,125,26,21,5,2,1
5,139,139,6,2,4,2,1
8,175,175,8,8,0,1,0
25,177,177,39,13,26,3,2
24,187,187,3,3,0,1,0
13,194,194,1,1,0,1,0
21,214,214,14,4,10,3,2
26,218,218,8,8,0,1,0
22,219,219,18,18,0,1,0
19,239,239,1,1,0,1,0
4,241,241,1,1,0,1,0
28,250,250,27,9,18,4,3
17,309,309,51,7,44,2,1
11,336,336,16,3,13,2,1
14,339,339,70,25,45,2,1
34,359,359,70,20,50,2,1
29,368,368,46,24,22,2,1
2,369,369,17,11,6,3,2
7,372,372,2,2,0,1,0
20,381,381,20,20,0,1,0
15,391,391,8,8,0,1,0
27,393,393,15,15,0,1,0
3,393,393,1,1,0,1,0
10,401,401,108,33,75,4,3
33,401,401,5,5,0,1,0
16,402,402,75,55,20,2,1
9,424,424,11,1,10,3,2
1,441,441,22,10,12,2,1
6,451,451,26,9,17,2,1
0,493,493,42,42,0,1,0
30,500,500,16,16,0,1,0

20,157,157,36,14,22,3,2
7,172,172,5,5,0,1,0
1,175,175,10,10,0,1,0
17,178,178,12,7,5,2,1
13,178,178,55,3,52,3,2
8,182,182,2,2,0,1,0
12,188,188,42,7,35,2,1
15,205,205,35,35,0,1,0
9,207,207,84,57,27,3,2
6,227,227,35,27,8,2,1
24,245,245,15,15,0,1,0
3,285,285,61,61,0,1,0
14,288,288,23,9,14,4,3
19,295,295,2,2,0,1,0
4,301,301,35,11,24,3,2
21,311,311,7,2,5,2,1
2,312,312,10,10,0,1,0
22,315,315,5,5,0,1,0
11,333,333,52,4,48,4,3
16,389,389,11,8,3,2,1
0,398,398,18,2,16,3,2
10,408,408,73,52,21,4,3
23,411,411,10,10,0,1,0
5,421,421,66,45,21,4,3
18,426,426,13,1,12,4,3

16,127,127,14,2,12,2,1
25,157,157,8,3,5,2,1
6,157,157,35,5,30,3,2
10,159,159,23,23,0,1,0
15,159,159,26,9,17,2,1
7,169,169,1,1,0,1,0
21,206,206,72,40,32,2,1
17,207,207,46,46,0,1,0
4,226,226,46,34,12,4,3
9,227,227,85,29,56,3,2
12,231,231,2,2,0,1,0
18,231,231,1,1,0,1,0
3,243,243,21,8,13,2,1
1,262,262,18,18,0,1,0
13,265,265,13,1,12,2,1
19,277,277,60,19,41,4,3
0,278,278,8,8,0,1,0
5,298,298,5,5,0,1,0
20,307,307,9,9,0,1,0
11,318,318,17,17,0,1,0
8,336,336,25,25,0,1,0
23,345,345,4,4,0,1,0
2,357,357,40,40,0,1,0
24,383,383,11,11,0,1,0
14,458,458,15,15,0,1,0
26,466,466,38,8,30,4,3
22,479,479,43,34,9,4,3

10,102,102,16,16,0,1,0
4,112,112,2,2,0,1,0
6,116,116,16,10,6,3,2
15,130,130,4,4,0,1,0
19,195,195,34,8,26,2,1
9,216,216,6,6,0,1,0
22,219,219,20,16,4,2,1
3,227,227,164,71,93,4,3
8,237,237,57,37,20,2,1
18,249,249,73,73,0,1,0
0,275,275,30,30,0,1,0
14,278,278,30,2,28,3,2
16,327,327,5,5,0,1,0
12,335,335,54,3,51,3,2
7,346,346,30,4,26,2,1
2,348,348,1,1,0,1,0
21,381,381,7,1,6,3,2
13,399,399,33,33,0,1,0
1,400,400,7,7,0,1,0
5,413,413,28,28,0,1,0
20,444,444,60,30,30,2,1
11,467,467,33,21,12,4,3
17,497,497,34,34,0,1,0

20,113,113,18,18,0,1,0
10,156,156,6,6,0,1,0
12,159,159,9,9,0,1,0
30,161,161,1,1,0,1,0
5,163,163,3,3,0,1,0
0,174,174,1,1,0,1,0
29,223,223,10,5,5,2,1
27,225,225,1,1,0,1,0
31,237,237,20,1,19,2,1
26,240,240,32,25,7,2,1
21,246,246,7,7,0,1,0
1,277,277,21,14,7,2,1
9,279,279,47,47,0,1,0
16,290,290,12,12,0,1,0
2,305,305,33,33,0,1,0
22,306,306,58,13,45,4,3
15,316,316,20,6,14,3,2
3,322,322,17,3,14,2,1
19,337,337,11,11,0,1,0
4,362,362,15,7,8,3,2
7,363,363,30,30,0,1,0
18,374,374,111,83,28,2,1
17,400,400,9,9,0,1,0
11,410,410,82,40,42,4,3
14,420,420,55,33,22,3,2
28,441,441,33,20,13,2,1
23,447,447,124,124,0,1,0
8,472,472,1,1,0,1,0
25,472,472,15,15,0,1,0
13,473,473,57,31,26,3,2
24,488,488,32,32,0,1,0
6,492,492,85,25,60,3,2

11,117,117,9,9,0,1,0
4,150,150,25,3,22,2,1
5,167,167,6,2,4,2,1
0,172,172,1,1,0,1,0
9,183,183,13,10,3,2,1
8,232,232,40,40,0,1,0
22,241,241,2,2,0,1,0
23,242,242,34,2,32,2,1
3,267,267,28,3,25,2,1
14,273,273,14,2,12,4,3
13,315,315,1,1,0,1,0
16,319,319,24,17,7,2,1
20,320,320,8,8,0,1,0
2,352,352,85,85,0,1,0
15,363,363,13,13,0,1,0
24,364,364,90,50,40,3,2
17,368,368,139,100,39,2,1
1,369,369,84,44,40,4,3
10,376,376,16,16,0,1,0
21,400,400,4,4,0,1,0
19,417,417,15,5,10,3,2
18,453,453,100,100,0,1,0
12,471,471,55,27,28,3,2
7,473,473,87,87,0,1,0
6,499,499,74,42,32,2,1

20,103,103,17,17,0,1,0
4,122,122,27,5,22,3,2
14,143,143,9,2,7,2,1
5,162,162,24,15,9,2,1
16,168,168,33,33,0,1,0
27,171,171,17,1,16,2,1
13,176,176,8,8,0,1,0
6,178,178,44,44,0,1,0
3,200,200,46,29,17,2,1
17,213,213,10,10,0,1,0
7,224,224,8,8,0,1,0
21,237,237,28,6,22,2,1
26,249,249,4,4,0,1,0
25,251,251,17,17,0,1,0
2,276,276,21,21,0,1,0
9,291,291,52,52,0,1,0
15,295,295,5,5,0,1,0
1,295,295,8,5,3,2,1
0,332,332,18,18,0,1,0
19,360,360,70,55,15,2,1
12,365,365,5,1,4,2,1
8,418,418,3,3,0,1,0
23,431,431,34,25,9,4,3
24,431,431,42,42,0,1,0
10,449,449,10,2,8,2,1
11,474,474,17,5,12,4,3
22,483,483,27,7,20,3,2
18,493,493,86,86,0,1,0
28,496,496,49,49,0,1,0

20,106,106,11,1,10,2,1
12,110,110,10,10,0,1,0
13,126,126,6,6,0,1,0
24,130,130,11,11,0,1,0
25,136,136,16,16,0,1,0
4,152,152,10,10,0,1,0
9,159,159,1,1,0,1,0
14,166,166,23,15,8,2,1
23,178,178,31,10,21,2,1
26,206,206,31,31,0,1,0
1,208,208,9,5,4,2,1
10,214,214,4,4,0,1,0
5,271,271,39,29,10,3,2
15,293,293,32,32,0,1,0
3,334,334,40,40,0,1,0
6,355,355,31,31,0,1,0
7,375,375,100,1,99,3,2
18,387,387,25,12,13,2,1
0,397,397,83,1,82,4,3
17,416,416,7,3,4,2,1
2,425,425,38,9,29,2,1
16,434,434,53,28,25,2,1
11,451,451,112,20,92,3,2
21,467,467,37,37,0,1,0
22,478,478,28,17,11,2,1
19,479,479,80,47,33,4,3
8,489,489,8,8,0,1,0

15,122,122,9,4,5,2,1
11,126,126,22,18,4,2,1
4,135,135,1,1,0,1,0
1,138,138,8,3,5,2,1
0,141,141,27,27,0,1,0
22,175,175,34,34,0,1,0
21,176,176,45,45,0,1,0
6,178,178,13,4,9,2,1
7,206,206,11,2,9,4,3
23,223,223,16,16,0,1,0
16,239,239,2,2,0,1,0
9,240,240,14,5,9,4,3
13,258,258,15,15,0,1,0
8,327,327,26,17,9,2,1
19,329,329,3,3,0,1,0
20,357,357,23,17,6,3,2
18,365,365,6,6,0,1,0
10,381,381,132,56,76,3,2
3,383,383,47,2,45,4,3
24,391,391,69,40,29,2,1
2,410,410,58,58,0,1,0
12,455,455,86,2,84,3,2
14,461,461,21,21,0,1,0
5,474,474,47,47,0,1,0
25,475,475,34,34,0,1,0
17,485,485,89,89,0,1,0

14,104,104,5,2,3,2,1
19,145,145,4,4,0,1,0
4,158,158,9,9,0,1,0
29,158,158,7,2,5,2,1
28,171,171,42,42,0,1,0
13,193,193,31,17,14,4,3
25,193,193,14,14,0,1,0
7,197,197,19,7,12,4,3
11,208,208,2,2,0,1,0
21,229,229,19,11,8,3,2
22,245,245,72,72,0,1,0
8,246,246,36,18,18,4,3
6,261,261,15,6,9,4,3
18,269,269,4,4,0,1,0
24,270,270,5,5,0,1,0
12,270,270,38,23,15,4,3
15,271,271,1,1,0,1,0
20,276,276,1,1,0,1,0
26,278,278,50,16,34,3,2
0,287,287,23,13,10,2,1
27,297,297,15,15,0,1,0
31,310,310,11,6,5,2,1
16,343,343,19,19,0,1,0
30,354,354,11,11,0,1,0
1,374,374,30,30,0,1,0
23,386,386,46,13,33,3,2
2,436,436,37,37,0,1,0
10,443,443,11,11,0,1,0
33,447,447,45,7,38,3,2
17,458,458,9,9,0,1,0
5,466,466,46,46,0,1,0
3,489,489,4,4,0,1,0
9,491,491,92,28,64,3,2
32,499,499,72,21,51,4,3

21,126,126,6,6,0,1,0
0,135,135,19,19,0,1,0
24,177,177,7,7,0,1,0
2,203,203,3,3,0,1,0
12,207,207,55,55,0,1,0
10,210,210,97,15,82,3,2
9,213,213,1,1,0,1,0
19,216,216,16,16,0,1,0
8,220,220,12,12,0,1,0
16,222,222,15,15,0,1,0
1,246,246,2,2,0,1,0
25,262,262,12,12,0,1,0
18,285,285,4,4,0,1,0
4,323,323,63,63,0,1,0
6,330,330,14,14,0,1,0
15,359,359,35,23,12,4,3
7,367,367,1,1,0,1,0
17,387,387,34,28,6,3,2
5,395,395,24,24,0,1,0
14,398,398,101,44,57,4,3
11,430,430,40,31,9,4,3
3,433,433,25,25,0,1,0
23,451,451,43,2,41,2,1
13,467,467,153,153,0,1,0
20,479,479,4,4,0,1,0
26,481,481,24,24,0,1,0
22,491,491,108,42,66,3,2

3,100,100,5,5,0,1,0
24,118,118,2,2,0,1,0
14,118,118,8,8,0,1,0
6,125,125,6,6,0,1,0
12,125,125,7,7,0,1,0
7,138,138,37,9,28,3,2
11,139,139,5,5,0,1,0
0,143,143,1,1,0,1,0
25,171,171,54,29,25,2,1
1,181,181,13,13,0,1,0
23,189,189,2,2,0,1,0
21,195,195,6,6,0,1,0
13,204,204,9,3,6,2,1
18,270,270,26,26,0,1,0
10,301,301,39,3,36,3,2
26,305,305,14,14,0,1,0
16,306,306,32,18,14,2,1
19,327,327,89,77,12,4,3
20,337,337,10,10,0,1,0
4,365,365,57,47,10,2,1
2,372,372,6,6,0,1,0
9,380,380,96,53,43,4,3
15,430,430,1,1,0,1,0
17,442,442,23,23,0,1,0
22,464,464,158,121,37,3,2
5,470,470,131,131,0,1,0
8,494,494,15,1,14,4,3

27,109,109,5,5,0,1,0
17,109,109,6,6,0,1,0
33,121,121,23,2,21,4,3
3,142,142,30,30,0,1,0
4,142,142,6,6,0,1,0
20,147,147,15,11,4,2,1
32,153,153,37,37,0,1,0
35,165,165,15,3,12,3,2
36,167,167,5,5,0,1,0
24,168,168,20,20,0,1,0
19,172,172,10,10,0,1,0
1,178,178,20,11,9,2,1
16,181,181,2,2,0,1,0
0,181,181,16,13,3,2,1
31,201,201,26,26,0,1,0
7,255,255,16,16,0,1,0
6,288,288,1,1,0,1,0
26,288,288,2,2,0,1,0
34,313,313,30,30,0,1,0
10,315,315,1,1,0,1,0
23,317,317,84,84,0,1,0
13,319,319,6,6,0,1,0
12,336,336,40,2,38,3,2
21,358,358,35,35,0,1,0
18,358,358,42,42,0,1,0
5,366,366,15,1,14,2,1
15,373,373,9,2,7,2,1
8,383,383,18,10,8,3,2
9,388,388,2,2,0,1,0
30,392,392,10,1,9,4,3
22,418,418,39,6,33,2,1
11,418,418,15,15,0,1,0
25,435,435,74,14,60,4,3
28,451,451,10,1,9,3,2
2,475,475,2,2,0,1,0
14,484,484,23,23,0,1,0
29,486,486,1,1,0,1,0

17,114,114,7,7,0,1,0
4,170,170,27,27,0,1,0
20,179,179,5,5,0,1,0
23,185,185,34,8,26,3,2
0,197,197,45,45,0,1,0
9,215,215,1,1,0,1,0
11,248,248,11,11,0,1,0
22,266,266,23,23,0,1,0
7,272,272,59,13,46,2,1
14,278,278,16,4,12,4,3
19,282,282,15,15,0,1,0
15,283,283,36,36,0,1,0
21,292,292,62,62,0,1,0
10,297,297,73,49,24,4,3
8,299,299,7,4,3,2,1
18,302,302,17,17,0,1,0
16,319,319,37,16,21,2,1
2,355,355,14,5,9,2,1
12,359,359,43,19,24,4,3
26,373,373,4,4,0,1,0
25,396,396,53,53,0,1,0
24,413,413,72,72,0,1,0
5,417,417,10,6,4,2,1
13,430,430,54,54,0,1,0
6,442,442,62,18,44,2,1
3,449,449,41,12,29,2,1
1,490,490,31,31,0,1,0

28,101,101,2,2,0,1,0
8,102,102,14,14,0,1,0
23,109,109,35,35,0,1,0
10,124,124,1,1,0,1,0
17,126,126,11,4,7,2,1
5,128,128,11,11,0,1,0
21,142,142,2,2,0,1,0
13,145,145,10,10,0,1,0
24,172,172,11,11,0,1,0
14,173,173,1,1,0,1,0
12,187,187,1,1,0,1,0
27,196,196,57,23,34,2,1
7,204,204,23,11,12,3,2
19,205,205,8,8,0,1,0
6,219,219,1,1,0,1,0
0,239,239,9,1,8,3,2
20,267,267,25,25,0,1,0
18,286,286,9,2,7,2,1
26,294,294,34,26,8,2,1
15,298,298,24,24,0,1,0
29,312,312,11,11,0,1,0
9,339,339,33,33,0,1,0
2,369,369,30,25,5,2,1
11,377,377,44,5,39,4,3
31,405,405,64,48,16,3,2
16,429,429,7,7,0,1,0
3,431,431,2,2,0,1,0
30,437,437,14,14,0,1,0
22,449,449,40,40,0,1,0
4,474,474,3,3,0,1,0
1,480,480,214,204,10,3,2
25,490,490,62,32,30,2,1

27,109,109,6,6,0,1,0
4,120,120,1,1,0,1,0
23,153,153,2,2,0,1,0
21,159,159,22,22,0,1,0
11,173,173,14,2,12,3,2
28,186,186,3,3,0,1,0
8,191,191,1,1,0,1,0
3,205,205,3,3,0,1,0
25,220,220,81,46,35,4,3
17,252,252,30,30,0,1,0
2,261,261,24,24,0,1,0
33,271,271,86,86,0,1,0
18,277,277,6,6,0,1,0
31,295,295,9,9,0,1,0
13,340,340,5,2,3,2,1
5,346,346,51,51,0,1,0
29,348,348,19,12,7,2,1
24,358,358,19,2,17,2,1
7,384,384,19,19,0,1,0
26,387,387,47,39,8,2,1
16,398,398,50,5,45,2,1
1,399,399,14,2,12,4,3
9,402,402,5,5,0,1,0
10,409,409,26,26,0,1,0
14,418,418,38,23,15,4,3
0,420,420,94,20,74,3,2
22,429,429,30,6,24,4,3
19,437,437,21,1,20,4,3
20,445,445,67,40,27,4,3
6,471,471,58,58,0,1,0
30,476,476,17,2,15,4,3
15,479,479,38,38,0,1,0
12,487,487,22,22,0,1,0
32,497,497,3,3,0,1,0

17,128,128,4,4,0,1,0
23,136,136,8,8,0,1,0
20,150,150,6,6,0,1,0
6,153,153,27,19,8,2,1
21,157,157,4,4,0,1,0
18,169,169,3,3,0,1,0
0,189,189,4,1,3,2,1
11,234,234,7,1,6,3,2
4,238,238,2,2,0,1,0
19,253,253,35,35,0,1,0
9,258,258,13,13,0,1,0
22,277,277,71,32,39,4,3
2,279,279,73,49,24,3,2
7,279,279,16,10,6,2,1
10,280,280,64,4,60,3,2
13,298,298,15,11,4,2,1
3,329,329,3,3,0,1,0
1,352,352,138,21,117,4,3
15,375,375,30,30,0,1,0
14,395,395,16,16,0,1,0
16,424,424,87,87,0,1,0
5,434,434,133,133,0,1,0
12,448,448,100,70,30,2,1
8,469,469,55,17,38,2,1

10,109,109,21,12,9,2,1
3,143,143,5,5,0,1,0
27,143,143,2,2,0,1,0
21,146,146,3,3,0,1,0
2,148,148,45,5,40,2,1
23,157,157,25,10,15,4,3
5,192,192,16,16,0,1,0
15,195,195,6,6,0,1,0
19,202,202,38,12,26,3,2
28,206,206,19,13,6,3,2
14,240,240,11,2,9,4,3
22,248,248,41,41,0,1,0
24,259,259,24,10,14,3,2
25,269,269,25,17,8,3,2
0,271,271,22,22,0,1,0
17,305,305,46,22,24,3,2
4,325,325,37,27,10,2,1
1,328,328,30,30,0,1,0
20,336,336,13,13,0,1,0
26,396,396,108,18,90,3,2
11,401,401,2,2,0,1,0
12,421,421,2,2,0,1,0
7,422,422,47,15,32,3,2
18,451,451,25,13,12,2,1
6,454,454,44,44,0,1,0
9,457,457,11,11,0,1,0
8,480,480,79,39,40,3,2
16,482,482,31,31,0,1,0
13,492,492,23,1,22,3,2

23,138,138,2,2,0,1,0
26,143,143,17,17,0,1,0
3,146,146,25,7,18,3,2
18,165,165,6,6,0,1,0
21,167,167,3,3,0,1,0
12,174,174,19,19,0,1,0
4,175,175,1,1,0,1,0
19,185,185,9,9,0,1,0
9,217,217,22,4,18,3,2
13,235,235,11,5,6,2,1
15,236,236,32,32,0,1,0
29,256,256,27,27,0,1,0
16,262,262,53,7,46,3,2
0,272,272,48,48,0,1,0
7,292,292,8,8,0,1,0
17,298,298,3,3,0,1,0
8,302,302,34,4,30,2,1
6,315,315,2,2,0,1,0
25,327,327,38,38,0,1,0
5,331,331,31,11,20,3,2
1,335,335,29,29,0,1,0
28,344,344,52,34,18,2,1
10,346,346,34,34,0,1,0
14,349,349,56,12,44,3,2
2,398,398,17,12,5,2,1
24,400,400,55,21,34,4,3
22,421,421,99,99,0,1,0
20,447,447,64,4,60,4,3
27,483,483,47,1,46,2,1
11,486,486,13,13,0,1,0

22,155,155,8,2,6,2,1
4,163,163,3,3,0,1,0
17,173,173,1,1,0,1,0
18,183,183,8,8,0,1,0
9,234,234,60,26,34,3,2
14,234,234,16,6,10,3,2
8,246,246,36,13,23,2,1
25,270,270,27,27,0,1,0
11,271,271,24,24,0,1,0
15,275,275,9,1,8,3,2
13,279,279,115,82,33,4,3
26,299,299,9,9,0,1,0
20,326,326,1,1,0,1,0
1,337,337,14,8,6,2,1
19,343,343,41,11,30,4,3
27,362,362,186,137,49,2,1
12,364,364,7,1,6,2,1
24,395,395,15,15,0,1,0
5,417,417,1,1,0,1,0
6,431,431,15,15,0,1,0
3,439,439,69,69,0,1,0
2,443,443,45,21,24,2,1
0,452,452,25,25,0,1,0
16,460,460,1,1,0,1,0
23,460,460,26,14,12,2,1
21,472,472,169,52,117,4,3
7,478,478,26,26,0,1,0
10,499,499,6,6,0,1,0

26,129,129,1,1,0,1,0
7,139,139,9,9,0,1,0
21,145,145,10,10,0,1,0
24,148,148,10,10,0,1,0
6,159,159,9,1,8,2,1
18,180,180,51,9,42,2,1
9,185,185,64,64,0,1,0
14,194,194,3,3,0,1,0
28,276,276,9,9,0,1,0
22,285,285,49,15,34,3,2
3,287,287,2,2,0,1,0
23,289,289,69,48,21,4,3
2,314,314,4,4,0,1,0
1,318,318,79,52,27,2,1
5,326,326,16,3,13,2,1
20,328,328,2,2,0,1,0
10,331,331,6,3,3,2,1
27,343,343,17,3,14,2,1
15,343,343,21,5,16,3,2
16,356,356,26,4,22,2,1
13,386,386,41,41,0,1,0
8,405,405,15,9,6,2,1
17,413,413,56,18,38,4,3
4,428,428,3,3,0,1,0
12,429,429,58,2,56,3,2
0,458,458,93,93,0,1,0
19,459,459,59,59,0,1,0
25,470,470,50,13,37,2,1
11,488,488,48,4,44,3,2

7,110,110,6,1,5,2,1
12,111,111,1,1,0,1,0
16,111,111,18,18,0,1,0
22,130,130,9,9,0,1,0
8,150,150,22,4,18,3,2
20,171,171,28,1,27,3,2
24,178,178,14,14,0,1,0
18,227,227,28,28,0,1,0
11,252,252,1,1,0,1,0
0,255,255,5,1,4,2,1
4,260,260,47,47,0,1,0
14,268,268,13,5,8,3,2
21,297,297,67,67,0,1,0
2,303,303,69,9,60,3,2
1,318,318,30,7,23,2,1
6,321,321,52,9,43,2,1
26,344,344,12,8,4,2,1
17,356,356,47,15,32,2,1
25,366,366,20,20,0,1,0
19,368,368,15,15,0,1,0
28,417,417,16,16,0,1,0
9,417,417,4,4,0,1,0
5,419,419,41,41,0,1,0
27,423,423,43,5,38,3,2
3,460,460,7,3,4,2,1
13,465,465,147,135,12,2,1
10,478,478,7,4,3,2,1
23,484,484,68,56,12,4,3
15,490,490,32,12,20,2,1

16,118,118,6,6,0,1,0
7,133,133,3,3,0,1,0
25,156,156,14,11,3,2,1
13,158,158,43,22,21,4,3
4,159,159,9,9,0,1,0
3,168,168,17,8,9,4,3
20,171,171,26,26,0,1,0
0,192,192,54,10,44,3,2
15,210,210,3,3,0,1,0
24,238,238,11,7,4,2,1
6,244,244,1,1,0,1,0
29,248,248,6,1,5,2,1
2,251,251,16,16,0,1,0
27,263,263,30,22,8,3,2
18,270,270,113,69,44,2,1
10,272,272,10,10,0,1,0
8,295,295,27,6,21,3,2
26,301,301,22,4,18,3,2
30,313,313,12,12,0,1,0
14,324,324,51,19,32,4,3
1,326,326,32,12,20,4,3
28,326,326,67,33,34,3,2
9,333,333,20,20,0,1,0
17,335,335,22,22,0,1,0
5,351,351,1,1,0,1,0
12,373,373,7,7,0,1,0
19,402,402,15,5,10,3,2
23,427,427,7,7,0,1,0
11,452,452,2,2,0,1,0
21,463,463,45,45,0,1,0
22,475,475,6,1,5,2,1
31,490,490,50,14,36,2,1

1,104,104,21,21,0,1,0
7,107,107,10,10,0,1,0
13,111,111,4,1,3,2,1
6,113,113,2,2,0,1,0
3,116,116,3,3,0,1,0
15,165,165,2,2,0,1,0
0,192,192,19,19,0,1,0
27,193,193,28,28,0,1,0
28,198,198,30,11,19,2,1
19,210,210,9,3,6,2,1
18,213,213,59,59,0,1,0
26,223,223,5,5,0,1,0
20,244,244,7,7,0,1,0
2,246,246,75,35,40,3,2
5,249,249,39,13,26,3,2
10,296,296,14,14,0,1,0
12,346,346,29,29,0,1,0
17,349,349,25,9,16,3,2
9,351,351,22,22,0,1,0
16,354,354,24,24,0,1,0
14,357,357,77,17,60,4,3
24,361,361,49,25,24,2,1
4,399,399,7,7,0,1,0
25,400,400,86,77,9,4,3
22,403,403,81,1,80,3,2
11,415,415,1,1,0,1,0
8,438,438,16,16,0,1,0
23,448,448,12,4,8,3,2
21,458,458,13,4,9,4,3

21,103,103,2,2,0,1,0
3,113,113,11,1,10,2,1
22,158,158,17,2,15,4,3
16,190,190,4,4,0,1,0
24,206,206,7,2,5,2,1
20,210,210,11,11,0,1,0
2,254,254,2,2,0,1,0
13,280,280,1,1,0,1,0
18,315,315,57,57,0,1,0
19,323,323,46,2,44,4,3
5,331,331,16,16,0,1,0
8,331,331,19,19,0,1,0
6,334,334,20,20,0,1,0
17,343,343,20,5,15,4,3
9,357,357,41,41,0,1,0
12,360,360,37,3,34,3,2
14,363,363,134,41,93,4,3
15,393,393,12,5,7,2,1
0,402,402,46,46,0,1,0
7,440,440,69,69,0,1,0
23,463,463,64,64,0,1,0
11,469,469,76,43,33,2,1
4,476,476,192,192,0,1,0
1,490,490,48,48,0,1,0
10,492,492,119,83,36,4,3

27,118,118,2,2,0,1,0
19,121,121,27,4,23,2,1
30,139,139,18,18,0,1,0
6,141,141,41,23,18,4,3
0,141,141,6,6,0,1,0
18,161,161,5,5,0,1,0
28,169,169,75,75,0,1,0
24,183,183,25,25,0,1,0
22,195,195,15,9,6,3,2
14,297,297,13,13,0,1,0
8,298,298,50,6,44,2,1
31,316,316,24,10,14,2,1
7,348,348,10,1,9,4,3
2,353,353,36,36,0,1,0
25,354,354,1,1,0,1,0
12,356,356,1,1,0,1,0
20,357,357,22,1,21,2,1
11,375,375,11,11,0,1,0
1,392,392,36,4,32,2,1
21,400,400,18,10,8,3,2
23,404,404,15,9,6,3,2
29,406,406,42,42,0,1,0
32,406,406,19,19,0,1,0
9,414,414,18,18,0,1,0
10,419,419,21,7,14,3,2
15,433,433,11,11,0,1,0
26,438,438,15,15,0,1,0
4,442,442,15,6,9,4,3
13,460,460,119,86,33,4,3
16,466,466,13,9,4,2,1
17,481,481,37,37,0,1,0
5,489,489,17,17,0,1,0
3,493,493,11,11,0,1,0

1,104,104,36,19,17,2,1
9,106,106,3,3,0,1,0
2,124,124,19,19,0,1,0
19,146,146,13,13,0,1,0
4,147,147,28,28,0,1,0
11,161,161,13,13,0,1,0
16,216,216,12,5,7,2,1
6,230,230,68,68,0,1,0
0,246,246,55,23,32,4,3
14,254,254,33,18,15,2,1
18,306,306,82,82,0,1,0
7,333,333,7,7,0,1,0
10,334,334,59,5,54,4,3
15,382,382,15,9,6,2,1
17,383,383,26,9,17,2,1
12,384,384,77,47,30,4,3
5,393,393,61,39,22,3,2
20,394,394,7,7,0,1,0
3,464,464,18,18,0,1,0
8,483,483,113,38,75,4,3
13,499,499,9,3,6,3,2

7,104,104,2,2,0,1,0
15,111,111,6,6,0,1,0
30,134,134,25,5,20,3,2
26,144,144,19,19,0,1,0
1,150,150,8,8,0,1,0
3,175,175,33,23,10,2,1
17,187,187,5,5,0,1,0
16,214,214,6,2,4,2,1
18,234,234,53,9,44,3,2
12,236,236,7,1,6,3,2
24,243,243,34,4,30,4,3
29,254,254,11,8,3,2,1
19,256,256,2,2,0,1,0
0,257,257,34,34,0,1,0
28,262,262,9,9,0,1,0
11,282,282,3,3,0,1,0
9,290,290,1,1,0,1,0
22,331,331,3,3,0,1,0
4,334,334,33,23,10,2,1
8,351,351,4,4,0,1,0
14,358,358,14,8,6,3,2
10,359,359,13,13,0,1,0
20,366,366,125,80,45,2,1
25,380,380,50,26,24,4,3
23,386,386,37,14,23,2,1
13,391,391,152,105,47,4,3
6,400,400,21,21,0,1,0
5,408,408,68,8,60,3,2
21,420,420,4,1,3,2,1
2,423,423,37,37,0,1,0
27,499,499,20,20,0,1,0

19,120,120,13,13,0,1,0
24,120,120,2,2,0,1,0
8,125,125,9,9,0,1,0
18,172,172,5,5,0,1,0
4,217,217,8,1,7,3,2
12,220,220,29,2,27,2,1
25,220,220,11,5,6,3,2
14,229,229,40,40,0,1,0
23,251,251,11,11,0,1,0
27,275,275,16,4,12,4,3
21,276,276,2,2,0,1,0
22,309,309,23,6,17,2,1
10,321,321,17,17,0,1,0
0,326,326,12,8,4,2,1
30,350,350,140,112,28,3,2
13,385,385,30,30,0,1,0
28,387,387,37,5,32,3,2
11,402,402,49,19,30,2,1
9,406,406,2,2,0,1,0
3,409,409,7,7,0,1,0
15,413,413,45,45,0,1,0
1,414,414,44,44,0,1,0
17,415,415,40,12,28,3,2
5,416,416,112,112,0,1,0
6,419,419,11,8,3,2,1
20,429,429,5,5,0,1,0
16,441,441,6,6,0,1,0
2,441,441,17,5,12,3,2
26,444,444,60,41,19,2,1
29,450,450,139,91,48,4,3
7,461,461,51,51,0,1,0

4,112,112,3,3,0,1,0
22,117,117,13,13,0,1,0
13,124,124,6,6,0,1,0
1,125,125,3,3,0,1,0
14,133,133,6,6,0,1,0
8,141,141,19,19,0,1,0
19,158,158,2,2,0,1,0
26,163,163,3,3,0,1,0
25,219,219,15,11,4,2,1
5,223,223,110,6,104,4,3
3,256,256,46,32,14,3,2
11,266,266,1,1,0,1,0
10,281,281,16,8,8,3,2
12,282,282,21,21,0,1,0
18,302,302,54,54,0,1,0
16,335,335,43,43,0,1,0
9,360,360,11,11,0,1,0
27,365,365,66,66,0,1,0
7,373,373,2,2,0,1,0
23,389,389,4,4,0,1,0
2,410,410,95,95,0,1,0
21,425,425,31,11,20,2,1
15,448,448,7,7,0,1,0
28,449,449,9,2,7,2,1
6,470,470,1,1,0,1,0
17,475,475,249,249,0,1,0
0,487,487,23,23,0,1,0
24,491,491,26,26,0,1,0
20,495,495,14,2,12,3,2

15,100,100,6,3,3,2,1
26,107,107,12,12,0,1,0
18,117,117,7,7,0,1,0
21,137,137,17,8,9,4,3
12,191,191,60,60,0,1,0
13,220,220,20,20,0,1,0
3,244,244,23,17,6,3,2
27,247,247,14,10,4,2,1
11,259,259,4,4,0,1,0
23,278,278,7,7,0,1,0
6,301,301,38,26,12,4,3
14,327,327,69,69,0,1,0
20,336,336,29,29,0,1,0
4,360,360,8,8,0,1,0
1,367,367,1,1,0,1,0
0,373,373,22,15,7,2,1
16,388,388,15,5,10,3,2
17,396,396,32,11,21,4,3
7,402,402,81,21,60,3,2
24,407,407,88,88,0,1,0
25,410,410,37,37,0,1,0
2,437,437,53,41,12,4,3
22,450,450,32,15,17,2,1
19,453,453,94,94,0,1,0
10,462,462,47,29,18,2,1
8,463,463,28,28,0,1,0
9,498,498,38,11,27,2,1
5,499,499,57,57,0,1,0

15,103,103,1,1,0,1,0
34,103,103,3,3,0,1,0
25,131,131,5,2,3,2,1
8,135,135,8,8,0,1,0
5,156,156,15,15,0,1,0
1,173,173,5,5,0,1,0
10,176,176,1,1,0,1,0
11,178,178,2,2,0,1,0
30,186,186,4,1,3,2,1
26,201,201,60,6,54,4,3
16,223,223,9,9,0,1,0
31,236,236,11,1,10,3,2
18,250,250,1,1,0,1,0
17,258,258,48,11,37,2,1
14,296,296,29,11,18,4,3
0,300,300,18,14,4,2,1
21,334,334,17,8,9,4,3
7,341,341,14,2,12,2,1
19,347,347,11,11,0,1,0
28,356,356,5,5,0,1,0
29,360,360,13,13,0,1,0
12,362,362,27,27,0,1,0
9,364,364,66,56,10,3,2
35,365,365,16,16,0,1,0
3,365,365,13,2,11,2,1
32,371,371,202,178,24,2,1
6,378,378,26,26,0,1,0
22,381,381,7,7,0,1,0
24,386,386,71,62,9,4,3
33,406,406,44,38,6,2,1
13,421,421,1,1,0,1,0
20,422,422,98,83,15,2,1
4,428,428,1,1,0,1,0
27,429,429,1,1,0,1,0
23,447,447,22,7,15,2,1
2,474,474,38,19,19,2,1

11,127,127,36,36,0,1,0
19,137,137,29,29,0,1,0
0,163,163,37,10,27,3,2
22,167,167,22,7,15,4,3
16,170,170,32,4,28,3,2
10,183,183,36,36,0,1,0
7,184,184,6,6,0,1,0
4,186,186,12,12,0,1,0
9,213,213,18,18,0,1,0
5,222,222,14,2,12,3,2
6,248,248,3,3,0,1,0
13,250,250,12,2,10,3,2
3,261,261,33,33,0,1,0
20,281,281,15,3,12,3,2
12,294,294,53,53,0,1,0
2,329,329,7,7,0,1,0
25,357,357,45,45,0,1,0
15,373,373,48,18,30,4,3
21,377,377,57,57,0,1,0
17,382,382,7,4,3,2,1
14,401,401,11,11,0,1,0
1,406,406,32,32,0,1,0
23,427,427,1,1,0,1,0
8,462,462,15,4,11,2,1
24,471,471,94,70,24,3,2
26,489,489,43,43,0,1,0
18,490,490,27,27,0,1,0

17,114,114,28,28,0,1,0
11,116,116,35,9,26,2,1
24,126,126,20,6,14,2,1
1,146,146,1,1,0,1,0
12,158,158,56,56,0,1,0
27,174,174,9,3,6,2,1
4,180,180,29,18,11,2,1
6,188,188,1,1,0,1,0
20,224,224,33,33,0,1,0
22,245,245,18,2,16,2,1
26,246,246,20,20,0,1,0
23,252,252,65,13,52,3,2
5,305,305,38,38,0,1,0
13,313,313,34,34,0,1,0
19,328,328,9,9,0,1,0
2,328,328,15,15,0,1,0
18,335,335,31,4,27,4,3
9,338,338,15,15,0,1,0
3,366,366,3,3,0,1,0
15,375,375,4,4,0,1,0
10,393,393,5,5,0,1,0
0,404,404,16,16,0,1,0
21,419,419,2,2,0,1,0
16,426,426,2,2,0,1,0
8,440,440,40,6,34,4,3
7,459,459,45,45,0,1,0
14,479,479,118,75,43,2,1
25,484,484,15,9,6,3,2

19,108,108,24,24,0,1,0
6,113,113,3,3,0,1,0
18,113,113,16,10,6,2,1
32,119,119,6,6,0,1,0
17,120,120,4,4,0,1,0
24,126,126,29,7,22,3,2
22,135,135,11,3,8,2,1
9,144,144,2,2,0,1,0
4,152,152,12,4,8,3,2
31,156,156,6,6,0,1,0
23,166,166,24,15,9,4,3
25,168,168,5,5,0,1,0
7,175,175,46,7,39,2,1
12,178,178,11,1,10,2,1
3,201,201,15,15,0,1,0
30,261,261,55,28,27,4,3
8,277,277,28,25,3,2,1
5,278,278,1,1,0,1,0
10,281,281,2,2,0,1,0
13,287,287,10,10,0,1,0
15,326,326,12,12,0,1,0
11,347,347,41,23,18,2,1
28,350,350,9,9,0,1,0
20,362,362,32,28,4,2,1
14,375,375,25,16,9,4,3
21,387,387,22,4,18,3,2
27,432,432,71,71,0,1,0
26,448,448,15,15,0,1,0
1,471,471,20,20,0,1,0
0,472,472,6,6,0,1,0
29,474,474,25,25,0,1,0
2,479,479,114,44,70,4,3
16,481,481,22,22,0,1,0

22,155,155,53,24,29,2,1
1,208,208,8,8,0,1,0
5,244,244,50,10,40,2,1
17,245,245,12,2,10,4,3
11,279,279,14,2,12,3,2
14,290,290,28,28,0,1,0
20,325,325,43,1,42,2,1
23,360,360,8,2,6,3,2
26,365,365,13,13,0,1,0
8,373,373,114,114,0,1,0
21,379,379,10,10,0,1,0
6,386,386,2,2,0,1,0
13,390,390,5,5,0,1,0
12,392,392,23,23,0,1,0
2,394,394,64,32,32,3,2
19,407,407,129,90,39,4,3
25,408,408,8,8,0,1,0
24,412,412,11,11,0,1,0
9,435,435,95,23,72,4,3
27,437,437,16,16,0,1,0
3,441,441,7,7,0,1,0
7,447,447,6,6,0,1,0
4,458,458,79,36,43,3,2
10,484,484,1,1,0,1,0
16,487,487,4,4,0,1,0
18,491,491,127,22,105,4,3
15,493,493,23,13,10,2,1
0,497,497,70,70,0,1,0

12,112,112,12,4,8,2,1
27,122,122,18,4,14,2,1
3,128,128,21,7,14,2,1
23,132,132,9,9,0,1,0
9,140,140,1,1,0,1,0
7,151,151,26,26,0,1,0
15,165,165,20,2,18,2,1
25,165,165,16,16,0,1,0
19,166,166,18,18,0,1,0
14,187,187,15,9,6,3,2
21,189,189,25,9,16,3,2
26,226,226,35,19,16,3,2
11,255,255,33,21,12,2,1
2,256,256,12,3,9,2,1
1,257,257,10,7,3,2,1
5,274,274,17,8,9,2,1
28,326,326,33,33,0,1,0
17,332,332,39,39,0,1,0
20,333,333,45,36,9,4,3
4,333,333,27,14,13,2,1
16,334,334,42,36,6,2,1
22,338,338,34,34,0,1,0
13,353,353,50,10,40,4,3
24,364,364,1,1,0,1,0
18,392,392,4,4,0,1,0
10,429,429,108,108,0,1,0
0,482,482,15,7,8,3,2
8,493,493,22,17,5,2,1
6,494,494,21,13,8,2,1

1,110,110,4,4,0,1,0
8,130,130,1,1,0,1,0
18,148,148,28,4,24,4,3
0,165,165,11,11,0,1,0
25,190,190,14,4,10,3,2
16,200,200,29,8,21,2,1
11,214,214,3,3,0,1,0
13,242,242,65,50,15,4,3
26,249,249,47,47,0,1,0
2,263,263,38,38,0,1,0
12,280,280,67,19,48,2,1
14,284,284,16,7,9,4,3
6,298,298,67,67,0,1,0
17,344,344,1,1,0,1,0
7,353,353,58,21,37,4,3
21,363,363,1,1,0,1,0
10,372,372,5,5,0,1,0
5,379,379,28,19,9,4,3
22,397,397,21,21,0,1,0
23,403,403,9,4,5,2,1
24,410,410,42,42,0,1,0
9,445,445,19,9,10,2,1
3,452,452,21,10,11,3,2
20,453,453,40,40,0,1,0
4,455,455,27,2,25,2,1
15,455,455,3,3,0,1,0
19,467,467,213,137,76,4,3
27,485,485,17,2,15,4,3

5,121,121,5,5,0,1,0
9,127,127,26,1,25,2,1
21,134,134,12,6,6,3,2
10,147,147,25,25,0,1,0
15,169,169,5,5,0,1,0
6,193,193,1,1,0,1,0
25,232,232,98,23,75,4,3
8,236,236,60,50,10,3,2
26,243,243,33,33,0,1,0
12,261,261,48,7,41,2,1
14,277,277,7,1,6,3,2
23,287,287,11,11,0,1,0
11,307,307,15,15,0,1,0
4,318,318,117,117,0,1,0
17,326,326,36,36,0,1,0
19,333,333,7,1,6,2,1
18,347,347,36,36,0,1,0
0,358,358,10,10,0,1,0
7,360,360,1,1,0,1,0
13,361,361,37,37,0,1,0
22,362,362,9,9,0,1,0
2,385,385,28,3,25,2,1
20,389,389,68,68,0,1,0
16,410,410,51,51,0,1,0
1,412,412,7,7,0,1,0
3,424,424,3,3,0,1,0
24,483,483,12,3,9,4,3

1,112,112,33,20,13,2,1
15,118,118,37,37,0,1,0
2,128,128,17,17,0,1,0
24,160,160,8,8,0,1,0
0,161,161,9,3,6,3,2
18,162,162,7,7,0,1,0
14,171,171,9,1,8,2,1
19,217,217,20,20,0,1,0
21,235,235,17,17,0,1,0
23,267,267,24,6,18,2,1
16,306,306,34,34,0,1,0
17,325,325,15,7,8,2,1
12,326,326,46,46,0,1,0
7,330,330,5,5,0,1,0
22,331,331,9,9,0,1,0
5,339,339,141,66,75,4,3
13,349,349,2,2,0,1,0
20,355,355,73,15,58,4,3
10,357,357,27,27,0,1,0
9,358,358,9,1,8,3,2
11,366,366,65,65,0,1,0
3,371,371,79,79,0,1,0
4,396,396,41,1,40,3,2
6,463,463,1,1,0,1,0
8,465,465,31,31,0,1,0

23,110,110,1,1,0,1,0
2,134,134,7,1,6,2,1
28,145,145,26,26,0,1,0
17,158,158,4,4,0,1,0
19,177,177,4,4,0,1,0
12,188,188,9,9,0,1,0
0,216,216,25,13,12,2,1
5,243,243,7,1,6,3,2
26,252,252,9,6,3,2,1
14,255,255,15,6,9,4,3
15,257,257,101,15,86,3,2
25,276,276,46,4,42,2,1
16,294,294,42,8,34,3,2
13,304,304,10,2,8,3,2
27,311,311,85,67,18,4,3
24,316,316,28,28,0,1,0
22,319,319,10,10,0,1,0
11,341,341,11,3,8,2,1
3,344,344,6,1,5,2,1
1,344,344,28,8,20,3,2
7,349,349,3,3,0,1,0
9,356,356,41,41,0,1,0
18,365,365,40,40,0,1,0
10,373,373,47,47,0,1,0
8,377,377,2,2,0,1,0
21,378,378,59,59,0,1,0
6,383,383,24,8,16,2,1
20,461,461,81,81,0,1,0
4,463,463,103,103,0,1,0
29,468,468,8,5,3,2,1

14,112,112,13,13,0,1,0
12,144,144,11,6,5,2,1
25,168,168,5,1,4,2,1
17,168,168,74,49,25,2,1
3,174,174,46,31,15,4,3
9,195,195,1,1,0,1,0
15,199,199,2,2,0,1,0
8,211,211,21,4,17,2,1
16,220,220,10,7,3,2,1
0,233,233,3,3,0,1,0
13,248,248,23,14,9,4,3
20,258,258,20,20,0,1,0
19,278,278,32,32,0,1,0
7,305,305,27,27,0,1,0
5,315,315,36,36,0,1,0
18,326,326,66,19,47,2,1
23,341,341,4,1,3,2,1
1,373,373,12,3,9,2,1
22,374,374,15,15,0,1,0
21,376,376,66,66,0,1,0
24,391,391,27,27,0,1,0
6,399,399,148,88,60,4,3
2,404,404,43,3,40,3,2
11,428,428,56,22,34,3,2
26,446,446,3,3,0,1,0
10,485,485,9,9,0,1,0
4,486,486,41,41,0,1,0

16,116,116,5,2,3,2,1
11,116,116,7,7,0,1,0
20,116,116,13,5,8,2,1
19,133,133,15,15,0,1,0
4,141,141,5,5,0,1,0
0,141,141,25,3,22,3,2
22,162,162,17,2,15,4,3
18,206,206,6,6,0,1,0
3,214,214,9,4,5,2,1
7,228,228,12,1,11,3,2
5,254,254,31,4,27,4,3
14,288,288,38,8,30,2,1
6,298,298,225,171,54,3,2
1,321,321,52,1,51,4,3
15,341,341,27,27,0,1,0
13,352,352,62,62,0,1,0
17,363,363,54,18,36,3,2
2,428,428,18,9,9,2,1
8,438,438,6,6,0,1,0
9,441,441,59,14,45,4,3
21,473,473,28,28,0,1,0
12,476,476,64,64,0,1,0
10,499,499,57,22,35,3,2

9,101,101,3,3,0,1,0
22,115,115,31,3,28,2,1
10,131,131,4,4,0,1,0
20,143,143,23,23,0,1,0
16,148,148,2,2,0,1,0
19,157,157,5,5,0,1,0
21,179,179,7,7,0,1,0
29,197,197,7,7,0,1,0
23,214,214,7,7,0,1,0
11,228,228,45,21,24,4,3
32,261,261,25,25,0,1,0
25,269,269,46,28,18,4,3
33,291,291,40,28,12,2,1
14,296,296,35,13,22,2,1
5,304,304,30,30,0,1,0
18,304,304,29,2,27,4,3
24,318,318,9,9,0,1,0
7,320,320,35,9,26,3,2
1,325,325,18,18,0,1,0
3,352,352,36,36,0,1,0
15,370,370,5,5,0,1,0
30,385,385,3,3,0,1,0
12,392,392,57,19,38,2,1
28,395,395,4,4,0,1,0
4,398,398,45,26,19,2,1
27,411,411,87,6,81,4,3
2,420,420,1,1,0,1,0
0,422,422,12,12,0,1,0
17,425,425,48,37,11,2,1
31,433,433,81,9,72,4,3
26,446,446,21,8,13,2,1
8,451,451,1,1,0,1,0
6,464,464,29,29,0,1,0
13,480,480,19,19,0,1,0

16,119,119,5,5,0,1,0
12,131,131,7,7,0,1,0
7,136,136,48,19,29,2,1
6,136,136,4,4,0,1,0
15,146,146,9,4,5,2,1
19,195,195,59,30,29,2,1
21,209,209,3,3,0,1,0
2,210,210,30,7,23,2,1
22,224,224,82,64,18,2,1
11,229,229,31,31,0,1,0
5,236,236,7,7,0,1,0
24,245,245,1,1,0,1,0
1,278,278,30,25,5,2,1
9,290,290,95,95,0,1,0
23,298,298,54,16,38,2,1
8,302,302,18,8,10,3,2
3,332,332,1,1,0,1,0
17,333,333,13,8,5,2,1
13,337,337,17,2,15,2,1
20,366,366,7,2,5,2,1
18,368,368,44,34,10,2,1
4,409,409,14,14,0,1,0
25,410,410,57,57,0,1,0
0,423,423,9,4,5,2,1
10,454,454,72,4,68,3,2
14,470,470,20,20,0,1,0

16,101,101,3,3,0,1,0
0,102,102,39,8,31,2,1
4,111,111,15,15,0,1,0
2,120,120,10,4,6,3,2
8,160,160,21,18,3,2,1
7,211,211,1,1,0,1,0
13,218,218,48,19,29,2,1
17,240,240,9,9,0,1,0
11,302,302,73,44,29,2,1
3,320,320,132,132,0,1,0
5,328,328,10,2,8,2,1
10,351,351,11,7,4,2,1
12,355,355,8,4,4,2,1
19,386,386,104,60,44,2,1
18,426,426,66,66,0,1,0
20,443,443,43,43,0,1,0
22,444,444,11,11,0,1,0
15,452,452,8,3,5,2,1
1,468,468,69,69,0,1,0
14,472,472,49,25,24,4,3
9,477,477,44,26,18,3,2
6,494,494,36,1,35,4,3
21,497,497,40,19,21,4,3

13,109,109,24,24,0,1,0
18,118,118,5,5,0,1,0
0,156,156,47,47,0,1,0
2,167,167,6,6,0,1,0
12,199,199,27,27,0,1,0
19,204,204,3,3,0,1,0
5,215,215,38,30,8,3,2
3,228,228,2,2,0,1,0
6,242,242,19,19,0,1,0
7,261,261,40,16,24,2,1
10,272,272,141,109,32,2,1
21,277,277,41,7,34,4,3
24,285,285,52,52,0,1,0
16,289,289,1,1,0,1,0
23,304,304,20,20,0,1,0
17,325,325,36,36,0,1,0
22,326,326,13,2,11,2,1
1,329,329,5,5,0,1,0
20,337,337,16,16,0,1,0
11,423,423,18,9,9,4,3
15,446,446,29,13,16,4,3
8,449,449,47,38,9,2,1
4,456,456,1,1,0,1,0
14,482,482,150,117,33,4,3
9,499,499,3,3,0,1,0

18,106,106,10,2,8,2,1
1,173,173,31,31,0,1,0
9,175,175,18,18,0,1,0
13,184,184,9,9,0,1,0
11,194,194,2,2,0,1,0
16,216,216,9,9,0,1,0
0,224,224,69,55,14,2,1
3,225,225,5,5,0,1,0
12,234,234,1,1,0,1,0
4,240,240,45,45,0,1,0
10,261,261,20,20,0,1,0
14,277,277,25,25,0,1,0
19,304,304,33,8,25,2,1
22,306,306,70,60,10,3,2
17,324,324,122,116,6,3,2
6,339,339,113,113,0,1,0
20,387,387,17,5,12,2,1
15,391,391,60,60,0,1,0
5,392,392,27,17,10,2,1
21,427,427,24,24,0,1,0
8,429,429,13,4,9,2,1
2,440,440,82,82,0,1,0
7,492,492,42,2,40,3,2

33,123,123,9,9,0,1,0
31,131,131,6,3,3,2,1
16,164,164,7,7,0,1,0
14,190,190,22,12,10,3,2
28,196,196,40,29,11,2,1
4,197,197,19,15,4,2,1
5,220,220,17,2,15,2,1
6,223,223,1,1,0,1,0
10,246,246,3,3,0,1,0
2,252,252,12,7,5,2,1
22,259,259,15,15,0,1,0
32,264,264,5,5,0,1,0
15,273,273,7,7,0,1,0
18,276,276,39,39,0,1,0
20,282,282,18,3,15,4,3
19,288,288,17,11,6,2,1
23,295,295,17,5,12,2,1
34,308,308,17,7,10,2,1
25,311,311,76,50,26,2,1
21,313,313,33,33,0,1,0
30,328,328,121,121,0,1,0
1,369,369,29,9,20,3,2
8,373,373,12,9,3,2,1
26,405,405,1,1,0,1,0
12,418,418,19,15,4,2,1
17,420,420,17,5,12,3,2
13,422,422,55,13,42,3,2
11,446,446,45,13,32,4,3
7,451,451,33,33,0,1,0
9,464,464,21,21,0,1,0
29,474,474,56,56,0,1,0
0,477,477,17,17,0,1,0
27,481,481,31,31,0,1,0
24,482,482,2,2,0,1,0
3,489,489,66,66,0,1,0

21,118,118,15,15,0,1,0
0,124,124,10,10,0,1,0
4,146,146,18,7,11,2,1
6,182,182,12,12,0,1,0
26,194,194,54,39,15,4,3
17,207,207,5,5,0,1,0
19,213,213,3,3,0,1,0
29,228,228,25,25,0,1,0
7,236,236,1,1,0,1,0
28,259,259,45,42,3,2,1
3,271,271,33,10,23,2,1
24,274,274,32,10,22,3,2
14,286,286,45,11,34,3,2
25,313,313,26,20,6,3,2
9,316,316,56,38,18,4,3
18,325,325,14,14,0,1,0
10,335,335,29,29,0,1,0
20,339,339,7,1,6,3,2
16,342,342,41,21,20,3,2
2,344,344,51,17,34,3,2
12,352,352,1,1,0,1,0
27,353,353,24,7,17,4,3
22,356,356,8,2,6,3,2
5,373,373,21,3,18,3,2
23,394,394,93,93,0,1,0
15,395,395,40,4,36,4,3
11,419,419,3,3,0,1,0
1,426,426,66,66,0,1,0
8,440,440,2,2,0,1,0
13,450,450,49,49,0,1,0

21,101,101,10,10,0,1,0
4,144,144,4,4,0,1,0
15,147,147,7,7,0,1,0
19,157,157,28,28,0,1,0
17,167,167,56,11,45,3,2
18,173,173,7,4,3,2,1
9,176,176,22,22,0,1,0
24,176,176,9,9,0,1,0
0,179,179,27,21,6,3,2
5,199,199,80,80,0,1,0
13,246,246,30,30,0,1,0
12,315,315,6,6,0,1,0
6,321,321,57,6,51,4,3
23,334,334,18,6,12,2,1
20,340,340,10,1,9,4,3
11,350,350,16,16,0,1,0
14,354,354,27,7,20,4,3
25,396,396,27,9,18,3,2
8,412,412,20,20,0,1,0
2,414,414,24,24,0,1,0
26,414,414,62,62,0,1,0
22,434,434,9,1,8,3,2
1,448,448,8,8,0,1,0
10,450,450,54,18,36,4,3
7,456,456,36,24,12,4,3
16,474,474,75,75,0,1,0
3,499,499,65,7,58,3,2

1,112,112,18,8,10,3,2
9,128,128,10,10,0,1,0
2,145,145,9,9,0,1,0
14,159,159,31,31,0,1,0
15,165,165,2,2,0,1,0
24,168,168,13,2,11,2,1
8,171,171,134,134,0,1,0
20,197,197,35,35,0,1,0
12,212,212,39,39,0,1,0
7,231,231,1,1,0,1,0
6,243,243,16,16,0,1,0
4,313,313,10,10,0,1,0
23,349,349,3,3,0,1,0
3,374,374,40,12,28,2,1
10,399,399,5,5,0,1,0
13,403,403,76,41,35,3,2
17,413,413,6,6,0,1,0
16,416,416,48,48,0,1,0
5,418,418,25,13,12,3,2
19,423,423,6,3,3,2,1
18,430,430,57,18,39,4,3
22,433,433,64,64,0,1,0
11,449,449,22,22,0,1,0
0,467,467,17,17,0,1,0
21,473,473,51,51,0,1,0

21,108,108,8,8,0,1,0
18,111,111,3,3,0,1,0
10,114,114,1,1,0,1,0
19,118,118,8,8,0,1,0
16,162,162,1,1,0,1,0
17,208,208,12,12,0,1,0
22,209,209,45,39,6,3,2
3,220,220,5,2,3,2,1
8,241,241,8,8,0,1,0
2,249,249,48,48,0,1,0
7,250,250,49,49,0,1,0
9,273,273,72,33,39,4,3
24,280,280,1,1,0,1,0
13,315,315,78,78,0,1,0
6,317,317,41,41,0,1,0
11,328,328,109,80,29,4,3
0,330,330,18,11,7,2,1
4,334,334,5,5,0,1,0
5,340,340,19,19,0,1,0
12,345,345,74,49,25,2,1
1,365,365,36,36,0,1,0
14,382,382,32,32,0,1,0
15,392,392,23,23,0,1,0
20,397,397,12,2,10,2,1
25,409,409,59,51,8,2,1
23,425,425,86,64,22,3,2

8,100,100,2,2,0,1,0
28,107,107,9,9,0,1,0
31,127,127,6,6,0,1,0
18,136,136,21,17,4,2,1
1,152,152,10,10,0,1,0
17,153,153,13,13,0,1,0
4,157,157,7,7,0,1,0
30,160,160,24,24,0,1,0
11,198,198,36,36,0,1,0
27,204,204,46,12,34,2,1
9,221,221,45,5,40,3,2
16,231,231,1,1,0,1,0
25,246,246,35,25,10,2,1
32,256,256,46,46,0,1,0
14,273,273,9,9,0,1,0
6,279,279,26,8,18,4,3
22,280,280,16,16,0,1,0
21,284,284,26,26,0,1,0
13,294,294,4,1,3,2,1
12,307,307,8,8,0,1,0
29,329,329,41,7,34,3,2
2,335,335,16,5,11,2,1
26,385,385,30,30,0,1,0
0,395,395,24,24,0,1,0
3,423,423,72,4,68,3,2
20,423,423,17,13,4,2,1
5,426,426,41,41,0,1,0
15,443,443,9,6,3,2,1
7,462,462,21,21,0,1,0
24,463,463,37,37,0,1,0
10,463,463,17,17,0,1,0
23,492,492,56,56,0,1,0
19,492,492,7,7,0,1,0

23,106,106,9,9,0,1,0
8,107,107,1,1,0,1,0
18,118,118,14,14,0,1,0
19,130,130,4,1,3,2,1
6,142,142,1,1,0,1,0
5,143,143,1,1,0,1,0
3,206,206,2,2,0,1,0
21,212,212,10,2,8,2,1
16,228,228,4,1,3,2,1
25,233,233,67,51,16,3,2
33,243,243,27,7,20,2,1
20,261,261,18,13,5,2,1
17,283,283,1,1,0,1,0
27,292,292,5,1,4,2,1
24,294,294,2,2,0,1,0
4,316,316,36,36,0,1,0
14,319,319,18,18,0,1,0
10,331,331,4,4,0,1,0
32,334,334,24,4,20,2,1
22,356,356,48,48,0,1,0
9,378,378,43,43,0,1,0
34,381,381,34,6,28,3,2
11,381,381,21,21,0,1,0
0,389,389,68,68,0,1,0
12,400,400,23,23,0,1,0
29,421,421,8,2,6,3,2
31,440,440,71,41,30,2,1
13,444,444,3,3,0,1,0
30,453,453,22,22,0,1,0
7,454,454,12,12,0,1,0
26,454,454,154,102,52,3,2
15,466,466,69,54,15,2,1
28,480,480,2,2,0,1,0
2,495,495,1,1,0,1,0
1,498,498,181,150,31,2,1

11,102,102,34,22,12,2,1
28,108,108,44,44,0,1,0
0,129,129,4,1,3,2,1
8,152,152,7,7,0,1,0
13,171,171,16,16,0,1,0
29,181,181,36,36,0,1,0
1,213,213,40,11,29,2,1
21,214,214,4,4,0,1,0
27,237,237,20,2,18,3,2
30,260,260,2,2,0,1,0
4,261,261,56,10,46,2,1
14,261,261,10,10,0,1,0
19,271,271,14,2,12,2,1
23,276,276,5,5,0,1,0
20,285,285,72,64,8,3,2
25,289,289,14,11,3,2,1
26,328,328,6,6,0,1,0
7,338,338,1,1,0,1,0
5,349,349,4,4,0,1,0
17,369,369,64,18,46,2,1
9,373,373,46,37,9,4,3
18,380,380,25,17,8,3,2
6,392,392,50,2,48,3,2
2,396,396,1,1,0,1,0
12,414,414,19,8,11,2,1
24,419,419,1,1,0,1,0
22,435,435,35,5,30,2,1
3,448,448,18,18,0,1,0
10,458,458,29,29,0,1,0
16,467,467,5,5,0,1,0
15,498,498,14,1,13,4,3

28,125,125,3,3,0,1,0
26,127,127,8,2,6,2,1
3,135,135,8,8,0,1,0
24,141,141,15,15,0,1,0
7,143,143,5,5,0,1,0
16,152,152,32,32,0,1,0
21,161,161,8,5,3,2,1
23,175,175,7,7,0,1,0
1,184,184,4,4,0,1,0
22,204,204,42,16,26,3,2
27,213,213,50,50,0,1,0
9,217,217,1,1,0,1,0
29,233,233,43,27,16,3,2
6,234,234,1,1,0,1,0
5,244,244,2,2,0,1,0
32,247,247,5,5,0,1,0
18,253,253,16,16,0,1,0
11,263,263,29,29,0,1,0
13,264,264,14,14,0,1,0
17,267,267,20,20,0,1,0
33,306,306,4,4,0,1,0
14,307,307,28,9,19,2,1
20,307,307,33,21,12,2,1
2,308,308,7,2,5,2,1
25,346,346,28,28,0,1,0
12,356,356,57,57,0,1,0
8,359,359,48,7,41,2,1
34,385,385,78,62,16,2,1
0,395,395,20,20,0,1,0
10,404,404,1,1,0,1,0
30,408,408,9,9,0,1,0
31,417,417,78,78,0,1,0
15,421,421,7,7,0,1,0
19,457,457,65,65,0,1,0
4,487,487,15,3,12,4,3

20,105,105,20,20,0,1,0
7,109,109,5,5,0,1,0
3,118,118,12,12,0,1,0
16,132,132,7,3,4,2,1
10,145,145,2,2,0,1,0
21,148,148,11,11,0,1,0
18,182,182,9,9,0,1,0
4,192,192,6,6,0,1,0
8,198,198,11,11,0,1,0
12,199,199,79,46,33,3,2
13,205,205,43,43,0,1,0
2,253,253,21,21,0,1,0
0,255,255,13,6,7,2,1
5,258,258,23,3,20,3,2
15,274,274,13,13,0,1,0
27,278,278,4,4,0,1,0
23,292,292,47,44,3,2,1
6,338,338,7,7,0,1,0
9,344,344,1,1,0,1,0
22,370,370,18,13,5,2,1
25,386,386,20,6,14,2,1
24,409,409,46,13,33,4,3
17,410,410,18,18,0,1,0
1,422,422,78,68,10,2,1
19,429,429,71,71,0,1,0
28,432,432,106,106,0,1,0
26,471,471,80,80,0,1,0
14,484,484,45,45,0,1,0
11,486,486,10,10,0,1,0

14,123,123,12,5,7,2,1
11,125,125,3,3,0,1,0
8,125,125,1,1,0,1,0
3,138,138,6,1,5,2,1
21,147,147,3,3,0,1,0
20,148,148,2,2,0,1,0
1,180,180,4,4,0,1,0
22,189,189,8,5,3,2,1
19,197,197,35,35,0,1,0
5,209,209,2,2,0,1,0
15,213,213,25,25,0,1,0
27,222,222,6,6,0,1,0
9,230,230,33,33,0,1,0
23,232,232,23,23,0,1,0
7,239,239,3,3,0,1,0
12,240,240,28,7,21,4,3
30,246,246,1,1,0,1,0
31,256,256,99,48,51,4,3
17,294,294,27,27,0,1,0
0,321,321,14,5,9,4,3
10,347,347,52,4,48,4,3
13,349,349,81,81,0,1,0
26,352,352,95,45,50,3,2
18,357,357,21,21,0,1,0
24,385,385,11,11,0,1,0
25,398,398,14,6,8,3,2
29,399,399,51,51,0,1,0
4,426,426,25,3,22,2,1
28,449,449,61,61,0,1,0
2,487,487,44,44,0,1,0
16,489,489,62,12,50,2,1
6,495,495,6,6,0,1,0

17,133,133,2,2,0,1,0
4,138,138,10,1,9,4,3
18,145,145,4,1,3,2,1
1,177,177,62,10,52,3,2
13,208,208,10,10,0,1,0
22,229,229,79,79,0,1,0
27,236,236,24,6,18,4,3
11,246,246,43,11,32,3,2
26,258,258,45,45,0,1,0
6,296,296,8,8,0,1,0
21,318,318,3,3,0,1,0
28,322,322,35,12,23,2,1
14,337,337,8,5,3,2,1
0,346,346,9,4,5,2,1
7,352,352,72,6,66,3,2
19,354,354,11,11,0,1,0
20,356,356,5,5,0,1,0
10,358,358,53,1,52,3,2
24,364,364,4,4,0,1,0
23,371,371,89,62,27,4,3
12,401,401,50,50,0,1,0
3,413,413,55,17,38,2,1
5,427,427,7,7,0,1,0
15,437,437,48,38,10,3,2
8,452,452,4,4,0,1,0
9,472,472,3,3,0,1,0
16,479,479,109,53,56,3,2
25,488,488,6,6,0,1,0
2,493,493,18,18,0,1,0

7,108,108,14,14,0,1,0
25,120,120,8,5,3,2,1
6,123,123,11,11,0,1,0
20,133,133,1,1,0,1,0
26,135,135,3,3,0,1,0
35,144,144,30,30,0,1,0
29,162,162,8,8,0,1,0
5,187,187,4,1,3,2,1
4,212,212,41,41,0,1,0
30,217,217,20,17,3,2,1
32,230,230,22,7,15,2,1
3,235,235,40,40,0,1,0
2,236,236,6,6,0,1,0
19,242,242,17,17,0,1,0
12,278,278,2,2,0,1,0
10,280,280,19,5,14,2,1
24,281,281,26,12,14,2,1
18,296,296,13,13,0,1,0
21,330,330,10,10,0,1,0
34,333,333,37,31,6,2,1
0,344,344,24,24,0,1,0
17,352,352,31,31,0,1,0
16,358,358,27,23,4,2,1
8,372,372,49,11,38,2,1
31,396,396,13,2,11,2,1
11,412,412,43,9,34,2,1
33,413,413,5,2,3,2,1
23,426,426,60,14,46,3,2
13,453,453,10,10,0,1,0
22,456,456,123,27,96,4,3
1,468,468,8,8,0,1,0
28,469,469,6,6,0,1,0
9,488,488,1,1,0,1,0
14,490,490,7,7,0,1,0
15,492,492,10,1,9,4,3
27,497,497,115,16,99,4,3

16,101,101,25,1,24,4,3
20,105,105,12,12,0,1,0
2,123,123,1,1,0,1,0
1,125,125,7,7,0,1,0
18,127,127,11,11,0,1,0
17,140,140,4,4,0,1,0
12,163,163,7,7,0,1,0
6,164,164,12,12,0,1,0
21,203,203,42,20,22,3,2
14,208,208,29,2,27,4,3
10,217,217,93,45,48,4,3
22,227,227,53,38,15,2,1
8,248,248,11,7,4,2,1
13,255,255,9,6,3,2,1
3,255,255,101,32,69,4,3
0,308,308,7,7,0,1,0
15,332,332,2,2,0,1,0
9,339,339,56,56,0,1,0
7,347,347,31,22,9,4,3
11,360,360,20,20,0,1,0
23,432,432,8,8,0,1,0
19,435,435,43,30,13,2,1
24,470,470,56,56,0,1,0
4,474,474,27,1,26,3,2
5,483,483,30,30,0,1,0

26,105,105,9,6,3,2,1
12,130,130,20,2,18,3,2
14,133,133,5,2,3,2,1
22,137,137,1,1,0,1,0
5,150,150,1,1,0,1,0
21,158,158,16,16,0,1,0
24,193,193,11,6,5,2,1
19,198,198,21,3,18,3,2
9,213,213,14,3,11,2,1
16,217,217,76,16,60,4,3
10,230,230,25,25,0,1,0
6,232,232,5,5,0,1,0
20,246,246,2,2,0,1,0
7,251,251,22,5,17,2,1
17,254,254,4,1,3,2,1
0,256,256,90,90,0,1,0
4,285,285,1,1,0,1,0
27,285,285,18,12,6,2,1
25,285,285,97,97,0,1,0
29,294,294,20,11,9,2,1
1,303,303,75,49,26,2,1
3,343,343,3,3,0,1,0
8,346,346,4,4,0,1,0
13,371,371,1,1,0,1,0
15,375,375,31,22,9,4,3
23,394,394,53,53,0,1,0
2,437,437,80,38,42,4,3
11,441,441,13,8,5,2,1
18,457,457,36,36,0,1,0
28,491,491,6,6,0,1,0

6,108,108,3,3,0,1,0
11,110,110,12,12,0,1,0
2,185,185,32,32,0,1,0
14,215,215,22,15,7,2,1
3,237,237,141,30,111,4,3
4,239,239,8,8,0,1,0
12,245,245,19,10,9,4,3
19,249,249,33,33,0,1,0
22,252,252,44,44,0,1,0
8,260,260,14,9,5,2,1
13,260,260,9,9,0,1,0
15,280,280,8,8,0,1,0
23,308,308,35,29,6,2,1
20,313,313,22,22,0,1,0
0,316,316,15,3,12,4,3
10,316,316,7,7,0,1,0
21,328,328,82,10,72,3,2
9,365,365,107,107,0,1,0
5,383,383,3,3,0,1,0
17,422,422,31,1,30,4,3
18,428,428,49,3,46,2,1
7,444,444,59,59,0,1,0
1,471,471,17,17,0,1,0
16,492,492,57,1,56,3,2

15,109,109,35,35,0,1,0
13,146,146,20,20,0,1,0
18,156,156,15,15,0,1,0
25,158,158,25,25,0,1,0
10,180,180,1,1,0,1,0
0,191,191,37,22,15,3,2
19,202,202,16,16,0,1,0
7,206,206,1,1,0,1,0
12,219,219,31,17,14,3,2
23,220,220,6,6,0,1,0
21,239,239,21,21,0,1,0
8,249,249,26,26,0,1,0
1,272,272,1,1,0,1,0
14,296,296,21,21,0,1,0
11,298,298,1,1,0,1,0
9,306,306,5,5,0,1,0
24,317,317,17,17,0,1,0
20,326,326,11,5,6,3,2
2,335,335,114,3,111,4,3
4,364,364,52,52,0,1,0
16,375,375,86,86,0,1,0
22,408,408,20,9,11,4,3
3,437,437,43,15,28,3,2
5,449,449,1,1,0,1,0
6,461,461,96,22,74,4,3
27,461,461,5,2,3,2,1
17,469,469,43,43,0,1,0
26,473,473,59,31,28,3,2

5,100,100,15,15,0,1,0
0,121,121,3,3,0,1,0
19,173,173,26,14,12,4,3
7,177,177,26,26,0,1,0
11,191,191,13,13,0,1,0
6,231,231,27,11,16,2,1
21,234,234,15,12,3,2,1
3,237,237,13,13,0,1,0
17,244,244,17,1,16,2,1
15,253,253,45,45,0,1,0
2,284,284,45,45,0,1,0
20,284,284,60,39,21,2,1
14,299,299,14,14,0,1,0
4,299,299,20,11,9,2,1
9,317,317,1,1,0,1,0
22,377,377,11,11,0,1,0
16,390,390,63,45,18,4,3
24,424,424,52,15,37,2,1
1,434,434,165,165,0,1,0
13,435,435,26,13,13,4,3
23,437,437,60,10,50,2,1
12,439,439,68,68,0,1,0
18,460,460,1,1,0,1,0
25,461,461,18,12,6,3,2
10,477,477,100,100,0,1,0
8,492,492,11,5,6,2,1

12,113,113,14,14,0,1,0
5,132,132,4,4,0,1,0
10,145,145,14,5,9,4,3
6,153,153,25,19,6,2,1
16,162,162,24,18,6,3,2
1,164,164,8,2,6,3,2
19,171,171,2,2,0,1,0
11,210,210,8,2,6,2,1
8,230,230,29,29,0,1,0
4,241,241,91,80,11,2,1
7,262,262,2,2,0,1,0
15,288,288,1,1,0,1,0
25,308,308,67,28,39,4,3
27,311,311,130,72,58,3,2
14,317,317,6,6,0,1,0
0,343,343,81,44,37,2,1
24,356,356,17,9,8,2,1
21,360,360,91,91,0,1,0
9,367,367,15,15,0,1,0
26,373,373,26,26,0,1,0
3,379,379,8,4,4,2,1
20,402,402,21,10,11,2,1
22,411,411,8,5,3,2,1
18,421,421,13,5,8,3,2
13,442,442,5,2,3,2,1
2,450,450,36,36,0,1,0
23,457,457,21,12,9,4,3
17,467,467,38,5,33,4,3

6,102,102,5,2,3,2,1
11,111,111,1,1,0,1,0
32,113,113,7,7,0,1,0
22,114,114,7,4,3,2,1
14,118,118,3,3,0,1,0
21,123,123,2,2,0,1,0
17,132,132,6,6,0,1,0
12,133,133,1,1,0,1,0
20,144,144,5,2,3,2,1
23,185,185,55,3,52,3,2
10,217,217,12,12,0,1,0
7,217,217,35,5,30,3,2
30,237,237,4,4,0,1,0
13,243,243,2,2,0,1,0
18,251,251,7,7,0,1,0
0,265,265,1,1,0,1,0
1,275,275,10,10,0,1,0
5,290,290,20,20,0,1,0
3,294,294,22,22,0,1,0
25,307,307,11,11,0,1,0
28,332,332,19,4,15,4,3
24,350,350,27,3,24,2,1
2,350,350,75,41,34,2,1
27,411,411,89,45,44,2,1
4,423,423,15,7,8,2,1
16,428,428,130,80,50,3,2
33,430,430,5,5,0,1,0
15,430,430,19,19,0,1,0
34,457,457,122,50,72,4,3
26,463,463,2,2,0,1,0
8,468,468,40,40,0,1,0
29,473,473,142,31,111,4,3
31,476,476,4,4,0,1,0
19,482,482,24,24,0,1,0
9,485,485,32,32,0,1,0

12,127,127,11,11,0,1,0
20,151,151,26,26,0,1,0
23,152,152,5,5,0,1,0
1,155,155,14,1,13,4,3
17,176,176,1,1,0,1,0
2,193,193,15,15,0,1,0
15,201,201,40,40,0,1,0
28,221,221,34,10,24,4,3
13,224,224,19,16,3,2,1
3,257,257,29,29,0,1,0
11,273,273,11,2,9,4,3
6,291,291,51,20,31,2,1
18,292,292,2,2,0,1,0
4,300,300,12,12,0,1,0
7,318,318,44,26,18,4,3
27,326,326,2,2,0,1,0
0,339,339,23,11,12,4,3
9,341,341,12,5,7,2,1
24,341,341,37,37,0,1,0
8,350,350,5,2,3,2,1
22,354,354,14,14,0,1,0
25,356,356,21,21,0,1,0
26,362,362,1,1,0,1,0
19,363,363,13,2,11,2,1
14,398,398,116,20,96,4,3
5,402,402,35,10,25,2,1
16,453,453,139,139,0,1,0
21,454,454,135,135,0,1,0
10,489,489,29,29,0,1,0

13,105,105,1,1,0,1,0
26,123,123,3,3,0,1,0
3,125,125,1,1,0,1,0
1,126,126,37,37,0,1,0
19,129,129,8,8,0,1,0
17,131,131,8,8,0,1,0
0,132,132,11,11,0,1,0
12,141,141,1,1,0,1,0
27,149,149,5,5,0,1,0
10,158,158,5,5,0,1,0
2,164,164,5,1,4,2,1
18,199,199,51,13,38,2,1
8,213,213,39,14,25,2,1
22,216,216,60,48,12,4,3
28,254,254,52,52,0,1,0
11,268,268,53,53,0,1,0
21,287,287,7,7,0,1,0
24,287,287,33,4,29,2,1
7,290,290,1,1,0,1,0
14,302,302,15,15,0,1,0
4,311,311,35,14,21,2,1
23,313,313,27,9,18,3,2
29,365,365,40,40,0,1,0
6,391,391,4,4,0,1,0
20,413,413,64,39,25,2,1
9,415,415,21,6,15,3,2
25,475,475,4,4,0,1,0
5,476,476,25,14,11,4,3
30,482,482,11,11,0,1,0
16,485,485,51,16,35,2,1
15,487,487,84,53,31,2,1

29,105,105,2,2,0,1,0
18,111,111,7,7,0,1,0
27,124,124,10,10,0,1,0
14,135,135,10,10,0,1,0
32,139,139,50,11,39,4,3
2,140,140,23,9,14,3,2
15,142,142,3,3,0,1,0
26,143,143,14,14,0,1,0
23,143,143,2,2,0,1,0
9,149,149,4,4,0,1,0
13,151,151,1,1,0,1,0
25,154,154,18,18,0,1,0
21,180,180,56,44,12,3,2
10,186,186,1,1,0,1,0
3,189,189,21,3,18,3,2
12,218,218,1,1,0,1,0
7,220,220,9,4,5,2,1
24,227,227,9,9,0,1,0
17,241,241,35,35,0,1,0
4,283,283,62,44,18,3,2
16,290,290,43,43,0,1,0
5,292,292,27,3,24,2,1
20,317,317,3,3,0,1,0
6,328,328,11,1,10,2,1
31,382,382,16,16,0,1,0
11,418,418,42,30,12,3,2
22,450,450,6,3,3,2,1
1,454,454,45,13,32,3,2
19,463,463,40,15,25,2,1
8,465,465,12,2,10,3,2
28,470,470,76,28,48,3,2
0,482,482,12,4,8,3,2
30,486,486,41,19,22,3,2

10,109,109,10,7,3,2,1
15,129,129,17,17,0,1,0
7,142,142,15,10,5,2,1
24,157,157,1,1,0,1,0
1,179,179,7,7,0,1,0
11,192,192,3,3,0,1,0
13,196,196,3,3,0,1,0
18,218,218,34,34,0,1,0
3,234,234,87,87,0,1,0
14,236,236,15,15,0,1,0
25,259,259,10,3,7,2,1
27,274,274,9,3,6,3,2
9,276,276,35,15,20,2,1
4,282,282,11,11,0,1,0
16,284,284,1,1,0,1,0
19,297,297,11,4,7,2,1
6,312,312,24,24,0,1,0
2,333,333,41,29,12,4,3
28,353,353,130,130,0,1,0
26,364,364,10,7,3,2,1
5,376,376,22,14,8,3,2
8,381,381,70,14,56,3,2
17,386,386,9,1,8,2,1
20,394,394,5,2,3,2,1
21,397,397,122,71,51,4,3
12,410,410,19,19,0,1,0
0,427,427,20,20,0,1,0
23,445,445,81,4,77,4,3
22,457,457,47,47,0,1,0

19,102,102,8,1,7,2,1
13,102,102,23,23,0,1,0
16,106,106,17,3,14,3,2
0,126,126,3,3,0,1,0
28,128,128,17,17,0,1,0
24,139,139,12,12,0,1,0
15,168,168,2,2,0,1,0
4,176,176,15,15,0,1,0
17,209,209,8,8,0,1,0
5,249,249,18,18,0,1,0
27,257,257,9,9,0,1,0
1,283,283,18,18,0,1,0
21,294,294,9,9,0,1,0
23,295,295,46,46,0,1,0
14,297,297,111,72,39,3,2
10,300,300,10,5,5,2,1
18,331,331,29,21,8,2,1
26,335,335,42,34,8,3,2
22,336,336,127,70,57,4,3
12,347,347,6,6,0,1,0
6,352,352,29,16,13,2,1
9,356,356,72,72,0,1,0
7,359,359,14,14,0,1,0
3,394,394,32,32,0,1,0
8,415,415,4,4,0,1,0
11,451,451,40,40,0,1,0
2,452,452,1,1,0,1,0
20,481,481,11,11,0,1,0
25,486,486,45,37,8,3,2

10,101,101,25,25,0,1,0
6,112,112,42,42,0,1,0
0,124,124,21,11,10,3,2
13,133,133,23,14,9,2,1
18,154,154,7,1,6,3,2
7,172,172,7,7,0,1,0
1,176,176,37,31,6,2,1
12,180,180,14,2,12,3,2
4,187,187,2,2,0,1,0
20,199,199,15,1,14,2,1
17,236,236,19,19,0,1,0
5,250,250,19,19,0,1,0
9,272,272,17,1,16,4,3
3,273,273,116,116,0,1,0
14,296,296,53,53,0,1,0
11,322,322,46,33,13,2,1
21,325,325,29,23,6,3,2
19,333,333,13,13,0,1,0
15,400,400,1,1,0,1,0
23,401,401,14,10,4,2,1
2,416,416,9,1,8,3,2
22,470,470,100,100,0,1,0
8,477,477,6,6,0,1,0
16,486,486,17,17,0,1,0

0,122,122,5,5,0,1,0
29,124,124,35,35,0,1,0
2,131,131,1,1,0,1,0
19,148,148,2,2,0,1,0
4,162,162,5,5,0,1,0
8,168,168,1,1,0,1,0
14,191,191,8,8,0,1,0
24,201,201,21,21,0,1,0
13,201,201,12,12,0,1,0
17,217,217,3,3,0,1,0
21,227,227,5,5,0,1,0
23,231,231,13,13,0,1,0
10,252,252,69,33,36,3,2
27,257,257,50,50,0,1,0
28,260,260,27,27,0,1,0
5,262,262,1,1,0,1,0
33,266,266,75,70,5,2,1
15,316,316,2,2,0,1,0
22,319,319,1,1,0,1,0
9,328,328,37,7,30,4,3
30,349,349,4,1,3,2,1
26,350,350,21,6,15,2,1
36,355,355,6,6,0,1,0
39,358,358,24,3,21,2,1
32,366,366,18,5,13,2,1
38,369,369,11,11,0,1,0
18,377,377,42,26,16,3,2
16,388,388,2,2,0,1,0
1,388,388,32,6,26,3,2
12,395,395,31,6,25,2,1
31,404,404,79,79,0,1,0
3,424,424,13,3,10,2,1
11,426,426,63,63,0,1,0
7,428,428,14,14,0,1,0
6,433,433,16,16,0,1,0
20,447,447,28,28,0,1,0
34,469,469,13,13,0,1,0
35,484,484,40,2,38,2,1
25,487,487,8,4,4,2,1
37,487,487,10,10,0,1,0

23,123,123,43,43,0,1,0
0,135,135,5,5,0,1,0
17,145,145,17,7,10,2,1
18,152,152,3,3,0,1,0
2,155,155,17,17,0,1,0
10,160,160,32,22,10,3,2
24,199,199,3,3,0,1,0
13,234,234,29,29,0,1,0
19,238,238,26,26,0,1,0
6,246,246,17,17,0,1,0
25,268,268,23,23,0,1,0
21,296,296,7,7,0,1,0
14,325,325,58,5,53,3,2
15,338,338,8,4,4,2,1
5,360,360,84,28,56,4,3
9,381,381,2,2,0,1,0
12,389,389,118,75,43,4,3
3,400,400,28,28,0,1,0
20,416,416,1,1,0,1,0
11,440,440,20,5,15,2,1
4,452,452,66,66,0,1,0
8,456,456,79,61,18,4,3
7,456,456,89,40,49,2,1
1,463,463,54,42,12,4,3
22,468,468,8,2,6,2,1
16,475,475,31,31,0,1,0

15,100,100,29,15,14,2,1
13,121,121,12,12,0,1,0
4,136,136,7,2,5,2,1
11,151,151,4,4,0,1,0
18,154,154,1,1,0,1,0
6,162,162,40,37,3,2,1
5,189,189,8,8,0,1,0
12,205,205,41,36,5,2,1
25,213,213,11,2,9,4,3
10,226,226,56,56,0,1,0
14,256,256,44,4,40,3,2
1,257,257,39,39,0,1,0
19,282,282,69,7,62,3,2
2,296,296,6,6,0,1,0
26,300,300,26,26,0,1,0
21,301,301,61,61,0,1,0
3,314,314,84,24,60,3,2
22,356,356,32,8,24,2,1
17,379,379,22,22,0,1,0
20,383,383,16,16,0,1,0
9,413,413,20,12,8,2,1
16,427,427,4,4,0,1,0
7,463,463,1,1,0,1,0
24,470,470,9,2,7,2,1
8,474,474,36,36,0,1,0
0,481,481,11,11,0,1,0
23,491,491,26,6,20,3,2

23,110,110,1,1,0,1,0
8,110,110,1,1,0,1,0
5,128,128,27,15,12,2,1
27,145,145,39,39,0,1,0
3,155,155,12,6,6,3,2
24,167,167,16,6,10,2,1
20,168,168,16,16,0,1,0
28,173,173,8,2,6,2,1
10,177,177,32,4,28,2,1
21,183,183,9,3,6,3,2
18,221,221,21,17,4,2,1
7,228,228,33,33,0,1,0
6,230,230,5,5,0,1,0
4,234,234,5,5,0,1,0
9,261,261,3,3,0,1,0
17,290,290,6,6,0,1,0
0,319,319,24,24,0,1,0
26,349,349,44,44,0,1,0
19,367,367,11,8,3,2,1
12,381,381,21,3,18,4,3
11,408,408,53,9,44,3,2
15,420,420,51,12,39,4,3
25,427,427,122,122,0,1,0
13,440,440,95,68,27,2,1
2,449,449,28,28,0,1,0
22,458,458,10,6,4,2,1
16,471,471,75,29,46,3,2
14,478,478,80,8,72,3,2
1,493,493,9,1,8,3,2

8,100,100,1,1,0,1,0
25,111,111,15,5,10,2,1
26,118,118,1,1,0,1,0
13,121,121,7,7,0,1,0
9,129,129,13,8,5,2,1
22,137,137,26,5,21,4,3
10,147,147,11,1,10,3,2
11,162,162,3,3,0,1,0
3,168,168,11,11,0,1,0
24,196,196,16,3,13,2,1
23,205,205,54,38,16,3,2
5,226,226,4,4,0,1,0
17,258,258,1,1,0,1,0
27,261,261,10,10,0,1,0
0,271,271,12,1,11,2,1
14,276,276,5,5,0,1,0
18,296,296,3,3,0,1,0
21,323,323,6,6,0,1,0
16,324,324,127,103,24,4,3
28,348,348,14,2,12,4,3
1,353,353,84,51,33,2,1
2,384,384,30,27,3,2,1
19,416,416,39,2,37,2,1
6,435,435,71,61,10,3,2
20,446,446,39,39,0,1,0
12,448,448,78,78,0,1,0
7,465,465,132,132,0,1,0
15,486,486,34,21,13,2,1
4,494,494,28,28,0,1,0

18,119,119,5,2,3,2,1
8,151,151,9,1,8,2,1
10,153,153,3,3,0,1,0
15,158,158,1,1,0,1,0
24,178,178,14,14,0,1,0
27,189,189,1,1,0,1,0
14,199,199,6,2,4,2,1
32,220,220,58,22,36,4,3
11,228,228,1,1,0,1,0
1,234,234,2,2,0,1,0
26,238,238,79,22,57,4,3
16,253,253,15,15,0,1,0
6,270,270,41,41,0,1,0
7,280,280,6,6,0,1,0
12,318,318,18,6,12,2,1
29,319,319,66,56,10,2,1
17,322,322,10,2,8,3,2
19,335,335,51,51,0,1,0
4,358,358,35,14,21,4,3
31,378,378,44,44,0,1,0
21,394,394,5,5,0,1,0
2,394,394,3,3,0,1,0
13,395,395,47,36,11,2,1
28,411,411,6,6,0,1,0
9,427,427,103,13,90,3,2
5,435,435,28,18,10,3,2
25,439,439,4,4,0,1,0
30,449,449,33,11,22,3,2
23,480,480,23,1,22,2,1
22,484,484,3,3,0,1,0
20,486,486,52,11,41,2,1
3,495,495,38,38,0,1,0
0,499,499,153,123,30,2,1

19,108,108,3,3,0,1,0
30,117,117,14,4,10,3,2
2,127,127,39,17,22,3,2
17,136,136,1,1,0,1,0
22,137,137,12,12,0,1,0
28,146,146,3,3,0,1,0
29,153,153,2,2,0,1,0
10,174,174,6,6,0,1,0
24,186,186,35,19,16,3,2
27,230,230,2,2,0,1,0
13,242,242,1,1,0,1,0
12,243,243,47,24,23,3,2
23,246,246,14,9,5,2,1
1,273,273,22,15,7,2,1
14,290,290,1,1,0,1,0
21,303,303,7,7,0,1,0
16,318,318,18,8,10,2,1
9,330,330,7,7,0,1,0
26,355,355,14,6,8,2,1
7,441,441,108,24,84,4,3
8,450,450,17,2,15,2,1
5,452,452,7,7,0,1,0
3,458,458,82,82,0,1,0
0,464,464,28,9,19,2,1
18,465,465,270,135,135,4,3
20,466,466,52,45,7,2,1
25,469,469,69,61,8,3,2
6,480,480,30,3,27,4,3
11,482,482,46,4,42,3,2
15,487,487,1,1,0,1,0
4,496,496,1,1,0,1,0

19,127,127,19,11,8,3,2
4,145,145,16,16,0,1,0
13,185,185,3,3,0,1,0
8,188,188,22,22,0,1,0
25,199,199,8,1,7,3,2
3,216,216,17,8,9,4,3
14,226,226,5,5,0,1,0
22,228,228,21,15,6,2,1
24,250,250,43,43,0,1,0
20,254,254,37,37,0,1,0
29,261,261,26,5,21,4,3
16,266,266,13,2,11,2,1
23,274,274,18,10,8,2,1
10,297,297,13,3,10,4,3
17,316,316,49,49,0,1,0
12,321,321,34,7,27,2,1
5,343,343,26,26,0,1,0
7,348,348,56,46,10,2,1
21,348,348,95,95,0,1,0
2,372,372,1,1,0,1,0
1,383,383,12,3,9,4,3
26,400,400,20,20,0,1,0
11,407,407,102,21,81,4,3
9,443,443,96,59,37,2,1
15,446,446,6,1,5,2,1
0,461,461,61,17,44,3,2
18,466,466,44,26,18,2,1
28,467,467,5,5,0,1,0
6,470,470,11,5,6,3,2
27,481,481,17,17,0,1,0

14,114,114,1,1,0,1,0
26,116,116,4,4,0,1,0
17,139,139,25,11,14,3,2
6,154,154,20,4,16,3,2
19,164,164,13,4,9,2,1
28,196,196,23,4,19,2,1
4,209,209,5,5,0,1,0
13,213,213,1,1,0,1,0
27,224,224,69,32,37,2,1
0,240,240,31,31,0,1,0
3,252,252,3,3,0,1,0
24,278,278,30,30,0,1,0
29,307,307,7,7,0,1,0
23,318,318,15,8,7,2,1
12,330,330,52,40,12,4,3
1,331,331,67,64,3,2,1
8,341,341,14,4,10,2,1
15,350,350,93,93,0,1,0
21,355,355,81,81,0,1,0
5,364,364,17,17,0,1,0
20,364,364,10,10,0,1,0
22,366,366,19,15,4,2,1
7,373,373,20,20,0,1,0
18,376,376,58,30,28,3,2
30,391,391,4,4,0,1,0
10,404,404,5,2,3,2,1
11,434,434,17,17,0,1,0
25,437,437,26,26,0,1,0
2,444,444,47,15,32,3,2
16,459,459,72,31,41,2,1
9,490,490,6,2,4,2,1

14,103,103,15,12,3,2,1
28,118,118,32,32,0,1,0
16,131,131,9,9,0,1,0
8,186,186,4,4,0,1,0
12,190,190,43,31,12,4,3
4,202,202,34,34,0,1,0
6,211,211,3,3,0,1,0
11,227,227,8,8,0,1,0
26,250,250,67,67,0,1,0
27,255,255,39,39,0,1,0
1,299,299,49,13,36,2,1
5,319,319,8,5,3,2,1
20,325,325,13,13,0,1,0
10,327,327,49,49,0,1,0
18,365,365,9,9,0,1,0
17,366,366,14,14,0,1,0
15,391,391,33,12,21,4,3
2,397,397,13,13,0,1,0
7,405,405,41,41,0,1,0
9,407,407,5,5,0,1,0
30,414,414,97,88,9,2,1
3,419,419,20,20,0,1,0
25,420,420,21,21,0,1,0
29,429,429,43,7,36,3,2
22,455,455,28,7,21,4,3
19,457,457,13,4,9,4,3
24,458,458,34,16,18,3,2
13,462,462,35,13,22,2,1
0,466,466,13,1,12,2,1
21,474,474,12,7,5,2,1
23,477,477,24,19,5,2,1

26,162,162,41,26,15,4,3
6,186,186,8,8,0,1,0
28,191,191,21,3,18,3,2
1,205,205,46,30,16,2,1
24,224,224,5,5,0,1,0
20,225,225,4,4,0,1,0
13,226,226,13,13,0,1,0
9,229,229,2,2,0,1,0
10,254,254,26,20,6,2,1
11,266,266,16,16,0,1,0
19,269,269,61,61,0,1,0
7,293,293,50,23,27,2,1
2,299,299,32,14,18,3,2
17,300,300,7,7,0,1,0
16,308,308,5,5,0,1,0
18,321,321,65,47,18,2,1
22,331,331,5,5,0,1,0
29,348,348,20,6,14,3,2
4,348,348,5,1,4,2,1
15,403,403,46,34,12,3,2
0,409,409,68,59,9,4,3
3,413,413,45,45,0,1,0
12,414,414,17,12,5,2,1
21,427,427,54,54,0,1,0
14,440,440,36,23,13,2,1
23,454,454,53,48,5,2,1
8,470,470,28,6,22,3,2
25,490,490,6,6,0,1,0
27,494,494,112,112,0,1,0
5,498,498,21,21,0,1,0

8,132,132,12,12,0,1,0
5,171,171,6,2,4,2,1
15,176,176,12,12,0,1,0
6,201,201,6,6,0,1,0
19,249,249,25,25,0,1,0
23,265,265,22,22,0,1,0
11,271,271,11,11,0,1,0
18,272,272,115,115,0,1,0
21,284,284,14,14,0,1,0
16,299,299,13,5,8,2,1
0,321,321,9,9,0,1,0
2,325,325,27,9,18,2,1
13,341,341,39,39,0,1,0
10,350,350,6,6,0,1,0
14,411,411,47,47,0,1,0
17,412,412,2,2,0,1,0
25,421,421,18,12,6,3,2
22,460,460,42,30,12,3,2
26,460,460,16,16,0,1,0
12,461,461,101,35,66,4,3
7,461,461,178,49,129,4,3
9,468,468,89,89,0,1,0
1,468,468,39,9,30,4,3
24,471,471,54,54,0,1,0
20,473,473,77,16,61,3,2
27,474,474,40,1,39,3,2
4,494,494,14,10,4,2,1
3,500,500,27,27,0,1,0

20,107,107,14,14,0,1,0
25,118,118,7,7,0,1,0
33,127,127,14,14,0,1,0
24,138,138,5,5,0,1,0
21,146,146,34,4,30,2,1
10,149,149,4,4,0,1,0
7,161,161,12,12,0,1,0
2,163,163,1,1,0,1,0
3,201,201,10,10,0,1,0
12,232,232,8,4,4,2,1
19,246,246,3,3,0,1,0
26,254,254,15,10,5,2,1
9,256,256,28,11,17,4,3
28,263,263,53,53,0,1,0
27,291,291,53,2,51,4,3
17,295,295,51,51,0,1,0
4,316,316,37,1,36,2,1
13,334,334,5,5,0,1,0
22,335,335,15,15,0,1,0
14,336,336,5,5,0,1,0
30,338,338,11,11,0,1,0
29,351,351,94,94,0,1,0
15,357,357,13,3,10,3,2
31,361,361,16,8,8,2,1
6,364,364,25,16,9,2,1
23,402,402,4,4,0,1,0
34,410,410,13,7,6,2,1
0,438,438,2,2,0,1,0
18,449,449,7,2,5,2,1
5,450,450,37,6,31,3,2
32,450,450,50,24,26,3,2
8,457,457,60,60,0,1,0
11,459,459,41,14,27,4,3
16,471,471,89,89,0,1,0
1,484,484,10,10,0,1,0

1,101,101,18,14,4,2,1
23,110,110,12,12,0,1,0
2,115,115,22,22,0,1,0
18,118,118,9,5,4,2,1
10,136,136,18,18,0,1,0
11,136,136,37,37,0,1,0
4,146,146,5,2,3,2,1
14,156,156,25,25,0,1,0
15,163,163,12,12,0,1,0
8,173,173,5,5,0,1,0
6,186,186,31,14,17,2,1
9,207,207,1,1,0,1,0
22,245,245,23,23,0,1,0
24,290,290,65,21,44,3,2
19,294,294,5,5,0,1,0
13,346,346,98,94,4,2,1
5,367,367,17,2,15,4,3
26,379,379,3,3,0,1,0
0,390,390,18,3,15,2,1
17,393,393,10,10,0,1,0
3,405,405,44,44,0,1,0
25,405,405,91,58,33,4,3
12,444,444,43,43,0,1,0
21,456,456,24,24,0,1,0
20,482,482,23,1,22,3,2
7,485,485,46,21,25,2,1
16,494,494,18,18,0,1,0

17,111,111,51,9,42,3,2
23,120,120,11,1,10,3,2
8,127,127,3,3,0,1,0
15,147,147,9,9,0,1,0
10,172,172,11,11,0,1,0
11,192,192,5,2,3,2,1
2,205,205,13,13,0,1,0
19,209,209,39,3,36,2,1
21,219,219,5,2,3,2,1
1,236,236,15,15,0,1,0
4,245,245,3,3,0,1,0
26,246,246,3,3,0,1,0
5,258,258,9,9,0,1,0
6,260,260,5,5,0,1,0
12,260,260,36,36,0,1,0
18,276,276,23,23,0,1,0
16,279,279,12,12,0,1,0
13,366,366,4,4,0,1,0
24,370,370,40,40,0,1,0
9,397,397,163,148,15,4,3
20,405,405,4,4,0,1,0
14,414,414,38,38,0,1,0
3,418,418,34,3,31,2,1
7,447,447,87,38,49,2,1
27,449,449,6,6,0,1,0
0,451,451,75,75,0,1,0
25,474,474,6,6,0,1,0
22,486,486,17,2,15,2,1
28,494,494,140,11,129,4,3

1,114,114,9,9,0,1,0
13,114,114,16,16,0,1,0
23,115,115,4,4,0,1,0
26,117,117,2,2,0,1,0
16,129,129,1,1,0,1,0
36,145,145,70,48,22,2,1
19,149,149,2,2,0,1,0
15,158,158,3,3,0,1,0
3,166,166,6,6,0,1,0
8,174,174,7,3,4,2,1
21,181,181,24,2,22,3,2
30,203,203,43,43,0,1,0
22,242,242,9,3,6,3,2
12,245,245,38,38,0,1,0
9,254,254,46,13,33,3,2
17,264,264,3,3,0,1,0
27,276,276,33,20,13,2,1
2,280,280,10,10,0,1,0
29,286,286,99,61,38,2,1
34,292,292,18,4,14,2,1
28,297,297,8,8,0,1,0
11,313,313,6,6,0,1,0
32,327,327,2,2,0,1,0
31,344,344,13,7,6,3,2
6,345,345,9,9,0,1,0
18,354,354,11,6,5,2,1
5,389,389,48,28,20,2,1
4,408,408,9,9,0,1,0
35,424,424,2,2,0,1,0
0,433,433,29,17,12,2,1
25,445,445,4,1,3,2,1
7,449,449,52,23,29,2,1
20,460,460,5,5,0,1,0
24,480,480,40,40,0,1,0
14,488,488,27,4,23,2,1
33,494,494,1,1,0,1,0
10,499,499,21,6,15,2,1

4,101,101,19,19,0,1,0
20,163,163,11,11,0,1,0
12,172,172,4,4,0,1,0
18,175,175,18,18,0,1,0
11,178,178,7,7,0,1,0
21,190,190,47,14,33,2,1
9,230,230,18,3,15,4,3
1,244,244,17,17,0,1,0
2,251,251,25,12,13,2,1
13,278,278,22,7,15,4,3
6,290,290,172,172,0,1,0
15,342,342,27,27,0,1,0
19,352,352,40,8,32,3,2
16,375,375,8,2,6,2,1
7,383,383,29,16,13,2,1
3,406,406,118,118,0,1,0
14,438,438,17,14,3,2,1
8,453,453,11,11,0,1,0
17,466,466,120,100,20,3,2
5,476,476,26,3,23,2,1
0,477,477,14,14,0,1,0
10,493,493,127,67,60,4,3

11,104,104,6,6,0,1,0
13,121,121,7,7,0,1,0
25,127,127,7,7,0,1,0
22,139,139,33,21,12,2,1
26,151,151,15,7,8,3,2
7,162,162,24,20,4,2,1
14,223,223,46,46,0,1,0
12,235,235,16,16,0,1,0
24,245,245,8,8,0,1,0
5,253,253,51,24,27,2,1
17,287,287,3,3,0,1,0
20,290,290,55,28,27,4,3
9,293,293,8,3,5,2,1
3,301,301,5,5,0,1,0
18,303,303,15,15,0,1,0
1,325,325,1,1,0,1,0
4,326,326,32,15,17,2,1
19,353,353,3,3,0,1,0
15,380,380,151,85,66,4,3
21,389,389,15,15,0,1,0
10,421,421,67,59,8,3,2
6,421,421,59,24,35,2,1
8,460,460,134,134,0,1,0
23,462,462,2,2,0,1,0
2,465,465,71,11,60,4,3
16,475,475,20,20,0,1,0
0,476,476,18,6,12,4,3

10,102,102,2,2,0,1,0
28,106,106,26,26,0,1,0
17,118,118,14,6,8,3,2
18,122,122,10,2,8,3,2
6,155,155,1,1,0,1,0
29,169,169,22,3,19,2,1
34,191,191,25,1,24,2,1
2,222,222,37,37,0,1,0
16,245,245,21,5,16,2,1
33,261,261,55,31,24,4,3
35,263,263,3,3,0,1,0
8,281,281,2,2,0,1,0
22,286,286,3,3,0,1,0
1,290,290,11,7,4,2,1
0,300,300,20,2,18,3,2
13,308,308,27,27,0,1,0
4,317,317,11,8,3,2,1
26,317,317,4,4,0,1,0
14,322,322,2,2,0,1,0
7,331,331,62,23,39,2,1
27,333,333,31,17,14,3,2
31,333,333,5,1,4,2,1
11,353,353,14,8,6,3,2
25,373,373,63,63,0,1,0
12,374,374,1,1,0,1,0
9,385,385,11,5,6,3,2
20,388,388,2,2,0,1,0
21,421,421,75,52,23,2,1
23,434,434,27,27,0,1,0
24,435,435,31,31,0,1,0
19,445,445,51,9,42,4,3
15,463,463,25,4,21,2,1
5,464,464,18,11,7,2,1
3,481,481,16,6,10,2,1
30,491,491,39,8,31,2,1
32,498,498,94,94,0,1,0

24,102,102,19,2,17,2,1
27,117,117,25,25,0,1,0
16,125,125,4,4,0,1,0
22,136,136,34,34,0,1,0
13,145,145,43,43,0,1,0
9,158,158,6,6,0,1,0
28,166,166,1,1,0,1,0
11,168,168,1,1,0,1,0
6,189,189,16,16,0,1,0
23,208,208,17,5,12,2,1
15,212,212,2,2,0,1,0
18,214,214,6,6,0,1,0
29,223,223,4,4,0,1,0
26,225,225,16,16,0,1,0
20,231,231,4,4,0,1,0
3,244,244,1,1,0,1,0
30,244,244,51,9,42,4,3
7,251,251,6,3,3,2,1
12,265,265,5,5,0,1,0
25,287,287,22,22,0,1,0
14,305,305,112,52,60,4,3
10,308,308,4,4,0,1,0
4,309,309,72,39,33,2,1
19,330,330,45,1,44,2,1
0,331,331,25,25,0,1,0
5,333,333,1,1,0,1,0
1,358,358,35,17,18,3,2
17,387,387,15,3,12,3,2
21,390,390,40,40,0,1,0
31,419,419,14,14,0,1,0
2,481,481,9,9,0,1,0
8,494,494,20,3,17,3,2

18,106,106,12,4,8,3,2
25,152,152,4,4,0,1,0
19,176,176,4,4,0,1,0
14,185,185,3,3,0,1,0
6,186,186,2,2,0,1,0
11,197,197,4,1,3,2,1
26,212,212,51,37,14,3,2
10,224,224,53,19,34,4,3
2,238,238,44,11,33,4,3
5,241,241,47,47,0,1,0
22,248,248,2,2,0,1,0
0,268,268,6,6,0,1,0
9,274,274,16,16,0,1,0
12,320,320,10,2,8,3,2
15,328,328,6,6,0,1,0
23,333,333,48,48,0,1,0
4,362,362,32,8,24,4,3
1,366,366,8,5,3,2,1
21,376,376,85,34,51,4,3
17,402,402,28,14,14,3,2
20,411,411,18,5,13,4,3
7,422,422,88,88,0,1,0
24,438,438,42,7,35,4,3
16,461,461,183,183,0,1,0
3,462,462,87,87,0,1,0
8,478,478,65,55,10,2,1
13,494,494,7,7,0,1,0

12,144,144,12,6,6,3,2
13,159,159,21,1,20,2,1
24,163,163,21,21,0,1,0
21,166,166,9,9,0,1,0
0,169,169,17,17,0,1,0
19,184,184,18,18,0,1,0
8,219,219,35,18,17,2,1
7,225,225,13,3,10,2,1
1,232,232,1,1,0,1,0
16,245,245,57,27,30,4,3
3,264,264,14,6,8,2,1
9,276,276,18,18,0,1,0
17,276,276,47,23,24,3,2
4,301,301,60,60,0,1,0
18,359,359,5,5,0,1,0
10,364,364,124,83,41,2,1
2,367,367,1,1,0,1,0
23,380,380,25,7,18,3,2
20,399,399,50,50,0,1,0
22,411,411,36,36,0,1,0
14,463,463,26,26,0,1,0
15,464,464,26,26,0,1,0
5,466,466,121,49,72,4,3
11,494,494,1,1,0,1,0
6,494,494,77,53,24,4,3
25,496,496,67,67,0,1,0

9,103,103,2,2,0,1,0
5,107,107,10,10,0,1,0
20,110,110,55,41,14,3,2
10,117,117,6,1,5,2,1
25,129,129,48,48,0,1,0
19,129,129,10,10,0,1,0
3,145,145,10,10,0,1,0
0,169,169,15,4,11,2,1
21,176,176,1,1,0,1,0
16,210,210,32,32,0,1,0
11,216,216,2,2,0,1,0
22,251,251,6,6,0,1,0
2,272,272,8,8,0,1,0
14,280,280,4,4,0,1,0
4,282,282,43,43,0,1,0
13,314,314,3,3,0,1,0
23,315,315,9,9,0,1,0
6,337,337,44,44,0,1,0
24,342,342,42,17,25,2,1
12,346,346,9,6,3,2,1
18,354,354,6,6,0,1,0
26,354,354,1,1,0,1,0
7,367,367,120,86,34,4,3
1,389,389,80,80,0,1,0
15,410,410,6,6,0,1,0
17,466,466,41,25,16,2,1
8,484,484,96,96,0,1,0

26,101,101,23,9,14,2,1
17,134,134,33,33,0,1,0
20,141,141,8,8,0,1,0
5,145,145,6,6,0,1,0
27,162,162,19,19,0,1,0
25,164,164,10,4,6,3,2
24,166,166,7,7,0,1,0
11,187,187,53,35,18,3,2
0,216,216,3,3,0,1,0
4,229,229,144,144,0,1,0
7,245,245,9,1,8,2,1
2,269,269,4,4,0,1,0
9,282,282,13,13,0,1,0
19,287,287,6,1,5,2,1
10,293,293,21,21,0,1,0
8,300,300,40,20,20,4,3
1,319,319,23,23,0,1,0
23,320,320,2,2,0,1,0
3,326,326,1,1,0,1,0
6,334,334,12,3,9,4,3
22,340,340,65,65,0,1,0
12,364,364,3,3,0,1,0
21,382,382,10,3,7,2,1
14,401,401,57,41,16,2,1
16,414,414,33,23,10,2,1
18,437,437,34,34,0,1,0
15,444,444,64,64,0,1,0
13,445,445,5,5,0,1,0

6,105,105,1,1,0,1,0
18,106,106,7,1,6,2,1
27,114,114,29,24,5,2,1
16,128,128,9,3,6,3,2
19,134,134,3,3,0,1,0
0,163,163,3,3,0,1,0
3,171,171,15,8,7,2,1
20,185,185,15,15,0,1,0
13,205,205,10,10,0,1,0
10,223,223,15,15,0,1,0
23,227,227,19,11,8,3,2
7,228,228,11,3,8,2,1
17,237,237,44,9,35,2,1
26,242,242,25,5,20,3,2
11,242,242,9,3,6,3,2
24,257,257,86,86,0,1,0
5,278,278,119,55,64,3,2
15,285,285,21,11,10,2,1
8,317,317,66,66,0,1,0
22,319,319,8,8,0,1,0
4,409,409,2,2,0,1,0
2,414,414,6,6,0,1,0
25,416,416,15,2,13,2,1
28,428,428,15,3,12,2,1
14,441,441,41,41,0,1,0
9,451,451,4,4,0,1,0
21,464,464,27,9,18,4,3
12,485,485,135,12,123,4,3
1,496,496,24,24,0,1,0

18,131,131,59,59,0,1,0
16,150,150,3,3,0,1,0
6,196,196,66,66,0,1,0
23,221,221,9,4,5,2,1
0,229,229,55,29,26,2,1
4,244,244,5,5,0,1,0
7,253,253,43,28,15,4,3
20,269,269,14,6,8,2,1
11,275,275,25,12,13,2,1
24,305,305,95,81,14,4,3
15,305,305,12,4,8,2,1
8,308,308,28,16,12,3,2
17,323,323,51,51,0,1,0
10,353,353,20,20,0,1,0
12,354,354,7,7,0,1,0
25,401,401,9,6,3,2,1
5,421,421,44,44,0,1,0
22,434,434,65,56,9,2,1
3,435,435,2,2,0,1,0
2,441,441,8,8,0,1,0
13,442,442,19,19,0,1,0
14,460,460,14,14,0,1,0
19,465,465,34,34,0,1,0
1,481,481,5,5,0,1,0
9,483,483,125,106,19,4,3
21,491,491,7,7,0,1,0

25,101,101,20,20,0,1,0
10,103,103,1,1,0,1,0
8,104,104,7,7,0,1,0
14,109,109,6,6,0,1,0
6,142,142,22,13,9,2,1
17,142,142,13,13,0,1,0
18,197,197,32,13,19,4,3
9,210,210,9,9,0,1,0
1,224,224,2,2,0,1,0
13,247,247,17,17,0,1,0
12,252,252,80,37,43,3,2
24,255,255,13,13,0,1,0
0,275,275,26,26,0,1,0
15,279,279,13,13,0,1,0
22,289,289,29,7,22,2,1
5,311,311,12,12,0,1,0
19,334,334,25,13,12,4,3
20,351,351,107,29,78,4,3
16,362,362,2,2,0,1,0
3,393,393,25,13,12,3,2
21,414,414,6,6,0,1,0
23,416,416,45,3,42,3,2
2,422,422,20,11,9,4,3
11,432,432,51,51,0,1,0
4,444,444,49,19,30,4,3
26,447,447,69,21,48,4,3
7,479,479,158,76,82,3,2

8,119,119,1,1,0,1,0
10,125,125,4,4,0,1,0
21,147,147,13,13,0,1,0
23,183,183,22,22,0,1,0
24,189,189,20,20,0,1,0
14,218,218,30,2,28,2,1
27,232,232,11,7,4,2,1
22,234,234,33,33,0,1,0
2,247,247,29,11,18,3,2
19,250,250,8,8,0,1,0
25,262,262,34,34,0,1,0
7,268,268,1,1,0,1,0
12,303,303,81,31,50,3,2
0,306,306,9,1,8,2,1
17,322,322,21,3,18,2,1
18,348,348,33,1,32,3,2
13,369,369,179,86,93,4,3
28,374,374,11,6,5,2,1
29,388,388,37,11,26,2,1
9,416,416,6,3,3,2,1
15,434,434,9,1,8,2,1
16,436,436,29,10,19,2,1
5,440,440,18,18,0,1,0
20,446,446,49,49,0,1,0
11,452,452,12,12,0,1,0
26,453,453,136,136,0,1,0
6,470,470,37,16,21,4,3
3,474,474,8,5,3,2,1
4,499,499,16,10,6,3,2
1,499,499,45,22,23,2,1

21,103,103,19,2,17,4,3
17,109,109,3,3,0,1,0
16,123,123,7,7,0,1,0
2,128,128,14,14,0,1,0
28,141,141,5,5,0,1,0
6,176,176,10,10,0,1,0
29,179,179,23,23,0,1,0
8,189,189,6,6,0,1,0
14,195,195,6,6,0,1,0
7,200,200,32,18,14,3,2
5,218,218,7,7,0,1,0
18,219,219,17,17,0,1,0
13,222,222,10,4,6,2,1
27,224,224,7,7,0,1,0
9,253,253,39,31,8,3,2
25,257,257,17,4,13,2,1
11,267,267,10,2,8,2,1
0,298,298,86,77,9,4,3
23,298,298,39,39,0,1,0
4,320,320,7,7,0,1,0
1,358,358,35,10,25,2,1
3,359,359,44,22,22,2,1
19,384,384,85,85,0,1,0
12,417,417,55,15,40,2,1
22,429,429,26,11,15,2,1
24,437,437,84,84,0,1,0
26,477,477,30,30,0,1,0
15,494,494,36,6,30,3,2
20,496,496,78,78,0,1,0
10,496,496,4,4,0,1,0

9,153,153,4,1,3,2,1
18,170,170,13,13,0,1,0
7,177,177,63,63,0,1,0
17,191,191,6,3,3,2,1
21,193,193,17,17,0,1,0
16,197,197,8,8,0,1,0
4,211,211,9,1,8,3,2
1,212,212,13,13,0,1,0
3,217,217,11,11,0,1,0
12,224,224,53,53,0,1,0
23,268,268,28,25,3,2,1
8,302,302,83,19,64,3,2
2,321,321,103,77,26,3,2
15,339,339,7,7,0,1,0
13,352,352,20,5,15,4,3
11,406,406,26,17,9,2,1
22,411,411,142,64,78,4,3
0,414,414,61,22,39,4,3
14,426,426,32,32,0,1,0
20,434,434,38,11,27,2,1
19,463,463,57,57,0,1,0
10,469,469,33,24,9,2,1
6,493,493,29,26,3,2,1
5,498,498,33,26,7,2,1

23,102,102,3,3,0,1,0
22,119,119,5,5,0,1,0
25,123,123,21,1,20,2,1
11,136,136,10,10,0,1,0
6,168,168,9,3,6,3,2
9,197,197,3,3,0,1,0
27,239,239,11,3,8,3,2
4,239,239,24,24,0,1,0
20,257,257,13,13,0,1,0
14,292,292,60,60,0,1,0
13,303,303,26,10,16,3,2
8,319,319,10,10,0,1,0
10,331,331,10,7,3,2,1
0,334,334,7,1,6,3,2
3,334,334,4,4,0,1,0
5,354,354,61,43,18,4,3
17,373,373,116,116,0,1,0
21,387,387,1,1,0,1,0
28,392,392,43,19,24,3,2
7,393,393,60,60,0,1,0
16,403,403,3,3,0,1,0
19,434,434,42,42,0,1,0
18,440,440,43,43,0,1,0
24,449,449,35,35,0,1,0
12,455,455,53,23,30,3,2
15,458,458,23,23,0,1,0
29,466,466,20,11,9,2,1
2,470,470,12,12,0,1,0
26,487,487,164,164,0,1,0
1,489,489,125,92,33,2,1

5,115,115,12,4,8,2,1
22,136,136,23,8,15,4,3
31,138,138,32,14,18,2,1
24,142,142,7,7,0,1,0
16,160,160,1,1,0,1,0
7,170,170,4,4,0,1,0
28,173,173,32,14,18,3,2
4,187,187,18,15,3,2,1
9,195,195,20,20,0,1,0
1,197,197,15,15,0,1,0
2,199,199,9,9,0,1,0
26,199,199,57,57,0,1,0
27,206,206,9,9,0,1,0
23,212,212,2,2,0,1,0
12,217,217,10,4,6,3,2
3,220,220,18,6,12,4,3
17,226,226,12,12,0,1,0
10,247,247,62,19,43,2,1
6,254,254,7,7,0,1,0
25,257,257,10,10,0,1,0
20,269,269,1,1,0,1,0
8,284,284,36,36,0,1,0
0,284,284,6,1,5,2,1
11,284,284,45,12,33,4,3
30,305,305,31,28,3,2,1
14,321,321,8,3,5,2,1
19,322,322,45,17,28,2,1
15,350,350,50,28,22,2,1
21,433,433,39,3,36,4,3
13,440,440,7,7,0,1,0
29,455,455,23,23,0,1,0
18,486,486,17,17,0,1,0

17,108,108,12,12,0,1,0
31,120,120,22,5,17,2,1
24,124,124,1,1,0,1,0
19,125,125,2,2,0,1,0
15,141,141,2,2,0,1,0
26,170,170,1,1,0,1,0
5,184,184,3,3,0,1,0
28,190,190,8,8,0,1,0
14,204,204,76,76,0,1,0
32,206,206,27,7,20,3,2
23,230,230,35,35,0,1,0
0,240,240,48,43,5,2,1
10,248,248,35,9,26,2,1
12,251,251,3,3,0,1,0
30,259,259,10,6,4,2,1
27,264,264,20,20,0,1,0
25,265,265,25,19,6,2,1
9,267,267,8,4,4,2,1
33,268,268,9,9,0,1,0
21,312,312,88,88,0,1,0
4,330,330,15,15,0,1,0
1,361,361,22,7,15,4,3
29,367,367,62,62,0,1,0
6,391,391,4,4,0,1,0
11,393,393,1,1,0,1,0
22,401,401,13,13,0,1,0
18,412,412,11,11,0,1,0
3,431,431,34,25,9,4,3
13,435,435,20,6,14,3,2
7,445,445,17,4,13,2,1
8,470,470,39,15,24,2,1
2,472,472,27,27,0,1,0
16,491,491,22,22,0,1,0
20,500,500,97,31,66,4,3

6,115,115,17,17,0,1,0
26,122,122,2,2,0,1,0
4,126,126,9,9,0,1,0
22,131,131,8,8,0,1,0
3,150,150,22,4,18,4,3
21,163,163,6,6,0,1,0
8,174,174,15,1,14,2,1
7,179,179,19,15,4,2,1
5,199,199,54,54,0,1,0
9,205,205,34,34,0,1,0
14,209,209,1,1,0,1,0
19,247,247,14,4,10,2,1
12,273,273,5,5,0,1,0
24,275,275,47,33,14,2,1
1,289,289,8,8,0,1,0
11,301,301,19,1,18,4,3
18,303,303,22,22,0,1,0
10,304,304,26,2,24,2,1
0,343,343,24,24,0,1,0
17,356,356,22,22,0,1,0
13,357,357,12,4,8,2,1
16,382,382,9,9,0,1,0
23,390,390,54,54,0,1,0
20,422,422,147,78,69,3,2
27,429,429,74,56,18,3,2
28,449,449,49,49,0,1,0
15,458,458,12,12,0,1,0
25,475,475,62,62,0,1,0
2,483,483,51,51,0,1,0

11,122,122,2,2,0,1,0
5,142,142,48,8,40,3,2
10,150,150,19,12,7,2,1
23,167,167,9,2,7,2,1
19,203,203,8,8,0,1,0
18,223,223,40,15,25,2,1
21,241,241,63,9,54,3,2
16,269,269,39,39,0,1,0
8,275,275,1,1,0,1,0
12,286,286,2,2,0,1,0
3,315,315,29,29,0,1,0
9,321,321,39,26,13,3,2
17,329,329,6,6,0,1,0
24,329,329,3,3,0,1,0
20,331,331,33,27,6,3,2
2,340,340,54,54,0,1,0
25,342,342,92,46,46,3,2
0,369,369,40,36,4,2,1
4,371,371,117,58,59,4,3
15,392,392,74,8,66,3,2
13,475,475,48,48,0,1,0
6,492,492,1,1,0,1,0
22,494,494,12,1,11,2,1
1,499,499,17,17,0,1,0
14,500,500,13,13,0,1,0
7,500,500,44,5,39,3,2

1,104,104,25,25,0,1,0
25,175,175,2,2,0,1,0
4,183,183,3,3,0,1,0
10,217,217,1,1,0,1,0
8,217,217,18,14,4,2,1
5,228,228,54,39,15,4,3
15,237,237,29,5,24,4,3
2,256,256,32,5,27,4,3
24,276,276,4,4,0,1,0
23,299,299,57,51,6,3,2
11,309,309,48,48,0,1,0
3,313,313,24,3,21,4,3
22,321,321,33,24,9,2,1
20,341,341,41,22,19,2,1
17,345,345,15,3,12,3,2
16,349,349,17,6,11,2,1
13,362,362,26,26,0,1,0
6,366,366,16,16,0,1,0
14,407,407,69,21,48,2,1
7,413,413,55,11,44,2,1
18,426,426,44,38,6,2,1
26,446,446,80,80,0,1,0
9,453,453,6,2,4,2,1
21,460,460,106,7,99,4,3
12,479,479,107,61,46,4,3
0,479,479,24,18,6,3,2
19,498,498,6,3,3,2,1

23,111,111,5,5,0,1,0
15,111,111,17,17,0,1,0
11,117,117,5,1,4,2,1
26,122,122,20,20,0,1,0
32,151,151,3,3,0,1,0
31,151,151,10,1,9,4,3
28,151,151,14,14,0,1,0
16,155,155,6,6,0,1,0
1,162,162,12,1,11,2,1
17,165,165,21,7,14,3,2
34,167,167,16,16,0,1,0
7,179,179,8,8,0,1,0
18,185,185,14,1,13,4,3
29,212,212,4,4,0,1,0
25,212,212,48,21,27,2,1
20,221,221,8,4,4,2,1
21,224,224,16,16,0,1,0
10,224,224,28,22,6,3,2
24,244,244,28,28,0,1,0
5,246,246,5,2,3,2,1
9,247,247,13,5,8,3,2
27,265,265,21,9,12,4,3
2,307,307,112,87,25,2,1
4,344,344,7,7,0,1,0
0,360,360,11,8,3,2,1
13,365,365,2,2,0,1,0
3,368,368,19,19,0,1,0
12,368,368,22,13,9,4,3
19,376,376,3,3,0,1,0
30,383,383,3,3,0,1,0
33,420,420,62,62,0,1,0
22,421,421,121,94,27,2,1
6,426,426,1,1,0,1,0
14,432,432,5,5,0,1,0
8,493,493,28,5,23,2,1

13,103,103,26,10,16,3,2
4,108,108,1,1,0,1,0
24,109,109,37,9,28,3,2
7,125,125,22,22,0,1,0
28,153,153,14,14,0,1,0
14,172,172,4,4,0,1,0
19,210,210,10,10,0,1,0
12,243,243,9,5,4,2,1
8,244,244,1,1,0,1,0
10,264,264,22,22,0,1,0
11,270,270,35,9,26,3,2
6,282,282,6,6,0,1,0
2,328,328,36,17,19,2,1
0,337,337,30,30,0,1,0
17,346,346,49,49,0,1,0
5,347,347,6,6,0,1,0
18,361,361,11,11,0,1,0
3,367,367,102,102,0,1,0
20,371,371,11,11,0,1,0
22,372,372,18,6,12,2,1
23,397,397,83,35,48,2,1
26,401,401,31,31,0,1,0
16,407,407,83,83,0,1,0
9,410,410,45,1,44,2,1
15,415,415,38,38,0,1,0
27,446,446,43,13,30,4,3
1,452,452,28,28,0,1,0
25,457,457,3,3,0,1,0
21,479,479,8,8,0,1,0

19,104,104,8,8,0,1,0
24,114,114,28,10,18,2,1
16,115,115,16,16,0,1,0
10,116,116,3,3,0,1,0
33,145,145,53,9,44,3,2
7,158,158,3,3,0,1,0
3,159,159,12,6,6,3,2
17,163,163,1,1,0,1,0
25,197,197,2,2,0,1,0
21,207,207,2,2,0,1,0
27,247,247,3,3,0,1,0
26,255,255,11,5,6,2,1
11,288,288,14,14,0,1,0
5,301,301,31,28,3,2,1
8,309,309,5,5,0,1,0
0,312,312,94,94,0,1,0
13,314,314,12,12,0,1,0
6,329,329,4,4,0,1,0
2,335,335,8,8,0,1,0
1,337,337,23,23,0,1,0
18,353,353,4,4,0,1,0
23,364,364,45,12,33,4,3
34,372,372,59,59,0,1,0
15,388,388,17,7,10,2,1
20,394,394,7,7,0,1,0
9,398,398,82,64,18,4,3
29,405,405,47,47,0,1,0
28,410,410,2,2,0,1,0
31,433,433,12,2,10,2,1
12,446,446,29,9,20,3,2
30,469,469,56,49,7,2,1
14,474,474,9,9,0,1,0
4,491,491,41,26,15,4,3
22,497,497,92,71,21,4,3
32,499,499,3,3,0,1,0

4,118,118,4,4,0,1,0
1,126,126,15,7,8,3,2
7,148,148,5,5,0,1,0
17,155,155,7,3,4,2,1
6,156,156,5,5,0,1,0
18,165,165,19,19,0,1,0
9,169,169,1,1,0,1,0
14,184,184,11,5,6,2,1
24,194,194,50,4,46,2,1
20,221,221,5,5,0,1,0
2,236,236,23,17,6,3,2
19,253,253,4,4,0,1,0
16,294,294,22,17,5,2,1
0,304,304,35,35,0,1,0
23,318,318,34,6,28,3,2
3,321,321,56,19,37,2,1
13,345,345,75,75,0,1,0
25,349,349,43,43,0,1,0
15,359,359,12,12,0,1,0
12,360,360,119,79,40,3,2
21,376,376,63,63,0,1,0
11,422,422,14,10,4,2,1
5,433,433,29,29,0,1,0
22,472,472,58,35,23,2,1
26,479,479,35,26,9,4,3
10,487,487,17,1,16,3,2
8,499,499,162,40,122,4,3

14,117,117,11,5,6,3,2
0,121,121,5,5,0,1,0
11,124,124,8,8,0,1,0
12,140,140,33,6,27,4,3
28,143,143,24,24,0,1,0
6,166,166,1,1,0,1,0
31,171,171,11,11,0,1,0
23,172,172,41,1,40,2,1
29,185,185,3,3,0,1,0
19,187,187,44,44,0,1,0
1,197,197,16,16,0,1,0
8,207,207,1,1,0,1,0
24,213,213,11,11,0,1,0
15,220,220,14,2,12,3,2
18,222,222,18,2,16,3,2
16,223,223,9,4,5,2,1
17,237,237,14,2,12,3,2
30,263,263,25,7,18,3,2
9,276,276,40,40,0,1,0
22,305,305,9,9,0,1,0
21,370,370,7,7,0,1,0
25,370,370,32,7,25,4,3
13,376,376,1,1,0,1,0
4,377,377,59,59,0,1,0
3,378,378,47,47,0,1,0
10,392,392,77,17,60,4,3
7,403,403,5,1,4,2,1
20,415,415,25,10,15,3,2
2,425,425,13,13,0,1,0
5,458,458,20,10,10,2,1
27,460,460,56,10,46,3,2
26,473,473,75,75,0,1,0

22,149,149,5,5,0,1,0
9,150,150,19,1,18,2,1
5,152,152,7,7,0,1,0
21,174,174,1,1,0,1,0
23,204,204,8,1,7,2,1
0,212,212,37,5,32,3,2
2,214,214,36,27,9,2,1
15,218,218,14,14,0,1,0
20,238,238,21,9,12,2,1
4,246,246,14,14,0,1,0
24,285,285,27,19,8,3,2
16,299,299,17,3,14,2,1
13,301,301,6,3,3,2,1
1,305,305,14,14,0,1,0
10,352,352,60,60,0,1,0
6,356,356,27,27,0,1,0
18,358,358,10,10,0,1,0
17,366,366,156,156,0,1,0
8,371,371,98,34,64,3,2
14,377,377,18,9,9,2,1
11,396,396,6,6,0,1,0
12,427,427,189,162,27,4,3
19,441,441,29,17,12,4,3
3,443,443,11,11,0,1,0
7,500,500,124,58,66,4,3

4,134,134,5,5,0,1,0
8,150,150,24,24,0,1,0
23,152,152,20,10,10,2,1
1,158,158,22,13,9,4,3
20,184,184,10,4,6,3,2
5,189,189,10,10,0,1,0
16,189,189,24,24,0,1,0
25,196,196,51,41,10,3,2
9,205,205,12,1,11,2,1
29,225,225,12,12,0,1,0
26,226,226,5,2,3,2,1
18,230,230,38,16,22,2,1
24,245,245,41,14,27,4,3
0,262,262,74,45,29,4,3
12,262,262,4,4,0,1,0
17,265,265,4,1,3,2,1
11,294,294,3,3,0,1,0
19,295,295,15,15,0,1,0
14,302,302,24,24,0,1,0
27,310,310,76,76,0,1,0
15,316,316,17,10,7,2,1
10,321,321,2,2,0,1,0
21,324,324,24,24,0,1,0
28,397,397,11,2,9,4,3
3,412,412,6,6,0,1,0
2,416,416,52,52,0,1,0
7,436,436,117,3,114,4,3
13,448,448,35,35,0,1,0
6,487,487,10,10,0,1,0
22,495,495,16,1,15,2,1

0,138,138,16,16,0,1,0
6,170,170,86,86,0,1,0
15,172,172,13,13,0,1,0
5,198,198,42,6,36,2,1
8,212,212,8,2,6,3,2
2,213,213,41,15,26,2,1
22,218,218,56,56,0,1,0
10,224,224,2,2,0,1,0
9,264,264,34,34,0,1,0
20,297,297,1,1,0,1,0
17,332,332,2,2,0,1,0
14,339,339,50,50,0,1,0
16,340,340,91,91,0,1,0
1,340,340,51,51,0,1,0
3,346,346,38,38,0,1,0
11,353,353,36,12,24,4,3
21,378,378,22,22,0,1,0
13,395,395,20,20,0,1,0
7,407,407,31,1,30,4,3
12,422,422,61,61,0,1,0
19,474,474,65,23,42,3,2
18,489,489,20,20,0,1,0
4,492,492,2,2,0,1,0

24,106,106,5,5,0,1,0
16,112,112,5,2,3,2,1
20,137,137,15,15,0,1,0
9,137,137,4,1,3,2,1
18,138,138,24,24,0,1,0
11,140,140,25,7,18,2,1
7,156,156,5,5,0,1,0
1,157,157,2,2,0,1,0
5,159,159,30,30,0,1,0
21,160,160,20,8,12,2,1
13,173,173,14,5,9,2,1
8,179,179,16,16,0,1,0
23,186,186,8,8,0,1,0
12,223,223,3,3,0,1,0
2,228,228,1,1,0,1,0
25,243,243,64,56,8,2,1
14,246,246,18,18,0,1,0
15,260,260,32,32,0,1,0
22,271,271,39,1,38,4,3
6,272,272,34,1,33,2,1
3,310,310,111,111,0,1,0
10,373,373,92,92,0,1,0
0,373,373,32,32,0,1,0
19,415,415,61,46,15,4,3
17,451,451,21,17,4,2,1
4,478,478,24,24,0,1,0

21,101,101,14,5,9,4,3
12,138,138,5,5,0,1,0
1,138,138,18,2,16,3,2
22,141,141,45,21,24,3,2
28,151,151,3,3,0,1,0
23,155,155,19,15,4,2,1
26,158,158,9,9,0,1,0
25,167,167,20,6,14,2,1
0,178,178,32,32,0,1,0
11,243,243,2,2,0,1,0
16,271,271,15,15,0,1,0
10,284,284,41,41,0,1,0
24,291,291,4,4,0,1,0
19,320,320,33,23,10,3,2
2,327,327,36,36,0,1,0
15,335,335,4,4,0,1,0
5,337,337,20,14,6,3,2
18,343,343,2,2,0,1,0
13,343,343,1,1,0,1,0
20,347,347,4,4,0,1,0
27,352,352,35,24,11,2,1
9,386,386,35,35,0,1,0
3,393,393,21,21,0,1,0
7,425,425,30,30,0,1,0
4,426,426,49,5,44,3,2
6,448,448,23,23,0,1,0
17,458,458,126,126,0,1,0
29,468,468,40,1,39,2,1
8,471,471,133,84,49,2,1
14,496,496,27,5,22,2,1

15,117,117,6,2,4,2,1
22,146,146,22,22,0,1,0
21,175,175,19,19,0,1,0
2,207,207,34,34,0,1,0
7,210,210,2,2,0,1,0
17,223,223,8,8,0,1,0
20,245,245,12,12,0,1,0
11,295,295,19,15,4,2,1
0,314,314,7,7,0,1,0
12,320,320,15,15,0,1,0
8,326,326,13,13,0,1,0
10,344,344,16,16,0,1,0
3,345,345,70,19,51,4,3
6,360,360,11,11,0,1,0
1,363,363,47,8,39,2,1
14,378,378,49,49,0,1,0
16,400,400,32,8,24,2,1
9,402,402,106,14,92,3,2
24,409,409,19,5,14,2,1
13,409,409,108,90,18,2,1
5,427,427,3,3,0,1,0
26,432,432,18,10,8,2,1
18,433,433,65,23,42,4,3
23,465,465,81,81,0,1,0
25,474,474,65,65,0,1,0
4,489,489,183,183,0,1,0
19,491,491,4,4,0,1,0

13,113,113,8,8,0,1,0
28,116,116,1,1,0,1,0
18,128,128,29,29,0,1,0
15,129,129,3,3,0,1,0
3,166,166,2,2,0,1,0
4,209,209,67,67,0,1,0
7,234,234,8,8,0,1,0
12,236,236,1,1,0,1,0
27,238,238,8,8,0,1,0
23,249,249,31,2,29,3,2
26,252,252,17,2,15,4,3
1,257,257,8,4,4,2,1
11,258,258,104,21,83,4,3
20,277,277,3,3,0,1,0
25,286,286,34,13,21,4,3
9,296,296,46,46,0,1,0
5,302,302,10,1,9,3,2
17,305,305,25,2,23,2,1
24,349,349,58,2,56,3,2
6,376,376,16,16,0,1,0
21,384,384,51,51,0,1,0
2,393,393,16,16,0,1,0
19,419,419,5,2,3,2,1
16,435,435,68,46,22,2,1
8,440,440,34,6,28,3,2
0,447,447,54,54,0,1,0
22,468,468,125,73,52,3,2
14,479,479,22,13,9,2,1
10,497,497,5,5,0,1,0

13,117,117,10,4,6,3,2
25,119,119,13,13,0,1,0
28,137,137,13,13,0,1,0
26,148,148,19,19,0,1,0
3,151,151,27,27,0,1,0
34,151,151,18,2,16,3,2
23,166,166,13,1,12,4,3
11,192,192,12,6,6,3,2
21,221,221,26,2,24,4,3
14,225,225,32,32,0,1,0
9,228,228,9,9,0,1,0
27,294,294,80,2,78,3,2
30,314,314,5,5,0,1,0
0,319,319,9,9,0,1,0
17,324,324,8,8,0,1,0
6,331,331,4,4,0,1,0
19,344,344,39,39,0,1,0
8,346,346,53,53,0,1,0
10,349,349,30,30,0,1,0
12,351,351,20,20,0,1,0
22,358,358,26,7,19,2,1
33,366,366,15,15,0,1,0
20,366,366,66,38,28,3,2
7,374,374,30,9,21,2,1
31,381,381,93,68,25,2,1
24,382,382,4,1,3,2,1
16,388,388,5,5,0,1,0
18,390,390,12,12,0,1,0
2,401,401,36,6,30,3,2
4,420,420,1,1,0,1,0
29,443,443,33,33,0,1,0
32,451,451,20,7,13,2,1
5,459,459,2,2,0,1,0
1,466,466,2,2,0,1,0
15,490,490,6,6,0,1,0

2,129,129,18,6,12,3,2
28,131,131,2,2,0,1,0
19,150,150,14,7,7,2,1
16,157,157,1,1,0,1,0
7,159,159,12,12,0,1,0
29,169,169,32,17,15,4,3
9,183,183,20,20,0,1,0
13,197,197,17,17,0,1,0
4,210,210,27,20,7,2,1
1,225,225,16,16,0,1,0
25,247,247,19,13,6,2,1
5,272,272,51,8,43,3,2
18,306,306,6,6,0,1,0
26,315,315,17,17,0,1,0
30,316,316,15,1,14,3,2
11,320,320,23,3,20,4,3
20,323,323,13,3,10,2,1
27,334,334,71,71,0,1,0
3,336,336,1,1,0,1,0
0,345,345,44,38,6,2,1
15,347,347,45,45,0,1,0
12,373,373,19,3,16,3,2
8,383,383,18,9,9,2,1
23,386,386,49,31,18,4,3
24,393,393,33,33,0,1,0
22,429,429,49,49,0,1,0
21,444,444,8,4,4,2,1
6,470,470,18,18,0,1,0
14,495,495,28,2,26,3,2
10,498,498,37,4,33,2,1
17,499,499,163,112,51,4,3

25,100,100,8,8,0,1,0
0,103,103,16,3,13,2,1
15,124,124,17,17,0,1,0
11,133,133,3,3,0,1,0
29,138,138,1,1,0,1,0
32,151,151,24,24,0,1,0
9,161,161,11,6,5,2,1
13,164,164,4,1,3,2,1
10,168,168,6,6,0,1,0
12,185,185,2,2,0,1,0
8,194,194,47,1,46,3,2
18,206,206,15,7,8,3,2
30,207,207,41,17,24,3,2
19,230,230,47,32,15,2,1
20,237,237,40,24,16,3,2
16,263,263,8,8,0,1,0
7,269,269,17,8,9,2,1
5,270,270,26,4,22,2,1
1,281,281,9,9,0,1,0
14,300,300,15,8,7,2,1
26,329,329,48,48,0,1,0
31,331,331,17,1,16,2,1
6,335,335,42,42,0,1,0
24,346,346,45,29,16,3,2
22,350,350,1,1,0,1,0
4,350,350,49,28,21,2,1
17,359,359,7,7,0,1,0
27,405,405,37,7,30,4,3
21,406,406,36,36,0,1,0
28,419,419,17,17,0,1,0
2,470,470,9,9,0,1,0
3,480,480,28,6,22,3,2
23,488,488,35,35,0,1,0

1,129,129,1,1,0,1,0
9,131,131,3,3,0,1,0
22,138,138,8,8,0,1,0
4,152,152,12,12,0,1,0
27,161,161,1,1,0,1,0
5,180,180,6,2,4,2,1
28,180,180,25,22,3,2,1
30,194,194,6,2,4,2,1
23,196,196,15,2,13,2,1
7,248,248,79,67,12,2,1
24,250,250,13,13,0,1,0
17,256,256,7,2,5,2,1
8,268,268,34,34,0,1,0
20,273,273,103,61,42,4,3
21,289,289,71,52,19,2,1
19,297,297,7,7,0,1,0
11,304,304,21,9,12,4,3
12,331,331,1,1,0,1,0
14,333,333,28,28,0,1,0
13,360,360,20,20,0,1,0
3,362,362,45,28,17,4,3
18,365,365,20,20,0,1,0
25,397,397,31,3,28,2,1
2,400,400,84,14,70,4,3
0,415,415,38,38,0,1,0
16,439,439,37,37,0,1,0
15,473,473,8,2,6,2,1
6,484,484,28,28,0,1,0
26,487,487,71,71,0,1,0
29,496,496,55,34,21,4,3
10,498,498,8,4,4,2,1

26,128,128,2,2,0,1,0
14,163,163,11,11,0,1,0
3,188,188,59,10,49,3,2
2,190,190,12,12,0,1,0
9,193,193,1,1,0,1,0
22,198,198,15,3,12,2,1
19,205,205,50,50,0,1,0
4,216,216,13,13,0,1,0
17,223,223,63,63,0,1,0
6,239,239,4,4,0,1,0
23,239,239,35,35,0,1,0
11,246,246,8,8,0,1,0
10,261,261,38,34,4,2,1
25,268,268,17,17,0,1,0
18,278,278,39,39,0,1,0
21,299,299,5,5,0,1,0
0,307,307,91,19,72,3,2
5,311,311,18,18,0,1,0
13,322,322,11,11,0,1,0
24,332,332,4,4,0,1,0
16,338,338,3,3,0,1,0
15,401,401,15,15,0,1,0
20,401,401,111,17,94,4,3
7,414,414,117,43,74,3,2
12,425,425,1,1,0,1,0
8,433,433,16,9,7,2,1
1,461,461,41,41,0,1,0

17,135,135,8,8,0,1,0
9,140,140,4,4,0,1,0
26,149,149,36,26,10,3,2
5,159,159,1,1,0,1,0
6,159,159,1,1,0,1,0
18,159,159,15,15,0,1,0
8,182,182,7,7,0,1,0
11,217,217,36,36,0,1,0
27,233,233,40,40,0,1,0
12,244,244,39,7,32,2,1
20,261,261,49,49,0,1,0
7,262,262,64,3,61,4,3
3,269,269,2,2,0,1,0
16,278,278,6,6,0,1,0
15,309,309,16,8,8,3,2
28,314,314,22,22,0,1,0
29,317,317,58,58,0,1,0
4,322,322,112,61,51,4,3
0,322,322,1,1,0,1,0
19,324,324,5,5,0,1,0
21,342,342,7,7,0,1,0
13,345,345,46,46,0,1,0
10,374,374,39,39,0,1,0
23,415,415,13,5,8,2,1
1,426,426,16,4,12,4,3
22,430,430,1,1,0,1,0
25,430,430,64,41,23,2,1
24,435,435,79,79,0,1,0
14,453,453,12,3,9,2,1
2,454,454,18,2,16,3,2

15,102,102,9,1,8,2,1
9,107,107,3,3,0,1,0
18,110,110,9,9,0,1,0
13,139,139,5,5,0,1,0
0,147,147,25,25,0,1,0
12,147,147,26,26,0,1,0
5,197,197,14,14,0,1,0
2,222,222,5,2,3,2,1
3,223,223,17,17,0,1,0
14,234,234,58,8,50,4,3
10,276,276,60,39,21,4,3
20,298,298,6,6,0,1,0
17,332,332,24,24,0,1,0
4,359,359,83,53,30,3,2
21,375,375,103,55,48,3,2
1,379,379,170,144,26,3,2
11,390,390,4,4,0,1,0
19,402,402,37,37,0,1,0
7,405,405,133,53,80,4,3
6,437,437,23,15,8,2,1
8,442,442,11,1,10,2,1
16,463,463,30,30,0,1,0

8,104,104,6,1,5,2,1
6,123,123,9,1,8,3,2
4,124,124,5,5,0,1,0
1,135,135,38,2,36,4,3
25,144,144,6,2,4,2,1
9,151,151,6,6,0,1,0
7,169,169,8,8,0,1,0
13,169,169,25,13,12,3,2
26,170,170,14,8,6,2,1
15,184,184,3,3,0,1,0
24,196,196,11,11,0,1,0
18,255,255,1,1,0,1,0
29,266,266,18,18,0,1,0
22,284,284,61,18,43,2,1
27,291,291,25,25,0,1,0
10,302,302,5,5,0,1,0
12,321,321,13,4,9,3,2
20,321,321,19,19,0,1,0
30,326,326,66,10,56,3,2
28,336,336,79,52,27,2,1
21,338,338,4,4,0,1,0
23,346,346,56,47,9,4,3
2,346,346,2,2,0,1,0
0,348,348,37,37,0,1,0
19,379,379,35,15,20,3,2
16,384,384,28,12,16,3,2
3,447,447,71,24,47,2,1
5,470,470,3,3,0,1,0
14,481,481,36,36,0,1,0
17,483,483,52,52,0,1,0
11,487,487,105,105,0,1,0

12,108,108,18,18,0,1,0
19,126,126,4,4,0,1,0
9,149,149,22,22,0,1,0
23,160,160,1,1,0,1,0
17,194,194,6,6,0,1,0
1,201,201,4,4,0,1,0
7,207,207,38,38,0,1,0
5,207,207,27,27,0,1,0
24,208,208,14,14,0,1,0
6,214,214,3,3,0,1,0
15,229,229,5,5,0,1,0
21,253,253,48,48,0,1,0
10,281,281,1,1,0,1,0
20,330,330,53,53,0,1,0
3,331,331,16,16,0,1,0
22,336,336,35,35,0,1,0
8,383,383,24,3,21,2,1
25,397,397,109,109,0,1,0
4,411,411,118,18,100,3,2
16,417,417,36,17,19,2,1
18,430,430,27,27,0,1,0
0,433,433,81,81,0,1,0
11,451,451,136,40,96,3,2
14,491,491,58,10,48,2,1
2,492,492,8,8,0,1,0
13,497,497,53,53,0,1,0

24,100,100,23,23,0,1,0
7,105,105,18,18,0,1,0
8,110,110,6,6,0,1,0
0,121,121,18,7,11,2,1
25,134,134,3,3,0,1,0
4,149,149,44,18,26,2,1
17,158,158,32,17,15,3,2
1,159,159,19,19,0,1,0
12,180,180,15,5,10,3,2
19,195,195,9,9,0,1,0
18,211,211,11,2,9,4,3
22,285,285,7,2,5,2,1
21,286,286,81,61,20,3,2
5,294,294,15,15,0,1,0
2,303,303,7,7,0,1,0
23,310,310,15,15,0,1,0
26,317,317,71,3,68,3,2
13,347,347,10,7,3,2,1
10,349,349,9,9,0,1,0
27,376,376,16,1,15,4,3
15,384,384,31,13,18,2,1
14,385,385,47,30,17,2,1
9,385,385,1,1,0,1,0
3,411,411,2,2,0,1,0
16,412,412,22,22,0,1,0
11,422,422,43,43,0,1,0
28,436,436,1,1,0,1,0
6,496,496,83,44,39,4,3
20,500,500,61,35,26,3,2

10,100,100,16,16,0,1,0
2,105,105,8,3,5,2,1
7,115,115,4,1,3,2,1
27,130,130,3,3,0,1,0
28,135,135,3,3,0,1,0
5,146,146,13,13,0,1,0
6,149,149,28,10,18,4,3
26,153,153,5,5,0,1,0
8,158,158,3,3,0,1,0
24,169,169,13,10,3,2,1
30,176,176,6,6,0,1,0
29,206,206,29,6,23,2,1
19,224,224,23,3,20,3,2
12,244,244,26,7,19,3,2
3,246,246,12,2,10,2,1
22,281,281,25,25,0,1,0
20,290,290,42,4,38,2,1
13,291,291,4,1,3,2,1
21,296,296,61,47,14,2,1
23,314,314,24,24,0,1,0
4,315,315,43,3,40,3,2
15,339,339,60,37,23,2,1
1,377,377,4,4,0,1,0
0,391,391,8,8,0,1,0
18,400,400,25,25,0,1,0
9,405,405,29,1,28,2,1
16,421,421,16,8,8,3,2
14,427,427,2,2,0,1,0
11,430,430,89,89,0,1,0
25,485,485,106,106,0,1,0
17,500,500,102,69,33,2,1

21,114,114,11,11,0,1,0
32,116,116,5,1,4,2,1
33,127,127,20,10,10,2,1
10,127,127,1,1,0,1,0
28,135,135,15,15,0,1,0
26,137,137,10,2,8,2,1
29,168,168,18,18,0,1,0
4,179,179,78,24,54,3,2
9,224,224,3,3,0,1,0
31,225,225,6,6,0,1,0
27,246,246,26,6,20,3,2
12,253,253,5,5,0,1,0
24,267,267,16,16,0,1,0
7,292,292,52,52,0,1,0
14,298,298,11,11,0,1,0
11,302,302,1,1,0,1,0
0,317,317,12,12,0,1,0
34,318,318,20,20,0,1,0
25,341,341,31,7,24,2,1
23,347,347,6,6,0,1,0
20,387,387,29,29,0,1,0
18,387,387,43,13,30,2,1
13,387,387,7,1,6,3,2
6,388,388,1,1,0,1,0
5,392,392,6,1,5,2,1
30,403,403,137,137,0,1,0
1,429,429,17,17,0,1,0
22,433,433,61,31,30,2,1
15,438,438,12,12,0,1,0
2,440,440,53,35,18,4,3
19,457,457,14,14,0,1,0
17,463,463,1,1,0,1,0
8,463,463,60,11,49,2,1
3,495,495,15,15,0,1,0
16,497,497,33,33,0,1,0

14,100,100,2,2,0,1,0
13,119,119,6,1,5,2,1
29,120,120,3,3,0,1,0
21,144,144,1,1,0,1,0
18,148,148,6,6,0,1,0
32,168,168,2,2,0,1,0
7,200,200,25,10,15,2,1
31,207,207,51,27,24,4,3
17,207,207,2,2,0,1,0
6,208,208,8,1,7,2,1
20,233,233,54,54,0,1,0
11,260,260,10,10,0,1,0
0,263,263,66,21,45,2,1
23,276,276,48,48,0,1,0
27,284,284,20,13,7,2,1
19,312,312,18,11,7,2,1
15,324,324,8,8,0,1,0
2,331,331,8,8,0,1,0
12,332,332,49,49,0,1,0
9,332,332,2,2,0,1,0
3,337,337,6,2,4,2,1
22,340,340,107,64,43,3,2
25,342,342,1,1,0,1,0
16,350,350,44,25,19,2,1
26,391,391,34,34,0,1,0
1,395,395,29,4,25,2,1
30,402,402,48,34,14,3,2
4,403,403,38,23,15,2,1
5,441,441,73,31,42,3,2
28,443,443,21,4,17,2,1
24,444,444,14,14,0,1,0
10,490,490,33,33,0,1,0
8,497,497,43,43,0,1,0

2,105,105,9,9,0,1,0
8,125,125,6,6,0,1,0
19,125,125,45,45,0,1,0
26,136,136,4,4,0,1,0
24,150,150,3,3,0,1,0
22,156,156,57,5,52,3,2
9,164,164,5,2,3,2,1
21,188,188,3,3,0,1,0
18,190,190,4,4,0,1,0
7,234,234,61,17,44,4,3
20,242,242,1,1,0,1,0
4,252,252,4,4,0,1,0
16,266,266,1,1,0,1,0
27,269,269,5,1,4,2,1
17,277,277,49,49,0,1,0
23,300,300,68,32,36,3,2
0,313,313,2,2,0,1,0
28,317,317,35,35,0,1,0
25,332,332,19,13,6,3,2
11,364,364,59,59,0,1,0
3,374,374,31,13,18,2,1
13,379,379,7,2,5,2,1
15,387,387,9,3,6,2,1
6,391,391,109,70,39,2,1
12,411,411,9,2,7,2,1
10,441,441,39,15,24,2,1
5,459,459,12,3,9,4,3
14,484,484,21,10,11,2,1
1,496,496,115,115,0,1,0

20,124,124,18,18,0,1,0
14,127,127,38,20,18,3,2
12,129,129,3,3,0,1,0
15,149,149,15,3,12,3,2
10,160,160,16,16,0,1,0
6,188,188,3,3,0,1,0
23,190,190,19,19,0,1,0
2,205,205,27,4,23,2,1
26,212,212,12,12,0,1,0
18,245,245,23,23,0,1,0
1,258,258,42,42,0,1,0
19,289,289,5,1,4,2,1
11,293,293,49,3,46,4,3
9,306,306,14,3,11,2,1
13,309,309,32,12,20,3,2
5,315,315,19,19,0,1,0
0,334,334,40,1,39,2,1
25,334,334,10,4,6,2,1
7,334,334,14,7,7,2,1
22,344,344,23,23,0,1,0
21,359,359,67,61,6,3,2
24,384,384,2,2,0,1,0
16,411,411,64,55,9,4,3
17,448,448,27,17,10,2,1
4,454,454,143,107,36,4,3
3,492,492,2,2,0,1,0
8,496,496,108,12,96,3,2

3,100,100,11,11,0,1,0
20,123,123,27,27,0,1,0
0,124,124,2,2,0,1,0
2,134,134,28,6,22,2,1
4,139,139,2,2,0,1,0
9,146,146,6,6,0,1,0
5,169,169,1,1,0,1,0
25,215,215,37,37,0,1,0
22,232,232,2,2,0,1,0
13,284,284,21,21,0,1,0
7,285,285,6,6,0,1,0
19,312,312,15,5,10,3,2
23,315,315,4,4,0,1,0
15,346,346,3,3,0,1,0
14,360,360,22,22,0,1,0
10,370,370,18,4,14,3,2
12,371,371,9,9,0,1,0
17,380,380,62,41,21,4,3
21,405,405,16,7,9,2,1
8,412,412,23,23,0,1,0
11,413,413,144,42,102,4,3
1,413,413,24,15,9,4,3
24,414,414,72,72,0,1,0
26,440,440,82,70,12,4,3
6,448,448,201,201,0,1,0
16,460,460,107,56,51,4,3
18,483,483,9,9,0,1,0

13,105,105,19,19,0,1,0
19,109,109,24,24,0,1,0
9,117,117,3,3,0,1,0
28,130,130,1,1,0,1,0
27,143,143,16,7,9,4,3
10,188,188,13,13,0,1,0
17,229,229,14,8,6,3,2
12,243,243,12,12,0,1,0
24,249,249,37,37,0,1,0
21,250,250,11,3,8,2,1
7,263,263,11,3,8,3,2
16,265,265,55,55,0,1,0
25,266,266,6,6,0,1,0
11,272,272,1,1,0,1,0
0,281,281,5,5,0,1,0
1,293,293,50,10,40,3,2
18,308,308,20,10,10,2,1
4,312,312,1,1,0,1,0
22,328,328,15,15,0,1,0
14,359,359,119,119,0,1,0
5,385,385,34,34,0,1,0
20,388,388,36,20,16,3,2
26,405,405,69,17,52,3,2
3,410,410,40,3,37,2,1
8,427,427,37,12,25,2,1
2,428,428,97,45,52,3,2
23,446,446,20,6,14,2,1
15,446,446,82,30,52,4,3
6,461,461,4,4,0,1,0

27,101,101,1,1,0,1,0
23,112,112,17,11,6,3,2
8,121,121,6,6,0,1,0
7,125,125,9,3,6,3,2
1,134,134,13,3,10,3,2
21,139,139,11,11,0,1,0
24,142,142,35,4,31,2,1
4,148,148,3,3,0,1,0
15,150,150,21,21,0,1,0
33,184,184,26,14,12,3,2
35,189,189,21,21,0,1,0
2,247,247,8,1,7,2,1
5,253,253,86,79,7,2,1
16,255,255,39,39,0,1,0
20,256,256,25,25,0,1,0
3,281,281,2,2,0,1,0
30,290,290,2,2,0,1,0
25,291,291,34,16,18,4,3
14,301,301,4,4,0,1,0
17,308,308,19,10,9,4,3
29,322,322,18,13,5,2,1
9,362,362,14,14,0,1,0
22,389,389,6,6,0,1,0
28,391,391,49,49,0,1,0
31,412,412,33,33,0,1,0
0,412,412,1,1,0,1,0
18,417,417,20,4,16,2,1
6,421,421,1,1,0,1,0
32,424,424,94,94,0,1,0
26,431,431,15,15,0,1,0
12,448,448,6,6,0,1,0
10,449,449,18,18,0,1,0
34,451,451,52,31,21,4,3
19,460,460,21,21,0,1,0
13,469,469,13,13,0,1,0
11,470,470,9,2,7,2,1

10,118,118,15,15,0,1,0
4,153,153,24,18,6,3,2
13,158,158,61,28,33,2,1
12,169,169,24,24,0,1,0
20,172,172,10,10,0,1,0
6,208,208,102,89,13,2,1
9,218,218,1,1,0,1,0
19,231,231,21,16,5,2,1
3,239,239,81,81,0,1,0
2,250,250,9,9,0,1,0
21,250,250,40,30,10,2,1
16,252,252,12,5,7,2,1
17,271,271,11,11,0,1,0
18,323,323,7,7,0,1,0
14,354,354,66,58,8,2,1
22,360,360,32,5,27,4,3
5,401,401,18,4,14,3,2
0,406,406,28,6,22,3,2
15,469,469,25,11,14,3,2
8,470,470,13,13,0,1,0
1,483,483,18,18,0,1,0
7,493,493,99,99,0,1,0
11,495,495,12,4,8,2,1

10,103,103,4,4,0,1,0
28,104,104,1,1,0,1,0
26,123,123,15,15,0,1,0
6,134,134,1,1,0,1,0
17,135,135,12,12,0,1,0
0,208,208,8,4,4,2,1
1,215,215,35,23,12,2,1
13,241,241,4,4,0,1,0
8,241,241,2,2,0,1,0
21,249,249,27,23,4,2,1
18,258,258,8,8,0,1,0
5,289,289,52,38,14,3,2
12,295,295,9,9,0,1,0
4,309,309,8,8,0,1,0
7,309,309,90,14,76,3,2
14,327,327,31,31,0,1,0
16,329,329,10,10,0,1,0
11,356,356,4,4,0,1,0
27,380,380,38,38,0,1,0
25,407,407,26,23,3,2,1
20,413,413,59,59,0,1,0
2,414,414,1,1,0,1,0
19,415,415,3,3,0,1,0
15,420,420,45,45,0,1,0
22,450,450,190,154,36,4,3
23,464,464,34,34,0,1,0
24,482,482,63,63,0,1,0
9,496,496,94,19,75,4,3
3,497,497,151,103,48,2,1

13,106,106,1,1,0,1,0
1,113,113,1,1,0,1,0
25,113,113,2,2,0,1,0
17,121,121,4,4,0,1,0
0,123,123,12,7,5,2,1
16,123,123,8,8,0,1,0
4,152,152,17,5,12,3,2
9,152,152,1,1,0,1,0
8,173,173,50,50,0,1,0
14,176,176,31,19,12,2,1
27,196,196,25,25,0,1,0
22,208,208,6,6,0,1,0
24,216,216,64,16,48,4,3
23,248,248,1,1,0,1,0
6,263,263,19,19,0,1,0
21,269,269,29,1,28,2,1
7,292,292,13,2,11,2,1
5,312,312,33,30,3,2,1
2,325,325,21,5,16,2,1
26,328,328,75,57,18,4,3
19,354,354,22,19,3,2,1
12,358,358,76,63,13,2,1
18,370,370,69,26,43,4,3
3,378,378,83,61,22,2,1
11,384,384,33,33,0,1,0
10,393,393,31,1,30,3,2
15,448,448,17,17,0,1,0
20,478,478,28,28,0,1,0

28,100,100,1,1,0,1,0
1,104,104,1,1,0,1,0
12,134,134,4,4,0,1,0
24,145,145,1,1,0,1,0
25,150,150,26,26,0,1,0
22,163,163,28,28,0,1,0
15,164,164,1,1,0,1,0
14,170,170,25,10,15,2,1
23,174,174,8,8,0,1,0
27,186,186,18,11,7,3,2
16,219,219,28,5,23,3,2
21,241,241,31,7,24,3,2
17,253,253,4,1,3,2,1
11,257,257,88,88,0,1,0
3,260,260,28,28,0,1,0
9,297,297,48,42,6,3,2
18,303,303,27,21,6,2,1
10,321,321,17,2,15,3,2
13,345,345,14,2,12,2,1
0,357,357,16,8,8,2,1
8,390,390,4,1,3,2,1
2,414,414,22,22,0,1,0
4,433,433,36,36,0,1,0
19,436,436,45,45,0,1,0
5,444,444,85,85,0,1,0
7,468,468,1,1,0,1,0
20,473,473,2,2,0,1,0
29,481,481,117,68,49,2,1
26,481,481,101,101,0,1,0
6,500,500,59,59,0,1,0

20,108,108,8,3,5,2,1
0,118,118,7,7,0,1,0
4,130,130,8,8,0,1,0
8,130,130,14,4,10,2,1
15,139,139,6,6,0,1,0
19,143,143,18,4,14,2,1
14,146,146,53,53,0,1,0
9,151,151,12,12,0,1,0
7,163,163,1,1,0,1,0
3,175,175,2,2,0,1,0
22,180,180,16,7,9,3,2
5,202,202,25,14,11,2,1
13,210,210,4,4,0,1,0
10,250,250,2,2,0,1,0
6,256,256,9,1,8,2,1
23,257,257,34,14,20,3,2
21,259,259,29,29,0,1,0
26,272,272,45,10,35,2,1
11,281,281,25,16,9,4,3
16,290,290,57,11,46,4,3
17,299,299,3,3,0,1,0
28,306,306,23,23,0,1,0
27,335,335,59,22,37,2,1
12,335,335,82,82,0,1,0
24,393,393,68,68,0,1,0
25,434,434,11,11,0,1,0
1,444,444,38,38,0,1,0
18,461,461,18,18,0,1,0
2,470,470,52,18,34,3,2

4,101,101,7,7,0,1,0
24,110,110,13,13,0,1,0
23,113,113,8,8,0,1,0
9,126,126,2,2,0,1,0
10,133,133,16,16,0,1,0
5,149,149,4,4,0,1,0
18,163,163,23,23,0,1,0
14,168,168,6,2,4,2,1
20,176,176,20,6,14,2,1
28,193,193,9,9,0,1,0
8,213,213,8,2,6,2,1
19,232,232,28,28,0,1,0
27,249,249,22,5,17,2,1
22,252,252,8,1,7,2,1
11,266,266,11,3,8,2,1
17,294,294,2,2,0,1,0
2,310,310,63,39,24,4,3
1,313,313,115,82,33,3,2
3,314,314,15,15,0,1,0
26,336,336,82,61,21,4,3
12,341,341,55,55,0,1,0
16,365,365,87,3,84,4,3
0,369,369,7,7,0,1,0
15,389,389,43,43,0,1,0
7,410,410,7,7,0,1,0
6,415,415,59,23,36,4,3
25,421,421,15,3,12,2,1
21,458,458,27,18,9,2,1
13,489,489,47,47,0,1,0

21,109,109,10,10,0,1,0
7,122,122,7,7,0,1,0
4,124,124,2,2,0,1,0
30,142,142,10,4,6,3,2
3,143,143,8,8,0,1,0
11,146,146,21,1,20,3,2
6,160,160,5,5,0,1,0
0,179,179,4,4,0,1,0
10,218,218,6,6,0,1,0
19,239,239,18,13,5,2,1
23,239,239,2,2,0,1,0
9,243,243,47,8,39,4,3
26,246,246,52,52,0,1,0
15,265,265,56,56,0,1,0
5,268,268,13,5,8,3,2
2,281,281,38,38,0,1,0
17,290,290,119,99,20,2,1
13,293,293,16,6,10,3,2
1,296,296,48,11,37,2,1
22,321,321,11,6,5,2,1
18,359,359,4,4,0,1,0
24,378,378,31,31,0,1,0
29,382,382,32,28,4,2,1
27,410,410,13,4,9,2,1
28,428,428,39,21,18,2,1
12,448,448,82,63,19,2,1
20,462,462,51,33,18,3,2
16,469,469,2,2,0,1,0
8,479,479,10,4,6,2,1
25,481,481,52,28,24,4,3
14,496,496,16,16,0,1,0

14,101,101,1,1,0,1,0
1,113,113,2,2,0,1,0
17,129,129,9,3,6,2,1
25,136,136,5,5,0,1,0
20,143,143,31,9,22,3,2
21,171,171,13,13,0,1,0
5,180,180,21,21,0,1,0
15,192,192,22,8,14,3,2
24,205,205,1,1,0,1,0
19,251,251,17,17,0,1,0
12,254,254,4,4,0,1,0
11,261,261,6,6,0,1,0
2,263,263,7,7,0,1,0
16,272,272,44,44,0,1,0
6,291,291,31,15,16,3,2
0,315,315,40,40,0,1,0
28,337,337,21,21,0,1,0
22,345,345,18,6,12,4,3
29,355,355,72,72,0,1,0
8,369,369,3,3,0,1,0
13,382,382,7,1,6,2,1
23,396,396,71,9,62,3,2
10,416,416,11,11,0,1,0
30,435,435,40,4,36,2,1
18,436,436,31,31,0,1,0
9,447,447,38,38,0,1,0
3,465,465,4,4,0,1,0
4,475,475,238,139,99,4,3
26,479,479,82,36,46,3,2
27,493,493,60,29,31,2,1
7,496,496,18,18,0,1,0

15,100,100,16,16,0,1,0
3,128,128,3,3,0,1,0
13,137,137,1,1,0,1,0
8,158,158,24,24,0,1,0
16,182,182,23,23,0,1,0
19,202,202,3,3,0,1,0
21,206,206,7,7,0,1,0
11,208,208,20,5,15,4,3
25,233,233,5,5,0,1,0
10,256,256,42,3,39,4,3
0,259,259,48,48,0,1,0
18,286,286,29,17,12,3,2
22,296,296,22,10,12,2,1
1,303,303,7,7,0,1,0
23,334,334,18,2,16,3,2
28,345,345,23,23,0,1,0
27,352,352,31,31,0,1,0
14,357,357,12,12,0,1,0
6,386,386,22,11,11,3,2
4,398,398,112,12,100,3,2
20,404,404,14,14,0,1,0
5,407,407,28,20,8,2,1
26,429,429,19,19,0,1,0
2,440,440,23,23,0,1,0
24,442,442,205,91,114,4,3
17,446,446,63,63,0,1,0
9,449,449,15,4,11,4,3
12,470,470,77,5,72,3,2
7,491,491,30,30,0,1,0

20,100,100,1,1,0,1,0
15,105,105,2,2,0,1,0
12,162,162,15,15,0,1,0
6,179,179,10,10,0,1,0
1,225,225,44,44,0,1,0
7,234,234,57,57,0,1,0
19,259,259,31,31,0,1,0
22,263,263,22,4,18,2,1
8,267,267,21,7,14,3,2
17,277,277,16,2,14,2,1
3,293,293,6,6,0,1,0
5,295,295,44,20,24,2,1
0,330,330,10,10,0,1,0
18,346,346,24,24,0,1,0
25,376,376,45,11,34,2,1
23,393,393,115,7,108,4,3
21,398,398,57,51,6,3,2
11,402,402,46,46,0,1,0
4,414,414,2,2,0,1,0
24,431,431,23,19,4,2,1
2,435,435,84,84,0,1,0
9,445,445,134,134,0,1,0
14,457,457,148,81,67,3,2
10,468,468,7,7,0,1,0
16,481,481,1,1,0,1,0
13,485,485,23,6,17,2,1

15,108,108,7,7,0,1,0
19,136,136,21,15,6,2,1
4,145,145,20,20,0,1,0
25,150,150,42,38,4,2,1
10,158,158,18,18,0,1,0
20,173,173,27,3,24,4,3
12,177,177,1,1,0,1,0
14,184,184,21,21,0,1,0
21,185,185,17,9,8,3,2
23,216,216,21,6,15,2,1
2,221,221,84,84,0,1,0
7,225,225,13,13,0,1,0
18,244,244,13,13,0,1,0
6,250,250,9,9,0,1,0
13,303,303,11,11,0,1,0
5,306,306,3,3,0,1,0
1,332,332,16,16,0,1,0
27,332,332,42,42,0,1,0
11,336,336,51,38,13,2,1
28,347,347,5,5,0,1,0
3,349,349,36,36,0,1,0
26,383,383,4,4,0,1,0
24,402,402,36,30,6,2,1
22,424,424,17,12,5,2,1
8,434,434,8,8,0,1,0
9,443,443,36,36,0,1,0
29,455,455,50,42,8,3,2
0,456,456,20,20,0,1,0
16,469,469,25,7,18,3,2
17,480,480,72,72,0,1,0

27,102,102,12,12,0,1,0
5,124,124,12,12,0,1,0
11,139,139,33,18,15,2,1
6,150,150,7,2,5,2,1
12,152,152,6,6,0,1,0
30,198,198,15,15,0,1,0
2,202,202,2,2,0,1,0
17,205,205,36,36,0,1,0
26,207,207,30,30,0,1,0
18,222,222,2,2,0,1,0
10,263,263,4,4,0,1,0
7,264,264,6,6,0,1,0
0,293,293,5,5,0,1,0
3,304,304,27,9,18,2,1
19,304,304,14,14,0,1,0
9,305,305,12,12,0,1,0
1,321,321,52,37,15,4,3
23,341,341,7,7,0,1,0
21,342,342,32,11,21,4,3
14,352,352,38,38,0,1,0
29,361,361,44,34,10,2,1
13,362,362,10,10,0,1,0
28,370,370,43,13,30,2,1
24,430,430,122,94,28,4,3
15,444,444,5,2,3,2,1
22,447,447,54,39,15,2,1
8,451,451,34,34,0,1,0
4,471,471,126,60,66,4,3
20,484,484,15,15,0,1,0
16,487,487,66,66,0,1,0
25,494,494,37,37,0,1,0

10,114,114,16,16,0,1,0
2,120,120,3,3,0,1,0
3,127,127,3,3,0,1,0
11,131,131,6,6,0,1,0
5,142,142,1,1,0,1,0
0,150,150,23,13,10,2,1
18,172,172,35,35,0,1,0
4,200,200,23,23,0,1,0
24,243,243,16,16,0,1,0
15,246,246,10,10,0,1,0
20,263,263,13,13,0,1,0
17,264,264,14,14,0,1,0
14,286,286,34,34,0,1,0
22,299,299,34,34,0,1,0
25,309,309,52,28,24,3,2
1,340,340,33,6,27,2,1
7,343,343,6,2,4,2,1
23,347,347,24,7,17,2,1
9,373,373,81,3,78,4,3
13,392,392,111,60,51,3,2
6,397,397,36,27,9,4,3
21,443,443,6,6,0,1,0
26,444,444,35,35,0,1,0
16,462,462,15,3,12,3,2
12,487,487,67,8,59,3,2
8,494,494,163,97,66,4,3
19,497,497,67,67,0,1,0

30,117,117,10,1,9,4,3
18,118,118,12,12,0,1,0
27,119,119,3,3,0,1,0
7,150,150,7,7,0,1,0
15,154,154,25,1,24,3,2
13,195,195,24,15,9,4,3
6,201,201,58,14,44,2,1
0,210,210,5,1,4,2,1
3,218,218,3,3,0,1,0
19,242,242,70,70,0,1,0
17,246,246,55,55,0,1,0
11,262,262,12,1,11,4,3
26,275,275,19,19,0,1,0
10,277,277,3,3,0,1,0
25,280,280,45,11,34,4,3
2,281,281,5,2,3,2,1
12,319,319,101,92,9,4,3
16,351,351,17,17,0,1,0
4,385,385,53,23,30,3,2
21,410,410,12,12,0,1,0
24,415,415,24,12,12,4,3
5,450,450,9,6,3,2,1
9,454,454,21,21,0,1,0
8,463,463,21,21,0,1,0
1,466,466,1,1,0,1,0
14,471,471,25,3,22,2,1
29,477,477,35,9,26,2,1
23,486,486,16,16,0,1,0
22,490,490,108,77,31,2,1
20,493,493,25,25,0,1,0
28,497,497,4,4,0,1,0

11,107,107,4,4,0,1,0
23,111,111,21,21,0,1,0
17,114,114,9,9,0,1,0
4,131,131,6,2,4,2,1
13,165,165,10,3,7,2,1
6,203,203,30,30,0,1,0
9,207,207,4,4,0,1,0
24,237,237,19,5,14,2,1
25,266,266,10,10,0,1,0
19,277,277,23,4,19,2,1
29,283,283,2,2,0,1,0
20,291,291,28,8,20,3,2
10,293,293,1,1,0,1,0
14,311,311,42,42,0,1,0
0,316,316,5,5,0,1,0
3,321,321,105,20,85,4,3
18,354,354,60,60,0,1,0
2,365,365,6,6,0,1,0
15,375,375,78,66,12,4,3
12,393,393,3,3,0,1,0
7,396,396,25,3,22,2,1
16,409,409,24,16,8,3,2
27,414,414,37,3,34,3,2
21,424,424,21,21,0,1,0
5,426,426,63,11,52,3,2
1,456,456,10,10,0,1,0
8,457,457,3,3,0,1,0
30,458,458,146,146,0,1,0
28,471,471,12,12,0,1,0
22,481,481,60,24,36,4,3
26,486,486,26,26,0,1,0
31,497,497,46,46,0,1,0

17,104,104,1,1,0,1,0
2,128,128,7,4,3,2,1
24,158,158,9,9,0,1,0
20,182,182,10,1,9,2,1
26,204,204,9,9,0,1,0
6,218,218,44,10,34,2,1
11,231,231,37,37,0,1,0
14,242,242,15,1,14,3,2
8,252,252,58,58,0,1,0
7,284,284,18,2,16,3,2
10,286,286,19,4,15,4,3
13,299,299,81,33,48,2,1
18,308,308,37,21,16,3,2
1,347,347,6,6,0,1,0
9,379,379,46,27,19,2,1
19,403,403,160,103,57,4,3
25,433,433,52,14,38,2,1
3,436,436,47,5,42,4,3
16,438,438,4,1,3,2,1
23,441,441,49,49,0,1,0
4,449,449,45,45,0,1,0
22,453,453,36,8,28,3,2
12,454,454,44,44,0,1,0
15,473,473,9,9,0,1,0
0,473,473,63,50,13,2,1
5,479,479,23,2,21,4,3
21,491,491,36,36,0,1,0

10,101,101,12,12,0,1,0
7,122,122,1,1,0,1,0
12,124,124,15,6,9,3,2
5,128,128,24,4,20,4,3
13,135,135,30,26,4,2,1
20,157,157,1,1,0,1,0
1,164,164,8,4,4,2,1
23,171,171,2,2,0,1,0
29,216,216,2,2,0,1,0
28,232,232,15,15,0,1,0
30,240,240,64,7,57,4,3
6,256,256,1,1,0,1,0
4,257,257,23,9,14,3,2
3,261,261,61,61,0,1,0
8,292,292,1,1,0,1,0
21,329,329,49,4,45,2,1
19,368,368,8,8,0,1,0
24,381,381,84,84,0,1,0
9,385,385,38,34,4,2,1
25,389,389,70,70,0,1,0
17,391,391,11,3,8,3,2
27,394,394,14,14,0,1,0
18,395,395,3,3,0,1,0
2,406,406,1,1,0,1,0
15,406,406,14,14,0,1,0
22,470,470,111,18,93,4,3
11,471,471,28,22,6,3,2
14,477,477,19,19,0,1,0
26,483,483,88,72,16,2,1
0,492,492,22,7,15,2,1
16,495,495,42,42,0,1,0

13,102,102,5,5,0,1,0
2,111,111,17,9,8,2,1
20,113,113,13,6,7,2,1
24,115,115,14,14,0,1,0
22,120,120,19,19,0,1,0
31,132,132,24,24,0,1,0
23,132,132,9,9,0,1,0
5,134,134,3,3,0,1,0
0,151,151,6,6,0,1,0
8,181,181,31,7,24,3,2
12,193,193,1,1,0,1,0
1,203,203,9,9,0,1,0
15,210,210,8,8,0,1,0
11,219,219,14,14,0,1,0
19,237,237,11,11,0,1,0
29,238,238,3,3,0,1,0
9,274,274,4,4,0,1,0
32,275,275,58,58,0,1,0
27,293,293,23,13,10,3,2
4,296,296,12,12,0,1,0
6,296,296,32,32,0,1,0
3,298,298,1,1,0,1,0
17,341,341,92,28,64,3,2
18,360,360,56,48,8,2,1
10,372,372,27,3,24,2,1
25,384,384,26,17,9,4,3
21,396,396,15,4,11,2,1
7,413,413,6,2,4,2,1
30,422,422,84,49,35,2,1
26,433,433,15,5,10,3,2
28,433,433,41,12,29,3,2
16,452,452,46,9,37,4,3
14,493,493,16,16,0,1,0

10,105,105,6,6,0,1,0
6,106,106,6,6,0,1,0
17,111,111,4,1,3,2,1
2,130,130,8,5,3,2,1
15,146,146,14,6,8,3,2
9,169,169,29,12,17,2,1
24,176,176,6,6,0,1,0
4,184,184,2,2,0,1,0
7,198,198,5,5,0,1,0
11,201,201,2,2,0,1,0
13,220,220,26,26,0,1,0
26,235,235,71,68,3,2,1
27,240,240,28,28,0,1,0
1,254,254,169,85,84,3,2
25,263,263,31,7,24,4,3
12,276,276,9,9,0,1,0
8,314,314,23,8,15,4,3
19,315,315,92,92,0,1,0
5,320,320,22,8,14,3,2
16,345,345,1,1,0,1,0
21,348,348,30,5,25,2,1
18,382,382,22,22,0,1,0
3,398,398,18,1,17,2,1
14,405,405,29,3,26,3,2
0,433,433,2,2,0,1,0
23,446,446,37,2,35,3,2
22,465,465,18,6,12,3,2
20,482,482,43,43,0,1,0

12,116,116,18,7,11,4,3
8,128,128,3,3,0,1,0
13,135,135,3,3,0,1,0
25,137,137,16,1,15,4,3
21,146,146,5,5,0,1,0
24,180,180,28,28,0,1,0
10,184,184,2,2,0,1,0
7,236,236,25,15,10,3,2
30,248,248,2,2,0,1,0
14,262,262,15,15,0,1,0
11,271,271,29,29,0,1,0
29,275,275,57,27,30,3,2
6,286,286,33,33,0,1,0
9,289,289,6,6,0,1,0
17,295,295,1,1,0,1,0
22,311,311,19,5,14,2,1
3,314,314,1,1,0,1,0
18,332,332,21,21,0,1,0
27,335,335,7,7,0,1,0
16,342,342,60,15,45,2,1
19,361,361,60,60,0,1,0
2,387,387,16,16,0,1,0
28,395,395,6,6,0,1,0
20,412,412,102,93,9,4,3
23,424,424,40,1,39,4,3
15,470,470,24,6,18,4,3
1,479,479,76,76,0,1,0
31,488,488,54,51,3,2,1
26,492,492,62,62,0,1,0
5,493,493,4,4,0,1,0
4,499,499,37,28,9,2,1
0,500,500,135,79,56,4,3

23,131,131,4,4,0,1,0
9,133,133,15,3,12,2,1
13,148,148,2,2,0,1,0
5,153,153,17,17,0,1,0
1,192,192,5,5,0,1,0
22,211,211,10,4,6,2,1
19,218,218,25,25,0,1,0
26,224,224,7,7,0,1,0
3,246,246,6,6,0,1,0
6,275,275,8,8,0,1,0
24,290,290,11,11,0,1,0
21,300,300,11,2,9,2,1
7,317,317,57,57,0,1,0
25,333,333,88,88,0,1,0
8,339,339,62,48,14,3,2
11,361,361,15,15,0,1,0
0,385,385,3,3,0,1,0
4,391,391,112,112,0,1,0
15,422,422,26,26,0,1,0
12,440,440,65,17,48,4,3
17,449,449,182,104,78,4,3
2,451,451,1,1,0,1,0
18,455,455,19,19,0,1,0
16,457,457,91,91,0,1,0
14,463,463,4,4,0,1,0
10,473,473,118,76,42,4,3
20,481,481,64,64,0,1,0

8,115,115,22,22,0,1,0
18,117,117,4,4,0,1,0
25,121,121,6,6,0,1,0
21,150,150,1,1,0,1,0
14,174,174,2,2,0,1,0
1,194,194,10,10,0,1,0
26,209,209,80,34,46,4,3
7,212,212,47,47,0,1,0
23,215,215,3,3,0,1,0
17,239,239,45,45,0,1,0
19,243,243,13,6,7,2,1
33,250,250,57,57,0,1,0
6,252,252,7,2,5,2,1
11,253,253,4,4,0,1,0
16,254,254,5,2,3,2,1
4,261,261,19,19,0,1,0
0,261,261,40,30,10,2,1
20,280,280,21,14,7,2,1
3,322,322,9,2,7,2,1
27,323,323,113,33,80,3,2
32,337,337,10,10,0,1,0
9,347,347,48,30,18,3,2
2,369,369,30,7,23,2,1
12,369,369,6,6,0,1,0
24,412,412,10,10,0,1,0
5,424,424,12,12,0,1,0
10,427,427,10,2,8,2,1
15,434,434,4,4,0,1,0
22,439,439,55,27,28,2,1
28,439,439,9,6,3,2,1
29,454,454,44,44,0,1,0
13,464,464,17,1,16,2,1
31,473,473,4,4,0,1,0
30,486,486,9,9,0,1,0

15,100,100,10,10,0,1,0
9,113,113,8,8,0,1,0
12,135,135,11,11,0,1,0
32,139,139,5,1,4,2,1
14,140,140,6,6,0,1,0
20,142,142,22,15,7,2,1
7,162,162,4,4,0,1,0
5,208,208,9,9,0,1,0
28,228,228,1,1,0,1,0
26,246,246,11,11,0,1,0
0,303,303,5,2,3,2,1
8,319,319,31,31,0,1,0
25,325,325,15,15,0,1,0
23,339,339,71,35,36,2,1
33,343,343,5,5,0,1,0
19,346,346,53,53,0,1,0
27,346,346,8,8,0,1,0
21,361,361,69,35,34,4,3
24,362,362,12,12,0,1,0
13,362,362,53,41,12,4,3
22,364,364,151,151,0,1,0
18,385,385,29,26,3,2,1
3,386,386,18,18,0,1,0
30,418,418,61,61,0,1,0
29,419,419,30,22,8,2,1
17,424,424,48,48,0,1,0
10,428,428,7,7,0,1,0
1,433,433,2,2,0,1,0
11,435,435,21,21,0,1,0
31,447,447,16,8,8,3,2
16,456,456,1,1,0,1,0
2,467,467,57,57,0,1,0
4,492,492,20,20,0,1,0
6,495,495,77,77,0,1,0

20,120,120,2,2,0,1,0
23,124,124,1,1,0,1,0
7,141,141,12,12,0,1,0
0,158,158,7,7,0,1,0
9,161,161,1,1,0,1,0
22,164,164,21,6,15,4,3
16,168,168,21,21,0,1,0
21,217,217,48,2,46,3,2
3,229,229,20,20,0,1,0
4,238,238,17,17,0,1,0
15,301,301,77,15,62,3,2
8,310,310,6,6,0,1,0
2,316,316,66,66,0,1,0
6,344,344,57,57,0,1,0
11,377,377,51,51,0,1,0
14,395,395,26,26,0,1,0
19,407,407,33,33,0,1,0
13,467,467,36,36,0,1,0
18,468,468,32,32,0,1,0
1,469,469,124,13,111,4,3
10,475,475,75,37,38,2,1
17,480,480,28,28,0,1,0
12,482,482,13,13,0,1,0
5,497,497,225,144,81,4,3

18,136,136,2,2,0,1,0
9,146,146,12,12,0,1,0
13,151,151,9,9,0,1,0
20,169,169,41,41,0,1,0
14,180,180,3,3,0,1,0
11,181,181,18,2,16,3,2
12,192,192,13,2,11,2,1
0,197,197,4,4,0,1,0
2,200,200,54,54,0,1,0
24,203,203,17,10,7,2,1
23,213,213,35,35,0,1,0
16,307,307,72,72,0,1,0
21,322,322,36,9,27,2,1
4,327,327,10,10,0,1,0
15,335,335,27,27,0,1,0
7,360,360,114,23,91,4,3
5,388,388,42,3,39,2,1
22,391,391,40,32,8,2,1
17,393,393,49,49,0,1,0
3,418,418,64,31,33,2,1
8,442,442,40,40,0,1,0
1,470,470,47,47,0,1,0
19,499,499,11,11,0,1,0
10,499,499,41,41,0,1,0
6,500,500,74,20,54,4,3

22,131,131,50,22,28,2,1
29,142,142,14,2,12,2,1
16,166,166,34,28,6,3,2
15,172,172,7,3,4,2,1
20,175,175,9,9,0,1,0
27,177,177,38,38,0,1,0
12,193,193,57,57,0,1,0
23,203,203,8,3,5,2,1
25,208,208,2,2,0,1,0
11,212,212,62,50,12,2,1
21,225,225,13,13,0,1,0
19,242,242,17,9,8,3,2
17,246,246,18,18,0,1,0
0,249,249,5,5,0,1,0
26,252,252,7,7,0,1,0
10,256,256,9,9,0,1,0
3,313,313,9,2,7,2,1
14,335,335,8,8,0,1,0
5,339,339,53,23,30,4,3
28,340,340,22,22,0,1,0
4,342,342,70,21,49,4,3
7,355,355,2,2,0,1,0
2,366,366,12,12,0,1,0
13,370,370,29,6,23,2,1
18,387,387,20,2,18,3,2
24,391,391,33,16,17,4,3
9,405,405,2,2,0,1,0
8,426,426,25,25,0,1,0
1,442,442,1,1,0,1,0
6,493,493,60,60,0,1,0

24,149,149,1,1,0,1,0
21,150,150,11,4,7,2,1
22,182,182,10,4,6,2,1
8,187,187,2,2,0,1,0
3,202,202,2,2,0,1,0
29,204,204,29,29,0,1,0
4,206,206,44,2,42,4,3
27,214,214,47,47,0,1,0
16,216,216,1,1,0,1,0
17,229,229,27,27,0,1,0
9,229,229,2,2,0,1,0
19,232,232,55,55,0,1,0
23,236,236,10,10,0,1,0
10,257,257,9,9,0,1,0
2,285,285,45,45,0,1,0
20,302,302,1,1,0,1,0
31,317,317,7,1,6,2,1
12,332,332,16,8,8,3,2
26,334,334,1,1,0,1,0
14,337,337,9,9,0,1,0
5,337,337,21,21,0,1,0
15,393,393,18,10,8,3,2
6,396,396,44,44,0,1,0
13,406,406,84,55,29,2,1
7,413,413,29,5,24,2,1
1,448,448,84,27,57,3,2
0,456,456,28,24,4,2,1
11,457,457,10,4,6,3,2
25,458,458,5,5,0,1,0
28,474,474,84,84,0,1,0
30,489,489,168,149,19,2,1
18,499,499,45,11,34,2,1

17,104,104,3,3,0,1,0
2,118,118,43,43,0,1,0
28,157,157,26,26,0,1,0
5,181,181,18,15,3,2,1
7,190,190,4,4,0,1,0
15,190,190,1,1,0,1,0
22,210,210,76,58,18,4,3
4,216,216,14,1,13,2,1
8,275,275,2,2,0,1,0
18,294,294,23,23,0,1,0
6,297,297,10,10,0,1,0
10,320,320,13,7,6,3,2
26,321,321,37,1,36,4,3
21,324,324,26,16,10,2,1
20,335,335,54,54,0,1,0
27,356,356,101,42,59,3,2
19,363,363,4,4,0,1,0
25,370,370,12,12,0,1,0
13,383,383,33,33,0,1,0
0,389,389,54,54,0,1,0
1,401,401,38,38,0,1,0
9,405,405,1,1,0,1,0
16,428,428,20,20,0,1,0
23,436,436,2,2,0,1,0
11,456,456,75,45,30,4,3
12,469,469,117,31,86,4,3
14,475,475,7,1,6,3,2
24,486,486,28,28,0,1,0
3,499,499,9,1,8,3,2

18,112,112,4,4,0,1,0
11,121,121,3,3,0,1,0
10,126,126,10,7,3,2,1
12,130,130,4,4,0,1,0
20,131,131,19,19,0,1,0
15,149,149,13,13,0,1,0
30,151,151,25,25,0,1,0
29,166,166,4,4,0,1,0
23,246,246,78,30,48,2,1
6,277,277,5,5,0,1,0
28,291,291,1,1,0,1,0
8,306,306,30,2,28,2,1
16,336,336,16,10,6,2,1
17,345,345,11,3,8,3,2
2,372,372,52,52,0,1,0
7,374,374,123,1,122,4,3
14,389,389,71,31,40,3,2
26,399,399,46,46,0,1,0
4,402,402,13,5,8,3,2
21,412,412,28,8,20,3,2
13,416,416,35,35,0,1,0
3,419,419,41,19,22,2,1
9,420,420,14,11,3,2,1
22,424,424,5,2,3,2,1
24,424,424,22,4,18,4,3
25,426,426,39,39,0,1,0
31,427,427,15,15,0,1,0
1,457,457,21,5,16,3,2
5,486,486,10,2,8,3,2
0,497,497,9,9,0,1,0
27,498,498,51,51,0,1,0
19,500,500,127,127,0,1,0

6,125,125,1,1,0,1,0
0,133,133,23,13,10,3,2
3,137,137,3,3,0,1,0
1,162,162,110,103,7,2,1
11,179,179,6,6,0,1,0
16,184,184,38,38,0,1,0
8,199,199,12,12,0,1,0
10,213,213,14,14,0,1,0
4,233,233,1,1,0,1,0
7,238,238,40,12,28,3,2
14,256,256,29,7,22,2,1
21,300,300,6,6,0,1,0
19,321,321,46,46,0,1,0
17,378,378,6,6,0,1,0
13,399,399,14,14,0,1,0
2,402,402,76,7,69,4,3
12,431,431,43,43,0,1,0
20,435,435,92,92,0,1,0
15,440,440,23,2,21,2,1
5,453,453,72,24,48,2,1
18,465,465,134,134,0,1,0
9,467,467,36,19,17,2,1

23,101,101,32,6,26,3,2
25,120,120,21,21,0,1,0
5,120,120,7,7,0,1,0
7,136,136,3,3,0,1,0
32,155,155,3,3,0,1,0
24,160,160,56,8,48,4,3
6,197,197,14,4,10,3,2
28,204,204,6,2,4,2,1
27,208,208,7,2,5,2,1
2,211,211,12,1,11,2,1
21,232,232,2,2,0,1,0
11,239,239,13,13,0,1,0
29,246,246,3,3,0,1,0
14,256,256,9,9,0,1,0
26,264,264,4,1,3,2,1
12,267,267,17,8,9,2,1
1,278,278,24,24,0,1,0
22,304,304,7,7,0,1,0
34,322,322,15,15,0,1,0
8,323,323,49,49,0,1,0
33,355,355,67,67,0,1,0
10,366,366,35,17,18,4,3
16,368,368,27,27,0,1,0
0,399,399,92,45,47,3,2
13,404,404,1,1,0,1,0
18,411,411,19,19,0,1,0
17,415,415,3,3,0,1,0
4,429,429,32,18,14,3,2
3,438,438,4,4,0,1,0
31,458,458,12,2,10,2,1
15,470,470,1,1,0,1,0
20,491,491,4,4,0,1,0
30,492,492,94,20,74,4,3
19,496,496,25,25,0,1,0
9,497,497,100,100,0,1,0

9,104,104,6,6,0,1,0
16,112,112,10,1,9,2,1
14,126,126,15,15,0,1,0
23,128,128,17,5,12,2,1
7,144,144,11,2,9,2,1
21,147,147,13,13,0,1,0
2,149,149,6,6,0,1,0
11,192,192,49,49,0,1,0
22,208,208,1,1,0,1,0
10,237,237,66,66,0,1,0
1,257,257,31,31,0,1,0
8,265,265,58,1,57,4,3
19,280,280,9,9,0,1,0
24,287,287,138,138,0,1,0
13,288,288,25,16,9,4,3
5,317,317,34,34,0,1,0
25,332,332,50,26,24,3,2
4,357,357,31,31,0,1,0
0,384,384,21,13,8,3,2
17,394,394,29,29,0,1,0
12,421,421,33,15,18,2,1
20,436,436,24,4,20,3,2
3,455,455,48,48,0,1,0
15,469,469,7,4,3,2,1
18,477,477,12,1,11,2,1
6,490,490,1,1,0,1,0

15,126,126,2,2,0,1,0
25,146,146,24,24,0,1,0
2,153,153,1,1,0,1,0
0,162,162,3,3,0,1,0
6,172,172,54,14,40,3,2
27,179,179,13,3,10,2,1
28,215,215,15,15,0,1,0
7,224,224,1,1,0,1,0
24,230,230,14,5,9,2,1
17,252,252,29,25,4,2,1
22,254,254,7,1,6,3,2
13,284,284,30,12,18,3,2
9,287,287,19,19,0,1,0
10,294,294,13,7,6,3,2
20,308,308,15,15,0,1,0
14,318,318,25,25,0,1,0
19,322,322,47,38,9,2,1
5,334,334,140,96,44,4,3
18,349,349,15,15,0,1,0
8,364,364,4,4,0,1,0
12,384,384,26,16,10,2,1
1,389,389,3,3,0,1,0
23,428,428,136,136,0,1,0
4,429,429,80,80,0,1,0
26,452,452,2,2,0,1,0
11,453,453,8,3,5,2,1
16,464,464,88,26,62,4,3
3,466,466,25,25,0,1,0
21,471,471,70,35,35,2,1

14,109,109,1,1,0,1,0
19,118,118,10,1,9,4,3
5,134,134,10,10,0,1,0
29,162,162,15,6,9,2,1
17,174,174,16,16,0,1,0
24,177,177,7,7,0,1,0
10,180,180,1,1,0,1,0
2,193,193,57,57,0,1,0
32,204,204,8,8,0,1,0
6,217,217,11,6,5,2,1
27,224,224,75,75,0,1,0
9,240,240,21,2,19,4,3
11,251,251,11,11,0,1,0
15,253,253,9,9,0,1,0
1,278,278,8,8,0,1,0
8,281,281,33,4,29,4,3
12,285,285,76,76,0,1,0
26,298,298,13,13,0,1,0
3,305,305,13,7,6,2,1
23,330,330,29,10,19,2,1
4,341,341,17,17,0,1,0
28,350,350,87,58,29,2,1
30,353,353,44,4,40,2,1
31,366,366,2,2,0,1,0
20,376,376,6,3,3,2,1
7,388,388,1,1,0,1,0
0,389,389,11,3,8,3,2
18,405,405,1,1,0,1,0
25,411,411,83,48,35,2,1
13,429,429,5,5,0,1,0
22,453,453,22,22,0,1,0
21,453,453,28,18,10,3,2
16,473,473,74,11,63,4,3

14,110,110,12,12,0,1,0
24,121,121,16,16,0,1,0
5,142,142,4,4,0,1,0
21,146,146,49,12,37,2,1
16,167,167,8,8,0,1,0
3,177,177,10,10,0,1,0
30,189,189,22,22,0,1,0
12,203,203,14,14,0,1,0
2,215,215,40,27,13,2,1
27,220,220,30,9,21,2,1
19,224,224,35,11,24,3,2
31,226,226,1,1,0,1,0
4,251,251,74,51,23,2,1
6,256,256,34,30,4,2,1
0,267,267,23,23,0,1,0
8,277,277,3,3,0,1,0
15,282,282,6,1,5,2,1
17,311,311,10,10,0,1,0
10,327,327,7,3,4,2,1
23,348,348,12,3,9,2,1
22,366,366,32,14,18,4,3
11,380,380,15,15,0,1,0
18,383,383,12,12,0,1,0
26,404,404,13,4,9,2,1
1,405,405,78,45,33,4,3
28,415,415,8,8,0,1,0
20,416,416,28,28,0,1,0
9,417,417,4,4,0,1,0
7,420,420,5,5,0,1,0
13,449,449,23,13,10,2,1
29,467,467,27,27,0,1,0
25,468,468,104,104,0,1,0

24,110,110,25,25,0,1,0
8,111,111,3,3,0,1,0
7,126,126,5,5,0,1,0
19,152,152,2,2,0,1,0
18,169,169,4,4,0,1,0
13,200,200,6,6,0,1,0
21,220,220,3,3,0,1,0
5,222,222,4,4,0,1,0
22,237,237,27,21,6,3,2
1,245,245,9,4,5,2,1
14,264,264,46,21,25,2,1
10,310,310,30,30,0,1,0
11,324,324,21,21,0,1,0
15,348,348,68,51,17,2,1
6,367,367,61,61,0,1,0
2,378,378,33,33,0,1,0
9,391,391,82,82,0,1,0
16,405,405,13,5,8,3,2
0,417,417,215,179,36,4,3
12,433,433,58,58,0,1,0
3,444,444,35,5,30,4,3
4,445,445,27,17,10,3,2
23,453,453,85,85,0,1,0
25,463,463,58,3,55,4,3
20,482,482,55,13,42,3,2
17,496,496,21,13,8,3,2

19,128,128,7,3,4,2,1
11,129,129,21,15,6,2,1
17,166,166,1,1,0,1,0
2,181,181,20,3,17,2,1
31,196,196,42,42,0,1,0
30,209,209,13,3,10,2,1
25,213,213,30,12,18,3,2
4,226,226,11,11,0,1,0
6,226,226,9,9,0,1,0
0,232,232,10,10,0,1,0
26,236,236,11,11,0,1,0
18,237,237,4,1,3,2,1
16,246,246,4,1,3,2,1
12,250,250,19,19,0,1,0
28,256,256,13,7,6,3,2
10,274,274,8,2,6,2,1
5,280,280,47,24,23,2,1
21,280,280,81,19,62,3,2
13,323,323,43,7,36,3,2
9,353,353,76,76,0,1,0
14,358,358,55,55,0,1,0
23,380,380,2,2,0,1,0
8,381,381,3,3,0,1,0
27,393,393,51,51,0,1,0
22,399,399,18,13,5,2,1
7,441,441,43,28,15,2,1
32,447,447,31,31,0,1,0
1,455,455,21,21,0,1,0
3,455,455,1,1,0,1,0
20,481,481,99,99,0,1,0
15,488,488,14,14,0,1,0
24,489,489,20,20,0,1,0
29,493,493,36,12,24,3,2

3,106,106,1,1,0,1,0
4,112,112,11,11,0,1,0
14,116,116,1,1,0,1,0
24,127,127,3,3,0,1,0
20,134,134,9,5,4,2,1
10,140,140,11,11,0,1,0
0,142,142,44,44,0,1,0
6,170,170,13,8,5,2,1
23,173,173,1,1,0,1,0
27,174,174,8,1,7,2,1
33,179,179,6,6,0,1,0
25,207,207,35,35,0,1,0
18,209,209,13,1,12,4,3
22,210,210,46,46,0,1,0
21,285,285,32,32,0,1,0
15,312,312,5,5,0,1,0
19,316,316,1,1,0,1,0
5,323,323,9,9,0,1,0
32,329,329,28,6,22,3,2
26,335,335,15,7,8,2,1
13,359,359,57,31,26,2,1
9,382,382,1,1,0,1,0
12,396,396,6,2,4,2,1
29,411,411,22,22,0,1,0
2,425,425,19,19,0,1,0
7,426,426,29,29,0,1,0
1,432,432,1,1,0,1,0
16,459,459,45,45,0,1,0
28,465,465,194,149,45,4,3
17,467,467,17,2,15,3,2
31,469,469,93,93,0,1,0
11,469,469,86,56,30,2,1
34,472,472,9,2,7,2,1
30,480,480,2,2,0,1,0
8,497,497,20,6,14,3,2

6,145,145,4,4,0,1,0
26,153,153,11,11,0,1,0
5,155,155,15,15,0,1,0
21,156,156,5,5,0,1,0
28,167,167,3,3,0,1,0
13,172,172,23,23,0,1,0
18,205,205,5,5,0,1,0
27,206,206,25,9,16,3,2
30,211,211,29,29,0,1,0
31,212,212,12,12,0,1,0
9,220,220,48,21,27,4,3
4,234,234,25,11,14,2,1
32,241,241,20,12,8,3,2
19,278,278,6,6,0,1,0
22,284,284,8,8,0,1,0
33,295,295,2,2,0,1,0
16,297,297,1,1,0,1,0
8,297,297,27,27,0,1,0
0,303,303,18,18,0,1,0
25,325,325,61,61,0,1,0
15,330,330,3,3,0,1,0
24,336,336,17,5,12,4,3
7,336,336,13,13,0,1,0
11,337,337,27,5,22,2,1
3,349,349,35,35,0,1,0
23,350,350,89,31,58,3,2
12,365,365,28,28,0,1,0
17,367,367,24,4,20,3,2
34,386,386,114,80,34,3,2
10,393,393,40,26,14,2,1
2,401,401,9,9,0,1,0
1,408,408,2,2,0,1,0
14,417,417,36,2,34,2,1
35,421,421,15,15,0,1,0
20,427,427,1,1,0,1,0
29,473,473,40,7,33,4,3

3,111,111,39,24,15,2,1
4,146,146,13,8,5,2,1
14,146,146,51,39,12,2,1
13,147,147,3,3,0,1,0
18,232,232,21,21,0,1,0
15,238,238,12,5,7,2,1
17,240,240,56,32,24,2,1
16,241,241,18,18,0,1,0
12,269,269,3,3,0,1,0
0,272,272,58,17,41,2,1
9,273,273,5,2,3,2,1
19,283,283,36,23,13,2,1
23,317,317,15,1,14,3,2
20,340,340,11,11,0,1,0
21,356,356,19,19,0,1,0
22,364,364,32,32,0,1,0
2,370,370,30,30,0,1,0
11,432,432,52,40,12,3,2
7,438,438,86,17,69,4,3
10,454,454,59,59,0,1,0
5,455,455,22,13,9,4,3
8,480,480,15,15,0,1,0
1,482,482,149,106,43,2,1
6,490,490,31,5,26,2,1

6,100,100,11,11,0,1,0
21,134,134,20,5,15,4,3
19,139,139,2,2,0,1,0
0,180,180,24,6,18,4,3
8,186,186,48,48,0,1,0
1,191,191,4,1,3,2,1
15,192,192,11,1,10,2,1
9,193,193,17,17,0,1,0
11,193,193,3,3,0,1,0
2,205,205,8,8,0,1,0
5,212,212,35,35,0,1,0
25,234,234,21,21,0,1,0
22,269,269,17,17,0,1,0
7,295,295,99,60,39,2,1
12,302,302,7,4,3,2,1
14,334,334,66,66,0,1,0
10,341,341,19,19,0,1,0
3,373,373,48,34,14,3,2
13,393,393,7,1,6,2,1
18,404,404,26,3,23,2,1
23,407,407,40,40,0,1,0
4,410,410,22,5,17,2,1
17,438,438,99,99,0,1,0
24,438,438,50,32,18,3,2
16,477,477,18,7,11,2,1
20,487,487,135,81,54,4,3

16,104,104,13,4,9,2,1
19,125,125,13,4,9,2,1
14,133,133,1,1,0,1,0
8,155,155,7,7,0,1,0
0,169,169,2,2,0,1,0
26,176,176,19,8,11,2,1
1,191,191,11,11,0,1,0
23,199,199,3,3,0,1,0
3,201,201,13,13,0,1,0
6,223,223,10,5,5,2,1
25,233,233,5,1,4,2,1
2,238,238,11,2,9,2,1
11,245,245,34,34,0,1,0
31,257,257,3,3,0,1,0
7,277,277,58,58,0,1,0
17,278,278,7,7,0,1,0
28,286,286,4,4,0,1,0
20,296,296,2,2,0,1,0
15,320,320,43,43,0,1,0
22,326,326,16,8,8,3,2
34,331,331,7,7,0,1,0
4,354,354,15,9,6,2,1
12,361,361,4,1,3,2,1
30,380,380,35,5,30,3,2
18,382,382,5,1,4,2,1
24,393,393,88,16,72,3,2
36,399,399,10,1,9,4,3
27,400,400,43,43,0,1,0
35,402,402,4,4,0,1,0
33,406,406,142,68,74,3,2
9,428,428,11,11,0,1,0
5,439,439,26,17,9,2,1
10,447,447,16,16,0,1,0
32,460,460,10,5,5,2,1
21,465,465,58,37,21,2,1
29,473,473,190,159,31,3,2
13,485,485,10,10,0,1,0

33,111,111,24,20,4,2,1
1,112,112,24,24,0,1,0
34,145,145,13,7,6,2,1
21,145,145,29,8,21,2,1
12,153,153,4,4,0,1,0
8,154,154,16,16,0,1,0
26,170,170,65,65,0,1,0
19,182,182,1,1,0,1,0
30,185,185,5,5,0,1,0
20,225,225,6,3,3,2,1
7,253,253,9,6,3,2,1
13,265,265,8,5,3,2,1
14,271,271,32,32,0,1,0
18,291,291,9,9,0,1,0
27,314,314,7,7,0,1,0
2,320,320,28,28,0,1,0
15,339,339,20,20,0,1,0
0,345,345,27,27,0,1,0
23,346,346,27,5,22,3,2
16,369,369,25,25,0,1,0
28,395,395,9,9,0,1,0
32,396,396,9,3,6,2,1
11,405,405,82,82,0,1,0
29,422,422,22,5,17,2,1
22,424,424,12,5,7,2,1
9,429,429,61,4,57,4,3
5,432,432,1,1,0,1,0
24,438,438,32,10,22,3,2
25,446,446,57,48,9,4,3
17,446,446,1,1,0,1,0
31,446,446,38,24,14,3,2
10,460,460,10,10,0,1,0
3,462,462,18,18,0,1,0
4,476,476,47,24,23,2,1
6,482,482,5,5,0,1,0

13,117,117,18,6,12,2,1
10,118,118,3,3,0,1,0
0,119,119,2,2,0,1,0
23,148,148,8,8,0,1,0
24,153,153,1,1,0,1,0
3,199,199,34,22,12,3,2
5,212,212,3,3,0,1,0
2,227,227,60,60,0,1,0
18,236,236,16,16,0,1,0
11,240,240,42,42,0,1,0
9,248,248,103,74,29,2,1
14,301,301,25,17,8,2,1
7,334,334,57,37,20,3,2
12,335,335,52,4,48,3,2
17,350,350,9,9,0,1,0
4,378,378,46,28,18,2,1
16,395,395,83,8,75,4,3
19,403,403,17,17,0,1,0
8,406,406,30,22,8,2,1
6,421,421,16,16,0,1,0
1,450,450,40,40,0,1,0
21,457,457,28,10,18,2,1
22,459,459,42,6,36,2,1
20,487,487,48,24,24,3,2
15,494,494,97,97,0,1,0

26,118,118,12,5,7,2,1
19,125,125,20,20,0,1,0
17,126,126,2,2,0,1,0
4,137,137,56,56,0,1,0
28,142,142,7,7,0,1,0
1,148,148,2,2,0,1,0
27,167,167,20,1,19,4,3
22,182,182,24,13,11,2,1
31,191,191,3,3,0,1,0
5,249,249,4,4,0,1,0
0,252,252,12,4,8,2,1
18,255,255,33,10,23,2,1
14,256,256,7,7,0,1,0
8,301,301,1,1,0,1,0
30,304,304,46,11,35,2,1
24,310,310,27,27,0,1,0
6,315,315,7,7,0,1,0
29,348,348,28,12,16,3,2
13,353,353,1,1,0,1,0
9,363,363,87,41,46,4,3
10,366,366,47,28,19,2,1
20,367,367,12,12,0,1,0
21,377,377,27,27,0,1,0
11,378,378,52,52,0,1,0
16,379,379,50,2,48,2,1
12,379,379,2,2,0,1,0
25,386,386,12,12,0,1,0
3,396,396,34,20,14,2,1
15,420,420,27,19,8,3,2
7,448,448,22,16,6,3,2
23,451,451,122,74,48,4,3
2,468,468,1,1,0,1,0

8,115,115,3,3,0,1,0
3,147,147,94,94,0,1,0
17,161,161,12,12,0,1,0
7,171,171,15,9,6,2,1
10,178,178,29,8,21,4,3
1,226,226,38,24,14,2,1
16,232,232,28,28,0,1,0
6,254,254,6,6,0,1,0
11,257,257,19,19,0,1,0
13,258,258,4,4,0,1,0
12,265,265,25,13,12,2,1
14,285,285,33,33,0,1,0
9,290,290,37,32,5,2,1
15,294,294,48,21,27,4,3
18,355,355,41,41,0,1,0
5,359,359,94,94,0,1,0
19,391,391,88,85,3,2,1
20,441,441,12,4,8,3,2
0,445,445,74,67,7,2,1
4,454,454,58,29,29,2,1
2,476,476,7,1,6,2,1

8,138,138,5,5,0,1,0
13,162,162,4,4,0,1,0
10,165,165,34,4,30,2,1
4,207,207,17,10,7,2,1
1,218,218,59,22,37,4,3
6,225,225,28,12,16,2,1
9,235,235,8,8,0,1,0
26,243,243,25,14,11,2,1
14,258,258,119,113,6,3,2
5,277,277,48,1,47,4,3
23,297,297,11,5,6,3,2
2,338,338,3,3,0,1,0
22,352,352,126,117,9,4,3
12,362,362,24,11,13,2,1
19,364,364,7,7,0,1,0
11,365,365,21,21,0,1,0
24,367,367,12,4,8,3,2
25,373,373,1,1,0,1,0
15,379,379,30,4,26,2,1
18,383,383,7,7,0,1,0
3,384,384,39,39,0,1,0
7,386,386,10,1,9,4,3
17,405,405,20,20,0,1,0
16,428,428,13,3,10,3,2
21,465,465,81,9,72,4,3
0,473,473,102,27,75,4,3
20,479,479,16,16,0,1,0

22,119,119,9,9,0,1,0
17,144,144,19,19,0,1,0
1,146,146,13,13,0,1,0
5,153,153,39,7,32,3,2
24,170,170,6,6,0,1,0
0,171,171,21,9,12,3,2
6,194,194,7,7,0,1,0
25,199,199,11,6,5,2,1
3,200,200,7,7,0,1,0
7,203,203,1,1,0,1,0
18,220,220,46,33,13,2,1
16,231,231,72,24,48,4,3
9,245,245,66,38,28,3,2
26,282,282,2,2,0,1,0
2,301,301,7,1,6,2,1
20,311,311,13,7,6,2,1
19,322,322,15,15,0,1,0
8,326,326,40,34,6,3,2
12,349,349,12,12,0,1,0
15,370,370,8,4,4,2,1
4,391,391,6,2,4,2,1
23,394,394,9,6,3,2,1
13,395,395,10,2,8,3,2
21,396,396,22,12,10,2,1
11,403,403,43,22,21,2,1
14,418,418,161,161,0,1,0
10,430,430,123,60,63,3,2

2,118,118,7,7,0,1,0
17,122,122,6,1,5,2,1
10,130,130,14,1,13,2,1
1,144,144,56,56,0,1,0
4,152,152,2,2,0,1,0
14,174,174,3,3,0,1,0
0,182,182,13,1,12,4,3
26,188,188,1,1,0,1,0
5,193,193,14,4,10,2,1
21,232,232,84,22,62,3,2
6,251,251,11,11,0,1,0
24,260,260,20,7,13,2,1
18,264,264,34,16,18,4,3
19,274,274,10,10,0,1,0
12,285,285,27,27,0,1,0
20,305,305,9,3,6,2,1
22,308,308,4,4,0,1,0
3,322,322,1,1,0,1,0
8,322,322,43,43,0,1,0
15,335,335,7,7,0,1,0
9,374,374,95,8,87,4,3
16,392,392,32,4,28,2,1
23,412,412,26,26,0,1,0
25,455,455,210,168,42,4,3
11,472,472,49,33,16,2,1
13,477,477,37,7,30,3,2
7,499,499,28,28,0,1,0

18,124,124,5,5,0,1,0
21,125,125,1,1,0,1,0
27,155,155,1,1,0,1,0
26,159,159,15,1,14,2,1
32,161,161,13,7,6,3,2
30,161,161,6,6,0,1,0
6,171,171,13,13,0,1,0
13,199,199,1,1,0,1,0
31,214,214,11,2,9,2,1
16,216,216,7,7,0,1,0
7,228,228,6,1,5,2,1
25,251,251,9,1,8,3,2
33,268,268,34,24,10,2,1
5,275,275,14,4,10,2,1
22,277,277,100,84,16,3,2
29,282,282,20,12,8,2,1
24,283,283,108,86,22,2,1
23,294,294,15,15,0,1,0
0,328,328,23,23,0,1,0
1,337,337,13,13,0,1,0
4,338,338,80,80,0,1,0
11,342,342,45,2,43,4,3
10,347,347,64,64,0,1,0
8,354,354,3,3,0,1,0
17,357,357,14,14,0,1,0
2,368,368,89,2,87,4,3
3,371,371,16,2,14,3,2
14,398,398,32,32,0,1,0
19,406,406,11,11,0,1,0
12,417,417,17,17,0,1,0
20,419,419,13,13,0,1,0
28,425,425,44,2,42,4,3
9,451,451,10,10,0,1,0
15,478,478,3,3,0,1,0

18,104,104,9,2,7,2,1
10,110,110,7,7,0,1,0
19,138,138,4,4,0,1,0
1,162,162,9,9,0,1,0
12,163,163,1,1,0,1,0
2,189,189,34,18,16,3,2
21,190,190,50,50,0,1,0
17,202,202,24,18,6,3,2
7,209,209,9,6,3,2,1
0,212,212,18,18,0,1,0
23,214,214,13,13,0,1,0
25,225,225,12,8,4,2,1
6,263,263,67,7,60,4,3
15,264,264,83,83,0,1,0
5,278,278,17,8,9,4,3
3,302,302,38,26,12,2,1
22,338,338,51,47,4,2,1
13,351,351,6,6,0,1,0
11,358,358,3,3,0,1,0
14,371,371,6,3,3,2,1
4,371,371,111,111,0,1,0
26,373,373,8,1,7,2,1
20,382,382,67,10,57,4,3
8,432,432,67,37,30,2,1
9,455,455,29,29,0,1,0
16,473,473,9,9,0,1,0
24,487,487,47,47,0,1,0

30,101,101,23,1,22,2,1
32,120,120,1,1,0,1,0
11,164,164,5,5,0,1,0
12,176,176,10,10,0,1,0
27,184,184,2,2,0,1,0
3,194,194,21,21,0,1,0
33,204,204,1,1,0,1,0
23,258,258,5,5,0,1,0
28,263,263,65,17,48,3,2
7,268,268,24,24,0,1,0
18,269,269,16,4,12,3,2
21,282,282,26,26,0,1,0
24,284,284,12,6,6,2,1
31,287,287,68,30,38,3,2
25,288,288,20,11,9,2,1
2,307,307,19,19,0,1,0
1,317,317,15,12,3,2,1
6,324,324,17,7,10,2,1
29,326,326,104,104,0,1,0
8,333,333,6,1,5,2,1
19,345,345,23,23,0,1,0
22,356,356,5,5,0,1,0
13,359,359,47,47,0,1,0
16,362,362,10,10,0,1,0
20,384,384,14,1,13,2,1
4,447,447,18,18,0,1,0
17,449,449,4,4,0,1,0
0,468,468,68,68,0,1,0
14,468,468,42,20,22,2,1
26,469,469,50,9,41,2,1
5,471,471,7,4,3,2,1
10,479,479,38,19,19,2,1
9,490,490,77,77,0,1,0
15,500,500,58,46,12,3,2

11,137,137,8,8,0,1,0
4,148,148,49,49,0,1,0
2,194,194,119,95,24,3,2
13,204,204,44,1,43,2,1
7,252,252,15,15,0,1,0
3,253,253,19,19,0,1,0
10,270,270,5,2,3,2,1
6,302,302,19,11,8,2,1
12,318,318,20,4,16,3,2
5,320,320,53,41,12,2,1
14,336,336,12,6,6,2,1
9,369,369,20,20,0,1,0
16,380,380,2,2,0,1,0
15,396,396,69,23,46,3,2
18,446,446,133,1,132,4,3
8,453,453,43,43,0,1,0
17,455,455,55,13,42,2,1
0,465,465,64,64,0,1,0
1,495,495,123,20,103,4,3

1,103,103,5,5,0,1,0
9,110,110,1,1,0,1,0
10,125,125,9,9,0,1,0
22,130,130,2,2,0,1,0
3,137,137,32,5,27,4,3
25,146,146,35,35,0,1,0
21,152,152,2,2,0,1,0
14,155,155,14,14,0,1,0
5,162,162,1,1,0,1,0
8,168,168,84,14,70,3,2
27,199,199,37,37,0,1,0
7,206,206,5,1,4,2,1
20,231,231,1,1,0,1,0
11,254,254,7,7,0,1,0
24,271,271,20,20,0,1,0
23,324,324,11,11,0,1,0
16,335,335,38,20,18,3,2
0,384,384,8,8,0,1,0
26,388,388,15,15,0,1,0
15,395,395,13,13,0,1,0
28,409,409,148,148,0,1,0
4,423,423,76,64,12,2,1
19,447,447,81,81,0,1,0
6,460,460,19,2,17,2,1
17,466,466,60,5,55,4,3
2,474,474,8,8,0,1,0
12,476,476,1,1,0,1,0
18,496,496,4,4,0,1,0
13,500,500,64,26,38,4,3

19,121,121,15,3,12,3,2
8,130,130,7,7,0,1,0
7,130,130,9,9,0,1,0
27,147,147,25,1,24,4,3
11,159,159,7,7,0,1,0
17,224,224,50,5,45,4,3
3,233,233,14,8,6,3,2
0,251,251,24,24,0,1,0
16,278,278,61,61,0,1,0
24,307,307,6,6,0,1,0
1,310,310,55,55,0,1,0
14,327,327,38,10,28,2,1
26,335,335,39,5,34,3,2
12,335,335,29,29,0,1,0
20,350,350,40,40,0,1,0
2,350,350,37,37,0,1,0
18,364,364,1,1,0,1,0
22,366,366,30,30,0,1,0
4,376,376,21,21,0,1,0
6,394,394,20,20,0,1,0
21,435,435,2,2,0,1,0
25,444,444,12,12,0,1,0
10,446,446,72,23,49,2,1
5,449,449,148,100,48,3,2
13,468,468,38,27,11,2,1
15,472,472,10,10,0,1,0
9,472,472,14,14,0,1,0
23,497,497,95,80,15,4,3

10,106,106,46,46,0,1,0
31,113,113,6,1,5,2,1
7,121,121,20,20,0,1,0
0,154,154,15,6,9,4,3
4,159,159,2,2,0,1,0
3,159,159,16,16,0,1,0
1,213,213,8,2,6,3,2
18,228,228,7,7,0,1,0
26,228,228,22,7,15,4,3
12,249,249,5,5,0,1,0
15,250,250,8,8,0,1,0
2,266,266,9,9,0,1,0
14,278,278,2,2,0,1,0
11,280,280,35,1,34,2,1
24,298,298,43,43,0,1,0
16,303,303,2,2,0,1,0
13,311,311,19,19,0,1,0
20,325,325,15,15,0,1,0
25,336,336,13,13,0,1,0
9,337,337,2,2,0,1,0
30,349,349,3,3,0,1,0
21,359,359,2,2,0,1,0
19,366,366,10,10,0,1,0
6,383,383,64,64,0,1,0
23,404,404,15,15,0,1,0
28,410,410,194,194,0,1,0
29,413,413,64,42,22,2,1
22,429,429,51,51,0,1,0
5,447,447,18,18,0,1,0
17,448,448,4,4,0,1,0
8,487,487,22,11,11,2,1
27,488,488,89,89,0,1,0

25,110,110,5,5,0,1,0
7,111,111,9,6,3,2,1
16,126,126,20,20,0,1,0
0,129,129,39,4,35,2,1
11,145,145,11,11,0,1,0
4,153,153,19,3,16,2,1
3,183,183,8,1,7,2,1
9,193,193,11,11,0,1,0
14,205,205,64,34,30,3,2
21,231,231,15,8,7,2,1
26,256,256,16,10,6,3,2
12,261,261,10,1,9,2,1
5,282,282,25,16,9,4,3
17,288,288,4,4,0,1,0
24,297,297,33,28,5,2,1
2,359,359,10,10,0,1,0
10,382,382,140,22,118,4,3
23,391,391,37,3,34,3,2
13,401,401,6,6,0,1,0
18,404,404,66,66,0,1,0
22,423,423,37,19,18,3,2
20,435,435,23,23,0,1,0
1,435,435,3,3,0,1,0
8,447,447,16,16,0,1,0
27,447,447,45,33,12,4,3
19,462,462,26,26,0,1,0
15,487,487,47,47,0,1,0
6,496,496,68,59,9,2,1

6,104,104,9,9,0,1,0
18,109,109,21,21,0,1,0
8,127,127,21,21,0,1,0
32,127,127,15,1,14,4,3
16,174,174,18,18,0,1,0
9,197,197,7,7,0,1,0
30,208,208,96,24,72,4,3
26,211,211,18,3,15,4,3
11,217,217,3,3,0,1,0
19,219,219,22,22,0,1,0
2,232,232,4,1,3,2,1
24,248,248,13,4,9,4,3
28,257,257,5,5,0,1,0
17,270,270,3,3,0,1,0
23,278,278,1,1,0,1,0
31,280,280,28,5,23,4,3
1,302,302,13,4,9,4,3
22,305,305,14,8,6,2,1
5,307,307,1,1,0,1,0
7,308,308,7,7,0,1,0
21,312,312,2,2,0,1,0
33,317,317,47,47,0,1,0
29,321,321,5,2,3,2,1
27,334,334,10,10,0,1,0
15,357,357,13,13,0,1,0
3,397,397,36,36,0,1,0
13,407,407,19,19,0,1,0
4,409,409,31,31,0,1,0
25,411,411,65,19,46,2,1
14,433,433,4,4,0,1,0
10,436,436,41,33,8,3,2
20,453,453,81,47,34,3,2
0,492,492,98,41,57,4,3
12,499,499,27,27,0,1,0

16,102,102,10,6,4,2,1
23,147,147,40,25,15,2,1
9,160,160,16,16,0,1,0
4,165,165,14,14,0,1,0
12,181,181,4,4,0,1,0
3,194,194,27,27,0,1,0
20,212,212,24,24,0,1,0
17,231,231,5,5,0,1,0
24,259,259,33,33,0,1,0
8,281,281,18,18,0,1,0
25,283,283,32,32,0,1,0
5,288,288,26,12,14,2,1
13,304,304,81,54,27,4,3
21,310,310,43,24,19,2,1
1,338,338,17,17,0,1,0
15,373,373,4,4,0,1,0
2,376,376,87,21,66,4,3
6,382,382,1,1,0,1,0
11,392,392,49,49,0,1,0
7,399,399,91,60,31,2,1
0,454,454,12,1,11,4,3
10,455,455,118,10,108,4,3
19,455,455,69,5,64,3,2
14,474,474,5,5,0,1,0
22,481,481,4,4,0,1,0
18,486,486,34,34,0,1,0

7,100,100,50,35,15,4,3
10,113,113,3,3,0,1,0
16,118,118,3,3,0,1,0
15,124,124,37,37,0,1,0
9,126,126,11,11,0,1,0
8,142,142,12,12,0,1,0
13,152,152,11,2,9,4,3
3,201,201,4,4,0,1,0
17,266,266,37,37,0,1,0
4,273,273,26,26,0,1,0
18,328,328,31,9,22,4,3
23,333,333,12,12,0,1,0
5,337,337,33,33,0,1,0
20,356,356,77,17,60,4,3
21,381,381,1,1,0,1,0
1,399,399,27,27,0,1,0
19,439,439,5,5,0,1,0
11,441,441,69,69,0,1,0
0,442,442,108,48,60,4,3
22,451,451,25,4,21,4,3
6,454,454,8,8,0,1,0
12,463,463,139,18,121,4,3
14,471,471,1,1,0,1,0
2,478,478,91,91,0,1,0

7,121,121,11,1,10,3,2
18,121,121,20,2,18,4,3
8,126,126,15,15,0,1,0
9,148,148,15,15,0,1,0
5,154,154,4,4,0,1,0
28,164,164,12,12,0,1,0
16,171,171,1,1,0,1,0
19,174,174,12,12,0,1,0
27,175,175,4,4,0,1,0
1,210,210,21,21,0,1,0
10,231,231,30,30,0,1,0
15,237,237,16,3,13,2,1
12,238,238,8,8,0,1,0
3,242,242,29,12,17,2,1
6,263,263,11,5,6,3,2
2,273,273,9,5,4,2,1
20,285,285,86,86,0,1,0
17,301,301,31,31,0,1,0
21,332,332,14,14,0,1,0
25,339,339,53,53,0,1,0
0,354,354,2,2,0,1,0
23,355,355,26,18,8,2,1
4,372,372,129,48,81,4,3
22,385,385,6,6,0,1,0
13,417,417,8,3,5,2,1
24,426,426,34,13,21,4,3
26,434,434,22,22,0,1,0
11,438,438,3,3,0,1,0
29,445,445,23,23,0,1,0
31,462,462,6,6,0,1,0
30,465,465,144,79,65,4,3
14,478,478,25,5,20,4,3

6,106,106,5,5,0,1,0
1,113,113,3,3,0,1,0
24,124,124,23,23,0,1,0
36,124,124,3,3,0,1,0
5,133,133,19,19,0,1,0
15,150,150,9,9,0,1,0
37,182,182,22,22,0,1,0
11,222,222,14,14,0,1,0
26,222,222,18,6,12,2,1
12,227,227,5,5,0,1,0
2,233,233,33,33,0,1,0
13,237,237,3,3,0,1,0
3,239,239,10,1,9,4,3
32,245,245,9,9,0,1,0
17,247,247,16,6,10,2,1
14,282,282,1,1,0,1,0
9,333,333,26,1,25,3,2
19,351,351,16,16,0,1,0
18,354,354,1,1,0,1,0
0,357,357,38,38,0,1,0
28,358,358,28,28,0,1,0
27,358,358,34,34,0,1,0
21,378,378,40,40,0,1,0
20,380,380,5,2,3,2,1
4,391,391,12,1,11,2,1
16,393,393,11,11,0,1,0
34,397,397,31,31,0,1,0
10,434,434,27,27,0,1,0
30,434,434,7,7,0,1,0
25,439,439,8,8,0,1,0
22,441,441,9,9,0,1,0
29,447,447,97,97,0,1,0
35,449,449,41,41,0,1,0
8,449,449,22,6,16,4,3
23,452,452,7,7,0,1,0
7,458,458,100,19,81,4,3
31,467,467,137,125,12,4,3
33,472,472,40,40,0,1,0

2,127,127,20,20,0,1,0
23,141,141,20,20,0,1,0
18,152,152,8,8,0,1,0
22,154,154,3,3,0,1,0
15,158,158,6,2,4,2,1
19,192,192,4,4,0,1,0
3,209,209,10,5,5,2,1
8,214,214,24,24,0,1,0
13,222,222,85,39,46,3,2
16,222,222,20,20,0,1,0
1,224,224,23,6,17,3,2
21,259,259,45,6,39,2,1
14,267,267,1,1,0,1,0
24,305,305,15,15,0,1,0
0,305,305,29,23,6,2,1
12,326,326,10,10,0,1,0
4,339,339,77,77,0,1,0
6,347,347,27,3,24,4,3
25,359,359,18,18,0,1,0
11,397,397,14,10,4,2,1
20,405,405,28,28,0,1,0
26,430,430,107,5,102,4,3
17,435,435,37,37,0,1,0
5,441,441,114,74,40,3,2
10,448,448,28,8,20,2,1
9,470,470,75,47,28,3,2
7,473,473,17,2,15,4,3

26,111,111,27,27,0,1,0
1,123,123,25,25,0,1,0
14,124,124,2,2,0,1,0
3,157,157,24,4,20,2,1
19,160,160,7,7,0,1,0
8,182,182,9,1,8,2,1
6,193,193,3,3,0,1,0
20,207,207,51,51,0,1,0
9,218,218,54,27,27,4,3
24,264,264,1,1,0,1,0
12,285,285,60,22,38,3,2
2,297,297,20,1,19,2,1
18,301,301,1,1,0,1,0
11,302,302,29,17,12,2,1
22,347,347,8,8,0,1,0
25,350,350,34,34,0,1,0
0,391,391,49,49,0,1,0
5,396,396,5,5,0,1,0
21,399,399,110,83,27,4,3
27,440,440,132,24,108,4,3
17,451,451,16,6,10,3,2
4,451,451,28,2,26,3,2
23,455,455,28,28,0,1,0
15,459,459,30,12,18,2,1
16,476,476,4,4,0,1,0
7,486,486,21,9,12,2,1
13,492,492,13,13,0,1,0
10,500,500,44,28,16,2,1

13,104,104,11,11,0,1,0
29,126,126,7,7,0,1,0
17,132,132,10,10,0,1,0
7,134,134,8,8,0,1,0
9,152,152,48,25,23,2,1
19,179,179,39,5,34,2,1
21,201,201,18,13,5,2,1
12,204,204,17,7,10,3,2
30,218,218,3,3,0,1,0
0,219,219,12,12,0,1,0
5,229,229,46,46,0,1,0
8,251,251,1,1,0,1,0
24,262,262,20,20,0,1,0
27,265,265,18,2,16,3,2
15,288,288,25,12,13,4,3
1,289,289,6,6,0,1,0
16,321,321,6,2,4,2,1
4,322,322,12,12,0,1,0
25,335,335,28,19,9,4,3
26,337,337,11,5,6,3,2
18,339,339,25,25,0,1,0
2,350,350,11,11,0,1,0
22,355,355,24,24,0,1,0
20,375,375,15,15,0,1,0
11,383,383,5,5,0,1,0
3,409,409,1,1,0,1,0
31,418,418,182,163,19,2,1
14,433,433,33,33,0,1,0
10,440,440,23,23,0,1,0
6,476,476,77,41,36,3,2
28,487,487,40,33,7,2,1
23,489,489,45,45,0,1,0

28,103,103,12,12,0,1,0
10,122,122,15,1,14,2,1
15,124,124,20,20,0,1,0
13,147,147,1,1,0,1,0
5,149,149,6,3,3,2,1
17,156,156,4,4,0,1,0
4,163,163,9,9,0,1,0
31,167,167,18,13,5,2,1
6,182,182,6,1,5,2,1
12,184,184,14,14,0,1,0
23,199,199,44,7,37,2,1
2,262,262,53,53,0,1,0
7,263,263,3,3,0,1,0
25,273,273,11,5,6,3,2
3,274,274,10,10,0,1,0
16,293,293,6,6,0,1,0
26,302,302,21,21,0,1,0
19,302,302,4,4,0,1,0
14,320,320,90,90,0,1,0
22,326,326,45,24,21,4,3
18,331,331,45,2,43,4,3
11,336,336,29,29,0,1,0
27,359,359,38,7,31,3,2
32,400,400,40,40,0,1,0
0,418,418,7,7,0,1,0
33,448,448,25,25,0,1,0
20,452,452,53,5,48,4,3
29,460,460,47,37,10,3,2
1,460,460,4,1,3,2,1
21,472,472,34,10,24,4,3
24,487,487,13,7,6,2,1
30,496,496,74,62,12,4,3
8,497,497,3,3,0,1,0
9,500,500,30,30,0,1,0

21,101,101,14,14,0,1,0
6,126,126,18,18,0,1,0
13,148,148,3,3,0,1,0
22,153,153,25,25,0,1,0
20,155,155,49,49,0,1,0
11,176,176,25,17,8,2,1
3,199,199,23,23,0,1,0
14,228,228,39,39,0,1,0
17,232,232,28,6,22,2,1
12,234,234,38,5,33,2,1
10,244,244,18,18,0,1,0
15,246,246,8,2,6,2,1
24,275,275,1,1,0,1,0
23,278,278,45,7,38,3,2
4,311,311,18,2,16,3,2
9,322,322,40,30,10,3,2
0,354,354,31,2,29,3,2
16,360,360,11,1,10,2,1
1,378,378,61,37,24,2,1
18,384,384,12,12,0,1,0
2,395,395,33,19,14,2,1
5,400,400,117,69,48,4,3
25,409,409,25,6,19,2,1
19,430,430,9,9,0,1,0
7,434,434,37,1,36,4,3
8,439,439,15,4,11,2,1

18,115,115,18,18,0,1,0
14,117,117,23,23,0,1,0
9,138,138,7,7,0,1,0
27,147,147,12,2,10,2,1
12,162,162,2,2,0,1,0
3,167,167,25,25,0,1,0
23,167,167,37,37,0,1,0
8,175,175,2,2,0,1,0
5,177,177,16,7,9,4,3
15,184,184,2,2,0,1,0
29,203,203,6,6,0,1,0
13,211,211,10,10,0,1,0
26,275,275,81,42,39,2,1
6,282,282,1,1,0,1,0
21,283,283,67,67,0,1,0
17,283,283,10,10,0,1,0
28,288,288,3,3,0,1,0
10,289,289,34,34,0,1,0
20,325,325,1,1,0,1,0
24,343,343,9,9,0,1,0
19,345,345,10,10,0,1,0
22,350,350,51,51,0,1,0
30,372,372,37,37,0,1,0
11,411,411,110,72,38,2,1
2,412,412,93,15,78,4,3
16,412,412,5,2,3,2,1
7,425,425,49,31,18,2,1
4,433,433,10,10,0,1,0
0,459,459,10,10,0,1,0
25,497,497,30,30,0,1,0
1,499,499,23,23,0,1,0

12,114,114,3,3,0,1,0
3,119,119,29,13,16,3,2
13,167,167,36,36,0,1,0
25,167,167,3,3,0,1,0
14,174,174,30,30,0,1,0
8,178,178,19,7,12,3,2
2,202,202,26,13,13,3,2
19,205,205,3,3,0,1,0
22,219,219,12,7,5,2,1
24,248,248,22,22,0,1,0
18,252,252,12,12,0,1,0
7,252,252,23,10,13,2,1
21,260,260,11,11,0,1,0
9,268,268,2,2,0,1,0
17,298,298,60,60,0,1,0
0,314,314,61,18,43,2,1
23,364,364,3,3,0,1,0
4,384,384,90,74,16,3,2
10,429,429,5,5,0,1,0
6,434,434,100,100,0,1,0
15,441,441,83,73,10,3,2
20,441,441,71,21,50,3,2
16,454,454,87,87,0,1,0
5,474,474,24,11,13,2,1
11,500,500,1,1,0,1,0
1,500,500,50,50,0,1,0

33,110,110,1,1,0,1,0
29,111,111,14,14,0,1,0
1,131,131,1,1,0,1,0
22,134,134,9,3,6,3,2
14,150,150,22,22,0,1,0
27,155,155,42,42,0,1,0
8,159,159,8,8,0,1,0
7,195,195,1,1,0,1,0
19,211,211,10,2,8,3,2
9,214,214,15,3,12,2,1
10,257,257,7,7,0,1,0
25,259,259,1,1,0,1,0
5,265,265,9,9,0,1,0
28,268,268,76,76,0,1,0
0,268,268,80,41,39,2,1
16,272,272,15,4,11,2,1
23,287,287,48,44,4,2,1
18,297,297,5,5,0,1,0
24,309,309,10,10,0,1,0
17,337,337,63,63,0,1,0
26,345,345,1,1,0,1,0
21,349,349,15,5,10,3,2
11,352,352,2,2,0,1,0
4,358,358,13,5,8,3,2
15,361,361,1,1,0,1,0
34,384,384,21,21,0,1,0
6,396,396,19,19,0,1,0
30,408,408,62,62,0,1,0
12,416,416,13,13,0,1,0
20,427,427,25,5,20,2,1
13,433,433,23,23,0,1,0
32,459,459,24,24,0,1,0
2,475,475,67,4,63,3,2
3,482,482,38,38,0,1,0
31,497,497,80,25,55,3,2

10,122,122,34,7,27,2,1
9,126,126,10,1,9,2,1
3,134,134,1,1,0,1,0
14,136,136,8,8,0,1,0
2,145,145,7,7,0,1,0
7,284,284,38,38,0,1,0
8,300,300,69,10,59,3,2
12,306,306,19,7,12,3,2
21,315,315,43,40,3,2,1
11,330,330,87,87,0,1,0
16,336,336,32,32,0,1,0
5,355,355,65,14,51,4,3
13,374,374,5,5,0,1,0
18,376,376,13,13,0,1,0
6,389,389,13,13,0,1,0
1,392,392,1,1,0,1,0
20,431,431,63,33,30,4,3
22,443,443,65,65,0,1,0
0,473,473,136,43,93,4,3
4,473,473,189,60,129,4,3
23,480,480,19,1,18,3,2
15,486,486,45,16,29,2,1
19,491,491,9,6,3,2,1
17,496,496,16,16,0,1,0

1,139,139,2,2,0,1,0
14,146,146,6,6,0,1,0
9,160,160,40,10,30,4,3
12,169,169,44,8,36,2,1
22,173,173,20,5,15,4,3
5,183,183,17,2,15,4,3
24,187,187,9,9,0,1,0
2,198,198,1,1,0,1,0
18,274,274,50,8,42,3,2
23,280,280,57,41,16,2,1
20,297,297,42,26,16,2,1
16,309,309,31,31,0,1,0
26,324,324,55,55,0,1,0
19,324,324,23,23,0,1,0
25,329,329,2,2,0,1,0
13,330,330,94,62,32,3,2
21,336,336,67,67,0,1,0
4,338,338,3,3,0,1,0
8,373,373,7,7,0,1,0
3,386,386,118,86,32,3,2
15,405,405,12,9,3,2,1
7,415,415,2,2,0,1,0
0,419,419,9,5,4,2,1
6,425,425,28,22,6,3,2
11,445,445,8,8,0,1,0
17,450,450,27,5,22,2,1
27,465,465,26,26,0,1,0
10,493,493,25,1,24,3,2

15,104,104,2,2,0,1,0
12,108,108,1,1,0,1,0
24,121,121,3,3,0,1,0
5,127,127,2,2,0,1,0
7,143,143,19,3,16,3,2
0,152,152,37,37,0,1,0
21,180,180,31,31,0,1,0
6,236,236,23,23,0,1,0
18,242,242,39,5,34,3,2
14,247,247,57,36,21,2,1
9,263,263,23,23,0,1,0
25,289,289,36,21,15,4,3
23,290,290,12,4,8,3,2
26,295,295,34,16,18,2,1
2,303,303,1,1,0,1,0
4,312,312,42,9,33,4,3
3,321,321,22,22,0,1,0
28,334,334,67,67,0,1,0
11,346,346,1,1,0,1,0
10,349,349,66,66,0,1,0
20,359,359,45,21,24,2,1
13,387,387,32,23,9,4,3
1,435,435,21,21,0,1,0
29,438,438,26,11,15,4,3
19,444,444,17,1,16,3,2
8,444,444,16,16,0,1,0
27,448,448,58,6,52,3,2
22,463,463,5,5,0,1,0
17,463,463,73,31,42,4,3
16,472,472,29,29,0,1,0

8,108,108,34,34,0,1,0
11,135,135,8,5,3,2,1
21,141,141,11,11,0,1,0
12,153,153,12,12,0,1,0
15,162,162,3,3,0,1,0
1,171,171,30,30,0,1,0
14,206,206,16,11,5,2,1
3,208,208,6,6,0,1,0
0,217,217,2,2,0,1,0
9,235,235,5,5,0,1,0
16,236,236,8,8,0,1,0
10,247,247,11,2,9,3,2
19,297,297,110,86,24,3,2
13,309,309,3,3,0,1,0
2,315,315,25,12,13,2,1
5,346,346,122,122,0,1,0
18,363,363,40,40,0,1,0
24,375,375,59,35,24,3,2
23,396,396,60,60,0,1,0
4,397,397,83,55,28,3,2
7,403,403,8,8,0,1,0
20,415,415,61,23,38,3,2
22,442,442,1,1,0,1,0
17,481,481,67,37,30,3,2
6,491,491,72,72,0,1,0

11,102,102,11,1,10,3,2
5,109,109,6,1,5,2,1
2,127,127,1,1,0,1,0
15,139,139,10,2,8,3,2
19,150,150,27,7,20,2,1
10,188,188,16,16,0,1,0
4,204,204,1,1,0,1,0
18,227,227,15,5,10,2,1
23,260,260,14,14,0,1,0
13,278,278,22,22,0,1,0
12,280,280,6,6,0,1,0
24,293,293,84,18,66,4,3
6,321,321,54,9,45,2,1
14,325,325,18,8,10,3,2
0,356,356,51,5,46,3,2
7,370,370,88,27,61,4,3
8,377,377,20,20,0,1,0
17,416,416,81,27,54,4,3
21,432,432,17,17,0,1,0
3,436,436,159,120,39,4,3
1,436,436,43,43,0,1,0
20,443,443,60,27,33,4,3
22,449,449,2,2,0,1,0
9,483,483,88,88,0,1,0
16,486,486,64,2,62,3,2

4,117,117,3,3,0,1,0
7,127,127,6,6,0,1,0
22,128,128,16,1,15,4,3
27,156,156,2,2,0,1,0
17,169,169,9,3,6,3,2
30,186,186,20,1,19,2,1
12,196,196,12,1,11,2,1
18,208,208,17,5,12,3,2
16,225,225,9,3,6,2,1
25,225,225,1,1,0,1,0
19,230,230,88,88,0,1,0
6,242,242,10,10,0,1,0
21,254,254,3,3,0,1,0
9,265,265,57,57,0,1,0
10,293,293,6,6,0,1,0
14,295,295,15,15,0,1,0
13,316,316,1,1,0,1,0
26,320,320,25,2,23,2,1
23,335,335,14,14,0,1,0
3,363,363,22,22,0,1,0
20,366,366,35,1,34,3,2
0,421,421,45,3,42,3,2
15,426,426,134,111,23,2,1
1,429,429,100,100,0,1,0
8,435,435,51,9,42,2,1
29,436,436,74,2,72,4,3
11,455,455,1,1,0,1,0
5,469,469,1,1,0,1,0
2,481,481,30,4,26,2,1
28,481,481,114,89,25,2,1
24,482,482,14,14,0,1,0

10,104,104,11,8,3,2,1
5,134,134,27,17,10,2,1
20,134,134,3,3,0,1,0
3,151,151,1,1,0,1,0
9,162,162,15,15,0,1,0
7,211,211,11,11,0,1,0
15,256,256,72,72,0,1,0
23,288,288,21,3,18,2,1
11,311,311,39,39,0,1,0
13,322,322,18,8,10,2,1
22,343,343,47,47,0,1,0
14,363,363,4,4,0,1,0
17,369,369,35,35,0,1,0
2,373,373,74,74,0,1,0
12,383,383,46,43,3,2,1
19,386,386,100,95,5,2,1
1,388,388,37,37,0,1,0
4,389,389,43,43,0,1,0
21,394,394,39,39,0,1,0
25,401,401,68,68,0,1,0
18,425,425,13,3,10,2,1
8,426,426,106,78,28,3,2
6,433,433,29,29,0,1,0
16,471,471,19,19,0,1,0
0,475,475,46,30,16,2,1
24,496,496,10,10,0,1,0

9,109,109,7,7,0,1,0
10,109,109,15,8,7,2,1
6,110,110,18,18,0,1,0
11,119,119,33,23,10,3,2
4,123,123,41,1,40,3,2
18,126,126,17,17,0,1,0
0,197,197,26,26,0,1,0
2,221,221,20,6,14,2,1
8,284,284,3,3,0,1,0
17,284,284,8,8,0,1,0
15,348,348,92,3,89,4,3
16,356,356,31,31,0,1,0
14,367,367,3,3,0,1,0
12,403,403,70,11,59,4,3
7,414,414,14,11,3,2,1
13,414,414,7,4,3,2,1
1,423,423,265,265,0,1,0
3,441,441,33,33,0,1,0
19,447,447,13,13,0,1,0
5,489,489,70,10,60,3,2

1,103,103,1,1,0,1,0
13,107,107,1,1,0,1,0
17,109,109,1,1,0,1,0
35,131,131,3,3,0,1,0
7,143,143,3,3,0,1,0
23,188,188,16,16,0,1,0
18,188,188,30,30,0,1,0
10,189,189,18,18,0,1,0
5,206,206,1,1,0,1,0
34,228,228,37,32,5,2,1
25,248,248,3,3,0,1,0
21,249,249,18,2,16,3,2
37,254,254,31,13,18,3,2
9,256,256,8,2,6,3,2
3,270,270,23,9,14,2,1
26,271,271,12,12,0,1,0
31,278,278,73,73,0,1,0
6,287,287,9,9,0,1,0
2,291,291,14,14,0,1,0
14,309,309,12,12,0,1,0
11,315,315,22,11,11,2,1
19,319,319,22,22,0,1,0
28,324,324,37,37,0,1,0
36,368,368,102,102,0,1,0
4,371,371,57,57,0,1,0
30,375,375,41,9,32,3,2
16,387,387,49,49,0,1,0
33,401,401,8,8,0,1,0
0,403,403,17,17,0,1,0
15,414,414,15,5,10,2,1
22,424,424,60,5,55,3,2
32,428,428,48,33,15,2,1
27,430,430,19,19,0,1,0
8,435,435,12,12,0,1,0
24,459,459,28,28,0,1,0
12,463,463,3,3,0,1,0
20,487,487,14,14,0,1,0
29,488,488,30,30,0,1,0

29,126,126,16,16,0,1,0
19,127,127,25,6,19,2,1
9,144,144,24,9,15,2,1
24,152,152,13,13,0,1,0
8,156,156,11,1,10,3,2
20,183,183,54,19,35,2,1
30,186,186,39,3,36,2,1
15,188,188,2,2,0,1,0
26,201,201,7,7,0,1,0
18,223,223,1,1,0,1,0
4,237,237,12,12,0,1,0
13,251,251,32,32,0,1,0
28,290,290,35,35,0,1,0
10,290,290,1,1,0,1,0
25,294,294,1,1,0,1,0
22,296,296,9,9,0,1,0
16,308,308,14,2,12,2,1
6,320,320,81,49,32,3,2
14,333,333,27,27,0,1,0
32,376,376,50,50,0,1,0
17,379,379,9,9,0,1,0
21,387,387,8,4,4,2,1
7,387,387,28,28,0,1,0
1,404,404,4,4,0,1,0
12,411,411,35,35,0,1,0
27,421,421,43,26,17,2,1
2,452,452,73,73,0,1,0
23,454,454,15,6,9,2,1
31,460,460,16,16,0,1,0
0,464,464,81,21,60,4,3
5,465,465,5,5,0,1,0
11,476,476,5,5,0,1,0
3,497,497,20,20,0,1,0

7,127,127,19,19,0,1,0
11,130,130,5,5,0,1,0
17,153,153,1,1,0,1,0
29,156,156,26,26,0,1,0
15,207,207,12,12,0,1,0
8,215,215,4,4,0,1,0
27,215,215,7,7,0,1,0
31,231,231,6,3,3,2,1
30,238,238,41,25,16,3,2
21,247,247,5,5,0,1,0
12,249,249,19,7,12,2,1
5,266,266,7,3,4,2,1
25,266,266,9,1,8,2,1
24,270,270,13,5,8,2,1
10,273,273,3,3,0,1,0
0,282,282,17,17,0,1,0
22,288,288,41,41,0,1,0
32,290,290,2,2,0,1,0
16,290,290,1,1,0,1,0
20,306,306,48,27,21,4,3
23,318,318,51,41,10,2,1
19,331,331,18,4,14,2,1
4,332,332,35,17,18,2,1
34,341,341,77,53,24,2,1
18,342,342,1,1,0,1,0
33,368,368,34,34,0,1,0
1,370,370,16,5,11,2,1
3,389,389,59,49,10,2,1
9,406,406,84,84,0,1,0
6,414,414,23,5,18,3,2
13,442,442,4,4,0,1,0
14,454,454,70,70,0,1,0
2,480,480,6,3,3,2,1
28,480,480,16,5,11,2,1
26,500,500,132,132,0,1,0

14,121,121,2,2,0,1,0
22,138,138,4,4,0,1,0
12,151,151,15,15,0,1,0
19,152,152,23,18,5,2,1
23,158,158,8,2,6,3,2
9,159,159,5,5,0,1,0
5,193,193,18,2,16,3,2
4,211,211,29,13,16,3,2
24,219,219,17,17,0,1,0
18,219,219,52,52,0,1,0
17,220,220,26,18,8,3,2
13,223,223,12,6,6,2,1
1,250,250,68,68,0,1,0
21,253,253,55,1,54,3,2
10,264,264,26,14,12,2,1
16,293,293,36,16,20,2,1
6,300,300,83,51,32,2,1
20,302,302,6,6,0,1,0
3,316,316,1,1,0,1,0
15,343,343,78,78,0,1,0
8,345,345,27,18,9,2,1
0,348,348,13,7,6,3,2
11,420,420,5,2,3,2,1
7,445,445,70,70,0,1,0
2,463,463,100,100,0,1,0

26,104,104,9,9,0,1,0
18,129,129,4,4,0,1,0
23,130,130,12,1,11,2,1
17,156,156,5,5,0,1,0
20,206,206,1,1,0,1,0
12,211,211,16,8,8,3,2
15,214,214,14,14,0,1,0
14,231,231,3,3,0,1,0
10,239,239,86,8,78,4,3
24,248,248,7,7,0,1,0
2,286,286,6,3,3,2,1
5,295,295,6,6,0,1,0
4,307,307,8,1,7,2,1
1,315,315,25,1,24,2,1
11,341,341,18,18,0,1,0
0,342,342,59,59,0,1,0
8,347,347,94,94,0,1,0
21,349,349,66,28,38,3,2
13,352,352,113,34,79,4,3
6,354,354,5,5,0,1,0
22,364,364,119,103,16,3,2
9,392,392,69,65,4,2,1
7,424,424,55,22,33,3,2
25,444,444,42,42,0,1,0
3,446,446,1,1,0,1,0
16,463,463,49,9,40,2,1
19,466,466,19,8,11,2,1

19,105,105,5,2,3,2,1
26,138,138,2,2,0,1,0
30,141,141,3,3,0,1,0
8,144,144,1,1,0,1,0
23,147,147,3,3,0,1,0
17,147,147,11,11,0,1,0
21,169,169,27,11,16,2,1
6,170,170,8,8,0,1,0
16,187,187,15,15,0,1,0
32,188,188,3,3,0,1,0
13,204,204,3,3,0,1,0
18,232,232,13,13,0,1,0
7,240,240,13,13,0,1,0
11,250,250,38,38,0,1,0
20,263,263,35,35,0,1,0
28,276,276,37,37,0,1,0
3,280,280,9,3,6,3,2
25,285,285,18,2,16,3,2
0,294,294,23,23,0,1,0
10,303,303,5,2,3,2,1
33,303,303,196,165,31,2,1
1,325,325,4,4,0,1,0
12,331,331,14,4,10,2,1
15,332,332,51,51,0,1,0
35,370,370,16,6,10,2,1
31,374,374,12,12,0,1,0
29,382,382,24,2,22,2,1
2,404,404,8,8,0,1,0
34,409,409,38,38,0,1,0
24,412,412,3,3,0,1,0
22,414,414,11,11,0,1,0
5,425,425,35,11,24,2,1
27,430,430,110,89,21,2,1
4,480,480,9,9,0,1,0
14,480,480,1,1,0,1,0
9,498,498,60,45,15,4,3

5,114,114,2,2,0,1,0
16,115,115,2,2,0,1,0
6,181,181,21,3,18,4,3
14,184,184,27,27,0,1,0
28,203,203,26,2,24,2,1
8,207,207,56,56,0,1,0
2,210,210,5,5,0,1,0
4,244,244,8,5,3,2,1
13,253,253,7,7,0,1,0
24,265,265,8,5,3,2,1
27,269,269,49,49,0,1,0
10,292,292,36,9,27,4,3
17,313,313,18,18,0,1,0
15,319,319,95,95,0,1,0
1,361,361,4,4,0,1,0
21,362,362,33,33,0,1,0
7,370,370,18,2,16,3,2
9,410,410,120,120,0,1,0
22,420,420,71,35,36,4,3
12,424,424,53,53,0,1,0
3,436,436,25,20,5,2,1
18,444,444,47,21,26,2,1
23,454,454,9,9,0,1,0
11,475,475,2,2,0,1,0
20,479,479,8,8,0,1,0
0,483,483,52,52,0,1,0
19,484,484,16,6,10,2,1
25,484,484,53,27,26,2,1
26,494,494,82,14,68,4,3

22,110,110,1,1,0,1,0
12,112,112,2,2,0,1,0
26,120,120,5,5,0,1,0
15,140,140,19,19,0,1,0
10,211,211,3,3,0,1,0
13,226,226,1,1,0,1,0
20,229,229,22,10,12,3,2
9,230,230,65,59,6,3,2
21,242,242,4,4,0,1,0
25,273,273,47,19,28,2,1
8,295,295,8,8,0,1,0
24,308,308,68,68,0,1,0
1,324,324,5,5,0,1,0
19,326,326,13,1,12,2,1
23,333,333,22,2,20,3,2
0,345,345,2,2,0,1,0
6,370,370,60,31,29,2,1
16,389,389,13,1,12,2,1
5,409,409,163,163,0,1,0
3,424,424,18,2,16,3,2
7,426,426,33,33,0,1,0
2,434,434,28,28,0,1,0
17,436,436,112,76,36,4,3
14,443,443,1,1,0,1,0
18,457,457,2,2,0,1,0
4,469,469,126,100,26,3,2
27,473,473,87,87,0,1,0
11,480,480,8,8,0,1,0
28,491,491,74,74,0,1,0

26,101,101,17,3,14,3,2
1,124,124,19,19,0,1,0
0,127,127,8,8,0,1,0
24,132,132,13,13,0,1,0
25,146,146,10,10,0,1,0
5,150,150,36,30,6,2,1
13,151,151,2,2,0,1,0
22,205,205,61,13,48,4,3
2,209,209,57,57,0,1,0
7,217,217,22,1,21,2,1
14,268,268,38,6,32,2,1
3,301,301,31,7,24,4,3
8,302,302,8,3,5,2,1
11,306,306,1,1,0,1,0
18,325,325,6,6,0,1,0
12,344,344,10,2,8,3,2
20,345,345,4,4,0,1,0
23,351,351,75,53,22,2,1
9,365,365,1,1,0,1,0
4,366,366,12,12,0,1,0
27,370,370,60,20,40,3,2
19,387,387,18,7,11,2,1
15,427,427,34,34,0,1,0
10,441,441,20,2,18,4,3
6,443,443,141,95,46,3,2
16,451,451,23,3,20,2,1
21,452,452,23,15,8,2,1
17,484,484,9,9,0,1,0

14,102,102,2,2,0,1,0
5,105,105,2,2,0,1,0
8,116,116,4,4,0,1,0
3,117,117,23,11,12,2,1
20,117,117,4,1,3,2,1
15,124,124,16,3,13,2,1
16,139,139,7,7,0,1,0
9,163,163,3,3,0,1,0
21,186,186,26,6,20,3,2
13,187,187,5,5,0,1,0
17,191,191,26,9,17,2,1
10,250,250,3,3,0,1,0
18,264,264,16,16,0,1,0
23,275,275,62,9,53,3,2
11,297,297,36,36,0,1,0
4,302,302,20,7,13,3,2
19,315,315,4,4,0,1,0
24,319,319,9,9,0,1,0
22,319,319,28,18,10,3,2
27,331,331,42,42,0,1,0
12,339,339,50,37,13,2,1
26,345,345,51,34,17,4,3
2,397,397,14,3,11,2,1
25,407,407,40,40,0,1,0
0,434,434,2,2,0,1,0
7,449,449,101,85,16,3,2
1,453,453,142,37,105,4,3
28,472,472,34,26,8,3,2
6,480,480,17,7,10,2,1
29,482,482,100,84,16,2,1

20,123,123,23,23,0,1,0
16,162,162,16,16,0,1,0
0,190,190,92,92,0,1,0
17,218,218,10,10,0,1,0
7,233,233,70,15,55,3,2
13,249,249,26,2,24,3,2
6,260,260,42,42,0,1,0
5,286,286,9,9,0,1,0
1,291,291,24,24,0,1,0
9,294,294,15,15,0,1,0
2,304,304,8,5,3,2,1
18,309,309,72,27,45,4,3
3,311,311,116,100,16,2,1
8,323,323,17,11,6,2,1
14,328,328,9,9,0,1,0
12,342,342,16,11,5,2,1
10,445,445,50,50,0,1,0
4,454,454,111,47,64,3,2
11,455,455,45,12,33,2,1
15,464,464,13,1,12,2,1
19,498,498,17,8,9,4,3

19,115,115,9,9,0,1,0
18,159,159,28,28,0,1,0
2,161,161,1,1,0,1,0
0,173,173,7,7,0,1,0
13,184,184,13,9,4,2,1
8,189,189,68,68,0,1,0
6,193,193,14,14,0,1,0
17,193,193,35,35,0,1,0
3,212,212,12,9,3,2,1
24,233,233,87,48,39,4,3
4,234,234,6,6,0,1,0
27,263,263,10,10,0,1,0
7,282,282,18,13,5,2,1
23,300,300,2,2,0,1,0
16,315,315,22,7,15,2,1
21,343,343,26,26,0,1,0
29,349,349,5,5,0,1,0
11,352,352,63,35,28,3,2
25,353,353,21,21,0,1,0
9,382,382,14,2,12,2,1
10,386,386,19,19,0,1,0
12,405,405,6,6,0,1,0
28,408,408,6,2,4,2,1
1,410,410,63,54,9,2,1
26,410,410,34,34,0,1,0
5,411,411,5,1,4,2,1
15,449,449,75,75,0,1,0
14,455,455,42,42,0,1,0
20,470,470,96,96,0,1,0
22,498,498,26,17,9,4,3

11,107,107,1,1,0,1,0
5,118,118,9,9,0,1,0
37,144,144,12,5,7,2,1
6,146,146,8,8,0,1,0
4,147,147,13,13,0,1,0
17,154,154,3,3,0,1,0
26,154,154,13,13,0,1,0
20,156,156,24,13,11,2,1
13,168,168,4,4,0,1,0
10,180,180,36,36,0,1,0
0,181,181,1,1,0,1,0
1,193,193,14,8,6,2,1
35,196,196,30,30,0,1,0
25,200,200,7,7,0,1,0
8,202,202,1,1,0,1,0
15,216,216,13,5,8,3,2
22,216,216,21,21,0,1,0
7,231,231,4,4,0,1,0
27,254,254,4,1,3,2,1
30,274,274,6,6,0,1,0
23,278,278,9,9,0,1,0
14,291,291,5,5,0,1,0
33,306,306,37,10,27,3,2
18,312,312,13,1,12,3,2
9,326,326,6,6,0,1,0
28,331,331,80,11,69,4,3
21,342,342,40,40,0,1,0
12,350,350,1,1,0,1,0
16,363,363,26,26,0,1,0
34,363,363,22,22,0,1,0
32,369,369,2,2,0,1,0
31,415,415,41,37,4,2,1
3,419,419,49,49,0,1,0
2,440,440,8,2,6,2,1
19,442,442,36,12,24,4,3
24,457,457,184,184,0,1,0
36,464,464,21,21,0,1,0
29,470,470,27,2,25,3,2

3,118,118,6,6,0,1,0
31,133,133,14,14,0,1,0
8,135,135,1,1,0,1,0
28,176,176,11,11,0,1,0
16,185,185,1,1,0,1,0
13,204,204,12,12,0,1,0
9,222,222,32,2,30,2,1
19,227,227,81,51,30,4,3
29,232,232,29,29,0,1,0
1,240,240,23,23,0,1,0
18,243,243,43,11,32,4,3
27,251,251,19,2,17,4,3
32,283,283,6,6,0,1,0
23,290,290,23,8,15,4,3
12,299,299,4,4,0,1,0
2,300,300,12,12,0,1,0
7,305,305,20,20,0,1,0
4,309,309,44,7,37,3,2
26,316,316,16,6,10,3,2
22,323,323,61,5,56,3,2
10,328,328,71,22,49,2,1
5,341,341,47,31,16,3,2
21,343,343,23,23,0,1,0
20,358,358,26,9,17,2,1
0,389,389,2,2,0,1,0
25,390,390,27,3,24,3,2
24,397,397,30,30,0,1,0
6,415,415,10,10,0,1,0
15,419,419,49,2,47,2,1
11,423,423,10,1,9,4,3
17,436,436,33,3,30,3,2
14,437,437,1,1,0,1,0
30,469,469,35,35,0,1,0

0,104,104,10,10,0,1,0
1,113,113,7,1,6,3,2
33,120,120,12,12,0,1,0
6,130,130,1,1,0,1,0
30,147,147,45,6,39,2,1
13,148,148,1,1,0,1,0
26,152,152,49,49,0,1,0
16,179,179,2,2,0,1,0
11,188,188,18,18,0,1,0
28,211,211,18,18,0,1,0
18,213,213,20,20,0,1,0
23,218,218,8,8,0,1,0
14,231,231,13,13,0,1,0
31,249,249,12,12,0,1,0
25,265,265,7,7,0,1,0
29,267,267,31,31,0,1,0
17,268,268,6,6,0,1,0
27,276,276,27,27,0,1,0
4,287,287,1,1,0,1,0
9,293,293,9,6,3,2,1
12,298,298,9,9,0,1,0
5,300,300,61,8,53,4,3
10,309,309,5,5,0,1,0
20,332,332,36,36,0,1,0
15,339,339,24,24,0,1,0
3,353,353,22,22,0,1,0
7,362,362,37,11,26,2,1
24,382,382,20,20,0,1,0
8,382,382,19,1,18,2,1
22,393,393,56,9,47,2,1
34,435,435,25,21,4,2,1
2,441,441,80,30,50,3,2
32,456,456,3,3,0,1,0
21,458,458,13,13,0,1,0
19,499,499,45,25,20,3,2

3,122,122,28,4,24,2,1
17,126,126,4,4,0,1,0
18,141,141,29,21,8,3,2
15,161,161,9,9,0,1,0
16,195,195,6,6,0,1,0
19,206,206,36,36,0,1,0
21,241,241,9,9,0,1,0
10,255,255,62,30,32,3,2
20,258,258,47,37,10,3,2
4,288,288,16,16,0,1,0
13,309,309,80,47,33,2,1
1,316,316,46,10,36,2,1
14,345,345,4,1,3,2,1
12,362,362,16,4,12,2,1
7,376,376,172,120,52,3,2
6,390,390,99,8,91,4,3
2,417,417,12,3,9,2,1
11,445,445,15,15,0,1,0
9,456,456,27,7,20,3,2
5,465,465,7,3,4,2,1
0,481,481,104,47,57,4,3
8,486,486,29,20,9,4,3

31,112,112,18,1,17,2,1
24,120,120,2,2,0,1,0
12,145,145,22,4,18,4,3
18,195,195,7,7,0,1,0
25,202,202,7,7,0,1,0
5,208,208,5,5,0,1,0
9,226,226,14,14,0,1,0
16,250,250,12,12,0,1,0
17,266,266,64,16,48,4,3
19,271,271,13,8,5,2,1
8,284,284,40,2,38,2,1
6,291,291,20,8,12,4,3
3,292,292,4,4,0,1,0
22,294,294,34,23,11,2,1
27,314,314,221,172,49,2,1
14,338,338,5,2,3,2,1
10,338,338,15,15,0,1,0
0,342,342,63,29,34,2,1
30,349,349,18,18,0,1,0
28,358,358,7,1,6,3,2
13,389,389,3,3,0,1,0
20,391,391,28,1,27,4,3
29,413,413,27,21,6,3,2
15,431,431,9,9,0,1,0
11,431,431,20,20,0,1,0
23,440,440,9,9,0,1,0
2,440,440,89,89,0,1,0
7,457,457,4,4,0,1,0
26,464,464,24,9,15,4,3
4,475,475,3,3,0,1,0
21,477,477,12,6,6,2,1
1,497,497,58,58,0,1,0

17,112,112,2,2,0,1,0
11,126,126,3,3,0,1,0
9,128,128,1,1,0,1,0
13,141,141,9,9,0,1,0
4,177,177,66,66,0,1,0
20,195,195,3,3,0,1,0
14,211,211,3,3,0,1,0
27,214,214,42,3,39,2,1
8,228,228,33,1,32,2,1
0,229,229,96,22,74,3,2
24,247,247,8,3,5,2,1
19,263,263,15,15,0,1,0
12,265,265,14,14,0,1,0
2,271,271,1,1,0,1,0
21,328,328,37,14,23,2,1
15,330,330,54,42,12,2,1
1,335,335,19,6,13,3,2
7,349,349,21,9,12,2,1
18,361,361,89,89,0,1,0
22,431,431,35,35,0,1,0
3,454,454,20,20,0,1,0
26,462,462,28,10,18,3,2
5,471,471,5,2,3,2,1
23,479,479,11,4,7,2,1
25,481,481,36,36,0,1,0
16,488,488,163,19,144,4,3
6,493,493,27,27,0,1,0
10,494,494,44,32,12,2,1

20,125,125,17,17,0,1,0
15,134,134,1,1,0,1,0
21,146,146,8,4,4,2,1
2,162,162,37,37,0,1,0
0,195,195,11,6,5,2,1
27,204,204,76,30,46,3,2
12,221,221,14,14,0,1,0
26,237,237,10,10,0,1,0
6,247,247,10,10,0,1,0
25,256,256,6,6,0,1,0
18,264,264,54,24,30,4,3
22,267,267,11,11,0,1,0
14,271,271,29,29,0,1,0
3,272,272,18,18,0,1,0
24,282,282,15,15,0,1,0
11,316,316,34,34,0,1,0
7,320,320,12,12,0,1,0
5,343,343,57,23,34,3,2
28,361,361,5,5,0,1,0
9,374,374,29,3,26,3,2
16,391,391,46,46,0,1,0
19,417,417,74,58,16,4,3
23,429,429,61,20,41,4,3
10,430,430,23,7,16,3,2
13,452,452,5,5,0,1,0
1,468,468,6,1,5,2,1
4,472,472,72,12,60,3,2
17,477,477,19,1,18,3,2
8,490,490,108,61,47,2,1

25,113,113,7,7,0,1,0
1,117,117,2,2,0,1,0
2,127,127,11,11,0,1,0
4,143,143,18,18,0,1,0
27,154,154,17,17,0,1,0
18,185,185,3,3,0,1,0
9,196,196,2,2,0,1,0
20,196,196,1,1,0,1,0
12,214,214,10,10,0,1,0
30,216,216,21,21,0,1,0
17,232,232,17,3,14,3,2
7,238,238,31,3,28,2,1
31,254,254,51,44,7,2,1
8,267,267,8,8,0,1,0
29,272,272,47,47,0,1,0
26,277,277,27,27,0,1,0
28,295,295,71,23,48,2,1
23,303,303,1,1,0,1,0
5,336,336,98,28,70,3,2
10,360,360,48,9,39,4,3
24,361,361,23,16,7,2,1
13,367,367,1,1,0,1,0
15,387,387,8,8,0,1,0
14,402,402,25,17,8,2,1
6,424,424,7,1,6,3,2
11,434,434,52,28,24,4,3
3,440,440,56,22,34,3,2
21,454,454,23,23,0,1,0
22,471,471,48,36,12,3,2
19,490,490,101,73,28,2,1
16,493,493,45,45,0,1,0
0,493,493,8,4,4,2,1

7,100,100,7,7,0,1,0
11,108,108,9,9,0,1,0
19,134,134,18,6,12,4,3
9,143,143,1,1,0,1,0
2,146,146,9,9,0,1,0
4,146,146,6,3,3,2,1
13,146,146,1,1,0,1,0
8,172,172,22,2,20,3,2
6,183,183,17,17,0,1,0
10,208,208,24,24,0,1,0
26,225,225,7,7,0,1,0
3,226,226,34,7,27,4,3
27,249,249,19,11,8,3,2
22,260,260,2,2,0,1,0
14,283,283,1,1,0,1,0
0,289,289,83,74,9,2,1
15,309,309,15,15,0,1,0
23,332,332,16,8,8,2,1
1,351,351,58,58,0,1,0
5,353,353,1,1,0,1,0
21,369,369,21,21,0,1,0
24,393,393,30,30,0,1,0
28,401,401,7,1,6,3,2
20,404,404,69,24,45,2,1
17,408,408,41,41,0,1,0
16,424,424,230,134,96,4,3
12,454,454,85,85,0,1,0
18,472,472,10,10,0,1,0
25,495,495,43,43,0,1,0

27,103,103,10,10,0,1,0
28,105,105,6,6,0,1,0
21,111,111,1,1,0,1,0
24,125,125,7,7,0,1,0
4,140,140,35,35,0,1,0
7,142,142,30,22,8,3,2
23,148,148,7,7,0,1,0
6,165,165,1,1,0,1,0
9,168,168,2,2,0,1,0
26,171,171,66,66,0,1,0
20,175,175,12,12,0,1,0
15,197,197,8,1,7,2,1
10,245,245,42,42,0,1,0
29,256,256,3,3,0,1,0
13,271,271,7,7,0,1,0
16,284,284,7,1,6,2,1
14,298,298,27,27,0,1,0
30,303,303,30,30,0,1,0
31,306,306,3,3,0,1,0
22,310,310,62,62,0,1,0
19,312,312,97,97,0,1,0
0,313,313,2,2,0,1,0
25,348,348,12,7,5,2,1
5,357,357,5,1,4,2,1
18,366,366,25,7,18,2,1
8,397,397,13,10,3,2,1
17,403,403,113,113,0,1,0
12,420,420,3,3,0,1,0
3,424,424,8,1,7,2,1
11,446,446,16,2,14,4,3
1,494,494,55,55,0,1,0
2,496,496,31,13,18,4,3

9,117,117,4,4,0,1,0
18,131,131,2,2,0,1,0
7,134,134,3,3,0,1,0
17,156,156,26,26,0,1,0
31,172,172,54,54,0,1,0
1,173,173,7,7,0,1,0
27,175,175,5,2,3,2,1
16,179,179,1,1,0,1,0
14,192,192,15,6,9,2,1
2,227,227,1,1,0,1,0
25,236,236,11,2,9,2,1
24,242,242,23,7,16,2,1
4,247,247,29,1,28,4,3
26,273,273,11,6,5,2,1
30,276,276,17,2,15,4,3
15,318,318,12,2,10,3,2
28,323,323,6,6,0,1,0
20,328,328,25,10,15,4,3
10,349,349,10,10,0,1,0
13,352,352,27,21,6,3,2
5,356,356,29,19,10,2,1
6,367,367,9,9,0,1,0
3,382,382,8,8,0,1,0
19,387,387,42,6,36,3,2
22,419,419,88,65,23,2,1
12,428,428,10,1,9,2,1
0,432,432,204,140,64,4,3
21,443,443,1,1,0,1,0
8,446,446,54,54,0,1,0
23,450,450,51,51,0,1,0
29,454,454,42,2,40,2,1
32,479,479,103,103,0,1,0
11,499,499,16,16,0,1,0

23,102,102,29,8,21,2,1
2,102,102,18,18,0,1,0
17,106,106,33,1,32,3,2
24,109,109,4,1,3,2,1
0,138,138,34,4,30,2,1
7,170,170,9,1,8,3,2
28,176,176,10,4,6,3,2
19,182,182,18,18,0,1,0
22,197,197,44,31,13,2,1
25,198,198,43,43,0,1,0
27,211,211,10,10,0,1,0
3,275,275,20,10,10,2,1
6,275,275,14,9,5,2,1
14,280,280,6,6,0,1,0
10,282,282,10,3,7,3,2
13,290,290,18,9,9,4,3
20,322,322,3,3,0,1,0
5,333,333,14,3,11,2,1
11,343,343,28,1,27,4,3
8,386,386,24,24,0,1,0
21,391,391,4,4,0,1,0
4,406,406,121,12,109,4,3
9,426,426,9,9,0,1,0
1,451,451,22,22,0,1,0
16,471,471,37,37,0,1,0
18,489,489,6,3,3,2,1
12,490,490,63,55,8,2,1
26,495,495,8,8,0,1,0
15,499,499,12,12,0,1,0

29,102,102,24,2,22,3,2
32,104,104,4,1,3,2,1
23,131,131,35,35,0,1,0
17,137,137,4,4,0,1,0
14,145,145,7,7,0,1,0
36,152,152,1,1,0,1,0
3,153,153,1,1,0,1,0
11,159,159,8,8,0,1,0
7,196,196,40,40,0,1,0
33,197,197,5,5,0,1,0
2,198,198,3,3,0,1,0
6,225,225,8,2,6,3,2
27,236,236,43,7,36,3,2
28,237,237,29,29,0,1,0
13,251,251,29,29,0,1,0
22,267,267,36,18,18,4,3
8,268,268,27,8,19,3,2
30,268,268,29,6,23,3,2
20,273,273,13,9,4,2,1
31,275,275,24,4,20,3,2
24,304,304,18,18,0,1,0
1,317,317,10,10,0,1,0
9,334,334,15,2,13,2,1
4,334,334,22,22,0,1,0
19,335,335,14,14,0,1,0
21,356,356,2,2,0,1,0
5,357,357,33,15,18,4,3
18,360,360,1,1,0,1,0
10,375,375,22,12,10,2,1
16,395,395,65,15,50,4,3
0,412,412,20,20,0,1,0
34,412,412,64,52,12,4,3
15,425,425,6,2,4,2,1
35,440,440,4,4,0,1,0
26,471,471,35,5,30,2,1
12,475,475,20,7,13,2,1
25,490,490,31,11,20,3,2

5,102,102,1,1,0,1,0
17,112,112,6,6,0,1,0
16,120,120,37,37,0,1,0
13,136,136,3,3,0,1,0
30,140,140,21,21,0,1,0
12,161,161,1,1,0,1,0
3,176,176,22,22,0,1,0
20,204,204,49,49,0,1,0
24,207,207,9,9,0,1,0
11,232,232,32,32,0,1,0
23,236,236,9,9,0,1,0
21,236,236,1,1,0,1,0
18,238,238,27,4,23,2,1
19,240,240,55,31,24,4,3
4,275,275,26,26,0,1,0
15,282,282,5,5,0,1,0
25,289,289,33,14,19,2,1
22,301,301,23,3,20,3,2
28,310,310,65,65,0,1,0
10,320,320,2,2,0,1,0
27,320,320,32,19,13,2,1
14,331,331,3,3,0,1,0
0,350,350,40,40,0,1,0
26,362,362,6,6,0,1,0
7,371,371,4,4,0,1,0
8,388,388,63,13,50,2,1
29,405,405,17,17,0,1,0
2,440,440,52,23,29,2,1
9,454,454,9,9,0,1,0
6,476,476,75,32,43,2,1
1,479,479,39,39,0,1,0

18,108,108,7,1,6,2,1
21,117,117,6,2,4,2,1
25,125,125,8,8,0,1,0
9,135,135,10,4,6,3,2
12,140,140,15,3,12,4,3
4,158,158,34,19,15,4,3
1,176,176,6,6,0,1,0
17,203,203,25,25,0,1,0
26,213,213,23,12,11,2,1
7,218,218,53,53,0,1,0
8,225,225,2,2,0,1,0
16,240,240,3,3,0,1,0
2,244,244,17,17,0,1,0
14,246,246,22,22,0,1,0
24,317,317,22,4,18,3,2
13,336,336,13,5,8,2,1
0,343,343,8,2,6,2,1
27,372,372,8,8,0,1,0
15,375,375,48,25,23,2,1
19,383,383,26,26,0,1,0
28,404,404,178,73,105,4,3
22,408,408,1,1,0,1,0
3,419,419,74,74,0,1,0
11,420,420,41,41,0,1,0
5,423,423,2,2,0,1,0
6,443,443,34,34,0,1,0
23,447,447,1,1,0,1,0
20,451,451,123,123,0,1,0
10,479,479,68,68,0,1,0

22,133,133,5,5,0,1,0
7,147,147,5,5,0,1,0
11,153,153,22,22,0,1,0
15,169,169,6,6,0,1,0
2,174,174,11,1,10,3,2
9,183,183,9,9,0,1,0
20,209,209,12,12,0,1,0
16,224,224,53,40,13,2,1
1,283,283,9,1,8,2,1
10,283,283,22,22,0,1,0
24,294,294,2,2,0,1,0
12,296,296,27,27,0,1,0
6,308,308,22,1,21,4,3
19,313,313,120,88,32,2,1
8,314,314,80,59,21,2,1
25,333,333,15,15,0,1,0
21,347,347,15,5,10,2,1
26,352,352,26,26,0,1,0
5,372,372,75,75,0,1,0
23,390,390,13,5,8,2,1
18,392,392,75,75,0,1,0
3,395,395,90,90,0,1,0
0,400,400,33,33,0,1,0
13,429,429,6,6,0,1,0
14,445,445,17,7,10,4,3
4,472,472,34,21,13,2,1
17,481,481,108,98,10,3,2

19,125,125,2,2,0,1,0
10,129,129,15,15,0,1,0
8,176,176,50,13,37,2,1
13,198,198,5,5,0,1,0
12,205,205,24,24,0,1,0
3,215,215,1,1,0,1,0
6,220,220,27,27,0,1,0
26,228,228,8,4,4,2,1
7,238,238,9,3,6,2,1
25,258,258,23,23,0,1,0
2,294,294,62,62,0,1,0
23,295,295,11,1,10,2,1
1,308,308,46,46,0,1,0
29,349,349,153,153,0,1,0
15,359,359,1,1,0,1,0
16,374,374,53,29,24,3,2
27,388,388,1,1,0,1,0
0,392,392,41,28,13,2,1
28,393,393,30,22,8,3,2
11,394,394,22,22,0,1,0
18,398,398,24,16,8,2,1
24,404,404,6,6,0,1,0
20,432,432,26,26,0,1,0
17,436,436,52,52,0,1,0
5,449,449,1,1,0,1,0
9,463,463,38,26,12,4,3
4,464,464,15,9,6,2,1
22,468,468,127,109,18,3,2
21,478,478,27,27,0,1,0
14,485,485,26,26,0,1,0

7,106,106,10,10,0,1,0
1,119,119,23,23,0,1,0
20,123,123,3,3,0,1,0
9,127,127,8,8,0,1,0
13,146,146,13,13,0,1,0
5,147,147,31,31,0,1,0
16,159,159,1,1,0,1,0
0,167,167,21,21,0,1,0
29,177,177,15,15,0,1,0
2,189,189,11,11,0,1,0
14,250,250,1,1,0,1,0
25,292,292,24,24,0,1,0
6,311,311,15,10,5,2,1
24,322,322,2,2,0,1,0
17,324,324,94,26,68,3,2
22,328,328,62,18,44,4,3
4,331,331,2,2,0,1,0
30,352,352,73,9,64,3,2
28,362,362,75,61,14,3,2
11,366,366,33,33,0,1,0
18,387,387,22,7,15,4,3
21,387,387,30,10,20,2,1
19,388,388,47,29,18,4,3
3,398,398,13,13,0,1,0
12,400,400,3,3,0,1,0
26,424,424,7,2,5,2,1
15,441,441,55,55,0,1,0
27,449,449,18,18,0,1,0
10,457,457,14,5,9,4,3
8,459,459,100,64,36,2,1
23,461,461,11,5,6,3,2

7,104,104,14,14,0,1,0
28,113,113,3,3,0,1,0
13,129,129,5,5,0,1,0
15,135,135,38,29,9,4,3
0,136,136,2,2,0,1,0
12,148,148,1,1,0,1,0
23,149,149,16,16,0,1,0
11,165,165,37,37,0,1,0
2,167,167,1,1,0,1,0
3,175,175,31,31,0,1,0
6,191,191,22,10,12,2,1
19,191,191,26,26,0,1,0
20,214,214,4,1,3,2,1
9,219,219,38,38,0,1,0
27,254,254,10,10,0,1,0
25,259,259,2,2,0,1,0
22,259,259,1,1,0,1,0
18,273,273,33,6,27,2,1
17,305,305,8,8,0,1,0
16,385,385,49,49,0,1,0
8,391,391,29,2,27,2,1
5,398,398,22,22,0,1,0
21,426,426,49,49,0,1,0
10,428,428,24,6,18,3,2
24,436,436,22,22,0,1,0
4,477,477,81,6,75,4,3
14,480,480,4,4,0,1,0
26,485,485,181,124,57,4,3
1,496,496,73,49,24,2,1

2,109,109,26,18,8,2,1
12,121,121,10,10,0,1,0
8,134,134,3,3,0,1,0
24,170,170,7,7,0,1,0
13,171,171,35,35,0,1,0
17,172,172,46,40,6,3,2
9,188,188,5,5,0,1,0
14,204,204,5,5,0,1,0
16,210,210,6,3,3,2,1
19,215,215,53,9,44,3,2
23,227,227,29,29,0,1,0
26,233,233,9,9,0,1,0
6,254,254,15,15,0,1,0
5,269,269,29,29,0,1,0
10,295,295,4,4,0,1,0
22,307,307,55,13,42,2,1
25,319,319,24,24,0,1,0
1,343,343,32,5,27,4,3
20,371,371,8,5,3,2,1
11,388,388,93,93,0,1,0
27,409,409,24,24,0,1,0
15,410,410,9,9,0,1,0
0,432,432,24,16,8,3,2
3,451,451,58,10,48,4,3
21,457,457,64,28,36,4,3
7,472,472,13,7,6,2,1
18,479,479,77,41,36,4,3
4,488,488,49,49,0,1,0

2,102,102,18,13,5,2,1
8,150,150,18,18,0,1,0
5,153,153,26,26,0,1,0
3,169,169,6,6,0,1,0
19,183,183,25,25,0,1,0
7,218,218,1,1,0,1,0
1,222,222,24,6,18,3,2
4,234,234,77,65,12,3,2
12,235,235,43,7,36,4,3
0,242,242,41,41,0,1,0
10,264,264,20,20,0,1,0
9,286,286,7,7,0,1,0
15,288,288,2,2,0,1,0
21,291,291,31,31,0,1,0
17,300,300,4,4,0,1,0
16,420,420,105,33,72,4,3
14,422,422,16,16,0,1,0
6,447,447,85,40,45,2,1
22,448,448,14,5,9,4,3
23,451,451,25,25,0,1,0
24,456,456,98,98,0,1,0
18,462,462,66,66,0,1,0
13,472,472,43,43,0,1,0
11,474,474,41,41,0,1,0
20,496,496,32,32,0,1,0

11,106,106,2,2,0,1,0
20,120,120,10,1,9,4,3
2,130,130,1,1,0,1,0
21,134,134,1,1,0,1,0
26,145,145,23,9,14,3,2
22,146,146,57,33,24,3,2
0,152,152,9,5,4,2,1
28,162,162,16,16,0,1,0
14,218,218,24,12,12,3,2
7,221,221,8,8,0,1,0
10,248,248,7,7,0,1,0
3,266,266,57,35,22,3,2
12,274,274,39,2,37,3,2
17,280,280,29,29,0,1,0
25,288,288,29,29,0,1,0
13,292,292,15,7,8,3,2
4,303,303,73,37,36,4,3
18,323,323,9,1,8,2,1
24,349,349,15,15,0,1,0
5,352,352,50,50,0,1,0
9,358,358,67,67,0,1,0
1,385,385,7,7,0,1,0
23,398,398,16,16,0,1,0
8,402,402,16,12,4,2,1
27,411,411,72,55,17,2,1
19,424,424,29,21,8,3,2
15,441,441,18,4,14,3,2
16,450,450,42,12,30,4,3
6,470,470,50,50,0,1,0

9,109,109,3,3,0,1,0
12,130,130,10,10,0,1,0
16,131,131,4,1,3,2,1
2,138,138,45,39,6,3,2
13,163,163,75,30,45,2,1
15,203,203,14,1,13,3,2
8,206,206,23,3,20,2,1
18,226,226,1,1,0,1,0
3,245,245,20,20,0,1,0
0,260,260,27,27,0,1,0
23,267,267,21,21,0,1,0
21,273,273,22,22,0,1,0
1,284,284,32,3,29,2,1
19,287,287,78,78,0,1,0
17,295,295,8,8,0,1,0
4,296,296,54,31,23,2,1
10,305,305,2,2,0,1,0
14,309,309,20,4,16,3,2
6,371,371,50,50,0,1,0
5,411,411,99,36,63,4,3
7,435,435,36,36,0,1,0
22,451,451,15,10,5,2,1
11,490,490,7,4,3,2,1
20,493,493,103,3,100,4,3

12,109,109,6,6,0,1,0
9,118,118,13,13,0,1,0
11,123,123,18,15,3,2,1
5,152,152,55,4,51,4,3
2,226,226,13,13,0,1,0
20,226,226,14,14,0,1,0
10,227,227,21,21,0,1,0
13,230,230,38,8,30,2,1
17,230,230,5,5,0,1,0
16,250,250,5,5,0,1,0
21,251,251,6,6,0,1,0
6,281,281,3,3,0,1,0
8,282,282,28,28,0,1,0
23,293,293,50,25,25,2,1
18,294,294,12,12,0,1,0
1,298,298,34,18,16,2,1
19,312,312,6,6,0,1,0
3,313,313,29,11,18,3,2
0,329,329,15,15,0,1,0
25,337,337,26,26,0,1,0
26,369,369,49,49,0,1,0
24,371,371,51,25,26,2,1
22,383,383,56,56,0,1,0
15,406,406,5,5,0,1,0
14,407,407,162,90,72,3,2
4,416,416,41,5,36,3,2
7,431,431,50,30,20,2,1

15,106,106,5,1,4,2,1
8,115,115,1,1,0,1,0
3,124,124,12,5,7,2,1
13,132,132,9,5,4,2,1
1,141,141,14,14,0,1,0
18,150,150,21,21,0,1,0
4,165,165,1,1,0,1,0
19,172,172,11,5,6,2,1
0,188,188,45,38,7,2,1
25,196,196,12,5,7,2,1
24,212,212,26,12,14,4,3
10,215,215,1,1,0,1,0
16,234,234,18,18,0,1,0
11,241,241,9,9,0,1,0
6,259,259,25,25,0,1,0
31,275,275,25,25,0,1,0
28,277,277,8,8,0,1,0
22,286,286,14,14,0,1,0
7,289,289,68,68,0,1,0
29,294,294,74,74,0,1,0
26,361,361,9,9,0,1,0
30,373,373,88,88,0,1,0
20,380,380,14,7,7,2,1
12,388,388,32,32,0,1,0
17,417,417,41,16,25,2,1
23,432,432,54,54,0,1,0
21,446,446,72,72,0,1,0
14,457,457,7,7,0,1,0
5,461,461,2,2,0,1,0
2,478,478,79,46,33,4,3
9,481,481,9,9,0,1,0
27,499,499,13,1,12,2,1

19,110,110,2,2,0,1,0
15,113,113,1,1,0,1,0
6,127,127,11,11,0,1,0
3,152,152,2,2,0,1,0
32,159,159,23,23,0,1,0
12,176,176,25,11,14,2,1
28,182,182,4,4,0,1,0
13,195,195,16,1,15,4,3
5,207,207,35,35,0,1,0
21,218,218,3,3,0,1,0
2,223,223,2,2,0,1,0
16,223,223,7,7,0,1,0
26,223,223,3,3,0,1,0
8,270,270,74,59,15,2,1
30,289,289,34,14,20,3,2
27,302,302,56,20,36,3,2
1,330,330,17,17,0,1,0
17,336,336,29,29,0,1,0
31,359,359,54,54,0,1,0
10,361,361,1,1,0,1,0
29,370,370,23,2,21,2,1
25,380,380,57,57,0,1,0
20,385,385,149,95,54,4,3
0,390,390,44,44,0,1,0
7,400,400,74,1,73,4,3
24,403,403,24,21,3,2,1
23,413,413,15,15,0,1,0
9,418,418,5,1,4,2,1
22,436,436,31,31,0,1,0
11,458,458,17,17,0,1,0
14,473,473,37,1,36,2,1
18,492,492,8,8,0,1,0
4,496,496,1,1,0,1,0

4,108,108,7,7,0,1,0
22,119,119,4,4,0,1,0
15,125,125,1,1,0,1,0
1,130,130,2,2,0,1,0
11,140,140,1,1,0,1,0
19,141,141,17,17,0,1,0
21,156,156,8,2,6,2,1
20,157,157,3,3,0,1,0
9,165,165,5,2,3,2,1
10,183,183,100,23,77,4,3
18,185,185,3,3,0,1,0
28,186,186,2,2,0,1,0
3,193,193,21,21,0,1,0
14,231,231,7,7,0,1,0
17,238,238,61,49,12,4,3
16,259,259,20,14,6,2,1
24,262,262,23,2,21,4,3
5,330,330,29,29,0,1,0
0,337,337,3,3,0,1,0
23,350,350,132,132,0,1,0
13,355,355,25,25,0,1,0
6,388,388,49,1,48,3,2
8,395,395,16,16,0,1,0
27,399,399,25,13,12,3,2
12,400,400,81,49,32,3,2
25,429,429,51,9,42,3,2
7,444,444,26,6,20,3,2
26,470,470,91,5,86,3,2
2,482,482,2,2,0,1,0

25,126,126,1,1,0,1,0
21,145,145,21,8,13,4,3
20,153,153,1,1,0,1,0
16,191,191,14,3,11,2,1
1,198,198,1,1,0,1,0
9,215,215,20,20,0,1,0
19,226,226,12,6,6,3,2
14,232,232,19,19,0,1,0
24,234,234,44,27,17,3,2
8,239,239,3,3,0,1,0
28,250,250,67,67,0,1,0
22,262,262,48,9,39,4,3
7,281,281,84,48,36,2,1
12,282,282,8,8,0,1,0
26,308,308,32,32,0,1,0
27,334,334,38,38,0,1,0
31,338,338,62,47,15,4,3
5,352,352,57,43,14,2,1
29,367,367,32,32,0,1,0
23,390,390,12,12,0,1,0
2,401,401,42,33,9,4,3
30,411,411,18,18,0,1,0
6,414,414,48,2,46,3,2
13,431,431,24,18,6,3,2
11,440,440,3,3,0,1,0
4,441,441,33,19,14,3,2
18,442,442,12,12,0,1,0
10,459,459,36,14,22,3,2
3,464,464,41,41,0,1,0
17,472,472,11,11,0,1,0
15,478,478,16,16,0,1,0
32,479,479,10,10,0,1,0
0,491,491,18,18,0,1,0

0,101,101,7,7,0,1,0
8,120,120,11,11,0,1,0
2,137,137,1,1,0,1,0
28,140,140,13,13,0,1,0
29,147,147,8,4,4,2,1
11,164,164,4,1,3,2,1
26,171,171,40,6,34,2,1
25,193,193,42,42,0,1,0
24,205,205,23,7,16,2,1
22,211,211,21,21,0,1,0
15,215,215,6,1,5,2,1
12,226,226,28,28,0,1,0
5,242,242,21,21,0,1,0
14,245,245,46,37,9,2,1
1,272,272,39,34,5,2,1
10,307,307,58,18,40,4,3
20,308,308,3,3,0,1,0
4,321,321,3,3,0,1,0
19,326,326,7,1,6,3,2
13,364,364,28,28,0,1,0
18,365,365,11,1,10,3,2
7,376,376,43,10,33,4,3
16,387,387,36,36,0,1,0
21,396,396,9,1,8,3,2
6,431,431,30,30,0,1,0
9,447,447,63,63,0,1,0
23,473,473,74,74,0,1,0
27,475,475,104,104,0,1,0
3,478,478,19,19,0,1,0
17,482,482,30,30,0,1,0

8,116,116,1,1,0,1,0
13,125,125,17,3,14,2,1
25,127,127,13,13,0,1,0
22,155,155,14,5,9,4,3
10,159,159,8,4,4,2,1
4,162,162,45,10,35,2,1
19,179,179,2,2,0,1,0
12,183,183,12,12,0,1,0
6,198,198,2,2,0,1,0
24,217,217,37,37,0,1,0
27,240,240,13,13,0,1,0
20,251,251,58,58,0,1,0
5,255,255,19,14,5,2,1
15,282,282,30,16,14,2,1
21,287,287,68,51,17,4,3
3,291,291,10,4,6,3,2
26,332,332,11,11,0,1,0
0,371,371,3,3,0,1,0
23,385,385,110,110,0,1,0
7,400,400,29,29,0,1,0
18,402,402,22,16,6,2,1
17,406,406,24,4,20,3,2
1,409,409,73,73,0,1,0
16,443,443,25,3,22,2,1
2,457,457,18,18,0,1,0
9,458,458,72,24,48,3,2
28,459,459,8,8,0,1,0
14,474,474,60,60,0,1,0
29,491,491,13,1,12,4,3
11,496,496,28,1,27,4,3

21,109,109,5,2,3,2,1
18,130,130,7,4,3,2,1
13,133,133,1,1,0,1,0
22,147,147,56,56,0,1,0
5,149,149,3,3,0,1,0
26,174,174,31,31,0,1,0
17,177,177,5,2,3,2,1
2,199,199,7,7,0,1,0
11,212,212,23,5,18,3,2
0,225,225,21,13,8,3,2
3,238,238,61,61,0,1,0
9,252,252,9,9,0,1,0
23,257,257,4,4,0,1,0
20,263,263,43,37,6,2,1
19,263,263,28,28,0,1,0
6,264,264,25,17,8,3,2
7,287,287,77,38,39,2,1
15,354,354,16,16,0,1,0
8,354,354,105,59,46,3,2
14,370,370,11,11,0,1,0
10,373,373,8,8,0,1,0
4,432,432,26,14,12,4,3
16,444,444,54,37,17,2,1
25,445,445,12,1,11,2,1
12,466,466,44,13,31,2,1
24,491,491,112,112,0,1,0
1,499,499,8,8,0,1,0

20,129,129,9,9,0,1,0
30,134,134,20,20,0,1,0
26,136,136,18,18,0,1,0
24,142,142,2,2,0,1,0
12,158,158,1,1,0,1,0
4,158,158,14,14,0,1,0
5,159,159,1,1,0,1,0
27,163,163,2,2,0,1,0
23,163,163,4,4,0,1,0
18,177,177,21,21,0,1,0
25,178,178,30,30,0,1,0
9,190,190,7,1,6,3,2
22,219,219,24,19,5,2,1
13,231,231,1,1,0,1,0
19,234,234,92,11,81,4,3
10,236,236,50,15,35,4,3
2,248,248,15,15,0,1,0
21,293,293,28,28,0,1,0
14,305,305,12,3,9,2,1
7,328,328,61,61,0,1,0
6,349,349,10,10,0,1,0
8,360,360,27,8,19,3,2
29,371,371,38,15,23,2,1
17,372,372,4,4,0,1,0
1,379,379,57,39,18,4,3
16,379,379,19,19,0,1,0
0,380,380,4,1,3,2,1
15,380,380,11,1,10,2,1
3,488,488,201,103,98,3,2
11,496,496,3,3,0,1,0
28,496,496,20,2,18,3,2

23,116,116,9,9,0,1,0
14,130,130,14,14,0,1,0
4,140,140,3,3,0,1,0
18,162,162,6,2,4,2,1
3,165,165,1,1,0,1,0
24,171,171,9,3,6,2,1
9,186,186,5,2,3,2,1
6,191,191,10,10,0,1,0
27,192,192,50,50,0,1,0
28,203,203,10,10,0,1,0
20,220,220,10,3,7,2,1
0,227,227,14,14,0,1,0
1,239,239,6,6,0,1,0
19,246,246,61,61,0,1,0
10,251,251,9,9,0,1,0
12,262,262,34,34,0,1,0
29,278,278,14,8,6,2,1
25,292,292,25,25,0,1,0
15,313,313,124,124,0,1,0
7,314,314,62,62,0,1,0
26,350,350,24,24,0,1,0
16,405,405,69,69,0,1,0
13,406,406,5,1,4,2,1
21,431,431,38,29,9,4,3
2,460,460,5,2,3,2,1
22,464,464,40,5,35,2,1
8,467,467,94,94,0,1,0
11,471,471,9,9,0,1,0
17,485,485,51,24,27,2,1
5,486,486,47,11,36,3,2

15,114,114,12,4,8,2,1
6,144,144,39,34,5,2,1
5,161,161,32,20,12,2,1
23,164,164,8,2,6,3,2
12,172,172,7,3,4,2,1
24,177,177,7,2,5,2,1
22,193,193,35,35,0,1,0
17,198,198,2,2,0,1,0
13,251,251,13,6,7,2,1
16,254,254,16,9,7,2,1
3,264,264,36,36,0,1,0
14,282,282,27,9,18,4,3
20,283,283,23,23,0,1,0
19,283,283,32,32,0,1,0
4,294,294,52,3,49,3,2
7,343,343,1,1,0,1,0
1,360,360,35,35,0,1,0
0,364,364,60,17,43,3,2
21,365,365,38,24,14,3,2
2,365,365,26,26,0,1,0
8,366,366,24,24,0,1,0
10,428,428,58,13,45,4,3
9,437,437,35,12,23,2,1
18,443,443,172,106,66,3,2
11,449,449,47,25,22,3,2

24,115,115,20,4,16,3,2
26,117,117,3,3,0,1,0
21,118,118,10,10,0,1,0
5,136,136,12,12,0,1,0
6,155,155,8,3,5,2,1
7,157,157,20,10,10,2,1
17,195,195,29,29,0,1,0
2,241,241,28,18,10,3,2
8,249,249,95,8,87,4,3
12,251,251,27,27,0,1,0
22,272,272,78,35,43,2,1
9,298,298,2,2,0,1,0
25,299,299,25,20,5,2,1
1,304,304,4,4,0,1,0
0,308,308,102,102,0,1,0
10,312,312,6,6,0,1,0
14,313,313,60,23,37,2,1
19,334,334,27,3,24,2,1
4,349,349,19,19,0,1,0
20,386,386,50,38,12,2,1
13,427,427,26,26,0,1,0
15,435,435,30,18,12,2,1
3,447,447,5,5,0,1,0
11,462,462,43,35,8,2,1
18,475,475,7,7,0,1,0
23,488,488,17,8,9,4,3
16,500,500,19,7,12,4,3

6,126,126,25,9,16,2,1
20,139,139,6,6,0,1,0
2,146,146,12,7,5,2,1
15,158,158,19,2,17,2,1
12,190,190,13,13,0,1,0
23,211,211,2,2,0,1,0
8,218,218,18,18,0,1,0
5,227,227,6,6,0,1,0
21,247,247,22,22,0,1,0
4,300,300,59,43,16,3,2
10,302,302,3,3,0,1,0
22,302,302,27,27,0,1,0
3,316,316,36,36,0,1,0
16,323,323,36,31,5,2,1
24,334,334,39,39,0,1,0
9,369,369,8,8,0,1,0
13,371,371,39,13,26,2,1
11,378,378,15,12,3,2,1
1,389,389,44,17,27,4,3
7,390,390,107,71,36,3,2
0,401,401,97,15,82,3,2
18,403,403,66,12,54,3,2
17,410,410,67,57,10,2,1
19,431,431,57,31,26,2,1
14,472,472,91,91,0,1,0
25,500,500,10,6,4,2,1

1,130,130,4,1,3,2,1
13,153,153,9,9,0,1,0
27,158,158,49,49,0,1,0
19,164,164,5,5,0,1,0
11,172,172,2,2,0,1,0
28,173,173,48,8,40,2,1
10,178,178,3,3,0,1,0
0,180,180,8,1,7,2,1
7,207,207,34,22,12,3,2
25,266,266,1,1,0,1,0
23,268,268,5,5,0,1,0
24,279,279,18,1,17,4,3
2,305,305,70,40,30,2,1
20,311,311,9,9,0,1,0
29,313,313,89,89,0,1,0
17,321,321,17,17,0,1,0
4,323,323,1,1,0,1,0
6,342,342,1,1,0,1,0
5,383,383,67,23,44,3,2
3,388,388,1,1,0,1,0
14,411,411,102,102,0,1,0
21,429,429,53,3,50,3,2
15,441,441,24,6,18,2,1
18,443,443,9,9,0,1,0
16,453,453,80,80,0,1,0
9,462,462,119,100,19,2,1
12,472,472,35,2,33,4,3
8,478,478,13,4,9,4,3
26,481,481,18,13,5,2,1
22,486,486,2,2,0,1,0

18,100,100,6,6,0,1,0
9,101,101,16,6,10,3,2
14,105,105,1,1,0,1,0
31,113,113,1,1,0,1,0
2,122,122,8,1,7,2,1
20,133,133,5,5,0,1,0
12,136,136,5,5,0,1,0
13,191,191,4,4,0,1,0
30,193,193,2,2,0,1,0
25,251,251,1,1,0,1,0
0,263,263,3,3,0,1,0
1,269,269,11,5,6,3,2
24,278,278,6,2,4,2,1
17,291,291,10,10,0,1,0
26,294,294,199,149,50,3,2
21,294,294,15,15,0,1,0
28,296,296,34,2,32,3,2
10,340,340,7,7,0,1,0
16,343,343,21,9,12,3,2
5,345,345,35,35,0,1,0
23,347,347,10,7,3,2,1
15,390,390,84,63,21,2,1
7,391,391,5,1,4,2,1
11,400,400,53,47,6,3,2
4,444,444,6,3,3,2,1
27,452,452,69,69,0,1,0
19,465,465,98,32,66,3,2
3,468,468,30,30,0,1,0
29,479,479,16,8,8,3,2
8,484,484,125,53,72,4,3
6,486,486,70,24,46,3,2
22,491,491,10,10,0,1,0

23,102,102,20,20,0,1,0
22,125,125,14,14,0,1,0
8,135,135,17,17,0,1,0
29,149,149,13,13,0,1,0
6,181,181,1,1,0,1,0
15,199,199,6,2,4,2,1
18,213,213,14,14,0,1,0
27,220,220,49,26,23,2,1
26,223,223,10,1,9,4,3
19,223,223,5,5,0,1,0
2,233,233,22,2,20,3,2
24,233,233,29,16,13,2,1
3,236,236,23,19,4,2,1
30,245,245,3,3,0,1,0
17,247,247,1,1,0,1,0
4,281,281,2,2,0,1,0
12,281,281,8,8,0,1,0
25,326,326,23,23,0,1,0
28,347,347,103,80,23,2,1
1,348,348,77,26,51,4,3
13,368,368,102,102,0,1,0
21,369,369,46,46,0,1,0
0,369,369,46,24,22,2,1
20,379,379,22,22,0,1,0
11,381,381,39,35,4,2,1
16,389,389,83,48,35,4,3
14,409,409,5,5,0,1,0
5,411,411,12,12,0,1,0
10,485,485,12,6,6,2,1
9,487,487,3,3,0,1,0
7,492,492,1,1,0,1,0

10,112,112,4,4,0,1,0
19,115,115,18,18,0,1,0
16,159,159,1,1,0,1,0
15,178,178,2,2,0,1,0
23,189,189,22,3,19,2,1
30,198,198,19,19,0,1,0
18,211,211,9,9,0,1,0
17,226,226,25,25,0,1,0
9,228,228,4,4,0,1,0
12,238,238,2,2,0,1,0
24,258,258,70,70,0,1,0
1,261,261,2,2,0,1,0
8,267,267,28,15,13,2,1
7,292,292,78,78,0,1,0
4,297,297,20,20,0,1,0
27,302,302,33,33,0,1,0
33,315,315,1,1,0,1,0
31,319,319,59,59,0,1,0
2,357,357,15,8,7,2,1
0,376,376,21,5,16,3,2
14,376,376,27,27,0,1,0
22,382,382,21,17,4,2,1
29,388,388,39,39,0,1,0
25,397,397,8,2,6,3,2
3,404,404,21,4,17,3,2
28,406,406,1,1,0,1,0
26,414,414,130,32,98,3,2
20,420,420,15,7,8,2,1
6,465,465,13,13,0,1,0
5,469,469,36,5,31,2,1
21,472,472,8,3,5,2,1
32,478,478,47,47,0,1,0
13,485,485,84,84,0,1,0
11,493,493,35,29,6,2,1

26,101,101,1,1,0,1,0
3,114,114,10,4,6,2,1
22,122,122,7,7,0,1,0
20,126,126,4,4,0,1,0
15,132,132,9,6,3,2,1
4,134,134,13,13,0,1,0
12,168,168,3,3,0,1,0
25,193,193,66,53,13,2,1
5,241,241,25,25,0,1,0
16,242,242,11,11,0,1,0
11,245,245,13,13,0,1,0
14,249,249,7,7,0,1,0
9,250,250,37,37,0,1,0
6,252,252,1,1,0,1,0
10,265,265,11,1,10,3,2
21,287,287,55,19,36,2,1
0,288,288,3,3,0,1,0
18,317,317,127,47,80,3,2
27,332,332,6,6,0,1,0
13,363,363,16,16,0,1,0
17,376,376,2,2,0,1,0
8,401,401,26,26,0,1,0
7,407,407,37,37,0,1,0
24,420,420,20,20,0,1,0
2,434,434,111,111,0,1,0
23,453,453,57,5,52,3,2
1,470,470,180,108,72,4,3
19,483,483,34,17,17,2,1

0,101,101,5,5,0,1,0
24,104,104,1,1,0,1,0
27,116,116,4,4,0,1,0
12,126,126,3,3,0,1,0
2,134,134,4,1,3,2,1
8,152,152,5,5,0,1,0
18,157,157,11,7,4,2,1
3,159,159,32,32,0,1,0
15,169,169,32,32,0,1,0
13,174,174,1,1,0,1,0
29,197,197,17,2,15,4,3
11,216,216,4,1,3,2,1
9,231,231,6,3,3,2,1
1,234,234,11,2,9,4,3
19,242,242,10,10,0,1,0
10,243,243,19,19,0,1,0
7,291,291,3,3,0,1,0
23,334,334,46,16,30,4,3
28,359,359,134,134,0,1,0
6,386,386,15,15,0,1,0
14,398,398,146,134,12,4,3
25,416,416,26,26,0,1,0
4,422,422,7,7,0,1,0
22,428,428,55,55,0,1,0
26,437,437,19,19,0,1,0
30,437,437,67,67,0,1,0
21,455,455,47,47,0,1,0
31,456,456,34,31,3,2,1
16,456,456,11,11,0,1,0
17,482,482,12,4,8,3,2
20,485,485,59,17,42,4,3
5,491,491,107,107,0,1,0

27,117,117,4,4,0,1,0
9,135,135,5,2,3,2,1
21,148,148,37,4,33,4,3
12,165,165,4,4,0,1,0
3,172,172,1,1,0,1,0
33,184,184,14,14,0,1,0
29,186,186,45,45,0,1,0
10,204,204,9,9,0,1,0
20,208,208,1,1,0,1,0
19,219,219,8,8,0,1,0
2,224,224,1,1,0,1,0
0,233,233,7,7,0,1,0
26,236,236,14,11,3,2,1
31,243,243,21,10,11,2,1
17,256,256,13,4,9,4,3
25,259,259,5,5,0,1,0
32,260,260,54,54,0,1,0
4,268,268,98,19,79,4,3
24,293,293,14,2,12,4,3
1,306,306,7,7,0,1,0
28,310,310,27,27,0,1,0
16,342,342,27,27,0,1,0
30,345,345,52,20,32,2,1
7,358,358,6,2,4,2,1
6,379,379,12,12,0,1,0
11,382,382,7,2,5,2,1
34,417,417,53,8,45,4,3
18,423,423,44,4,40,3,2
15,433,433,63,63,0,1,0
13,439,439,42,32,10,2,1
5,450,450,20,4,16,2,1
22,470,470,3,3,0,1,0
8,478,478,9,9,0,1,0
23,491,491,19,19,0,1,0
14,495,495,109,49,60,3,2

4,113,113,5,5,0,1,0
17,132,132,9,9,0,1,0
3,142,142,12,2,10,3,2
9,155,155,12,5,7,2,1
2,161,161,13,4,9,2,1
27,179,179,17,17,0,1,0
22,186,186,5,5,0,1,0
5,188,188,17,1,16,3,2
1,201,201,4,4,0,1,0
8,205,205,27,20,7,2,1
26,207,207,56,56,0,1,0
24,224,224,10,10,0,1,0
20,225,225,16,10,6,3,2
18,232,232,5,5,0,1,0
6,259,259,3,3,0,1,0
23,285,285,88,88,0,1,0
28,292,292,6,6,0,1,0
16,315,315,36,36,0,1,0
12,324,324,21,9,12,2,1
11,324,324,53,17,36,2,1
15,341,341,47,47,0,1,0
7,343,343,29,8,21,2,1
13,348,348,28,15,13,2,1
0,384,384,90,51,39,4,3
25,384,384,57,57,0,1,0
21,389,389,24,24,0,1,0
14,421,421,16,3,13,4,3
19,445,445,17,17,0,1,0
10,446,446,87,39,48,3,2

8,102,102,2,2,0,1,0
23,105,105,25,25,0,1,0
26,110,110,10,10,0,1,0
25,136,136,5,5,0,1,0
27,154,154,10,10,0,1,0
7,155,155,15,15,0,1,0
13,170,170,15,6,9,2,1
10,174,174,1,1,0,1,0
2,183,183,36,36,0,1,0
15,194,194,13,6,7,2,1
17,226,226,12,12,0,1,0
11,231,231,47,18,29,2,1
29,233,233,32,12,20,2,1
12,262,262,20,20,0,1,0
3,276,276,30,30,0,1,0
22,279,279,44,15,29,2,1
0,335,335,24,12,12,4,3
5,342,342,38,38,0,1,0
20,352,352,121,121,0,1,0
6,366,366,10,3,7,2,1
31,371,371,11,6,5,2,1
18,412,412,42,42,0,1,0
28,412,412,24,24,0,1,0
14,414,414,43,43,0,1,0
21,430,430,38,38,0,1,0
16,460,460,1,1,0,1,0
24,471,471,22,10,12,4,3
19,473,473,5,5,0,1,0
9,483,483,51,51,0,1,0
30,489,489,12,12,0,1,0
1,493,493,18,18,0,1,0
4,497,497,15,15,0,1,0

5,121,121,15,15,0,1,0
9,121,121,46,46,0,1,0
21,122,122,6,6,0,1,0
11,149,149,14,5,9,2,1
24,156,156,27,1,26,2,1
0,168,168,1,1,0,1,0
8,229,229,3,3,0,1,0
7,239,239,58,58,0,1,0
4,253,253,22,22,0,1,0
6,256,256,35,9,26,2,1
14,262,262,3,3,0,1,0
12,263,263,7,7,0,1,0
20,321,321,52,24,28,3,2
2,360,360,4,4,0,1,0
17,379,379,3,3,0,1,0
13,386,386,27,10,17,2,1
19,392,392,70,34,36,4,3
15,398,398,111,107,4,2,1
23,418,418,15,4,11,2,1
1,420,420,34,27,7,2,1
16,428,428,46,46,0,1,0
10,454,454,85,1,84,4,3
22,475,475,52,19,33,4,3
3,488,488,65,45,20,3,2
18,490,490,60,26,34,2,1

2,103,103,2,2,0,1,0
26,116,116,11,1,10,2,1
1,125,125,26,8,18,4,3
4,144,144,5,5,0,1,0
24,146,146,5,5,0,1,0
27,180,180,13,13,0,1,0
29,186,186,19,19,0,1,0
7,190,190,31,31,0,1,0
30,197,197,42,42,0,1,0
0,197,197,5,5,0,1,0
22,221,221,6,6,0,1,0
19,234,234,19,10,9,3,2
10,241,241,17,17,0,1,0
13,263,263,2,2,0,1,0
15,278,278,7,2,5,2,1
14,295,295,16,16,0,1,0
6,296,296,7,7,0,1,0
20,313,313,113,113,0,1,0
17,333,333,23,9,14,2,1
18,357,357,7,7,0,1,0
5,358,358,4,4,0,1,0
25,379,379,17,2,15,2,1
8,382,382,145,145,0,1,0
31,384,384,73,58,15,4,3
16,387,387,42,8,34,3,2
9,408,408,17,17,0,1,0
3,413,413,7,4,3,2,1
23,429,429,18,18,0,1,0
12,436,436,1,1,0,1,0
11,485,485,68,23,45,3,2
28,487,487,38,38,0,1,0
21,500,500,36,12,24,4,3

29,110,110,4,4,0,1,0
32,139,139,45,19,26,3,2
6,141,141,3,3,0,1,0
0,174,174,37,37,0,1,0
14,200,200,1,1,0,1,0
1,220,220,4,4,0,1,0
17,234,234,11,5,6,2,1
20,252,252,15,15,0,1,0
26,266,266,18,8,10,2,1
2,269,269,17,5,12,2,1
31,288,288,5,1,4,2,1
19,298,298,42,42,0,1,0
16,299,299,24,8,16,3,2
21,316,316,12,12,0,1,0
18,317,317,16,16,0,1,0
11,323,323,28,28,0,1,0
9,332,332,9,6,3,2,1
22,337,337,7,7,0,1,0
15,339,339,6,6,0,1,0
30,345,345,19,19,0,1,0
8,347,347,17,17,0,1,0
10,365,365,19,13,6,2,1
25,366,366,35,35,0,1,0
3,378,378,28,17,11,2,1
34,390,390,25,25,0,1,0
13,396,396,34,34,0,1,0
28,422,422,97,73,24,4,3
27,425,425,71,61,10,3,2
5,438,438,10,3,7,2,1
23,450,450,128,28,100,4,3
7,464,464,74,74,0,1,0
12,466,466,3,3,0,1,0
33,471,471,4,4,0,1,0
24,484,484,9,9,0,1,0
4,497,497,61,61,0,1,0

3,100,100,7,7,0,1,0
2,104,104,15,15,0,1,0
17,110,110,5,1,4,2,1
26,129,129,25,25,0,1,0
19,132,132,21,1,20,3,2
25,136,136,10,10,0,1,0
24,161,161,15,3,12,4,3
6,163,163,10,7,3,2,1
5,170,170,5,2,3,2,1
28,182,182,22,2,20,3,2
15,196,196,7,7,0,1,0
23,227,227,9,9,0,1,0
11,229,229,77,77,0,1,0
27,280,280,86,86,0,1,0
1,304,304,19,9,10,2,1
16,361,361,12,6,6,3,2
20,361,361,50,26,24,2,1
12,380,380,38,23,15,2,1
7,400,400,36,4,32,2,1
21,401,401,19,7,12,3,2
0,404,404,114,109,5,2,1
14,413,413,5,5,0,1,0
8,439,439,13,6,7,2,1
18,448,448,5,5,0,1,0
22,465,465,62,41,21,4,3
4,471,471,19,4,15,4,3
9,473,473,36,28,8,3,2
13,474,474,9,3,6,3,2
10,490,490,23,11,12,3,2

0,104,104,3,3,0,1,0
27,118,118,13,7,6,3,2
17,121,121,37,7,30,4,3
24,126,126,14,14,0,1,0
26,175,175,2,2,0,1,0
20,186,186,37,37,0,1,0
25,212,212,6,2,4,2,1
11,215,215,4,4,0,1,0
5,218,218,45,13,32,3,2
15,252,252,32,7,25,2,1
1,264,264,84,36,48,4,3
2,278,278,5,2,3,2,1
8,299,299,27,27,0,1,0
16,333,333,8,5,3,2,1
23,347,347,17,5,12,2,1
10,365,365,3,3,0,1,0
3,368,368,69,64,5,2,1
12,370,370,1,1,0,1,0
6,371,371,7,7,0,1,0
13,371,371,18,18,0,1,0
22,384,384,5,5,0,1,0
14,392,392,83,83,0,1,0
7,419,419,12,12,0,1,0
19,440,440,38,38,0,1,0
21,443,443,41,41,0,1,0
9,443,443,97,97,0,1,0
4,485,485,101,101,0,1,0
18,499,499,30,16,14,2,1

28,101,101,2,2,0,1,0
7,123,123,1,1,0,1,0
25,161,161,18,18,0,1,0
0,172,172,13,4,9,4,3
24,178,178,1,1,0,1,0
30,225,225,28,28,0,1,0
26,259,259,5,5,0,1,0
16,262,262,23,23,0,1,0
18,269,269,21,3,18,3,2
14,275,275,10,3,7,2,1
31,278,278,34,28,6,3,2
27,282,282,83,61,22,3,2
22,282,282,91,87,4,2,1
9,286,286,1,1,0,1,0
6,304,304,45,9,36,3,2
21,334,334,10,10,0,1,0
12,342,342,39,20,19,2,1
1,343,343,51,42,9,4,3
4,360,360,22,22,0,1,0
10,366,366,73,23,50,2,1
29,380,380,16,1,15,2,1
11,389,389,44,32,12,4,3
8,393,393,66,66,0,1,0
3,409,409,17,17,0,1,0
15,412,412,4,1,3,2,1
13,423,423,9,1,8,3,2
20,436,436,22,4,18,4,3
19,443,443,43,43,0,1,0
17,450,450,29,18,11,2,1
23,467,467,53,53,0,1,0
5,479,479,10,10,0,1,0
2,484,484,38,11,27,2,1

20,111,111,14,14,0,1,0
18,156,156,16,16,0,1,0
6,174,174,24,10,14,2,1
3,177,177,6,6,0,1,0
7,191,191,15,3,12,2,1
15,195,195,9,1,8,2,1
13,211,211,76,47,29,2,1
8,213,213,10,10,0,1,0
12,230,230,10,10,0,1,0
4,263,263,23,2,21,4,3
9,274,274,6,6,0,1,0
14,301,301,2,2,0,1,0
10,338,338,88,25,63,4,3
11,354,354,40,40,0,1,0
0,365,365,133,109,24,4,3
16,414,414,12,12,0,1,0
1,425,425,3,3,0,1,0
19,432,432,76,26,50,3,2
5,435,435,25,25,0,1,0
2,447,447,319,274,45,3,2
17,466,466,7,7,0,1,0

3,120,120,2,2,0,1,0
6,125,125,39,39,0,1,0
16,136,136,9,3,6,2,1
30,172,172,3,3,0,1,0
0,196,196,5,5,0,1,0
17,201,201,12,2,10,2,1
18,211,211,41,17,24,3,2
28,227,227,17,4,13,4,3
4,263,263,8,8,0,1,0
9,276,276,13,1,12,2,1
19,280,280,37,11,26,2,1
29,284,284,15,4,11,2,1
21,302,302,22,22,0,1,0
27,321,321,44,44,0,1,0
10,330,330,26,9,17,4,3
25,336,336,63,5,58,3,2
22,345,345,18,18,0,1,0
24,357,357,19,10,9,3,2
5,373,373,24,24,0,1,0
7,383,383,42,42,0,1,0
11,387,387,24,24,0,1,0
12,391,391,52,47,5,2,1
1,407,407,24,24,0,1,0
13,442,442,18,18,0,1,0
26,445,445,75,75,0,1,0
23,458,458,9,2,7,2,1
8,459,459,18,18,0,1,0
2,461,461,25,25,0,1,0
15,475,475,25,25,0,1,0
20,481,481,35,35,0,1,0
14,489,489,73,61,12,3,2
31,499,499,93,55,38,3,2

30,101,101,7,7,0,1,0
4,107,107,14,9,5,2,1
10,132,132,2,2,0,1,0
28,149,149,13,13,0,1,0
27,159,159,12,12,0,1,0
19,196,196,37,3,34,2,1
17,220,220,44,30,14,3,2
16,221,221,26,11,15,3,2
8,224,224,9,6,3,2,1
22,244,244,22,5,17,2,1
13,271,271,79,41,38,2,1
12,273,273,1,1,0,1,0
14,280,280,3,3,0,1,0
21,286,286,36,4,32,2,1
24,292,292,39,39,0,1,0
6,302,302,1,1,0,1,0
7,323,323,13,7,6,3,2
15,348,348,118,118,0,1,0
3,354,354,33,33,0,1,0
2,380,380,1,1,0,1,0
5,381,381,2,2,0,1,0
29,381,381,3,3,0,1,0
0,382,382,7,7,0,1,0
31,421,421,55,55,0,1,0
11,428,428,4,4,0,1,0
1,432,432,19,19,0,1,0
9,434,434,16,9,7,2,1
20,452,452,20,20,0,1,0
18,456,456,1,1,0,1,0
23,474,474,136,40,96,4,3
25,485,485,78,8,70,3,2
26,489,489,12,12,0,1,0

6,108,108,3,3,0,1,0
15,117,117,1,1,0,1,0
0,118,118,30,12,18,3,2
31,179,179,15,15,0,1,0
5,183,183,6,6,0,1,0
12,184,184,21,21,0,1,0
26,228,228,28,28,0,1,0
28,242,242,1,1,0,1,0
19,278,278,41,41,0,1,0
30,295,295,47,47,0,1,0
9,303,303,47,47,0,1,0
24,308,308,8,8,0,1,0
14,310,310,88,28,60,4,3
2,326,326,19,19,0,1,0
10,344,344,61,61,0,1,0
22,364,364,24,15,9,4,3
29,369,369,50,45,5,2,1
11,371,371,5,5,0,1,0
27,372,372,100,80,20,2,1
20,393,393,5,5,0,1,0
7,395,395,8,4,4,2,1
17,397,397,2,2,0,1,0
4,403,403,58,58,0,1,0
8,418,418,3,3,0,1,0
1,441,441,6,3,3,2,1
21,450,450,137,128,9,4,3
18,453,453,16,16,0,1,0
3,457,457,26,26,0,1,0
13,457,457,4,4,0,1,0
25,466,466,23,23,0,1,0
23,468,468,2,2,0,1,0
16,500,500,10,10,0,1,0

7,110,110,16,16,0,1,0
6,112,112,1,1,0,1,0
29,118,118,12,12,0,1,0
18,125,125,2,2,0,1,0
10,157,157,26,26,0,1,0
15,157,157,4,4,0,1,0
11,161,161,47,7,40,3,2
19,179,179,26,26,0,1,0
22,181,181,38,18,20,2,1
20,243,243,28,6,22,2,1
25,257,257,13,13,0,1,0
12,259,259,3,3,0,1,0
14,286,286,26,26,0,1,0
3,290,290,37,37,0,1,0
8,292,292,2,2,0,1,0
16,293,293,18,18,0,1,0
26,326,326,38,38,0,1,0
4,326,326,15,3,12,3,2
5,334,334,7,7,0,1,0
21,337,337,11,5,6,2,1
17,342,342,27,27,0,1,0
0,368,368,24,24,0,1,0
2,403,403,49,49,0,1,0
1,420,420,48,9,39,4,3
24,423,423,80,80,0,1,0
23,447,447,31,21,10,2,1
13,452,452,31,31,0,1,0
28,456,456,54,54,0,1,0
30,471,471,77,77,0,1,0
9,480,480,14,14,0,1,0
27,491,491,11,7,4,2,1

10,126,126,2,2,0,1,0
25,144,144,19,19,0,1,0
7,148,148,13,7,6,2,1
5,160,160,2,2,0,1,0
13,168,168,32,16,16,3,2
24,173,173,14,6,8,2,1
14,182,182,1,1,0,1,0
9,207,207,7,1,6,3,2
2,210,210,29,19,10,2,1
11,212,212,21,10,11,2,1
4,219,219,59,59,0,1,0
27,224,224,12,12,0,1,0
0,252,252,61,21,40,2,1
26,253,253,7,7,0,1,0
21,255,255,42,18,24,4,3
8,318,318,30,21,9,4,3
6,318,318,7,7,0,1,0
19,337,337,40,40,0,1,0
22,344,344,58,58,0,1,0
3,365,365,39,39,0,1,0
28,380,380,57,42,15,2,1
16,430,430,41,41,0,1,0
18,446,446,87,23,64,3,2
20,452,452,2,2,0,1,0
12,453,453,13,4,9,2,1
17,459,459,63,51,12,3,2
15,460,460,3,3,0,1,0
1,469,469,26,26,0,1,0
23,495,495,44,23,21,2,1

16,100,100,2,2,0,1,0
24,108,108,6,6,0,1,0
26,109,109,1,1,0,1,0
0,117,117,1,1,0,1,0
21,126,126,8,1,7,2,1
11,141,141,15,15,0,1,0
12,143,143,4,4,0,1,0
14,162,162,17,1,16,2,1
25,165,165,28,4,24,2,1
13,183,183,33,33,0,1,0
22,201,201,29,7,22,2,1
2,209,209,47,36,11,2,1
17,246,246,11,11,0,1,0
1,281,281,18,18,0,1,0
10,284,284,4,4,0,1,0
4,294,294,6,6,0,1,0
23,321,321,37,37,0,1,0
19,326,326,44,5,39,4,3
7,360,360,96,80,16,2,1
5,375,375,48,27,21,2,1
6,379,379,91,53,38,4,3
8,380,380,33,18,15,4,3
9,381,381,10,10,0,1,0
3,415,415,4,1,3,2,1
15,419,419,17,17,0,1,0
27,421,421,76,28,48,3,2
20,467,467,132,132,0,1,0
18,467,467,36,36,0,1,0

6,115,115,2,2,0,1,0
1,147,147,5,5,0,1,0
10,169,169,34,14,20,2,1
23,171,171,6,1,5,2,1
0,178,178,12,12,0,1,0
21,180,180,4,4,0,1,0
28,188,188,38,28,10,3,2
9,205,205,11,3,8,2,1
19,225,225,26,11,15,4,3
31,228,228,17,17,0,1,0
15,230,230,26,5,21,2,1
8,235,235,4,1,3,2,1
24,250,250,1,1,0,1,0
18,259,259,11,11,0,1,0
4,277,277,48,48,0,1,0
22,289,289,7,4,3,2,1
5,300,300,6,6,0,1,0
32,307,307,62,38,24,2,1
14,324,324,39,39,0,1,0
20,329,329,86,86,0,1,0
30,335,335,49,17,32,3,2
12,358,358,22,22,0,1,0
27,368,368,26,23,3,2,1
25,399,399,49,49,0,1,0
17,403,403,10,10,0,1,0
3,408,408,8,2,6,2,1
13,453,453,39,1,38,4,3
29,474,474,48,42,6,3,2
7,481,481,99,99,0,1,0
16,486,486,21,8,13,4,3
11,486,486,33,33,0,1,0
2,491,491,16,11,5,2,1
26,500,500,18,18,0,1,0

21,155,155,58,31,27,4,3
7,197,197,106,98,8,3,2
1,215,215,48,22,26,2,1
2,235,235,38,14,24,2,1
18,260,260,3,3,0,1,0
10,268,268,2,2,0,1,0
4,274,274,27,5,22,3,2
19,307,307,59,59,0,1,0
20,327,327,52,30,22,3,2
14,343,343,28,16,12,4,3
17,347,347,20,5,15,4,3
15,350,350,24,24,0,1,0
5,401,401,87,87,0,1,0
11,404,404,10,10,0,1,0
0,414,414,44,44,0,1,0
6,432,432,4,1,3,2,1
8,440,440,32,12,20,3,2
3,440,440,22,16,6,3,2
9,441,441,46,46,0,1,0
13,477,477,33,33,0,1,0
16,497,497,43,43,0,1,0
12,498,498,55,5,50,2,1

5,116,116,1,1,0,1,0
2,141,141,28,28,0,1,0
9,149,149,40,4,36,4,3
8,188,188,60,60,0,1,0
21,196,196,18,18,0,1,0
22,204,204,13,13,0,1,0
6,260,260,6,6,0,1,0
25,267,267,4,4,0,1,0
1,272,272,13,10,3,2,1
15,278,278,85,39,46,2,1
0,282,282,34,10,24,4,3
4,292,292,4,4,0,1,0
19,294,294,26,8,18,2,1
17,304,304,28,28,0,1,0
24,304,304,68,26,42,4,3
11,339,339,56,45,11,2,1
7,341,341,37,37,0,1,0
12,357,357,28,28,0,1,0
23,364,364,28,12,16,3,2
14,381,381,25,18,7,2,1
3,400,400,3,3,0,1,0
18,436,436,9,9,0,1,0
20,444,444,106,58,48,3,2
13,453,453,21,1,20,3,2
16,464,464,6,6,0,1,0
10,476,476,57,24,33,2,1

5,125,125,75,75,0,1,0
9,149,149,14,14,0,1,0
13,151,151,2,2,0,1,0
17,173,173,42,27,15,2,1
11,180,180,28,12,16,3,2
10,199,199,7,7,0,1,0
14,201,201,19,19,0,1,0
12,216,216,12,12,0,1,0
0,325,325,58,19,39,3,2
4,327,327,48,48,0,1,0
6,348,348,2,2,0,1,0
18,359,359,88,52,36,2,1
1,374,374,22,4,18,4,3
20,403,403,12,12,0,1,0
2,407,407,150,60,90,4,3
19,407,407,20,20,0,1,0
8,416,416,49,49,0,1,0
16,432,432,22,22,0,1,0
15,461,461,107,57,50,3,2
7,488,488,7,7,0,1,0
3,490,490,21,21,0,1,0

16,101,101,21,10,11,2,1
0,108,108,1,1,0,1,0
6,127,127,6,6,0,1,0
25,143,143,45,18,27,2,1
10,156,156,1,1,0,1,0
19,185,185,4,1,3,2,1
21,190,190,8,8,0,1,0
18,193,193,6,6,0,1,0
5,199,199,20,10,10,3,2
11,200,200,52,52,0,1,0
27,213,213,15,15,0,1,0
24,271,271,15,15,0,1,0
8,306,306,7,7,0,1,0
15,306,306,18,18,0,1,0
28,306,306,14,14,0,1,0
13,326,326,2,2,0,1,0
23,341,341,45,9,36,2,1
4,353,353,5,2,3,2,1
2,371,371,25,25,0,1,0
17,377,377,30,15,15,4,3
26,377,377,51,19,32,3,2
9,430,430,26,26,0,1,0
3,434,434,72,72,0,1,0
14,446,446,69,14,55,4,3
7,454,454,1,1,0,1,0
1,462,462,180,180,0,1,0
12,473,473,45,45,0,1,0
22,490,490,60,53,7,2,1
20,499,499,61,23,38,3,2

3,111,111,1,1,0,1,0
6,138,138,9,9,0,1,0
22,188,188,6,2,4,2,1
5,199,199,39,27,12,4,3
26,200,200,6,6,0,1,0
23,254,254,50,23,27,2,1
10,259,259,21,21,0,1,0
9,271,271,5,5,0,1,0
11,299,299,19,1,18,2,1
8,305,305,61,43,18,4,3
15,318,318,70,52,18,3,2
2,319,319,103,7,96,4,3
21,335,335,21,17,4,2,1
7,355,355,42,42,0,1,0
25,362,362,43,32,11,2,1
27,388,388,19,12,7,2,1
18,395,395,38,15,23,2,1
12,402,402,1,1,0,1,0
0,433,433,111,75,36,3,2
4,439,439,9,9,0,1,0
19,440,440,47,6,41,2,1
1,444,444,4,4,0,1,0
20,449,449,45,15,30,3,2
17,457,457,115,45,70,3,2
24,462,462,10,10,0,1,0
16,463,463,56,56,0,1,0
13,473,473,18,18,0,1,0
14,497,497,7,1,6,2,1

3,100,100,16,5,11,3,2
11,102,102,1,1,0,1,0
13,109,109,1,1,0,1,0
20,111,111,7,1,6,2,1
15,113,113,3,3,0,1,0
9,116,116,13,13,0,1,0
28,119,119,38,38,0,1,0
4,124,124,1,1,0,1,0
16,136,136,29,17,12,3,2
12,143,143,52,52,0,1,0
27,163,163,1,1,0,1,0
6,169,169,3,3,0,1,0
14,173,173,4,4,0,1,0
24,185,185,29,3,26,2,1
19,211,211,21,16,5,2,1
2,246,246,24,24,0,1,0
22,310,310,28,8,20,4,3
1,326,326,39,6,33,2,1
21,340,340,16,16,0,1,0
25,368,368,40,28,12,4,3
10,402,402,30,10,20,3,2
23,412,412,31,31,0,1,0
7,418,418,63,20,43,2,1
18,422,422,46,40,6,2,1
8,427,427,61,61,0,1,0
0,432,432,2,2,0,1,0
17,443,443,16,8,8,2,1
5,450,450,49,9,40,2,1
26,465,465,40,7,33,4,3

19,101,101,25,25,0,1,0
14,120,120,4,4,0,1,0
1,158,158,3,3,0,1,0
6,160,160,30,30,0,1,0
10,160,160,5,1,4,2,1
18,177,177,8,8,0,1,0
16,207,207,2,2,0,1,0
21,218,218,51,33,18,2,1
17,231,231,36,3,33,4,3
15,244,244,14,14,0,1,0
5,245,245,20,6,14,2,1
13,273,273,4,4,0,1,0
11,281,281,33,17,16,4,3
8,295,295,38,23,15,2,1
7,310,310,68,29,39,2,1
22,345,345,51,6,45,2,1
12,392,392,1,1,0,1,0
0,409,409,54,23,31,2,1
2,417,417,183,111,72,4,3
4,419,419,45,2,43,2,1
23,443,443,63,5,58,4,3
3,452,452,26,15,11,2,1
20,462,462,88,61,27,4,3
9,500,500,14,14,0,1,0

13,101,101,4,4,0,1,0
14,110,110,15,15,0,1,0
17,116,116,23,9,14,3,2
10,135,135,21,21,0,1,0
23,135,135,5,2,3,2,1
12,151,151,34,34,0,1,0
4,154,154,41,41,0,1,0
24,166,166,5,5,0,1,0
21,167,167,41,19,22,2,1
6,180,180,4,4,0,1,0
8,181,181,13,13,0,1,0
16,220,220,21,21,0,1,0
22,223,223,4,4,0,1,0
9,276,276,62,54,8,3,2
2,297,297,7,4,3,2,1
18,307,307,24,24,0,1,0
19,339,339,24,15,9,4,3
7,342,342,5,1,4,2,1
15,350,350,12,12,0,1,0
1,361,361,32,1,31,2,1
3,383,383,149,149,0,1,0
20,388,388,25,4,21,2,1
11,448,448,70,20,50,3,2
5,459,459,34,23,11,2,1
0,481,481,34,4,30,2,1

26,117,117,1,1,0,1,0
6,125,125,1,1,0,1,0
16,172,172,6,6,0,1,0
17,178,178,13,13,0,1,0
2,183,183,44,37,7,2,1
22,188,188,15,15,0,1,0
4,191,191,16,16,0,1,0
14,223,223,1,1,0,1,0
9,243,243,24,24,0,1,0
1,265,265,44,12,32,4,3
8,284,284,5,5,0,1,0
18,285,285,28,13,15,2,1
11,293,293,65,20,45,4,3
10,306,306,16,4,12,4,3
20,330,330,105,57,48,4,3
21,330,330,4,4,0,1,0
3,341,341,21,5,16,3,2
19,365,365,39,20,19,2,1
24,382,382,88,46,42,4,3
15,400,400,113,89,24,2,1
13,411,411,3,3,0,1,0
7,412,412,121,121,0,1,0
0,424,424,29,29,0,1,0
5,435,435,25,11,14,2,1
23,450,450,11,11,0,1,0
25,456,456,63,63,0,1,0
12,464,464,14,3,11,2,1

9,121,121,30,30,0,1,0
1,130,130,27,27,0,1,0
6,133,133,8,2,6,3,2
19,136,136,18,12,6,2,1
13,141,141,13,9,4,2,1
15,147,147,23,23,0,1,0
23,165,165,7,7,0,1,0
14,189,189,5,5,0,1,0
5,198,198,11,5,6,3,2
18,220,220,22,22,0,1,0
2,244,244,29,29,0,1,0
0,248,248,63,63,0,1,0
22,263,263,18,3,15,2,1
3,271,271,36,36,0,1,0
12,309,309,17,17,0,1,0
20,318,318,49,36,13,2,1
17,349,349,26,8,18,4,3
4,357,357,3,3,0,1,0
8,375,375,4,1,3,2,1
10,378,378,40,24,16,2,1
11,398,398,12,5,7,2,1
16,417,417,65,65,0,1,0
21,450,450,104,42,62,3,2
7,466,466,145,64,81,3,2

20,101,101,7,7,0,1,0
0,140,140,13,13,0,1,0
18,150,150,33,33,0,1,0
26,157,157,5,5,0,1,0
11,181,181,19,19,0,1,0
2,189,189,12,12,0,1,0
7,189,189,4,4,0,1,0
5,195,195,30,30,0,1,0
9,214,214,6,6,0,1,0
1,221,221,7,1,6,3,2
13,227,227,14,8,6,3,2
24,249,249,7,7,0,1,0
17,255,255,18,8,10,2,1
16,264,264,49,4,45,2,1
12,274,274,31,31,0,1,0
28,284,284,8,4,4,2,1
10,286,286,3,3,0,1,0
8,294,294,13,13,0,1,0
6,304,304,31,25,6,3,2
22,311,311,10,10,0,1,0
19,314,314,59,3,56,4,3
27,321,321,59,44,15,2,1
3,323,323,1,1,0,1,0
14,342,342,161,161,0,1,0
23,349,349,42,42,0,1,0
25,393,393,41,15,26,2,1
15,423,423,36,12,24,3,2
21,446,446,47,47,0,1,0
29,457,457,27,5,22,3,2
4,463,463,7,1,6,2,1

18,107,107,17,1,16,2,1
24,113,113,6,6,0,1,0
28,115,115,4,4,0,1,0
25,123,123,2,2,0,1,0
0,146,146,8,8,0,1,0
7,169,169,19,19,0,1,0
4,185,185,13,13,0,1,0
1,213,213,14,3,11,2,1
3,218,218,9,9,0,1,0
20,226,226,25,13,12,2,1
13,230,230,53,53,0,1,0
8,239,239,23,23,0,1,0
16,242,242,25,25,0,1,0
27,257,257,20,8,12,4,3
15,266,266,20,20,0,1,0
14,269,269,11,11,0,1,0
12,302,302,79,79,0,1,0
9,329,329,24,21,3,2,1
22,339,339,113,101,12,2,1
17,357,357,15,15,0,1,0
10,358,358,14,9,5,2,1
19,364,364,112,90,22,4,3
21,416,416,1,1,0,1,0
2,419,419,4,1,3,2,1
6,431,431,84,84,0,1,0
5,438,438,20,1,19,3,2
11,491,491,32,32,0,1,0
26,494,494,23,23,0,1,0
23,495,495,35,35,0,1,0

4,101,101,11,11,0,1,0
15,136,136,6,6,0,1,0
19,149,149,26,1,25,3,2
5,162,162,26,26,0,1,0
17,166,166,26,17,9,4,3
21,170,170,23,23,0,1,0
23,185,185,34,31,3,2,1
1,195,195,63,9,54,3,2
9,219,219,5,5,0,1,0
12,270,270,25,17,8,2,1
13,272,272,11,6,5,2,1
2,307,307,32,32,0,1,0
18,315,315,35,32,3,2,1
0,324,324,3,3,0,1,0
16,335,335,53,53,0,1,0
11,341,341,13,5,8,2,1
6,352,352,6,6,0,1,0
10,369,369,17,17,0,1,0
7,396,396,171,108,63,4,3
22,399,399,15,1,14,2,1
3,427,427,73,35,38,3,2
8,469,469,26,14,12,4,3
14,477,477,20,20,0,1,0
20,492,492,81,1,80,3,2

21,106,106,12,1,11,2,1
5,111,111,2,2,0,1,0
29,112,112,11,11,0,1,0
4,127,127,5,5,0,1,0
1,152,152,1,1,0,1,0
26,164,164,14,7,7,2,1
17,201,201,11,11,0,1,0
20,225,225,6,6,0,1,0
28,236,236,28,10,18,2,1
15,258,258,84,62,22,4,3
9,263,263,12,5,7,2,1
6,291,291,14,14,0,1,0
33,301,301,12,8,4,2,1
34,304,304,55,34,21,4,3
32,306,306,32,20,12,4,3
11,316,316,2,2,0,1,0
12,332,332,24,6,18,4,3
19,337,337,4,4,0,1,0
8,341,341,6,2,4,2,1
25,345,345,79,5,74,3,2
3,366,366,37,37,0,1,0
27,382,382,21,13,8,2,1
18,406,406,32,32,0,1,0
0,413,413,91,82,9,4,3
24,415,415,70,14,56,3,2
23,425,425,7,7,0,1,0
13,438,438,35,35,0,1,0
30,440,440,50,50,0,1,0
31,440,440,4,4,0,1,0
10,441,441,3,3,0,1,0
22,450,450,8,8,0,1,0
14,458,458,6,3,3,2,1
16,481,481,8,8,0,1,0
35,483,483,91,62,29,4,3
2,494,494,24,24,0,1,0
7,495,495,26,11,15,4,3

22,118,118,3,3,0,1,0
9,123,123,41,41,0,1,0
20,125,125,58,58,0,1,0
2,142,142,18,18,0,1,0
6,144,144,7,1,6,3,2
15,163,163,2,2,0,1,0
23,165,165,11,8,3,2,1
14,185,185,8,8,0,1,0
12,200,200,46,10,36,3,2
17,258,258,3,3,0,1,0
5,266,266,36,36,0,1,0
8,282,282,16,2,14,2,1
1,304,304,1,1,0,1,0
16,322,322,16,1,15,2,1
19,370,370,93,67,26,3,2
7,375,375,3,3,0,1,0
21,406,406,5,5,0,1,0
3,420,420,33,8,25,2,1
4,432,432,221,181,40,3,2
18,448,448,4,4,0,1,0
13,453,453,17,1,16,2,1
11,460,460,89,89,0,1,0
0,460,460,48,24,24,2,1
10,461,461,5,1,4,2,1

25,135,135,3,3,0,1,0
5,141,141,25,25,0,1,0
20,166,166,9,9,0,1,0
8,174,174,29,8,21,4,3
9,197,197,5,2,3,2,1
29,204,204,24,8,16,2,1
12,204,204,1,1,0,1,0
0,209,209,27,27,0,1,0
7,211,211,25,18,7,2,1
17,281,281,44,44,0,1,0
1,286,286,74,74,0,1,0
3,298,298,2,2,0,1,0
21,327,327,80,80,0,1,0
14,346,346,46,46,0,1,0
18,348,348,110,110,0,1,0
15,363,363,3,3,0,1,0
2,383,383,3,3,0,1,0
23,385,385,22,15,7,2,1
26,396,396,18,9,9,2,1
11,417,417,20,6,14,3,2
19,432,432,36,5,31,4,3
28,450,450,109,16,93,4,3
24,459,459,18,11,7,2,1
16,473,473,9,3,6,2,1
10,480,480,31,31,0,1,0
13,486,486,66,66,0,1,0
4,490,490,41,29,12,4,3
22,490,490,3,3,0,1,0
6,497,497,17,13,4,2,1
27,497,497,8,2,6,2,1

5,120,120,1,1,0,1,0
13,121,121,7,7,0,1,0
2,142,142,10,10,0,1,0
21,152,152,17,17,0,1,0
1,206,206,8,8,0,1,0
18,208,208,45,45,0,1,0
12,211,211,6,6,0,1,0
4,247,247,49,49,0,1,0
17,252,252,59,59,0,1,0
20,260,260,75,71,4,2,1
16,267,267,32,32,0,1,0
14,268,268,10,1,9,4,3
19,314,314,18,1,17,2,1
7,321,321,204,118,86,4,3
8,338,338,16,1,15,3,2
11,339,339,13,5,8,2,1
9,352,352,6,6,0,1,0
15,396,396,14,14,0,1,0
6,399,399,53,53,0,1,0
10,437,437,61,61,0,1,0
3,463,463,104,58,46,2,1
0,492,492,46,34,12,3,2

20,120,120,4,4,0,1,0
19,133,133,12,12,0,1,0
13,139,139,20,20,0,1,0
7,152,152,8,3,5,2,1
12,170,170,5,5,0,1,0
1,209,209,36,33,3,2,1
0,229,229,7,7,0,1,0
4,239,239,27,27,0,1,0
18,241,241,3,3,0,1,0
17,245,245,104,80,24,2,1
9,253,253,3,3,0,1,0
3,254,254,10,10,0,1,0
8,289,289,18,9,9,2,1
16,300,300,45,45,0,1,0
5,327,327,72,72,0,1,0
15,369,369,6,6,0,1,0
14,372,372,34,1,33,4,3
21,399,399,2,2,0,1,0
2,420,420,256,190,66,3,2
11,421,421,40,11,29,3,2
22,449,449,63,39,24,3,2
6,458,458,46,46,0,1,0
10,498,498,94,69,25,2,1

24,110,110,3,3,0,1,0
10,111,111,6,6,0,1,0
7,143,143,9,1,8,2,1
1,159,159,21,21,0,1,0
19,164,164,8,8,0,1,0
20,178,178,5,5,0,1,0
4,181,181,1,1,0,1,0
0,203,203,3,3,0,1,0
8,219,219,18,6,12,4,3
12,226,226,80,69,11,2,1
6,238,238,14,7,7,2,1
22,255,255,37,37,0,1,0
17,273,273,107,107,0,1,0
21,319,319,5,5,0,1,0
5,335,335,79,7,72,3,2
9,357,357,12,12,0,1,0
26,366,366,16,13,3,2,1
23,394,394,19,11,8,2,1
2,423,423,40,40,0,1,0
15,431,431,166,70,96,4,3
3,449,449,109,4,105,4,3
14,453,453,74,74,0,1,0
16,454,454,37,37,0,1,0
13,458,458,1,1,0,1,0
25,481,481,4,4,0,1,0
18,489,489,20,20,0,1,0
11,490,490,16,7,9,2,1

7,142,142,18,5,13,2,1
15,146,146,1,1,0,1,0
1,148,148,9,5,4,2,1
26,165,165,9,4,5,2,1
31,185,185,1,1,0,1,0
29,191,191,7,7,0,1,0
13,197,197,11,5,6,3,2
9,217,217,6,6,0,1,0
8,226,226,37,23,14,2,1
22,228,228,2,2,0,1,0
18,239,239,93,75,18,4,3
23,240,240,42,42,0,1,0
6,279,279,5,5,0,1,0
5,290,290,17,17,0,1,0
24,290,290,29,17,12,3,2
19,292,292,21,21,0,1,0
21,330,330,65,65,0,1,0
4,330,330,10,10,0,1,0
20,344,344,7,1,6,2,1
10,351,351,30,30,0,1,0
17,372,372,16,6,10,3,2
12,385,385,14,2,12,4,3
0,390,390,60,60,0,1,0
14,396,396,2,2,0,1,0
25,427,427,5,5,0,1,0
28,435,435,8,8,0,1,0
3,453,453,114,70,44,2,1
30,460,460,120,54,66,3,2
16,461,461,19,1,18,3,2
11,484,484,53,53,0,1,0
27,494,494,38,38,0,1,0
2,500,500,63,16,47,2,1

13,173,173,8,8,0,1,0
21,175,175,4,1,3,2,1
28,178,178,31,31,0,1,0
10,179,179,17,5,12,4,3
16,185,185,7,7,0,1,0
20,204,204,3,3,0,1,0
9,225,225,29,11,18,4,3
17,270,270,11,11,0,1,0
24,302,302,20,20,0,1,0
11,302,302,31,31,0,1,0
0,311,311,4,4,0,1,0
27,350,350,4,1,3,2,1
4,354,354,2,2,0,1,0
26,360,360,85,85,0,1,0
5,383,383,3,3,0,1,0
8,402,402,70,70,0,1,0
3,420,420,145,70,75,4,3
14,422,422,95,95,0,1,0
2,427,427,35,35,0,1,0
18,436,436,96,74,22,2,1
7,441,441,1,1,0,1,0
22,443,443,31,13,18,2,1
19,459,459,40,40,0,1,0
12,462,462,22,13,9,2,1
6,476,476,22,10,12,2,1
15,488,488,177,91,86,4,3
23,489,489,32,32,0,1,0
25,494,494,7,7,0,1,0
1,499,499,40,40,0,1,0

29,101,101,5,5,0,1,0
17,117,117,6,2,4,2,1
0,124,124,4,4,0,1,0
25,126,126,44,39,5,2,1
21,148,148,12,12,0,1,0
35,158,158,40,40,0,1,0
28,163,163,3,3,0,1,0
4,182,182,4,1,3,2,1
23,205,205,3,3,0,1,0
10,224,224,12,12,0,1,0
33,233,233,3,3,0,1,0
6,242,242,11,11,0,1,0
13,244,244,7,4,3,2,1
9,253,253,30,30,0,1,0
24,268,268,119,119,0,1,0
27,288,288,3,3,0,1,0
30,307,307,22,22,0,1,0
19,343,343,7,7,0,1,0
20,349,349,34,34,0,1,0
3,352,352,7,4,3,2,1
2,352,352,20,7,13,2,1
26,353,353,4,4,0,1,0
8,360,360,4,4,0,1,0
11,363,363,1,1,0,1,0
15,369,369,3,3,0,1,0
12,370,370,87,43,44,2,1
16,390,390,34,34,0,1,0
7,393,393,27,9,18,3,2
1,408,408,51,45,6,2,1
32,429,429,1,1,0,1,0
18,430,430,34,14,20,2,1
22,436,436,61,61,0,1,0
5,444,444,39,29,10,3,2
34,454,454,16,7,9,4,3
31,477,477,12,12,0,1,0
14,484,484,34,34,0,1,0

23,107,107,25,9,16,3,2
8,111,111,4,1,3,2,1
19,123,123,22,22,0,1,0
12,140,140,14,14,0,1,0
24,142,142,13,13,0,1,0
29,143,143,21,12,9,4,3
17,150,150,1,1,0,1,0
28,168,168,22,22,0,1,0
16,183,183,6,2,4,2,1
6,183,183,67,21,46,3,2
5,196,196,1,1,0,1,0
30,206,206,6,6,0,1,0
13,213,213,10,4,6,2,1
0,227,227,1,1,0,1,0
31,233,233,16,13,3,2,1
18,260,260,22,22,0,1,0
10,274,274,4,1,3,2,1
1,285,285,20,14,6,3,2
14,303,303,12,12,0,1,0
26,307,307,1,1,0,1,0
2,315,315,80,80,0,1,0
9,323,323,4,4,0,1,0
4,347,347,13,13,0,1,0
11,376,376,16,16,0,1,0
27,378,378,68,5,63,3,2
21,407,407,17,17,0,1,0
15,409,409,6,6,0,1,0
22,409,409,9,2,7,2,1
20,442,442,51,6,45,4,3
3,447,447,131,2,129,4,3
7,487,487,13,13,0,1,0
25,488,488,59,3,56,4,3

17,116,116,2,2,0,1,0
8,117,117,8,8,0,1,0
12,128,128,1,1,0,1,0
19,142,142,6,6,0,1,0
11,151,151,1,1,0,1,0
1,164,164,1,1,0,1,0
14,167,167,2,2,0,1,0
15,167,167,1,1,0,1,0
22,183,183,32,14,18,4,3
13,194,194,4,4,0,1,0
3,197,197,15,1,14,3,2
9,207,207,2,2,0,1,0
30,219,219,47,47,0,1,0
6,238,238,6,3,3,2,1
7,255,255,26,11,15,2,1
23,277,277,4,4,0,1,0
10,289,289,62,62,0,1,0
16,300,300,70,20,50,3,2
4,301,301,77,77,0,1,0
28,304,304,59,23,36,2,1
26,310,310,18,18,0,1,0
20,335,335,76,64,12,4,3
25,342,342,29,29,0,1,0
0,347,347,1,1,0,1,0
29,377,377,8,8,0,1,0
2,382,382,37,37,0,1,0
5,397,397,102,84,18,2,1
24,429,429,7,7,0,1,0
21,435,435,61,61,0,1,0
27,446,446,90,10,80,3,2
18,479,479,11,11,0,1,0

11,102,102,6,3,3,2,1
16,103,103,1,1,0,1,0
22,131,131,7,7,0,1,0
12,158,158,20,12,8,2,1
28,224,224,92,25,67,3,2
25,232,232,32,32,0,1,0
24,233,233,32,32,0,1,0
5,240,240,18,6,12,3,2
13,250,250,20,5,15,2,1
2,261,261,21,8,13,3,2
30,265,265,14,14,0,1,0
15,269,269,15,10,5,2,1
0,270,270,23,23,0,1,0
27,282,282,4,4,0,1,0
10,290,290,11,11,0,1,0
18,291,291,13,2,11,3,2
3,332,332,56,56,0,1,0
20,339,339,1,1,0,1,0
9,357,357,1,1,0,1,0
23,358,358,17,17,0,1,0
31,361,361,1,1,0,1,0
1,361,361,3,3,0,1,0
32,369,369,79,72,7,2,1
34,384,384,26,12,14,2,1
8,393,393,12,12,0,1,0
33,395,395,5,5,0,1,0
21,410,410,50,28,22,2,1
19,412,412,24,18,6,2,1
26,426,426,50,6,44,2,1
29,429,429,15,1,14,2,1
4,432,432,110,62,48,3,2
17,443,443,5,2,3,2,1
7,463,463,4,4,0,1,0
6,467,467,93,54,39,4,3
14,481,481,1,1,0,1,0

24,101,101,1,1,0,1,0
10,120,120,3,3,0,1,0
9,121,121,1,1,0,1,0
17,127,127,1,1,0,1,0
1,153,153,17,17,0,1,0
14,157,157,28,28,0,1,0
21,159,159,52,2,50,3,2
16,191,191,21,21,0,1,0
19,210,210,62,26,36,2,1
3,230,230,90,90,0,1,0
25,231,231,15,2,13,2,1
15,254,254,15,15,0,1,0
23,276,276,21,21,0,1,0
20,293,293,7,7,0,1,0
8,306,306,20,20,0,1,0
0,344,344,30,30,0,1,0
2,363,363,7,1,6,3,2
11,388,388,113,58,55,4,3
12,404,404,38,1,37,2,1
13,407,407,31,14,17,2,1
5,417,417,2,2,0,1,0
4,446,446,146,146,0,1,0
18,461,461,42,42,0,1,0
7,466,466,1,1,0,1,0
22,481,481,10,1,9,2,1
6,500,500,34,22,12,2,1

14,113,113,13,9,4,2,1
5,156,156,8,8,0,1,0
24,160,160,16,16,0,1,0
18,171,171,3,3,0,1,0
26,217,217,37,10,27,4,3
27,233,233,29,29,0,1,0
7,244,244,5,5,0,1,0
1,257,257,29,29,0,1,0
10,267,267,24,24,0,1,0
17,277,277,5,5,0,1,0
30,292,292,80,80,0,1,0
8,322,322,3,3,0,1,0
6,345,345,7,7,0,1,0
13,346,346,10,6,4,2,1
29,364,364,11,11,0,1,0
31,372,372,8,2,6,3,2
23,380,380,21,21,0,1,0
28,387,387,87,42,45,2,1
0,390,390,8,8,0,1,0
21,411,411,30,5,25,4,3
4,414,414,145,68,77,4,3
19,416,416,44,34,10,2,1
2,421,421,59,1,58,3,2
20,423,423,17,7,10,3,2
11,437,437,8,1,7,2,1
9,442,442,41,20,21,2,1
22,446,446,5,2,3,2,1
25,446,446,78,24,54,4,3
16,447,447,13,1,12,3,2
3,452,452,73,59,14,2,1
12,468,468,53,53,0,1,0
15,481,481,4,4,0,1,0

10,107,107,1,1,0,1,0
25,134,134,1,1,0,1,0
6,138,138,17,17,0,1,0
23,142,142,37,37,0,1,0
20,222,222,1,1,0,1,0
29,230,230,4,4,0,1,0
1,242,242,55,25,30,4,3
7,248,248,1,1,0,1,0
14,265,265,2,2,0,1,0
17,271,271,40,40,0,1,0
2,282,282,35,35,0,1,0
28,298,298,22,14,8,2,1
27,306,306,10,2,8,3,2
22,334,334,86,2,84,4,3
15,339,339,15,4,11,4,3
0,350,350,9,9,0,1,0
18,363,363,4,4,0,1,0
5,369,369,39,39,0,1,0
26,376,376,133,61,72,4,3
24,404,404,3,3,0,1,0
30,426,426,38,19,19,2,1
21,435,435,20,20,0,1,0
4,446,446,2,2,0,1,0
11,454,454,242,166,76,3,2
3,463,463,37,37,0,1,0
9,468,468,5,5,0,1,0
12,471,471,23,23,0,1,0
16,471,471,3,3,0,1,0
8,480,480,10,10,0,1,0
13,486,486,12,3,9,4,3
19,490,490,56,56,0,1,0

16,108,108,7,3,4,2,1
0,113,113,12,4,8,2,1
26,121,121,20,14,6,3,2
11,136,136,14,14,0,1,0
4,139,139,16,4,12,3,2
19,144,144,8,8,0,1,0
6,152,152,3,3,0,1,0
13,180,180,12,12,0,1,0
9,199,199,31,23,8,3,2
3,200,200,6,6,0,1,0
21,201,201,37,25,12,3,2
1,221,221,1,1,0,1,0
7,226,226,34,10,24,3,2
23,228,228,67,67,0,1,0
25,238,238,4,1,3,2,1
22,260,260,12,12,0,1,0
14,279,279,57,57,0,1,0
2,284,284,14,14,0,1,0
20,338,338,45,36,9,2,1
10,344,344,14,14,0,1,0
8,360,360,22,22,0,1,0
18,370,370,19,1,18,4,3
17,377,377,18,6,12,2,1
24,383,383,21,10,11,2,1
12,447,447,10,6,4,2,1
5,485,485,263,218,45,4,3
15,487,487,24,24,0,1,0

0,101,101,1,1,0,1,0
4,110,110,13,7,6,3,2
11,131,131,1,1,0,1,0
24,133,133,2,2,0,1,0
18,141,141,3,3,0,1,0
23,143,143,17,17,0,1,0
1,150,150,15,15,0,1,0
19,151,151,16,6,10,3,2
20,155,155,23,17,6,2,1
7,156,156,2,2,0,1,0
29,181,181,7,1,6,2,1
26,196,196,34,34,0,1,0
2,201,201,13,13,0,1,0
16,203,203,20,4,16,2,1
5,219,219,13,13,0,1,0
22,229,229,24,3,21,4,3
21,258,258,5,5,0,1,0
8,263,263,2,2,0,1,0
3,296,296,5,5,0,1,0
15,302,302,73,73,0,1,0
6,303,303,23,20,3,2,1
9,306,306,11,5,6,2,1
28,332,332,16,16,0,1,0
17,394,394,38,26,12,2,1
27,430,430,104,81,23,2,1
12,437,437,138,9,129,4,3
25,468,468,100,100,0,1,0
10,468,468,1,1,0,1,0
14,486,486,119,33,86,3,2
13,493,493,44,25,19,2,1

9,150,150,14,14,0,1,0
6,180,180,21,10,11,2,1
3,184,184,7,2,5,2,1
0,203,203,43,23,20,3,2
1,203,203,27,27,0,1,0
8,216,216,12,12,0,1,0
10,216,216,17,17,0,1,0
18,243,243,8,8,0,1,0
20,259,259,58,46,12,3,2
4,262,262,88,7,81,4,3
15,287,287,71,19,52,4,3
21,298,298,36,6,30,2,1
7,306,306,4,4,0,1,0
11,309,309,23,23,0,1,0
12,310,310,49,33,16,3,2
2,349,349,67,3,64,3,2
19,356,356,13,2,11,3,2
17,384,384,9,9,0,1,0
5,400,400,85,72,13,2,1
23,429,429,8,8,0,1,0
22,437,437,8,2,6,2,1
14,439,439,81,41,40,3,2
13,486,486,59,59,0,1,0
16,487,487,38,14,24,4,3

6,101,101,28,4,24,2,1
15,111,111,3,3,0,1,0
5,137,137,21,8,13,2,1
26,148,148,1,1,0,1,0
11,167,167,19,19,0,1,0
12,170,170,4,4,0,1,0
14,174,174,1,1,0,1,0
17,181,181,8,8,0,1,0
23,212,212,11,1,10,2,1
13,257,257,45,24,21,4,3
0,267,267,15,15,0,1,0
7,329,329,9,9,0,1,0
19,331,331,51,13,38,3,2
2,343,343,62,62,0,1,0
21,345,345,46,28,18,3,2
4,348,348,1,1,0,1,0
25,358,358,34,34,0,1,0
20,367,367,73,10,63,4,3
24,368,368,86,86,0,1,0
9,372,372,60,23,37,2,1
3,380,380,37,37,0,1,0
28,392,392,11,11,0,1,0
10,408,408,1,1,0,1,0
1,414,414,24,24,0,1,0
22,426,426,15,1,14,4,3
27,448,448,55,55,0,1,0
16,452,452,4,4,0,1,0
8,473,473,32,32,0,1,0
18,481,481,137,61,76,3,2

12,106,106,5,2,3,2,1
15,118,118,19,19,0,1,0
25,124,124,13,5,8,2,1
19,129,129,1,1,0,1,0
21,152,152,10,10,0,1,0
0,160,160,4,4,0,1,0
32,168,168,22,22,0,1,0
2,180,180,12,12,0,1,0
7,188,188,7,7,0,1,0
16,198,198,32,32,0,1,0
13,215,215,4,4,0,1,0
11,269,269,33,1,32,3,2
23,270,270,104,2,102,4,3
31,282,282,24,2,22,3,2
17,288,288,15,15,0,1,0
6,305,305,10,2,8,3,2
3,323,323,83,9,74,3,2
8,338,338,8,8,0,1,0
9,343,343,23,5,18,4,3
24,357,357,30,18,12,2,1
28,372,372,28,28,0,1,0
1,380,380,20,20,0,1,0
30,383,383,112,112,0,1,0
4,396,396,19,19,0,1,0
29,402,402,13,1,12,3,2
26,435,435,4,4,0,1,0
5,446,446,3,3,0,1,0
27,453,453,8,8,0,1,0
10,460,460,10,10,0,1,0
14,462,462,20,2,18,3,2
18,466,466,73,3,70,3,2
22,468,468,26,26,0,1,0
20,475,475,42,12,30,3,2

17,112,112,1,1,0,1,0
13,135,135,7,7,0,1,0
11,138,138,12,12,0,1,0
12,166,166,10,1,9,4,3
20,173,173,24,1,23,2,1
7,187,187,13,4,9,4,3
14,217,217,12,12,0,1,0
24,263,263,26,1,25,2,1
25,264,264,46,6,40,4,3
26,288,288,33,21,12,2,1
27,289,289,29,29,0,1,0
4,305,305,15,15,0,1,0
16,306,306,46,46,0,1,0
9,314,314,75,50,25,4,3
22,349,349,24,24,0,1,0
15,384,384,17,11,6,2,1
6,388,388,11,11,0,1,0
18,389,389,9,9,0,1,0
3,406,406,39,14,25,2,1
1,419,419,123,123,0,1,0
19,429,429,22,22,0,1,0
2,436,436,64,24,40,2,1
21,459,459,73,13,60,3,2
10,474,474,2,2,0,1,0
0,475,475,32,4,28,3,2
5,483,483,59,59,0,1,0
8,488,488,45,15,30,3,2
23,497,497,119,35,84,3,2

7,103,103,18,18,0,1,0
27,127,127,12,4,8,2,1
22,128,128,1,1,0,1,0
28,146,146,13,13,0,1,0
16,151,151,5,5,0,1,0
21,184,184,28,13,15,4,3
10,195,195,12,1,11,2,1
17,228,228,9,9,0,1,0
24,244,244,12,6,6,3,2
19,257,257,8,8,0,1,0
29,271,271,23,2,21,2,1
1,283,283,3,3,0,1,0
9,305,305,32,17,15,4,3
12,306,306,24,24,0,1,0
5,306,306,10,10,0,1,0
0,318,318,37,37,0,1,0
4,320,320,34,34,0,1,0
20,339,339,77,55,22,4,3
13,356,356,1,1,0,1,0
14,356,356,32,32,0,1,0
3,361,361,40,40,0,1,0
15,364,364,15,15,0,1,0
11,403,403,72,72,0,1,0
18,403,403,4,4,0,1,0
31,406,406,30,30,0,1,0
30,408,408,97,97,0,1,0
25,435,435,92,92,0,1,0
26,441,441,18,18,0,1,0
6,467,467,1,1,0,1,0
8,473,473,5,5,0,1,0
2,487,487,102,32,70,4,3
23,493,493,55,19,36,4,3

7,115,115,2,2,0,1,0
21,124,124,10,10,0,1,0
15,147,147,2,2,0,1,0
23,152,152,13,1,12,4,3
18,162,162,46,16,30,4,3
17,163,163,4,4,0,1,0
12,226,226,54,54,0,1,0
9,230,230,44,34,10,2,1
13,235,235,4,1,3,2,1
25,236,236,12,12,0,1,0
6,246,246,2,2,0,1,0
3,258,258,49,49,0,1,0
4,274,274,23,23,0,1,0
5,329,329,8,8,0,1,0
19,340,340,36,18,18,2,1
8,370,370,81,36,45,2,1
22,382,382,49,28,21,4,3
26,388,388,169,122,47,4,3
0,392,392,85,61,24,2,1
10,408,408,15,10,5,2,1
2,408,408,49,2,47,4,3
16,435,435,18,9,9,2,1
24,438,438,11,3,8,3,2
14,444,444,40,40,0,1,0
20,455,455,16,16,0,1,0
1,475,475,10,10,0,1,0
11,485,485,16,6,10,3,2

15,128,128,4,1,3,2,1
25,129,129,8,2,6,3,2
23,133,133,13,1,12,4,3
12,157,157,13,1,12,4,3
7,190,190,10,3,7,2,1
29,223,223,5,5,0,1,0
9,235,235,22,12,10,3,2
1,243,243,41,33,8,3,2
6,248,248,37,3,34,3,2
5,250,250,4,1,3,2,1
4,258,258,17,3,14,2,1
11,272,272,64,30,34,3,2
21,327,327,96,42,54,4,3
22,337,337,27,10,17,2,1
17,346,346,67,25,42,3,2
8,348,348,16,11,5,2,1
14,355,355,27,27,0,1,0
24,383,383,15,15,0,1,0
13,397,397,50,50,0,1,0
16,415,415,21,12,9,3,2
18,417,417,93,93,0,1,0
27,428,428,34,18,16,3,2
20,438,438,58,58,0,1,0
0,439,439,19,6,13,2,1
28,440,440,37,2,35,2,1
10,458,458,48,48,0,1,0
26,459,459,9,4,5,2,1
2,464,464,18,18,0,1,0
3,480,480,35,4,31,2,1
19,498,498,19,6,13,4,3

17,101,101,6,6,0,1,0
23,123,123,35,1,34,2,1
8,129,129,17,8,9,2,1
14,143,143,4,4,0,1,0
19,159,159,25,8,17,2,1
0,159,159,13,13,0,1,0
18,220,220,2,2,0,1,0
1,224,224,59,14,45,4,3
26,227,227,18,18,0,1,0
25,234,234,10,2,8,3,2
15,235,235,12,3,9,2,1
22,236,236,1,1,0,1,0
12,244,244,107,24,83,4,3
5,254,254,25,19,6,2,1
21,264,264,2,2,0,1,0
28,266,266,8,8,0,1,0
20,286,286,47,21,26,2,1
3,293,293,7,2,5,2,1
2,299,299,9,9,0,1,0
11,321,321,1,1,0,1,0
16,330,330,16,9,7,2,1
13,341,341,1,1,0,1,0
29,398,398,105,87,18,4,3
27,406,406,96,24,72,3,2
10,408,408,68,68,0,1,0
24,414,414,15,15,0,1,0
4,420,420,1,1,0,1,0
6,436,436,22,22,0,1,0
7,471,471,3,3,0,1,0
9,472,472,11,3,8,2,1

13,135,135,13,4,9,4,3
15,139,139,1,1,0,1,0
5,143,143,63,43,20,3,2
14,153,153,12,3,9,2,1
1,157,157,42,42,0,1,0
20,216,216,39,18,21,4,3
4,267,267,15,15,0,1,0
6,277,277,39,19,20,3,2
18,283,283,66,66,0,1,0
11,297,297,8,2,6,2,1
19,308,308,99,72,27,4,3
10,320,320,2,2,0,1,0
12,351,351,9,5,4,2,1
3,361,361,86,52,34,2,1
9,363,363,8,8,0,1,0
8,368,368,14,6,8,3,2
2,413,413,38,38,0,1,0
17,424,424,89,71,18,4,3
16,425,425,50,50,0,1,0
0,454,454,75,21,54,3,2
7,476,476,35,3,32,2,1

1,117,117,16,7,9,2,1
2,127,127,9,9,0,1,0
18,136,136,8,1,7,2,1
6,138,138,10,1,9,4,3
9,156,156,10,10,0,1,0
7,183,183,49,9,40,3,2
13,206,206,1,1,0,1,0
14,206,206,50,50,0,1,0
17,251,251,15,15,0,1,0
23,253,253,1,1,0,1,0
5,263,263,5,5,0,1,0
11,311,311,11,5,6,3,2
0,324,324,15,7,8,2,1
22,337,337,19,5,14,3,2
16,354,354,3,3,0,1,0
12,388,388,65,20,45,2,1
3,397,397,24,24,0,1,0
8,417,417,79,79,0,1,0
19,423,423,69,69,0,1,0
24,428,428,6,6,0,1,0
21,431,431,86,86,0,1,0
20,470,470,107,67,40,2,1
15,484,484,87,58,29,2,1
4,492,492,215,179,36,3,2
10,494,494,18,18,0,1,0

12,123,123,14,14,0,1,0
17,140,140,7,7,0,1,0
18,146,146,14,14,0,1,0
4,156,156,2,2,0,1,0
14,160,160,37,15,22,3,2
26,179,179,1,1,0,1,0
22,191,191,15,15,0,1,0
21,193,193,2,2,0,1,0
1,204,204,1,1,0,1,0
15,229,229,48,26,22,2,1
9,233,233,31,5,26,3,2
24,262,262,27,27,0,1,0
8,354,354,47,32,15,4,3
19,362,362,26,26,0,1,0
6,373,373,50,26,24,3,2
2,380,380,92,44,48,3,2
11,392,392,10,5,5,2,1
10,395,395,75,6,69,4,3
20,407,407,113,47,66,4,3
25,409,409,1,1,0,1,0
5,419,419,18,18,0,1,0
3,422,422,9,3,6,3,2
16,440,440,32,32,0,1,0
7,446,446,125,125,0,1,0
13,450,450,86,86,0,1,0
0,459,459,31,7,24,3,2
23,489,489,17,3,14,3,2

1,113,113,19,19,0,1,0
11,138,138,11,11,0,1,0
30,141,141,31,31,0,1,0
29,157,157,8,8,0,1,0
32,169,169,3,3,0,1,0
22,183,183,26,6,20,3,2
16,193,193,1,1,0,1,0
6,214,214,1,1,0,1,0
20,217,217,33,33,0,1,0
15,221,221,10,10,0,1,0
4,271,271,2,2,0,1,0
9,274,274,8,4,4,2,1
35,284,284,132,84,48,3,2
27,308,308,12,12,0,1,0
8,312,312,12,5,7,2,1
7,316,316,48,48,0,1,0
19,327,327,6,6,0,1,0
2,327,327,41,15,26,2,1
33,354,354,9,1,8,2,1
25,354,354,21,9,12,3,2
36,361,361,14,14,0,1,0
10,375,375,2,2,0,1,0
18,400,400,6,6,0,1,0
13,417,417,1,1,0,1,0
21,417,417,1,1,0,1,0
24,435,435,42,42,0,1,0
3,441,441,21,11,10,3,2
5,443,443,10,10,0,1,0
26,443,443,5,2,3,2,1
12,449,449,2,2,0,1,0
34,453,453,96,35,61,4,3
14,459,459,63,47,16,2,1
17,459,459,16,16,0,1,0
23,480,480,77,77,0,1,0
31,484,484,10,10,0,1,0
0,499,499,82,44,38,2,1
28,499,499,6,6,0,1,0

13,142,142,5,5,0,1,0
22,163,163,4,1,3,2,1
20,176,176,21,10,11,2,1
8,190,190,17,2,15,2,1
7,193,193,65,65,0,1,0
23,209,209,17,9,8,2,1
6,219,219,9,9,0,1,0
19,243,243,38,4,34,2,1
0,262,262,19,19,0,1,0
24,279,279,6,3,3,2,1
14,291,291,74,26,48,4,3
15,294,294,61,61,0,1,0
10,343,343,78,15,63,4,3
21,344,344,4,4,0,1,0
4,358,358,53,53,0,1,0
16,359,359,51,39,12,3,2
25,367,367,21,13,8,2,1
3,368,368,14,7,7,2,1
2,371,371,4,4,0,1,0
12,375,375,15,15,0,1,0
17,385,385,6,2,4,2,1
9,417,417,42,9,33,4,3
5,422,422,13,13,0,1,0
1,423,423,107,98,9,2,1
18,435,435,113,97,16,2,1
11,445,445,23,23,0,1,0

28,130,130,4,4,0,1,0
33,134,134,1,1,0,1,0
3,137,137,23,23,0,1,0
17,147,147,15,6,9,4,3
6,147,147,11,11,0,1,0
16,155,155,10,4,6,2,1
30,177,177,53,25,28,2,1
18,214,214,8,8,0,1,0
21,214,214,36,30,6,3,2
1,218,218,9,4,5,2,1
11,220,220,15,15,0,1,0
25,227,227,7,7,0,1,0
12,230,230,6,6,0,1,0
26,238,238,10,10,0,1,0
15,255,255,3,3,0,1,0
7,269,269,20,5,15,2,1
14,279,279,33,7,26,2,1
4,296,296,55,50,5,2,1
8,299,299,2,2,0,1,0
31,318,318,6,6,0,1,0
20,324,324,9,4,5,2,1
32,326,326,24,9,15,2,1
27,396,396,90,66,24,2,1
9,402,402,23,1,22,2,1
23,404,404,29,29,0,1,0
10,411,411,5,5,0,1,0
22,414,414,79,79,0,1,0
29,414,414,4,4,0,1,0
19,418,418,20,20,0,1,0
34,419,419,22,4,18,4,3
13,424,424,1,1,0,1,0
5,427,427,101,12,89,4,3
0,438,438,16,16,0,1,0
2,471,471,1,1,0,1,0
24,473,473,92,33,59,4,3

11,117,117,1,1,0,1,0
6,125,125,7,1,6,2,1
31,143,143,23,23,0,1,0
19,153,153,3,3,0,1,0
3,192,192,2,2,0,1,0
17,196,196,30,2,28,4,3
0,213,213,27,9,18,2,1
27,217,217,18,13,5,2,1
21,220,220,39,1,38,3,2
15,234,234,1,1,0,1,0
8,250,250,2,2,0,1,0
30,260,260,8,1,7,2,1
1,278,278,11,2,9,2,1
20,282,282,31,31,0,1,0
29,288,288,25,5,20,3,2
28,302,302,32,5,27,4,3
9,307,307,30,4,26,2,1
12,336,336,20,20,0,1,0
14,349,349,24,24,0,1,0
2,354,354,36,36,0,1,0
24,366,366,19,19,0,1,0
4,368,368,60,60,0,1,0
13,383,383,35,35,0,1,0
7,398,398,97,89,8,3,2
5,409,409,19,19,0,1,0
10,436,436,36,15,21,4,3
18,452,452,78,40,38,3,2
23,453,453,57,3,54,4,3
22,458,458,51,28,23,2,1
26,459,459,15,12,3,2,1
25,469,469,75,30,45,4,3
16,489,489,19,9,10,3,2

12,132,132,27,9,18,3,2
1,136,136,24,12,12,4,3
22,185,185,3,3,0,1,0
7,190,190,14,14,0,1,0
4,193,193,19,1,18,4,3
10,203,203,22,5,17,2,1
6,205,205,74,26,48,4,3
20,215,215,22,6,16,3,2
17,222,222,18,18,0,1,0
8,230,230,18,2,16,2,1
16,250,250,10,10,0,1,0
25,264,264,17,17,0,1,0
23,278,278,3,3,0,1,0
2,290,290,33,33,0,1,0
14,293,293,24,24,0,1,0
11,314,314,16,16,0,1,0
0,315,315,45,39,6,3,2
24,318,318,3,3,0,1,0
19,344,344,116,116,0,1,0
3,356,356,6,6,0,1,0
15,364,364,93,93,0,1,0
9,390,390,48,22,26,2,1
13,397,397,13,2,11,2,1
21,440,440,82,82,0,1,0
18,473,473,4,4,0,1,0
5,494,494,29,7,22,3,2

15,112,112,4,4,0,1,0
13,114,114,1,1,0,1,0
14,122,122,13,13,0,1,0
17,143,143,37,37,0,1,0
8,150,150,2,2,0,1,0
22,180,180,33,21,12,4,3
21,182,182,15,15,0,1,0
5,190,190,20,2,18,3,2
16,192,192,24,24,0,1,0
26,211,211,34,4,30,3,2
27,252,252,25,25,0,1,0
9,271,271,48,2,46,2,1
29,288,288,1,1,0,1,0
10,289,289,3,3,0,1,0
23,313,313,7,7,0,1,0
6,327,327,44,17,27,2,1
11,343,343,10,2,8,2,1
1,344,344,1,1,0,1,0
12,355,355,52,52,0,1,0
4,360,360,7,7,0,1,0
20,377,377,30,18,12,3,2
25,388,388,17,11,6,2,1
31,409,409,28,28,0,1,0
19,418,418,44,5,39,2,1
0,423,423,32,32,0,1,0
30,424,424,6,6,0,1,0
2,433,433,10,10,0,1,0
3,459,459,10,7,3,2,1
18,469,469,95,50,45,4,3
28,475,475,162,162,0,1,0
24,479,479,11,3,8,3,2
7,481,481,54,54,0,1,0

13,120,120,24,2,22,2,1
8,124,124,8,2,6,3,2
9,124,124,12,4,8,3,2
20,133,133,28,10,18,2,1
23,138,138,15,4,11,2,1
7,161,161,13,13,0,1,0
25,206,206,8,8,0,1,0
12,219,219,10,10,0,1,0
16,234,234,18,10,8,2,1
15,250,250,24,24,0,1,0
10,255,255,3,3,0,1,0
1,260,260,59,24,35,2,1
5,276,276,41,29,12,2,1
19,282,282,4,4,0,1,0
26,296,296,19,9,10,3,2
14,297,297,14,6,8,2,1
17,328,328,38,10,28,2,1
4,336,336,30,6,24,2,1
27,354,354,8,8,0,1,0
3,358,358,18,18,0,1,0
11,360,360,13,1,12,3,2
28,363,363,21,3,18,2,1
6,379,379,4,4,0,1,0
2,383,383,19,19,0,1,0
18,393,393,104,32,72,3,2
21,417,417,3,3,0,1,0
0,427,427,104,104,0,1,0
24,473,473,61,43,18,4,3
22,488,488,111,111,0,1,0

5,100,100,25,3,22,3,2
25,125,125,12,3,9,4,3
3,128,128,22,22,0,1,0
6,157,157,36,36,0,1,0
11,162,162,27,27,0,1,0
9,162,162,21,21,0,1,0
4,199,199,2,2,0,1,0
22,201,201,5,5,0,1,0
16,261,261,7,7,0,1,0
20,290,290,3,3,0,1,0
23,302,302,32,32,0,1,0
7,303,303,37,37,0,1,0
12,318,318,65,1,64,3,2
8,325,325,4,4,0,1,0
18,340,340,20,20,0,1,0
24,360,360,79,4,75,4,3
14,393,393,74,29,45,3,2
13,410,410,72,72,0,1,0
0,410,410,9,9,0,1,0
21,417,417,57,57,0,1,0
17,432,432,15,15,0,1,0
19,451,451,14,14,0,1,0
10,458,458,86,8,78,4,3
1,477,477,37,37,0,1,0
2,485,485,12,8,4,2,1
15,487,487,54,54,0,1,0

19,107,107,3,3,0,1,0
16,110,110,4,1,3,2,1
13,121,121,18,18,0,1,0
21,134,134,8,8,0,1,0
10,137,137,1,1,0,1,0
0,147,147,1,1,0,1,0
26,168,168,31,31,0,1,0
23,168,168,23,4,19,2,1
14,175,175,25,4,21,4,3
25,186,186,7,7,0,1,0
22,192,192,50,50,0,1,0
18,194,194,41,11,30,3,2
6,202,202,39,4,35,2,1
3,210,210,1,1,0,1,0
9,276,276,24,10,14,3,2
15,296,296,3,3,0,1,0
8,354,354,1,1,0,1,0
4,374,374,29,29,0,1,0
12,395,395,98,94,4,2,1
5,397,397,66,20,46,2,1
2,402,402,23,23,0,1,0
7,407,407,38,20,18,2,1
20,409,409,29,15,14,2,1
1,445,445,201,174,27,4,3
11,449,449,2,2,0,1,0
17,464,464,52,21,31,4,3
24,469,469,3,3,0,1,0

0,118,118,6,2,4,2,1
10,121,121,7,7,0,1,0
23,137,137,7,7,0,1,0
19,157,157,27,27,0,1,0
6,240,240,9,9,0,1,0
9,249,249,10,10,0,1,0
11,255,255,5,5,0,1,0
16,270,270,22,22,0,1,0
18,272,272,5,5,0,1,0
7,273,273,18,10,8,2,1
21,296,296,16,2,14,2,1
22,301,301,46,10,36,2,1
26,302,302,59,40,19,2,1
8,305,305,70,70,0,1,0
24,309,309,72,44,28,2,1
17,334,334,8,3,5,2,1
25,359,359,75,63,12,2,1
5,368,368,39,11,28,2,1
1,392,392,6,6,0,1,0
13,412,412,51,51,0,1,0
4,419,419,117,89,28,2,1
2,423,423,2,2,0,1,0
15,450,450,9,9,0,1,0
20,465,465,52,6,46,4,3
27,469,469,43,43,0,1,0
12,474,474,26,22,4,2,1
14,481,481,4,4,0,1,0
3,498,498,157,157,0,1,0

2,130,130,18,9,9,2,1
20,135,135,5,5,0,1,0
18,170,170,17,17,0,1,0
23,182,182,29,29,0,1,0
10,194,194,4,4,0,1,0
3,204,204,1,1,0,1,0
27,205,205,12,12,0,1,0
15,208,208,46,34,12,4,3
0,216,216,38,38,0,1,0
7,229,229,4,4,0,1,0
12,234,234,22,22,0,1,0
21,250,250,40,26,14,2,1
6,277,277,11,5,6,2,1
1,285,285,36,36,0,1,0
30,286,286,22,22,0,1,0
26,301,301,8,8,0,1,0
8,315,315,51,51,0,1,0
24,349,349,42,30,12,3,2
5,350,350,18,15,3,2,1
9,350,350,3,3,0,1,0
11,405,405,21,21,0,1,0
25,424,424,30,30,0,1,0
17,433,433,137,75,62,4,3
14,438,438,1,1,0,1,0
28,445,445,1,1,0,1,0
19,466,466,49,25,24,4,3
29,469,469,4,4,0,1,0
22,477,477,85,85,0,1,0
16,496,496,137,137,0,1,0
4,499,499,4,4,0,1,0
13,500,500,1,1,0,1,0

7,101,101,6,6,0,1,0
26,129,129,22,10,12,2,1
16,131,131,29,29,0,1,0
27,138,138,9,4,5,2,1
10,142,142,68,28,40,3,2
1,152,152,1,1,0,1,0
2,166,166,21,4,17,2,1
17,169,169,12,12,0,1,0
3,186,186,16,1,15,2,1
28,229,229,8,8,0,1,0
8,253,253,2,2,0,1,0
11,262,262,4,4,0,1,0
13,267,267,52,52,0,1,0
12,268,268,19,5,14,3,2
5,282,282,30,27,3,2,1
18,296,296,23,23,0,1,0
21,313,313,41,27,14,3,2
22,327,327,3,3,0,1,0
6,331,331,7,7,0,1,0
9,336,336,4,4,0,1,0
14,351,351,35,35,0,1,0
19,355,355,32,32,0,1,0
23,362,362,45,37,8,3,2
25,368,368,38,12,26,2,1
15,370,370,1,1,0,1,0
24,385,385,99,9,90,4,3
0,420,420,48,48,0,1,0
20,436,436,30,30,0,1,0
4,475,475,1,1,0,1,0

6,100,100,20,20,0,1,0
16,117,117,17,5,12,3,2
2,131,131,5,2,3,2,1
8,138,138,2,2,0,1,0
20,162,162,49,18,31,2,1
21,177,177,22,22,0,1,0
14,182,182,2,2,0,1,0
4,186,186,17,17,0,1,0
19,202,202,6,6,0,1,0
27,206,206,26,26,0,1,0
7,243,243,2,2,0,1,0
28,253,253,1,1,0,1,0
22,270,270,41,41,0,1,0
11,283,283,17,5,12,4,3
0,284,284,36,36,0,1,0
26,292,292,2,2,0,1,0
18,305,305,2,2,0,1,0
24,320,320,59,54,5,2,1
5,325,325,24,12,12,4,3
13,342,342,11,5,6,3,2
31,345,345,65,65,0,1,0
9,361,361,59,16,43,2,1
1,362,362,69,69,0,1,0
15,365,365,43,43,0,1,0
17,403,403,9,9,0,1,0
23,404,404,11,2,9,4,3
3,422,422,32,26,6,3,2
30,453,453,26,20,6,3,2
25,458,458,77,77,0,1,0
12,459,459,3,3,0,1,0
10,492,492,11,11,0,1,0
29,497,497,24,24,0,1,0

24,113,113,8,8,0,1,0
7,114,114,9,9,0,1,0
23,119,119,16,13,3,2,1
11,123,123,15,6,9,4,3
10,133,133,27,10,17,2,1
17,135,135,11,4,7,2,1
3,159,159,26,1,25,2,1
18,192,192,7,7,0,1,0
25,213,213,3,3,0,1,0
20,220,220,47,5,42,3,2
19,229,229,34,34,0,1,0
26,232,232,49,22,27,2,1
30,240,240,7,1,6,2,1
1,264,264,7,7,0,1,0
0,279,279,51,15,36,3,2
21,292,292,7,7,0,1,0
16,304,304,10,10,0,1,0
8,314,314,10,10,0,1,0
27,319,319,48,12,36,4,3
22,339,339,79,73,6,3,2
28,341,341,18,9,9,2,1
15,352,352,17,8,9,2,1
5,363,363,21,21,0,1,0
2,365,365,5,5,0,1,0
14,374,374,72,72,0,1,0
9,376,376,1,1,0,1,0
12,383,383,14,2,12,2,1
31,399,399,26,26,0,1,0
29,425,425,25,25,0,1,0
13,438,438,1,1,0,1,0
4,475,475,4,4,0,1,0
6,496,496,59,59,0,1,0

1,137,137,16,16,0,1,0
4,168,168,13,4,9,2,1
22,206,206,7,7,0,1,0
20,208,208,65,65,0,1,0
16,208,208,9,3,6,3,2
19,210,210,4,4,0,1,0
7,226,226,56,26,30,4,3
12,263,263,43,2,41,2,1
9,265,265,68,45,23,2,1
17,289,289,3,3,0,1,0
10,291,291,22,22,0,1,0
23,332,332,59,11,48,2,1
8,338,338,6,6,0,1,0
11,358,358,63,25,38,3,2
6,360,360,36,36,0,1,0
5,369,369,77,77,0,1,0
24,398,398,3,3,0,1,0
21,407,407,5,5,0,1,0
0,415,415,55,55,0,1,0
13,416,416,34,9,25,2,1
15,436,436,131,61,70,3,2
3,445,445,59,59,0,1,0
14,447,447,9,9,0,1,0
2,482,482,18,18,0,1,0
18,492,492,33,26,7,2,1

22,117,117,4,4,0,1,0
4,121,121,6,3,3,2,1
1,139,139,19,6,13,2,1
0,145,145,7,1,6,2,1
11,145,145,15,7,8,2,1
6,170,170,46,37,9,4,3
14,199,199,5,5,0,1,0
12,213,213,41,1,40,2,1
9,218,218,7,7,0,1,0
29,228,228,41,3,38,3,2
2,246,246,28,28,0,1,0
18,249,249,11,11,0,1,0
15,250,250,19,19,0,1,0
5,261,261,14,5,9,2,1
8,293,293,15,15,0,1,0
20,296,296,110,1,109,4,3
13,298,298,1,1,0,1,0
10,302,302,11,5,6,2,1
30,313,313,4,4,0,1,0
7,318,318,3,3,0,1,0
21,333,333,36,36,0,1,0
25,370,370,21,21,0,1,0
27,371,371,56,4,52,3,2
16,394,394,19,19,0,1,0
26,406,406,54,10,44,3,2
3,421,421,63,63,0,1,0
19,428,428,60,34,26,3,2
24,438,438,36,12,24,3,2
17,443,443,28,1,27,4,3
28,443,443,17,17,0,1,0
23,487,487,4,1,3,2,1

24,108,108,5,5,0,1,0
25,116,116,16,10,6,2,1
22,145,145,26,8,18,3,2
3,166,166,38,26,12,3,2
21,167,167,18,18,0,1,0
7,174,174,10,10,0,1,0
19,192,192,30,18,12,3,2
12,197,197,1,1,0,1,0
4,198,198,26,17,9,4,3
5,217,217,30,30,0,1,0
9,252,252,38,23,15,2,1
16,254,254,30,30,0,1,0
18,275,275,38,14,24,2,1
1,283,283,4,4,0,1,0
14,290,290,35,35,0,1,0
23,301,301,39,39,0,1,0
15,332,332,16,12,4,2,1
17,344,344,15,3,12,2,1
20,347,347,68,68,0,1,0
13,352,352,2,2,0,1,0
2,378,378,18,6,12,2,1
11,390,390,67,39,28,3,2
10,410,410,99,91,8,2,1
6,448,448,4,4,0,1,0
8,449,449,3,3,0,1,0
0,486,486,99,99,0,1,0

1,127,127,21,13,8,3,2
18,142,142,73,73,0,1,0
6,197,197,46,5,41,4,3
3,221,221,8,8,0,1,0
19,222,222,2,2,0,1,0
7,234,234,14,5,9,4,3
5,246,246,61,15,46,2,1
10,262,262,5,1,4,2,1
12,264,264,30,30,0,1,0
13,269,269,10,2,8,3,2
8,296,296,19,8,11,2,1
22,363,363,4,4,0,1,0
15,367,367,1,1,0,1,0
4,385,385,78,8,70,3,2
20,391,391,52,52,0,1,0
0,399,399,61,61,0,1,0
2,419,419,100,76,24,3,2
9,422,422,17,1,16,2,1
16,422,422,16,6,10,3,2
14,472,472,93,93,0,1,0
17,476,476,61,13,48,4,3
11,484,484,55,5,50,3,2
21,484,484,35,4,31,4,3

21,109,109,20,20,0,1,0
4,128,128,2,2,0,1,0
15,137,137,6,6,0,1,0
16,149,149,2,2,0,1,0
13,151,151,33,6,27,2,1
24,157,157,2,2,0,1,0
22,157,157,31,31,0,1,0
20,160,160,4,4,0,1,0
27,160,160,2,2,0,1,0
19,174,174,27,6,21,2,1
3,175,175,2,2,0,1,0
17,186,186,30,24,6,3,2
14,212,212,18,18,0,1,0
6,217,217,8,3,5,2,1
28,221,221,17,17,0,1,0
18,237,237,50,50,0,1,0
29,264,264,14,4,10,3,2
0,264,264,2,2,0,1,0
11,273,273,12,12,0,1,0
25,276,276,7,7,0,1,0
5,288,288,23,17,6,3,2
8,300,300,11,11,0,1,0
9,324,324,144,110,34,3,2
30,339,339,38,17,21,2,1
12,368,368,2,2,0,1,0
7,369,369,46,46,0,1,0
23,389,389,40,14,26,2,1
1,443,443,42,12,30,4,3
2,494,494,26,22,4,2,1
26,496,496,49,29,20,2,1
10,497,497,43,43,0,1,0

7,141,141,1,1,0,1,0
17,164,164,20,20,0,1,0
23,201,201,3,3,0,1,0
13,208,208,34,17,17,2,1
22,213,213,10,10,0,1,0
14,221,221,32,32,0,1,0
8,235,235,13,13,0,1,0
9,239,239,16,16,0,1,0
2,246,246,63,63,0,1,0
6,248,248,7,7,0,1,0
16,254,254,65,45,20,2,1
11,260,260,20,20,0,1,0
19,261,261,3,3,0,1,0
24,266,266,8,8,0,1,0
12,284,284,21,21,0,1,0
10,285,285,1,1,0,1,0
21,306,306,20,9,11,2,1
4,326,326,98,29,69,4,3
3,343,343,161,101,60,3,2
18,396,396,60,37,23,2,1
20,414,414,90,62,28,3,2
5,434,434,43,33,10,3,2
15,443,443,23,3,20,4,3
0,459,459,43,43,0,1,0
1,474,474,10,2,8,2,1

19,100,100,20,17,3,2,1
10,108,108,1,1,0,1,0
16,113,113,13,5,8,3,2
4,117,117,16,4,12,3,2
24,139,139,29,29,0,1,0
14,163,163,1,1,0,1,0
7,179,179,11,1,10,3,2
1,189,189,15,15,0,1,0
11,205,205,23,23,0,1,0
12,255,255,13,13,0,1,0
23,274,274,7,7,0,1,0
9,286,286,13,13,0,1,0
2,296,296,1,1,0,1,0
5,300,300,19,19,0,1,0
0,331,331,169,63,106,4,3
13,372,372,60,60,0,1,0
15,378,378,21,21,0,1,0
22,385,385,16,5,11,2,1
18,407,407,24,14,10,3,2
17,422,422,75,75,0,1,0
21,446,446,21,13,8,3,2
3,451,451,130,130,0,1,0
25,483,483,51,1,50,2,1
6,486,486,4,4,0,1,0
20,488,488,86,29,57,4,3
8,491,491,41,41,0,1,0

22,123,123,1,1,0,1,0
12,138,138,16,11,5,2,1
17,153,153,20,20,0,1,0
11,189,189,34,6,28,2,1
25,190,190,1,1,0,1,0
26,208,208,74,69,5,2,1
13,222,222,33,4,29,2,1
5,234,234,8,8,0,1,0
10,241,241,16,13,3,2,1
24,251,251,31,31,0,1,0
27,255,255,16,16,0,1,0
7,262,262,37,4,33,2,1
9,285,285,46,26,20,3,2
23,291,291,59,59,0,1,0
18,297,297,7,2,5,2,1
14,300,300,39,39,0,1,0
2,302,302,49,15,34,2,1
1,326,326,23,12,11,4,3
4,336,336,14,9,5,2,1
6,343,343,21,11,10,2,1
21,362,362,51,27,24,3,2
0,363,363,29,1,28,3,2
20,368,368,12,3,9,4,3
8,417,417,46,24,22,2,1
19,429,429,7,4,3,2,1
16,455,455,40,2,38,2,1
3,478,478,13,13,0,1,0
15,480,480,55,44,11,2,1

4,115,115,3,3,0,1,0
2,118,118,1,1,0,1,0
18,122,122,23,9,14,3,2
19,125,125,16,16,0,1,0
3,128,128,1,1,0,1,0
30,141,141,3,3,0,1,0
9,159,159,4,1,3,2,1
20,159,159,44,44,0,1,0
26,176,176,21,9,12,4,3
13,179,179,1,1,0,1,0
0,192,192,24,3,21,2,1
5,253,253,35,35,0,1,0
16,259,259,50,50,0,1,0
14,263,263,10,3,7,2,1
24,289,289,45,6,39,2,1
25,303,303,42,12,30,4,3
28,316,316,28,28,0,1,0
27,322,322,19,8,11,2,1
6,324,324,4,4,0,1,0
29,328,328,7,7,0,1,0
8,341,341,30,30,0,1,0
17,347,347,9,2,7,2,1
22,348,348,25,25,0,1,0
21,357,357,2,2,0,1,0
23,375,375,51,29,22,3,2
10,400,400,142,4,138,4,3
1,422,422,1,1,0,1,0
12,444,444,12,12,0,1,0
11,448,448,29,29,0,1,0
7,458,458,126,46,80,3,2
15,467,467,4,4,0,1,0

14,111,111,8,4,4,2,1
19,129,129,8,8,0,1,0
2,152,152,22,2,20,2,1
9,163,163,6,6,0,1,0
8,164,164,24,7,17,2,1
16,197,197,20,20,0,1,0
17,275,275,75,43,32,2,1
18,277,277,73,73,0,1,0
0,287,287,27,27,0,1,0
11,299,299,28,28,0,1,0
10,337,337,75,75,0,1,0
13,338,338,2,2,0,1,0
12,360,360,31,23,8,3,2
4,360,360,19,19,0,1,0
15,377,377,18,18,0,1,0
5,422,422,31,10,21,2,1
21,423,423,2,2,0,1,0
1,430,430,194,194,0,1,0
3,431,431,104,104,0,1,0
20,445,445,7,7,0,1,0
7,475,475,47,47,0,1,0
6,492,492,120,75,45,2,1

10,108,108,5,1,4,2,1
6,124,124,4,4,0,1,0
21,139,139,42,42,0,1,0
8,144,144,3,3,0,1,0
5,154,154,6,6,0,1,0
13,208,208,1,1,0,1,0
27,215,215,38,3,35,2,1
20,224,224,11,3,8,2,1
15,230,230,6,2,4,2,1
17,230,230,80,80,0,1,0
1,266,266,66,66,0,1,0
28,277,277,36,18,18,4,3
9,283,283,5,5,0,1,0
22,284,284,29,29,0,1,0
14,293,293,5,5,0,1,0
16,297,297,2,2,0,1,0
25,298,298,1,1,0,1,0
26,372,372,25,5,20,4,3
18,375,375,8,8,0,1,0
2,384,384,13,13,0,1,0
4,386,386,44,44,0,1,0
12,396,396,57,33,24,4,3
0,402,402,54,46,8,2,1
7,409,409,24,24,0,1,0
24,425,425,3,3,0,1,0
23,431,431,37,37,0,1,0
19,456,456,7,2,5,2,1
3,460,460,25,25,0,1,0
29,481,481,52,15,37,2,1
11,484,484,198,139,59,4,3

23,128,128,3,3,0,1,0
3,137,137,2,2,0,1,0
6,138,138,9,4,5,2,1
15,149,149,17,7,10,3,2
11,181,181,105,60,45,4,3
21,181,181,3,3,0,1,0
4,190,190,1,1,0,1,0
13,191,191,13,13,0,1,0
12,195,195,1,1,0,1,0
26,200,200,3,3,0,1,0
25,206,206,11,3,8,3,2
2,242,242,4,4,0,1,0
20,249,249,12,5,7,2,1
16,250,250,35,35,0,1,0
27,255,255,8,8,0,1,0
1,296,296,4,1,3,2,1
14,351,351,71,71,0,1,0
0,362,362,31,5,26,3,2
7,367,367,74,74,0,1,0
19,381,381,92,33,59,4,3
24,403,403,119,33,86,3,2
10,404,404,19,19,0,1,0
18,423,423,71,24,47,4,3
17,424,424,28,28,0,1,0
22,427,427,6,3,3,2,1
8,435,435,12,4,8,2,1
5,439,439,57,49,8,2,1
9,493,493,70,37,33,4,3

10,105,105,1,1,0,1,0
18,120,120,2,2,0,1,0
7,137,137,16,7,9,2,1
24,161,161,1,1,0,1,0
31,165,165,12,12,0,1,0
11,196,196,18,7,11,2,1
5,211,211,35,35,0,1,0
17,211,211,8,8,0,1,0
9,214,214,23,23,0,1,0
19,222,222,30,30,0,1,0
3,225,225,22,22,0,1,0
30,226,226,14,8,6,2,1
26,240,240,41,4,37,3,2
15,258,258,1,1,0,1,0
22,264,264,7,1,6,2,1
0,265,265,4,4,0,1,0
8,272,272,14,14,0,1,0
27,305,305,18,18,0,1,0
16,345,345,4,1,3,2,1
28,354,354,39,21,18,4,3
1,355,355,83,83,0,1,0
21,380,380,13,13,0,1,0
6,405,405,29,5,24,4,3
29,461,461,11,3,8,3,2
14,467,467,54,54,0,1,0
2,472,472,24,24,0,1,0
23,474,474,121,121,0,1,0
4,478,478,44,30,14,2,1
12,479,479,54,54,0,1,0
25,482,482,201,153,48,4,3
13,493,493,9,9,0,1,0
20,498,498,17,10,7,3,2

29,124,124,31,31,0,1,0
9,125,125,4,4,0,1,0
20,142,142,32,32,0,1,0
25,182,182,7,4,3,2,1
3,185,185,6,6,0,1,0
26,191,191,31,31,0,1,0
19,192,192,23,5,18,4,3
5,202,202,10,10,0,1,0
28,233,233,4,4,0,1,0
18,258,258,5,5,0,1,0
14,265,265,12,1,11,3,2
15,273,273,9,9,0,1,0
2,274,274,19,19,0,1,0
10,306,306,52,30,22,2,1
6,312,312,33,7,26,3,2
17,316,316,4,1,3,2,1
16,333,333,15,15,0,1,0
27,353,353,32,10,22,2,1
23,363,363,72,72,0,1,0
1,370,370,26,6,20,2,1
13,373,373,2,2,0,1,0
21,402,402,58,21,37,2,1
7,411,411,45,11,34,3,2
11,426,426,43,3,40,2,1
0,428,428,119,47,72,4,3
22,442,442,34,6,28,2,1
24,443,443,12,2,10,3,2
12,473,473,40,40,0,1,0
4,477,477,60,60,0,1,0
8,485,485,43,1,42,4,3

3,103,103,7,2,5,2,1
0,118,118,4,1,3,2,1
15,164,164,3,3,0,1,0
17,165,165,3,3,0,1,0
18,169,169,6,6,0,1,0
28,177,177,57,36,21,3,2
22,205,205,14,7,7,2,1
20,205,205,8,2,6,3,2
19,205,205,4,4,0,1,0
13,206,206,22,6,16,3,2
26,224,224,4,4,0,1,0
11,235,235,8,2,6,2,1
23,252,252,74,44,30,3,2
16,269,269,36,13,23,3,2
9,300,300,56,56,0,1,0
12,300,300,17,17,0,1,0
2,305,305,24,24,0,1,0
8,345,345,88,88,0,1,0
10,354,354,2,2,0,1,0
5,371,371,65,47,18,4,3
21,386,386,73,51,22,2,1
6,388,388,26,26,0,1,0
25,394,394,14,14,0,1,0
29,408,408,18,18,0,1,0
7,419,419,88,84,4,2,1
4,449,449,30,30,0,1,0
27,457,457,56,18,38,3,2
14,467,467,14,14,0,1,0
24,480,480,39,17,22,2,1
1,484,484,4,1,3,2,1

23,106,106,29,12,17,2,1
14,124,124,25,16,9,2,1
27,157,157,2,2,0,1,0
4,170,170,3,3,0,1,0
8,172,172,19,4,15,3,2
7,202,202,17,17,0,1,0
28,205,205,62,22,40,2,1
26,215,215,27,27,0,1,0
9,217,217,7,7,0,1,0
5,218,218,30,30,0,1,0
18,258,258,19,19,0,1,0
17,283,283,3,3,0,1,0
15,310,310,16,16,0,1,0
3,324,324,1,1,0,1,0
20,326,326,14,1,13,2,1
21,334,334,39,3,36,2,1
25,336,336,12,12,0,1,0
30,339,339,10,2,8,3,2
12,341,341,15,15,0,1,0
22,343,343,22,22,0,1,0
16,361,361,88,68,20,2,1
10,368,368,96,64,32,3,2
6,382,382,19,14,5,2,1
0,394,394,16,8,8,2,1
2,406,406,2,2,0,1,0
29,435,435,48,26,22,2,1
1,438,438,43,1,42,2,1
11,444,444,8,8,0,1,0
19,470,470,20,6,14,2,1
13,483,483,1,1,0,1,0
24,488,488,92,76,16,3,2

31,105,105,15,15,0,1,0
33,106,106,12,2,10,3,2
2,107,107,1,1,0,1,0
29,146,146,17,1,16,3,2
17,149,149,2,2,0,1,0
1,164,164,6,3,3,2,1
5,165,165,2,2,0,1,0
16,170,170,15,15,0,1,0
26,191,191,19,2,17,2,1
11,192,192,2,2,0,1,0
12,200,200,13,7,6,3,2
8,200,200,8,8,0,1,0
18,203,203,5,5,0,1,0
27,205,205,6,1,5,2,1
23,206,206,23,23,0,1,0
20,232,232,25,11,14,3,2
19,263,263,2,2,0,1,0
0,291,291,23,23,0,1,0
21,306,306,24,24,0,1,0
6,313,313,36,36,0,1,0
15,321,321,37,6,31,2,1
32,324,324,2,2,0,1,0
22,344,344,64,64,0,1,0
10,356,356,41,3,38,3,2
3,361,361,76,39,37,2,1
14,382,382,73,53,20,3,2
13,396,396,1,1,0,1,0
28,403,403,108,49,59,4,3
30,409,409,30,30,0,1,0
7,439,439,69,69,0,1,0
25,453,453,4,1,3,2,1
4,458,458,35,35,0,1,0
24,461,461,40,30,10,3,2
9,489,489,15,1,14,3,2

24,106,106,11,11,0,1,0
6,130,130,11,11,0,1,0
21,135,135,8,3,5,2,1
11,163,163,5,5,0,1,0
16,174,174,49,23,26,2,1
18,176,176,25,13,12,3,2
25,195,195,15,15,0,1,0
22,195,195,4,4,0,1,0
15,200,200,30,24,6,2,1
1,205,205,46,46,0,1,0
27,209,209,16,16,0,1,0
20,215,215,9,9,0,1,0
17,217,217,12,12,0,1,0
26,231,231,9,5,4,2,1
2,241,241,12,12,0,1,0
10,289,289,22,1,21,3,2
4,313,313,46,46,0,1,0
0,328,328,69,23,46,3,2
8,385,385,13,4,9,2,1
19,400,400,108,32,76,4,3
9,431,431,10,10,0,1,0
13,446,446,7,4,3,2,1
3,461,461,104,81,23,2,1
5,473,473,35,35,0,1,0
7,474,474,48,48,0,1,0
23,475,475,51,51,0,1,0
14,497,497,6,6,0,1,0
12,500,500,52,52,0,1,0

9,109,109,9,9,0,1,0
14,112,112,2,2,0,1,0
20,116,116,7,4,3,2,1
17,120,120,15,15,0,1,0
6,134,134,3,3,0,1,0
28,192,192,5,5,0,1,0
16,217,217,22,8,14,3,2
12,226,226,40,28,12,2,1
26,232,232,38,38,0,1,0
11,250,250,23,23,0,1,0
18,258,258,19,2,17,2,1
8,277,277,7,7,0,1,0
3,280,280,24,21,3,2,1
13,304,304,37,37,0,1,0
22,311,311,72,37,35,2,1
27,312,312,14,14,0,1,0
30,316,316,46,46,0,1,0
19,316,316,13,10,3,2,1
24,333,333,62,62,0,1,0
4,334,334,118,76,42,4,3
21,356,356,1,1,0,1,0
5,369,369,22,22,0,1,0
31,381,381,26,26,0,1,0
15,386,386,10,10,0,1,0
25,407,407,29,9,20,2,1
2,410,410,1,1,0,1,0
23,423,423,105,48,57,4,3
10,431,431,13,4,9,4,3
29,435,435,29,5,24,4,3
7,462,462,14,14,0,1,0
1,472,472,19,10,9,2,1
0,495,495,5,1,4,2,1

21,103,103,1,1,0,1,0
18,131,131,5,5,0,1,0
13,148,148,3,3,0,1,0
20,160,160,16,8,8,2,1
14,180,180,15,15,0,1,0
7,184,184,6,6,0,1,0
10,190,190,5,5,0,1,0
26,198,198,10,6,4,2,1
16,199,199,68,54,14,2,1
2,218,218,35,15,20,2,1
11,239,239,37,5,32,3,2
0,241,241,31,8,23,4,3
24,256,256,33,33,0,1,0
25,287,287,9,9,0,1,0
5,324,324,2,2,0,1,0
27,324,324,32,32,0,1,0
12,332,332,3,3,0,1,0
28,339,339,66,57,9,4,3
17,359,359,1,1,0,1,0
22,360,360,6,3,3,2,1
9,373,373,29,11,18,3,2
4,385,385,3,3,0,1,0
1,393,393,54,9,45,4,3
3,395,395,126,126,0,1,0
8,412,412,51,7,44,2,1
23,422,422,136,46,90,4,3
15,475,475,25,4,21,4,3
6,476,476,54,14,40,3,2
19,495,495,23,23,0,1,0

11,124,124,8,8,0,1,0
31,126,126,10,10,0,1,0
1,131,131,28,28,0,1,0
3,133,133,1,1,0,1,0
12,153,153,14,14,0,1,0
24,161,161,31,1,30,4,3
8,164,164,18,6,12,3,2
18,171,171,23,7,16,2,1
9,217,217,25,21,4,2,1
19,228,228,52,52,0,1,0
20,229,229,40,40,0,1,0
25,265,265,7,7,0,1,0
13,278,278,6,6,0,1,0
0,285,285,42,9,33,2,1
6,288,288,12,12,0,1,0
16,299,299,9,2,7,2,1
10,329,329,15,15,0,1,0
4,338,338,2,2,0,1,0
23,343,343,4,4,0,1,0
7,357,357,39,10,29,4,3
21,365,365,4,4,0,1,0
26,379,379,23,9,14,4,3
2,399,399,31,31,0,1,0
5,401,401,29,11,18,3,2
17,407,407,38,38,0,1,0
30,431,431,2,2,0,1,0
22,435,435,9,3,6,3,2
28,443,443,135,135,0,1,0
27,451,451,33,33,0,1,0
15,476,476,65,18,47,2,1
29,476,476,54,54,0,1,0
14,492,492,9,9,0,1,0

1,108,108,5,1,4,2,1
27,109,109,6,6,0,1,0
24,143,143,6,1,5,2,1
12,162,162,37,13,24,4,3
29,172,172,2,2,0,1,0
17,177,177,20,12,8,3,2
5,179,179,8,8,0,1,0
28,213,213,22,22,0,1,0
22,213,213,43,43,0,1,0
11,294,294,1,1,0,1,0
20,296,296,19,1,18,4,3
16,314,314,20,4,16,3,2
25,327,327,74,20,54,3,2
6,338,338,9,9,0,1,0
23,339,339,63,12,51,4,3
4,341,341,3,3,0,1,0
14,354,354,22,12,10,2,1
7,378,378,1,1,0,1,0
3,379,379,129,47,82,3,2
21,379,379,103,103,0,1,0
0,381,381,14,14,0,1,0
18,392,392,3,3,0,1,0
10,395,395,96,33,63,4,3
2,411,411,77,35,42,3,2
19,416,416,6,2,4,2,1
26,432,432,31,12,19,3,2
9,445,445,4,4,0,1,0
13,448,448,40,25,15,2,1
15,483,483,19,19,0,1,0
8,491,491,16,16,0,1,0

29,133,133,14,10,4,2,1
13,147,147,30,16,14,2,1
18,153,153,27,27,0,1,0
30,154,154,8,2,6,2,1
0,159,159,2,2,0,1,0
12,163,163,3,3,0,1,0
7,165,165,1,1,0,1,0
21,202,202,1,1,0,1,0
17,215,215,25,25,0,1,0
2,276,276,36,36,0,1,0
11,285,285,25,25,0,1,0
23,290,290,79,23,56,3,2
27,294,294,8,8,0,1,0
5,295,295,36,24,12,2,1
6,298,298,4,4,0,1,0
24,319,319,66,24,42,3,2
20,320,320,22,22,0,1,0
15,334,334,40,7,33,4,3
25,340,340,11,2,9,4,3
9,345,345,7,7,0,1,0
14,363,363,48,2,46,2,1
26,381,381,5,5,0,1,0
1,397,397,13,13,0,1,0
8,411,411,3,3,0,1,0
4,425,425,113,50,63,4,3
22,433,433,80,80,0,1,0
16,439,439,10,10,0,1,0
3,444,444,19,1,18,2,1
28,449,449,72,66,6,2,1
31,456,456,35,35,0,1,0
10,463,463,21,1,20,3,2
19,468,468,23,23,0,1,0

16,114,114,7,7,0,1,0
26,127,127,7,7,0,1,0
10,139,139,8,2,6,3,2
25,150,150,8,2,6,2,1
28,158,158,17,12,5,2,1
0,165,165,1,1,0,1,0
11,167,167,24,10,14,3,2
19,169,169,2,2,0,1,0
5,174,174,16,16,0,1,0
3,203,203,48,48,0,1,0
7,204,204,13,6,7,2,1
14,214,214,3,3,0,1,0
23,233,233,3,3,0,1,0
9,243,243,60,2,58,4,3
21,244,244,9,9,0,1,0
17,275,275,20,20,0,1,0
20,317,317,94,76,18,4,3
15,320,320,20,20,0,1,0
8,323,323,2,2,0,1,0
24,332,332,36,36,0,1,0
22,355,355,93,6,87,4,3
13,357,357,15,5,10,3,2
2,366,366,18,5,13,2,1
1,372,372,7,1,6,3,2
4,425,425,59,39,20,3,2
12,448,448,74,74,0,1,0
30,452,452,66,66,0,1,0
18,457,457,24,24,0,1,0
27,463,463,18,18,0,1,0
6,480,480,1,1,0,1,0
29,499,499,85,38,47,2,1

25,122,122,38,38,0,1,0
10,129,129,7,7,0,1,0
18,168,168,2,2,0,1,0
4,169,169,44,44,0,1,0
11,171,171,19,7,12,2,1
13,217,217,15,1,14,2,1
17,235,235,11,6,5,2,1
21,238,238,52,52,0,1,0
20,242,242,5,5,0,1,0
24,256,256,33,23,10,3,2
14,261,261,46,46,0,1,0
7,261,261,2,2,0,1,0
19,267,267,15,15,0,1,0
26,271,271,23,23,0,1,0
1,278,278,1,1,0,1,0
23,285,285,8,1,7,2,1
22,303,303,60,60,0,1,0
15,318,318,24,21,3,2,1
27,333,333,9,9,0,1,0
3,333,333,12,12,0,1,0
12,333,333,68,68,0,1,0
6,335,335,45,9,36,3,2
5,380,380,57,26,31,2,1
8,384,384,7,7,0,1,0
16,405,405,18,1,17,3,2
2,407,407,48,48,0,1,0
9,420,420,71,50,21,4,3
0,456,456,30,3,27,4,3

27,102,102,15,15,0,1,0
28,114,114,12,4,8,2,1
16,123,123,2,2,0,1,0
9,124,124,11,11,0,1,0
34,137,137,11,4,7,2,1
4,144,144,11,3,8,2,1
2,151,151,5,2,3,2,1
5,156,156,6,6,0,1,0
24,159,159,40,40,0,1,0
11,179,179,1,1,0,1,0
13,203,203,7,2,5,2,1
12,226,226,29,29,0,1,0
23,226,226,3,3,0,1,0
6,247,247,29,29,0,1,0
22,276,276,40,40,0,1,0
0,285,285,31,31,0,1,0
3,302,302,1,1,0,1,0
8,307,307,48,4,44,2,1
17,314,314,5,5,0,1,0
33,326,326,19,19,0,1,0
29,347,347,10,1,9,2,1
18,356,356,15,15,0,1,0
32,369,369,13,7,6,3,2
15,378,378,20,20,0,1,0
25,401,401,9,9,0,1,0
7,406,406,22,22,0,1,0
21,408,408,21,15,6,3,2
10,418,418,85,85,0,1,0
1,441,441,35,35,0,1,0
19,452,452,8,3,5,2,1
26,453,453,9,9,0,1,0
30,475,475,102,71,31,2,1
20,484,484,14,14,0,1,0
14,495,495,24,4,20,2,1
35,496,496,15,15,0,1,0
31,498,498,136,55,81,4,3

25,106,106,12,12,0,1,0
18,113,113,26,26,0,1,0
16,123,123,11,11,0,1,0
8,139,139,23,11,12,4,3
9,139,139,2,2,0,1,0
24,148,148,11,3,8,3,2
17,178,178,19,19,0,1,0
28,191,191,2,2,0,1,0
0,202,202,12,12,0,1,0
13,215,215,34,34,0,1,0
27,247,247,28,28,0,1,0
29,282,282,10,1,9,2,1
12,293,293,11,2,9,4,3
6,301,301,63,15,48,4,3
5,317,317,17,10,7,2,1
19,323,323,48,6,42,2,1
21,327,327,15,15,0,1,0
4,337,337,33,33,0,1,0
20,356,356,37,37,0,1,0
2,366,366,27,27,0,1,0
7,369,369,30,2,28,4,3
1,415,415,29,21,8,2,1
3,434,434,24,14,10,2,1
23,437,437,64,64,0,1,0
14,445,445,3,3,0,1,0
26,452,452,10,10,0,1,0
10,453,453,15,15,0,1,0
22,468,468,90,22,68,3,2
15,470,470,46,46,0,1,0
30,476,476,41,33,8,3,2
11,498,498,49,31,18,3,2

6,117,117,8,3,5,2,1
12,131,131,19,19,0,1,0
8,133,133,33,17,16,3,2
17,155,155,5,2,3,2,1
7,161,161,4,4,0,1,0
18,162,162,60,60,0,1,0
1,170,170,10,5,5,2,1
11,170,170,11,11,0,1,0
20,176,176,53,9,44,3,2
16,185,185,14,6,8,2,1
14,247,247,7,7,0,1,0
19,325,325,13,13,0,1,0
23,330,330,60,60,0,1,0
2,356,356,25,25,0,1,0
22,360,360,8,8,0,1,0
4,387,387,8,8,0,1,0
26,410,410,29,8,21,2,1
0,418,418,21,9,12,3,2
3,454,454,79,25,54,4,3
10,460,460,180,125,55,3,2
15,473,473,26,2,24,4,3
24,474,474,24,24,0,1,0
13,476,476,3,3,0,1,0
21,482,482,18,18,0,1,0
25,485,485,77,38,39,4,3
5,494,494,24,16,8,3,2
9,497,497,21,5,16,2,1

7,111,111,15,15,0,1,0
5,122,122,5,5,0,1,0
15,138,138,4,4,0,1,0
22,145,145,21,7,14,2,1
2,160,160,3,3,0,1,0
29,165,165,6,6,0,1,0
23,180,180,8,2,6,2,1
1,204,204,74,50,24,3,2
4,205,205,24,6,18,4,3
11,205,205,8,8,0,1,0
14,208,208,8,1,7,2,1
30,224,224,2,2,0,1,0
16,240,240,16,7,9,2,1
25,260,260,2,2,0,1,0
18,272,272,79,22,57,4,3
6,274,274,45,45,0,1,0
9,276,276,7,7,0,1,0
31,280,280,3,3,0,1,0
8,300,300,21,6,15,2,1
24,303,303,26,26,0,1,0
17,315,315,2,2,0,1,0
28,316,316,73,65,8,3,2
3,340,340,7,7,0,1,0
19,343,343,50,5,45,2,1
21,355,355,14,10,4,2,1
10,368,368,67,61,6,2,1
12,372,372,4,4,0,1,0
20,411,411,25,8,17,3,2
26,414,414,61,43,18,2,1
27,415,415,76,12,64,3,2
0,427,427,10,3,7,2,1
13,456,456,23,23,0,1,0

4,100,100,1,1,0,1,0
15,104,104,10,3,7,2,1
9,122,122,19,11,8,3,2
24,131,131,16,16,0,1,0
0,154,154,34,34,0,1,0
12,175,175,33,22,11,3,2
6,179,179,44,44,0,1,0
11,188,188,49,49,0,1,0
22,192,192,3,3,0,1,0
3,223,223,5,5,0,1,0
14,242,242,15,5,10,3,2
13,261,261,27,1,26,4,3
1,264,264,18,18,0,1,0
20,290,290,46,46,0,1,0
21,309,309,13,13,0,1,0
2,331,331,127,19,108,4,3
19,387,387,36,36,0,1,0
16,399,399,39,6,33,4,3
18,422,422,15,3,12,3,2
5,430,430,15,6,9,2,1
23,431,431,58,31,27,2,1
17,448,448,7,7,0,1,0
7,469,469,40,40,0,1,0
8,477,477,1,1,0,1,0
10,492,492,85,66,19,4,3

12,101,101,3,3,0,1,0
30,146,146,11,11,0,1,0
15,153,153,1,1,0,1,0
26,192,192,3,3,0,1,0
19,193,193,2,2,0,1,0
7,204,204,15,15,0,1,0
10,223,223,45,29,16,3,2
2,242,242,8,2,6,2,1
16,252,252,91,68,23,2,1
8,257,257,25,25,0,1,0
17,264,264,12,3,9,3,2
13,277,277,8,5,3,2,1
28,281,281,17,17,0,1,0
23,299,299,17,5,12,2,1
5,303,303,27,27,0,1,0
21,323,323,51,18,33,4,3
6,335,335,15,3,12,2,1
4,348,348,30,30,0,1,0
18,350,350,61,23,38,4,3
25,367,367,98,54,44,3,2
29,370,370,8,8,0,1,0
14,385,385,2,2,0,1,0
22,398,398,18,4,14,4,3
11,406,406,12,12,0,1,0
0,411,411,2,2,0,1,0
20,424,424,193,61,132,4,3
27,424,424,14,4,10,3,2
9,450,450,8,4,4,2,1
3,452,452,13,13,0,1,0
1,454,454,99,31,68,3,2
31,460,460,11,11,0,1,0
24,474,474,16,6,10,2,1

8,105,105,20,20,0,1,0
21,106,106,8,2,6,3,2
5,136,136,10,3,7,2,1
10,158,158,4,4,0,1,0
2,173,173,24,21,3,2,1
15,197,197,18,12,6,3,2
7,213,213,66,24,42,4,3
22,238,238,16,4,12,3,2
1,246,246,5,5,0,1,0
12,247,247,14,14,0,1,0
14,248,248,13,13,0,1,0
20,249,249,27,27,0,1,0
6,281,281,34,22,12,3,2
23,293,293,7,7,0,1,0
4,316,316,97,43,54,4,3
9,342,342,1,1,0,1,0
25,358,358,81,66,15,4,3
16,366,366,10,10,0,1,0
17,369,369,29,5,24,4,3
11,380,380,1,1,0,1,0
3,401,401,3,3,0,1,0
19,414,414,56,35,21,4,3
13,424,424,16,16,0,1,0
0,474,474,96,48,48,3,2
18,488,488,145,68,77,4,3
24,488,488,73,42,31,2,1

18,124,124,35,15,20,2,1
10,132,132,10,10,0,1,0
6,153,153,11,4,7,2,1
12,157,157,4,1,3,2,1
5,158,158,32,12,20,2,1
17,164,164,27,5,22,3,2
24,175,175,8,8,0,1,0
23,253,253,4,4,0,1,0
13,261,261,16,4,12,2,1
11,261,261,63,63,0,1,0
15,265,265,12,12,0,1,0
4,275,275,77,77,0,1,0
14,289,289,24,24,0,1,0
21,298,298,32,10,22,3,2
25,304,304,6,6,0,1,0
0,324,324,14,14,0,1,0
7,348,348,37,37,0,1,0
22,356,356,61,61,0,1,0
20,372,372,117,96,21,2,1
9,374,374,39,5,34,2,1
16,393,393,21,7,14,2,1
19,420,420,17,17,0,1,0
3,428,428,15,7,8,3,2
1,452,452,28,28,0,1,0
8,460,460,81,33,48,4,3
2,486,486,1,1,0,1,0

15,112,112,7,7,0,1,0
8,153,153,10,10,0,1,0
14,154,154,48,48,0,1,0
29,158,158,37,37,0,1,0
26,200,200,11,1,10,2,1
21,202,202,37,17,20,3,2
3,216,216,23,2,21,4,3
7,227,227,18,14,4,2,1
13,228,228,42,34,8,3,2
9,244,244,6,6,0,1,0
23,263,263,16,16,0,1,0
12,279,279,6,6,0,1,0
25,283,283,9,9,0,1,0
27,291,291,4,4,0,1,0
4,310,310,17,9,8,2,1
28,335,335,28,5,23,4,3
5,336,336,14,14,0,1,0
22,341,341,8,8,0,1,0
20,352,352,77,62,15,4,3
16,365,365,35,35,0,1,0
11,368,368,27,5,22,2,1
0,371,371,50,50,0,1,0
1,372,372,1,1,0,1,0
6,375,375,21,21,0,1,0
17,408,408,116,76,40,3,2
18,426,426,2,2,0,1,0
10,468,468,5,5,0,1,0
19,471,471,27,27,0,1,0
2,488,488,84,53,31,2,1
24,491,491,39,5,34,2,1

10,101,101,1,1,0,1,0
12,104,104,3,3,0,1,0
23,111,111,15,7,8,3,2
6,113,113,8,8,0,1,0
11,128,128,11,11,0,1,0
7,150,150,1,1,0,1,0
20,162,162,30,24,6,2,1
17,183,183,1,1,0,1,0
2,183,183,4,4,0,1,0
4,193,193,18,12,6,2,1
9,201,201,42,1,41,4,3
22,203,203,48,48,0,1,0
14,249,249,39,39,0,1,0
18,274,274,11,7,4,2,1
8,298,298,96,21,75,4,3
3,300,300,85,68,17,2,1
5,324,324,57,57,0,1,0
1,361,361,57,20,37,3,2
15,365,365,25,25,0,1,0
19,424,424,60,30,30,4,3
21,459,459,66,66,0,1,0
13,469,469,14,4,10,3,2
0,485,485,28,28,0,1,0
16,485,485,1,1,0,1,0
24,500,500,80,80,0,1,0

5,106,106,4,4,0,1,0
15,123,123,10,6,4,2,1
7,176,176,47,47,0,1,0
14,221,221,24,24,0,1,0
20,228,228,27,27,0,1,0
17,240,240,1,1,0,1,0
22,271,271,16,1,15,4,3
10,281,281,15,15,0,1,0
23,301,301,8,8,0,1,0
6,303,303,51,14,37,2,1
3,304,304,14,14,0,1,0
4,327,327,86,47,39,4,3
24,336,336,18,18,0,1,0
0,361,361,78,2,76,3,2
16,375,375,128,42,86,4,3
21,379,379,91,53,38,2,1
12,380,380,47,17,30,4,3
8,389,389,32,8,24,4,3
2,389,389,29,29,0,1,0
1,398,398,59,38,21,4,3
9,417,417,19,1,18,2,1
19,432,432,8,3,5,2,1
18,452,452,72,42,30,3,2
11,457,457,37,37,0,1,0
13,476,476,1,1,0,1,0

12,109,109,23,14,9,2,1
8,130,130,1,1,0,1,0
14,142,142,8,8,0,1,0
3,147,147,29,1,28,2,1
7,171,171,47,39,8,3,2
21,175,175,8,5,3,2,1
2,179,179,1,1,0,1,0
17,186,186,8,3,5,2,1
29,197,197,7,7,0,1,0
20,223,223,23,11,12,4,3
1,225,225,15,15,0,1,0
28,250,250,31,23,8,3,2
27,250,250,47,4,43,2,1
23,258,258,27,9,18,3,2
26,262,262,2,2,0,1,0
0,301,301,43,43,0,1,0
13,330,330,14,14,0,1,0
4,337,337,22,14,8,2,1
11,340,340,44,16,28,4,3
10,350,350,3,3,0,1,0
15,356,356,44,37,7,2,1
19,360,360,44,44,0,1,0
18,377,377,88,27,61,4,3
22,378,378,2,2,0,1,0
5,382,382,12,6,6,2,1
9,435,435,1,1,0,1,0
25,446,446,49,4,45,4,3
6,449,449,16,16,0,1,0
24,461,461,34,23,11,2,1
16,493,493,114,96,18,4,3

19,119,119,10,10,0,1,0
12,121,121,5,5,0,1,0
9,136,136,9,9,0,1,0
0,142,142,28,4,24,2,1
5,142,142,3,3,0,1,0
16,166,166,29,8,21,2,1
2,185,185,22,22,0,1,0
22,199,199,54,12,42,4,3
17,234,234,81,48,33,4,3
14,262,262,9,9,0,1,0
11,271,271,1,1,0,1,0
20,288,288,7,1,6,3,2
8,290,290,45,27,18,3,2
4,334,334,61,20,41,2,1
13,338,338,1,1,0,1,0
23,359,359,35,23,12,3,2
15,360,360,30,11,19,3,2
1,377,377,49,4,45,2,1
18,379,379,30,2,28,2,1
3,390,390,25,25,0,1,0
21,421,421,5,5,0,1,0
7,437,437,132,82,50,3,2
6,464,464,78,68,10,3,2
10,491,491,89,89,0,1,0

10,131,131,10,10,0,1,0
22,148,148,4,4,0,1,0
9,151,151,6,6,0,1,0
14,161,161,10,10,0,1,0
18,171,171,46,12,34,2,1
2,189,189,12,7,5,2,1
26,189,189,18,5,13,3,2
13,198,198,36,36,0,1,0
12,221,221,1,1,0,1,0
4,225,225,51,51,0,1,0
0,254,254,1,1,0,1,0
7,282,282,41,41,0,1,0
15,290,290,30,15,15,4,3
21,293,293,37,6,31,2,1
27,330,330,13,13,0,1,0
11,330,330,16,6,10,3,2
20,330,330,15,15,0,1,0
1,344,344,91,83,8,3,2
16,351,351,101,101,0,1,0
6,369,369,22,22,0,1,0
19,375,375,20,16,4,2,1
23,394,394,7,7,0,1,0
28,416,416,51,12,39,4,3
17,426,426,39,39,0,1,0
3,429,429,40,40,0,1,0
8,434,434,14,1,13,3,2
5,445,445,45,33,12,2,1
24,490,490,12,5,7,2,1
25,495,495,58,26,32,2,1

15,100,100,41,41,0,1,0
12,107,107,3,3,0,1,0
21,120,120,3,3,0,1,0
23,147,147,14,14,0,1,0
20,147,147,32,22,10,2,1
14,168,168,11,5,6,2,1
18,176,176,22,4,18,4,3
11,188,188,10,10,0,1,0
24,196,196,43,13,30,2,1
17,197,197,6,6,0,1,0
2,207,207,11,11,0,1,0
10,215,215,35,35,0,1,0
9,241,241,37,37,0,1,0
16,242,242,21,5,16,2,1
8,293,293,37,1,36,3,2
3,335,335,36,36,0,1,0
7,340,340,68,68,0,1,0
13,360,360,8,2,6,2,1
0,402,402,104,8,96,4,3
5,405,405,44,44,0,1,0
4,408,408,8,5,3,2,1
1,429,429,63,55,8,3,2
22,433,433,28,28,0,1,0
6,437,437,29,29,0,1,0
19,442,442,1,1,0,1,0

14,102,102,2,2,0,1,0
21,154,154,6,6,0,1,0
1,181,181,60,3,57,4,3
0,201,201,6,6,0,1,0
12,207,207,20,20,0,1,0
8,211,211,21,21,0,1,0
18,229,229,17,17,0,1,0
23,233,233,27,5,22,2,1
24,261,261,12,3,9,2,1
7,263,263,14,8,6,2,1
6,269,269,92,3,89,3,2
3,275,275,29,29,0,1,0
2,279,279,13,13,0,1,0
25,282,282,89,29,60,4,3
26,295,295,17,6,11,2,1
19,339,339,12,12,0,1,0
5,342,342,61,61,0,1,0
11,377,377,10,1,9,2,1
22,378,378,59,42,17,2,1
13,410,410,25,16,9,2,1
17,421,421,51,5,46,3,2
10,434,434,12,12,0,1,0
9,438,438,2,2,0,1,0
15,454,454,15,5,10,2,1
20,464,464,108,60,48,4,3
4,485,485,29,22,7,2,1
16,500,500,55,5,50,3,2

1,101,101,1,1,0,1,0
13,107,107,12,2,10,3,2
7,126,126,30,30,0,1,0
2,136,136,26,1,25,3,2
20,152,152,4,4,0,1,0
25,155,155,9,9,0,1,0
14,156,156,17,10,7,2,1
23,178,178,6,6,0,1,0
15,185,185,30,30,0,1,0
21,206,206,22,5,17,2,1
19,235,235,47,30,17,2,1
22,282,282,49,49,0,1,0
27,304,304,15,3,12,2,1
8,336,336,9,9,0,1,0
10,344,344,11,11,0,1,0
24,352,352,67,15,52,3,2
4,371,371,27,19,8,3,2
16,375,375,10,10,0,1,0
3,393,393,31,31,0,1,0
9,394,394,4,4,0,1,0
28,399,399,12,5,7,2,1
12,409,409,91,17,74,3,2
18,415,415,34,34,0,1,0
6,439,439,24,16,8,3,2
26,442,442,20,20,0,1,0
11,474,474,20,2,18,4,3
5,486,486,14,1,13,2,1
0,491,491,85,5,80,3,2
17,496,496,120,30,90,4,3

1,110,110,13,5,8,2,1
0,117,117,15,15,0,1,0
17,136,136,35,5,30,4,3
14,185,185,11,11,0,1,0
2,195,195,1,1,0,1,0
22,204,204,10,10,0,1,0
25,247,247,26,2,24,3,2
23,252,252,1,1,0,1,0
21,267,267,14,5,9,4,3
10,273,273,8,8,0,1,0
16,282,282,21,1,20,2,1
4,286,286,162,92,70,4,3
15,315,315,3,3,0,1,0
11,332,332,24,20,4,2,1
24,349,349,48,48,0,1,0
12,351,351,33,1,32,3,2
5,351,351,21,21,0,1,0
7,377,377,3,3,0,1,0
18,386,386,95,76,19,2,1
20,421,421,87,87,0,1,0
8,449,449,56,56,0,1,0
9,457,457,45,35,10,3,2
3,471,471,29,2,27,4,3
13,477,477,38,38,0,1,0
19,478,478,23,23,0,1,0
6,496,496,64,64,0,1,0

25,115,115,15,15,0,1,0
9,141,141,8,8,0,1,0
19,163,163,2,2,0,1,0
2,178,178,7,2,5,2,1
0,203,203,78,78,0,1,0
13,205,205,9,3,6,2,1
21,216,216,2,2,0,1,0
28,230,230,6,6,0,1,0
18,234,234,1,1,0,1,0
4,246,246,72,14,58,3,2
27,263,263,32,1,31,2,1
1,266,266,17,17,0,1,0
11,272,272,54,12,42,2,1
6,289,289,31,31,0,1,0
26,307,307,6,6,0,1,0
10,313,313,11,3,8,3,2
23,313,313,43,28,15,2,1
24,315,315,40,7,33,4,3
5,351,351,7,7,0,1,0
3,358,358,34,19,15,4,3
22,390,390,25,2,23,2,1
14,391,391,1,1,0,1,0
12,404,404,5,5,0,1,0
16,417,417,60,14,46,3,2
7,417,417,6,3,3,2,1
20,453,453,202,202,0,1,0
8,458,458,16,16,0,1,0
17,481,481,2,2,0,1,0
15,483,483,88,34,54,3,2

10,126,126,6,2,4,2,1
5,141,141,6,6,0,1,0
8,142,142,6,2,4,2,1
21,143,143,38,38,0,1,0
0,168,168,58,28,30,2,1
26,172,172,6,6,0,1,0
19,174,174,24,13,11,2,1
13,176,176,12,8,4,2,1
4,215,215,29,20,9,4,3
12,222,222,5,2,3,2,1
6,231,231,15,3,12,2,1
28,237,237,21,1,20,4,3
18,257,257,2,2,0,1,0
23,258,258,12,12,0,1,0
15,271,271,41,26,15,2,1
30,303,303,129,111,18,2,1
9,316,316,12,8,4,2,1
24,348,348,27,9,18,4,3
2,351,351,44,44,0,1,0
22,382,382,22,22,0,1,0
31,384,384,10,10,0,1,0
3,385,385,1,1,0,1,0
7,395,395,4,4,0,1,0
27,399,399,22,5,17,2,1
11,421,421,3,3,0,1,0
16,425,425,21,21,0,1,0
14,431,431,28,3,25,2,1
1,431,431,33,33,0,1,0
17,449,449,48,34,14,2,1
29,451,451,81,77,4,2,1
25,462,462,7,7,0,1,0
20,471,471,2,2,0,1,0

29,104,104,8,8,0,1,0
10,142,142,33,33,0,1,0
3,157,157,2,2,0,1,0
12,164,164,18,10,8,3,2
30,170,170,6,6,0,1,0
14,185,185,1,1,0,1,0
5,205,205,4,4,0,1,0
22,227,227,4,4,0,1,0
1,236,236,1,1,0,1,0
0,248,248,8,4,4,2,1
33,252,252,43,21,22,2,1
16,268,268,24,24,0,1,0
19,269,269,34,2,32,3,2
25,289,289,14,2,12,3,2
6,294,294,32,16,16,3,2
28,301,301,39,30,9,2,1
7,302,302,16,16,0,1,0
17,303,303,25,3,22,2,1
26,329,329,55,55,0,1,0
27,330,330,41,41,0,1,0
18,341,341,38,22,16,2,1
9,343,343,14,14,0,1,0
13,359,359,21,9,12,4,3
15,369,369,19,7,12,2,1
4,374,374,6,2,4,2,1
20,383,383,14,14,0,1,0
32,401,401,40,24,16,3,2
11,423,423,5,2,3,2,1
23,424,424,60,44,16,2,1
21,428,428,81,69,12,3,2
24,443,443,63,63,0,1,0
31,464,464,22,11,11,4,3
2,471,471,78,78,0,1,0
8,483,483,34,10,24,3,2

11,102,102,22,13,9,2,1
2,104,104,22,18,4,2,1
18,109,109,11,11,0,1,0
15,116,116,6,6,0,1,0
10,134,134,9,3,6,2,1
4,143,143,5,5,0,1,0
19,146,146,30,10,20,4,3
17,164,164,18,18,0,1,0
1,166,166,33,1,32,3,2
3,180,180,10,4,6,2,1
9,227,227,1,1,0,1,0
5,256,256,73,73,0,1,0
0,311,311,21,21,0,1,0
6,352,352,64,37,27,4,3
21,360,360,38,38,0,1,0
12,395,395,74,52,22,3,2
13,410,410,8,8,0,1,0
7,424,424,155,155,0,1,0
20,436,436,12,4,8,3,2
14,463,463,29,29,0,1,0
16,497,497,111,75,36,3,2
8,499,499,25,8,17,2,1

27,102,102,33,33,0,1,0
25,115,115,25,25,0,1,0
2,154,154,19,1,18,4,3
3,157,157,22,22,0,1,0
13,173,173,24,12,12,2,1
17,177,177,22,22,0,1,0
11,185,185,7,3,4,2,1
19,198,198,11,11,0,1,0
16,212,212,5,2,3,2,1
7,226,226,19,4,15,4,3
22,231,231,8,2,6,2,1
4,242,242,5,2,3,2,1
20,248,248,30,30,0,1,0
24,286,286,42,42,0,1,0
18,295,295,1,1,0,1,0
12,297,297,2,2,0,1,0
6,297,297,38,30,8,2,1
8,315,315,1,1,0,1,0
14,319,319,4,4,0,1,0
15,321,321,8,8,0,1,0
0,331,331,17,17,0,1,0
5,332,332,36,8,28,3,2
21,333,333,4,1,3,2,1
10,349,349,1,1,0,1,0
1,351,351,180,175,5,2,1
9,369,369,16,16,0,1,0
23,463,463,63,44,19,2,1
26,488,488,94,44,50,2,1

3,100,100,1,1,0,1,0
22,108,108,5,5,0,1,0
11,114,114,8,8,0,1,0
26,132,132,4,1,3,2,1
25,153,153,2,2,0,1,0
2,154,154,9,9,0,1,0
29,182,182,38,38,0,1,0
24,206,206,16,16,0,1,0
30,226,226,3,3,0,1,0
12,228,228,5,5,0,1,0
13,237,237,20,12,8,3,2
6,244,244,14,14,0,1,0
4,248,248,25,25,0,1,0
28,255,255,8,4,4,2,1
27,257,257,59,8,51,4,3
0,313,313,4,4,0,1,0
17,325,325,77,77,0,1,0
5,329,329,12,12,0,1,0
18,331,331,10,10,0,1,0
1,362,362,57,57,0,1,0
15,377,377,60,12,48,4,3
19,377,377,57,57,0,1,0
23,382,382,54,54,0,1,0
20,432,432,90,36,54,4,3
14,438,438,8,4,4,2,1
16,452,452,84,38,46,2,1
7,454,454,44,44,0,1,0
9,461,461,19,3,16,2,1
10,470,470,100,74,26,2,1
21,474,474,4,4,0,1,0
8,488,488,38,24,14,3,2

16,114,114,9,1,8,2,1
21,137,137,8,8,0,1,0
6,149,149,13,8,5,2,1
8,161,161,20,20,0,1,0
15,174,174,8,8,0,1,0
9,184,184,26,26,0,1,0
19,193,193,5,5,0,1,0
7,238,238,39,39,0,1,0
13,244,244,1,1,0,1,0
5,271,271,25,25,0,1,0
1,276,276,35,9,26,2,1
10,322,322,48,45,3,2,1
2,324,324,114,114,0,1,0
23,328,328,10,2,8,3,2
12,349,349,148,97,51,4,3
18,371,371,74,17,57,4,3
4,390,390,8,8,0,1,0
22,393,393,19,19,0,1,0
11,399,399,41,41,0,1,0
20,402,402,35,35,0,1,0
3,408,408,57,57,0,1,0
14,416,416,44,7,37,2,1
17,452,452,25,25,0,1,0
0,494,494,77,36,41,3,2

0,108,108,19,19,0,1,0
13,124,124,20,20,0,1,0
15,127,127,8,8,0,1,0
25,128,128,3,3,0,1,0
23,131,131,42,15,27,4,3
14,135,135,7,7,0,1,0
3,138,138,36,28,8,3,2
11,142,142,1,1,0,1,0
17,147,147,48,21,27,4,3
24,156,156,5,5,0,1,0
20,159,159,13,13,0,1,0
9,181,181,17,5,12,2,1
18,197,197,4,4,0,1,0
7,243,243,8,2,6,3,2
6,275,275,48,48,0,1,0
19,296,296,28,28,0,1,0
8,299,299,34,13,21,4,3
22,305,305,26,26,0,1,0
27,317,317,33,33,0,1,0
12,341,341,40,12,28,3,2
26,373,373,55,20,35,2,1
10,375,375,18,5,13,4,3
1,379,379,24,7,17,4,3
5,393,393,13,4,9,4,3
21,420,420,19,11,8,3,2
4,483,483,13,3,10,2,1
16,487,487,20,10,10,2,1
2,496,496,46,46,0,1,0

4,106,106,7,7,0,1,0
14,109,109,1,1,0,1,0
26,131,131,14,14,0,1,0
1,151,151,35,22,13,2,1
23,159,159,4,4,0,1,0
3,160,160,10,2,8,2,1
18,178,178,7,7,0,1,0
2,203,203,18,18,0,1,0
13,223,223,8,8,0,1,0
25,235,235,93,87,6,3,2
21,264,264,20,10,10,2,1
9,278,278,80,31,49,2,1
19,304,304,37,25,12,4,3
5,323,323,21,21,0,1,0
27,324,324,59,55,4,2,1
8,368,368,3,3,0,1,0
12,370,370,17,17,0,1,0
10,380,380,43,13,30,2,1
22,387,387,16,16,0,1,0
20,391,391,61,61,0,1,0
15,395,395,61,43,18,3,2
6,418,418,13,13,0,1,0
17,423,423,3,3,0,1,0
7,429,429,54,36,18,4,3
16,437,437,17,17,0,1,0
0,466,466,9,9,0,1,0
11,472,472,105,48,57,4,3
24,484,484,37,28,9,2,1

7,119,119,1,1,0,1,0
3,129,129,3,3,0,1,0
13,129,129,45,12,33,3,2
18,139,139,11,11,0,1,0
14,145,145,30,23,7,2,1
24,195,195,27,1,26,2,1
9,202,202,24,11,13,2,1
11,207,207,19,19,0,1,0
2,258,258,7,4,3,2,1
6,270,270,57,57,0,1,0
1,293,293,15,15,0,1,0
10,306,306,118,28,90,3,2
5,310,310,80,14,66,4,3
22,329,329,54,20,34,2,1
12,338,338,7,7,0,1,0
21,347,347,10,10,0,1,0
19,349,349,68,7,61,3,2
23,352,352,3,3,0,1,0
20,404,404,15,15,0,1,0
0,406,406,99,99,0,1,0
8,430,430,21,21,0,1,0
4,454,454,12,6,6,3,2
17,478,478,3,3,0,1,0
16,483,483,42,12,30,4,3
15,493,493,7,7,0,1,0

2,110,110,8,8,0,1,0
19,139,139,31,4,27,2,1
20,155,155,8,8,0,1,0
25,169,169,10,10,0,1,0
15,218,218,35,35,0,1,0
11,229,229,3,3,0,1,0
6,267,267,10,10,0,1,0
0,295,295,17,17,0,1,0
10,315,315,49,25,24,4,3
12,341,341,17,17,0,1,0
9,341,341,31,31,0,1,0
8,359,359,65,65,0,1,0
24,366,366,38,38,0,1,0
14,372,372,24,24,0,1,0
16,374,374,3,3,0,1,0
21,377,377,130,59,71,4,3
7,403,403,138,105,33,3,2
5,421,421,20,5,15,2,1
23,434,434,22,22,0,1,0
18,441,441,12,2,10,2,1
22,448,448,11,7,4,2,1
1,451,451,133,133,0,1,0
17,454,454,87,87,0,1,0
3,463,463,46,46,0,1,0
13,473,473,30,30,0,1,0
4,480,480,4,4,0,1,0

13,105,105,9,9,0,1,0
0,107,107,4,1,3,2,1
18,120,120,5,2,3,2,1
22,127,127,10,10,0,1,0
6,132,132,2,2,0,1,0
4,137,137,47,12,35,2,1
2,144,144,1,1,0,1,0
17,159,159,7,7,0,1,0
14,161,161,9,9,0,1,0
3,196,196,1,1,0,1,0
12,201,201,11,11,0,1,0
5,204,204,34,9,25,3,2
16,220,220,5,5,0,1,0
29,261,261,12,9,3,2,1
27,269,269,7,7,0,1,0
15,282,282,6,6,0,1,0
7,289,289,11,11,0,1,0
20,294,294,81,69,12,4,3
1,296,296,74,44,30,3,2
8,308,308,51,51,0,1,0
26,328,328,1,1,0,1,0
19,340,340,38,38,0,1,0
9,344,344,11,11,0,1,0
28,366,366,28,28,0,1,0
11,382,382,36,31,5,2,1
23,413,413,14,9,5,2,1
10,417,417,3,3,0,1,0
30,419,419,55,55,0,1,0
24,445,445,24,24,0,1,0
25,454,454,156,156,0,1,0
21,454,454,71,31,40,2,1

25,103,103,25,25,0,1,0
2,126,126,4,4,0,1,0
7,132,132,18,3,15,4,3
18,133,133,3,3,0,1,0
21,150,150,8,2,6,2,1
27,211,211,38,30,8,2,1
17,226,226,26,2,24,2,1
0,235,235,6,6,0,1,0
20,243,243,42,18,24,4,3
11,245,245,20,3,17,3,2
9,255,255,5,5,0,1,0
10,257,257,17,17,0,1,0
15,269,269,3,3,0,1,0
5,296,296,20,4,16,4,3
8,313,313,7,7,0,1,0
24,324,324,54,24,30,3,2
19,327,327,41,41,0,1,0
14,339,339,164,35,129,4,3
1,353,353,13,13,0,1,0
23,364,364,22,10,12,3,2
29,366,366,8,2,6,2,1
26,386,386,6,1,5,2,1
16,425,425,28,12,16,3,2
3,436,436,22,14,8,2,1
6,448,448,55,38,17,2,1
4,478,478,7,4,3,2,1
12,480,480,76,19,57,4,3
28,480,480,27,12,15,2,1
13,481,481,35,3,32,2,1
22,491,491,61,51,10,2,1

19,107,107,20,4,16,4,3
12,116,116,2,2,0,1,0
6,124,124,27,4,23,3,2
11,140,140,5,5,0,1,0
14,147,147,1,1,0,1,0
22,152,152,40,8,32,3,2
10,181,181,3,3,0,1,0
8,197,197,41,41,0,1,0
21,206,206,23,23,0,1,0
16,223,223,5,5,0,1,0
17,232,232,7,7,0,1,0
7,255,255,19,19,0,1,0
1,258,258,43,13,30,4,3
2,261,261,30,21,9,2,1
0,341,341,16,16,0,1,0
20,356,356,32,32,0,1,0
3,366,366,105,87,18,4,3
23,378,378,1,1,0,1,0
18,427,427,85,85,0,1,0
5,441,441,76,76,0,1,0
4,456,456,39,39,0,1,0
13,471,471,51,51,0,1,0
9,488,488,13,13,0,1,0
15,492,492,166,166,0,1,0

28,130,130,8,8,0,1,0
12,142,142,20,20,0,1,0
24,160,160,33,21,12,2,1
27,163,163,35,8,27,4,3
17,167,167,8,8,0,1,0
23,170,170,3,3,0,1,0
2,181,181,10,10,0,1,0
1,199,199,7,4,3,2,1
16,230,230,27,15,12,2,1
20,251,251,7,7,0,1,0
29,278,278,6,6,0,1,0
30,280,280,43,1,42,3,2
25,280,280,53,7,46,2,1
18,285,285,18,8,10,2,1
8,320,320,1,1,0,1,0
3,351,351,38,38,0,1,0
26,374,374,59,59,0,1,0
22,378,378,15,3,12,3,2
14,380,380,1,1,0,1,0
7,393,393,52,35,17,2,1
13,401,401,33,33,0,1,0
4,405,405,1,1,0,1,0
6,408,408,11,11,0,1,0
15,409,409,42,14,28,2,1
5,424,424,41,7,34,2,1
10,429,429,60,60,0,1,0
0,432,432,36,36,0,1,0
11,442,442,69,17,52,3,2
9,485,485,57,18,39,4,3
21,492,492,80,12,68,3,2
19,495,495,33,13,20,2,1

1,103,103,17,7,10,2,1
15,108,108,15,15,0,1,0
6,125,125,2,2,0,1,0
23,126,126,45,45,0,1,0
4,139,139,62,42,20,3,2
26,149,149,20,6,14,2,1
18,155,155,14,14,0,1,0
27,161,161,19,19,0,1,0
24,173,173,31,18,13,2,1
3,176,176,7,7,0,1,0
5,181,181,33,12,21,4,3
9,186,186,35,12,23,2,1
7,227,227,4,4,0,1,0
20,257,257,1,1,0,1,0
28,271,271,36,36,0,1,0
12,276,276,8,8,0,1,0
17,277,277,18,18,0,1,0
16,326,326,1,1,0,1,0
0,327,327,3,3,0,1,0
10,357,357,2,2,0,1,0
8,366,366,32,32,0,1,0
11,390,390,22,22,0,1,0
21,391,391,2,2,0,1,0
25,398,398,25,15,10,2,1
22,399,399,49,19,30,3,2
2,413,413,11,11,0,1,0
13,441,441,24,3,21,2,1
19,490,490,10,10,0,1,0
14,495,495,38,13,25,2,1

26,105,105,5,5,0,1,0
11,110,110,8,8,0,1,0
5,119,119,1,1,0,1,0
16,148,148,3,3,0,1,0
2,190,190,45,26,19,2,1
10,194,194,4,4,0,1,0
8,200,200,3,3,0,1,0
23,201,201,8,8,0,1,0
1,204,204,10,10,0,1,0
32,235,235,2,2,0,1,0
9,244,244,9,9,0,1,0
28,247,247,30,30,0,1,0
13,253,253,83,83,0,1,0
6,254,254,24,3,21,2,1
12,255,255,3,3,0,1,0
31,280,280,30,30,0,1,0
27,281,281,38,31,7,2,1
29,284,284,49,34,15,4,3
30,291,291,20,20,0,1,0
17,298,298,5,2,3,2,1
20,298,298,28,10,18,3,2
24,305,305,3,3,0,1,0
3,307,307,55,55,0,1,0
14,333,333,12,5,7,2,1
18,362,362,5,1,4,2,1
22,367,367,164,76,88,4,3
21,399,399,14,14,0,1,0
19,425,425,4,1,3,2,1
4,440,440,8,8,0,1,0
7,440,440,39,12,27,4,3
0,472,472,64,23,41,2,1
15,478,478,9,9,0,1,0
25,492,492,70,40,30,4,3

11,107,107,1,1,0,1,0
10,123,123,58,28,30,4,3
16,136,136,22,22,0,1,0
4,163,163,17,3,14,3,2
1,173,173,24,24,0,1,0
17,185,185,1,1,0,1,0
12,190,190,64,14,50,3,2
22,199,199,17,17,0,1,0
7,205,205,15,15,0,1,0
14,218,218,3,3,0,1,0
15,222,222,20,7,13,2,1
5,235,235,6,6,0,1,0
21,251,251,28,28,0,1,0
24,263,263,18,18,0,1,0
8,268,268,23,6,17,2,1
13,285,285,57,34,23,2,1
19,305,305,52,52,0,1,0
9,326,326,52,41,11,2,1
0,330,330,42,42,0,1,0
23,360,360,33,33,0,1,0
2,445,445,50,50,0,1,0
3,447,447,37,27,10,2,1
20,480,480,13,13,0,1,0
6,488,488,10,10,0,1,0
18,495,495,32,4,28,4,3

10,127,127,9,4,5,2,1
20,133,133,8,1,7,2,1
8,145,145,3,3,0,1,0
19,164,164,54,54,0,1,0
22,173,173,8,8,0,1,0
26,185,185,13,2,11,2,1
27,239,239,4,4,0,1,0
30,241,241,30,16,14,3,2
1,243,243,41,8,33,4,3
11,255,255,34,4,30,2,1
21,293,293,83,37,46,2,1
18,307,307,1,1,0,1,0
16,309,309,73,41,32,4,3
4,311,311,5,5,0,1,0
14,322,322,43,43,0,1,0
12,328,328,35,16,19,4,3
17,349,349,8,4,4,2,1
5,354,354,20,20,0,1,0
24,372,372,18,2,16,4,3
7,387,387,72,72,0,1,0
9,398,398,8,2,6,2,1
6,401,401,33,3,30,2,1
3,405,405,5,5,0,1,0
15,443,443,16,16,0,1,0
28,450,450,61,20,41,2,1
23,453,453,17,17,0,1,0
29,478,478,108,96,12,4,3
0,485,485,17,11,6,2,1
13,486,486,22,10,12,2,1
25,486,486,11,4,7,2,1
2,487,487,20,20,0,1,0

2,118,118,3,3,0,1,0
24,134,134,17,17,0,1,0
9,139,139,39,3,36,2,1
18,151,151,6,2,4,2,1
12,153,153,17,17,0,1,0
11,178,178,7,7,0,1,0
4,186,186,12,12,0,1,0
14,225,225,1,1,0,1,0
7,231,231,1,1,0,1,0
6,234,234,49,49,0,1,0
19,244,244,7,7,0,1,0
27,245,245,19,19,0,1,0
20,256,256,37,25,12,2,1
13,286,286,12,12,0,1,0
15,310,310,10,3,7,2,1
10,326,326,8,8,0,1,0
16,328,328,56,22,34,2,1
1,342,342,13,13,0,1,0
17,355,355,15,5,10,3,2
26,355,355,45,33,12,3,2
5,361,361,17,17,0,1,0
8,367,367,52,52,0,1,0
22,386,386,110,86,24,3,2
25,416,416,1,1,0,1,0
3,418,418,3,3,0,1,0
23,445,445,6,6,0,1,0
31,451,451,110,49,61,4,3
0,458,458,54,20,34,2,1
28,459,459,11,11,0,1,0
30,493,493,67,11,56,3,2
21,495,495,30,30,0,1,0
29,496,496,59,32,27,4,3

1,106,106,4,1,3,2,1
7,112,112,20,10,10,2,1
18,117,117,17,17,0,1,0
17,124,124,1,1,0,1,0
12,129,129,22,22,0,1,0
9,173,173,2,2,0,1,0
16,177,177,53,53,0,1,0
6,179,179,14,2,12,4,3
21,181,181,9,9,0,1,0
0,184,184,75,21,54,4,3
19,202,202,20,20,0,1,0
8,285,285,31,31,0,1,0
20,300,300,16,16,0,1,0
10,303,303,42,42,0,1,0
2,309,309,3,3,0,1,0
11,340,340,36,2,34,3,2
4,417,417,52,52,0,1,0
5,431,431,69,23,46,3,2
13,460,460,62,62,0,1,0
15,484,484,47,17,30,2,1
3,495,495,200,191,9,4,3
14,496,496,7,7,0,1,0

20,105,105,5,5,0,1,0
7,116,116,18,9,9,4,3
9,121,121,2,2,0,1,0
2,167,167,22,14,8,3,2
17,172,172,37,37,0,1,0
18,175,175,4,4,0,1,0
8,176,176,20,4,16,2,1
23,177,177,16,16,0,1,0
12,200,200,7,3,4,2,1
21,212,212,75,28,47,4,3
3,232,232,13,1,12,2,1
5,234,234,1,1,0,1,0
25,245,245,18,4,14,3,2
27,257,257,50,50,0,1,0
4,258,258,66,21,45,2,1
26,277,277,28,4,24,2,1
0,326,326,3,3,0,1,0
14,331,331,12,8,4,2,1
13,353,353,9,1,8,2,1
16,371,371,39,17,22,2,1
10,389,389,83,47,36,4,3
1,393,393,105,105,0,1,0
19,394,394,5,5,0,1,0
22,408,408,9,3,6,2,1
24,458,458,30,14,16,3,2
6,460,460,32,2,30,2,1
11,478,478,23,1,22,3,2
15,489,489,46,46,0,1,0

12,107,107,32,17,15,4,3
11,120,120,9,9,0,1,0
27,134,134,1,1,0,1,0
34,136,136,5,1,4,2,1
15,138,138,5,5,0,1,0
3,154,154,1,1,0,1,0
33,180,180,29,20,9,4,3
23,188,188,4,4,0,1,0
31,212,212,55,55,0,1,0
24,220,220,43,43,0,1,0
28,229,229,6,2,4,2,1
18,233,233,18,18,0,1,0
13,249,249,2,2,0,1,0
10,249,249,16,7,9,4,3
8,254,254,14,4,10,3,2
19,255,255,15,15,0,1,0
21,258,258,20,5,15,4,3
25,273,273,15,15,0,1,0
32,298,298,12,12,0,1,0
4,312,312,22,16,6,3,2
5,317,317,14,10,4,2,1
22,321,321,115,23,92,3,2
30,343,343,52,52,0,1,0
26,370,370,2,2,0,1,0
1,372,372,31,4,27,4,3
7,382,382,48,48,0,1,0
6,388,388,44,14,30,4,3
29,393,393,12,12,0,1,0
9,405,405,18,18,0,1,0
0,409,409,19,19,0,1,0
16,436,436,12,12,0,1,0
20,447,447,6,6,0,1,0
17,453,453,16,16,0,1,0
2,467,467,39,25,14,2,1
14,486,486,16,9,7,2,1

2,100,100,4,4,0,1,0
19,101,101,5,2,3,2,1
4,112,112,23,13,10,2,1
18,218,218,30,13,17,2,1
12,233,233,8,8,0,1,0
15,242,242,4,4,0,1,0
22,254,254,56,19,37,3,2
14,267,267,23,3,20,3,2
20,275,275,9,9,0,1,0
0,277,277,32,32,0,1,0
10,285,285,86,44,42,2,1
1,286,286,33,2,31,2,1
24,302,302,6,6,0,1,0
16,307,307,63,42,21,2,1
21,316,316,12,3,9,2,1
11,325,325,14,2,12,3,2
9,339,339,105,68,37,2,1
6,341,341,13,13,0,1,0
25,346,346,105,105,0,1,0
13,359,359,4,4,0,1,0
17,370,370,90,59,31,2,1
8,397,397,29,29,0,1,0
7,452,452,45,30,15,2,1
23,462,462,15,15,0,1,0
5,470,470,13,13,0,1,0
3,492,492,16,16,0,1,0

16,121,121,14,14,0,1,0
18,140,140,28,28,0,1,0
1,151,151,7,7,0,1,0
10,178,178,8,8,0,1,0
13,184,184,24,5,19,2,1
5,194,194,7,7,0,1,0
24,198,198,8,4,4,2,1
4,227,227,28,28,0,1,0
22,237,237,10,10,0,1,0
21,250,250,25,5,20,3,2
3,295,295,5,5,0,1,0
9,313,313,71,71,0,1,0
6,323,323,78,78,0,1,0
8,325,325,45,21,24,4,3
17,333,333,75,40,35,2,1
19,339,339,10,10,0,1,0
12,361,361,4,1,3,2,1
14,376,376,15,15,0,1,0
27,378,378,2,2,0,1,0
2,384,384,21,18,3,2,1
0,400,400,1,1,0,1,0
15,402,402,84,34,50,3,2
11,405,405,31,31,0,1,0
23,418,418,107,93,14,3,2
29,460,460,19,13,6,2,1
7,465,465,1,1,0,1,0
28,469,469,24,24,0,1,0
20,474,474,31,17,14,2,1
26,496,496,106,22,84,4,3
25,499,499,23,11,12,3,2

4,101,101,8,8,0,1,0
13,128,128,1,1,0,1,0
1,134,134,32,32,0,1,0
7,135,135,6,3,3,2,1
3,144,144,5,1,4,2,1
14,154,154,20,6,14,3,2
19,162,162,78,78,0,1,0
0,193,193,4,4,0,1,0
21,202,202,12,12,0,1,0
8,223,223,27,27,0,1,0
2,231,231,66,20,46,2,1
11,239,239,28,1,27,4,3
25,248,248,6,1,5,2,1
20,264,264,8,8,0,1,0
9,264,264,29,3,26,3,2
28,269,269,19,19,0,1,0
12,320,320,59,10,49,2,1
15,326,326,39,39,0,1,0
22,328,328,2,2,0,1,0
24,336,336,10,6,4,2,1
18,342,342,79,16,63,4,3
26,348,348,41,41,0,1,0
17,358,358,26,14,12,2,1
5,361,361,7,7,0,1,0
6,362,362,2,2,0,1,0
23,363,363,17,8,9,3,2
27,364,364,42,42,0,1,0
10,411,411,1,1,0,1,0
16,427,427,8,8,0,1,0

30,108,108,5,5,0,1,0
27,122,122,1,1,0,1,0
19,130,130,3,3,0,1,0
18,130,130,3,3,0,1,0
22,168,168,13,7,6,2,1
10,179,179,15,12,3,2,1
33,179,179,3,3,0,1,0
25,182,182,10,10,0,1,0
1,187,187,4,4,0,1,0
21,188,188,7,7,0,1,0
8,196,196,4,4,0,1,0
3,208,208,6,2,4,2,1
2,258,258,32,12,20,2,1
9,270,270,2,2,0,1,0
20,272,272,12,12,0,1,0
28,281,281,35,5,30,3,2
17,296,296,1,1,0,1,0
24,299,299,8,8,0,1,0
29,309,309,5,5,0,1,0
15,313,313,81,37,44,3,2
12,317,317,136,121,15,2,1
34,345,345,5,5,0,1,0
0,383,383,1,1,0,1,0
13,383,383,26,2,24,3,2
4,411,411,1,1,0,1,0
32,419,419,63,53,10,3,2
16,423,423,6,6,0,1,0
5,423,423,3,3,0,1,0
26,424,424,119,119,0,1,0
6,431,431,64,12,52,3,2
31,433,433,149,64,85,4,3
35,444,444,101,21,80,3,2
23,445,445,17,9,8,3,2
14,451,451,12,12,0,1,0
7,456,456,13,13,0,1,0
11,478,478,1,1,0,1,0

12,110,110,1,1,0,1,0
10,112,112,11,1,10,2,1
25,133,133,2,2,0,1,0
8,144,144,4,4,0,1,0
0,146,146,55,29,26,3,2
13,166,166,31,11,20,2,1
6,203,203,3,3,0,1,0
3,224,224,25,15,10,3,2
5,229,229,14,14,0,1,0
21,264,264,18,18,0,1,0
19,290,290,108,99,9,4,3
17,305,305,45,30,15,4,3
7,315,315,47,2,45,2,1
11,318,318,11,11,0,1,0
15,339,339,6,6,0,1,0
14,361,361,58,58,0,1,0
2,365,365,12,12,0,1,0
9,396,396,47,47,0,1,0
16,414,414,90,90,0,1,0
18,438,438,4,4,0,1,0
23,460,460,54,22,32,2,1
1,474,474,154,38,116,4,3
22,474,474,18,6,12,2,1
24,479,479,2,2,0,1,0
20,486,486,30,8,22,3,2
4,493,493,25,25,0,1,0

15,138,138,6,6,0,1,0
21,158,158,12,12,0,1,0
4,173,173,23,23,0,1,0
8,192,192,35,35,0,1,0
10,195,195,62,20,42,3,2
11,205,205,15,15,0,1,0
24,231,231,2,2,0,1,0
26,242,242,15,15,0,1,0
25,251,251,14,8,6,2,1
23,256,256,48,48,0,1,0
0,264,264,1,1,0,1,0
6,276,276,24,5,19,2,1
14,277,277,26,8,18,3,2
3,278,278,117,19,98,3,2
16,281,281,15,1,14,3,2
17,298,298,8,5,3,2,1
9,310,310,6,6,0,1,0
12,340,340,5,5,0,1,0
7,359,359,20,5,15,2,1
5,393,393,12,1,11,2,1
18,410,410,68,17,51,4,3
2,429,429,21,9,12,4,3
22,446,446,23,3,20,2,1
13,448,448,95,55,40,4,3
19,458,458,56,44,12,3,2
1,458,458,7,7,0,1,0
20,496,496,133,133,0,1,0

6,103,103,9,9,0,1,0
12,126,126,6,6,0,1,0
14,127,127,29,29,0,1,0
7,141,141,1,1,0,1,0
4,152,152,4,4,0,1,0
8,160,160,10,10,0,1,0
15,163,163,36,36,0,1,0
1,165,165,88,88,0,1,0
3,181,181,61,21,40,3,2
13,182,182,2,2,0,1,0
19,196,196,43,13,30,4,3
18,214,214,19,6,13,4,3
23,246,246,6,6,0,1,0
24,264,264,41,41,0,1,0
2,309,309,23,23,0,1,0
20,309,309,20,16,4,2,1
11,353,353,11,5,6,3,2
10,358,358,35,9,26,3,2
21,370,370,76,26,50,3,2
22,396,396,2,2,0,1,0
0,397,397,54,54,0,1,0
17,414,414,14,14,0,1,0
5,417,417,3,3,0,1,0
9,475,475,15,10,5,2,1
16,493,493,46,46,0,1,0

23,112,112,8,3,5,2,1
20,122,122,2,2,0,1,0
19,127,127,29,15,14,2,1
24,155,155,13,13,0,1,0
17,188,188,19,19,0,1,0
13,207,207,3,3,0,1,0
11,251,251,30,30,0,1,0
22,256,256,4,1,3,2,1
8,263,263,40,40,0,1,0
1,272,272,5,5,0,1,0
16,287,287,15,3,12,4,3
10,316,316,13,13,0,1,0
21,347,347,27,27,0,1,0
4,369,369,87,61,26,2,1
18,382,382,7,2,5,2,1
15,383,383,24,24,0,1,0
14,392,392,48,48,0,1,0
7,393,393,87,21,66,3,2
6,398,398,44,6,38,3,2
0,415,415,23,10,13,2,1
5,419,419,73,28,45,3,2
3,424,424,11,5,6,2,1
2,426,426,56,56,0,1,0
9,436,436,50,38,12,2,1
12,441,441,164,67,97,4,3
25,471,471,94,68,26,4,3

8,125,125,5,5,0,1,0
9,154,154,38,17,21,4,3
12,162,162,1,1,0,1,0
6,197,197,30,30,0,1,0
10,197,197,17,17,0,1,0
25,199,199,6,6,0,1,0
15,218,218,1,1,0,1,0
21,223,223,42,2,40,3,2
17,226,226,29,29,0,1,0
3,233,233,34,9,25,2,1
4,234,234,71,71,0,1,0
5,249,249,1,1,0,1,0
22,249,249,38,38,0,1,0
24,255,255,14,11,3,2,1
23,270,270,6,6,0,1,0
2,273,273,29,22,7,2,1
19,324,324,33,33,0,1,0
20,329,329,31,10,21,4,3
1,369,369,44,32,12,4,3
0,376,376,16,3,13,2,1
7,380,380,33,2,31,2,1
11,385,385,24,9,15,4,3
18,424,424,127,105,22,3,2
16,443,443,10,10,0,1,0
26,453,453,4,4,0,1,0
14,460,460,5,5,0,1,0
13,463,463,143,23,120,4,3

30,127,127,5,5,0,1,0
23,133,133,47,22,25,4,3
17,146,146,27,21,6,2,1
10,161,161,26,26,0,1,0
4,166,166,1,1,0,1,0
16,189,189,43,43,0,1,0
14,208,208,4,4,0,1,0
31,219,219,12,4,8,3,2
6,219,219,1,1,0,1,0
11,220,220,5,5,0,1,0
5,241,241,3,3,0,1,0
28,242,242,66,66,0,1,0
26,258,258,11,2,9,4,3
0,264,264,15,15,0,1,0
22,279,279,32,20,12,4,3
8,288,288,37,13,24,2,1
25,300,300,21,21,0,1,0
21,309,309,26,26,0,1,0
19,315,315,26,26,0,1,0
24,317,317,5,5,0,1,0
2,342,342,3,3,0,1,0
12,364,364,34,34,0,1,0
20,384,384,86,52,34,3,2
27,394,394,8,8,0,1,0
13,412,412,51,51,0,1,0
18,437,437,3,3,0,1,0
15,452,452,4,4,0,1,0
29,465,465,23,23,0,1,0
7,475,475,5,5,0,1,0
1,481,481,42,25,17,2,1
3,486,486,37,31,6,3,2
9,497,497,86,47,39,4,3

23,108,108,2,2,0,1,0
1,119,119,12,7,5,2,1
20,142,142,15,1,14,3,2
16,153,153,22,22,0,1,0
10,188,188,31,31,0,1,0
4,193,193,23,5,18,4,3
19,198,198,9,3,6,3,2
17,227,227,39,9,30,4,3
12,234,234,36,36,0,1,0
2,240,240,22,22,0,1,0
21,242,242,22,22,0,1,0
13,245,245,88,22,66,3,2
0,266,266,1,1,0,1,0
22,266,266,25,7,18,4,3
3,289,289,81,33,48,3,2
9,301,301,78,57,21,4,3
6,316,316,10,10,0,1,0
14,359,359,29,17,12,4,3
18,366,366,5,5,0,1,0
24,393,393,13,1,12,3,2
5,415,415,36,36,0,1,0
7,434,434,94,43,51,4,3
8,441,441,21,4,17,2,1
11,484,484,7,1,6,3,2
15,486,486,49,49,0,1,0

6,107,107,2,2,0,1,0
26,127,127,3,3,0,1,0
11,130,130,3,3,0,1,0
17,133,133,9,9,0,1,0
21,144,144,33,33,0,1,0
8,228,228,13,13,0,1,0
5,232,232,55,55,0,1,0
0,240,240,2,2,0,1,0
4,244,244,23,23,0,1,0
13,246,246,50,50,0,1,0
10,257,257,49,49,0,1,0
3,261,261,10,10,0,1,0
12,291,291,5,5,0,1,0
22,305,305,41,41,0,1,0
2,322,322,91,65,26,2,1
16,325,325,59,59,0,1,0
25,329,329,10,10,0,1,0
18,342,342,22,6,16,3,2
9,371,371,76,76,0,1,0
23,389,389,33,33,0,1,0
15,393,393,19,19,0,1,0
1,404,404,3,3,0,1,0
24,410,410,1,1,0,1,0
14,445,445,31,4,27,4,3
20,464,464,74,74,0,1,0
19,478,478,54,9,45,2,1
7,481,481,9,3,6,2,1
27,493,493,106,106,0,1,0

6,101,101,10,10,0,1,0
9,111,111,10,10,0,1,0
27,121,121,22,7,15,4,3
10,137,137,12,12,0,1,0
24,149,149,1,1,0,1,0
23,171,171,2,2,0,1,0
1,217,217,19,19,0,1,0
17,218,218,14,14,0,1,0
25,225,225,67,25,42,4,3
5,228,228,34,34,0,1,0
11,230,230,21,21,0,1,0
13,238,238,3,3,0,1,0
7,254,254,10,10,0,1,0
28,304,304,40,3,37,2,1
0,314,314,67,67,0,1,0
21,340,340,60,60,0,1,0
22,342,342,85,73,12,2,1
12,368,368,64,64,0,1,0
15,373,373,1,1,0,1,0
4,379,379,1,1,0,1,0
2,388,388,15,15,0,1,0
14,398,398,66,52,14,2,1
8,418,418,11,11,0,1,0
26,420,420,66,43,23,2,1
29,434,434,5,5,0,1,0
20,456,456,13,13,0,1,0
19,471,471,7,1,6,3,2
16,476,476,16,6,10,3,2
3,480,480,58,34,24,3,2
18,493,493,30,15,15,2,1

14,104,104,14,14,0,1,0
2,112,112,15,15,0,1,0
26,125,125,4,1,3,2,1
13,175,175,5,5,0,1,0
8,207,207,38,38,0,1,0
18,209,209,45,45,0,1,0
17,227,227,21,21,0,1,0
27,228,228,33,33,0,1,0
5,234,234,3,3,0,1,0
7,244,244,1,1,0,1,0
15,262,262,7,7,0,1,0
16,272,272,63,55,8,3,2
19,293,293,11,7,4,2,1
11,293,293,6,3,3,2,1
20,299,299,48,48,0,1,0
6,300,300,3,3,0,1,0
23,322,322,6,6,0,1,0
3,329,329,174,174,0,1,0
22,347,347,11,5,6,3,2
12,357,357,17,1,16,2,1
4,357,357,27,27,0,1,0
9,399,399,35,9,26,3,2
25,424,424,102,102,0,1,0
24,425,425,13,13,0,1,0
21,433,433,13,1,12,2,1
1,458,458,78,48,30,2,1
10,475,475,29,29,0,1,0
0,486,486,19,19,0,1,0

32,100,100,2,2,0,1,0
33,102,102,3,3,0,1,0
31,105,105,8,4,4,2,1
1,107,107,8,8,0,1,0
28,131,131,1,1,0,1,0
25,138,138,38,38,0,1,0
9,144,144,13,5,8,2,1
7,147,147,1,1,0,1,0
29,153,153,9,9,0,1,0
34,154,154,24,7,17,2,1
19,160,160,19,7,12,4,3
16,163,163,3,3,0,1,0
8,166,166,1,1,0,1,0
2,170,170,11,11,0,1,0
23,194,194,18,4,14,2,1
37,199,199,5,1,4,2,1
36,227,227,21,21,0,1,0
12,259,259,9,9,0,1,0
18,282,282,48,48,0,1,0
15,323,323,16,8,8,3,2
14,323,323,11,7,4,2,1
26,328,328,98,8,90,4,3
4,329,329,3,3,0,1,0
22,332,332,44,9,35,2,1
20,341,341,9,9,0,1,0
17,342,342,5,5,0,1,0
5,344,344,20,12,8,3,2
13,366,366,2,2,0,1,0
38,383,383,97,94,3,2,1
11,401,401,8,8,0,1,0
6,402,402,47,47,0,1,0
24,408,408,17,17,0,1,0
3,409,409,13,13,0,1,0
0,413,413,31,31,0,1,0
10,425,425,44,38,6,2,1
27,435,435,43,43,0,1,0
35,454,454,8,8,0,1,0
30,455,455,15,15,0,1,0
21,466,466,2,2,0,1,0

16,105,105,1,1,0,1,0
17,112,112,2,2,0,1,0
33,134,134,12,12,0,1,0
32,175,175,14,14,0,1,0
12,202,202,1,1,0,1,0
14,221,221,10,10,0,1,0
15,224,224,10,10,0,1,0
6,226,226,7,7,0,1,0
13,230,230,27,27,0,1,0
19,242,242,4,4,0,1,0
24,259,259,48,39,9,4,3
0,260,260,26,26,0,1,0
18,304,304,9,3,6,3,2
2,307,307,38,38,0,1,0
4,338,338,22,22,0,1,0
29,369,369,43,43,0,1,0
30,380,380,13,7,6,2,1
21,383,383,11,11,0,1,0
31,386,386,43,13,30,3,2
25,394,394,18,6,12,4,3
23,396,396,64,64,0,1,0
10,399,399,3,3,0,1,0
20,400,400,109,25,84,3,2
11,414,414,64,64,0,1,0
28,419,419,12,2,10,2,1
26,435,435,62,16,46,3,2
1,449,449,25,7,18,3,2
9,453,453,110,88,22,3,2
22,454,454,23,11,12,3,2
5,454,454,77,57,20,2,1
7,466,466,63,6,57,3,2
8,490,490,13,7,6,3,2
3,491,491,3,3,0,1,0
27,493,493,38,38,0,1,0

22,130,130,8,4,4,2,1
6,146,146,14,8,6,2,1
8,151,151,7,7,0,1,0
25,152,152,4,4,0,1,0
28,153,153,21,21,0,1,0
27,157,157,6,6,0,1,0
1,165,165,1,1,0,1,0
13,167,167,7,7,0,1,0
23,171,171,19,13,6,2,1
30,192,192,18,9,9,2,1
11,200,200,19,11,8,2,1
5,202,202,1,1,0,1,0
4,218,218,21,21,0,1,0
7,222,222,8,8,0,1,0
2,248,248,60,12,48,2,1
18,253,253,14,6,8,2,1
12,255,255,8,8,0,1,0
0,262,262,1,1,0,1,0
3,278,278,29,29,0,1,0
16,296,296,14,14,0,1,0
26,302,302,12,12,0,1,0
17,329,329,6,6,0,1,0
14,333,333,108,108,0,1,0
29,333,333,135,135,0,1,0
19,351,351,12,2,10,2,1
10,382,382,53,28,25,2,1
21,397,397,96,61,35,4,3
9,404,404,19,19,0,1,0
15,433,433,18,6,12,3,2
24,461,461,47,47,0,1,0
20,475,475,36,12,24,4,3

5,100,100,1,1,0,1,0
24,104,104,4,4,0,1,0
7,151,151,36,36,0,1,0
13,152,152,9,9,0,1,0
18,157,157,2,2,0,1,0
9,189,189,2,2,0,1,0
0,226,226,26,26,0,1,0
6,256,256,19,19,0,1,0
25,261,261,20,20,0,1,0
8,299,299,20,16,4,2,1
23,314,314,7,3,4,2,1
21,328,328,10,10,0,1,0
11,349,349,65,65,0,1,0
3,352,352,78,78,0,1,0
4,369,369,54,15,39,4,3
20,378,378,38,6,32,3,2
26,386,386,144,103,41,2,1
14,393,393,20,20,0,1,0
22,409,409,64,64,0,1,0
16,419,419,57,57,0,1,0
1,423,423,63,63,0,1,0
17,424,424,121,121,0,1,0
10,437,437,1,1,0,1,0
19,460,460,34,34,0,1,0
2,463,463,13,4,9,4,3
12,479,479,73,73,0,1,0
15,495,495,7,7,0,1,0

20,100,100,8,2,6,3,2
17,144,144,2,2,0,1,0
11,148,148,10,10,0,1,0
0,152,152,3,3,0,1,0
23,174,174,46,46,0,1,0
4,179,179,78,34,44,2,1
25,189,189,4,1,3,2,1
6,195,195,2,2,0,1,0
15,201,201,39,39,0,1,0
7,204,204,65,65,0,1,0
9,236,236,4,4,0,1,0
1,242,242,34,22,12,4,3
21,264,264,5,2,3,2,1
16,316,316,57,24,33,4,3
14,316,316,30,4,26,3,2
10,327,327,14,8,6,3,2
18,358,358,60,2,58,3,2
12,370,370,23,23,0,1,0
8,416,416,60,32,28,2,1
19,433,433,26,26,0,1,0
2,438,438,47,7,40,2,1
22,439,439,13,13,0,1,0
5,468,468,27,27,0,1,0
13,474,474,21,4,17,4,3
3,479,479,20,1,19,2,1
24,493,493,97,39,58,3,2

8,114,114,11,11,0,1,0
12,137,137,20,12,8,2,1
14,138,138,6,6,0,1,0
25,164,164,11,11,0,1,0
26,171,171,21,21,0,1,0
5,178,178,49,10,39,2,1
3,189,189,11,11,0,1,0
19,206,206,28,28,0,1,0
0,207,207,3,3,0,1,0
1,238,238,20,20,0,1,0
21,265,265,8,8,0,1,0
23,277,277,33,33,0,1,0
20,281,281,83,51,32,2,1
16,291,291,9,9,0,1,0
15,294,294,3,3,0,1,0
18,295,295,59,17,42,4,3
7,345,345,2,2,0,1,0
29,375,375,56,56,0,1,0
10,376,376,60,38,22,2,1
27,388,388,23,23,0,1,0
9,393,393,3,3,0,1,0
22,398,398,5,5,0,1,0
13,404,404,17,1,16,3,2
17,420,420,20,20,0,1,0
4,434,434,5,5,0,1,0
6,451,451,111,111,0,1,0
2,453,453,84,70,14,3,2
28,457,457,1,1,0,1,0
24,460,460,68,68,0,1,0
11,473,473,8,2,6,3,2

26,100,100,5,5,0,1,0
2,129,129,2,2,0,1,0
0,138,138,28,14,14,4,3
8,224,224,1,1,0,1,0
24,228,228,31,10,21,2,1
5,229,229,27,19,8,3,2
10,248,248,15,6,9,4,3
23,255,255,11,11,0,1,0
20,255,255,30,30,0,1,0
11,275,275,1,1,0,1,0
21,280,280,4,4,0,1,0
18,283,283,118,114,4,2,1
3,290,290,75,75,0,1,0
22,306,306,5,2,3,2,1
17,314,314,15,15,0,1,0
25,369,369,21,14,7,2,1
14,369,369,37,25,12,3,2
6,370,370,117,41,76,3,2
16,378,378,15,15,0,1,0
9,383,383,12,12,0,1,0
12,388,388,29,29,0,1,0
15,397,397,99,99,0,1,0
13,406,406,50,50,0,1,0
4,417,417,1,1,0,1,0
7,429,429,28,16,12,3,2
28,449,449,68,68,0,1,0
1,473,473,12,12,0,1,0
27,484,484,1,1,0,1,0
19,488,488,38,11,27,2,1

18,101,101,3,3,0,1,0
20,114,114,24,24,0,1,0
21,126,126,23,1,22,2,1
11,127,127,23,23,0,1,0
7,150,150,18,2,16,3,2
33,153,153,2,2,0,1,0
24,167,167,7,2,5,2,1
9,176,176,26,26,0,1,0
13,208,208,26,26,0,1,0
15,221,221,1,1,0,1,0
23,227,227,36,21,15,4,3
31,248,248,16,16,0,1,0
26,257,257,16,4,12,3,2
32,277,277,20,16,4,2,1
6,288,288,48,48,0,1,0
1,288,288,8,1,7,2,1
19,294,294,12,12,0,1,0
5,303,303,12,12,0,1,0
8,321,321,13,13,0,1,0
10,327,327,41,26,15,4,3
27,337,337,8,8,0,1,0
30,340,340,2,2,0,1,0
28,343,343,25,22,3,2,1
25,344,344,54,38,16,2,1
17,351,351,36,14,22,2,1
0,360,360,1,1,0,1,0
16,367,367,5,5,0,1,0
3,385,385,1,1,0,1,0
14,393,393,6,6,0,1,0
12,430,430,27,27,0,1,0
2,442,442,7,1,6,3,2
4,476,476,65,65,0,1,0
29,486,486,85,85,0,1,0
22,491,491,93,57,36,2,1

4,140,140,12,12,0,1,0
13,186,186,16,16,0,1,0
8,206,206,21,21,0,1,0
11,222,222,14,2,12,3,2
1,234,234,76,2,74,3,2
18,257,257,12,2,10,3,2
7,282,282,28,25,3,2,1
14,295,295,1,1,0,1,0
3,304,304,46,31,15,2,1
2,311,311,2,2,0,1,0
0,340,340,24,24,0,1,0
15,350,350,25,25,0,1,0
10,352,352,91,83,8,2,1
6,358,358,171,115,56,4,3
22,385,385,119,104,15,2,1
12,395,395,92,80,12,2,1
16,400,400,7,3,4,2,1
20,427,427,89,2,87,4,3
9,433,433,14,14,0,1,0
17,446,446,12,7,5,2,1
5,451,451,38,38,0,1,0
21,452,452,23,4,19,2,1
19,492,492,8,1,7,2,1

15,116,116,12,3,9,2,1
26,141,141,3,3,0,1,0
21,176,176,4,1,3,2,1
20,191,191,27,27,0,1,0
2,194,194,22,22,0,1,0
25,199,199,15,15,0,1,0
27,210,210,32,32,0,1,0
13,215,215,4,4,0,1,0
24,215,215,30,30,0,1,0
7,254,254,9,9,0,1,0
10,271,271,3,3,0,1,0
16,273,273,8,4,4,2,1
29,278,278,22,22,0,1,0
33,296,296,23,1,22,2,1
32,329,329,101,72,29,4,3
6,348,348,9,9,0,1,0
30,355,355,30,9,21,3,2
9,357,357,14,14,0,1,0
3,362,362,7,7,0,1,0
28,365,365,52,12,40,4,3
1,368,368,22,6,16,3,2
19,375,375,8,8,0,1,0
5,392,392,37,6,31,2,1
4,392,392,43,11,32,2,1
8,400,400,30,18,12,3,2
12,402,402,10,10,0,1,0
0,405,405,55,35,20,2,1
18,418,418,38,38,0,1,0
17,421,421,81,45,36,4,3
31,449,449,23,17,6,3,2
11,458,458,2,2,0,1,0
23,463,463,14,2,12,2,1
22,485,485,49,22,27,2,1
14,490,490,97,52,45,2,1

27,115,115,7,7,0,1,0
21,115,115,1,1,0,1,0
8,128,128,1,1,0,1,0
5,142,142,5,5,0,1,0
7,169,169,7,7,0,1,0
26,172,172,50,22,28,3,2
34,175,175,26,22,4,2,1
4,190,190,1,1,0,1,0
0,214,214,13,13,0,1,0
32,215,215,35,35,0,1,0
17,219,219,36,10,26,2,1
28,232,232,20,20,0,1,0
36,284,284,5,5,0,1,0
37,286,286,47,43,4,2,1
12,289,289,23,23,0,1,0
23,293,293,22,22,0,1,0
15,308,308,35,35,0,1,0
3,314,314,11,11,0,1,0
25,329,329,34,34,0,1,0
30,349,349,40,40,0,1,0
13,366,366,23,4,19,2,1
29,384,384,10,10,0,1,0
35,387,387,14,14,0,1,0
24,390,390,6,6,0,1,0
33,402,402,23,23,0,1,0
38,409,409,51,51,0,1,0
20,418,418,1,1,0,1,0
2,424,424,7,7,0,1,0
31,430,430,26,26,0,1,0
11,435,435,9,9,0,1,0
9,445,445,16,5,11,2,1
19,464,464,21,21,0,1,0
16,467,467,22,12,10,2,1
39,468,468,37,1,36,4,3
6,469,469,15,6,9,2,1
10,474,474,92,70,22,3,2
1,488,488,67,27,40,3,2
14,492,492,17,17,0,1,0
18,494,494,12,7,5,2,1
22,500,500,1,1,0,1,0

13,106,106,1,1,0,1,0
33,112,112,38,18,20,3,2
9,114,114,4,4,0,1,0
2,116,116,25,15,10,2,1
3,125,125,1,1,0,1,0
12,136,136,26,16,10,2,1
1,151,151,8,8,0,1,0
31,157,157,38,38,0,1,0
30,183,183,1,1,0,1,0
32,185,185,2,2,0,1,0
8,212,212,8,8,0,1,0
29,226,226,2,2,0,1,0
25,234,234,22,13,9,2,1
6,237,237,39,27,12,3,2
15,239,239,10,10,0,1,0
26,247,247,69,24,45,4,3
23,249,249,1,1,0,1,0
0,262,262,1,1,0,1,0
19,284,284,31,31,0,1,0
27,286,286,21,21,0,1,0
16,290,290,10,10,0,1,0
21,292,292,84,49,35,3,2
11,333,333,17,7,10,3,2
5,375,375,1,1,0,1,0
18,382,382,13,13,0,1,0
7,395,395,43,43,0,1,0
24,406,406,6,6,0,1,0
28,415,415,7,3,4,2,1
17,416,416,69,69,0,1,0
20,430,430,16,16,0,1,0
14,435,435,24,24,0,1,0
22,456,456,11,11,0,1,0
10,460,460,5,5,0,1,0
4,469,469,33,33,0,1,0

24,103,103,8,8,0,1,0
16,114,114,20,20,0,1,0
19,146,146,1,1,0,1,0
1,161,161,1,1,0,1,0
12,166,166,20,20,0,1,0
3,190,190,6,3,3,2,1
13,194,194,18,18,0,1,0
15,224,224,5,5,0,1,0
6,230,230,48,48,0,1,0
7,236,236,73,4,69,4,3
14,241,241,25,25,0,1,0
22,259,259,6,6,0,1,0
5,261,261,13,8,5,2,1
2,266,266,52,52,0,1,0
20,266,266,28,23,5,2,1
4,317,317,7,7,0,1,0
10,327,327,38,10,28,3,2
21,345,345,11,11,0,1,0
8,356,356,1,1,0,1,0
0,356,356,81,63,18,3,2
18,361,361,165,111,54,4,3
11,368,368,35,8,27,2,1
25,384,384,45,5,40,3,2
9,417,417,8,2,6,2,1
26,488,488,30,30,0,1,0
23,488,488,9,9,0,1,0
17,499,499,70,41,29,2,1

3,112,112,5,5,0,1,0
1,149,149,45,45,0,1,0
27,150,150,9,3,6,3,2
5,164,164,2,2,0,1,0
6,169,169,25,7,18,4,3
8,186,186,12,12,0,1,0
4,194,194,35,35,0,1,0
15,205,205,9,2,7,2,1
2,209,209,1,1,0,1,0
22,218,218,9,1,8,2,1
20,222,222,12,12,0,1,0
14,234,234,22,22,0,1,0
23,242,242,66,42,24,4,3
7,249,249,6,6,0,1,0
25,267,267,11,1,10,2,1
10,275,275,8,8,0,1,0
13,328,328,105,21,84,4,3
0,331,331,15,7,8,3,2
12,348,348,15,5,10,3,2
28,378,378,36,12,24,4,3
17,385,385,77,45,32,3,2
24,393,393,77,77,0,1,0
19,413,413,33,28,5,2,1
16,415,415,49,23,26,3,2
11,417,417,16,6,10,2,1
18,418,418,2,2,0,1,0
21,435,435,89,51,38,2,1
9,462,462,23,23,0,1,0
26,494,494,8,1,7,3,2

18,102,102,2,2,0,1,0
22,107,107,5,5,0,1,0
2,177,177,7,3,4,2,1
24,194,194,2,2,0,1,0
29,225,225,7,2,5,2,1
12,236,236,28,28,0,1,0
1,239,239,27,27,0,1,0
3,266,266,5,1,4,2,1
10,269,269,23,23,0,1,0
0,281,281,2,2,0,1,0
31,297,297,43,10,33,2,1
32,304,304,25,25,0,1,0
27,308,308,15,11,4,2,1
13,310,310,35,17,18,4,3
25,322,322,26,5,21,4,3
17,330,330,8,8,0,1,0
4,335,335,9,5,4,2,1
30,343,343,22,3,19,2,1
14,350,350,19,19,0,1,0
11,352,352,6,2,4,2,1
16,358,358,40,40,0,1,0
20,363,363,31,31,0,1,0
19,367,367,7,4,3,2,1
23,378,378,7,7,0,1,0
26,379,379,56,9,47,2,1
9,390,390,78,78,0,1,0
15,404,404,1,1,0,1,0
5,435,435,41,35,6,3,2
7,454,454,7,7,0,1,0
6,454,454,141,141,0,1,0
28,474,474,255,255,0,1,0
8,493,493,16,16,0,1,0
21,495,495,54,37,17,2,1

30,104,104,20,2,18,2,1
11,111,111,11,1,10,2,1
18,119,119,20,7,13,2,1
12,133,133,13,2,11,2,1
27,162,162,16,9,7,2,1
21,193,193,1,1,0,1,0
14,196,196,9,2,7,2,1
8,200,200,1,1,0,1,0
17,205,205,6,6,0,1,0
10,208,208,7,3,4,2,1
16,235,235,13,1,12,3,2
28,237,237,16,16,0,1,0
26,237,237,26,11,15,2,1
6,240,240,14,6,8,2,1
7,259,259,18,18,0,1,0
15,267,267,6,1,5,2,1
24,269,269,31,31,0,1,0
19,288,288,39,39,0,1,0
25,353,353,19,3,16,2,1
20,354,354,69,33,36,3,2
2,356,356,15,15,0,1,0
29,374,374,58,58,0,1,0
4,385,385,21,1,20,3,2
13,391,391,76,31,45,4,3
3,398,398,35,17,18,3,2
32,440,440,2,2,0,1,0
9,442,442,18,15,3,2,1
5,445,445,77,50,27,4,3
1,469,469,57,18,39,2,1
0,469,469,3,3,0,1,0
23,477,477,49,49,0,1,0
31,485,485,90,42,48,3,2
22,488,488,2,2,0,1,0

12,130,130,19,1,18,4,3
14,131,131,10,10,0,1,0
21,153,153,3,3,0,1,0
28,158,158,47,47,0,1,0
8,167,167,7,1,6,3,2
16,172,172,4,4,0,1,0
25,179,179,43,1,42,4,3
2,193,193,20,8,12,2,1
4,200,200,1,1,0,1,0
1,213,213,6,6,0,1,0
19,216,216,37,25,12,2,1
11,218,218,44,44,0,1,0
26,227,227,61,37,24,4,3
7,254,254,106,85,21,4,3
15,268,268,22,22,0,1,0
0,287,287,1,1,0,1,0
13,289,289,7,3,4,2,1
20,290,290,37,37,0,1,0
27,297,297,15,9,6,3,2
10,298,298,11,11,0,1,0
6,338,338,22,14,8,2,1
22,340,340,39,8,31,2,1
29,353,353,5,5,0,1,0
5,372,372,16,16,0,1,0
23,375,375,4,4,0,1,0
18,391,391,4,4,0,1,0
24,436,436,24,1,23,2,1
9,476,476,6,6,0,1,0
17,493,493,9,9,0,1,0
3,493,493,57,57,0,1,0

18,109,109,12,12,0,1,0
14,123,123,20,20,0,1,0
4,130,130,11,11,0,1,0
10,145,145,2,2,0,1,0
9,157,157,7,7,0,1,0
26,166,166,29,2,27,4,3
32,173,173,4,4,0,1,0
24,175,175,16,2,14,3,2
30,194,194,5,2,3,2,1
12,205,205,14,14,0,1,0
34,205,205,17,7,10,3,2
35,222,222,6,2,4,2,1
0,223,223,37,37,0,1,0
29,243,243,2,2,0,1,0
5,265,265,21,21,0,1,0
28,265,265,34,34,0,1,0
23,269,269,125,72,53,4,3
2,277,277,20,11,9,2,1
7,277,277,2,2,0,1,0
19,288,288,30,4,26,3,2
22,300,300,2,2,0,1,0
3,307,307,5,5,0,1,0
33,315,315,54,16,38,2,1
8,316,316,26,19,7,2,1
6,325,325,10,10,0,1,0
11,326,326,55,11,44,2,1
15,335,335,2,2,0,1,0
25,363,363,1,1,0,1,0
31,373,373,1,1,0,1,0
13,385,385,4,4,0,1,0
20,417,417,1,1,0,1,0
27,428,428,93,23,70,3,2
21,434,434,39,39,0,1,0
1,454,454,19,19,0,1,0
17,479,479,1,1,0,1,0
16,484,484,18,18,0,1,0

13,106,106,11,11,0,1,0
14,109,109,3,3,0,1,0
6,121,121,1,1,0,1,0
4,160,160,16,16,0,1,0
10,167,167,12,12,0,1,0
8,177,177,3,3,0,1,0
18,180,180,17,17,0,1,0
7,184,184,1,1,0,1,0
19,198,198,11,11,0,1,0
20,208,208,49,18,31,4,3
11,208,208,14,5,9,4,3
16,209,209,11,4,7,2,1
24,211,211,6,6,0,1,0
1,241,241,1,1,0,1,0
9,254,254,136,136,0,1,0
3,282,282,10,10,0,1,0
5,285,285,106,64,42,4,3
0,325,325,77,77,0,1,0
12,345,345,29,21,8,3,2
23,355,355,33,33,0,1,0
15,390,390,3,3,0,1,0
22,429,429,157,157,0,1,0
17,438,438,76,17,59,4,3
2,478,478,8,5,3,2,1
21,488,488,21,21,0,1,0

18,102,102,4,4,0,1,0
19,121,121,2,2,0,1,0
4,135,135,38,38,0,1,0
0,140,140,11,11,0,1,0
6,144,144,36,8,28,2,1
3,149,149,39,9,30,2,1
13,165,165,11,11,0,1,0
23,189,189,29,19,10,2,1
22,192,192,24,24,0,1,0
2,195,195,56,42,14,3,2
12,217,217,26,26,0,1,0
9,258,258,20,20,0,1,0
16,267,267,51,51,0,1,0
8,283,283,4,4,0,1,0
7,301,301,26,6,20,4,3
14,325,325,113,51,62,4,3
15,341,341,4,4,0,1,0
11,356,356,34,34,0,1,0
17,399,399,23,7,16,3,2
10,411,411,22,22,0,1,0
5,419,419,2,2,0,1,0
20,422,422,26,26,0,1,0
1,474,474,29,29,0,1,0
21,475,475,46,46,0,1,0

17,116,116,8,8,0,1,0
13,119,119,5,5,0,1,0
25,137,137,4,4,0,1,0
8,167,167,2,2,0,1,0
5,190,190,28,17,11,3,2
4,216,216,30,30,0,1,0
12,236,236,33,33,0,1,0
10,238,238,4,4,0,1,0
20,245,245,4,4,0,1,0
7,275,275,113,13,100,3,2
0,333,333,13,13,0,1,0
16,346,346,25,9,16,3,2
22,378,378,8,2,6,3,2
15,388,388,58,58,0,1,0
21,425,425,11,7,4,2,1
2,428,428,76,76,0,1,0
6,450,450,68,24,44,4,3
11,456,456,14,2,12,3,2
23,469,469,34,34,0,1,0
19,470,470,12,4,8,3,2
18,473,473,150,150,0,1,0
24,473,473,114,114,0,1,0
3,474,474,17,10,7,2,1
14,482,482,102,74,28,3,2
1,485,485,17,17,0,1,0
9,485,485,100,79,21,4,3

18,113,113,1,1,0,1,0
1,137,137,9,2,7,2,1
20,172,172,8,8,0,1,0
0,214,214,22,8,14,2,1
6,234,234,51,30,21,2,1
26,251,251,3,3,0,1,0
25,254,254,34,6,28,3,2
12,262,262,12,4,8,2,1
17,280,280,124,88,36,4,3
2,292,292,11,11,0,1,0
5,293,293,18,18,0,1,0
21,298,298,41,5,36,2,1
19,299,299,27,27,0,1,0
14,312,312,6,6,0,1,0
9,329,329,68,68,0,1,0
27,363,363,47,47,0,1,0
22,367,367,1,1,0,1,0
10,367,367,46,37,9,2,1
24,384,384,70,70,0,1,0
8,385,385,22,6,16,3,2
23,405,405,28,8,20,2,1
4,406,406,43,17,26,2,1
15,451,451,35,35,0,1,0
11,463,463,13,1,12,4,3
3,477,477,15,7,8,3,2
13,480,480,80,80,0,1,0
7,483,483,72,72,0,1,0
16,488,488,35,14,21,2,1

6,100,100,1,1,0,1,0
7,109,109,1,1,0,1,0
5,112,112,5,1,4,2,1
13,116,116,12,12,0,1,0
2,119,119,13,13,0,1,0
9,127,127,19,19,0,1,0
27,129,129,31,31,0,1,0
0,139,139,14,5,9,4,3
8,142,142,4,1,3,2,1
4,149,149,7,7,0,1,0
32,182,182,25,25,0,1,0
11,204,204,3,3,0,1,0
3,215,215,1,1,0,1,0
14,227,227,23,23,0,1,0
16,240,240,9,9,0,1,0
1,246,246,32,32,0,1,0
15,262,262,3,3,0,1,0
24,335,335,39,20,19,2,1
21,343,343,5,2,3,2,1
33,348,348,20,20,0,1,0
31,355,355,14,14,0,1,0
20,358,358,79,40,39,4,3
26,363,363,22,22,0,1,0
18,375,375,10,10,0,1,0
29,382,382,30,30,0,1,0
17,412,412,85,79,6,3,2
30,418,418,2,2,0,1,0
12,420,420,13,1,12,4,3
10,446,446,52,34,18,4,3
19,446,446,53,41,12,4,3
25,482,482,29,14,15,2,1
22,488,488,31,21,10,2,1
28,488,488,131,103,28,3,2
23,493,493,28,28,0,1,0

30,110,110,8,2,6,3,2
5,112,112,19,4,15,4,3
21,149,149,13,7,6,2,1
14,152,152,1,1,0,1,0
2,154,154,1,1,0,1,0
8,155,155,1,1,0,1,0
28,204,204,35,35,0,1,0
24,206,206,53,50,3,2,1
13,226,226,3,3,0,1,0
32,233,233,4,1,3,2,1
20,291,291,26,16,10,2,1
18,295,295,17,17,0,1,0
11,301,301,23,23,0,1,0
34,302,302,42,30,12,4,3
16,307,307,50,50,0,1,0
1,316,316,23,5,18,3,2
12,319,319,6,6,0,1,0
6,328,328,32,13,19,2,1
35,330,330,25,20,5,2,1
29,337,337,3,3,0,1,0
4,342,342,21,1,20,4,3
26,343,343,2,2,0,1,0
7,348,348,3,3,0,1,0
9,361,361,1,1,0,1,0
17,389,389,39,39,0,1,0
19,400,400,26,26,0,1,0
27,401,401,37,37,0,1,0
22,403,403,2,2,0,1,0
15,404,404,34,26,8,2,1
23,410,410,37,22,15,4,3
0,449,449,45,45,0,1,0
31,470,470,82,46,36,4,3
3,471,471,32,3,29,3,2
25,487,487,32,32,0,1,0
33,495,495,124,90,34,3,2
10,498,498,25,25,0,1,0

14,111,111,33,23,10,2,1
19,138,138,8,2,6,2,1
23,142,142,3,3,0,1,0
26,148,148,27,17,10,3,2
4,152,152,1,1,0,1,0
7,153,153,11,11,0,1,0
11,161,161,46,46,0,1,0
12,210,210,20,20,0,1,0
27,224,224,22,22,0,1,0
17,225,225,12,12,0,1,0
21,233,233,12,5,7,2,1
6,265,265,8,8,0,1,0
1,291,291,4,4,0,1,0
2,292,292,42,2,40,2,1
15,321,321,9,9,0,1,0
5,325,325,9,9,0,1,0
18,341,341,2,2,0,1,0
16,352,352,194,173,21,4,3
20,402,402,15,3,12,3,2
9,405,405,33,21,12,2,1
8,438,438,31,21,10,2,1
25,456,456,1,1,0,1,0
10,458,458,80,9,71,4,3
3,464,464,64,3,61,4,3
24,471,471,18,18,0,1,0
0,483,483,107,107,0,1,0
13,484,484,19,19,0,1,0
22,484,484,2,2,0,1,0

6,127,127,19,11,8,3,2
2,142,142,37,15,22,3,2
13,144,144,4,1,3,2,1
21,163,163,3,3,0,1,0
1,180,180,4,4,0,1,0
4,208,208,5,1,4,2,1
11,218,218,42,42,0,1,0
16,222,222,59,32,27,4,3
14,230,230,28,10,18,2,1
12,248,248,33,33,0,1,0
9,261,261,31,15,16,4,3
15,290,290,14,14,0,1,0
0,307,307,18,4,14,3,2
23,322,322,33,2,31,2,1
22,341,341,15,7,8,3,2
5,365,365,80,34,46,3,2
19,368,368,5,1,4,2,1
3,388,388,9,9,0,1,0
7,467,467,179,142,37,3,2
18,468,468,40,40,0,1,0
8,476,476,68,68,0,1,0
20,476,476,65,11,54,3,2
17,483,483,69,69,0,1,0
10,493,493,42,42,0,1,0

8,106,106,6,2,4,2,1
36,124,124,6,6,0,1,0
3,135,135,9,9,0,1,0
24,150,150,4,4,0,1,0
7,170,170,6,2,4,2,1
31,172,172,19,1,18,3,2
27,179,179,24,24,0,1,0
22,182,182,18,5,13,2,1
4,184,184,24,2,22,4,3
29,193,193,22,22,0,1,0
18,209,209,6,6,0,1,0
9,209,209,1,1,0,1,0
5,243,243,20,10,10,2,1
37,248,248,53,53,0,1,0
16,256,256,3,3,0,1,0
33,280,280,14,14,0,1,0
15,282,282,13,4,9,2,1
11,295,295,7,7,0,1,0
26,299,299,82,42,40,3,2
6,309,309,47,4,43,4,3
23,329,329,13,7,6,3,2
12,329,329,46,22,24,4,3
35,353,353,39,27,12,2,1
17,354,354,10,10,0,1,0
34,363,363,11,5,6,3,2
14,366,366,3,3,0,1,0
21,367,367,2,2,0,1,0
28,377,377,4,4,0,1,0
38,392,392,51,21,30,4,3
19,415,415,46,34,12,2,1
32,418,418,47,34,13,3,2
30,426,426,23,23,0,1,0
20,446,446,10,10,0,1,0
0,451,451,3,3,0,1,0
2,466,466,12,12,0,1,0
1,470,470,33,33,0,1,0
39,479,479,15,15,0,1,0
25,488,488,25,14,11,2,1
10,493,493,28,28,0,1,0
13,497,497,36,30,6,3,2

4,103,103,2,2,0,1,0
11,122,122,14,14,0,1,0
23,126,126,17,17,0,1,0
17,133,133,6,6,0,1,0
27,134,134,2,2,0,1,0
24,134,134,2,2,0,1,0
14,143,143,27,15,12,3,2
8,164,164,4,4,0,1,0
22,179,179,11,5,6,2,1
3,180,180,63,37,26,3,2
1,190,190,9,9,0,1,0
28,198,198,10,10,0,1,0
5,233,233,7,2,5,2,1
25,248,248,11,6,5,2,1
26,248,248,88,88,0,1,0
21,256,256,48,48,0,1,0
6,288,288,20,20,0,1,0
19,301,301,11,11,0,1,0
13,331,331,13,5,8,2,1
15,338,338,2,2,0,1,0
18,356,356,106,10,96,3,2
20,391,391,68,68,0,1,0
10,410,410,129,95,34,2,1
0,410,410,1,1,0,1,0
16,426,426,1,1,0,1,0
12,443,443,67,17,50,3,2
2,454,454,4,4,0,1,0
7,481,481,14,9,5,2,1
9,492,492,7,7,0,1,0

26,101,101,3,3,0,1,0
15,103,103,7,2,5,2,1
14,111,111,7,7,0,1,0
27,122,122,10,10,0,1,0
10,123,123,7,7,0,1,0
12,128,128,28,28,0,1,0
9,132,132,8,8,0,1,0
0,143,143,9,3,6,2,1
30,144,144,5,5,0,1,0
4,174,174,44,44,0,1,0
7,202,202,10,6,4,2,1
3,223,223,13,1,12,2,1
28,235,235,14,14,0,1,0
17,301,301,2,2,0,1,0
13,317,317,7,1,6,2,1
6,322,322,9,5,4,2,1
2,325,325,4,4,0,1,0
22,327,327,5,2,3,2,1
5,349,349,15,15,0,1,0
20,358,358,63,63,0,1,0
19,367,367,18,18,0,1,0
25,420,420,88,61,27,2,1
23,431,431,54,36,18,4,3
21,433,433,4,1,3,2,1
33,436,436,101,64,37,2,1
16,448,448,28,28,0,1,0
8,471,471,82,82,0,1,0
29,473,473,53,11,42,3,2
18,480,480,13,13,0,1,0
1,483,483,39,28,11,2,1
11,483,483,3,3,0,1,0
32,489,489,90,35,55,4,3
31,491,491,68,12,56,3,2
24,494,494,13,13,0,1,0

21,107,107,2,2,0,1,0
12,110,110,17,17,0,1,0
13,125,125,12,7,5,2,1
7,136,136,26,18,8,3,2
15,200,200,10,10,0,1,0
10,207,207,101,101,0,1,0
19,207,207,1,1,0,1,0
1,235,235,62,53,9,4,3
6,255,255,48,48,0,1,0
14,258,258,3,3,0,1,0
5,267,267,53,53,0,1,0
16,279,279,45,30,15,4,3
18,317,317,1,1,0,1,0
2,347,347,62,62,0,1,0
0,360,360,23,23,0,1,0
4,399,399,10,1,9,4,3
22,408,408,10,5,5,2,1
17,410,410,72,72,0,1,0
8,419,419,44,20,24,2,1
3,421,421,79,51,28,2,1
11,436,436,30,6,24,2,1
20,436,436,66,15,51,3,2
9,444,444,10,10,0,1,0

27,103,103,3,3,0,1,0
18,134,134,1,1,0,1,0
0,141,141,21,3,18,3,2
17,152,152,30,30,0,1,0
13,156,156,38,38,0,1,0
8,160,160,12,12,0,1,0
26,163,163,4,4,0,1,0
16,187,187,2,2,0,1,0
2,190,190,3,3,0,1,0
30,203,203,55,55,0,1,0
25,225,225,30,16,14,3,2
23,226,226,12,12,0,1,0
1,260,260,9,1,8,3,2
11,285,285,2,2,0,1,0
15,300,300,8,5,3,2,1
9,305,305,12,4,8,3,2
5,319,319,72,72,0,1,0
3,320,320,5,5,0,1,0
20,321,321,62,50,12,3,2
12,327,327,62,62,0,1,0
6,332,332,49,5,44,2,1
29,334,334,23,15,8,3,2
19,354,354,4,4,0,1,0
4,364,364,13,9,4,2,1
7,389,389,26,26,0,1,0
21,404,404,6,6,0,1,0
14,414,414,7,7,0,1,0
22,468,468,153,150,3,2,1
28,473,473,19,4,15,2,1
10,479,479,49,11,38,2,1
24,499,499,30,30,0,1,0

4,112,112,1,1,0,1,0
28,114,114,7,7,0,1,0
9,126,126,4,1,3,2,1
1,130,130,2,2,0,1,0
24,169,169,5,2,3,2,1
3,171,171,15,4,11,2,1
22,183,183,12,4,8,2,1
8,214,214,14,14,0,1,0
2,220,220,11,11,0,1,0
19,238,238,24,10,14,3,2
20,243,243,5,5,0,1,0
10,274,274,13,13,0,1,0
7,278,278,3,3,0,1,0
6,285,285,62,62,0,1,0
17,324,324,2,2,0,1,0
21,324,324,17,17,0,1,0
26,339,339,122,84,38,2,1
31,373,373,19,19,0,1,0
11,404,404,9,9,0,1,0
12,405,405,71,28,43,2,1
15,407,407,55,55,0,1,0
27,409,409,71,47,24,3,2
16,411,411,14,14,0,1,0
32,414,414,40,4,36,2,1
14,415,415,75,59,16,2,1
23,438,438,26,16,10,2,1
29,439,439,27,27,0,1,0
30,453,453,96,96,0,1,0
25,456,456,38,4,34,3,2
0,468,468,25,25,0,1,0
5,474,474,2,2,0,1,0
18,479,479,38,26,12,3,2
13,486,486,85,5,80,4,3

8,113,113,8,8,0,1,0
5,118,118,32,2,30,2,1
10,133,133,7,7,0,1,0
15,145,145,4,4,0,1,0
0,157,157,41,41,0,1,0
12,169,169,25,25,0,1,0
9,192,192,8,8,0,1,0
22,207,207,16,12,4,2,1
21,232,232,23,14,9,4,3
14,276,276,32,4,28,3,2
13,279,279,42,38,4,2,1
17,306,306,26,26,0,1,0
6,312,312,151,151,0,1,0
18,341,341,7,7,0,1,0
19,395,395,1,1,0,1,0
1,408,408,3,3,0,1,0
3,422,422,24,24,0,1,0
2,442,442,55,8,47,2,1
16,444,444,159,92,67,4,3
20,452,452,92,29,63,4,3
7,464,464,30,30,0,1,0
4,486,486,30,18,12,2,1
11,493,493,23,23,0,1,0

11,122,122,6,6,0,1,0
10,159,159,20,12,8,2,1
30,162,162,15,15,0,1,0
9,173,173,9,9,0,1,0
17,186,186,9,9,0,1,0
5,186,186,1,1,0,1,0
25,193,193,32,9,23,2,1
24,195,195,10,10,0,1,0
19,198,198,7,4,3,2,1
16,198,198,15,15,0,1,0
3,215,215,8,4,4,2,1
26,222,222,87,66,21,4,3
27,232,232,9,9,0,1,0
14,240,240,26,1,25,2,1
0,241,241,35,3,32,2,1
2,243,243,1,1,0,1,0
28,264,264,9,2,7,2,1
18,265,265,2,2,0,1,0
1,272,272,20,4,16,3,2
20,272,272,19,4,15,4,3
21,275,275,23,23,0,1,0
31,293,293,71,51,20,2,1
23,334,334,8,8,0,1,0
13,342,342,19,19,0,1,0
6,368,368,20,2,18,2,1
12,370,370,13,4,9,4,3
4,376,376,24,6,18,3,2
29,389,389,42,42,0,1,0
22,427,427,36,4,32,2,1
8,438,438,57,9,48,3,2
15,463,463,79,54,25,2,1
7,470,470,79,79,0,1,0

5,121,121,2,2,0,1,0
27,127,127,48,48,0,1,0
19,129,129,15,4,11,2,1
13,143,143,1,1,0,1,0
30,144,144,7,3,4,2,1
23,156,156,14,14,0,1,0
24,192,192,63,60,3,2,1
29,213,213,4,1,3,2,1
9,214,214,10,10,0,1,0
3,224,224,54,3,51,3,2
10,233,233,43,35,8,2,1
25,236,236,13,8,5,2,1
0,246,246,4,4,0,1,0
17,248,248,22,22,0,1,0
2,254,254,1,1,0,1,0
21,255,255,14,14,0,1,0
26,267,267,10,10,0,1,0
22,274,274,13,13,0,1,0
12,292,292,21,21,0,1,0
20,293,293,21,21,0,1,0
1,306,306,19,19,0,1,0
16,326,326,33,33,0,1,0
28,387,387,11,11,0,1,0
8,412,412,36,27,9,2,1
14,418,418,3,3,0,1,0
11,418,418,26,4,22,2,1
15,427,427,53,25,28,3,2
18,447,447,33,23,10,2,1
6,449,449,50,50,0,1,0
7,468,468,4,1,3,2,1
4,492,492,122,65,57,4,3

24,117,117,1,1,0,1,0
14,161,161,4,4,0,1,0
3,164,164,1,1,0,1,0
25,185,185,19,19,0,1,0
16,191,191,18,18,0,1,0
27,197,197,3,3,0,1,0
20,201,201,1,1,0,1,0
5,209,209,41,41,0,1,0
6,212,212,43,43,0,1,0
2,280,280,33,33,0,1,0
23,298,298,9,6,3,2,1
15,312,312,102,66,36,2,1
7,332,332,60,3,57,4,3
17,341,341,71,53,18,4,3
21,358,358,18,18,0,1,0
9,368,368,88,19,69,4,3
12,372,372,3,3,0,1,0
22,377,377,100,91,9,2,1
26,414,414,90,90,0,1,0
0,414,414,36,36,0,1,0
1,419,419,13,13,0,1,0
13,437,437,38,38,0,1,0
4,439,439,26,23,3,2,1
11,464,464,41,23,18,4,3
18,468,468,4,4,0,1,0
8,476,476,8,8,0,1,0
10,495,495,40,40,0,1,0
19,495,495,34,34,0,1,0

3,124,124,1,1,0,1,0
17,128,128,15,3,12,2,1
26,142,142,20,20,0,1,0
10,148,148,2,2,0,1,0
9,152,152,29,29,0,1,0
31,193,193,20,20,0,1,0
11,208,208,12,12,0,1,0
12,215,215,8,2,6,2,1
6,217,217,2,2,0,1,0
5,221,221,1,1,0,1,0
1,320,320,14,8,6,2,1
18,320,320,1,1,0,1,0
20,339,339,29,29,0,1,0
30,342,342,19,19,0,1,0
7,344,344,54,2,52,3,2
14,345,345,18,2,16,2,1
16,349,349,25,11,14,2,1
33,349,349,3,3,0,1,0
25,350,350,72,54,18,2,1
15,373,373,29,29,0,1,0
32,375,375,17,17,0,1,0
24,378,378,3,3,0,1,0
13,384,384,32,18,14,3,2
8,402,402,59,11,48,4,3
2,425,425,21,1,20,3,2
22,436,436,65,65,0,1,0
4,439,439,42,42,0,1,0
27,448,448,105,17,88,4,3
0,454,454,63,15,48,4,3
21,477,477,32,32,0,1,0
28,484,484,55,55,0,1,0
19,485,485,21,11,10,3,2
29,491,491,42,8,34,3,2
23,498,498,59,59,0,1,0

5,110,110,4,1,3,2,1
16,113,113,3,3,0,1,0
4,149,149,48,26,22,4,3
20,170,170,34,1,33,4,3
15,248,248,23,12,11,2,1
6,263,263,78,78,0,1,0
9,296,296,32,32,0,1,0
0,302,302,2,2,0,1,0
13,302,302,21,21,0,1,0
8,336,336,55,55,0,1,0
3,349,349,8,8,0,1,0
11,361,361,46,46,0,1,0
1,361,361,174,129,45,4,3
14,392,392,128,30,98,3,2
12,395,395,4,4,0,1,0
17,451,451,21,21,0,1,0
19,468,468,5,1,4,2,1
2,478,478,7,7,0,1,0
7,484,484,106,73,33,4,3
10,486,486,90,90,0,1,0
18,493,493,6,6,0,1,0
21,494,494,23,23,0,1,0

18,106,106,5,5,0,1,0
3,109,109,16,16,0,1,0
8,123,123,3,3,0,1,0
4,132,132,41,41,0,1,0
24,173,173,9,9,0,1,0
16,177,177,19,13,6,2,1
21,190,190,20,5,15,2,1
23,197,197,19,19,0,1,0
6,199,199,8,8,0,1,0
22,228,228,44,44,0,1,0
14,243,243,78,38,40,3,2
5,256,256,36,36,0,1,0
7,332,332,8,1,7,2,1
10,335,335,50,9,41,2,1
20,354,354,48,44,4,2,1
26,373,373,25,25,0,1,0
13,390,390,17,17,0,1,0
9,395,395,18,18,0,1,0
11,415,415,87,87,0,1,0
2,416,416,18,14,4,2,1
1,420,420,22,22,0,1,0
19,425,425,4,1,3,2,1
25,427,427,14,14,0,1,0
12,436,436,27,27,0,1,0
15,443,443,71,60,11,3,2
0,454,454,69,59,10,3,2
17,472,472,30,22,8,3,2

29,103,103,8,2,6,2,1
16,103,103,12,4,8,3,2
22,116,116,3,3,0,1,0
17,121,121,1,1,0,1,0
15,123,123,2,2,0,1,0
21,132,132,4,4,0,1,0
20,134,134,4,4,0,1,0
31,145,145,28,4,24,3,2
6,158,158,2,2,0,1,0
37,180,180,42,12,30,4,3
7,185,185,12,12,0,1,0
2,206,206,23,4,19,2,1
4,221,221,1,1,0,1,0
14,229,229,36,36,0,1,0
11,232,232,3,3,0,1,0
33,248,248,54,54,0,1,0
9,274,274,44,20,24,2,1
19,276,276,16,16,0,1,0
8,289,289,33,33,0,1,0
35,289,289,10,7,3,2,1
36,299,299,12,1,11,4,3
5,308,308,16,6,10,3,2
34,318,318,57,9,48,2,1
24,320,320,21,3,18,4,3
12,353,353,37,10,27,2,1
10,376,376,30,30,0,1,0
28,386,386,28,28,0,1,0
13,418,418,12,12,0,1,0
3,431,431,20,20,0,1,0
26,432,432,13,13,0,1,0
30,444,444,2,2,0,1,0
27,452,452,26,14,12,4,3
1,466,466,8,8,0,1,0
23,470,470,13,13,0,1,0
25,476,476,59,31,28,3,2
18,486,486,40,28,12,3,2
32,492,492,48,48,0,1,0
0,494,494,19,2,17,2,1

0,106,106,2,2,0,1,0
18,114,114,13,1,12,2,1
20,120,120,22,22,0,1,0
13,142,142,5,5,0,1,0
6,157,157,25,6,19,2,1
21,158,158,5,5,0,1,0
5,180,180,29,29,0,1,0
24,191,191,5,5,0,1,0
8,204,204,22,22,0,1,0
17,230,230,1,1,0,1,0
7,242,242,33,17,16,2,1
11,255,255,5,5,0,1,0
14,273,273,5,5,0,1,0
4,283,283,9,2,7,2,1
2,290,290,85,13,72,3,2
26,321,321,3,3,0,1,0
25,334,334,37,37,0,1,0
12,336,336,26,26,0,1,0
10,337,337,4,4,0,1,0
19,360,360,125,55,70,4,3
9,361,361,12,12,0,1,0
23,385,385,2,2,0,1,0
16,404,404,5,5,0,1,0
28,406,406,31,31,0,1,0
1,442,442,120,58,62,4,3
3,445,445,12,4,8,3,2
22,447,447,188,147,41,2,1
27,450,450,33,23,10,3,2
15,493,493,12,12,0,1,0

22,109,109,5,5,0,1,0
3,120,120,1,1,0,1,0
6,125,125,1,1,0,1,0
19,135,135,14,2,12,2,1
23,138,138,18,13,5,2,1
7,143,143,14,7,7,2,1
13,196,196,1,1,0,1,0
8,208,208,57,57,0,1,0
20,215,215,14,7,7,2,1
21,231,231,11,11,0,1,0
17,238,238,24,24,0,1,0
9,260,260,99,75,24,3,2
4,273,273,19,1,18,2,1
18,345,345,56,56,0,1,0
1,348,348,10,10,0,1,0
14,387,387,79,79,0,1,0
12,399,399,55,22,33,2,1
0,408,408,89,40,49,2,1
10,413,413,6,6,0,1,0
11,429,429,82,36,46,4,3
16,455,455,2,2,0,1,0
2,461,461,125,23,102,4,3
5,485,485,22,22,0,1,0
15,492,492,105,105,0,1,0

18,115,115,3,3,0,1,0
13,126,126,9,6,3,2,1
24,126,126,2,2,0,1,0
17,140,140,6,6,0,1,0
7,144,144,25,2,23,2,1
11,156,156,7,7,0,1,0
14,160,160,1,1,0,1,0
20,178,178,43,43,0,1,0
10,198,198,14,8,6,3,2
5,207,207,13,4,9,2,1
28,208,208,21,21,0,1,0
8,208,208,6,2,4,2,1
2,213,213,3,3,0,1,0
12,226,226,1,1,0,1,0
19,238,238,31,8,23,2,1
0,240,240,1,1,0,1,0
21,260,260,5,5,0,1,0
36,270,270,29,3,26,3,2
9,277,277,6,1,5,2,1
23,278,278,12,5,7,2,1
4,293,293,8,8,0,1,0
22,311,311,5,5,0,1,0
29,324,324,7,7,0,1,0
34,333,333,137,93,44,3,2
27,340,340,5,5,0,1,0
31,366,366,8,8,0,1,0
1,383,383,36,36,0,1,0
33,390,390,1,1,0,1,0
30,392,392,32,32,0,1,0
26,422,422,51,51,0,1,0
6,431,431,50,6,44,2,1
16,436,436,38,38,0,1,0
32,446,446,28,28,0,1,0
15,453,453,19,19,0,1,0
3,455,455,6,6,0,1,0
35,462,462,30,30,0,1,0
37,470,470,54,31,23,2,1
25,488,488,136,126,10,2,1

22,115,115,3,3,0,1,0
4,116,116,2,2,0,1,0
11,130,130,3,3,0,1,0
16,152,152,14,4,10,3,2
7,154,154,16,16,0,1,0
9,275,275,23,3,20,3,2
3,288,288,67,58,9,2,1
25,297,297,7,7,0,1,0
13,320,320,70,29,41,2,1
26,330,330,15,15,0,1,0
1,330,330,24,14,10,2,1
5,346,346,19,7,12,2,1
20,353,353,17,17,0,1,0
18,368,368,33,6,27,4,3
17,373,373,59,59,0,1,0
10,379,379,28,28,0,1,0
12,387,387,43,8,35,2,1
15,406,406,73,73,0,1,0
8,407,407,6,6,0,1,0
0,423,423,125,68,57,4,3
14,428,428,145,94,51,4,3
24,429,429,14,7,7,2,1
21,442,442,20,20,0,1,0
19,448,448,33,33,0,1,0
2,468,468,138,84,54,4,3
23,476,476,24,17,7,2,1
6,499,499,11,2,9,4,3

17,100,100,24,24,0,1,0
9,153,153,18,18,0,1,0
7,155,155,6,6,0,1,0
27,158,158,2,2,0,1,0
16,168,168,6,6,0,1,0
24,173,173,48,48,0,1,0
1,177,177,22,10,12,2,1
15,184,184,5,2,3,2,1
23,190,190,41,8,33,3,2
12,208,208,9,1,8,3,2
3,221,221,11,11,0,1,0
21,233,233,12,12,0,1,0
0,246,246,8,8,0,1,0
28,252,252,51,35,16,3,2
25,254,254,32,2,30,4,3
11,260,260,4,4,0,1,0
20,271,271,28,6,22,2,1
32,280,280,16,16,0,1,0
29,296,296,25,14,11,2,1
6,296,296,3,3,0,1,0
14,321,321,49,49,0,1,0
30,326,326,1,1,0,1,0
13,370,370,5,5,0,1,0
4,376,376,5,5,0,1,0
8,395,395,75,25,50,3,2
19,419,419,14,14,0,1,0
10,430,430,22,22,0,1,0
26,443,443,16,4,12,4,3
2,452,452,29,17,12,2,1
31,456,456,3,3,0,1,0
22,458,458,97,97,0,1,0
5,494,494,15,15,0,1,0
18,500,500,76,76,0,1,0

22,138,138,6,6,0,1,0
24,139,139,26,4,22,2,1
0,150,150,15,2,13,3,2
20,157,157,20,20,0,1,0
3,159,159,9,9,0,1,0
15,167,167,12,8,4,2,1
13,170,170,32,23,9,4,3
21,170,170,6,6,0,1,0
25,186,186,18,18,0,1,0
12,190,190,6,6,0,1,0
5,193,193,3,3,0,1,0
30,197,197,55,55,0,1,0
6,205,205,18,18,0,1,0
4,206,206,15,15,0,1,0
23,222,222,31,31,0,1,0
29,236,236,9,9,0,1,0
18,240,240,5,5,0,1,0
1,250,250,9,9,0,1,0
8,277,277,35,35,0,1,0
27,286,286,33,24,9,2,1
19,294,294,27,27,0,1,0
17,297,297,8,8,0,1,0
7,322,322,11,11,0,1,0
16,329,329,23,23,0,1,0
31,332,332,5,2,3,2,1
9,416,416,49,34,15,2,1
2,417,417,12,12,0,1,0
10,432,432,107,38,69,4,3
32,447,447,60,47,13,2,1
28,458,458,41,28,13,2,1
26,468,468,15,15,0,1,0
14,484,484,6,6,0,1,0
11,491,491,27,27,0,1,0

20,105,105,1,1,0,1,0
2,128,128,54,16,38,3,2
16,132,132,2,2,0,1,0
4,145,145,11,11,0,1,0
7,154,154,14,2,12,3,2
11,163,163,26,15,11,2,1
24,175,175,37,37,0,1,0
3,216,216,1,1,0,1,0
6,220,220,26,16,10,2,1
14,246,246,13,5,8,2,1
18,249,249,45,5,40,2,1
12,250,250,12,4,8,2,1
10,252,252,3,3,0,1,0
22,275,275,1,1,0,1,0
23,278,278,44,44,0,1,0
1,290,290,2,2,0,1,0
25,304,304,35,35,0,1,0
8,305,305,25,14,11,2,1
27,355,355,5,2,3,2,1
17,368,368,16,16,0,1,0
9,380,380,61,61,0,1,0
5,381,381,1,1,0,1,0
15,415,415,53,35,18,2,1
26,425,425,146,74,72,3,2
21,463,463,16,16,0,1,0
13,472,472,63,63,0,1,0
19,478,478,58,58,0,1,0
0,486,486,41,41,0,1,0

10,116,116,13,6,7,2,1
8,117,117,12,8,4,2,1
15,130,130,14,9,5,2,1
21,150,150,6,6,0,1,0
20,151,151,11,11,0,1,0
1,170,170,23,4,19,2,1
11,179,179,25,20,5,2,1
23,181,181,1,1,0,1,0
3,184,184,24,4,20,2,1
0,217,217,8,8,0,1,0
9,225,225,51,27,24,2,1
14,236,236,5,1,4,2,1
7,240,240,1,1,0,1,0
5,243,243,4,4,0,1,0
6,285,285,13,13,0,1,0
22,295,295,12,12,0,1,0
12,341,341,118,58,60,3,2
13,385,385,88,46,42,4,3
19,402,402,12,3,9,4,3
17,420,420,5,5,0,1,0
4,421,421,181,155,26,2,1
2,429,429,118,107,11,2,1
16,442,442,31,31,0,1,0
18,498,498,102,102,0,1,0

20,110,110,12,12,0,1,0
16,143,143,1,1,0,1,0
23,148,148,14,14,0,1,0
22,152,152,11,11,0,1,0
11,159,159,23,23,0,1,0
18,176,176,7,2,5,2,1
7,205,205,49,49,0,1,0
8,210,210,101,77,24,3,2
6,219,219,37,37,0,1,0
19,237,237,7,7,0,1,0
3,240,240,17,17,0,1,0
17,242,242,22,22,0,1,0
10,279,279,25,25,0,1,0
1,308,308,4,4,0,1,0
9,317,317,32,32,0,1,0
5,353,353,10,10,0,1,0
0,353,353,52,34,18,2,1
12,356,356,25,25,0,1,0
2,360,360,21,7,14,2,1
4,367,367,35,35,0,1,0
14,432,432,120,111,9,2,1
15,442,442,35,17,18,4,3
13,475,475,10,2,8,2,1
21,485,485,149,99,50,3,2

17,102,102,6,1,5,2,1
13,106,106,8,3,5,2,1
9,126,126,2,2,0,1,0
14,127,127,18,12,6,3,2
12,130,130,4,4,0,1,0
22,166,166,47,24,23,2,1
2,195,195,11,11,0,1,0
21,198,198,9,9,0,1,0
5,234,234,23,5,18,4,3
11,234,234,35,35,0,1,0
10,264,264,7,3,4,2,1
25,269,269,17,17,0,1,0
7,274,274,39,18,21,2,1
1,300,300,25,1,24,2,1
0,307,307,19,5,14,3,2
8,323,323,12,12,0,1,0
15,387,387,64,2,62,3,2
3,399,399,85,85,0,1,0
4,401,401,74,22,52,3,2
16,403,403,42,42,0,1,0
6,418,418,140,79,61,3,2
19,450,450,12,12,0,1,0
23,451,451,18,1,17,2,1
18,454,454,34,3,31,2,1
20,487,487,79,63,16,3,2
24,493,493,77,38,39,2,1

17,104,104,10,1,9,2,1
11,126,126,1,1,0,1,0
25,130,130,20,20,0,1,0
18,148,148,8,8,0,1,0
12,155,155,5,5,0,1,0
6,156,156,19,1,18,2,1
15,163,163,28,10,18,4,3
7,166,166,7,7,0,1,0
21,166,166,25,25,0,1,0
19,195,195,60,60,0,1,0
4,202,202,14,9,5,2,1
13,208,208,46,1,45,4,3
23,210,210,6,6,0,1,0
14,234,234,7,2,5,2,1
5,243,243,47,47,0,1,0
10,261,261,31,31,0,1,0
16,269,269,8,2,6,2,1
0,285,285,5,5,0,1,0
8,293,293,84,28,56,3,2
9,298,298,92,27,65,4,3
1,342,342,1,1,0,1,0
24,351,351,28,1,27,2,1
3,386,386,59,59,0,1,0
22,422,422,11,11,0,1,0
2,450,450,38,38,0,1,0
20,474,474,24,24,0,1,0

14,116,116,1,1,0,1,0
0,133,133,2,2,0,1,0
1,155,155,1,1,0,1,0
18,197,197,22,22,0,1,0
6,206,206,9,9,0,1,0
17,215,215,1,1,0,1,0
5,237,237,9,9,0,1,0
3,239,239,30,30,0,1,0
29,246,246,8,8,0,1,0
23,254,254,34,10,24,2,1
7,258,258,25,10,15,4,3
28,265,265,12,12,0,1,0
16,298,298,20,20,0,1,0
20,303,303,4,4,0,1,0
15,312,312,64,14,50,3,2
24,319,319,100,43,57,4,3
13,319,319,13,13,0,1,0
25,321,321,53,53,0,1,0
9,348,348,125,60,65,3,2
19,356,356,5,5,0,1,0
10,367,367,12,1,11,2,1
2,373,373,58,58,0,1,0
27,374,374,51,18,33,4,3
11,379,379,3,3,0,1,0
8,385,385,26,26,0,1,0
21,396,396,94,22,72,4,3
4,402,402,44,10,34,3,2
12,430,430,39,7,32,3,2
26,482,482,24,24,0,1,0
22,487,487,50,50,0,1,0

8,102,102,12,12,0,1,0
5,132,132,4,4,0,1,0
11,137,137,1,1,0,1,0
21,155,155,44,44,0,1,0
16,193,193,36,36,0,1,0
25,202,202,2,2,0,1,0
18,219,219,11,6,5,2,1
23,228,228,8,8,0,1,0
2,232,232,67,67,0,1,0
3,254,254,72,21,51,4,3
26,267,267,6,3,3,2,1
20,293,293,13,13,0,1,0
19,297,297,4,4,0,1,0
4,298,298,15,15,0,1,0
13,310,310,134,50,84,4,3
17,352,352,31,31,0,1,0
12,357,357,10,2,8,2,1
0,387,387,40,40,0,1,0
15,388,388,12,12,0,1,0
9,393,393,47,27,20,2,1
1,408,408,73,73,0,1,0
7,410,410,22,22,0,1,0
22,438,438,34,34,0,1,0
10,453,453,38,11,27,2,1
6,454,454,25,13,12,4,3
14,463,463,63,7,56,3,2
24,496,496,8,1,7,2,1

13,122,122,14,2,12,2,1
28,134,134,11,11,0,1,0
5,136,136,30,2,28,2,1
18,164,164,21,21,0,1,0
10,184,184,12,12,0,1,0
22,186,186,25,9,16,2,1
12,187,187,15,15,0,1,0
17,206,206,17,5,12,4,3
9,226,226,46,5,41,4,3
26,226,226,31,31,0,1,0
11,229,229,6,6,0,1,0
25,245,245,1,1,0,1,0
3,273,273,11,5,6,2,1
6,283,283,31,31,0,1,0
16,296,296,85,9,76,3,2
15,301,301,1,1,0,1,0
7,306,306,1,1,0,1,0
20,308,308,81,81,0,1,0
19,312,312,10,10,0,1,0
23,332,332,50,50,0,1,0
4,333,333,90,90,0,1,0
0,342,342,7,7,0,1,0
8,381,381,2,2,0,1,0
2,415,415,12,2,10,2,1
21,431,431,20,4,16,3,2
27,436,436,8,1,7,2,1
1,442,442,73,73,0,1,0
14,446,446,21,21,0,1,0
24,485,485,30,16,14,3,2

26,129,129,3,3,0,1,0
27,133,133,11,8,3,2,1
11,168,168,13,1,12,4,3
5,172,172,2,2,0,1,0
13,183,183,18,3,15,2,1
21,192,192,40,25,15,4,3
23,196,196,5,5,0,1,0
6,225,225,17,1,16,3,2
24,239,239,2,2,0,1,0
9,279,279,40,12,28,3,2
14,301,301,13,7,6,2,1
7,350,350,2,2,0,1,0
15,367,367,31,1,30,4,3
16,369,369,54,54,0,1,0
28,377,377,10,2,8,3,2
3,384,384,30,15,15,2,1
4,385,385,3,3,0,1,0
2,399,399,27,9,18,3,2
22,403,403,2,2,0,1,0
10,414,414,16,16,0,1,0
19,415,415,131,69,62,4,3
1,443,443,61,21,40,2,1
18,451,451,66,54,12,2,1
0,463,463,193,83,110,4,3
25,463,463,10,2,8,3,2
12,473,473,52,52,0,1,0
20,475,475,97,51,46,3,2
8,481,481,43,9,34,4,3
17,482,482,62,62,0,1,0

24,106,106,30,30,0,1,0
26,128,128,25,25,0,1,0
6,129,129,2,2,0,1,0
7,134,134,2,2,0,1,0
1,141,141,23,11,12,3,2
22,169,169,14,14,0,1,0
5,180,180,10,10,0,1,0
8,200,200,51,1,50,3,2
12,209,209,15,15,0,1,0
13,240,240,6,6,0,1,0
25,260,260,29,4,25,2,1
18,261,261,41,20,21,2,1
20,264,264,25,25,0,1,0
16,282,282,28,15,13,2,1
10,299,299,35,23,12,4,3
9,305,305,78,50,28,3,2
23,317,317,6,6,0,1,0
14,318,318,4,4,0,1,0
3,332,332,33,33,0,1,0
15,333,333,39,39,0,1,0
11,341,341,1,1,0,1,0
4,378,378,21,21,0,1,0
21,386,386,21,21,0,1,0
19,401,401,14,14,0,1,0
0,416,416,40,35,5,2,1
17,446,446,53,53,0,1,0
2,463,463,80,67,13,2,1
27,469,469,26,26,0,1,0

2,104,104,1,1,0,1,0
29,113,113,13,13,0,1,0
16,114,114,3,3,0,1,0
30,122,122,2,2,0,1,0
5,127,127,16,16,0,1,0
26,131,131,20,20,0,1,0
19,155,155,25,25,0,1,0
22,163,163,5,5,0,1,0
31,164,164,14,7,7,2,1
1,174,174,6,6,0,1,0
8,189,189,24,24,0,1,0
3,195,195,8,8,0,1,0
27,212,212,2,2,0,1,0
24,250,250,38,30,8,2,1
10,254,254,19,19,0,1,0
11,259,259,12,3,9,4,3
25,263,263,4,4,0,1,0
4,286,286,75,51,24,2,1
28,297,297,14,3,11,2,1
15,304,304,9,4,5,2,1
23,323,323,21,5,16,2,1
20,335,335,23,6,17,2,1
21,353,353,19,7,12,4,3
6,364,364,2,2,0,1,0
32,386,386,178,64,114,4,3
12,402,402,51,44,7,2,1
0,413,413,41,29,12,3,2
14,418,418,38,38,0,1,0
17,433,433,31,31,0,1,0
9,436,436,7,7,0,1,0
18,447,447,26,26,0,1,0
13,475,475,49,49,0,1,0
7,489,489,26,26,0,1,0

12,115,115,10,10,0,1,0
2,130,130,10,4,6,3,2
17,158,158,18,4,14,3,2
16,186,186,45,13,32,3,2
13,200,200,6,1,5,2,1
25,246,246,11,2,9,4,3
1,254,254,40,2,38,2,1
6,259,259,24,15,9,2,1
19,285,285,52,16,36,3,2
20,299,299,28,28,0,1,0
9,310,310,7,7,0,1,0
14,312,312,35,4,31,3,2
10,316,316,10,10,0,1,0
3,345,345,8,8,0,1,0
21,366,366,52,26,26,2,1
8,370,370,18,18,0,1,0
23,373,373,3,3,0,1,0
28,392,392,22,15,7,2,1
7,408,408,14,11,3,2,1
5,431,431,21,21,0,1,0
11,437,437,169,88,81,4,3
27,452,452,5,5,0,1,0
15,460,460,17,17,0,1,0
26,463,463,70,26,44,2,1
0,467,467,56,44,12,4,3
24,483,483,21,1,20,4,3
4,485,485,63,29,34,3,2
22,495,495,73,53,20,2,1
18,498,498,75,75,0,1,0

23,134,134,18,18,0,1,0
18,135,135,3,3,0,1,0
22,166,166,23,23,0,1,0
13,180,180,35,7,28,2,1
10,217,217,5,5,0,1,0
5,220,220,1,1,0,1,0
1,265,265,2,2,0,1,0
21,269,269,15,15,0,1,0
25,282,282,12,6,6,3,2
12,284,284,17,17,0,1,0
2,290,290,20,20,0,1,0
7,321,321,17,17,0,1,0
19,335,335,60,60,0,1,0
11,339,339,3,3,0,1,0
14,342,342,43,31,12,4,3
4,357,357,1,1,0,1,0
8,365,365,61,61,0,1,0
15,405,405,7,1,6,3,2
17,413,413,40,40,0,1,0
20,418,418,92,92,0,1,0
9,418,418,23,15,8,2,1
3,440,440,127,127,0,1,0
0,451,451,196,192,4,2,1
6,457,457,16,8,8,3,2
27,458,458,14,14,0,1,0
26,460,460,110,92,18,4,3
16,461,461,45,6,39,2,1
24,475,475,12,12,0,1,0

15,103,103,18,12,6,3,2
25,109,109,14,14,0,1,0
10,116,116,11,11,0,1,0
19,130,130,16,16,0,1,0
1,155,155,1,1,0,1,0
17,195,195,5,5,0,1,0
13,196,196,6,6,0,1,0
6,215,215,3,3,0,1,0
0,229,229,35,35,0,1,0
4,231,231,4,4,0,1,0
26,258,258,36,36,0,1,0
22,260,260,4,4,0,1,0
24,267,267,31,31,0,1,0
14,285,285,67,16,51,4,3
3,295,295,18,6,12,3,2
5,322,322,17,17,0,1,0
8,335,335,13,13,0,1,0
20,352,352,5,5,0,1,0
12,366,366,26,8,18,3,2
9,366,366,39,1,38,2,1
21,376,376,47,8,39,4,3
27,377,377,48,17,31,2,1
18,378,378,12,8,4,2,1
23,379,379,50,26,24,4,3
11,431,431,160,33,127,4,3
7,450,450,15,15,0,1,0
16,470,470,24,24,0,1,0
2,471,471,166,85,81,4,3

26,106,106,12,4,8,3,2
19,109,109,17,5,12,3,2
22,118,118,16,7,9,2,1
24,120,120,4,4,0,1,0
27,144,144,32,8,24,2,1
4,154,154,75,75,0,1,0
11,165,165,2,2,0,1,0
8,177,177,7,7,0,1,0
10,186,186,20,20,0,1,0
6,201,201,12,3,9,2,1
25,202,202,15,15,0,1,0
14,212,212,5,2,3,2,1
12,243,243,10,10,0,1,0
15,283,283,14,14,0,1,0
1,290,290,51,51,0,1,0
17,297,297,56,43,13,2,1
5,361,361,4,4,0,1,0
28,367,367,10,10,0,1,0
18,380,380,4,4,0,1,0
0,381,381,14,14,0,1,0
16,382,382,121,97,24,3,2
2,414,414,18,12,6,2,1
21,426,426,9,6,3,2,1
29,442,442,35,35,0,1,0
9,452,452,1,1,0,1,0
7,471,471,115,88,27,2,1
13,480,480,30,30,0,1,0
23,484,484,10,5,5,2,1
3,490,490,2,2,0,1,0
20,498,498,19,19,0,1,0

9,145,145,22,22,0,1,0
26,155,155,18,18,0,1,0
3,163,163,1,1,0,1,0
27,168,168,22,16,6,2,1
11,202,202,19,10,9,4,3
5,208,208,32,10,22,3,2
12,235,235,6,6,0,1,0
18,239,239,32,8,24,4,3
29,251,251,52,30,22,3,2
25,253,253,17,8,9,2,1
21,279,279,33,29,4,2,1
4,283,283,29,11,18,3,2
7,307,307,34,12,22,2,1
24,307,307,42,42,0,1,0
23,310,310,26,26,0,1,0
8,316,316,29,29,0,1,0
14,379,379,14,14,0,1,0
15,380,380,7,7,0,1,0
2,383,383,61,61,0,1,0
16,393,393,12,12,0,1,0
19,405,405,3,3,0,1,0
6,411,411,21,21,0,1,0
1,419,419,30,4,26,3,2
13,420,420,54,4,50,2,1
10,454,454,11,2,9,4,3
22,458,458,11,2,9,4,3
28,464,464,95,24,71,4,3
0,467,467,82,32,50,2,1
20,477,477,26,26,0,1,0
17,479,479,50,36,14,3,2

19,101,101,3,3,0,1,0
0,122,122,4,4,0,1,0
3,142,142,53,5,48,2,1
17,176,176,10,1,9,2,1
10,219,219,6,1,5,2,1
4,228,228,22,8,14,3,2
11,236,236,36,18,18,4,3
20,264,264,20,20,0,1,0
8,277,277,3,3,0,1,0
21,297,297,19,19,0,1,0
14,307,307,19,10,9,2,1
6,317,317,17,10,7,2,1
9,352,352,90,84,6,2,1
1,357,357,4,4,0,1,0
22,372,372,2,2,0,1,0
15,397,397,63,63,0,1,0
23,404,404,61,31,30,3,2
12,445,445,5,5,0,1,0
16,451,451,37,37,0,1,0
2,474,474,169,163,6,2,1
7,477,477,21,21,0,1,0
18,479,479,247,229,18,2,1
5,491,491,82,34,48,3,2
13,500,500,17,17,0,1,0

8,124,124,4,4,0,1,0
0,172,172,6,6,0,1,0
28,175,175,2,2,0,1,0
21,196,196,10,1,9,2,1
4,199,199,3,3,0,1,0
22,207,207,2,2,0,1,0
3,238,238,25,25,0,1,0
16,293,293,19,13,6,3,2
25,296,296,80,56,24,2,1
23,320,320,7,1,6,2,1
6,329,329,14,14,0,1,0
20,334,334,38,6,32,3,2
1,349,349,49,49,0,1,0
17,360,360,29,29,0,1,0
11,365,365,48,48,0,1,0
12,378,378,36,18,18,3,2
27,399,399,8,2,6,2,1
15,401,401,62,43,19,2,1
7,407,407,5,5,0,1,0
2,409,409,58,31,27,2,1
26,418,418,44,16,28,3,2
10,452,452,48,16,32,4,3
9,466,466,127,85,42,4,3
13,470,470,26,2,24,4,3
19,474,474,21,9,12,2,1
24,475,475,102,102,0,1,0
18,482,482,128,70,58,3,2
5,484,484,50,50,0,1,0
14,488,488,55,55,0,1,0

11,124,124,8,8,0,1,0
0,126,126,3,3,0,1,0
16,131,131,2,2,0,1,0
12,135,135,37,28,9,2,1
4,141,141,13,13,0,1,0
14,153,153,10,10,0,1,0
7,171,171,1,1,0,1,0
19,178,178,117,89,28,2,1
2,189,189,1,1,0,1,0
15,198,198,15,6,9,4,3
6,199,199,12,2,10,3,2
3,221,221,46,16,30,3,2
23,239,239,31,31,0,1,0
9,249,249,6,6,0,1,0
20,253,253,2,2,0,1,0
18,261,261,18,6,12,4,3
5,275,275,20,20,0,1,0
21,299,299,8,8,0,1,0
8,334,334,3,3,0,1,0
13,346,346,69,25,44,3,2
27,360,360,12,8,4,2,1
1,409,409,42,26,16,3,2
17,420,420,21,21,0,1,0
22,441,441,8,5,3,2,1
10,469,469,121,112,9,4,3
25,470,470,82,82,0,1,0
26,482,482,2,2,0,1,0
24,490,490,52,52,0,1,0

11,107,107,4,4,0,1,0
20,113,113,22,13,9,4,3
28,119,119,21,21,0,1,0
9,135,135,24,9,15,4,3
14,153,153,26,26,0,1,0
12,158,158,1,1,0,1,0
29,162,162,26,11,15,2,1
23,169,169,44,6,38,2,1
5,183,183,6,6,0,1,0
10,195,195,15,15,0,1,0
6,201,201,5,5,0,1,0
21,211,211,13,5,8,2,1
30,256,256,2,2,0,1,0
27,258,258,33,33,0,1,0
16,263,263,22,22,0,1,0
22,265,265,44,44,0,1,0
19,273,273,5,5,0,1,0
2,278,278,15,4,11,3,2
17,278,278,27,4,23,2,1
13,299,299,4,4,0,1,0
7,303,303,24,12,12,3,2
1,326,326,2,2,0,1,0
18,331,331,1,1,0,1,0
3,345,345,89,58,31,2,1
15,367,367,50,50,0,1,0
25,387,387,2,2,0,1,0
24,396,396,63,42,21,4,3
0,435,435,28,2,26,3,2
4,465,465,28,4,24,3,2
26,467,467,12,12,0,1,0
31,474,474,35,35,0,1,0
8,484,484,12,7,5,2,1

3,119,119,13,13,0,1,0
21,126,126,2,2,0,1,0
33,139,139,18,18,0,1,0
24,142,142,3,3,0,1,0
29,149,149,1,1,0,1,0
2,152,152,7,7,0,1,0
8,177,177,8,8,0,1,0
10,179,179,13,1,12,3,2
25,200,200,55,4,51,4,3
9,208,208,10,10,0,1,0
34,213,213,18,18,0,1,0
12,226,226,45,23,22,3,2
14,228,228,1,1,0,1,0
15,233,233,6,2,4,2,1
17,247,247,7,7,0,1,0
22,258,258,25,25,0,1,0
32,263,263,53,11,42,4,3
6,274,274,16,6,10,3,2
35,292,292,11,11,0,1,0
28,309,309,33,21,12,2,1
1,316,316,19,19,0,1,0
13,323,323,39,14,25,2,1
5,326,326,28,16,12,2,1
18,338,338,6,6,0,1,0
19,347,347,53,39,14,2,1
31,348,348,41,41,0,1,0
4,361,361,28,28,0,1,0
0,385,385,30,15,15,4,3
11,390,390,3,3,0,1,0
30,406,406,68,68,0,1,0
16,408,408,41,13,28,2,1
23,432,432,30,23,7,2,1
7,461,461,19,10,9,3,2
26,480,480,27,16,11,2,1
20,487,487,5,5,0,1,0
27,488,488,34,34,0,1,0

9,107,107,1,1,0,1,0
13,130,130,4,4,0,1,0
34,142,142,1,1,0,1,0
35,145,145,2,2,0,1,0
6,147,147,9,1,8,2,1
21,174,174,2,2,0,1,0
27,175,175,12,12,0,1,0
17,180,180,13,7,6,2,1
7,182,182,12,12,0,1,0
24,219,219,13,13,0,1,0
5,220,220,20,20,0,1,0
28,221,221,31,31,0,1,0
15,223,223,14,2,12,4,3
29,234,234,20,20,0,1,0
16,242,242,1,1,0,1,0
18,278,278,7,7,0,1,0
1,296,296,26,26,0,1,0
32,301,301,88,88,0,1,0
30,309,309,6,1,5,2,1
20,310,310,1,1,0,1,0
25,319,319,122,23,99,4,3
26,355,355,40,7,33,4,3
0,355,355,77,63,14,2,1
4,371,371,7,4,3,2,1
23,393,393,54,54,0,1,0
19,395,395,1,1,0,1,0
31,427,427,6,6,0,1,0
8,440,440,64,32,32,3,2
33,441,441,35,35,0,1,0
2,445,445,17,17,0,1,0
3,453,453,30,30,0,1,0
12,456,456,46,46,0,1,0
10,480,480,35,10,25,2,1
11,487,487,98,42,56,4,3
14,489,489,6,2,4,2,1
22,494,494,11,2,9,4,3

3,101,101,9,9,0,1,0
12,129,129,1,1,0,1,0
15,130,130,6,6,0,1,0
27,158,158,22,14,8,2,1
5,183,183,61,61,0,1,0
7,183,183,1,1,0,1,0
29,189,189,20,20,0,1,0
25,211,211,7,7,0,1,0
19,221,221,9,9,0,1,0
26,235,235,24,24,0,1,0
20,241,241,5,5,0,1,0
24,301,301,4,4,0,1,0
17,319,319,6,2,4,2,1
30,320,320,69,26,43,2,1
9,325,325,23,23,0,1,0
28,348,348,65,39,26,3,2
22,361,361,14,14,0,1,0
0,370,370,15,8,7,2,1
21,380,380,79,79,0,1,0
11,388,388,24,14,10,2,1
2,407,407,142,16,126,4,3
18,416,416,85,37,48,2,1
1,421,421,47,7,40,4,3
10,424,424,18,18,0,1,0
4,449,449,42,42,0,1,0
14,453,453,11,11,0,1,0
8,453,453,9,6,3,2,1
6,464,464,30,8,22,3,2
13,474,474,3,3,0,1,0
23,487,487,47,47,0,1,0
16,495,495,17,17,0,1,0

25,113,113,20,16,4,2,1
18,127,127,4,4,0,1,0
1,166,166,14,2,12,3,2
8,168,168,12,12,0,1,0
21,173,173,13,10,3,2,1
5,174,174,26,26,0,1,0
6,192,192,13,13,0,1,0
17,210,210,8,1,7,2,1
24,214,214,62,62,0,1,0
29,216,216,3,3,0,1,0
0,245,245,40,6,34,2,1
9,267,267,6,3,3,2,1
28,292,292,7,7,0,1,0
15,299,299,28,11,17,2,1
2,303,303,24,24,0,1,0
23,316,316,82,62,20,2,1
27,323,323,2,2,0,1,0
4,328,328,65,9,56,3,2
30,331,331,107,7,100,4,3
20,334,334,25,25,0,1,0
10,355,355,17,12,5,2,1
22,371,371,21,21,0,1,0
16,376,376,55,19,36,4,3
12,396,396,42,24,18,4,3
19,400,400,20,20,0,1,0
26,402,402,5,2,3,2,1
3,429,429,1,1,0,1,0
14,443,443,24,3,21,4,3
7,466,466,42,29,13,2,1
13,468,468,1,1,0,1,0
11,472,472,11,2,9,2,1

24,123,123,4,4,0,1,0
22,128,128,1,1,0,1,0
3,135,135,18,18,0,1,0
6,144,144,71,67,4,2,1
10,182,182,21,21,0,1,0
2,188,188,17,17,0,1,0
14,207,207,7,7,0,1,0
0,214,214,1,1,0,1,0
19,215,215,10,3,7,2,1
12,222,222,37,11,26,3,2
13,225,225,25,25,0,1,0
1,243,243,1,1,0,1,0
5,251,251,37,37,0,1,0
8,265,265,67,37,30,4,3
4,265,265,9,3,6,2,1
11,284,284,56,20,36,2,1
18,286,286,23,15,8,3,2
15,292,292,39,11,28,3,2
17,354,354,44,35,9,2,1
7,363,363,42,42,0,1,0
23,363,363,28,28,0,1,0
20,415,415,73,35,38,4,3
21,429,429,42,42,0,1,0
9,431,431,4,1,3,2,1
16,462,462,68,20,48,4,3

21,116,116,2,2,0,1,0
23,116,116,2,2,0,1,0
1,132,132,7,7,0,1,0
26,163,163,35,13,22,3,2
2,177,177,24,5,19,3,2
7,191,191,1,1,0,1,0
12,193,193,27,10,17,2,1
19,210,210,9,6,3,2,1
16,224,224,16,6,10,3,2
0,248,248,6,6,0,1,0
17,264,264,34,34,0,1,0
24,273,273,53,53,0,1,0
5,283,283,59,45,14,3,2
9,296,296,37,5,32,3,2
13,303,303,32,18,14,3,2
25,315,315,55,55,0,1,0
15,323,323,22,22,0,1,0
28,340,340,37,37,0,1,0
3,349,349,69,28,41,4,3
22,361,361,21,21,0,1,0
14,367,367,8,2,6,2,1
10,395,395,1,1,0,1,0
20,406,406,87,3,84,3,2
29,411,411,35,35,0,1,0
4,413,413,29,20,9,4,3
8,426,426,11,11,0,1,0
18,440,440,34,34,0,1,0
11,441,441,93,93,0,1,0
6,487,487,3,3,0,1,0
27,492,492,12,12,0,1,0

7,134,134,15,15,0,1,0
16,164,164,13,13,0,1,0
22,207,207,57,9,48,2,1
17,218,218,27,15,12,4,3
27,219,219,13,3,10,3,2
12,229,229,7,1,6,2,1
0,240,240,21,16,5,2,1
9,244,244,11,5,6,2,1
21,261,261,16,16,0,1,0
23,267,267,19,19,0,1,0
25,272,272,49,17,32,3,2
26,280,280,7,7,0,1,0
2,304,304,56,56,0,1,0
14,311,311,36,9,27,4,3
13,314,314,21,21,0,1,0
24,315,315,33,33,0,1,0
20,321,321,6,6,0,1,0
11,329,329,81,50,31,2,1
15,339,339,17,17,0,1,0
6,350,350,28,28,0,1,0
8,357,357,20,5,15,3,2
18,373,373,37,37,0,1,0
4,384,384,22,10,12,2,1
1,385,385,105,84,21,2,1
3,418,418,40,40,0,1,0
5,449,449,13,13,0,1,0
10,453,453,18,12,6,2,1
19,488,488,77,77,0,1,0

4,179,179,1,1,0,1,0
26,184,184,2,2,0,1,0
22,229,229,7,7,0,1,0
7,239,239,2,2,0,1,0
28,252,252,83,20,63,4,3
17,253,253,6,6,0,1,0
33,269,269,9,2,7,2,1
5,276,276,12,12,0,1,0
10,286,286,6,3,3,2,1
16,309,309,46,46,0,1,0
31,320,320,19,11,8,2,1
12,330,330,15,3,12,4,3
21,333,333,26,26,0,1,0
29,334,334,61,9,52,3,2
23,354,354,24,24,0,1,0
3,364,364,59,59,0,1,0
11,375,375,48,48,0,1,0
25,381,381,32,32,0,1,0
8,385,385,17,17,0,1,0
2,389,389,2,2,0,1,0
9,407,407,24,2,22,3,2
19,423,423,19,8,11,3,2
0,427,427,18,6,12,4,3
14,438,438,62,62,0,1,0
18,440,440,51,12,39,2,1
6,446,446,41,41,0,1,0
30,446,446,29,29,0,1,0
15,449,449,1,1,0,1,0
13,449,449,58,58,0,1,0
32,460,460,35,2,33,2,1
24,471,471,67,67,0,1,0
27,483,483,20,7,13,2,1
20,490,490,108,108,0,1,0
1,496,496,69,69,0,1,0

11,130,130,18,18,0,1,0
14,159,159,15,15,0,1,0
16,182,182,51,36,15,4,3
0,185,185,34,10,24,2,1
20,189,189,11,2,9,2,1
10,195,195,54,51,3,2,1
26,199,199,10,10,0,1,0
8,205,205,4,4,0,1,0
2,206,206,24,24,0,1,0
25,227,227,55,18,37,2,1
21,232,232,27,21,6,2,1
4,237,237,4,4,0,1,0
7,266,266,4,4,0,1,0
18,268,268,9,1,8,3,2
5,281,281,11,3,8,2,1
22,286,286,1,1,0,1,0
27,325,325,38,29,9,4,3
24,336,336,14,14,0,1,0
23,341,341,12,1,11,2,1
17,349,349,80,80,0,1,0
6,369,369,14,14,0,1,0
13,378,378,85,61,24,2,1
19,379,379,42,42,0,1,0
9,383,383,9,1,8,3,2
1,417,417,33,33,0,1,0
3,424,424,58,36,22,3,2
12,427,427,40,4,36,4,3
15,472,472,9,1,8,3,2

10,110,110,6,6,0,1,0
11,136,136,1,1,0,1,0
22,153,153,6,6,0,1,0
0,172,172,6,3,3,2,1
32,174,174,13,13,0,1,0
1,184,184,3,3,0,1,0
17,188,188,24,21,3,2,1
5,206,206,24,9,15,2,1
13,222,222,9,3,6,3,2
25,240,240,59,23,36,4,3
12,262,262,8,8,0,1,0
2,270,270,15,8,7,2,1
15,279,279,1,1,0,1,0
20,284,284,3,3,0,1,0
27,302,302,28,28,0,1,0
14,306,306,22,11,11,2,1
3,313,313,113,113,0,1,0
19,316,316,2,2,0,1,0
29,324,324,35,35,0,1,0
28,326,326,32,24,8,3,2
7,327,327,15,1,14,4,3
23,341,341,54,54,0,1,0
31,362,362,30,12,18,2,1
8,367,367,23,23,0,1,0
9,370,370,5,5,0,1,0
24,375,375,92,67,25,4,3
4,407,407,34,22,12,2,1
16,437,437,43,43,0,1,0
21,463,463,12,2,10,3,2
6,481,481,76,76,0,1,0
18,484,484,9,5,4,2,1
26,489,489,115,40,75,4,3
30,489,489,2,2,0,1,0

26,100,100,24,24,0,1,0
12,103,103,17,17,0,1,0
15,119,119,16,6,10,2,1
19,121,121,8,8,0,1,0
20,131,131,3,3,0,1,0
6,163,163,33,25,8,3,2
0,171,171,37,37,0,1,0
21,229,229,2,2,0,1,0
10,255,255,3,3,0,1,0
17,267,267,3,3,0,1,0
18,268,268,19,4,15,2,1
7,269,269,25,25,0,1,0
2,272,272,4,4,0,1,0
11,272,272,4,1,3,2,1
28,283,283,1,1,0,1,0
1,286,286,41,41,0,1,0
25,293,293,97,81,16,3,2
4,321,321,33,1,32,3,2
13,331,331,8,8,0,1,0
8,335,335,14,14,0,1,0
24,339,339,11,11,0,1,0
22,348,348,4,4,0,1,0
14,363,363,14,6,8,2,1
27,363,363,40,30,10,2,1
9,374,374,58,58,0,1,0
23,375,375,83,13,70,3,2
5,425,425,26,8,18,3,2
16,434,434,73,73,0,1,0
3,499,499,58,58,0,1,0

23,100,100,27,27,0,1,0
15,105,105,6,3,3,2,1
10,112,112,4,4,0,1,0
16,119,119,20,20,0,1,0
32,126,126,21,21,0,1,0
11,130,130,17,5,12,2,1
18,139,139,12,12,0,1,0
27,156,156,8,3,5,2,1
12,193,193,1,1,0,1,0
2,200,200,2,2,0,1,0
29,205,205,8,8,0,1,0
26,213,213,4,4,0,1,0
13,214,214,16,16,0,1,0
31,224,224,32,4,28,3,2
4,267,267,26,26,0,1,0
8,269,269,13,6,7,2,1
7,271,271,30,30,0,1,0
3,276,276,4,4,0,1,0
14,323,323,12,12,0,1,0
24,334,334,40,16,24,4,3
22,338,338,6,6,0,1,0
1,342,342,14,14,0,1,0
19,345,345,6,6,0,1,0
9,360,360,8,8,0,1,0
6,365,365,30,4,26,3,2
5,381,381,67,46,21,4,3
20,406,406,57,57,0,1,0
30,407,407,54,54,0,1,0
0,431,431,1,1,0,1,0
33,441,441,12,12,0,1,0
17,474,474,88,88,0,1,0
21,480,480,109,109,0,1,0
25,481,481,1,1,0,1,0
28,499,499,39,10,29,3,2

16,106,106,5,5,0,1,0
3,139,139,20,12,8,2,1
20,152,152,3,3,0,1,0
13,152,152,24,24,0,1,0
10,165,165,13,5,8,2,1
1,173,173,24,10,14,3,2
15,179,179,10,2,8,2,1
21,208,208,16,16,0,1,0
18,232,232,6,6,0,1,0
12,255,255,12,4,8,2,1
6,268,268,39,10,29,2,1
22,272,272,4,4,0,1,0
9,275,275,8,8,0,1,0
19,280,280,203,169,34,4,3
5,305,305,93,93,0,1,0
7,387,387,18,1,17,4,3
2,428,428,128,96,32,2,1
0,429,429,11,5,6,2,1
17,452,452,26,7,19,2,1
8,458,458,43,43,0,1,0
4,461,461,94,76,18,4,3
11,473,473,40,23,17,2,1
14,492,492,7,1,6,2,1

34,101,101,3,3,0,1,0
1,108,108,3,3,0,1,0
33,120,120,12,12,0,1,0
19,142,142,4,1,3,2,1
9,150,150,3,3,0,1,0
22,152,152,2,2,0,1,0
5,153,153,13,13,0,1,0
20,153,153,9,6,3,2,1
23,175,175,5,5,0,1,0
2,187,187,10,10,0,1,0
26,203,203,14,10,4,2,1
13,257,257,14,14,0,1,0
4,272,272,13,13,0,1,0
25,273,273,68,34,34,2,1
28,276,276,8,8,0,1,0
31,309,309,93,81,12,4,3
24,320,320,1,1,0,1,0
11,326,326,1,1,0,1,0
8,336,336,11,3,8,2,1
29,339,339,107,107,0,1,0
27,351,351,28,5,23,2,1
30,373,373,1,1,0,1,0
12,380,380,62,62,0,1,0
32,391,391,8,8,0,1,0
17,391,391,45,1,44,2,1
7,405,405,62,62,0,1,0
21,410,410,77,77,0,1,0
0,411,411,4,4,0,1,0
10,413,413,85,27,58,3,2
6,414,414,36,36,0,1,0
15,418,418,22,8,14,3,2
18,447,447,3,3,0,1,0
3,447,447,41,41,0,1,0
14,453,453,21,21,0,1,0
16,483,483,30,4,26,3,2

19,118,118,1,1,0,1,0
3,129,129,4,4,0,1,0
14,135,135,1,1,0,1,0
10,136,136,16,16,0,1,0
31,137,137,17,17,0,1,0
29,138,138,10,10,0,1,0
23,139,139,17,8,9,4,3
9,155,155,9,9,0,1,0
4,156,156,4,4,0,1,0
33,160,160,34,20,14,2,1
30,170,170,14,9,5,2,1
20,181,181,1,1,0,1,0
5,200,200,7,7,0,1,0
26,217,217,17,17,0,1,0
34,225,225,8,8,0,1,0
8,226,226,11,11,0,1,0
1,228,228,39,8,31,2,1
32,252,252,1,1,0,1,0
12,254,254,21,21,0,1,0
16,258,258,1,1,0,1,0
2,262,262,2,2,0,1,0
28,281,281,31,3,28,3,2
11,288,288,37,9,28,3,2
35,304,304,37,37,0,1,0
7,323,323,38,6,32,3,2
25,329,329,8,8,0,1,0
27,410,410,32,21,11,2,1
15,418,418,7,4,3,2,1
21,419,419,7,7,0,1,0
17,436,436,46,46,0,1,0
13,448,448,20,5,15,4,3
0,454,454,109,86,23,2,1
22,472,472,30,7,23,2,1
18,472,472,32,32,0,1,0
24,475,475,145,85,60,3,2
6,497,497,30,15,15,4,3

7,103,103,13,13,0,1,0
14,128,128,9,9,0,1,0
30,147,147,9,1,8,3,2
22,193,193,12,7,5,2,1
16,207,207,14,2,12,4,3
9,215,215,6,6,0,1,0
8,217,217,19,19,0,1,0
19,238,238,24,13,11,2,1
24,252,252,18,18,0,1,0
18,267,267,4,4,0,1,0
2,287,287,39,39,0,1,0
32,300,300,11,2,9,2,1
21,300,300,17,17,0,1,0
6,302,302,9,5,4,2,1
31,304,304,2,2,0,1,0
17,309,309,1,1,0,1,0
1,315,315,30,22,8,2,1
13,326,326,17,1,16,3,2
10,340,340,32,32,0,1,0
12,357,357,56,56,0,1,0
29,357,357,6,6,0,1,0
3,363,363,1,1,0,1,0
11,365,365,17,17,0,1,0
28,373,373,54,18,36,3,2
33,375,375,26,26,0,1,0
25,389,389,53,8,45,4,3
15,422,422,20,5,15,2,1
5,425,425,28,3,25,2,1
26,426,426,38,29,9,4,3
20,426,426,143,67,76,3,2
0,474,474,74,37,37,2,1
27,487,487,158,158,0,1,0
4,490,490,10,4,6,2,1
23,499,499,11,11,0,1,0

28,103,103,1,1,0,1,0
20,106,106,6,6,0,1,0
19,106,106,18,9,9,4,3
6,124,124,24,24,0,1,0
22,125,125,17,11,6,3,2
26,128,128,1,1,0,1,0
29,130,130,5,5,0,1,0
16,136,136,5,5,0,1,0
23,151,151,4,4,0,1,0
21,152,152,42,42,0,1,0
30,169,169,1,1,0,1,0
9,176,176,6,6,0,1,0
11,225,225,4,4,0,1,0
25,236,236,18,18,0,1,0
27,251,251,57,43,14,2,1
7,299,299,11,11,0,1,0
5,311,311,13,2,11,2,1
18,324,324,77,77,0,1,0
17,330,330,53,53,0,1,0
24,334,334,6,6,0,1,0
4,347,347,10,3,7,2,1
13,390,390,57,42,15,4,3
1,398,398,27,19,8,2,1
2,415,415,49,6,43,4,3
3,431,431,76,32,44,4,3
14,453,453,11,11,0,1,0
10,455,455,20,6,14,3,2
8,469,469,35,22,13,4,3
12,471,471,12,12,0,1,0
0,475,475,51,15,36,3,2
15,492,492,112,69,43,3,2

15,114,114,8,8,0,1,0
19,138,138,69,57,12,2,1
0,147,147,1,1,0,1,0
18,149,149,4,1,3,2,1
1,156,156,13,13,0,1,0
27,159,159,24,24,0,1,0
22,162,162,8,8,0,1,0
13,186,186,1,1,0,1,0
4,189,189,39,39,0,1,0
10,197,197,19,8,11,3,2
5,198,198,17,6,11,4,3
14,215,215,55,25,30,4,3
20,216,216,18,14,4,2,1
12,264,264,10,10,0,1,0
30,270,270,16,4,12,3,2
24,273,273,51,39,12,3,2
6,282,282,34,14,20,4,3
3,288,288,13,6,7,2,1
29,290,290,2,2,0,1,0
2,291,291,27,27,0,1,0
7,293,293,10,10,0,1,0
11,314,314,43,43,0,1,0
26,362,362,12,6,6,3,2
25,390,390,24,14,10,2,1
17,396,396,43,19,24,2,1
8,404,404,25,25,0,1,0
28,409,409,20,20,0,1,0
9,428,428,4,4,0,1,0
23,429,429,1,1,0,1,0
16,482,482,25,25,0,1,0
21,495,495,55,55,0,1,0

13,116,116,34,30,4,2,1
10,126,126,4,4,0,1,0
21,129,129,16,16,0,1,0
1,138,138,12,12,0,1,0
32,144,144,5,5,0,1,0
16,151,151,8,8,0,1,0
2,157,157,1,1,0,1,0
24,187,187,6,6,0,1,0
0,197,197,22,22,0,1,0
25,207,207,32,32,0,1,0
14,209,209,3,3,0,1,0
3,233,233,1,1,0,1,0
33,241,241,41,41,0,1,0
11,247,247,1,1,0,1,0
22,253,253,13,13,0,1,0
28,265,265,25,25,0,1,0
7,273,273,31,31,0,1,0
20,274,274,27,27,0,1,0
9,283,283,4,4,0,1,0
12,304,304,13,13,0,1,0
5,306,306,4,4,0,1,0
30,318,318,9,9,0,1,0
23,331,331,9,9,0,1,0
29,337,337,34,14,20,2,1
17,342,342,1,1,0,1,0
15,347,347,65,38,27,4,3
27,374,374,134,32,102,4,3
19,390,390,11,4,7,2,1
18,394,394,11,11,0,1,0
6,408,408,99,99,0,1,0
8,432,432,15,15,0,1,0
31,434,434,27,27,0,1,0
26,466,466,43,18,25,2,1
4,470,470,42,6,36,3,2

17,127,127,31,31,0,1,0
23,136,136,14,14,0,1,0
15,139,139,16,16,0,1,0
21,158,158,6,6,0,1,0
26,185,185,21,17,4,2,1
2,192,192,25,25,0,1,0
0,192,192,13,1,12,2,1
20,194,194,3,3,0,1,0
9,197,197,9,5,4,2,1
14,206,206,15,15,0,1,0
19,215,215,6,6,0,1,0
6,245,245,5,5,0,1,0
10,251,251,27,11,16,4,3
18,284,284,14,14,0,1,0
8,289,289,15,15,0,1,0
22,291,291,15,7,8,3,2
7,300,300,65,16,49,4,3
11,353,353,41,2,39,2,1
12,364,364,36,12,24,4,3
25,369,369,62,62,0,1,0
16,385,385,14,8,6,3,2
4,409,409,82,71,11,3,2
27,421,421,31,31,0,1,0
24,433,433,138,138,0,1,0
3,449,449,26,26,0,1,0
1,463,463,1,1,0,1,0
13,478,478,51,51,0,1,0
5,483,483,86,75,11,2,1

19,101,101,2,2,0,1,0
12,104,104,12,8,4,2,1
10,105,105,15,15,0,1,0
16,115,115,12,12,0,1,0
1,133,133,1,1,0,1,0
21,143,143,52,28,24,4,3
23,151,151,17,17,0,1,0
17,215,215,2,2,0,1,0
20,225,225,28,28,0,1,0
0,232,232,37,37,0,1,0
3,254,254,9,3,6,3,2
14,272,272,19,4,15,3,2
28,283,283,19,19,0,1,0
25,294,294,37,37,0,1,0
15,294,294,49,21,28,2,1
9,307,307,29,29,0,1,0
5,321,321,11,2,9,3,2
27,324,324,1,1,0,1,0
7,357,357,41,41,0,1,0
18,360,360,28,13,15,4,3
24,361,361,2,2,0,1,0
2,376,376,55,40,15,2,1
11,393,393,1,1,0,1,0
13,399,399,38,18,20,3,2
26,400,400,45,21,24,4,3
8,411,411,23,2,21,2,1
6,412,412,83,2,81,4,3
4,415,415,52,52,0,1,0
22,478,478,69,69,0,1,0

19,101,101,31,31,0,1,0
21,126,126,2,2,0,1,0
8,132,132,7,4,3,2,1
15,136,136,30,30,0,1,0
25,145,145,22,22,0,1,0
4,150,150,5,2,3,2,1
1,176,176,6,6,0,1,0
12,187,187,82,44,38,2,1
13,211,211,7,1,6,3,2
14,232,232,4,4,0,1,0
7,244,244,18,18,0,1,0
26,248,248,28,8,20,2,1
6,280,280,29,29,0,1,0
10,318,318,19,19,0,1,0
0,334,334,37,9,28,4,3
18,349,349,1,1,0,1,0
22,377,377,8,8,0,1,0
24,382,382,1,1,0,1,0
9,384,384,33,29,4,2,1
11,404,404,34,7,27,2,1
23,423,423,96,96,0,1,0
2,439,439,30,13,17,4,3
16,446,446,11,11,0,1,0
5,451,451,19,19,0,1,0
20,455,455,132,74,58,4,3
3,475,475,103,95,8,3,2
17,490,490,2,2,0,1,0

2,102,102,20,20,0,1,0
30,118,118,2,2,0,1,0
25,133,133,21,16,5,2,1
0,140,140,18,18,0,1,0
28,148,148,8,8,0,1,0
14,150,150,21,21,0,1,0
22,159,159,6,6,0,1,0
16,205,205,1,1,0,1,0
20,255,255,17,17,0,1,0
19,261,261,19,19,0,1,0
26,285,285,3,3,0,1,0
10,291,291,25,25,0,1,0
7,314,314,2,2,0,1,0
31,322,322,107,47,60,4,3
8,334,334,26,26,0,1,0
29,335,335,13,9,4,2,1
13,339,339,13,13,0,1,0
11,352,352,17,1,16,2,1
9,353,353,41,41,0,1,0
4,375,375,24,24,0,1,0
18,379,379,15,3,12,2,1
3,400,400,4,1,3,2,1
17,410,410,21,21,0,1,0
24,416,416,53,53,0,1,0
21,423,423,59,59,0,1,0
23,429,429,94,80,14,2,1
5,434,434,77,11,66,4,3
1,442,442,35,4,31,2,1
12,443,443,58,50,8,2,1
27,467,467,54,11,43,2,1
15,468,468,17,9,8,3,2
6,496,496,5,1,4,2,1

3,122,122,8,8,0,1,0
22,143,143,13,13,0,1,0
25,148,148,13,13,0,1,0
18,164,164,13,13,0,1,0
6,185,185,7,7,0,1,0
26,223,223,1,1,0,1,0
23,225,225,28,11,17,2,1
15,247,247,11,7,4,2,1
9,249,249,13,13,0,1,0
0,259,259,8,3,5,2,1
7,282,282,21,21,0,1,0
20,300,300,89,25,64,3,2
11,314,314,14,5,9,2,1
4,322,322,128,128,0,1,0
17,345,345,55,55,0,1,0
5,347,347,42,42,0,1,0
21,410,410,2,2,0,1,0
14,416,416,50,50,0,1,0
1,420,420,57,57,0,1,0
16,421,421,64,64,0,1,0
8,432,432,76,76,0,1,0
12,440,440,35,35,0,1,0
13,469,469,3,3,0,1,0
24,476,476,57,34,23,2,1
27,478,478,8,8,0,1,0
19,484,484,62,8,54,4,3
10,498,498,40,6,34,4,3
2,500,500,49,21,28,3,2

13,102,102,1,1,0,1,0
15,105,105,12,12,0,1,0
20,125,125,17,12,5,2,1
24,128,128,2,2,0,1,0
17,129,129,6,6,0,1,0
2,132,132,2,2,0,1,0
21,136,136,34,5,29,2,1
27,140,140,9,9,0,1,0
16,142,142,1,1,0,1,0
14,178,178,5,2,3,2,1
18,185,185,6,3,3,2,1
9,195,195,25,13,12,2,1
1,206,206,1,1,0,1,0
28,229,229,31,31,0,1,0
25,239,239,20,20,0,1,0
12,261,261,18,18,0,1,0
22,273,273,12,12,0,1,0
5,297,297,114,96,18,3,2
11,300,300,56,56,0,1,0
10,309,309,19,16,3,2,1
3,339,339,14,1,13,3,2
8,357,357,3,3,0,1,0
7,377,377,58,34,24,3,2
6,383,383,41,41,0,1,0
19,423,423,18,18,0,1,0
4,428,428,20,20,0,1,0
26,447,447,65,32,33,2,1
0,447,447,16,16,0,1,0
23,468,468,65,24,41,4,3
30,471,471,78,39,39,4,3
29,483,483,64,64,0,1,0

0,106,106,5,5,0,1,0
23,117,117,38,38,0,1,0
7,122,122,14,2,12,4,3
13,137,137,12,12,0,1,0
29,139,139,2,2,0,1,0
25,139,139,5,5,0,1,0
32,165,165,29,14,15,2,1
17,178,178,10,10,0,1,0
21,183,183,20,20,0,1,0
9,212,212,3,3,0,1,0
3,222,222,18,13,5,2,1
1,255,255,18,9,9,4,3
30,276,276,11,11,0,1,0
8,278,278,114,50,64,3,2
12,299,299,6,6,0,1,0
4,311,311,6,2,4,2,1
19,313,313,31,15,16,3,2
11,321,321,5,5,0,1,0
22,322,322,14,14,0,1,0
5,336,336,48,48,0,1,0
31,339,339,44,44,0,1,0
24,342,342,85,10,75,4,3
20,345,345,40,40,0,1,0
6,358,358,2,2,0,1,0
27,360,360,1,1,0,1,0
14,364,364,1,1,0,1,0
16,372,372,23,7,16,2,1
15,380,380,38,25,13,2,1
28,402,402,2,2,0,1,0
10,421,421,7,7,0,1,0
26,442,442,39,39,0,1,0
18,446,446,57,41,16,3,2
2,453,453,3,3,0,1,0

29,125,125,11,11,0,1,0
31,142,142,27,19,8,3,2
5,144,144,24,6,18,4,3
23,153,153,1,1,0,1,0
11,160,160,1,1,0,1,0
12,176,176,9,6,3,2,1
24,183,183,3,3,0,1,0
20,190,190,47,47,0,1,0
19,191,191,24,6,18,2,1
3,210,210,10,10,0,1,0
28,233,233,20,20,0,1,0
6,235,235,12,12,0,1,0
9,256,256,1,1,0,1,0
13,263,263,56,56,0,1,0
26,285,285,4,4,0,1,0
7,289,289,12,12,0,1,0
14,290,290,26,26,0,1,0
8,300,300,66,26,40,4,3
33,307,307,54,54,0,1,0
32,312,312,6,6,0,1,0
30,313,313,16,7,9,2,1
4,321,321,1,1,0,1,0
0,339,339,16,16,0,1,0
22,352,352,70,22,48,2,1
17,358,358,26,3,23,2,1
10,370,370,12,4,8,3,2
25,371,371,10,10,0,1,0
21,372,372,15,15,0,1,0
15,378,378,23,7,16,2,1
16,420,420,9,1,8,2,1
18,422,422,10,10,0,1,0
27,422,422,110,110,0,1,0
1,449,449,34,34,0,1,0
2,469,469,23,23,0,1,0

8,112,112,7,4,3,2,1
23,125,125,25,1,24,3,2
9,127,127,7,7,0,1,0
21,133,133,2,2,0,1,0
2,144,144,17,8,9,4,3
24,177,177,28,5,23,2,1
17,184,184,1,1,0,1,0
25,195,195,10,1,9,2,1
0,212,212,7,7,0,1,0
5,248,248,52,45,7,2,1
4,259,259,6,1,5,2,1
12,263,263,56,56,0,1,0
19,279,279,5,1,4,2,1
16,300,300,27,13,14,2,1
10,304,304,19,15,4,2,1
14,306,306,94,46,48,3,2
1,308,308,4,4,0,1,0
6,355,355,35,35,0,1,0
13,357,357,13,7,6,3,2
11,368,368,181,99,82,3,2
18,386,386,45,14,31,2,1
26,452,452,21,21,0,1,0
3,457,457,5,2,3,2,1
20,477,477,71,37,34,3,2
15,478,478,34,2,32,2,1
7,481,481,5,2,3,2,1
22,483,483,76,31,45,4,3

3,114,114,7,7,0,1,0
4,115,115,15,8,7,2,1
30,115,115,18,18,0,1,0
33,144,144,2,2,0,1,0
8,166,166,11,11,0,1,0
20,181,181,23,1,22,2,1
17,181,181,28,23,5,2,1
29,196,196,19,9,10,2,1
15,205,205,5,5,0,1,0
32,225,225,10,10,0,1,0
18,227,227,22,5,17,4,3
13,229,229,11,1,10,2,1
25,237,237,14,14,0,1,0
0,247,247,10,4,6,2,1
24,261,261,33,16,17,2,1
2,269,269,7,7,0,1,0
7,298,298,23,1,22,3,2
34,326,326,62,62,0,1,0
11,331,331,7,4,3,2,1
26,341,341,23,8,15,2,1
31,345,345,44,33,11,2,1
21,361,361,1,1,0,1,0
23,368,368,74,6,68,3,2
22,373,373,19,19,0,1,0
1,378,378,28,28,0,1,0
10,382,382,28,28,0,1,0
5,384,384,18,18,0,1,0
28,391,391,102,90,12,2,1
9,391,391,6,6,0,1,0
12,413,413,13,7,6,2,1
16,420,420,32,23,9,2,1
14,426,426,35,35,0,1,0
27,444,444,11,4,7,2,1
6,474,474,7,7,0,1,0
19,496,496,57,57,0,1,0

20,104,104,14,14,0,1,0
29,105,105,4,4,0,1,0
8,105,105,5,5,0,1,0
15,111,111,2,2,0,1,0
25,157,157,12,8,4,2,1
24,189,189,44,28,16,3,2
19,190,190,15,15,0,1,0
16,191,191,55,55,0,1,0
2,194,194,4,4,0,1,0
9,226,226,13,13,0,1,0
21,228,228,8,8,0,1,0
7,249,249,1,1,0,1,0
6,271,271,16,16,0,1,0
12,274,274,8,8,0,1,0
13,281,281,12,1,11,4,3
3,290,290,38,9,29,2,1
26,312,312,10,4,6,3,2
30,313,313,37,12,25,2,1
23,315,315,46,20,26,3,2
27,315,315,22,7,15,4,3
17,322,322,1,1,0,1,0
18,353,353,76,73,3,2,1
4,358,358,48,48,0,1,0
14,383,383,63,63,0,1,0
1,387,387,44,44,0,1,0
22,389,389,45,45,0,1,0
5,445,445,16,2,14,2,1
0,449,449,48,1,47,4,3
10,455,455,22,3,19,2,1
28,460,460,67,49,18,4,3
11,467,467,47,47,0,1,0

18,100,100,2,2,0,1,0
21,114,114,6,6,0,1,0
1,132,132,1,1,0,1,0
13,133,133,1,1,0,1,0
4,140,140,1,1,0,1,0
0,140,140,2,2,0,1,0
19,148,148,12,12,0,1,0
16,163,163,9,9,0,1,0
9,166,166,11,11,0,1,0
24,178,178,30,30,0,1,0
25,190,190,7,3,4,2,1
6,198,198,33,9,24,4,3
28,227,227,1,1,0,1,0
12,232,232,15,15,0,1,0
23,257,257,36,18,18,2,1
17,264,264,17,2,15,2,1
3,265,265,25,25,0,1,0
14,273,273,65,49,16,2,1
8,277,277,70,62,8,3,2
22,279,279,27,12,15,4,3
7,280,280,20,20,0,1,0
26,283,283,33,33,0,1,0
30,301,301,54,54,0,1,0
2,332,332,24,24,0,1,0
15,353,353,11,11,0,1,0
20,355,355,9,9,0,1,0
31,377,377,82,65,17,2,1
10,420,420,4,1,3,2,1
11,437,437,20,20,0,1,0
27,443,443,5,5,0,1,0
5,485,485,64,19,45,2,1
29,488,488,143,143,0,1,0

24,101,101,3,3,0,1,0
26,110,110,46,46,0,1,0
17,127,127,3,3,0,1,0
3,143,143,19,2,17,2,1
7,160,160,5,2,3,2,1
13,230,230,9,6,3,2,1
5,268,268,1,1,0,1,0
12,285,285,22,4,18,3,2
18,291,291,31,6,25,2,1
10,335,335,13,5,8,3,2
21,349,349,82,61,21,2,1
16,360,360,11,11,0,1,0
9,377,377,41,41,0,1,0
1,378,378,37,37,0,1,0
0,382,382,107,107,0,1,0
15,392,392,54,54,0,1,0
14,421,421,44,32,12,3,2
23,421,421,37,3,34,3,2
8,425,425,100,16,84,3,2
20,427,427,6,6,0,1,0
25,432,432,27,4,23,2,1
11,434,434,15,15,0,1,0
6,436,436,19,19,0,1,0
22,461,461,24,24,0,1,0
4,472,472,134,111,23,2,1
2,476,476,16,10,6,2,1
19,487,487,39,39,0,1,0

7,104,104,1,1,0,1,0
18,131,131,21,17,4,2,1
10,134,134,1,1,0,1,0
21,145,145,25,5,20,2,1
9,159,159,8,8,0,1,0
13,184,184,16,5,11,2,1
19,195,195,44,44,0,1,0
6,201,201,16,9,7,2,1
3,206,206,29,29,0,1,0
2,219,219,24,24,0,1,0
1,233,233,8,8,0,1,0
11,241,241,13,13,0,1,0
25,252,252,33,10,23,2,1
17,283,283,10,5,5,2,1
8,288,288,6,6,0,1,0
20,307,307,60,60,0,1,0
16,313,313,123,123,0,1,0
5,339,339,39,10,29,2,1
4,356,356,37,4,33,2,1
30,358,358,23,5,18,2,1
28,372,372,47,47,0,1,0
15,379,379,14,14,0,1,0
0,396,396,50,50,0,1,0
26,400,400,12,12,0,1,0
12,402,402,6,6,0,1,0
14,405,405,7,7,0,1,0
29,409,409,29,29,0,1,0
24,419,419,15,5,10,2,1
27,475,475,9,3,6,3,2
23,479,479,1,1,0,1,0
22,482,482,75,75,0,1,0

11,138,138,22,13,9,2,1
13,146,146,8,2,6,3,2
23,148,148,8,5,3,2,1
22,163,163,2,2,0,1,0
25,178,178,2,2,0,1,0
5,186,186,23,23,0,1,0
16,216,216,36,36,0,1,0
9,251,251,56,28,28,3,2
14,273,273,11,11,0,1,0
29,279,279,8,2,6,3,2
26,280,280,34,34,0,1,0
0,286,286,16,16,0,1,0
19,315,315,23,13,10,2,1
3,343,343,20,5,15,4,3
24,343,343,17,14,3,2,1
20,356,356,6,6,0,1,0
21,356,356,2,2,0,1,0
4,384,384,76,9,67,4,3
28,391,391,144,144,0,1,0
2,393,393,1,1,0,1,0
18,399,399,42,24,18,2,1
27,409,409,48,38,10,2,1
1,414,414,39,39,0,1,0
7,423,423,64,64,0,1,0
15,424,424,24,24,0,1,0
10,433,433,10,10,0,1,0
17,440,440,130,112,18,4,3
8,459,459,40,5,35,2,1
12,483,483,31,31,0,1,0
6,487,487,4,4,0,1,0

28,140,140,9,3,6,2,1
21,141,141,1,1,0,1,0
24,153,153,5,5,0,1,0
30,154,154,36,36,0,1,0
1,157,157,15,15,0,1,0
5,169,169,14,14,0,1,0
4,170,170,50,5,45,3,2
20,192,192,5,5,0,1,0
18,212,212,17,2,15,4,3
6,231,231,9,3,6,3,2
23,244,244,19,19,0,1,0
25,257,257,16,16,0,1,0
13,261,261,17,3,14,3,2
0,264,264,1,1,0,1,0
11,302,302,15,4,11,2,1
15,311,311,52,52,0,1,0
19,312,312,130,130,0,1,0
12,321,321,33,18,15,3,2
9,325,325,37,37,0,1,0
22,331,331,13,4,9,4,3
3,332,332,36,36,0,1,0
29,353,353,48,4,44,3,2
2,357,357,9,9,0,1,0
26,377,377,26,26,0,1,0
8,415,415,11,11,0,1,0
16,419,419,18,14,4,2,1
17,437,437,46,13,33,2,1
7,469,469,2,2,0,1,0
27,475,475,40,5,35,2,1
14,480,480,69,69,0,1,0
10,482,482,18,18,0,1,0

10,115,115,6,2,4,2,1
24,148,148,5,5,0,1,0
7,175,175,8,8,0,1,0
0,177,177,1,1,0,1,0
4,183,183,111,111,0,1,0
11,186,186,27,27,0,1,0
1,192,192,26,20,6,3,2
27,194,194,6,6,0,1,0
21,203,203,43,43,0,1,0
19,216,216,2,2,0,1,0
12,231,231,19,9,10,3,2
25,243,243,29,29,0,1,0
13,263,263,14,14,0,1,0
6,313,313,4,4,0,1,0
2,342,342,1,1,0,1,0
26,343,343,14,8,6,3,2
23,354,354,38,20,18,3,2
16,357,357,65,65,0,1,0
3,368,368,4,4,0,1,0
20,395,395,38,12,26,3,2
5,401,401,1,1,0,1,0
9,404,404,68,68,0,1,0
15,405,405,104,104,0,1,0
18,426,426,3,3,0,1,0
8,431,431,34,34,0,1,0
17,454,454,27,27,0,1,0
14,473,473,46,46,0,1,0
22,498,498,84,12,72,4,3

19,125,125,3,3,0,1,0
0,140,140,1,1,0,1,0
7,142,142,14,14,0,1,0
26,150,150,64,64,0,1,0
2,156,156,8,2,6,3,2
8,164,164,29,29,0,1,0
24,192,192,18,3,15,4,3
31,196,196,24,13,11,2,1
9,199,199,35,3,32,2,1
13,216,216,5,5,0,1,0
18,231,231,29,11,18,3,2
1,231,231,35,7,28,2,1
23,235,235,21,3,18,3,2
4,249,249,11,11,0,1,0
25,272,272,22,22,0,1,0
5,278,278,9,9,0,1,0
17,317,317,16,16,0,1,0
29,325,325,11,6,5,2,1
21,326,326,6,2,4,2,1
16,327,327,9,3,6,2,1
27,362,362,19,19,0,1,0
10,381,381,4,4,0,1,0
20,394,394,21,21,0,1,0
12,415,415,15,5,10,3,2
15,416,416,22,1,21,4,3
30,423,423,65,2,63,4,3
32,441,441,114,114,0,1,0
14,450,450,4,4,0,1,0
22,469,469,3,3,0,1,0
3,479,479,3,3,0,1,0
28,486,486,8,8,0,1,0
11,489,489,23,23,0,1,0
6,494,494,136,130,6,2,1

8,105,105,26,1,25,4,3
25,138,138,1,1,0,1,0
31,163,163,9,6,3,2,1
26,165,165,15,1,14,3,2
10,177,177,15,15,0,1,0
15,196,196,12,12,0,1,0
13,197,197,13,13,0,1,0
23,201,201,40,40,0,1,0
20,202,202,7,2,5,2,1
3,217,217,1,1,0,1,0
11,219,219,25,15,10,3,2
24,223,223,22,22,0,1,0
19,227,227,46,3,43,2,1
9,238,238,14,6,8,3,2
16,247,247,6,6,0,1,0
6,289,289,13,13,0,1,0
0,305,305,23,23,0,1,0
18,310,310,14,14,0,1,0
12,313,313,6,6,0,1,0
14,317,317,64,49,15,2,1
5,330,330,28,8,20,2,1
29,335,335,34,34,0,1,0
4,337,337,20,14,6,2,1
17,340,340,6,6,0,1,0
21,354,354,22,12,10,2,1
7,357,357,6,6,0,1,0
1,380,380,2,2,0,1,0
27,380,380,61,16,45,2,1
22,402,402,101,101,0,1,0
30,403,403,12,5,7,2,1
2,464,464,100,34,66,4,3
28,492,492,43,43,0,1,0

4,139,139,26,26,0,1,0
9,167,167,11,11,0,1,0
16,167,167,22,22,0,1,0
5,205,205,54,54,0,1,0
12,207,207,2,2,0,1,0
1,221,221,19,11,8,3,2
24,224,224,30,30,0,1,0
19,245,245,3,3,0,1,0
25,272,272,60,52,8,3,2
17,301,301,23,23,0,1,0
0,307,307,44,19,25,2,1
10,308,308,18,18,0,1,0
2,315,315,21,7,14,2,1
7,333,333,53,40,13,2,1
15,340,340,81,7,74,3,2
3,346,346,31,31,0,1,0
18,375,375,9,9,0,1,0
8,376,376,47,47,0,1,0
6,386,386,29,29,0,1,0
21,404,404,36,8,28,3,2
14,412,412,46,42,4,2,1
22,433,433,43,43,0,1,0
13,473,473,80,80,0,1,0
20,476,476,15,15,0,1,0
26,485,485,12,12,0,1,0
23,487,487,28,28,0,1,0
11,493,493,36,36,0,1,0

0,106,106,13,13,0,1,0
20,147,147,19,7,12,3,2
15,162,162,21,12,9,2,1
12,163,163,30,3,27,4,3
8,171,171,31,31,0,1,0
3,189,189,37,12,25,2,1
24,209,209,31,24,7,2,1
4,262,262,24,24,0,1,0
13,282,282,6,3,3,2,1
10,296,296,20,20,0,1,0
23,317,317,1,1,0,1,0
16,326,326,62,4,58,3,2
21,335,335,3,3,0,1,0
18,339,339,37,2,35,2,1
5,344,344,78,71,7,2,1
6,345,345,103,103,0,1,0
9,362,362,14,9,5,2,1
22,390,390,97,97,0,1,0
19,393,393,35,22,13,2,1
17,429,429,10,7,3,2,1
11,440,440,47,15,32,3,2
2,443,443,22,3,19,2,1
1,458,458,20,20,0,1,0
14,472,472,15,15,0,1,0
7,493,493,42,42,0,1,0

14,102,102,14,7,7,3,2
21,105,105,2,2,0,1,0
6,122,122,6,3,3,2,1
8,133,133,9,9,0,1,0
7,136,136,42,24,18,4,3
20,157,157,1,1,0,1,0
22,169,169,11,11,0,1,0
16,172,172,5,1,4,2,1
31,180,180,5,5,0,1,0
28,206,206,38,38,0,1,0
5,210,210,1,1,0,1,0
18,213,213,6,6,0,1,0
4,226,226,23,8,15,2,1
26,231,231,39,32,7,2,1
19,244,244,9,3,6,2,1
32,254,254,2,2,0,1,0
1,257,257,43,34,9,2,1
17,260,260,6,3,3,2,1
3,264,264,1,1,0,1,0
10,268,268,9,9,0,1,0
11,269,269,30,5,25,2,1
12,279,279,10,2,8,3,2
30,302,302,24,1,23,4,3
24,302,302,2,2,0,1,0
0,307,307,34,11,23,2,1
29,310,310,6,6,0,1,0
25,399,399,177,63,114,4,3
15,402,402,21,4,17,4,3
2,403,403,1,1,0,1,0
27,430,430,20,15,5,2,1
33,439,439,88,2,86,3,2
9,452,452,30,17,13,2,1
13,456,456,14,7,7,2,1
23,473,473,73,53,20,3,2

17,121,121,1,1,0,1,0
30,165,165,18,12,6,3,2
1,172,172,6,6,0,1,0
18,175,175,35,8,27,2,1
15,209,209,37,34,3,2,1
2,220,220,13,13,0,1,0
22,236,236,1,1,0,1,0
19,240,240,3,3,0,1,0
25,259,259,1,1,0,1,0
9,263,263,24,24,0,1,0
10,271,271,17,17,0,1,0
29,272,272,5,5,0,1,0
12,281,281,17,3,14,2,1
8,282,282,1,1,0,1,0
32,287,287,46,46,0,1,0
21,287,287,41,41,0,1,0
23,290,290,3,3,0,1,0
28,292,292,73,55,18,4,3
24,302,302,20,20,0,1,0
26,308,308,14,2,12,4,3
11,338,338,3,3,0,1,0
7,346,346,14,14,0,1,0
31,352,352,81,9,72,4,3
20,357,357,24,1,23,3,2
4,383,383,90,90,0,1,0
6,386,386,26,26,0,1,0
0,395,395,13,13,0,1,0
13,396,396,83,27,56,3,2
3,416,416,17,17,0,1,0
14,422,422,6,6,0,1,0
33,437,437,121,96,25,2,1
5,448,448,1,1,0,1,0
27,467,467,22,13,9,2,1
16,493,493,21,21,0,1,0

20,124,124,9,9,0,1,0
0,132,132,10,10,0,1,0
1,132,132,8,8,0,1,0
6,138,138,7,7,0,1,0
22,149,149,13,13,0,1,0
25,172,172,25,25,0,1,0
4,180,180,7,1,6,3,2
26,192,192,12,4,8,3,2
28,206,206,6,6,0,1,0
16,217,217,17,3,14,3,2
10,219,219,13,13,0,1,0
17,243,243,37,37,0,1,0
13,261,261,44,21,23,2,1
21,269,269,32,5,27,4,3
7,273,273,7,4,3,2,1
27,282,282,23,23,0,1,0
12,301,301,7,7,0,1,0
2,327,327,108,108,0,1,0
15,331,331,33,33,0,1,0
29,351,351,44,2,42,3,2
23,357,357,48,9,39,2,1
9,358,358,19,19,0,1,0
24,360,360,50,13,37,4,3
8,410,410,35,7,28,3,2
3,412,412,13,5,8,3,2
19,427,427,40,40,0,1,0
14,451,451,7,4,3,2,1
5,456,456,46,1,45,4,3
18,466,466,54,37,17,2,1
11,467,467,85,7,78,4,3

4,112,112,10,6,4,2,1
31,119,119,5,5,0,1,0
0,128,128,1,1,0,1,0
3,129,129,16,16,0,1,0
20,129,129,25,25,0,1,0
18,133,133,29,14,15,2,1
22,149,149,3,3,0,1,0
7,151,151,2,2,0,1,0
6,215,215,25,3,22,3,2
33,220,220,16,6,10,3,2
26,258,258,51,15,36,4,3
11,264,264,8,8,0,1,0
28,298,298,40,40,0,1,0
16,318,318,3,3,0,1,0
2,318,318,37,37,0,1,0
30,321,321,64,15,49,2,1
17,338,338,10,1,9,2,1
9,338,338,16,16,0,1,0
32,338,338,7,7,0,1,0
29,349,349,28,15,13,2,1
1,366,366,11,11,0,1,0
5,380,380,25,7,18,2,1
12,389,389,8,8,0,1,0
10,395,395,10,10,0,1,0
14,413,413,89,89,0,1,0
15,431,431,36,11,25,2,1
21,440,440,40,5,35,2,1
8,454,454,33,33,0,1,0
19,463,463,7,7,0,1,0
23,465,465,34,2,32,3,2
24,469,469,7,7,0,1,0
13,486,486,34,34,0,1,0
25,487,487,24,24,0,1,0
27,491,491,116,92,24,2,1

16,116,116,2,2,0,1,0
9,130,130,1,1,0,1,0
31,133,133,22,14,8,2,1
32,139,139,25,25,0,1,0
8,145,145,11,11,0,1,0
22,156,156,2,2,0,1,0
3,177,177,1,1,0,1,0
2,182,182,16,8,8,2,1
34,217,217,31,7,24,4,3
23,222,222,9,1,8,3,2
20,223,223,47,47,0,1,0
21,224,224,11,1,10,2,1
15,242,242,17,13,4,2,1
6,244,244,22,22,0,1,0
12,277,277,2,2,0,1,0
33,299,299,71,26,45,2,1
0,300,300,7,7,0,1,0
18,310,310,79,19,60,3,2
5,321,321,9,2,7,2,1
27,324,324,1,1,0,1,0
17,331,331,21,5,16,2,1
10,335,335,64,64,0,1,0
14,356,356,8,8,0,1,0
24,356,356,5,5,0,1,0
7,365,365,1,1,0,1,0
28,378,378,27,27,0,1,0
29,386,386,17,17,0,1,0
4,401,401,9,5,4,2,1
19,402,402,74,43,31,2,1
11,408,408,2,2,0,1,0
26,422,422,104,62,42,3,2
30,425,425,46,46,0,1,0
25,440,440,49,49,0,1,0
13,492,492,6,6,0,1,0
1,497,497,11,4,7,2,1

22,111,111,7,7,0,1,0
0,112,112,8,8,0,1,0
15,155,155,2,2,0,1,0
4,202,202,73,21,52,3,2
24,208,208,16,6,10,3,2
26,213,213,2,2,0,1,0
21,213,213,4,4,0,1,0
14,213,213,29,29,0,1,0
3,226,226,7,7,0,1,0
1,229,229,79,79,0,1,0
19,230,230,41,41,0,1,0
11,231,231,12,12,0,1,0
12,315,315,13,1,12,3,2
25,338,338,101,83,18,3,2
9,368,368,9,9,0,1,0
5,371,371,57,15,42,3,2
7,373,373,56,51,5,2,1
8,386,386,5,5,0,1,0
13,408,408,58,46,12,4,3
20,412,412,92,34,58,4,3
16,436,436,77,54,23,2,1
2,436,436,40,40,0,1,0
6,454,454,22,4,18,4,3
23,455,455,1,1,0,1,0
17,463,463,35,7,28,3,2
10,469,469,9,9,0,1,0
18,482,482,7,2,5,2,1

19,122,122,2,2,0,1,0
24,133,133,9,9,0,1,0
18,142,142,31,3,28,3,2
21,153,153,8,8,0,1,0
30,173,173,1,1,0,1,0
8,185,185,6,6,0,1,0
5,194,194,39,5,34,3,2
16,206,206,3,3,0,1,0
14,206,206,3,3,0,1,0
1,231,231,12,7,5,2,1
6,246,246,1,1,0,1,0
10,250,250,4,4,0,1,0
27,253,253,28,10,18,3,2
11,265,265,17,13,4,2,1
13,296,296,25,2,23,2,1
3,307,307,4,1,3,2,1
7,309,309,25,25,0,1,0
9,309,309,60,56,4,2,1
28,311,311,37,4,33,4,3
2,325,325,41,4,37,2,1
26,332,332,9,9,0,1,0
17,349,349,19,3,16,3,2
12,395,395,32,32,0,1,0
25,408,408,13,13,0,1,0
20,416,416,126,126,0,1,0
15,417,417,10,10,0,1,0
33,429,429,34,17,17,2,1
4,435,435,16,2,14,2,1
31,446,446,100,80,20,3,2
32,451,451,8,3,5,2,1
0,474,474,36,5,31,2,1
23,480,480,73,73,0,1,0
22,480,480,81,81,0,1,0
29,494,494,31,9,22,3,2

3,118,118,15,3,12,4,3
32,129,129,55,55,0,1,0
29,131,131,4,4,0,1,0
20,146,146,4,1,3,2,1
30,189,189,11,5,6,3,2
4,206,206,8,8,0,1,0
2,230,230,29,17,12,3,2
22,261,261,1,1,0,1,0
1,262,262,32,10,22,2,1
10,263,263,8,2,6,2,1
12,268,268,1,1,0,1,0
16,276,276,8,2,6,3,2
11,278,278,27,9,18,2,1
6,303,303,13,7,6,3,2
5,308,308,55,21,34,2,1
0,310,310,7,7,0,1,0
23,311,311,48,48,0,1,0
7,332,332,23,14,9,2,1
25,332,332,16,13,3,2,1
15,337,337,1,1,0,1,0
17,369,369,19,19,0,1,0
28,374,374,10,10,0,1,0
8,378,378,25,9,16,2,1
13,392,392,18,18,0,1,0
24,419,419,33,33,0,1,0
18,424,424,39,10,29,2,1
31,426,426,26,26,0,1,0
9,426,426,30,9,21,4,3
14,429,429,12,7,5,2,1
19,454,454,71,11,60,4,3
26,459,459,101,101,0,1,0
33,461,461,12,9,3,2,1
21,465,465,93,93,0,1,0
27,478,478,31,31,0,1,0

20,102,102,2,2,0,1,0
27,130,130,49,49,0,1,0
11,147,147,19,14,5,2,1
7,164,164,1,1,0,1,0
19,169,169,32,23,9,4,3
12,181,181,27,27,0,1,0
10,191,191,16,4,12,3,2
26,205,205,21,7,14,3,2
21,265,265,21,6,15,2,1
5,266,266,5,1,4,2,1
1,269,269,26,26,0,1,0
23,309,309,73,30,43,2,1
3,315,315,21,21,0,1,0
18,321,321,6,6,0,1,0
14,323,323,55,25,30,2,1
24,325,325,17,17,0,1,0
15,325,325,47,47,0,1,0
25,360,360,21,21,0,1,0
6,386,386,68,68,0,1,0
16,388,388,4,4,0,1,0
22,418,418,21,10,11,2,1
4,419,419,56,56,0,1,0
17,422,422,34,25,9,2,1
2,428,428,11,11,0,1,0
0,439,439,79,73,6,2,1
8,440,440,1,1,0,1,0
9,456,456,52,52,0,1,0
13,459,459,23,5,18,2,1
28,475,475,7,4,3,2,1

5,106,106,15,15,0,1,0
18,117,117,7,7,0,1,0
23,159,159,23,23,0,1,0
17,195,195,3,3,0,1,0
22,214,214,26,26,0,1,0
14,216,216,2,2,0,1,0
21,232,232,44,44,0,1,0
2,245,245,24,16,8,2,1
1,286,286,13,13,0,1,0
28,288,288,24,24,0,1,0
11,291,291,88,88,0,1,0
16,291,291,59,59,0,1,0
27,301,301,2,2,0,1,0
19,304,304,31,8,23,2,1
20,319,319,26,26,0,1,0
0,327,327,24,16,8,2,1
7,341,341,1,1,0,1,0
9,343,343,1,1,0,1,0
26,352,352,42,19,23,2,1
12,370,370,59,3,56,4,3
13,395,395,29,29,0,1,0
15,407,407,44,44,0,1,0
6,409,409,27,27,0,1,0
29,430,430,73,25,48,2,1
25,436,436,40,40,0,1,0
3,447,447,14,14,0,1,0
4,454,454,31,31,0,1,0
8,481,481,27,15,12,2,1
10,486,486,79,79,0,1,0
24,488,488,17,17,0,1,0

1,106,106,4,4,0,1,0
18,123,123,2,2,0,1,0
0,128,128,8,8,0,1,0
6,128,128,22,13,9,4,3
7,154,154,1,1,0,1,0
22,179,179,5,5,0,1,0
11,190,190,22,3,19,2,1
30,193,193,2,2,0,1,0
24,194,194,40,40,0,1,0
23,232,232,31,11,20,2,1
8,233,233,6,6,0,1,0
26,245,245,12,12,0,1,0
9,249,249,5,5,0,1,0
13,262,262,21,21,0,1,0
14,274,274,17,8,9,4,3
12,279,279,3,3,0,1,0
16,289,289,4,4,0,1,0
15,290,290,2,2,0,1,0
3,304,304,40,16,24,4,3
17,321,321,31,19,12,3,2
25,351,351,16,16,0,1,0
19,354,354,34,34,0,1,0
28,360,360,3,3,0,1,0
10,372,372,13,1,12,3,2
29,374,374,21,2,19,4,3
27,382,382,4,4,0,1,0
4,384,384,3,3,0,1,0
2,390,390,46,46,0,1,0
21,390,390,192,69,123,4,3
31,414,414,17,9,8,2,1
20,464,464,107,80,27,4,3
5,483,483,192,192,0,1,0

16,115,115,30,30,0,1,0
12,136,136,7,7,0,1,0
11,149,149,25,25,0,1,0
7,173,173,11,6,5,2,1
20,182,182,13,13,0,1,0
5,192,192,33,15,18,4,3
27,202,202,15,15,0,1,0
8,204,204,14,14,0,1,0
23,212,212,10,2,8,3,2
24,216,216,6,6,0,1,0
19,218,218,14,2,12,2,1
18,227,227,11,11,0,1,0
0,236,236,7,2,5,2,1
4,263,263,2,2,0,1,0
6,309,309,110,110,0,1,0
22,334,334,25,11,14,3,2
26,348,348,1,1,0,1,0
10,351,351,11,11,0,1,0
13,353,353,40,34,6,2,1
25,368,368,10,2,8,2,1
2,375,375,1,1,0,1,0
15,377,377,26,26,0,1,0
14,405,405,59,3,56,3,2
1,405,405,35,8,27,4,3
21,414,414,101,60,41,2,1
28,432,432,125,89,36,4,3
9,446,446,32,32,0,1,0
17,449,449,57,57,0,1,0
3,479,479,16,2,14,3,2

9,111,111,1,1,0,1,0
24,148,148,6,6,0,1,0
1,161,161,25,25,0,1,0
17,182,182,53,23,30,3,2
21,185,185,5,2,3,2,1
12,221,221,5,5,0,1,0
28,227,227,13,10,3,2,1
4,247,247,5,5,0,1,0
27,260,260,35,35,0,1,0
20,262,262,26,8,18,4,3
19,281,281,3,3,0,1,0
7,298,298,25,17,8,2,1
2,299,299,11,11,0,1,0
22,302,302,39,39,0,1,0
15,315,315,69,69,0,1,0
11,353,353,31,31,0,1,0
3,378,378,57,27,30,4,3
14,379,379,50,14,36,4,3
25,379,379,17,17,0,1,0
26,382,382,45,21,24,2,1
6,383,383,59,54,5,2,1
0,398,398,7,7,0,1,0
13,429,429,54,34,20,3,2
8,438,438,127,84,43,4,3
5,446,446,3,3,0,1,0
18,449,449,9,9,0,1,0
23,481,481,7,7,0,1,0
16,485,485,106,106,0,1,0
10,488,488,53,53,0,1,0

10,112,112,21,6,15,2,1
13,113,113,6,6,0,1,0
5,131,131,3,3,0,1,0
21,131,131,30,18,12,2,1
17,168,168,16,16,0,1,0
18,174,174,32,32,0,1,0
27,186,186,11,11,0,1,0
14,191,191,26,6,20,4,3
8,193,193,35,10,25,2,1
26,198,198,10,1,9,4,3
12,202,202,6,2,4,2,1
16,231,231,10,10,0,1,0
24,238,238,24,3,21,4,3
11,242,242,13,13,0,1,0
19,272,272,41,4,37,2,1
29,277,277,17,17,0,1,0
23,318,318,33,27,6,3,2
4,325,325,1,1,0,1,0
30,336,336,12,5,7,3,2
2,347,347,3,3,0,1,0
7,354,354,106,60,46,2,1
15,382,382,65,65,0,1,0
9,410,410,1,1,0,1,0
6,417,417,3,3,0,1,0
20,421,421,22,4,18,2,1
1,439,439,78,2,76,3,2
25,455,455,94,16,78,3,2
22,474,474,6,3,3,2,1
28,479,479,42,33,9,4,3
3,480,480,9,9,0,1,0
0,498,498,4,4,0,1,0

33,141,141,11,11,0,1,0
4,144,144,1,1,0,1,0
14,152,152,4,4,0,1,0
25,154,154,9,9,0,1,0
0,164,164,19,10,9,4,3
28,169,169,41,41,0,1,0
26,177,177,18,18,0,1,0
13,181,181,10,10,0,1,0
31,191,191,7,7,0,1,0
10,204,204,14,14,0,1,0
2,208,208,13,13,0,1,0
11,218,218,14,14,0,1,0
23,239,239,35,23,12,2,1
18,250,250,38,38,0,1,0
6,256,256,8,8,0,1,0
1,259,259,26,12,14,3,2
9,268,268,35,35,0,1,0
3,277,277,4,1,3,2,1
29,278,278,57,39,18,4,3
17,281,281,1,1,0,1,0
20,305,305,67,67,0,1,0
32,338,338,85,10,75,4,3
30,347,347,14,14,0,1,0
5,358,358,4,4,0,1,0
19,361,361,20,7,13,3,2
21,361,361,6,6,0,1,0
16,368,368,6,6,0,1,0
8,370,370,34,2,32,4,3
35,376,376,12,12,0,1,0
27,391,391,16,4,12,2,1
12,391,391,3,3,0,1,0
15,413,413,45,31,14,3,2
24,449,449,1,1,0,1,0
22,450,450,64,64,0,1,0
34,472,472,22,5,17,2,1
7,486,486,20,20,0,1,0

22,111,111,11,4,7,2,1
23,116,116,17,17,0,1,0
4,125,125,10,1,9,2,1
18,178,178,8,8,0,1,0
1,201,201,56,56,0,1,0
5,225,225,32,32,0,1,0
17,241,241,79,79,0,1,0
16,243,243,43,23,20,2,1
14,252,252,4,4,0,1,0
6,257,257,5,5,0,1,0
7,273,273,15,15,0,1,0
10,292,292,10,5,5,2,1
15,309,309,10,4,6,3,2
2,310,310,13,5,8,2,1
20,320,320,24,24,0,1,0
0,357,357,31,18,13,2,1
25,389,389,9,3,6,2,1
19,390,390,52,22,30,3,2
27,393,393,36,9,27,2,1
11,394,394,6,6,0,1,0
12,401,401,48,48,0,1,0
26,410,410,16,16,0,1,0
3,428,428,65,65,0,1,0
24,448,448,34,25,9,2,1
9,450,450,95,35,60,4,3
13,472,472,57,20,37,2,1
21,489,489,71,71,0,1,0
8,500,500,22,22,0,1,0

5,113,113,2,2,0,1,0
18,131,131,3,3,0,1,0
28,166,166,16,4,12,4,3
12,177,177,33,33,0,1,0
25,205,205,27,6,21,2,1
30,216,216,20,20,0,1,0
15,229,229,40,40,0,1,0
27,231,231,42,42,0,1,0
20,231,231,18,6,12,4,3
6,233,233,10,4,6,2,1
7,287,287,22,22,0,1,0
16,310,310,39,17,22,4,3
0,311,311,48,48,0,1,0
11,314,314,1,1,0,1,0
9,319,319,16,16,0,1,0
21,327,327,35,35,0,1,0
13,349,349,29,4,25,4,3
1,355,355,15,7,8,2,1
10,356,356,35,35,0,1,0
17,360,360,40,40,0,1,0
24,367,367,98,56,42,4,3
14,369,369,10,1,9,2,1
22,370,370,13,13,0,1,0
2,383,383,99,99,0,1,0
19,400,400,12,12,0,1,0
8,421,421,12,12,0,1,0
26,444,444,21,21,0,1,0
29,476,476,66,15,51,4,3
3,484,484,7,7,0,1,0
4,488,488,9,9,0,1,0
23,489,489,37,16,21,2,1

24,105,105,17,5,12,4,3
20,110,110,7,7,0,1,0
2,114,114,5,5,0,1,0
13,115,115,15,9,6,2,1
5,124,124,2,2,0,1,0
8,130,130,2,2,0,1,0
25,134,134,26,26,0,1,0
21,157,157,7,3,4,2,1
14,203,203,19,7,12,4,3
4,207,207,3,3,0,1,0
19,216,216,11,1,10,2,1
1,227,227,27,4,23,2,1
22,230,230,7,1,6,3,2
3,244,244,2,2,0,1,0
9,254,254,19,7,12,2,1
16,258,258,42,18,24,3,2
12,287,287,10,10,0,1,0
11,289,289,92,92,0,1,0
27,300,300,57,36,21,4,3
15,301,301,1,1,0,1,0
0,306,306,1,1,0,1,0
26,308,308,9,9,0,1,0
23,314,314,11,11,0,1,0
29,322,322,4,4,0,1,0
6,340,340,102,53,49,2,1
18,354,354,83,27,56,3,2
10,356,356,14,14,0,1,0
17,363,363,39,13,26,3,2
28,382,382,50,50,0,1,0
30,415,415,66,42,24,2,1
7,430,430,11,5,6,3,2

5,116,116,2,2,0,1,0
20,156,156,16,16,0,1,0
16,171,171,46,46,0,1,0
8,174,174,7,1,6,3,2
17,197,197,23,23,0,1,0
1,202,202,21,15,6,3,2
14,215,215,10,10,0,1,0
25,224,224,11,11,0,1,0
15,236,236,34,23,11,2,1
12,243,243,32,19,13,2,1
23,246,246,22,22,0,1,0
13,247,247,36,36,0,1,0
9,306,306,41,41,0,1,0
22,336,336,11,11,0,1,0
0,343,343,9,2,7,2,1
2,349,349,29,29,0,1,0
10,353,353,142,142,0,1,0
26,360,360,7,7,0,1,0
4,367,367,32,32,0,1,0
19,370,370,28,23,5,2,1
11,385,385,9,9,0,1,0
3,402,402,2,2,0,1,0
21,413,413,34,8,26,3,2
28,431,431,30,30,0,1,0
6,463,463,47,47,0,1,0
7,465,465,26,19,7,2,1
27,467,467,21,21,0,1,0
24,469,469,63,63,0,1,0
18,497,497,95,95,0,1,0

29,103,103,1,1,0,1,0
21,104,104,8,8,0,1,0
19,109,109,6,6,0,1,0
30,119,119,14,14,0,1,0
27,147,147,27,27,0,1,0
7,150,150,8,8,0,1,0
15,184,184,30,17,13,2,1
16,189,189,2,2,0,1,0
24,212,212,57,57,0,1,0
4,216,216,8,1,7,2,1
2,238,238,10,10,0,1,0
25,241,241,1,1,0,1,0
1,247,247,8,8,0,1,0
14,312,312,2,2,0,1,0
13,334,334,38,1,37,2,1
18,338,338,3,3,0,1,0
3,348,348,44,44,0,1,0
5,349,349,24,24,0,1,0
20,391,391,89,14,75,4,3
28,396,396,93,19,74,3,2
9,400,400,21,21,0,1,0
17,403,403,8,8,0,1,0
0,407,407,40,40,0,1,0
6,420,420,141,78,63,4,3
26,432,432,23,13,10,2,1
8,439,439,33,1,32,4,3
23,448,448,84,30,54,3,2
11,465,465,8,8,0,1,0
12,479,479,60,37,23,2,1
22,481,481,2,2,0,1,0
10,490,490,21,9,12,2,1

18,135,135,2,2,0,1,0
20,153,153,38,9,29,4,3
17,160,160,10,1,9,3,2
0,172,172,2,2,0,1,0
15,192,192,18,18,0,1,0
13,194,194,19,19,0,1,0
25,195,195,66,66,0,1,0
6,208,208,15,15,0,1,0
22,214,214,18,18,0,1,0
24,218,218,37,28,9,4,3
16,243,243,7,7,0,1,0
12,260,260,28,28,0,1,0
8,268,268,59,50,9,2,1
21,270,270,10,5,5,2,1
1,276,276,13,13,0,1,0
4,280,280,1,1,0,1,0
23,340,340,32,32,0,1,0
3,361,361,85,27,58,3,2
7,381,381,98,98,0,1,0
11,404,404,52,52,0,1,0
5,411,411,61,61,0,1,0
26,431,431,28,28,0,1,0
9,450,450,47,14,33,4,3
19,454,454,36,14,22,2,1
10,463,463,1,1,0,1,0
2,470,470,29,29,0,1,0
14,481,481,8,8,0,1,0

22,101,101,10,10,0,1,0
3,104,104,29,29,0,1,0
24,122,122,15,15,0,1,0
15,124,124,11,7,4,2,1
12,151,151,23,4,19,2,1
2,167,167,21,10,11,2,1
13,168,168,2,2,0,1,0
0,175,175,48,48,0,1,0
16,226,226,57,57,0,1,0
6,241,241,38,38,0,1,0
14,243,243,18,18,0,1,0
18,262,262,12,4,8,3,2
1,265,265,18,18,0,1,0
21,265,265,72,72,0,1,0
17,309,309,24,24,0,1,0
10,313,313,36,2,34,3,2
20,384,384,9,9,0,1,0
4,399,399,6,1,5,2,1
9,401,401,97,97,0,1,0
23,422,422,30,30,0,1,0
19,428,428,46,46,0,1,0
11,452,452,16,1,15,4,3
8,457,457,33,3,30,2,1
5,473,473,20,20,0,1,0
7,494,494,5,5,0,1,0

18,108,108,3,3,0,1,0
3,110,110,4,4,0,1,0
22,124,124,17,1,16,4,3
15,139,139,18,18,0,1,0
16,141,141,4,4,0,1,0
6,170,170,9,1,8,3,2
19,170,170,3,3,0,1,0
21,198,198,21,21,0,1,0
24,203,203,11,3,8,3,2
0,231,231,36,36,0,1,0
4,236,236,9,9,0,1,0
11,289,289,72,30,42,4,3
12,315,315,33,33,0,1,0
23,315,315,132,132,0,1,0
7,333,333,1,1,0,1,0
14,355,355,33,33,0,1,0
8,396,396,47,47,0,1,0
9,403,403,25,25,0,1,0
25,414,414,9,9,0,1,0
10,418,418,171,171,0,1,0
20,421,421,34,14,20,2,1
17,433,433,87,41,46,2,1
13,479,479,1,1,0,1,0
5,483,483,55,55,0,1,0
1,490,490,32,5,27,2,1
2,500,500,49,49,0,1,0

10,118,118,12,12,0,1,0
24,125,125,8,8,0,1,0
18,134,134,16,16,0,1,0
23,138,138,16,16,0,1,0
0,156,156,7,7,0,1,0
16,181,181,55,13,42,2,1
8,189,189,25,4,21,2,1
14,209,209,4,1,3,2,1
3,220,220,8,8,0,1,0
7,227,227,28,8,20,2,1
25,232,232,20,20,0,1,0
28,248,248,8,8,0,1,0
19,281,281,4,4,0,1,0
9,286,286,20,20,0,1,0
27,287,287,5,5,0,1,0
12,309,309,6,2,4,2,1
11,334,334,36,18,18,2,1
29,354,354,33,29,4,2,1
5,356,356,21,1,20,2,1
17,374,374,9,9,0,1,0
6,392,392,47,47,0,1,0
22,419,419,59,59,0,1,0
21,445,445,92,35,57,4,3
26,448,448,74,44,30,3,2
2,451,451,59,44,15,2,1
20,453,453,20,20,0,1,0
15,454,454,36,33,3,2,1
13,476,476,83,83,0,1,0
4,493,493,56,56,0,1,0
1,498,498,35,35,0,1,0

27,133,133,11,4,7,3,2
7,133,133,9,9,0,1,0
17,163,163,1,1,0,1,0
3,176,176,11,11,0,1,0
4,179,179,28,5,23,4,3
22,196,196,20,20,0,1,0
20,220,220,12,12,0,1,0
26,240,240,49,49,0,1,0
8,258,258,18,18,0,1,0
21,261,261,9,3,6,2,1
9,264,264,36,36,0,1,0
23,272,272,69,69,0,1,0
15,292,292,1,1,0,1,0
12,319,319,3,3,0,1,0
0,331,331,86,70,16,2,1
19,357,357,34,7,27,4,3
18,371,371,69,48,21,4,3
25,375,375,19,13,6,3,2
14,380,380,25,5,20,2,1
6,383,383,56,56,0,1,0
2,383,383,9,9,0,1,0
13,421,421,25,10,15,4,3
10,441,441,169,130,39,4,3
24,444,444,9,5,4,2,1
11,452,452,2,2,0,1,0
1,453,453,6,6,0,1,0
16,455,455,124,50,74,3,2
5,499,499,5,1,4,2,1

33,113,113,14,14,0,1,0
12,118,118,8,3,5,2,1
21,137,137,7,7,0,1,0
5,160,160,16,16,0,1,0
13,164,164,4,4,0,1,0
18,167,167,39,7,32,3,2
25,183,183,21,1,20,4,3
1,203,203,61,61,0,1,0
28,209,209,6,6,0,1,0
31,224,224,26,26,0,1,0
17,227,227,32,32,0,1,0
7,234,234,15,8,7,2,1
15,234,234,17,2,15,2,1
23,234,234,8,8,0,1,0
3,240,240,6,6,0,1,0
0,278,278,1,1,0,1,0
22,331,331,52,17,35,2,1
29,339,339,30,30,0,1,0
4,340,340,27,20,7,2,1
2,347,347,4,4,0,1,0
30,353,353,45,7,38,3,2
9,358,358,2,2,0,1,0
11,364,364,25,25,0,1,0
14,364,364,1,1,0,1,0
32,365,365,19,7,12,3,2
24,378,378,70,70,0,1,0
20,382,382,67,29,38,3,2
16,384,384,9,2,7,2,1
27,418,418,5,1,4,2,1
8,420,420,26,20,6,2,1
19,429,429,17,17,0,1,0
10,444,444,22,22,0,1,0
6,455,455,12,12,0,1,0
26,468,468,75,26,49,2,1

11,118,118,26,26,0,1,0
18,125,125,5,1,4,2,1
2,142,142,43,43,0,1,0
1,169,169,25,21,4,2,1
14,171,171,8,4,4,2,1
19,187,187,1,1,0,1,0
8,199,199,2,2,0,1,0
7,219,219,15,4,11,2,1
25,219,219,75,55,20,3,2
16,225,225,29,29,0,1,0
17,243,243,14,8,6,2,1
3,267,267,32,32,0,1,0
12,271,271,3,3,0,1,0
6,285,285,23,10,13,2,1
4,297,297,4,4,0,1,0
10,305,305,4,4,0,1,0
0,310,310,35,30,5,2,1
20,313,313,29,8,21,2,1
15,318,318,23,23,0,1,0
24,338,338,33,33,0,1,0
26,344,344,40,40,0,1,0
29,346,346,49,49,0,1,0
22,371,371,3,3,0,1,0
28,385,385,102,102,0,1,0
5,402,402,9,9,0,1,0
23,405,405,53,53,0,1,0
30,415,415,37,7,30,2,1
21,420,420,11,11,0,1,0
9,452,452,12,12,0,1,0
13,457,457,2,2,0,1,0
27,458,458,5,5,0,1,0

24,134,134,10,6,4,2,1
6,135,135,8,4,4,2,1
21,162,162,10,10,0,1,0
25,166,166,16,7,9,4,3
1,172,172,42,12,30,2,1
5,194,194,10,4,6,2,1
0,243,243,21,21,0,1,0
26,249,249,19,19,0,1,0
3,268,268,8,2,6,3,2
11,273,273,90,18,72,4,3
4,278,278,7,7,0,1,0
13,295,295,15,15,0,1,0
7,304,304,59,59,0,1,0
19,306,306,103,103,0,1,0
9,309,309,10,10,0,1,0
18,335,335,18,18,0,1,0
16,341,341,55,9,46,2,1
8,348,348,25,25,0,1,0
28,385,385,21,21,0,1,0
23,397,397,1,1,0,1,0
12,406,406,10,4,6,3,2
10,410,410,51,19,32,2,1
14,431,431,28,22,6,3,2
15,437,437,22,6,16,2,1
22,472,472,46,13,33,2,1
20,479,479,33,24,9,4,3
17,490,490,65,23,42,3,2
27,491,491,77,23,54,4,3
2,498,498,6,1,5,2,1

24,142,142,71,62,9,2,1
28,150,150,20,20,0,1,0
22,150,150,2,2,0,1,0
1,152,152,20,20,0,1,0
8,168,168,19,19,0,1,0
2,172,172,12,12,0,1,0
21,174,174,3,3,0,1,0
27,179,179,9,9,0,1,0
14,181,181,4,1,3,2,1
20,195,195,22,22,0,1,0
3,202,202,5,5,0,1,0
10,209,209,1,1,0,1,0
15,212,212,38,38,0,1,0
18,226,226,41,41,0,1,0
25,251,251,11,11,0,1,0
11,278,278,104,104,0,1,0
23,282,282,10,2,8,3,2
26,302,302,5,5,0,1,0
7,309,309,48,48,0,1,0
0,337,337,22,22,0,1,0
16,341,341,13,3,10,3,2
19,341,341,5,5,0,1,0
4,358,358,8,8,0,1,0
9,399,399,81,81,0,1,0
12,439,439,6,6,0,1,0
6,468,468,49,37,12,2,1
13,473,473,34,34,0,1,0
5,487,487,14,14,0,1,0
17,497,497,44,30,14,2,1

19,109,109,12,12,0,1,0
15,122,122,10,10,0,1,0
11,141,141,1,1,0,1,0
3,155,155,22,22,0,1,0
13,162,162,3,3,0,1,0
7,200,200,52,15,37,4,3
23,249,249,30,6,24,2,1
22,258,258,26,9,17,2,1
16,267,267,53,27,26,2,1
6,284,284,21,15,6,3,2
5,294,294,36,21,15,4,3
20,323,323,102,15,87,4,3
26,333,333,12,12,0,1,0
1,335,335,20,20,0,1,0
12,341,341,62,57,5,2,1
18,353,353,89,67,22,3,2
21,355,355,9,9,0,1,0
4,400,400,23,6,17,4,3
14,403,403,8,8,0,1,0
10,411,411,9,9,0,1,0
17,412,412,2,2,0,1,0
9,462,462,93,3,90,4,3
25,464,464,2,2,0,1,0
8,470,470,55,15,40,4,3
24,478,478,62,52,10,2,1
0,480,480,51,51,0,1,0
2,500,500,26,14,12,2,1

20,114,114,6,1,5,2,1
10,129,129,11,11,0,1,0
14,132,132,4,4,0,1,0
35,134,134,43,43,0,1,0
32,138,138,6,6,0,1,0
11,141,141,2,2,0,1,0
0,142,142,7,7,0,1,0
4,151,151,10,10,0,1,0
27,160,160,6,6,0,1,0
28,163,163,11,2,9,4,3
7,185,185,5,5,0,1,0
3,193,193,12,12,0,1,0
18,204,204,16,16,0,1,0
24,237,237,27,27,0,1,0
33,254,254,65,65,0,1,0
21,265,265,4,4,0,1,0
1,290,290,17,8,9,2,1
36,300,300,70,58,12,2,1
15,317,317,34,3,31,2,1
26,321,321,19,5,14,3,2
19,323,323,7,7,0,1,0
16,378,378,38,38,0,1,0
31,378,378,36,14,22,4,3
17,379,379,6,6,0,1,0
29,381,381,10,10,0,1,0
13,385,385,65,65,0,1,0
9,396,396,3,3,0,1,0
6,398,398,9,9,0,1,0
34,421,421,4,4,0,1,0
8,451,451,23,23,0,1,0
30,456,456,45,10,35,4,3
2,465,465,121,19,102,4,3
25,468,468,22,4,18,3,2
22,478,478,9,9,0,1,0
12,491,491,32,29,3,2,1
5,495,495,11,2,9,2,1
23,499,499,9,4,5,2,1

27,123,123,11,11,0,1,0
16,123,123,1,1,0,1,0
12,126,126,3,3,0,1,0
18,128,128,19,3,16,2,1
6,140,140,5,2,3,2,1
8,156,156,27,27,0,1,0
11,159,159,15,3,12,4,3
28,196,196,4,1,3,2,1
1,203,203,14,14,0,1,0
30,207,207,64,42,22,2,1
24,216,216,25,25,0,1,0
20,257,257,88,42,46,4,3
17,262,262,9,2,7,2,1
26,264,264,11,6,5,2,1
21,305,305,28,28,0,1,0
9,309,309,10,3,7,2,1
2,312,312,43,43,0,1,0
23,324,324,14,14,0,1,0
14,342,342,35,35,0,1,0
3,342,342,43,7,36,3,2
15,356,356,3,3,0,1,0
7,357,357,9,3,6,3,2
22,371,371,1,1,0,1,0
5,401,401,9,9,0,1,0
25,408,408,30,24,6,2,1
13,419,419,24,24,0,1,0
19,441,441,35,35,0,1,0
29,446,446,17,17,0,1,0
0,455,455,118,86,32,2,1
4,479,479,66,52,14,2,1
10,486,486,45,34,11,2,1

15,103,103,7,1,6,3,2
3,142,142,10,7,3,2,1
7,155,155,13,4,9,2,1
19,164,164,60,37,23,2,1
8,180,180,106,106,0,1,0
17,183,183,2,2,0,1,0
25,184,184,49,49,0,1,0
20,194,194,10,2,8,2,1
14,195,195,6,1,5,2,1
24,203,203,2,2,0,1,0
12,203,203,13,13,0,1,0
9,204,204,81,81,0,1,0
4,205,205,10,10,0,1,0
18,213,213,13,13,0,1,0
23,261,261,27,27,0,1,0
13,265,265,1,1,0,1,0
5,305,305,33,33,0,1,0
21,310,310,11,11,0,1,0
2,311,311,2,2,0,1,0
22,353,353,1,1,0,1,0
1,403,403,25,1,24,4,3
10,410,410,5,1,4,2,1
0,415,415,1,1,0,1,0
16,448,448,164,130,34,4,3
6,468,468,3,3,0,1,0
11,498,498,7,7,0,1,0

3,116,116,42,5,37,3,2
2,130,130,86,86,0,1,0
15,170,170,5,5,0,1,0
13,173,173,40,40,0,1,0
12,207,207,5,5,0,1,0
10,232,232,33,33,0,1,0
1,259,259,40,40,0,1,0
5,280,280,44,44,0,1,0
17,292,292,29,29,0,1,0
4,303,303,11,7,4,2,1
8,318,318,16,7,9,4,3
16,319,319,26,19,7,2,1
7,335,335,6,6,0,1,0
14,370,370,89,37,52,3,2
11,373,373,14,4,10,2,1
6,380,380,102,51,51,4,3
9,418,418,5,5,0,1,0
0,463,463,106,106,0,1,0

12,112,112,13,13,0,1,0
4,124,124,23,2,21,2,1
21,133,133,31,1,30,3,2
23,156,156,1,1,0,1,0
10,181,181,45,12,33,2,1
20,213,213,27,27,0,1,0
26,221,221,23,6,17,2,1
14,229,229,34,12,22,2,1
15,239,239,34,34,0,1,0
0,266,266,14,5,9,4,3
9,269,269,12,12,0,1,0
13,272,272,37,25,12,2,1
8,273,273,12,4,8,2,1
25,280,280,23,14,9,4,3
19,282,282,28,4,24,3,2
17,302,302,17,17,0,1,0
11,319,319,12,12,0,1,0
2,360,360,5,1,4,2,1
3,363,363,54,31,23,2,1
22,366,366,25,25,0,1,0
1,406,406,47,47,0,1,0
7,429,429,144,42,102,4,3
18,450,450,1,1,0,1,0
5,456,456,13,5,8,2,1
24,465,465,77,17,60,4,3
16,470,470,25,25,0,1,0
6,485,485,16,10,6,2,1

21,104,104,18,3,15,2,1
6,120,120,15,15,0,1,0
3,154,154,1,1,0,1,0
28,174,174,13,6,7,2,1
26,197,197,7,3,4,2,1
9,226,226,3,3,0,1,0
15,234,234,44,12,32,3,2
7,253,253,27,1,26,2,1
14,254,254,1,1,0,1,0
12,274,274,37,37,0,1,0
1,278,278,28,4,24,4,3
2,292,292,19,6,13,2,1
11,293,293,121,121,0,1,0
17,296,296,30,30,0,1,0
4,357,357,17,17,0,1,0
13,365,365,1,1,0,1,0
24,366,366,7,7,0,1,0
8,368,368,11,11,0,1,0
25,393,393,19,14,5,2,1
19,409,409,145,63,82,3,2
23,412,412,37,37,0,1,0
10,419,419,38,38,0,1,0
0,437,437,2,2,0,1,0
16,440,440,43,43,0,1,0
18,448,448,28,28,0,1,0
27,467,467,29,2,27,4,3
5,470,470,120,80,40,3,2
20,474,474,37,4,33,2,1
22,488,488,21,21,0,1,0

