18,102,102,1,1,0,1,0
27,103,103,6,6,0,1,0
28,135,135,2,2,0,1,0
23,136,136,8,8,0,1,0
8,141,141,3,3,0,1,0
36,141,141,7,2,5,2,1
19,145,145,22,8,14,2,1
26,184,184,27,4,23,2,1
32,185,185,2,2,0,1,0
9,198,198,40,21,19,2,1
7,198,198,2,2,0,1,0
14,215,215,4,4,0,1,0
41,217,217,22,19,3,2,1
10,221,221,19,13,6,3,2
42,234,234,14,14,0,1,0
4,235,235,28,28,0,1,0
2,245,245,60,60,0,1,0
40,246,246,2,2,0,1,0
1,255,255,6,6,0,1,0
12,265,265,15,4,11,4,3
24,266,266,7,3,4,2,1
43,293,293,120,3,117,4,3
31,297,297,22,7,15,2,1
34,311,311,122,24,98,3,2
37,315,315,130,73,57,4,3
39,336,336,3,3,0,1,0
3,379,379,9,9,0,1,0
35,386,386,13,13,0,1,0
0,390,390,75,75,0,1,0
22,395,395,65,9,56,3,2
20,399,399,7,7,0,1,0
5,412,412,34,16,18,3,2
17,424,424,30,30,0,1,0
21,430,430,5,5,0,1,0
15,431,431,2,2,0,1,0
38,433,433,1,1,0,1,0
29,448,448,1,1,0,1,0
25,448,448,45,45,0,1,0
16,449,449,28,7,21,3,2
11,455,455,1,1,0,1,0
33,475,475,17,2,15,2,1
6,484,484,103,94,9,2,1
13,491,491,13,13,0,1,0
30,498,498,8,4,4,2,1

21,102,102,11,1,10,2,1
10,112,112,35,7,28,2,1
1,114,114,24,24,0,1,0
23,128,128,9,9,0,1,0
13,133,133,36,12,24,3,2
5,137,137,3,3,0,1,0
11,137,137,22,22,0,1,0
30,156,156,58,15,43,2,1
28,161,161,6,6,0,1,0
27,163,163,8,8,0,1,0
29,171,171,2,2,0,1,0
15,184,184,9,9,0,1,0
20,186,186,7,7,0,1,0
18,238,238,26,8,18,4,3
19,246,246,25,25,0,1,0
16,250,250,2,2,0,1,0
25,264,264,11,11,0,1,0
0,268,268,21,3,18,3,2
34,276,276,5,5,0,1,0
6,293,293,120,84,36,3,2
24,321,321,93,93,0,1,0
32,332,332,28,20,8,3,2
26,339,339,7,1,6,3,2
17,341,341,5,5,0,1,0
36,351,351,38,31,7,2,1
7,362,362,5,1,4,2,1
2,410,410,67,34,33,4,3
33,418,418,11,11,0,1,0
22,421,421,78,58,20,3,2
4,422,422,33,33,0,1,0
3,430,430,3,3,0,1,0
35,440,440,87,87,0,1,0
12,448,448,6,3,3,2,1
8,458,458,7,7,0,1,0
9,494,494,3,3,0,1,0
31,497,497,32,32,0,1,0
14,500,500,34,20,14,3,2

11,125,125,6,6,0,1,0
17,127,127,2,2,0,1,0
16,129,129,4,4,0,1,0
12,129,129,13,13,0,1,0
24,132,132,26,26,0,1,0
1,134,134,44,44,0,1,0
18,153,153,27,27,0,1,0
36,156,156,17,12,5,2,1
31,165,165,9,9,0,1,0
23,169,169,9,3,6,2,1
5,170,170,19,19,0,1,0
7,186,186,7,7,0,1,0
4,198,198,2,2,0,1,0
2,200,200,2,2,0,1,0
27,225,225,23,23,0,1,0
34,226,226,50,27,23,2,1
35,242,242,30,30,0,1,0
14,264,264,19,7,12,3,2
15,288,288,73,58,15,4,3
29,359,359,46,46,0,1,0
8,359,359,75,75,0,1,0
3,365,365,31,21,10,3,2
6,372,372,3,3,0,1,0
32,373,373,14,9,5,2,1
10,378,378,81,81,0,1,0
22,391,391,26,26,0,1,0
20,392,392,9,9,0,1,0
0,393,393,25,25,0,1,0
9,395,395,43,25,18,4,3
19,414,414,16,8,8,2,1
37,417,417,51,51,0,1,0
21,432,432,44,44,0,1,0
33,445,445,103,103,0,1,0
26,450,450,3,3,0,1,0
30,465,465,69,69,0,1,0
28,471,471,60,53,7,2,1
13,489,489,11,11,0,1,0
25,495,495,21,21,0,1,0

8,101,101,11,11,0,1,0
3,111,111,11,3,8,2,1
32,119,119,1,1,0,1,0
14,121,121,5,5,0,1,0
19,156,156,5,5,0,1,0
26,168,168,9,9,0,1,0
11,178,178,7,7,0,1,0
13,188,188,22,10,12,4,3
27,199,199,23,23,0,1,0
20,209,209,21,21,0,1,0
25,227,227,6,6,0,1,0
21,256,256,65,18,47,3,2
15,257,257,8,8,0,1,0
23,275,275,2,2,0,1,0
18,283,283,59,9,50,2,1
34,284,284,2,2,0,1,0
17,294,294,49,31,18,4,3
1,304,304,100,30,70,3,2
31,324,324,29,20,9,2,1
4,327,327,5,5,0,1,0
2,330,330,1,1,0,1,0
28,333,333,41,32,9,4,3
5,348,348,107,107,0,1,0
12,356,356,27,11,16,3,2
6,362,362,52,52,0,1,0
7,382,382,8,8,0,1,0
10,399,399,34,34,0,1,0
33,438,438,3,3,0,1,0
9,439,439,46,46,0,1,0
35,457,457,6,3,3,2,1
24,457,457,167,167,0,1,0
29,464,464,44,11,33,4,3
30,472,472,79,35,44,4,3
22,483,483,46,46,0,1,0
16,493,493,154,139,15,4,3
0,499,499,33,5,28,3,2

5,108,108,2,2,0,1,0
30,123,123,22,16,6,3,2
34,124,124,3,3,0,1,0
37,131,131,4,4,0,1,0
15,171,171,39,27,12,2,1
8,175,175,1,1,0,1,0
10,176,176,1,1,0,1,0
26,180,180,19,19,0,1,0
35,187,187,17,9,8,3,2
6,220,220,1,1,0,1,0
16,221,221,20,5,15,4,3
3,261,261,34,34,0,1,0
39,265,265,30,20,10,2,1
9,270,270,8,3,5,2,1
4,276,276,8,8,0,1,0
41,278,278,1,1,0,1,0
40,286,286,16,4,12,2,1
12,319,319,15,15,0,1,0
32,328,328,27,15,12,3,2
13,332,332,9,4,5,2,1
24,336,336,34,34,0,1,0
31,337,337,106,6,100,3,2
27,338,338,37,37,0,1,0
38,341,341,70,23,47,2,1
0,344,344,11,11,0,1,0
21,350,350,14,3,11,2,1
25,355,355,22,22,0,1,0
20,364,364,35,35,0,1,0
23,377,377,46,46,0,1,0
17,382,382,100,63,37,2,1
11,385,385,4,1,3,2,1
18,407,407,1,1,0,1,0
2,420,420,47,47,0,1,0
1,429,429,60,20,40,3,2
33,434,434,61,53,8,3,2
29,442,442,71,27,44,3,2
36,444,444,2,2,0,1,0
7,453,453,217,217,0,1,0
22,476,476,4,4,0,1,0
14,478,478,37,16,21,4,3
19,487,487,12,12,0,1,0
28,497,497,16,2,14,2,1

30,114,114,5,2,3,2,1
23,115,115,17,3,14,2,1
24,121,121,32,2,30,2,1
5,137,137,22,12,10,3,2
12,139,139,9,9,0,1,0
34,147,147,3,3,0,1,0
22,149,149,8,3,5,2,1
31,166,166,1,1,0,1,0
33,177,177,6,6,0,1,0
2,180,180,48,48,0,1,0
15,199,199,1,1,0,1,0
17,207,207,55,17,38,3,2
28,221,221,6,6,0,1,0
10,240,240,4,1,3,2,1
37,248,248,19,19,0,1,0
8,251,251,6,6,0,1,0
38,280,280,51,51,0,1,0
21,284,284,3,3,0,1,0
14,290,290,25,25,0,1,0
18,351,351,39,31,8,2,1
13,364,364,1,1,0,1,0
0,368,368,4,1,3,2,1
16,374,374,62,53,9,4,3
9,385,385,1,1,0,1,0
27,386,386,38,38,0,1,0
19,393,393,36,36,0,1,0
25,405,405,153,135,18,3,2
7,409,409,128,128,0,1,0
3,413,413,25,25,0,1,0
4,437,437,2,2,0,1,0
20,438,438,79,79,0,1,0
1,440,440,8,8,0,1,0
26,446,446,3,3,0,1,0
35,448,448,1,1,0,1,0
11,456,456,94,58,36,4,3
36,462,462,8,8,0,1,0
29,463,463,156,118,38,2,1
32,472,472,21,21,0,1,0
6,485,485,12,12,0,1,0

36,124,124,5,1,4,2,1
32,124,124,1,1,0,1,0
37,130,130,6,6,0,1,0
26,131,131,4,4,0,1,0
39,141,141,21,9,12,4,3
13,146,146,10,10,0,1,0
35,169,169,6,6,0,1,0
0,172,172,12,3,9,2,1
25,173,173,22,22,0,1,0
34,177,177,3,3,0,1,0
27,200,200,32,32,0,1,0
20,221,221,6,6,0,1,0
38,235,235,50,50,0,1,0
30,239,239,7,7,0,1,0
2,249,249,33,33,0,1,0
1,257,257,16,3,13,2,1
15,267,267,28,2,26,2,1
28,273,273,27,11,16,3,2
11,278,278,14,14,0,1,0
24,279,279,22,4,18,4,3
10,290,290,6,6,0,1,0
40,301,301,8,8,0,1,0
14,304,304,40,40,0,1,0
33,306,306,16,16,0,1,0
9,323,323,55,33,22,3,2
16,323,323,4,4,0,1,0
22,327,327,67,47,20,3,2
8,330,330,46,7,39,4,3
17,339,339,7,7,0,1,0
21,347,347,43,13,30,4,3
3,354,354,23,23,0,1,0
5,376,376,88,68,20,2,1
19,387,387,32,4,28,2,1
23,425,425,143,143,0,1,0
12,426,426,55,55,0,1,0
6,429,429,36,36,0,1,0
4,436,436,29,29,0,1,0
7,448,448,47,47,0,1,0
31,465,465,34,10,24,2,1
18,470,470,1,1,0,1,0
29,497,497,109,109,0,1,0

25,109,109,9,9,0,1,0
30,111,111,3,3,0,1,0
5,131,131,48,45,3,2,1
29,147,147,14,6,8,3,2
16,154,154,8,8,0,1,0
9,158,158,6,6,0,1,0
24,184,184,58,22,36,2,1
17,189,189,6,6,0,1,0
6,208,208,16,6,10,2,1
7,216,216,56,56,0,1,0
28,223,223,12,2,10,3,2
12,230,230,84,84,0,1,0
26,233,233,3,3,0,1,0
2,233,233,10,10,0,1,0
21,240,240,4,4,0,1,0
10,266,266,18,18,0,1,0
27,267,267,6,6,0,1,0
23,267,267,11,3,8,3,2
14,303,303,57,18,39,2,1
31,330,330,56,56,0,1,0
19,344,344,30,2,28,2,1
22,350,350,113,15,98,4,3
15,353,353,14,14,0,1,0
18,355,355,68,68,0,1,0
1,372,372,83,68,15,2,1
11,395,395,52,20,32,2,1
20,396,396,51,1,50,3,2
13,439,439,29,11,18,2,1
0,452,452,84,84,0,1,0
3,456,456,10,10,0,1,0
4,485,485,15,15,0,1,0
8,494,494,46,46,0,1,0

39,106,106,3,3,0,1,0
5,124,124,17,17,0,1,0
21,133,133,9,3,6,2,1
32,139,139,1,1,0,1,0
0,144,144,5,5,0,1,0
35,156,156,1,1,0,1,0
7,167,167,16,2,14,2,1
26,170,170,11,11,0,1,0
22,175,175,3,3,0,1,0
10,176,176,12,5,7,2,1
25,178,178,23,23,0,1,0
11,195,195,3,3,0,1,0
1,197,197,6,6,0,1,0
14,203,203,46,46,0,1,0
3,216,216,68,59,9,4,3
28,221,221,134,29,105,4,3
9,248,248,48,22,26,2,1
36,257,257,39,39,0,1,0
31,257,257,20,8,12,2,1
17,275,275,15,2,13,2,1
23,282,282,47,47,0,1,0
29,311,311,49,49,0,1,0
34,313,313,41,20,21,2,1
12,314,314,4,4,0,1,0
2,315,315,14,14,0,1,0
13,317,317,15,15,0,1,0
16,334,334,24,24,0,1,0
30,366,366,4,4,0,1,0
33,370,370,4,4,0,1,0
8,389,389,8,5,3,2,1
18,395,395,13,3,10,3,2
20,410,410,17,9,8,3,2
6,456,456,102,102,0,1,0
19,466,466,2,2,0,1,0
4,468,468,30,30,0,1,0
27,479,479,31,31,0,1,0
24,486,486,31,31,0,1,0
37,492,492,12,7,5,2,1
15,495,495,83,83,0,1,0
38,499,499,82,82,0,1,0

30,101,101,1,1,0,1,0
2,104,104,3,3,0,1,0
31,120,120,11,5,6,2,1
17,145,145,1,1,0,1,0
22,148,148,14,14,0,1,0
11,152,152,8,8,0,1,0
12,155,155,38,32,6,2,1
10,176,176,19,19,0,1,0
20,178,178,24,9,15,2,1
25,200,200,43,12,31,2,1
14,223,223,11,11,0,1,0
4,239,239,14,6,8,2,1
0,259,259,84,72,12,4,3
19,270,270,61,13,48,2,1
13,273,273,1,1,0,1,0
9,281,281,31,31,0,1,0
18,301,301,7,1,6,3,2
1,304,304,19,19,0,1,0
16,309,309,7,1,6,2,1
3,321,321,3,3,0,1,0
32,354,354,23,23,0,1,0
29,361,361,86,86,0,1,0
33,374,374,145,133,12,4,3
8,382,382,173,134,39,2,1
7,421,421,42,31,11,2,1
26,432,432,53,43,10,2,1
28,447,447,3,3,0,1,0
6,449,449,20,10,10,2,1
5,470,470,119,119,0,1,0
21,479,479,64,64,0,1,0
23,486,486,14,2,12,2,1
24,486,486,1,1,0,1,0
27,490,490,48,48,0,1,0
15,500,500,15,15,0,1,0

23,113,113,19,19,0,1,0
16,113,113,1,1,0,1,0
2,118,118,13,1,12,2,1
20,121,121,2,2,0,1,0
32,154,154,2,2,0,1,0
35,162,162,4,4,0,1,0
34,164,164,22,22,0,1,0
27,178,178,6,6,0,1,0
15,193,193,7,1,6,2,1
26,209,209,21,14,7,2,1
29,214,214,1,1,0,1,0
25,218,218,14,6,8,3,2
9,222,222,2,2,0,1,0
18,228,228,32,25,7,2,1
37,240,240,77,17,60,3,2
10,251,251,9,1,8,2,1
31,254,254,6,2,4,2,1
6,257,257,14,9,5,2,1
3,278,278,68,34,34,2,1
33,279,279,92,65,27,4,3
21,295,295,48,48,0,1,0
12,300,300,9,9,0,1,0
28,316,316,12,12,0,1,0
8,319,319,49,19,30,3,2
24,324,324,27,27,0,1,0
19,329,329,13,13,0,1,0
14,341,341,26,17,9,4,3
4,346,346,12,12,0,1,0
7,372,372,51,47,4,2,1
1,402,402,31,23,8,3,2
5,415,415,5,5,0,1,0
22,428,428,18,18,0,1,0
0,429,429,81,14,67,3,2
11,446,446,21,6,15,4,3
17,453,453,158,158,0,1,0
13,455,455,71,71,0,1,0
30,465,465,84,57,27,2,1
36,481,481,82,57,25,2,1

32,101,101,3,3,0,1,0
35,109,109,7,7,0,1,0
18,134,134,28,28,0,1,0
11,148,148,6,2,4,2,1
34,159,159,3,3,0,1,0
0,160,160,4,4,0,1,0
2,178,178,1,1,0,1,0
4,182,182,4,1,3,2,1
9,186,186,11,11,0,1,0
22,186,186,26,26,0,1,0
36,187,187,22,14,8,3,2
28,199,199,16,10,6,3,2
8,211,211,56,56,0,1,0
20,235,235,7,4,3,2,1
14,251,251,11,11,0,1,0
13,254,254,15,15,0,1,0
1,281,281,14,14,0,1,0
26,293,293,40,40,0,1,0
23,297,297,46,46,0,1,0
24,303,303,87,3,84,4,3
25,324,324,90,2,88,3,2
3,342,342,45,27,18,3,2
6,361,361,94,82,12,3,2
30,369,369,9,3,6,3,2
37,369,369,9,9,0,1,0
5,391,391,33,33,0,1,0
17,394,394,60,30,30,2,1
19,396,396,20,8,12,4,3
15,414,414,42,42,0,1,0
39,417,417,28,7,21,2,1
12,418,418,2,2,0,1,0
27,421,421,2,2,0,1,0
33,451,451,24,12,12,3,2
31,469,469,32,32,0,1,0
7,470,470,72,72,0,1,0
16,474,474,51,22,29,2,1
29,479,479,98,76,22,2,1
10,479,479,22,22,0,1,0
38,487,487,68,17,51,4,3
21,488,488,23,17,6,2,1

21,110,110,11,3,8,2,1
11,141,141,7,7,0,1,0
35,153,153,1,1,0,1,0
33,169,169,2,2,0,1,0
24,175,175,14,4,10,3,2
38,187,187,2,2,0,1,0
25,196,196,58,58,0,1,0
2,198,198,13,13,0,1,0
23,210,210,15,15,0,1,0
28,221,221,1,1,0,1,0
9,228,228,5,5,0,1,0
13,229,229,69,69,0,1,0
39,253,253,70,53,17,2,1
12,256,256,35,35,0,1,0
0,262,262,3,3,0,1,0
18,266,266,57,38,19,2,1
17,280,280,14,3,11,3,2
8,281,281,9,9,0,1,0
10,297,297,19,19,0,1,0
7,313,313,8,2,6,3,2
30,317,317,7,7,0,1,0
31,319,319,21,9,12,2,1
14,323,323,1,1,0,1,0
27,337,337,109,91,18,4,3
32,340,340,26,20,6,3,2
16,345,345,20,16,4,2,1
6,356,356,38,38,0,1,0
29,357,357,1,1,0,1,0
4,379,379,19,14,5,2,1
5,397,397,33,21,12,4,3
22,401,401,74,3,71,4,3
34,404,404,70,26,44,3,2
26,416,416,45,10,35,2,1
36,431,431,48,48,0,1,0
15,436,436,119,43,76,4,3
37,439,439,7,1,6,2,1
19,444,444,73,73,0,1,0
20,450,450,2,2,0,1,0
1,461,461,43,28,15,4,3
3,498,498,46,13,33,2,1

32,100,100,2,2,0,1,0
3,103,103,11,11,0,1,0
8,104,104,1,1,0,1,0
25,105,105,2,2,0,1,0
35,105,105,15,15,0,1,0
29,117,117,2,2,0,1,0
22,163,163,18,18,0,1,0
34,174,174,29,3,26,3,2
2,192,192,28,28,0,1,0
33,201,201,1,1,0,1,0
9,204,204,37,37,0,1,0
37,207,207,2,2,0,1,0
30,236,236,15,3,12,4,3
26,242,242,70,70,0,1,0
14,248,248,31,31,0,1,0
5,257,257,29,22,7,2,1
24,260,260,21,4,17,2,1
12,282,282,18,18,0,1,0
10,293,293,21,6,15,3,2
0,294,294,4,4,0,1,0
16,294,294,32,32,0,1,0
4,299,299,33,20,13,2,1
28,306,306,6,6,0,1,0
31,312,312,56,56,0,1,0
7,354,354,60,10,50,2,1
11,363,363,42,42,0,1,0
39,371,371,116,60,56,3,2
18,381,381,46,7,39,4,3
6,385,385,47,14,33,2,1
38,388,388,42,42,0,1,0
1,395,395,31,21,10,3,2
36,397,397,23,23,0,1,0
19,412,412,6,6,0,1,0
20,413,413,40,2,38,3,2
15,433,433,22,17,5,2,1
13,443,443,20,2,18,4,3
17,466,466,17,5,12,3,2
27,473,473,88,84,4,2,1
21,497,497,19,19,0,1,0
23,500,500,58,58,0,1,0

4,116,116,24,24,0,1,0
38,124,124,21,21,0,1,0
33,128,128,3,3,0,1,0
8,128,128,1,1,0,1,0
21,145,145,1,1,0,1,0
2,154,154,4,4,0,1,0
17,168,168,1,1,0,1,0
25,173,173,24,12,12,2,1
18,184,184,1,1,0,1,0
11,207,207,1,1,0,1,0
0,208,208,5,5,0,1,0
36,211,211,4,1,3,2,1
37,218,218,11,3,8,2,1
31,219,219,33,5,28,2,1
24,225,225,33,21,12,4,3
32,228,228,20,8,12,3,2
28,238,238,17,17,0,1,0
6,267,267,6,3,3,2,1
19,278,278,18,18,0,1,0
10,285,285,34,8,26,3,2
7,314,314,91,25,66,4,3
3,314,314,15,9,6,3,2
22,321,321,6,6,0,1,0
26,335,335,28,28,0,1,0
29,341,341,66,66,0,1,0
1,349,349,5,5,0,1,0
12,353,353,81,50,31,3,2
35,354,354,73,23,50,3,2
40,366,366,9,9,0,1,0
5,386,386,4,1,3,2,1
23,399,399,73,4,69,4,3
14,403,403,24,24,0,1,0
15,411,411,1,1,0,1,0
30,415,415,25,25,0,1,0
39,431,431,60,60,0,1,0
9,438,438,1,1,0,1,0
16,449,449,117,85,32,2,1
34,460,460,44,4,40,2,1
13,476,476,206,194,12,2,1
41,483,483,34,1,33,4,3
27,492,492,9,1,8,2,1
20,494,494,19,19,0,1,0

23,110,110,1,1,0,1,0
22,122,122,13,7,6,2,1
19,129,129,14,1,13,2,1
7,152,152,56,53,3,2,1
28,171,171,37,37,0,1,0
25,194,194,9,9,0,1,0
15,201,201,25,2,23,2,1
26,205,205,6,6,0,1,0
13,243,243,97,41,56,3,2
1,256,256,12,5,7,2,1
29,288,288,39,39,0,1,0
0,303,303,102,55,47,2,1
9,307,307,24,24,0,1,0
11,311,311,37,37,0,1,0
4,314,314,99,12,87,4,3
24,319,319,1,1,0,1,0
5,326,326,28,28,0,1,0
27,367,367,25,25,0,1,0
8,372,372,129,129,0,1,0
20,377,377,4,4,0,1,0
18,389,389,41,41,0,1,0
10,398,398,59,52,7,2,1
2,413,413,17,17,0,1,0
6,424,424,31,5,26,3,2
14,437,437,39,21,18,3,2
3,447,447,27,15,12,2,1
21,455,455,13,2,11,2,1
17,490,490,25,8,17,2,1
16,493,493,9,9,0,1,0
12,497,497,134,92,42,4,3

35,114,114,1,1,0,1,0
28,124,124,8,8,0,1,0
7,130,130,1,1,0,1,0
29,151,151,12,12,0,1,0
37,154,154,7,7,0,1,0
5,166,166,24,24,0,1,0
4,169,169,1,1,0,1,0
6,178,178,4,4,0,1,0
18,182,182,8,8,0,1,0
34,188,188,11,4,7,2,1
3,194,194,6,3,3,2,1
2,196,196,6,6,0,1,0
38,224,224,50,26,24,3,2
17,245,245,8,8,0,1,0
32,260,260,32,32,0,1,0
15,261,261,1,1,0,1,0
31,277,277,8,3,5,2,1
20,288,288,25,4,21,4,3
13,292,292,81,48,33,4,3
16,299,299,58,58,0,1,0
0,300,300,27,7,20,3,2
40,308,308,11,11,0,1,0
23,310,310,49,49,0,1,0
27,337,337,61,25,36,2,1
9,338,338,15,9,6,3,2
1,340,340,34,34,0,1,0
12,359,359,122,38,84,4,3
22,363,363,45,17,28,2,1
10,372,372,25,1,24,2,1
14,372,372,11,11,0,1,0
8,373,373,24,2,22,3,2
39,389,389,55,55,0,1,0
26,391,391,97,97,0,1,0
24,391,391,109,109,0,1,0
11,394,394,36,36,0,1,0
36,418,418,3,3,0,1,0
30,424,424,12,12,0,1,0
21,434,434,45,10,35,2,1
25,437,437,12,6,6,2,1
19,457,457,41,35,6,3,2
33,466,466,32,16,16,2,1

28,111,111,16,16,0,1,0
0,114,114,37,6,31,3,2
25,169,169,12,12,0,1,0
26,177,177,7,7,0,1,0
34,178,178,2,2,0,1,0
33,182,182,25,9,16,2,1
21,183,183,27,24,3,2,1
24,190,190,11,1,10,2,1
17,191,191,7,7,0,1,0
4,191,191,52,52,0,1,0
12,231,231,15,15,0,1,0
19,232,232,20,5,15,2,1
6,241,241,10,10,0,1,0
10,249,249,78,59,19,2,1
7,254,254,1,1,0,1,0
29,281,281,55,27,28,2,1
32,284,284,35,35,0,1,0
15,285,285,9,9,0,1,0
8,288,288,1,1,0,1,0
14,292,292,47,47,0,1,0
27,319,319,7,7,0,1,0
2,347,347,120,54,66,4,3
1,364,364,2,2,0,1,0
23,371,371,8,8,0,1,0
13,373,373,9,9,0,1,0
9,393,393,29,29,0,1,0
22,400,400,106,86,20,2,1
3,424,424,7,7,0,1,0
18,434,434,124,73,51,3,2
16,460,460,76,4,72,4,3
30,466,466,38,29,9,4,3
5,472,472,79,75,4,2,1
20,486,486,25,9,16,2,1
11,491,491,25,25,0,1,0
31,492,492,2,2,0,1,0

10,114,114,20,7,13,2,1
41,152,152,10,10,0,1,0
3,162,162,16,16,0,1,0
19,166,166,18,4,14,2,1
0,167,167,2,2,0,1,0
2,175,175,4,4,0,1,0
4,179,179,14,5,9,2,1
22,185,185,10,4,6,3,2
26,196,196,10,10,0,1,0
7,204,204,24,24,0,1,0
17,211,211,37,37,0,1,0
30,218,218,28,10,18,3,2
14,219,219,2,2,0,1,0
1,237,237,2,2,0,1,0
36,242,242,57,54,3,2,1
9,248,248,35,35,0,1,0
20,250,250,29,29,0,1,0
31,251,251,45,17,28,3,2
15,255,255,5,1,4,2,1
34,274,274,19,10,9,2,1
16,293,293,37,37,0,1,0
28,298,298,88,55,33,4,3
13,328,328,21,21,0,1,0
39,339,339,10,10,0,1,0
8,339,339,9,9,0,1,0
27,343,343,2,2,0,1,0
35,376,376,61,40,21,2,1
33,397,397,38,38,0,1,0
24,402,402,3,3,0,1,0
5,406,406,2,2,0,1,0
32,412,412,95,62,33,2,1
29,413,413,16,16,0,1,0
38,422,422,60,32,28,2,1
6,425,425,9,9,0,1,0
21,428,428,71,71,0,1,0
12,432,432,10,10,0,1,0
25,432,432,20,11,9,3,2
23,482,482,31,31,0,1,0
11,485,485,73,73,0,1,0
40,496,496,8,8,0,1,0
37,497,497,32,14,18,2,1
18,500,500,91,68,23,2,1

28,103,103,5,5,0,1,0
12,129,129,31,31,0,1,0
33,136,136,28,19,9,4,3
21,139,139,11,11,0,1,0
22,147,147,9,1,8,3,2
13,152,152,1,1,0,1,0
8,176,176,12,2,10,2,1
0,185,185,35,35,0,1,0
10,193,193,26,2,24,4,3
15,195,195,2,2,0,1,0
9,196,196,3,3,0,1,0
6,197,197,17,17,0,1,0
25,259,259,105,17,88,4,3
35,260,260,56,7,49,4,3
11,260,260,38,38,0,1,0
17,265,265,23,4,19,2,1
3,280,280,1,1,0,1,0
27,280,280,12,12,0,1,0
23,304,304,3,3,0,1,0
14,321,321,75,18,57,3,2
4,327,327,133,1,132,4,3
26,335,335,1,1,0,1,0
16,339,339,7,1,6,3,2
32,343,343,7,7,0,1,0
34,349,349,83,43,40,2,1
29,372,372,16,5,11,2,1
1,375,375,69,69,0,1,0
20,378,378,31,10,21,4,3
19,382,382,56,23,33,4,3
30,386,386,44,44,0,1,0
5,425,425,4,4,0,1,0
2,433,433,29,29,0,1,0
18,460,460,3,3,0,1,0
24,461,461,6,6,0,1,0
7,493,493,39,36,3,2,1
31,498,498,64,64,0,1,0

34,120,120,8,8,0,1,0
33,129,129,3,3,0,1,0
17,131,131,3,3,0,1,0
13,132,132,16,5,11,2,1
16,144,144,7,7,0,1,0
37,154,154,27,27,0,1,0
9,169,169,12,12,0,1,0
29,185,185,41,41,0,1,0
7,187,187,3,3,0,1,0
35,233,233,90,84,6,2,1
24,253,253,6,3,3,2,1
19,272,272,29,29,0,1,0
8,291,291,29,1,28,3,2
11,297,297,27,13,14,2,1
3,308,308,4,4,0,1,0
36,321,321,49,49,0,1,0
5,324,324,75,37,38,4,3
10,329,329,103,82,21,4,3
25,342,342,10,1,9,2,1
26,354,354,8,8,0,1,0
18,358,358,102,78,24,4,3
4,361,361,3,3,0,1,0
27,363,363,25,25,0,1,0
23,364,364,48,18,30,4,3
28,381,381,44,20,24,2,1
1,389,389,43,13,30,3,2
6,393,393,3,3,0,1,0
20,408,408,5,5,0,1,0
22,414,414,4,1,3,2,1
2,422,422,42,7,35,4,3
12,440,440,38,20,18,3,2
15,448,448,61,61,0,1,0
21,453,453,75,75,0,1,0
32,459,459,29,29,0,1,0
30,469,469,22,22,0,1,0
0,473,473,12,12,0,1,0
31,490,490,58,46,12,4,3
14,494,494,57,11,46,2,1

17,103,103,22,2,20,4,3
22,107,107,4,4,0,1,0
39,113,113,1,1,0,1,0
14,138,138,7,7,0,1,0
28,145,145,7,3,4,2,1
5,149,149,1,1,0,1,0
15,155,155,24,10,14,2,1
21,168,168,30,11,19,4,3
40,180,180,9,9,0,1,0
4,213,213,28,13,15,2,1
0,225,225,1,1,0,1,0
13,238,238,9,9,0,1,0
11,243,243,48,25,23,2,1
3,246,246,13,5,8,2,1
27,249,249,34,13,21,2,1
24,253,253,15,15,0,1,0
41,255,255,24,18,6,3,2
1,255,255,9,6,3,2,1
8,270,270,13,10,3,2,1
18,285,285,9,9,0,1,0
2,310,310,69,69,0,1,0
19,327,327,1,1,0,1,0
25,328,328,62,62,0,1,0
7,346,346,4,4,0,1,0
33,355,355,18,10,8,3,2
10,376,376,31,31,0,1,0
36,376,376,11,2,9,4,3
35,390,390,14,3,11,2,1
26,398,398,52,31,21,4,3
31,399,399,63,63,0,1,0
6,406,406,11,8,3,2,1
37,408,408,57,19,38,3,2
9,410,410,21,3,18,2,1
23,416,416,76,10,66,4,3
12,421,421,12,12,0,1,0
29,427,427,21,21,0,1,0
20,434,434,120,102,18,3,2
38,438,438,3,3,0,1,0
34,442,442,37,37,0,1,0
32,447,447,30,8,22,2,1
16,449,449,10,3,7,2,1
30,493,493,200,187,13,2,1

22,114,114,8,2,6,3,2
10,140,140,13,13,0,1,0
1,144,144,24,24,0,1,0
31,152,152,7,7,0,1,0
25,158,158,14,14,0,1,0
26,175,175,31,31,0,1,0
27,183,183,22,22,0,1,0
12,190,190,29,5,24,2,1
28,199,199,4,4,0,1,0
32,203,203,26,26,0,1,0
5,212,212,16,8,8,3,2
19,221,221,59,38,21,4,3
17,222,222,13,9,4,2,1
7,228,228,24,4,20,3,2
3,235,235,18,18,0,1,0
2,240,240,74,35,39,4,3
23,247,247,5,5,0,1,0
14,279,279,27,3,24,4,3
13,292,292,38,11,27,4,3
24,294,294,3,3,0,1,0
34,309,309,94,94,0,1,0
29,314,314,75,75,0,1,0
15,315,315,2,2,0,1,0
8,315,315,45,17,28,2,1
4,317,317,18,2,16,4,3
30,318,318,13,13,0,1,0
35,350,350,53,53,0,1,0
9,385,385,4,4,0,1,0
16,424,424,1,1,0,1,0
18,430,430,38,6,32,3,2
6,433,433,143,130,13,3,2
20,462,462,5,5,0,1,0
33,466,466,18,3,15,4,3
36,469,469,45,3,42,4,3
11,477,477,31,19,12,3,2
0,495,495,12,3,9,4,3
21,498,498,11,11,0,1,0

2,109,109,8,8,0,1,0
6,132,132,12,12,0,1,0
9,135,135,31,31,0,1,0
22,151,151,8,8,0,1,0
5,168,168,3,3,0,1,0
1,178,178,16,16,0,1,0
18,198,198,10,10,0,1,0
29,224,224,28,28,0,1,0
27,236,236,61,41,20,4,3
11,239,239,11,11,0,1,0
26,243,243,4,4,0,1,0
30,244,244,36,25,11,2,1
20,247,247,25,25,0,1,0
19,256,256,62,62,0,1,0
13,258,258,8,4,4,2,1
10,269,269,17,3,14,2,1
23,274,274,13,5,8,2,1
33,276,276,34,34,0,1,0
4,280,280,76,76,0,1,0
8,292,292,19,4,15,2,1
24,300,300,11,11,0,1,0
25,301,301,66,66,0,1,0
0,324,324,18,12,6,3,2
17,326,326,23,9,14,3,2
14,330,330,71,71,0,1,0
28,339,339,19,19,0,1,0
34,354,354,16,16,0,1,0
3,356,356,69,69,0,1,0
32,402,402,54,54,0,1,0
31,408,408,11,11,0,1,0
7,427,427,8,8,0,1,0
15,439,439,128,83,45,4,3
21,441,441,67,40,27,2,1
35,448,448,14,14,0,1,0
12,481,481,24,17,7,2,1
16,493,493,48,14,34,2,1

39,105,105,7,4,3,2,1
4,110,110,46,5,41,2,1
7,124,124,6,6,0,1,0
21,156,156,14,9,5,2,1
15,164,164,1,1,0,1,0
10,172,172,1,1,0,1,0
37,183,183,10,6,4,2,1
19,187,187,3,3,0,1,0
31,187,187,12,4,8,2,1
11,194,194,12,1,11,2,1
0,219,219,3,3,0,1,0
9,228,228,24,5,19,3,2
34,241,241,4,1,3,2,1
13,253,253,5,5,0,1,0
36,253,253,30,20,10,2,1
25,259,259,9,9,0,1,0
12,259,259,24,9,15,2,1
23,265,265,42,42,0,1,0
28,283,283,46,36,10,2,1
8,287,287,10,10,0,1,0
2,289,289,5,5,0,1,0
20,292,292,21,13,8,3,2
6,292,292,3,3,0,1,0
5,300,300,1,1,0,1,0
26,301,301,19,5,14,2,1
14,303,303,11,8,3,2,1
32,308,308,45,6,39,4,3
3,344,344,141,27,114,4,3
1,354,354,52,10,42,4,3
18,393,393,30,30,0,1,0
30,399,399,1,1,0,1,0
29,407,407,53,30,23,2,1
41,433,433,5,5,0,1,0
35,434,434,16,2,14,2,1
40,449,449,69,69,0,1,0
22,453,453,20,2,18,3,2
17,454,454,14,5,9,4,3
16,464,464,66,66,0,1,0
38,465,465,6,2,4,2,1
27,466,466,92,37,55,4,3
24,466,466,130,56,74,4,3
33,479,479,108,96,12,2,1

0,104,104,5,1,4,2,1
19,105,105,19,19,0,1,0
17,114,114,8,8,0,1,0
10,130,130,1,1,0,1,0
38,166,166,10,10,0,1,0
43,180,180,22,10,12,3,2
9,182,182,4,4,0,1,0
25,195,195,1,1,0,1,0
12,206,206,4,4,0,1,0
26,207,207,1,1,0,1,0
21,210,210,12,12,0,1,0
3,216,216,16,7,9,4,3
8,222,222,6,6,0,1,0
5,232,232,13,13,0,1,0
13,240,240,22,22,0,1,0
30,247,247,54,54,0,1,0
40,250,250,27,2,25,2,1
24,251,251,58,7,51,4,3
6,254,254,19,19,0,1,0
37,271,271,4,4,0,1,0
31,289,289,4,4,0,1,0
18,315,315,17,2,15,2,1
16,316,316,4,4,0,1,0
45,317,317,36,6,30,3,2
33,329,329,18,18,0,1,0
11,331,331,11,11,0,1,0
34,334,334,16,16,0,1,0
14,334,334,67,49,18,3,2
2,343,343,16,4,12,2,1
27,352,352,10,3,7,3,2
42,370,370,75,48,27,4,3
44,374,374,76,19,57,4,3
23,380,380,72,62,10,2,1
7,388,388,6,2,4,2,1
36,393,393,2,2,0,1,0
41,397,397,22,2,20,2,1
15,408,408,25,17,8,3,2
20,411,411,60,60,0,1,0
28,448,448,4,4,0,1,0
29,466,466,20,6,14,3,2
32,471,471,5,5,0,1,0
22,476,476,8,1,7,2,1
35,486,486,42,7,35,4,3
4,493,493,51,6,45,4,3
1,494,494,12,8,4,2,1
39,496,496,197,166,31,2,1
46,500,500,85,85,0,1,0

23,102,102,2,2,0,1,0
8,104,104,20,20,0,1,0
18,118,118,21,5,16,2,1
14,132,132,10,6,4,2,1
32,138,138,3,3,0,1,0
17,179,179,25,14,11,2,1
20,181,181,7,7,0,1,0
21,182,182,8,8,0,1,0
29,194,194,65,8,57,4,3
3,197,197,9,9,0,1,0
25,202,202,24,15,9,2,1
28,214,214,19,4,15,4,3
10,228,228,26,26,0,1,0
19,228,228,26,15,11,2,1
27,233,233,28,28,0,1,0
11,235,235,50,15,35,2,1
22,259,259,17,17,0,1,0
31,266,266,11,11,0,1,0
26,269,269,38,20,18,4,3
12,292,292,7,7,0,1,0
33,307,307,35,8,27,2,1
9,310,310,19,19,0,1,0
6,311,311,18,13,5,2,1
15,313,313,6,1,5,2,1
34,337,337,36,1,35,2,1
16,346,346,10,10,0,1,0
0,360,360,104,41,63,4,3
7,374,374,76,76,0,1,0
24,428,428,27,27,0,1,0
13,441,441,32,32,0,1,0
5,441,441,18,6,12,3,2
1,449,449,90,51,39,2,1
4,467,467,81,63,18,4,3
2,473,473,56,56,0,1,0
30,490,490,75,75,0,1,0

35,106,106,6,6,0,1,0
7,116,116,2,2,0,1,0
15,129,129,8,8,0,1,0
1,137,137,8,8,0,1,0
25,155,155,5,2,3,2,1
17,160,160,20,20,0,1,0
32,187,187,4,4,0,1,0
33,192,192,59,21,38,3,2
6,212,212,19,10,9,2,1
21,220,220,30,2,28,3,2
3,248,248,42,22,20,3,2
29,250,250,85,61,24,3,2
20,259,259,33,13,20,3,2
26,265,265,5,5,0,1,0
8,267,267,77,77,0,1,0
2,277,277,10,10,0,1,0
16,285,285,1,1,0,1,0
22,308,308,14,14,0,1,0
24,311,311,6,6,0,1,0
30,350,350,18,18,0,1,0
19,350,350,30,2,28,3,2
31,355,355,16,8,8,2,1
34,361,361,18,18,0,1,0
27,373,373,150,102,48,4,3
0,389,389,35,35,0,1,0
5,393,393,39,1,38,2,1
23,394,394,13,13,0,1,0
11,417,417,83,78,5,2,1
13,429,429,123,123,0,1,0
18,448,448,51,21,30,4,3
36,466,466,11,3,8,3,2
9,480,480,4,4,0,1,0
10,482,482,38,2,36,4,3
12,483,483,1,1,0,1,0
4,483,483,79,79,0,1,0
14,487,487,60,60,0,1,0
28,497,497,18,13,5,2,1

34,139,139,10,10,0,1,0
20,141,141,20,11,9,2,1
7,170,170,7,7,0,1,0
23,176,176,20,20,0,1,0
28,199,199,44,44,0,1,0
35,212,212,3,3,0,1,0
17,228,228,50,36,14,3,2
15,229,229,69,69,0,1,0
24,243,243,13,13,0,1,0
1,243,243,6,6,0,1,0
0,245,245,40,40,0,1,0
22,250,250,15,15,0,1,0
13,257,257,10,10,0,1,0
25,268,268,6,3,3,2,1
32,272,272,5,5,0,1,0
4,281,281,31,9,22,3,2
11,287,287,30,22,8,3,2
9,289,289,16,16,0,1,0
10,295,295,1,1,0,1,0
6,296,296,24,6,18,2,1
8,323,323,28,11,17,2,1
14,352,352,11,11,0,1,0
12,354,354,43,34,9,2,1
26,368,368,27,9,18,4,3
3,370,370,95,2,93,4,3
33,377,377,70,13,57,4,3
30,394,394,48,48,0,1,0
2,399,399,24,18,6,2,1
18,430,430,82,82,0,1,0
29,431,431,93,93,0,1,0
36,444,444,12,2,10,2,1
19,456,456,25,25,0,1,0
31,465,465,77,30,47,2,1
21,466,466,23,9,14,2,1
16,480,480,59,59,0,1,0
27,488,488,65,65,0,1,0
5,499,499,39,26,13,2,1

16,101,101,22,10,12,2,1
35,102,102,2,2,0,1,0
23,102,102,10,10,0,1,0
32,113,113,5,5,0,1,0
2,114,114,3,3,0,1,0
25,127,127,4,1,3,2,1
34,173,173,5,5,0,1,0
20,185,185,17,17,0,1,0
30,192,192,5,5,0,1,0
13,197,197,3,3,0,1,0
39,198,198,8,1,7,2,1
26,224,224,35,35,0,1,0
4,243,243,17,11,6,3,2
18,247,247,31,15,16,3,2
3,262,262,6,6,0,1,0
8,272,272,6,6,0,1,0
0,292,292,18,14,4,2,1
27,296,296,46,2,44,3,2
12,297,297,35,17,18,4,3
1,332,332,22,22,0,1,0
29,340,340,16,16,0,1,0
21,343,343,78,42,36,4,3
19,349,349,2,2,0,1,0
37,359,359,112,94,18,3,2
22,373,373,79,49,30,3,2
6,378,378,47,9,38,3,2
36,393,393,129,129,0,1,0
28,402,402,23,23,0,1,0
24,408,408,33,15,18,4,3
38,408,408,8,8,0,1,0
14,410,410,4,4,0,1,0
5,435,435,13,13,0,1,0
7,437,437,75,49,26,2,1
9,455,455,22,11,11,2,1
31,455,455,3,3,0,1,0
11,460,460,93,93,0,1,0
17,472,472,158,158,0,1,0
33,474,474,22,3,19,2,1
15,490,490,37,1,36,2,1
10,493,493,31,31,0,1,0

4,102,102,4,4,0,1,0
20,118,118,8,8,0,1,0
12,126,126,2,2,0,1,0
7,131,131,13,13,0,1,0
10,144,144,21,1,20,2,1
35,145,145,6,2,4,2,1
19,154,154,7,2,5,2,1
32,155,155,13,1,12,4,3
13,170,170,37,24,13,2,1
0,175,175,3,3,0,1,0
23,196,196,21,21,0,1,0
31,230,230,8,8,0,1,0
2,233,233,3,3,0,1,0
6,254,254,37,37,0,1,0
11,259,259,2,2,0,1,0
33,279,279,4,1,3,2,1
15,286,286,8,8,0,1,0
36,290,290,147,141,6,3,2
37,294,294,16,11,5,2,1
18,297,297,9,1,8,2,1
27,307,307,12,12,0,1,0
1,309,309,54,42,12,4,3
28,316,316,26,12,14,2,1
24,317,317,34,34,0,1,0
26,322,322,42,42,0,1,0
8,328,328,5,5,0,1,0
21,348,348,25,25,0,1,0
9,371,371,82,76,6,2,1
25,378,378,30,8,22,4,3
34,400,400,25,19,6,2,1
16,401,401,83,58,25,2,1
30,402,402,11,8,3,2,1
5,429,429,152,122,30,4,3
29,438,438,80,72,8,3,2
17,442,442,14,14,0,1,0
22,442,442,88,59,29,2,1
3,464,464,36,36,0,1,0
14,481,481,29,3,26,3,2

14,111,111,18,18,0,1,0
5,112,112,9,9,0,1,0
34,114,114,6,3,3,2,1
18,127,127,13,13,0,1,0
28,127,127,20,20,0,1,0
11,135,135,11,4,7,2,1
8,144,144,6,3,3,2,1
43,151,151,2,2,0,1,0
24,159,159,1,1,0,1,0
41,159,159,9,9,0,1,0
7,174,174,6,6,0,1,0
38,178,178,34,34,0,1,0
25,186,186,20,20,0,1,0
0,187,187,6,1,5,2,1
33,204,204,36,13,23,2,1
36,205,205,29,8,21,2,1
13,210,210,36,24,12,3,2
23,213,213,3,3,0,1,0
32,219,219,17,4,13,2,1
27,234,234,16,10,6,3,2
31,238,238,72,62,10,2,1
26,252,252,17,17,0,1,0
12,262,262,24,24,0,1,0
17,265,265,26,26,0,1,0
9,316,316,1,1,0,1,0
21,317,317,6,6,0,1,0
10,325,325,2,2,0,1,0
42,326,326,9,1,8,3,2
29,341,341,60,60,0,1,0
15,341,341,6,6,0,1,0
35,349,349,6,6,0,1,0
39,355,355,43,2,41,2,1
1,365,365,78,78,0,1,0
22,373,373,10,1,9,4,3
19,383,383,59,59,0,1,0
3,412,412,13,6,7,2,1
2,429,429,53,53,0,1,0
6,432,432,47,47,0,1,0
4,453,453,8,8,0,1,0
30,464,464,16,7,9,4,3
20,468,468,5,5,0,1,0
40,474,474,45,29,16,3,2
37,479,479,30,30,0,1,0
16,479,479,122,122,0,1,0

12,124,124,2,2,0,1,0
10,142,142,6,1,5,2,1
16,167,167,14,4,10,3,2
25,168,168,1,1,0,1,0
32,180,180,12,2,10,2,1
26,187,187,7,3,4,2,1
27,195,195,50,6,44,3,2
34,220,220,9,5,4,2,1
21,225,225,8,2,6,3,2
18,231,231,4,4,0,1,0
37,234,234,7,7,0,1,0
4,234,234,55,15,40,3,2
20,266,266,37,37,0,1,0
36,275,275,56,17,39,4,3
30,293,293,12,7,5,2,1
19,297,297,92,75,17,2,1
15,311,311,59,59,0,1,0
33,321,321,83,53,30,4,3
23,327,327,6,6,0,1,0
5,327,327,25,15,10,3,2
6,332,332,28,28,0,1,0
31,339,339,45,45,0,1,0
7,350,350,8,8,0,1,0
2,351,351,8,8,0,1,0
8,364,364,12,12,0,1,0
13,373,373,44,37,7,2,1
22,387,387,38,38,0,1,0
14,393,393,32,16,16,3,2
17,400,400,1,1,0,1,0
24,405,405,8,8,0,1,0
9,419,419,27,27,0,1,0
11,422,422,1,1,0,1,0
0,445,445,120,120,0,1,0
1,453,453,100,51,49,2,1
38,478,478,27,4,23,2,1
35,486,486,84,84,0,1,0
28,490,490,144,86,58,4,3
3,499,499,5,5,0,1,0
29,500,500,11,11,0,1,0

16,103,103,12,6,6,2,1
20,118,118,7,2,5,2,1
9,120,120,14,14,0,1,0
3,140,140,26,4,22,2,1
14,142,142,18,18,0,1,0
18,160,160,1,1,0,1,0
1,173,173,5,5,0,1,0
7,175,175,7,7,0,1,0
5,176,176,13,13,0,1,0
32,193,193,12,12,0,1,0
30,202,202,41,41,0,1,0
31,209,209,68,29,39,4,3
33,211,211,39,24,15,2,1
29,213,213,17,3,14,3,2
27,217,217,19,3,16,4,3
22,229,229,18,8,10,3,2
25,236,236,6,6,0,1,0
12,293,293,11,11,0,1,0
2,294,294,85,85,0,1,0
23,312,312,30,30,0,1,0
10,333,333,53,53,0,1,0
13,341,341,102,17,85,4,3
26,345,345,16,16,0,1,0
8,387,387,3,3,0,1,0
0,392,392,19,19,0,1,0
28,399,399,60,60,0,1,0
11,407,407,46,46,0,1,0
17,424,424,18,8,10,2,1
15,431,431,69,69,0,1,0
24,433,433,40,10,30,3,2
21,453,453,63,29,34,4,3
34,459,459,60,9,51,4,3
6,475,475,44,37,7,2,1
19,481,481,8,8,0,1,0
4,500,500,61,21,40,2,1

17,108,108,4,4,0,1,0
7,121,121,5,5,0,1,0
2,131,131,18,3,15,2,1
21,138,138,18,18,0,1,0
26,147,147,2,2,0,1,0
25,148,148,34,10,24,2,1
11,155,155,15,15,0,1,0
9,159,159,1,1,0,1,0
36,175,175,20,20,0,1,0
30,186,186,27,27,0,1,0
3,196,196,28,7,21,4,3
29,220,220,5,2,3,2,1
10,222,222,17,3,14,2,1
34,231,231,55,55,0,1,0
22,259,259,1,1,0,1,0
12,264,264,14,7,7,2,1
1,289,289,63,63,0,1,0
23,298,298,26,8,18,2,1
32,304,304,18,3,15,3,2
0,313,313,11,11,0,1,0
4,322,322,16,16,0,1,0
37,323,323,37,37,0,1,0
15,326,326,42,27,15,2,1
8,330,330,7,4,3,2,1
14,343,343,17,4,13,3,2
27,351,351,6,6,0,1,0
35,354,354,75,57,18,2,1
33,362,362,111,80,31,2,1
19,365,365,31,31,0,1,0
5,367,367,116,79,37,2,1
13,379,379,46,22,24,2,1
6,393,393,37,2,35,2,1
28,442,442,10,10,0,1,0
24,443,443,57,57,0,1,0
31,470,470,4,4,0,1,0
16,495,495,113,53,60,4,3
20,497,497,2,2,0,1,0
18,499,499,24,24,0,1,0

38,103,103,6,6,0,1,0
23,111,111,5,1,4,2,1
1,120,120,11,2,9,2,1
35,129,129,14,9,5,2,1
2,163,163,2,2,0,1,0
9,166,166,25,25,0,1,0
6,180,180,7,7,0,1,0
3,210,210,26,8,18,3,2
11,231,231,16,16,0,1,0
28,235,235,23,10,13,2,1
27,236,236,6,6,0,1,0
5,244,244,5,5,0,1,0
14,246,246,38,10,28,3,2
33,246,246,11,11,0,1,0
31,255,255,32,32,0,1,0
22,259,259,10,6,4,2,1
10,271,271,46,46,0,1,0
4,288,288,26,2,24,4,3
17,323,323,24,6,18,2,1
0,324,324,29,7,22,2,1
12,337,337,14,5,9,2,1
19,352,352,13,4,9,4,3
24,362,362,9,9,0,1,0
34,365,365,113,113,0,1,0
32,371,371,42,24,18,2,1
8,387,387,18,1,17,2,1
26,389,389,56,13,43,2,1
29,394,394,16,3,13,2,1
16,410,410,18,18,0,1,0
15,420,420,82,82,0,1,0
37,428,428,88,88,0,1,0
7,450,450,149,133,16,3,2
25,453,453,22,15,7,2,1
36,454,454,40,40,0,1,0
30,459,459,16,8,8,3,2
18,463,463,55,16,39,4,3
13,465,465,1,1,0,1,0
20,468,468,164,152,12,2,1
21,486,486,19,19,0,1,0

24,119,119,24,24,0,1,0
19,128,128,10,10,0,1,0
12,148,148,57,57,0,1,0
28,194,194,1,1,0,1,0
15,195,195,24,24,0,1,0
17,207,207,6,6,0,1,0
26,214,214,15,15,0,1,0
14,217,217,64,28,36,2,1
21,227,227,10,10,0,1,0
4,236,236,8,1,7,2,1
22,239,239,1,1,0,1,0
2,266,266,1,1,0,1,0
11,269,269,15,4,11,2,1
10,290,290,30,9,21,4,3
3,316,316,69,48,21,4,3
5,338,338,210,201,9,3,2
18,339,339,19,19,0,1,0
8,349,349,72,72,0,1,0
13,360,360,22,7,15,3,2
0,401,401,97,75,22,3,2
20,415,415,66,44,22,2,1
27,449,449,18,18,0,1,0
1,452,452,30,30,0,1,0
23,453,453,50,17,33,2,1
16,461,461,10,10,0,1,0
25,461,461,44,12,32,4,3
6,461,461,15,3,12,3,2
9,471,471,132,54,78,4,3
7,486,486,95,95,0,1,0

13,108,108,1,1,0,1,0
6,117,117,36,27,9,4,3
21,117,117,12,2,10,2,1
22,119,119,7,7,0,1,0
32,134,134,6,6,0,1,0
1,144,144,14,14,0,1,0
27,147,147,15,15,0,1,0
3,164,164,14,14,0,1,0
25,195,195,55,19,36,3,2
34,245,245,7,4,3,2,1
0,266,266,29,17,12,3,2
15,267,267,32,32,0,1,0
10,277,277,22,12,10,2,1
30,299,299,4,1,3,2,1
33,301,301,9,9,0,1,0
20,308,308,22,22,0,1,0
26,325,325,8,8,0,1,0
23,334,334,118,67,51,4,3
8,352,352,63,63,0,1,0
24,358,358,49,49,0,1,0
36,359,359,31,15,16,2,1
31,369,369,24,9,15,2,1
16,390,390,8,8,0,1,0
9,399,399,9,9,0,1,0
19,400,400,35,3,32,2,1
35,404,404,22,5,17,2,1
14,410,410,15,15,0,1,0
2,426,426,12,6,6,3,2
4,431,431,16,8,8,3,2
29,436,436,78,63,15,4,3
11,445,445,147,147,0,1,0
5,456,456,81,49,32,2,1
7,458,458,34,5,29,2,1
28,461,461,37,37,0,1,0
12,463,463,37,37,0,1,0
17,485,485,52,16,36,2,1
18,494,494,68,22,46,2,1

38,113,113,6,6,0,1,0
14,113,113,8,8,0,1,0
39,118,118,9,4,5,2,1
2,144,144,30,30,0,1,0
30,144,144,7,7,0,1,0
25,145,145,29,2,27,2,1
1,146,146,15,15,0,1,0
12,148,148,1,1,0,1,0
22,172,172,1,1,0,1,0
17,176,176,1,1,0,1,0
26,187,187,10,10,0,1,0
5,192,192,6,2,4,2,1
29,199,199,2,2,0,1,0
16,201,201,77,31,46,2,1
8,204,204,6,6,0,1,0
6,206,206,1,1,0,1,0
36,225,225,39,39,0,1,0
15,230,230,3,3,0,1,0
11,231,231,1,1,0,1,0
10,235,235,63,37,26,3,2
13,235,235,2,2,0,1,0
31,273,273,47,47,0,1,0
37,293,293,97,19,78,3,2
18,301,301,7,1,6,2,1
9,302,302,48,48,0,1,0
34,311,311,13,8,5,2,1
32,311,311,91,48,43,2,1
21,366,366,45,8,37,2,1
20,369,369,3,3,0,1,0
40,370,370,31,16,15,2,1
28,371,371,1,1,0,1,0
24,372,372,25,18,7,2,1
41,388,388,1,1,0,1,0
0,393,393,8,8,0,1,0
4,393,393,16,16,0,1,0
42,404,404,2,2,0,1,0
23,421,421,38,38,0,1,0
27,431,431,79,23,56,4,3
35,458,458,68,48,20,3,2
3,466,466,59,59,0,1,0
19,477,477,21,9,12,3,2
7,483,483,60,60,0,1,0
33,487,487,1,1,0,1,0

4,105,105,17,17,0,1,0
27,108,108,1,1,0,1,0
38,140,140,3,3,0,1,0
30,143,143,10,4,6,3,2
34,149,149,99,21,78,3,2
39,166,166,22,22,0,1,0
25,173,173,11,11,0,1,0
12,175,175,2,2,0,1,0
29,187,187,33,33,0,1,0
36,187,187,12,12,0,1,0
9,190,190,3,3,0,1,0
10,199,199,36,36,0,1,0
11,203,203,4,4,0,1,0
45,210,210,6,6,0,1,0
22,210,210,1,1,0,1,0
21,222,222,4,4,0,1,0
44,228,228,6,6,0,1,0
1,231,231,8,2,6,3,2
0,245,245,14,5,9,4,3
5,260,260,34,19,15,4,3
42,290,290,16,4,12,3,2
2,303,303,41,41,0,1,0
41,308,308,25,25,0,1,0
7,321,321,5,5,0,1,0
43,334,334,7,3,4,2,1
47,334,334,24,2,22,2,1
26,342,342,17,17,0,1,0
15,343,343,69,69,0,1,0
32,348,348,16,16,0,1,0
40,356,356,40,6,34,2,1
31,395,395,27,17,10,2,1
16,405,405,17,7,10,2,1
37,408,408,12,4,8,2,1
35,421,421,22,8,14,2,1
28,425,425,30,30,0,1,0
24,425,425,19,1,18,4,3
14,431,431,15,15,0,1,0
18,431,431,7,7,0,1,0
17,435,435,39,5,34,3,2
13,439,439,63,25,38,3,2
33,443,443,1,1,0,1,0
8,453,453,69,69,0,1,0
23,455,455,22,8,14,3,2
46,476,476,104,85,19,2,1
20,484,484,47,47,0,1,0
19,484,484,1,1,0,1,0
6,495,495,13,5,8,3,2
3,497,497,12,8,4,2,1

35,101,101,10,4,6,3,2
12,103,103,12,12,0,1,0
24,108,108,28,16,12,4,3
6,125,125,12,3,9,4,3
31,126,126,4,4,0,1,0
29,127,127,4,4,0,1,0
34,128,128,10,10,0,1,0
1,149,149,4,4,0,1,0
33,159,159,35,35,0,1,0
11,161,161,15,15,0,1,0
5,169,169,1,1,0,1,0
13,188,188,49,49,0,1,0
32,190,190,19,7,12,4,3
4,195,195,3,3,0,1,0
28,204,204,12,12,0,1,0
8,211,211,49,31,18,4,3
15,212,212,19,1,18,2,1
23,231,231,15,15,0,1,0
25,235,235,7,1,6,3,2
26,237,237,66,45,21,2,1
19,250,250,4,4,0,1,0
36,270,270,8,2,6,2,1
18,272,272,1,1,0,1,0
20,276,276,14,3,11,2,1
38,277,277,47,17,30,4,3
16,302,302,50,50,0,1,0
10,302,302,8,8,0,1,0
27,316,316,36,36,0,1,0
9,379,379,17,17,0,1,0
3,393,393,85,85,0,1,0
30,394,394,2,2,0,1,0
21,404,404,6,6,0,1,0
37,410,410,9,9,0,1,0
7,418,418,75,75,0,1,0
17,445,445,16,4,12,3,2
22,450,450,133,103,30,4,3
0,461,461,80,80,0,1,0
14,493,493,32,32,0,1,0
2,499,499,19,19,0,1,0

23,112,112,5,5,0,1,0
9,134,134,1,1,0,1,0
21,136,136,1,1,0,1,0
36,147,147,9,9,0,1,0
35,175,175,2,2,0,1,0
37,181,181,47,41,6,3,2
22,185,185,13,13,0,1,0
30,198,198,62,3,59,4,3
39,214,214,35,23,12,4,3
26,215,215,4,4,0,1,0
27,221,221,19,3,16,4,3
25,223,223,48,48,0,1,0
11,249,249,34,34,0,1,0
4,255,255,38,38,0,1,0
33,257,257,33,33,0,1,0
2,266,266,5,5,0,1,0
38,274,274,12,4,8,2,1
20,275,275,1,1,0,1,0
29,278,278,43,12,31,3,2
10,285,285,170,148,22,2,1
18,286,286,43,43,0,1,0
28,288,288,34,14,20,3,2
16,290,290,1,1,0,1,0
17,294,294,12,4,8,3,2
13,302,302,6,6,0,1,0
7,307,307,36,36,0,1,0
19,316,316,7,7,0,1,0
0,336,336,16,16,0,1,0
34,358,358,26,8,18,4,3
32,365,365,12,4,8,3,2
5,368,368,19,2,17,4,3
3,370,370,5,5,0,1,0
1,377,377,2,2,0,1,0
40,393,393,33,6,27,2,1
15,414,414,34,16,18,4,3
14,430,430,22,13,9,2,1
8,442,442,14,14,0,1,0
6,447,447,104,62,42,4,3
12,458,458,53,53,0,1,0
31,461,461,20,5,15,3,2
24,483,483,10,10,0,1,0

3,120,120,1,1,0,1,0
12,124,124,1,1,0,1,0
22,129,129,11,11,0,1,0
8,132,132,36,27,9,2,1
30,145,145,5,5,0,1,0
28,157,157,28,14,14,2,1
5,177,177,1,1,0,1,0
13,184,184,14,3,11,2,1
27,224,224,13,7,6,2,1
0,230,230,41,4,37,2,1
1,247,247,14,14,0,1,0
23,249,249,32,32,0,1,0
21,253,253,9,1,8,2,1
18,255,255,18,18,0,1,0
20,261,261,15,8,7,2,1
7,298,298,59,21,38,2,1
17,328,328,33,33,0,1,0
10,336,336,34,34,0,1,0
29,349,349,15,15,0,1,0
14,350,350,114,114,0,1,0
19,363,363,14,14,0,1,0
16,371,371,32,17,15,4,3
33,374,374,28,6,22,3,2
11,374,374,100,16,84,3,2
25,377,377,17,2,15,2,1
6,380,380,41,9,32,4,3
15,393,393,47,8,39,4,3
9,400,400,75,43,32,3,2
4,414,414,41,26,15,4,3
24,419,419,90,90,0,1,0
32,427,427,34,34,0,1,0
26,444,444,180,150,30,3,2
31,483,483,38,38,0,1,0
2,490,490,5,5,0,1,0

18,101,101,1,1,0,1,0
28,112,112,3,3,0,1,0
2,116,116,2,2,0,1,0
46,119,119,4,4,0,1,0
1,127,127,25,25,0,1,0
23,135,135,8,8,0,1,0
16,164,164,3,3,0,1,0
27,166,166,1,1,0,1,0
40,174,174,17,2,15,2,1
17,177,177,31,31,0,1,0
41,181,181,18,15,3,2,1
13,185,185,13,1,12,3,2
11,189,189,1,1,0,1,0
36,191,191,20,20,0,1,0
32,193,193,24,8,16,2,1
9,199,199,3,3,0,1,0
31,204,204,15,3,12,2,1
4,235,235,29,29,0,1,0
35,242,242,11,11,0,1,0
22,246,246,13,13,0,1,0
44,257,257,18,1,17,2,1
39,263,263,26,26,0,1,0
7,280,280,25,25,0,1,0
34,305,305,89,89,0,1,0
6,318,318,5,5,0,1,0
42,321,321,1,1,0,1,0
12,322,322,20,20,0,1,0
15,328,328,21,6,15,2,1
38,335,335,80,47,33,4,3
0,352,352,90,72,18,2,1
5,358,358,29,6,23,2,1
37,360,360,22,22,0,1,0
43,362,362,31,31,0,1,0
8,369,369,5,5,0,1,0
26,384,384,107,107,0,1,0
14,385,385,8,8,0,1,0
3,393,393,2,2,0,1,0
25,404,404,10,10,0,1,0
30,421,421,20,20,0,1,0
45,426,426,26,26,0,1,0
47,430,430,1,1,0,1,0
21,432,432,35,4,31,2,1
24,434,434,34,25,9,2,1
33,446,446,57,47,10,3,2
10,449,449,4,4,0,1,0
20,486,486,7,7,0,1,0
19,491,491,16,16,0,1,0
29,496,496,135,135,0,1,0

0,101,101,40,40,0,1,0
9,101,101,13,13,0,1,0
24,104,104,7,7,0,1,0
25,105,105,5,5,0,1,0
6,132,132,6,6,0,1,0
3,140,140,3,3,0,1,0
35,165,165,1,1,0,1,0
7,182,182,9,9,0,1,0
14,190,190,18,6,12,2,1
16,223,223,21,21,0,1,0
36,242,242,63,35,28,3,2
2,244,244,53,3,50,3,2
27,248,248,10,3,7,2,1
13,253,253,44,14,30,3,2
30,255,255,26,26,0,1,0
22,262,262,4,1,3,2,1
5,268,268,13,13,0,1,0
33,271,271,28,10,18,3,2
8,273,273,14,8,6,2,1
21,277,277,4,4,0,1,0
31,279,279,10,10,0,1,0
29,291,291,92,92,0,1,0
11,297,297,33,11,22,3,2
28,307,307,68,68,0,1,0
23,309,309,57,21,36,4,3
17,310,310,31,31,0,1,0
26,318,318,21,21,0,1,0
18,327,327,4,1,3,2,1
20,331,331,34,34,0,1,0
12,379,379,4,4,0,1,0
32,380,380,71,38,33,2,1
10,399,399,83,9,74,3,2
1,402,402,26,26,0,1,0
34,421,421,38,18,20,2,1
19,462,462,27,15,12,2,1
4,475,475,24,10,14,3,2
15,496,496,17,8,9,4,3

25,100,100,3,3,0,1,0
17,114,114,2,2,0,1,0
21,121,121,6,6,0,1,0
8,124,124,32,8,24,4,3
26,129,129,21,21,0,1,0
19,131,131,16,16,0,1,0
4,132,132,17,10,7,2,1
10,134,134,20,20,0,1,0
27,152,152,26,6,20,2,1
1,174,174,4,4,0,1,0
22,179,179,12,12,0,1,0
34,192,192,27,27,0,1,0
32,222,222,14,14,0,1,0
31,230,230,7,1,6,3,2
12,231,231,6,2,4,2,1
15,242,242,6,6,0,1,0
36,244,244,5,2,3,2,1
5,256,256,77,8,69,4,3
7,257,257,29,29,0,1,0
30,309,309,7,3,4,2,1
2,314,314,30,30,0,1,0
11,335,335,9,9,0,1,0
35,340,340,5,5,0,1,0
37,351,351,16,16,0,1,0
20,352,352,42,11,31,2,1
18,354,354,53,37,16,3,2
23,366,366,21,9,12,4,3
33,372,372,8,5,3,2,1
14,384,384,24,20,4,2,1
16,389,389,1,1,0,1,0
38,393,393,69,30,39,4,3
28,415,415,41,41,0,1,0
6,421,421,29,29,0,1,0
24,427,427,221,71,150,4,3
3,440,440,7,1,6,2,1
9,460,460,26,4,22,3,2
29,475,475,67,5,62,4,3
0,494,494,37,23,14,2,1
13,500,500,93,15,78,4,3

4,120,120,1,1,0,1,0
11,130,130,3,3,0,1,0
15,132,132,4,4,0,1,0
17,147,147,17,5,12,3,2
6,171,171,5,5,0,1,0
22,187,187,26,26,0,1,0
16,193,193,44,11,33,4,3
10,217,217,33,33,0,1,0
8,220,220,7,1,6,3,2
26,223,223,16,16,0,1,0
3,235,235,14,9,5,2,1
0,240,240,33,33,0,1,0
24,241,241,1,1,0,1,0
25,244,244,14,14,0,1,0
13,249,249,1,1,0,1,0
30,250,250,20,20,0,1,0
18,250,250,18,18,0,1,0
21,251,251,13,13,0,1,0
7,252,252,1,1,0,1,0
34,260,260,1,1,0,1,0
35,286,286,10,10,0,1,0
12,308,308,107,34,73,4,3
23,314,314,14,14,0,1,0
2,331,331,58,58,0,1,0
5,334,334,140,44,96,4,3
32,336,336,55,55,0,1,0
33,348,348,6,3,3,2,1
27,350,350,127,59,68,4,3
20,365,365,36,36,0,1,0
9,385,385,38,14,24,3,2
31,404,404,82,74,8,3,2
1,419,419,7,2,5,2,1
19,422,422,70,52,18,3,2
28,435,435,16,16,0,1,0
29,445,445,93,44,49,2,1
14,481,481,65,13,52,4,3

10,100,100,36,36,0,1,0
13,106,106,16,3,13,2,1
30,108,108,6,3,3,2,1
20,120,120,5,5,0,1,0
9,127,127,18,18,0,1,0
19,139,139,17,1,16,4,3
6,142,142,1,1,0,1,0
0,156,156,27,27,0,1,0
28,181,181,2,2,0,1,0
15,185,185,2,2,0,1,0
25,200,200,21,21,0,1,0
2,262,262,30,30,0,1,0
7,272,272,13,2,11,4,3
24,284,284,12,12,0,1,0
1,285,285,46,19,27,2,1
21,314,314,4,4,0,1,0
22,322,322,1,1,0,1,0
11,328,328,79,36,43,2,1
32,338,338,40,19,21,4,3
3,345,345,62,49,13,2,1
17,358,358,119,19,100,3,2
16,361,361,97,55,42,4,3
4,387,387,1,1,0,1,0
23,399,399,45,45,0,1,0
27,404,404,21,12,9,4,3
5,419,419,67,52,15,2,1
31,424,424,56,56,0,1,0
8,447,447,50,34,16,3,2
12,449,449,23,23,0,1,0
29,462,462,115,29,86,3,2
18,465,465,18,8,10,3,2
14,478,478,80,45,35,2,1
26,483,483,29,29,0,1,0

4,112,112,6,6,0,1,0
18,112,112,6,6,0,1,0
31,144,144,14,14,0,1,0
23,162,162,45,40,5,2,1
14,188,188,18,18,0,1,0
17,198,198,27,1,26,3,2
22,220,220,35,35,0,1,0
30,223,223,30,30,0,1,0
25,250,250,10,1,9,2,1
2,263,263,51,51,0,1,0
13,265,265,8,8,0,1,0
6,270,270,50,50,0,1,0
20,273,273,5,5,0,1,0
8,277,277,34,12,22,3,2
27,280,280,3,3,0,1,0
12,285,285,56,32,24,4,3
16,285,285,45,6,39,2,1
9,306,306,59,59,0,1,0
21,310,310,1,1,0,1,0
33,327,327,20,14,6,3,2
5,345,345,1,1,0,1,0
34,354,354,22,22,0,1,0
26,369,369,75,2,73,4,3
15,370,370,10,10,0,1,0
10,380,380,23,23,0,1,0
28,383,383,37,37,0,1,0
24,385,385,21,12,9,2,1
11,411,411,20,17,3,2,1
0,425,425,16,16,0,1,0
32,442,442,28,28,0,1,0
19,443,443,26,8,18,2,1
1,468,468,148,114,34,2,1
7,473,473,61,61,0,1,0
3,483,483,101,21,80,4,3
29,484,484,120,19,101,4,3

13,101,101,1,1,0,1,0
17,113,113,12,2,10,2,1
25,116,116,2,2,0,1,0
1,133,133,5,5,0,1,0
32,141,141,25,16,9,4,3
22,156,156,35,18,17,2,1
11,156,156,18,18,0,1,0
15,158,158,2,2,0,1,0
24,160,160,18,10,8,3,2
19,164,164,1,1,0,1,0
42,165,165,8,4,4,2,1
37,180,180,1,1,0,1,0
23,189,189,3,3,0,1,0
16,190,190,9,3,6,3,2
10,191,191,6,6,0,1,0
12,192,192,10,3,7,2,1
21,195,195,32,32,0,1,0
6,196,196,17,13,4,2,1
44,227,227,1,1,0,1,0
27,230,230,27,7,20,2,1
20,239,239,2,2,0,1,0
39,243,243,59,59,0,1,0
14,253,253,1,1,0,1,0
35,275,275,8,8,0,1,0
0,277,277,18,18,0,1,0
2,282,282,18,18,0,1,0
5,282,282,11,11,0,1,0
38,312,312,50,26,24,2,1
46,314,314,109,20,89,3,2
41,328,328,14,14,0,1,0
30,345,345,31,11,20,3,2
3,345,345,1,1,0,1,0
8,352,352,21,13,8,2,1
43,363,363,5,1,4,2,1
26,388,388,21,13,8,2,1
36,399,399,4,4,0,1,0
7,401,401,31,31,0,1,0
29,417,417,34,34,0,1,0
34,428,428,51,51,0,1,0
31,441,441,16,16,0,1,0
28,447,447,70,70,0,1,0
4,483,483,79,76,3,2,1
33,494,494,47,22,25,2,1
9,494,494,92,50,42,2,1
40,496,496,16,16,0,1,0
18,498,498,10,2,8,2,1
45,499,499,117,109,8,3,2

28,102,102,2,2,0,1,0
25,113,113,3,3,0,1,0
7,125,125,16,2,14,3,2
24,128,128,2,2,0,1,0
16,142,142,8,8,0,1,0
34,146,146,11,1,10,2,1
3,151,151,13,13,0,1,0
29,166,166,38,14,24,4,3
22,171,171,17,8,9,4,3
20,194,194,2,2,0,1,0
5,203,203,6,6,0,1,0
15,203,203,17,13,4,2,1
27,224,224,3,3,0,1,0
31,229,229,20,12,8,3,2
14,233,233,80,30,50,2,1
0,240,240,8,5,3,2,1
38,242,242,33,25,8,2,1
23,260,260,20,20,0,1,0
43,272,272,17,13,4,2,1
26,280,280,27,21,6,2,1
36,280,280,76,76,0,1,0
42,290,290,13,13,0,1,0
32,313,313,16,16,0,1,0
40,317,317,25,8,17,4,3
45,346,346,101,19,82,4,3
6,371,371,10,10,0,1,0
10,372,372,6,6,0,1,0
11,379,379,66,44,22,2,1
30,381,381,40,40,0,1,0
37,382,382,28,28,0,1,0
12,384,384,24,24,0,1,0
33,392,392,55,6,49,2,1
19,398,398,17,17,0,1,0
39,406,406,17,8,9,4,3
41,421,421,14,14,0,1,0
21,434,434,4,1,3,2,1
18,434,434,18,18,0,1,0
9,454,454,83,83,0,1,0
13,455,455,15,15,0,1,0
4,463,463,17,5,12,3,2
17,467,467,29,9,20,3,2
1,470,470,4,1,3,2,1
8,471,471,38,38,0,1,0
44,479,479,8,8,0,1,0
35,488,488,78,78,0,1,0
2,491,491,20,13,7,2,1

25,112,112,30,16,14,2,1
32,112,112,20,4,16,2,1
13,113,113,33,25,8,3,2
5,121,121,7,7,0,1,0
18,127,127,6,6,0,1,0
29,139,139,2,2,0,1,0
20,150,150,74,8,66,3,2
8,152,152,1,1,0,1,0
2,154,154,43,40,3,2,1
21,154,154,14,14,0,1,0
0,180,180,1,1,0,1,0
6,213,213,15,15,0,1,0
30,215,215,3,3,0,1,0
9,235,235,11,3,8,3,2
22,240,240,31,31,0,1,0
36,248,248,21,21,0,1,0
19,260,260,3,3,0,1,0
15,270,270,52,4,48,4,3
1,293,293,1,1,0,1,0
10,306,306,65,8,57,4,3
28,328,328,5,5,0,1,0
3,330,330,3,3,0,1,0
11,341,341,70,43,27,4,3
4,357,357,28,28,0,1,0
23,363,363,14,2,12,3,2
14,372,372,17,17,0,1,0
35,379,379,11,11,0,1,0
31,385,385,25,25,0,1,0
16,405,405,7,7,0,1,0
12,407,407,22,22,0,1,0
27,425,425,107,13,94,3,2
17,438,438,79,69,10,3,2
24,439,439,50,2,48,2,1
34,448,448,5,5,0,1,0
33,477,477,2,2,0,1,0
7,496,496,71,38,33,2,1
26,498,498,39,39,0,1,0

20,100,100,18,4,14,3,2
18,104,104,9,9,0,1,0
10,119,119,12,5,7,2,1
15,139,139,13,13,0,1,0
12,172,172,11,4,7,2,1
38,213,213,17,6,11,2,1
28,214,214,21,21,0,1,0
39,220,220,2,2,0,1,0
29,263,263,7,1,6,3,2
30,266,266,6,6,0,1,0
26,271,271,15,15,0,1,0
17,276,276,21,21,0,1,0
21,279,279,27,8,19,3,2
7,298,298,4,4,0,1,0
24,299,299,60,24,36,2,1
9,300,300,5,5,0,1,0
14,301,301,13,13,0,1,0
16,306,306,43,37,6,2,1
40,311,311,55,32,23,3,2
3,315,315,53,53,0,1,0
27,315,315,20,12,8,3,2
8,339,339,17,17,0,1,0
35,374,374,41,37,4,2,1
19,375,375,5,5,0,1,0
22,379,379,22,12,10,2,1
36,389,389,30,30,0,1,0
41,391,391,93,46,47,2,1
1,392,392,12,12,0,1,0
11,413,413,135,22,113,4,3
0,428,428,1,1,0,1,0
2,437,437,34,34,0,1,0
13,442,442,5,5,0,1,0
5,451,451,22,22,0,1,0
32,454,454,133,81,52,4,3
4,455,455,71,71,0,1,0
37,470,470,30,30,0,1,0
33,477,477,14,2,12,2,1
23,486,486,19,19,0,1,0
34,487,487,16,1,15,4,3
6,491,491,23,17,6,3,2
25,494,494,74,74,0,1,0
31,499,499,83,41,42,4,3

21,121,121,2,2,0,1,0
14,131,131,3,3,0,1,0
26,159,159,8,3,5,2,1
30,171,171,1,1,0,1,0
35,176,176,18,1,17,3,2
27,193,193,100,42,58,3,2
4,198,198,20,20,0,1,0
18,209,209,3,3,0,1,0
16,209,209,6,6,0,1,0
12,221,221,2,2,0,1,0
11,234,234,22,3,19,2,1
31,251,251,21,21,0,1,0
0,251,251,62,62,0,1,0
5,267,267,14,4,10,2,1
38,270,270,61,44,17,2,1
24,272,272,16,5,11,2,1
20,280,280,5,5,0,1,0
6,283,283,37,1,36,3,2
39,288,288,8,3,5,2,1
2,289,289,61,61,0,1,0
8,295,295,28,28,0,1,0
1,302,302,31,9,22,3,2
36,306,306,38,20,18,2,1
10,309,309,13,13,0,1,0
41,310,310,3,3,0,1,0
29,324,324,19,19,0,1,0
13,334,334,30,30,0,1,0
25,337,337,55,55,0,1,0
40,337,337,49,15,34,2,1
9,340,340,12,2,10,2,1
23,341,341,32,18,14,2,1
19,342,342,35,24,11,2,1
33,367,367,49,21,28,2,1
37,373,373,15,6,9,4,3
17,382,382,102,102,0,1,0
3,383,383,19,19,0,1,0
22,393,393,21,13,8,3,2
15,398,398,36,36,0,1,0
7,398,398,11,11,0,1,0
28,409,409,16,4,12,3,2
34,425,425,4,4,0,1,0
32,494,494,21,14,7,2,1

18,110,110,1,1,0,1,0
22,124,124,20,12,8,2,1
19,147,147,7,7,0,1,0
26,161,161,8,3,5,2,1
1,164,164,32,32,0,1,0
28,193,193,14,4,10,3,2
5,195,195,14,14,0,1,0
13,199,199,33,33,0,1,0
11,210,210,2,2,0,1,0
9,232,232,25,25,0,1,0
21,248,248,50,50,0,1,0
27,257,257,15,12,3,2,1
25,261,261,34,29,5,2,1
24,271,271,101,59,42,4,3
4,286,286,29,19,10,3,2
6,291,291,11,11,0,1,0
14,315,315,52,26,26,2,1
2,322,322,112,74,38,2,1
23,383,383,42,28,14,3,2
0,386,386,107,107,0,1,0
16,417,417,17,17,0,1,0
7,437,437,91,30,61,4,3
10,439,439,25,19,6,3,2
29,445,445,14,8,6,3,2
15,447,447,34,18,16,3,2
20,473,473,6,6,0,1,0
17,478,478,108,96,12,4,3
8,483,483,118,103,15,4,3
3,484,484,122,10,112,4,3
12,489,489,1,1,0,1,0

28,118,118,5,5,0,1,0
13,122,122,4,1,3,2,1
21,160,160,21,21,0,1,0
24,165,165,63,63,0,1,0
18,169,169,12,12,0,1,0
25,179,179,21,21,0,1,0
2,189,189,30,30,0,1,0
1,192,192,26,26,0,1,0
27,206,206,17,4,13,2,1
31,207,207,33,33,0,1,0
4,227,227,3,3,0,1,0
5,237,237,9,5,4,2,1
29,239,239,7,7,0,1,0
16,249,249,7,7,0,1,0
15,298,298,111,111,0,1,0
19,298,298,43,19,24,3,2
10,304,304,61,61,0,1,0
32,310,310,20,20,0,1,0
23,324,324,12,9,3,2,1
7,343,343,107,29,78,4,3
0,349,349,14,6,8,3,2
22,354,354,13,5,8,3,2
14,358,358,114,38,76,4,3
26,359,359,37,37,0,1,0
33,362,362,6,6,0,1,0
17,386,386,20,3,17,3,2
11,390,390,54,40,14,2,1
8,398,398,1,1,0,1,0
9,405,405,41,29,12,2,1
20,433,433,24,18,6,2,1
3,435,435,103,68,35,4,3
12,444,444,75,15,60,4,3
6,479,479,2,2,0,1,0
30,489,489,7,2,5,2,1

17,117,117,21,7,14,3,2
4,147,147,66,6,60,3,2
13,152,152,7,4,3,2,1
27,166,166,10,10,0,1,0
6,172,172,19,6,13,2,1
19,175,175,5,5,0,1,0
23,184,184,34,16,18,4,3
7,188,188,47,24,23,2,1
2,197,197,4,4,0,1,0
21,212,212,62,57,5,2,1
14,251,251,5,5,0,1,0
10,255,255,11,2,9,4,3
31,256,256,39,39,0,1,0
15,279,279,46,40,6,2,1
30,293,293,61,30,31,2,1
16,294,294,21,21,0,1,0
1,301,301,169,90,79,3,2
24,307,307,40,27,13,2,1
12,345,345,5,5,0,1,0
9,350,350,9,9,0,1,0
8,359,359,32,27,5,2,1
0,359,359,51,51,0,1,0
3,369,369,1,1,0,1,0
29,371,371,82,82,0,1,0
28,371,371,33,33,0,1,0
18,452,452,1,1,0,1,0
5,457,457,59,59,0,1,0
26,464,464,13,13,0,1,0
11,484,484,31,7,24,3,2
25,496,496,13,13,0,1,0
22,497,497,10,3,7,2,1
20,499,499,8,8,0,1,0

15,112,112,6,6,0,1,0
26,131,131,18,18,0,1,0
20,133,133,12,12,0,1,0
19,141,141,6,6,0,1,0
25,144,144,29,21,8,3,2
33,146,146,22,2,20,3,2
22,166,166,1,1,0,1,0
30,183,183,21,9,12,2,1
31,206,206,20,20,0,1,0
11,221,221,1,1,0,1,0
34,222,222,34,34,0,1,0
4,223,223,1,1,0,1,0
16,224,224,46,23,23,2,1
14,240,240,13,6,7,2,1
35,246,246,6,6,0,1,0
10,255,255,34,4,30,2,1
32,261,261,57,57,0,1,0
12,282,282,34,34,0,1,0
18,317,317,51,27,24,2,1
13,325,325,25,25,0,1,0
24,328,328,29,29,0,1,0
2,335,335,3,3,0,1,0
8,341,341,6,6,0,1,0
29,355,355,16,16,0,1,0
21,365,365,17,17,0,1,0
23,381,381,25,25,0,1,0
5,397,397,52,52,0,1,0
17,418,418,84,60,24,3,2
3,441,441,19,19,0,1,0
36,442,442,25,7,18,3,2
0,444,444,6,2,4,2,1
9,450,450,107,21,86,3,2
28,453,453,58,54,4,2,1
1,482,482,61,17,44,2,1
6,483,483,136,103,33,2,1
27,498,498,54,32,22,3,2
7,500,500,94,94,0,1,0

7,120,120,3,3,0,1,0
14,133,133,1,1,0,1,0
36,133,133,9,9,0,1,0
26,140,140,1,1,0,1,0
15,140,140,1,1,0,1,0
1,146,146,5,5,0,1,0
21,147,147,8,1,7,2,1
37,155,155,11,1,10,2,1
18,169,169,16,13,3,2,1
4,196,196,14,5,9,4,3
31,203,203,54,54,0,1,0
27,204,204,37,8,29,2,1
2,214,214,19,19,0,1,0
3,224,224,99,99,0,1,0
12,234,234,3,3,0,1,0
41,237,237,28,3,25,4,3
10,243,243,11,11,0,1,0
35,245,245,6,3,3,2,1
29,272,272,7,7,0,1,0
16,277,277,14,10,4,2,1
0,284,284,23,23,0,1,0
23,303,303,13,6,7,2,1
40,307,307,9,9,0,1,0
8,311,311,19,19,0,1,0
43,323,323,72,50,22,2,1
32,332,332,23,12,11,2,1
42,333,333,11,11,0,1,0
39,333,333,43,13,30,4,3
17,336,336,18,2,16,2,1
25,342,342,98,98,0,1,0
11,347,347,5,5,0,1,0
19,358,358,32,12,20,3,2
13,362,362,19,19,0,1,0
5,372,372,74,17,57,4,3
33,384,384,15,15,0,1,0
20,392,392,30,30,0,1,0
24,399,399,33,10,23,2,1
28,401,401,9,9,0,1,0
9,413,413,35,35,0,1,0
30,447,447,32,18,14,2,1
6,453,453,41,17,24,4,3
38,470,470,109,72,37,2,1
22,482,482,19,19,0,1,0
34,490,490,21,21,0,1,0

12,115,115,13,3,10,3,2
41,118,118,21,21,0,1,0
19,130,130,4,4,0,1,0
2,132,132,17,17,0,1,0
29,142,142,3,3,0,1,0
8,143,143,24,8,16,2,1
11,146,146,12,12,0,1,0
7,148,148,1,1,0,1,0
17,149,149,27,27,0,1,0
25,161,161,36,36,0,1,0
22,164,164,6,2,4,2,1
10,164,164,9,3,6,3,2
42,176,176,79,53,26,2,1
6,187,187,3,3,0,1,0
26,190,190,37,37,0,1,0
5,190,190,11,11,0,1,0
34,209,209,20,17,3,2,1
18,228,228,39,23,16,2,1
38,245,245,22,6,16,3,2
13,247,247,4,4,0,1,0
35,254,254,1,1,0,1,0
1,257,257,29,29,0,1,0
16,257,257,35,35,0,1,0
40,264,264,7,7,0,1,0
39,264,264,9,9,0,1,0
28,284,284,12,12,0,1,0
21,301,301,26,26,0,1,0
32,305,305,6,3,3,2,1
20,309,309,5,5,0,1,0
31,314,314,64,17,47,2,1
30,344,344,14,5,9,4,3
9,349,349,11,11,0,1,0
14,368,368,4,4,0,1,0
27,371,371,6,6,0,1,0
37,379,379,22,4,18,4,3
24,391,391,7,7,0,1,0
43,392,392,11,11,0,1,0
23,393,393,21,1,20,3,2
4,416,416,4,4,0,1,0
0,443,443,45,12,33,3,2
15,450,450,89,49,40,3,2
3,459,459,29,11,18,4,3
33,480,480,30,17,13,2,1
36,483,483,75,75,0,1,0

4,101,101,17,17,0,1,0
3,125,125,4,4,0,1,0
13,150,150,6,6,0,1,0
2,150,150,13,13,0,1,0
18,153,153,4,4,0,1,0
6,155,155,18,2,16,3,2
29,166,166,25,18,7,2,1
19,184,184,32,18,14,3,2
30,185,185,44,11,33,2,1
11,196,196,21,21,0,1,0
16,207,207,7,7,0,1,0
32,214,214,48,26,22,2,1
23,220,220,11,11,0,1,0
38,227,227,28,17,11,2,1
36,232,232,5,5,0,1,0
21,273,273,23,1,22,3,2
10,284,284,7,1,6,3,2
8,285,285,1,1,0,1,0
20,300,300,7,7,0,1,0
37,302,302,24,3,21,2,1
0,320,320,2,2,0,1,0
28,329,329,26,16,10,2,1
5,344,344,1,1,0,1,0
17,345,345,29,8,21,4,3
26,358,358,2,2,0,1,0
24,363,363,54,54,0,1,0
15,371,371,66,39,27,2,1
35,387,387,2,2,0,1,0
14,392,392,123,115,8,2,1
31,400,400,68,68,0,1,0
27,400,400,72,63,9,2,1
9,410,410,67,67,0,1,0
34,413,413,34,19,15,4,3
33,421,421,41,41,0,1,0
39,426,426,47,47,0,1,0
1,434,434,125,125,0,1,0
22,464,464,24,12,12,3,2
25,467,467,12,12,0,1,0
7,483,483,6,6,0,1,0
12,485,485,8,2,6,2,1

24,111,111,9,9,0,1,0
30,111,111,1,1,0,1,0
27,121,121,12,12,0,1,0
0,127,127,1,1,0,1,0
10,148,148,5,5,0,1,0
18,156,156,12,12,0,1,0
26,160,160,10,1,9,4,3
3,167,167,11,11,0,1,0
16,171,171,2,2,0,1,0
25,176,176,35,19,16,2,1
34,198,198,8,8,0,1,0
17,232,232,60,13,47,3,2
11,233,233,19,4,15,2,1
21,279,279,5,5,0,1,0
9,280,280,8,8,0,1,0
15,281,281,38,26,12,3,2
12,297,297,137,76,61,4,3
20,299,299,2,2,0,1,0
7,311,311,20,20,0,1,0
6,313,313,117,102,15,2,1
29,320,320,49,33,16,2,1
13,325,325,8,8,0,1,0
33,370,370,31,10,21,4,3
14,382,382,64,64,0,1,0
28,388,388,103,59,44,2,1
1,432,432,65,31,34,3,2
2,438,438,8,8,0,1,0
8,442,442,19,2,17,3,2
31,444,444,51,33,18,4,3
22,454,454,95,60,35,2,1
5,468,468,19,4,15,4,3
23,482,482,59,59,0,1,0
4,482,482,98,98,0,1,0
32,483,483,20,3,17,4,3
19,500,500,50,38,12,3,2

36,119,119,5,5,0,1,0
10,120,120,10,7,3,2,1
13,123,123,10,10,0,1,0
25,128,128,14,3,11,2,1
11,148,148,22,2,20,3,2
37,149,149,5,2,3,2,1
2,156,156,12,12,0,1,0
34,164,164,4,4,0,1,0
12,175,175,37,37,0,1,0
18,200,200,8,8,0,1,0
30,206,206,17,17,0,1,0
8,218,218,20,3,17,2,1
17,219,219,29,17,12,4,3
22,225,225,25,11,14,3,2
7,269,269,65,33,32,2,1
14,279,279,7,7,0,1,0
3,310,310,22,22,0,1,0
20,310,310,12,2,10,2,1
16,313,313,64,46,18,4,3
4,323,323,44,2,42,4,3
29,330,330,34,22,12,4,3
26,335,335,1,1,0,1,0
24,343,343,24,24,0,1,0
31,347,347,75,75,0,1,0
21,360,360,16,16,0,1,0
28,371,371,11,11,0,1,0
23,372,372,221,89,132,4,3
15,396,396,19,4,15,2,1
0,409,409,92,92,0,1,0
5,420,420,1,1,0,1,0
33,434,434,19,19,0,1,0
6,440,440,14,7,7,2,1
9,448,448,21,9,12,3,2
19,461,461,68,68,0,1,0
1,464,464,1,1,0,1,0
27,468,468,28,25,3,2,1
32,469,469,38,38,0,1,0
35,498,498,55,55,0,1,0

23,105,105,1,1,0,1,0
5,122,122,2,2,0,1,0
17,133,133,2,2,0,1,0
33,138,138,19,2,17,2,1
39,141,141,2,2,0,1,0
3,157,157,7,4,3,2,1
24,158,158,4,1,3,2,1
37,159,159,10,10,0,1,0
13,165,165,15,4,11,2,1
14,169,169,7,2,5,2,1
31,190,190,14,14,0,1,0
25,193,193,15,15,0,1,0
12,203,203,4,1,3,2,1
34,208,208,4,1,3,2,1
40,219,219,7,4,3,2,1
42,222,222,32,5,27,3,2
43,238,238,44,44,0,1,0
1,241,241,14,14,0,1,0
7,243,243,2,2,0,1,0
35,258,258,3,3,0,1,0
16,264,264,10,10,0,1,0
29,272,272,29,29,0,1,0
41,286,286,17,17,0,1,0
0,288,288,99,65,34,4,3
32,290,290,1,1,0,1,0
4,297,297,17,17,0,1,0
18,322,322,21,21,0,1,0
20,326,326,21,21,0,1,0
10,327,327,41,2,39,4,3
8,346,346,3,3,0,1,0
45,352,352,104,46,58,3,2
22,353,353,29,29,0,1,0
47,361,361,55,55,0,1,0
15,364,364,13,13,0,1,0
9,383,383,16,1,15,2,1
6,402,402,69,41,28,3,2
21,407,407,8,8,0,1,0
38,408,408,16,1,15,4,3
27,416,416,19,7,12,2,1
11,419,419,5,5,0,1,0
30,421,421,86,41,45,2,1
19,436,436,59,59,0,1,0
44,462,462,61,52,9,4,3
2,477,477,56,25,31,2,1
46,479,479,4,4,0,1,0
36,481,481,121,106,15,4,3
26,497,497,13,13,0,1,0
28,500,500,52,7,45,4,3

2,102,102,6,6,0,1,0
29,106,106,6,6,0,1,0
21,133,133,16,6,10,2,1
19,157,157,10,10,0,1,0
39,171,171,11,11,0,1,0
28,171,171,7,7,0,1,0
31,173,173,4,1,3,2,1
40,177,177,15,8,7,2,1
15,179,179,3,3,0,1,0
30,181,181,79,79,0,1,0
37,183,183,20,14,6,3,2
14,186,186,15,15,0,1,0
24,195,195,6,6,0,1,0
23,202,202,12,12,0,1,0
12,202,202,19,19,0,1,0
17,206,206,33,3,30,3,2
1,216,216,2,2,0,1,0
4,231,231,15,15,0,1,0
22,236,236,33,33,0,1,0
7,254,254,60,60,0,1,0
38,259,259,20,20,0,1,0
18,259,259,1,1,0,1,0
27,263,263,8,8,0,1,0
25,272,272,63,12,51,4,3
32,276,276,5,5,0,1,0
0,287,287,19,10,9,4,3
20,298,298,83,8,75,4,3
36,305,305,26,4,22,3,2
9,339,339,32,8,24,3,2
11,345,345,2,2,0,1,0
16,362,362,7,7,0,1,0
10,367,367,17,17,0,1,0
42,379,379,13,13,0,1,0
26,391,391,102,86,16,2,1
3,400,400,26,26,0,1,0
5,423,423,76,38,38,2,1
6,428,428,3,3,0,1,0
13,435,435,1,1,0,1,0
33,445,445,112,112,0,1,0
34,449,449,5,1,4,2,1
35,473,473,2,2,0,1,0
41,485,485,41,36,5,2,1
8,491,491,15,3,12,3,2

23,120,120,30,12,18,4,3
6,138,138,3,3,0,1,0
1,146,146,45,26,19,3,2
38,147,147,9,4,5,2,1
26,171,171,11,11,0,1,0
35,175,175,43,15,28,2,1
14,178,178,15,2,13,2,1
15,184,184,10,10,0,1,0
4,193,193,17,10,7,2,1
32,196,196,39,39,0,1,0
13,205,205,8,8,0,1,0
17,208,208,8,2,6,2,1
30,211,211,21,21,0,1,0
18,222,222,8,8,0,1,0
12,225,225,19,1,18,3,2
33,229,229,3,3,0,1,0
34,233,233,38,38,0,1,0
29,238,238,4,4,0,1,0
2,239,239,2,2,0,1,0
24,275,275,21,21,0,1,0
8,276,276,10,10,0,1,0
19,286,286,8,4,4,2,1
20,303,303,33,33,0,1,0
11,305,305,97,97,0,1,0
28,305,305,6,6,0,1,0
0,323,323,44,44,0,1,0
31,323,323,6,6,0,1,0
16,330,330,19,19,0,1,0
7,343,343,27,7,20,4,3
9,372,372,8,2,6,3,2
3,386,386,24,24,0,1,0
5,395,395,86,48,38,2,1
25,397,397,6,6,0,1,0
37,413,413,14,14,0,1,0
36,429,429,92,28,64,3,2
22,448,448,55,55,0,1,0
39,452,452,35,35,0,1,0
21,470,470,41,34,7,2,1
10,492,492,37,37,0,1,0
27,495,495,76,34,42,2,1

26,102,102,2,2,0,1,0
42,110,110,20,20,0,1,0
33,113,113,27,27,0,1,0
11,119,119,16,16,0,1,0
29,126,126,15,2,13,2,1
8,128,128,6,6,0,1,0
1,130,130,6,6,0,1,0
35,184,184,8,2,6,3,2
43,189,189,12,12,0,1,0
44,195,195,5,2,3,2,1
19,207,207,10,10,0,1,0
27,221,221,38,38,0,1,0
5,230,230,10,4,6,3,2
2,242,242,10,10,0,1,0
12,244,244,2,2,0,1,0
34,248,248,3,3,0,1,0
16,263,263,1,1,0,1,0
17,279,279,6,3,3,2,1
13,283,283,10,10,0,1,0
31,302,302,45,45,0,1,0
36,307,307,1,1,0,1,0
30,315,315,86,86,0,1,0
6,318,318,14,1,13,2,1
4,324,324,37,37,0,1,0
32,329,329,7,4,3,2,1
9,334,334,57,12,45,3,2
3,338,338,18,18,0,1,0
28,338,338,45,25,20,3,2
38,344,344,32,5,27,2,1
25,346,346,32,21,11,2,1
0,351,351,73,73,0,1,0
23,368,368,6,3,3,2,1
39,377,377,8,3,5,2,1
45,378,378,13,10,3,2,1
14,402,402,105,87,18,3,2
41,402,402,31,31,0,1,0
10,404,404,28,28,0,1,0
22,421,421,4,4,0,1,0
40,438,438,78,78,0,1,0
7,447,447,8,2,6,3,2
18,451,451,1,1,0,1,0
20,470,470,67,17,50,2,1
37,486,486,45,36,9,2,1
21,489,489,67,67,0,1,0
24,492,492,23,18,5,2,1
15,493,493,33,33,0,1,0

29,100,100,17,17,0,1,0
6,108,108,15,15,0,1,0
1,110,110,27,4,23,2,1
0,137,137,9,9,0,1,0
32,141,141,8,2,6,2,1
4,157,157,16,4,12,2,1
12,164,164,15,15,0,1,0
14,181,181,24,8,16,3,2
24,207,207,1,1,0,1,0
15,213,213,48,48,0,1,0
27,217,217,3,3,0,1,0
22,233,233,2,2,0,1,0
17,239,239,32,32,0,1,0
11,242,242,10,10,0,1,0
10,251,251,79,79,0,1,0
7,300,300,26,6,20,3,2
30,319,319,20,20,0,1,0
26,337,337,58,14,44,2,1
33,339,339,37,4,33,4,3
23,352,352,9,9,0,1,0
28,362,362,26,15,11,2,1
3,373,373,6,3,3,2,1
2,393,393,34,34,0,1,0
20,401,401,91,19,72,4,3
5,432,432,1,1,0,1,0
13,434,434,162,48,114,4,3
18,452,452,40,2,38,2,1
25,476,476,85,19,66,3,2
16,479,479,91,16,75,4,3
21,481,481,6,6,0,1,0
19,490,490,67,67,0,1,0
31,492,492,26,1,25,2,1
9,498,498,88,88,0,1,0
8,499,499,15,15,0,1,0

28,102,102,1,1,0,1,0
38,114,114,8,8,0,1,0
43,118,118,11,1,10,2,1
4,127,127,7,7,0,1,0
34,156,156,42,2,40,4,3
22,177,177,29,29,0,1,0
35,178,178,17,14,3,2,1
15,182,182,24,10,14,2,1
20,185,185,21,4,17,4,3
11,192,192,3,3,0,1,0
3,193,193,15,15,0,1,0
32,196,196,30,30,0,1,0
42,200,200,4,4,0,1,0
18,200,200,2,2,0,1,0
5,208,208,6,2,4,2,1
19,214,214,2,2,0,1,0
8,222,222,25,10,15,2,1
10,226,226,22,10,12,4,3
23,229,229,18,10,8,3,2
0,242,242,25,25,0,1,0
16,244,244,8,8,0,1,0
17,257,257,8,2,6,3,2
44,259,259,9,9,0,1,0
37,265,265,24,24,0,1,0
46,265,265,103,83,20,2,1
24,284,284,20,15,5,2,1
14,291,291,1,1,0,1,0
21,297,297,4,1,3,2,1
2,298,298,39,17,22,3,2
40,301,301,5,5,0,1,0
31,327,327,31,9,22,2,1
7,330,330,17,17,0,1,0
9,342,342,6,6,0,1,0
29,351,351,62,26,36,3,2
13,357,357,21,2,19,3,2
25,397,397,99,76,23,4,3
12,399,399,24,15,9,2,1
39,401,401,3,3,0,1,0
41,417,417,59,29,30,4,3
45,418,418,6,6,0,1,0
33,434,434,3,3,0,1,0
36,479,479,86,12,74,4,3
6,485,485,23,5,18,3,2
27,487,487,24,24,0,1,0
26,498,498,9,9,0,1,0
1,499,499,34,34,0,1,0
30,500,500,41,41,0,1,0

11,101,101,8,4,4,2,1
0,107,107,3,3,0,1,0
15,111,111,7,7,0,1,0
13,135,135,17,11,6,2,1
35,136,136,6,6,0,1,0
30,150,150,3,3,0,1,0
5,150,150,16,7,9,4,3
36,163,163,1,1,0,1,0
20,168,168,11,11,0,1,0
37,171,171,19,19,0,1,0
18,188,188,1,1,0,1,0
16,210,210,8,8,0,1,0
7,241,241,85,11,74,3,2
19,250,250,17,14,3,2,1
8,253,253,34,24,10,3,2
26,269,269,31,19,12,3,2
24,298,298,50,26,24,4,3
4,298,298,30,22,8,2,1
12,298,298,18,18,0,1,0
32,306,306,1,1,0,1,0
22,319,319,1,1,0,1,0
27,319,319,24,24,0,1,0
1,342,342,10,10,0,1,0
40,345,345,22,22,0,1,0
39,355,355,22,22,0,1,0
31,373,373,82,45,37,2,1
23,386,386,6,6,0,1,0
25,390,390,14,14,0,1,0
3,396,396,30,6,24,2,1
21,415,415,54,41,13,2,1
14,423,423,42,4,38,2,1
42,428,428,25,19,6,2,1
9,455,455,3,3,0,1,0
43,460,460,1,1,0,1,0
33,468,468,117,29,88,3,2
6,468,468,31,31,0,1,0
41,470,470,141,141,0,1,0
17,475,475,9,3,6,3,2
29,482,482,162,141,21,4,3
2,482,482,23,23,0,1,0
38,489,489,74,74,0,1,0
34,492,492,28,19,9,4,3
28,493,493,9,4,5,2,1
10,498,498,7,7,0,1,0

5,102,102,3,3,0,1,0
9,102,102,19,8,11,4,3
11,120,120,11,11,0,1,0
30,126,126,8,8,0,1,0
13,129,129,3,3,0,1,0
25,137,137,8,8,0,1,0
14,141,141,14,14,0,1,0
4,150,150,18,18,0,1,0
8,153,153,1,1,0,1,0
10,159,159,11,11,0,1,0
26,159,159,44,44,0,1,0
20,161,161,22,22,0,1,0
6,163,163,1,1,0,1,0
1,165,165,17,8,9,2,1
33,195,195,22,6,16,2,1
18,204,204,29,4,25,2,1
39,224,224,28,28,0,1,0
38,250,250,20,20,0,1,0
22,278,278,29,29,0,1,0
15,287,287,8,8,0,1,0
12,294,294,13,1,12,4,3
28,297,297,8,8,0,1,0
23,311,311,14,14,0,1,0
27,315,315,71,71,0,1,0
2,315,315,13,13,0,1,0
21,316,316,2,2,0,1,0
37,317,317,21,21,0,1,0
34,341,341,23,23,0,1,0
36,360,360,1,1,0,1,0
17,362,362,10,10,0,1,0
0,371,371,78,78,0,1,0
29,372,372,24,6,18,3,2
19,394,394,150,120,30,4,3
7,445,445,8,2,6,3,2
3,457,457,36,36,0,1,0
16,460,460,28,28,0,1,0
24,463,463,88,10,78,3,2
35,477,477,93,12,81,4,3
31,493,493,20,12,8,2,1
32,499,499,95,85,10,2,1

12,114,114,2,2,0,1,0
1,127,127,1,1,0,1,0
31,127,127,5,5,0,1,0
6,137,137,27,13,14,3,2
25,143,143,26,12,14,2,1
8,157,157,31,27,4,2,1
26,190,190,21,21,0,1,0
21,199,199,8,8,0,1,0
4,206,206,23,1,22,3,2
29,206,206,5,2,3,2,1
23,242,242,5,5,0,1,0
2,244,244,17,17,0,1,0
17,254,254,9,9,0,1,0
9,260,260,31,1,30,2,1
30,269,269,103,25,78,4,3
32,270,270,5,1,4,2,1
16,276,276,81,29,52,3,2
5,282,282,59,37,22,2,1
19,283,283,67,67,0,1,0
18,285,285,45,45,0,1,0
13,288,288,30,30,0,1,0
15,293,293,8,3,5,2,1
27,293,293,25,19,6,3,2
36,298,298,36,20,16,2,1
24,320,320,49,49,0,1,0
28,322,322,68,68,0,1,0
0,327,327,15,15,0,1,0
7,353,353,103,103,0,1,0
20,383,383,37,37,0,1,0
22,386,386,1,1,0,1,0
33,398,398,7,4,3,2,1
10,399,399,47,13,34,2,1
35,404,404,5,5,0,1,0
3,426,426,8,8,0,1,0
14,443,443,11,11,0,1,0
11,478,478,6,6,0,1,0
34,481,481,17,17,0,1,0

17,101,101,26,26,0,1,0
19,103,103,7,7,0,1,0
25,103,103,9,4,5,2,1
32,106,106,9,9,0,1,0
10,126,126,6,6,0,1,0
11,131,131,17,5,12,4,3
22,131,131,5,5,0,1,0
12,148,148,8,8,0,1,0
6,167,167,7,7,0,1,0
15,199,199,1,1,0,1,0
3,236,236,12,12,0,1,0
30,244,244,7,7,0,1,0
21,249,249,42,42,0,1,0
38,251,251,16,4,12,2,1
1,258,258,12,12,0,1,0
37,277,277,36,36,0,1,0
4,279,279,1,1,0,1,0
36,281,281,13,5,8,3,2
28,288,288,37,37,0,1,0
24,292,292,40,3,37,3,2
18,313,313,40,7,33,3,2
26,314,314,59,31,28,3,2
29,315,315,11,7,4,2,1
20,335,335,82,82,0,1,0
33,338,338,10,10,0,1,0
31,341,341,20,20,0,1,0
35,343,343,92,92,0,1,0
39,348,348,32,32,0,1,0
0,354,354,50,50,0,1,0
9,360,360,9,9,0,1,0
7,366,366,28,11,17,4,3
8,372,372,24,24,0,1,0
34,374,374,17,17,0,1,0
2,376,376,10,10,0,1,0
14,381,381,57,15,42,4,3
27,395,395,11,5,6,2,1
23,395,395,113,113,0,1,0
16,470,470,11,11,0,1,0
5,480,480,26,26,0,1,0
13,494,494,130,130,0,1,0

11,103,103,4,4,0,1,0
20,123,123,8,8,0,1,0
40,139,139,20,17,3,2,1
19,146,146,40,10,30,2,1
18,151,151,7,7,0,1,0
28,160,160,12,12,0,1,0
24,163,163,2,2,0,1,0
14,184,184,10,10,0,1,0
39,191,191,27,23,4,2,1
12,201,201,2,2,0,1,0
31,217,217,17,3,14,3,2
27,228,228,41,41,0,1,0
5,238,238,34,34,0,1,0
8,251,251,8,8,0,1,0
13,272,272,5,2,3,2,1
4,282,282,29,29,0,1,0
34,292,292,43,3,40,3,2
30,296,296,45,45,0,1,0
26,304,304,18,18,0,1,0
10,311,311,23,11,12,4,3
3,312,312,8,8,0,1,0
21,334,334,6,6,0,1,0
38,341,341,2,2,0,1,0
16,345,345,54,31,23,2,1
9,355,355,11,3,8,3,2
17,356,356,63,18,45,2,1
25,366,366,126,35,91,4,3
15,393,393,6,3,3,2,1
42,399,399,8,8,0,1,0
7,428,428,31,31,0,1,0
23,432,432,42,20,22,2,1
41,432,432,78,78,0,1,0
35,433,433,1,1,0,1,0
33,436,436,45,1,44,3,2
36,443,443,35,35,0,1,0
22,447,447,114,6,108,4,3
6,474,474,7,7,0,1,0
29,475,475,4,1,3,2,1
37,478,478,89,23,66,4,3
32,481,481,6,6,0,1,0
1,487,487,33,33,0,1,0
0,493,493,8,8,0,1,0
2,495,495,47,9,38,2,1

14,108,108,11,11,0,1,0
17,128,128,5,5,0,1,0
25,165,165,11,8,3,2,1
38,172,172,23,15,8,2,1
4,184,184,33,28,5,2,1
27,202,202,38,5,33,2,1
11,203,203,48,48,0,1,0
31,209,209,41,21,20,3,2
24,249,249,9,1,8,3,2
10,250,250,53,19,34,2,1
2,255,255,15,9,6,2,1
15,272,272,1,1,0,1,0
18,288,288,5,2,3,2,1
32,292,292,13,1,12,2,1
29,301,301,2,2,0,1,0
37,305,305,2,2,0,1,0
26,310,310,39,39,0,1,0
16,313,313,43,28,15,4,3
8,318,318,1,1,0,1,0
20,326,326,88,71,17,2,1
28,338,338,50,50,0,1,0
12,350,350,36,12,24,2,1
3,372,372,7,1,6,3,2
21,382,382,17,17,0,1,0
34,388,388,75,39,36,4,3
7,400,400,23,23,0,1,0
22,400,400,30,30,0,1,0
30,409,409,19,12,7,2,1
33,429,429,72,72,0,1,0
35,436,436,31,8,23,2,1
19,439,439,14,14,0,1,0
9,441,441,6,3,3,2,1
5,453,453,111,17,94,4,3
36,455,455,22,22,0,1,0
0,464,464,33,11,22,3,2
1,465,465,71,23,48,3,2
23,466,466,34,24,10,3,2
13,475,475,52,52,0,1,0
6,488,488,53,31,22,2,1

26,130,130,8,4,4,2,1
2,152,152,7,4,3,2,1
16,174,174,9,6,3,2,1
22,179,179,3,3,0,1,0
33,183,183,23,9,14,3,2
0,184,184,73,37,36,4,3
12,210,210,22,4,18,2,1
34,225,225,4,4,0,1,0
32,239,239,45,45,0,1,0
15,242,242,53,3,50,4,3
4,254,254,12,2,10,3,2
21,273,273,17,17,0,1,0
7,279,279,10,10,0,1,0
28,302,302,27,27,0,1,0
17,307,307,13,13,0,1,0
11,320,320,62,30,32,3,2
19,334,334,37,7,30,4,3
3,348,348,109,42,67,4,3
8,354,354,28,4,24,3,2
29,355,355,52,34,18,2,1
6,359,359,8,8,0,1,0
35,370,370,8,8,0,1,0
5,376,376,2,2,0,1,0
30,384,384,4,4,0,1,0
31,390,390,101,72,29,2,1
24,393,393,72,63,9,3,2
23,408,408,129,48,81,4,3
18,416,416,9,9,0,1,0
14,423,423,28,28,0,1,0
25,459,459,18,6,12,4,3
27,466,466,57,57,0,1,0
13,474,474,2,2,0,1,0
9,490,490,59,59,0,1,0
1,494,494,7,7,0,1,0
20,497,497,53,21,32,4,3
10,499,499,90,90,0,1,0

19,106,106,14,10,4,2,1
6,112,112,13,13,0,1,0
24,123,123,21,5,16,2,1
31,136,136,5,5,0,1,0
22,143,143,11,11,0,1,0
15,144,144,12,12,0,1,0
0,161,161,11,3,8,3,2
41,166,166,14,14,0,1,0
5,178,178,4,4,0,1,0
12,184,184,1,1,0,1,0
33,184,184,35,5,30,2,1
23,186,186,9,9,0,1,0
42,186,186,11,7,4,2,1
30,207,207,17,17,0,1,0
35,211,211,21,12,9,2,1
18,271,271,8,3,5,2,1
2,301,301,28,24,4,2,1
29,303,303,35,16,19,2,1
38,303,303,6,6,0,1,0
21,305,305,33,33,0,1,0
36,322,322,5,2,3,2,1
26,328,328,28,28,0,1,0
34,330,330,41,28,13,2,1
4,348,348,56,13,43,2,1
28,375,375,63,63,0,1,0
3,381,381,5,2,3,2,1
39,399,399,38,38,0,1,0
32,415,415,19,13,6,3,2
14,422,422,18,9,9,2,1
1,425,425,14,14,0,1,0
20,429,429,15,15,0,1,0
25,431,431,78,60,18,2,1
40,433,433,110,42,68,3,2
11,435,435,21,7,14,2,1
9,439,439,4,1,3,2,1
8,442,442,10,10,0,1,0
27,464,464,32,32,0,1,0
16,464,464,18,18,0,1,0
10,464,464,162,83,79,4,3
17,471,471,86,5,81,4,3
13,483,483,21,21,0,1,0
7,485,485,67,21,46,2,1
37,496,496,26,26,0,1,0

35,101,101,1,1,0,1,0
13,116,116,4,4,0,1,0
32,126,126,1,1,0,1,0
20,130,130,4,1,3,2,1
19,159,159,3,3,0,1,0
3,164,164,24,1,23,2,1
10,202,202,48,48,0,1,0
1,218,218,20,2,18,4,3
33,223,223,2,2,0,1,0
16,241,241,4,4,0,1,0
25,254,254,25,9,16,3,2
6,260,260,35,4,31,2,1
34,262,262,27,27,0,1,0
28,262,262,78,78,0,1,0
11,266,266,3,3,0,1,0
12,288,288,55,13,42,4,3
14,289,289,40,40,0,1,0
9,297,297,13,3,10,2,1
17,301,301,25,25,0,1,0
5,302,302,58,26,32,2,1
2,303,303,6,6,0,1,0
31,303,303,5,5,0,1,0
0,314,314,56,26,30,3,2
21,327,327,60,24,36,2,1
18,331,331,88,58,30,4,3
27,336,336,12,12,0,1,0
36,337,337,17,17,0,1,0
4,352,352,46,31,15,4,3
23,369,369,70,25,45,2,1
24,400,400,31,31,0,1,0
7,408,408,17,3,14,3,2
8,436,436,31,31,0,1,0
22,446,446,120,6,114,4,3
30,477,477,42,42,0,1,0
29,482,482,30,30,0,1,0
15,486,486,67,31,36,4,3
26,489,489,62,26,36,4,3

27,102,102,5,5,0,1,0
9,109,109,6,6,0,1,0
14,109,109,13,13,0,1,0
28,130,130,5,2,3,2,1
31,134,134,5,5,0,1,0
32,139,139,10,10,0,1,0
8,144,144,13,13,0,1,0
19,146,146,5,5,0,1,0
15,164,164,9,3,6,3,2
23,177,177,2,2,0,1,0
3,194,194,1,1,0,1,0
1,197,197,55,55,0,1,0
26,218,218,50,50,0,1,0
17,249,249,16,11,5,2,1
12,257,257,5,5,0,1,0
16,258,258,24,4,20,2,1
30,266,266,26,26,0,1,0
34,275,275,2,2,0,1,0
2,295,295,52,21,31,2,1
6,296,296,25,25,0,1,0
24,298,298,10,3,7,2,1
4,301,301,5,5,0,1,0
7,332,332,5,5,0,1,0
35,334,334,44,44,0,1,0
5,338,338,1,1,0,1,0
11,356,356,67,49,18,2,1
29,362,362,30,30,0,1,0
13,369,369,183,143,40,2,1
22,373,373,44,44,0,1,0
33,393,393,64,64,0,1,0
10,394,394,17,12,5,2,1
20,397,397,149,63,86,3,2
21,424,424,46,9,37,3,2
0,437,437,71,65,6,2,1
18,441,441,124,47,77,3,2
25,493,493,7,7,0,1,0

17,122,122,1,1,0,1,0
2,128,128,6,1,5,2,1
37,136,136,25,25,0,1,0
7,163,163,22,14,8,2,1
23,165,165,14,14,0,1,0
16,169,169,14,5,9,4,3
36,170,170,15,15,0,1,0
24,173,173,47,47,0,1,0
10,184,184,16,16,0,1,0
5,189,189,19,5,14,2,1
25,189,189,10,10,0,1,0
14,194,194,46,1,45,4,3
4,205,205,8,2,6,2,1
30,229,229,114,60,54,4,3
20,236,236,36,8,28,3,2
18,252,252,34,34,0,1,0
31,258,258,11,4,7,2,1
0,270,270,42,26,16,3,2
8,270,270,12,3,9,4,3
9,272,272,3,3,0,1,0
38,273,273,15,15,0,1,0
19,288,288,13,13,0,1,0
29,292,292,5,2,3,2,1
21,303,303,29,21,8,2,1
11,308,308,40,5,35,2,1
22,308,308,61,27,34,4,3
35,330,330,2,2,0,1,0
3,355,355,78,78,0,1,0
15,355,355,18,18,0,1,0
32,364,364,13,4,9,2,1
26,369,369,5,2,3,2,1
39,379,379,20,11,9,2,1
6,387,387,18,3,15,4,3
34,399,399,73,19,54,4,3
1,445,445,34,22,12,4,3
27,462,462,9,9,0,1,0
13,465,465,41,20,21,4,3
33,468,468,9,1,8,2,1
12,486,486,6,6,0,1,0
28,488,488,16,16,0,1,0

30,103,103,12,4,8,2,1
17,119,119,33,3,30,4,3
7,126,126,22,22,0,1,0
22,143,143,26,26,0,1,0
28,165,165,12,12,0,1,0
40,169,169,4,1,3,2,1
2,173,173,19,10,9,4,3
1,178,178,2,2,0,1,0
21,207,207,1,1,0,1,0
6,220,220,7,7,0,1,0
26,235,235,3,3,0,1,0
27,242,242,32,32,0,1,0
43,249,249,69,69,0,1,0
16,286,286,42,42,0,1,0
8,293,293,49,49,0,1,0
12,300,300,2,2,0,1,0
5,302,302,8,5,3,2,1
23,306,306,23,8,15,4,3
38,313,313,21,21,0,1,0
31,313,313,102,102,0,1,0
0,320,320,5,5,0,1,0
33,324,324,46,46,0,1,0
29,333,333,11,4,7,2,1
15,333,333,40,3,37,3,2
10,348,348,7,7,0,1,0
42,351,351,22,16,6,3,2
24,358,358,22,1,21,4,3
37,362,362,27,17,10,2,1
13,369,369,6,6,0,1,0
20,372,372,5,5,0,1,0
34,387,387,29,2,27,2,1
4,388,388,57,57,0,1,0
41,401,401,16,1,15,4,3
35,402,402,97,18,79,4,3
25,410,410,9,9,0,1,0
11,421,421,38,23,15,4,3
39,438,438,46,21,25,2,1
3,440,440,5,5,0,1,0
14,443,443,24,9,15,3,2
32,446,446,25,25,0,1,0
36,456,456,24,6,18,3,2
19,456,456,49,6,43,2,1
18,484,484,10,5,5,2,1
9,497,497,5,5,0,1,0

31,102,102,10,10,0,1,0
34,130,130,27,27,0,1,0
9,141,141,1,1,0,1,0
4,169,169,4,4,0,1,0
16,184,184,4,4,0,1,0
28,189,189,5,5,0,1,0
15,205,205,3,3,0,1,0
32,206,206,21,11,10,3,2
11,215,215,8,8,0,1,0
36,219,219,17,17,0,1,0
1,227,227,70,70,0,1,0
10,227,227,27,3,24,4,3
29,232,232,7,7,0,1,0
8,249,249,10,3,7,2,1
14,250,250,6,6,0,1,0
26,255,255,42,42,0,1,0
33,277,277,4,4,0,1,0
13,280,280,19,10,9,4,3
38,287,287,18,9,9,4,3
24,333,333,48,48,0,1,0
7,336,336,2,2,0,1,0
2,340,340,36,5,31,2,1
6,340,340,10,1,9,4,3
25,353,353,73,3,70,3,2
21,363,363,52,7,45,4,3
5,364,364,8,8,0,1,0
0,368,368,16,1,15,2,1
18,373,373,94,82,12,3,2
22,386,386,22,10,12,3,2
27,395,395,8,8,0,1,0
20,415,415,1,1,0,1,0
17,416,416,44,44,0,1,0
42,419,419,2,2,0,1,0
35,423,423,4,1,3,2,1
41,431,431,99,54,45,2,1
12,435,435,38,38,0,1,0
37,443,443,4,4,0,1,0
39,447,447,28,2,26,2,1
23,453,453,21,21,0,1,0
19,453,453,51,51,0,1,0
30,468,468,146,137,9,4,3
3,480,480,108,65,43,4,3
40,488,488,77,47,30,4,3

32,111,111,2,2,0,1,0
2,115,115,5,5,0,1,0
16,115,115,10,10,0,1,0
30,133,133,43,29,14,2,1
5,136,136,30,22,8,3,2
22,164,164,15,3,12,4,3
13,166,166,25,25,0,1,0
3,169,169,45,15,30,4,3
9,179,179,34,34,0,1,0
25,183,183,1,1,0,1,0
28,184,184,3,3,0,1,0
7,185,185,6,6,0,1,0
26,195,195,33,33,0,1,0
21,209,209,9,9,0,1,0
4,220,220,5,5,0,1,0
20,221,221,12,12,0,1,0
1,229,229,6,2,4,2,1
8,236,236,19,14,5,2,1
18,249,249,2,2,0,1,0
0,260,260,19,19,0,1,0
11,345,345,34,34,0,1,0
29,377,377,10,7,3,2,1
10,381,381,13,4,9,4,3
17,382,382,31,28,3,2,1
23,388,388,17,17,0,1,0
27,392,392,10,1,9,2,1
24,405,405,182,96,86,4,3
33,419,419,69,69,0,1,0
19,421,421,23,23,0,1,0
14,428,428,92,92,0,1,0
15,442,442,35,35,0,1,0
6,453,453,46,46,0,1,0
12,480,480,166,103,63,4,3
31,485,485,97,97,0,1,0

36,100,100,24,24,0,1,0
16,112,112,2,2,0,1,0
22,114,114,29,5,24,4,3
18,130,130,5,5,0,1,0
10,138,138,26,26,0,1,0
34,150,150,11,2,9,4,3
6,158,158,27,15,12,4,3
21,169,169,37,21,16,2,1
11,177,177,38,38,0,1,0
32,178,178,6,2,4,2,1
37,198,198,16,16,0,1,0
28,202,202,1,1,0,1,0
8,217,217,13,13,0,1,0
9,261,261,52,23,29,2,1
24,264,264,7,2,5,2,1
25,268,268,68,22,46,3,2
19,281,281,87,87,0,1,0
4,284,284,39,39,0,1,0
23,313,313,5,2,3,2,1
2,323,323,22,22,0,1,0
0,343,343,10,10,0,1,0
5,350,350,50,32,18,2,1
30,355,355,45,45,0,1,0
27,356,356,22,22,0,1,0
3,367,367,10,1,9,4,3
15,390,390,28,7,21,2,1
1,402,402,30,30,0,1,0
17,417,417,9,9,0,1,0
13,418,418,2,2,0,1,0
20,435,435,49,4,45,3,2
33,436,436,62,53,9,2,1
12,438,438,8,8,0,1,0
31,444,444,8,8,0,1,0
7,445,445,27,1,26,2,1
29,461,461,17,17,0,1,0
35,466,466,84,70,14,3,2
26,480,480,25,25,0,1,0
38,482,482,1,1,0,1,0
14,488,488,22,10,12,4,3

19,100,100,6,6,0,1,0
10,109,109,5,5,0,1,0
32,110,110,7,7,0,1,0
14,118,118,29,29,0,1,0
27,162,162,43,13,30,4,3
2,164,164,19,19,0,1,0
7,194,194,51,4,47,2,1
12,201,201,1,1,0,1,0
43,208,208,37,37,0,1,0
4,213,213,10,10,0,1,0
3,222,222,25,13,12,3,2
42,236,236,24,21,3,2,1
35,237,237,10,10,0,1,0
5,253,253,6,6,0,1,0
23,258,258,8,2,6,3,2
22,270,270,9,9,0,1,0
38,295,295,3,3,0,1,0
13,307,307,35,23,12,2,1
11,309,309,73,73,0,1,0
15,311,311,7,7,0,1,0
39,319,319,33,33,0,1,0
25,321,321,2,2,0,1,0
41,328,328,86,62,24,4,3
37,339,339,78,78,0,1,0
36,376,376,9,9,0,1,0
29,384,384,11,1,10,2,1
8,386,386,27,27,0,1,0
28,406,406,2,2,0,1,0
40,424,424,99,99,0,1,0
24,425,425,20,2,18,4,3
26,434,434,22,15,7,2,1
0,442,442,35,35,0,1,0
1,454,454,24,5,19,2,1
18,456,456,4,4,0,1,0
30,457,457,3,3,0,1,0
9,457,457,26,26,0,1,0
21,458,458,20,20,0,1,0
20,464,464,17,8,9,2,1
16,464,464,40,6,34,3,2
17,471,471,8,2,6,2,1
31,484,484,39,20,19,2,1
34,486,486,19,19,0,1,0
33,487,487,100,88,12,2,1
6,497,497,23,1,22,3,2

25,127,127,11,11,0,1,0
5,128,128,1,1,0,1,0
21,142,142,2,2,0,1,0
26,147,147,4,4,0,1,0
23,147,147,4,4,0,1,0
37,164,164,20,15,5,2,1
35,168,168,4,4,0,1,0
28,170,170,9,9,0,1,0
20,180,180,9,6,3,2,1
19,185,185,3,3,0,1,0
29,222,222,38,17,21,2,1
27,227,227,14,4,10,2,1
36,232,232,34,34,0,1,0
0,232,232,62,62,0,1,0
16,236,236,5,2,3,2,1
33,238,238,14,4,10,3,2
32,255,255,28,28,0,1,0
18,257,257,11,7,4,2,1
4,259,259,26,10,16,3,2
22,300,300,98,60,38,3,2
12,304,304,24,24,0,1,0
3,306,306,82,59,23,2,1
15,314,314,16,1,15,2,1
31,318,318,68,14,54,3,2
7,331,331,12,2,10,2,1
11,339,339,27,5,22,2,1
17,347,347,51,51,0,1,0
10,354,354,31,31,0,1,0
39,355,355,88,42,46,3,2
6,373,373,61,61,0,1,0
34,400,400,4,4,0,1,0
1,410,410,9,9,0,1,0
24,417,417,90,67,23,2,1
8,436,436,11,11,0,1,0
2,439,439,65,23,42,3,2
30,450,450,14,4,10,2,1
9,456,456,79,79,0,1,0
13,471,471,41,41,0,1,0
38,487,487,1,1,0,1,0
14,498,498,14,14,0,1,0

16,106,106,3,3,0,1,0
37,121,121,7,1,6,2,1
24,127,127,4,4,0,1,0
11,133,133,6,3,3,2,1
20,141,141,18,8,10,4,3
34,156,156,22,22,0,1,0
5,185,185,70,70,0,1,0
6,194,194,23,8,15,2,1
13,209,209,1,1,0,1,0
7,223,223,12,12,0,1,0
21,226,226,15,6,9,4,3
35,243,243,11,11,0,1,0
12,260,260,37,1,36,2,1
31,273,273,5,5,0,1,0
10,307,307,8,3,5,2,1
18,309,309,25,25,0,1,0
3,311,311,27,27,0,1,0
27,312,312,116,116,0,1,0
33,361,361,70,70,0,1,0
8,378,378,49,19,30,4,3
22,385,385,45,45,0,1,0
4,395,395,126,27,99,4,3
23,395,395,30,3,27,4,3
14,409,409,2,2,0,1,0
2,412,412,41,15,26,2,1
0,413,413,114,12,102,4,3
25,419,419,32,32,0,1,0
26,449,449,38,38,0,1,0
29,449,449,62,38,24,4,3
30,453,453,13,6,7,2,1
1,458,458,25,25,0,1,0
19,459,459,15,15,0,1,0
15,459,459,7,4,3,2,1
9,461,461,17,8,9,4,3
17,463,463,1,1,0,1,0
28,472,472,1,1,0,1,0
32,480,480,10,10,0,1,0
36,487,487,149,35,114,4,3

12,101,101,34,34,0,1,0
20,116,116,22,22,0,1,0
15,119,119,4,4,0,1,0
27,122,122,37,37,0,1,0
31,130,130,22,22,0,1,0
33,138,138,9,9,0,1,0
11,144,144,1,1,0,1,0
19,161,161,8,2,6,2,1
4,165,165,25,25,0,1,0
14,166,166,9,3,6,2,1
22,169,169,5,5,0,1,0
16,204,204,22,22,0,1,0
26,209,209,3,3,0,1,0
10,210,210,1,1,0,1,0
37,234,234,3,3,0,1,0
29,234,234,63,63,0,1,0
32,235,235,60,28,32,3,2
28,243,243,2,2,0,1,0
34,265,265,16,8,8,2,1
30,273,273,16,6,10,3,2
8,277,277,8,8,0,1,0
3,293,293,36,9,27,2,1
7,299,299,91,91,0,1,0
2,307,307,11,1,10,3,2
0,308,308,34,34,0,1,0
24,311,311,62,32,30,3,2
25,312,312,2,2,0,1,0
6,377,377,51,51,0,1,0
5,386,386,69,69,0,1,0
1,415,415,23,11,12,3,2
17,423,423,35,14,21,4,3
36,435,435,20,17,3,2,1
13,464,464,31,2,29,2,1
9,471,471,5,5,0,1,0
18,474,474,35,20,15,2,1
35,483,483,88,44,44,3,2
21,496,496,12,7,5,2,1
23,500,500,1,1,0,1,0

3,110,110,4,4,0,1,0
18,116,116,4,4,0,1,0
21,124,124,6,6,0,1,0
13,145,145,40,4,36,3,2
22,159,159,6,6,0,1,0
35,162,162,12,4,8,3,2
2,224,224,6,6,0,1,0
8,229,229,38,38,0,1,0
4,230,230,1,1,0,1,0
6,238,238,13,7,6,2,1
9,266,266,35,35,0,1,0
20,273,273,81,81,0,1,0
33,279,279,99,9,90,3,2
28,285,285,43,43,0,1,0
24,296,296,29,8,21,2,1
11,313,313,44,44,0,1,0
5,326,326,2,2,0,1,0
10,327,327,55,55,0,1,0
26,331,331,64,64,0,1,0
32,340,340,17,17,0,1,0
15,341,341,2,2,0,1,0
17,360,360,3,3,0,1,0
31,368,368,1,1,0,1,0
7,405,405,77,77,0,1,0
23,410,410,17,11,6,3,2
36,414,414,22,2,20,3,2
30,427,427,28,28,0,1,0
19,435,435,29,5,24,2,1
29,441,441,32,8,24,3,2
12,441,441,82,46,36,2,1
27,460,460,94,56,38,3,2
14,462,462,1,1,0,1,0
0,464,464,43,43,0,1,0
1,464,464,107,107,0,1,0
25,473,473,24,24,0,1,0
16,477,477,84,84,0,1,0
34,479,479,14,1,13,4,3

24,104,104,12,12,0,1,0
8,110,110,1,1,0,1,0
20,148,148,64,64,0,1,0
21,164,164,20,20,0,1,0
16,179,179,18,18,0,1,0
25,181,181,50,50,0,1,0
26,197,197,13,6,7,3,2
28,201,201,2,2,0,1,0
2,212,212,26,26,0,1,0
17,226,226,2,2,0,1,0
29,266,266,48,48,0,1,0
32,279,279,18,18,0,1,0
11,282,282,48,48,0,1,0
9,290,290,13,8,5,2,1
15,309,309,5,5,0,1,0
7,309,309,20,20,0,1,0
35,309,309,71,5,66,3,2
39,310,310,4,1,3,2,1
4,335,335,4,4,0,1,0
19,343,343,3,3,0,1,0
18,344,344,19,1,18,4,3
41,345,345,2,2,0,1,0
0,348,348,3,3,0,1,0
5,365,365,23,23,0,1,0
14,366,366,11,3,8,2,1
36,367,367,70,31,39,4,3
37,371,371,9,4,5,2,1
3,391,391,77,27,50,4,3
10,402,402,67,67,0,1,0
1,407,407,27,27,0,1,0
38,408,408,38,38,0,1,0
40,418,418,94,94,0,1,0
23,424,424,38,6,32,3,2
30,425,425,14,1,13,2,1
33,425,425,32,32,0,1,0
34,440,440,17,17,0,1,0
6,444,444,18,2,16,3,2
22,444,444,5,1,4,2,1
31,456,456,63,63,0,1,0
27,458,458,29,3,26,4,3
12,461,461,48,48,0,1,0
13,462,462,21,21,0,1,0

1,100,100,7,7,0,1,0
0,106,106,8,8,0,1,0
14,106,106,3,3,0,1,0
9,120,120,17,17,0,1,0
23,147,147,2,2,0,1,0
2,174,174,14,14,0,1,0
17,179,179,22,11,11,2,1
7,189,189,16,16,0,1,0
3,203,203,12,12,0,1,0
13,208,208,45,45,0,1,0
29,218,218,1,1,0,1,0
33,238,238,20,20,0,1,0
27,244,244,32,32,0,1,0
18,277,277,52,34,18,3,2
24,282,282,56,26,30,3,2
34,286,286,5,2,3,2,1
20,307,307,38,38,0,1,0
10,323,323,33,33,0,1,0
6,334,334,63,6,57,4,3
26,338,338,83,41,42,4,3
11,372,372,68,68,0,1,0
16,388,388,29,13,16,2,1
5,392,392,59,59,0,1,0
32,398,398,55,1,54,4,3
8,411,411,7,7,0,1,0
25,414,414,5,5,0,1,0
28,420,420,13,9,4,2,1
19,420,420,26,26,0,1,0
4,445,445,1,1,0,1,0
15,466,466,213,213,0,1,0
30,471,471,13,5,8,2,1
12,481,481,21,21,0,1,0
22,497,497,59,23,36,3,2
31,499,499,159,159,0,1,0
21,500,500,11,11,0,1,0

22,114,114,8,8,0,1,0
24,117,117,5,5,0,1,0
20,125,125,10,7,3,2,1
38,152,152,54,54,0,1,0
5,168,168,1,1,0,1,0
33,199,199,10,10,0,1,0
1,212,212,8,1,7,2,1
11,212,212,13,3,10,2,1
23,214,214,33,24,9,2,1
21,215,215,40,4,36,3,2
34,224,224,7,7,0,1,0
0,234,234,16,16,0,1,0
4,238,238,5,5,0,1,0
16,240,240,85,58,27,2,1
9,269,269,23,23,0,1,0
35,275,275,7,7,0,1,0
17,275,275,13,13,0,1,0
28,276,276,19,19,0,1,0
29,299,299,3,3,0,1,0
18,301,301,17,17,0,1,0
25,315,315,50,50,0,1,0
7,320,320,17,10,7,2,1
36,327,327,63,39,24,4,3
26,330,330,37,37,0,1,0
32,336,336,19,9,10,2,1
8,359,359,73,73,0,1,0
6,360,360,2,2,0,1,0
30,395,395,33,15,18,4,3
13,397,397,59,43,16,3,2
15,407,407,15,12,3,2,1
27,410,410,16,10,6,2,1
19,418,418,108,87,21,4,3
37,429,429,42,24,18,4,3
14,430,430,1,1,0,1,0
3,466,466,77,77,0,1,0
12,475,475,19,6,13,3,2
2,476,476,40,40,0,1,0
31,486,486,60,4,56,3,2
10,488,488,81,81,0,1,0

19,113,113,1,1,0,1,0
36,121,121,23,6,17,2,1
33,129,129,14,4,10,2,1
0,138,138,11,11,0,1,0
45,163,163,3,3,0,1,0
34,165,165,43,43,0,1,0
35,167,167,1,1,0,1,0
7,184,184,3,3,0,1,0
32,201,201,16,10,6,3,2
20,206,206,1,1,0,1,0
30,209,209,4,4,0,1,0
11,217,217,41,26,15,4,3
12,226,226,37,33,4,2,1
27,237,237,26,26,0,1,0
49,249,249,42,1,41,3,2
42,252,252,5,2,3,2,1
43,264,264,5,5,0,1,0
10,269,269,22,7,15,4,3
18,270,270,2,2,0,1,0
5,275,275,12,12,0,1,0
9,278,278,6,2,4,2,1
26,296,296,3,3,0,1,0
31,303,303,33,3,30,4,3
22,312,312,46,27,19,2,1
23,314,314,12,12,0,1,0
41,322,322,77,41,36,4,3
2,328,328,29,29,0,1,0
46,347,347,42,24,18,2,1
39,347,347,14,14,0,1,0
21,348,348,11,5,6,2,1
1,357,357,14,14,0,1,0
38,359,359,7,7,0,1,0
37,368,368,12,12,0,1,0
13,387,387,98,15,83,4,3
16,392,392,3,3,0,1,0
40,394,394,34,24,10,2,1
48,400,400,70,17,53,4,3
44,411,411,71,29,42,3,2
28,416,416,6,3,3,2,1
24,416,416,1,1,0,1,0
17,425,425,12,12,0,1,0
15,426,426,7,7,0,1,0
14,431,431,60,60,0,1,0
25,434,434,40,40,0,1,0
8,440,440,42,9,33,2,1
4,441,441,13,13,0,1,0
3,461,461,20,14,6,2,1
6,466,466,1,1,0,1,0
47,483,483,38,38,0,1,0
29,492,492,38,14,24,2,1

17,104,104,1,1,0,1,0
25,108,108,9,4,5,2,1
1,113,113,11,11,0,1,0
15,132,132,6,6,0,1,0
0,149,149,8,8,0,1,0
22,150,150,5,5,0,1,0
40,170,170,9,9,0,1,0
36,178,178,6,6,0,1,0
44,192,192,8,3,5,2,1
41,208,208,8,2,6,3,2
26,217,217,18,18,0,1,0
43,227,227,27,2,25,2,1
2,245,245,7,1,6,2,1
6,255,255,8,2,6,2,1
28,263,263,20,11,9,2,1
14,273,273,17,17,0,1,0
37,275,275,43,43,0,1,0
3,275,275,4,1,3,2,1
13,278,278,5,5,0,1,0
4,280,280,14,4,10,2,1
7,285,285,1,1,0,1,0
11,298,298,59,59,0,1,0
27,299,299,28,28,0,1,0
21,303,303,44,44,0,1,0
5,321,321,7,2,5,2,1
20,329,329,120,87,33,2,1
9,330,330,8,8,0,1,0
38,352,352,62,38,24,4,3
19,367,367,55,40,15,4,3
39,377,377,103,53,50,4,3
8,386,386,14,4,10,3,2
46,399,399,47,47,0,1,0
33,406,406,6,6,0,1,0
31,407,407,40,40,0,1,0
30,427,427,5,2,3,2,1
24,430,430,26,26,0,1,0
29,454,454,31,31,0,1,0
10,461,461,8,2,6,2,1
12,462,462,5,5,0,1,0
32,471,471,24,24,0,1,0
35,474,474,144,138,6,2,1
16,486,486,59,37,22,3,2
42,486,486,1,1,0,1,0
45,492,492,33,6,27,4,3
34,497,497,115,72,43,2,1
23,497,497,13,13,0,1,0
18,498,498,8,8,0,1,0

31,109,109,5,5,0,1,0
13,125,125,10,7,3,2,1
20,136,136,47,38,9,4,3
24,150,150,14,14,0,1,0
30,152,152,5,5,0,1,0
8,153,153,51,9,42,4,3
4,154,154,1,1,0,1,0
17,167,167,18,18,0,1,0
9,167,167,42,33,9,4,3
0,195,195,1,1,0,1,0
29,224,224,20,13,7,2,1
26,246,246,14,14,0,1,0
1,247,247,38,38,0,1,0
21,265,265,8,8,0,1,0
33,296,296,40,40,0,1,0
11,300,300,6,2,4,2,1
25,340,340,27,27,0,1,0
14,346,346,13,13,0,1,0
3,348,348,94,94,0,1,0
16,357,357,21,21,0,1,0
27,365,365,6,6,0,1,0
12,366,366,77,77,0,1,0
7,367,367,93,3,90,4,3
22,369,369,44,5,39,3,2
6,370,370,21,18,3,2,1
5,390,390,61,49,12,2,1
32,397,397,117,117,0,1,0
2,415,415,1,1,0,1,0
18,443,443,32,32,0,1,0
28,444,444,37,23,14,3,2
15,444,444,104,62,42,2,1
10,463,463,30,15,15,4,3
19,476,476,13,10,3,2,1
23,496,496,10,10,0,1,0

36,103,103,19,12,7,2,1
9,111,111,14,1,13,2,1
35,117,117,2,2,0,1,0
6,171,171,6,6,0,1,0
37,174,174,12,3,9,4,3
0,177,177,1,1,0,1,0
3,181,181,2,2,0,1,0
15,198,198,12,3,9,4,3
12,202,202,26,10,16,3,2
39,207,207,20,14,6,2,1
34,234,234,5,5,0,1,0
41,237,237,13,13,0,1,0
18,245,245,1,1,0,1,0
27,247,247,11,5,6,2,1
25,248,248,28,28,0,1,0
32,262,262,27,27,0,1,0
38,266,266,84,84,0,1,0
31,269,269,45,24,21,4,3
24,291,291,79,31,48,4,3
11,299,299,64,64,0,1,0
8,305,305,12,8,4,2,1
28,308,308,22,2,20,4,3
4,314,314,8,4,4,2,1
19,316,316,2,2,0,1,0
2,329,329,55,28,27,4,3
10,332,332,7,7,0,1,0
33,340,340,17,5,12,4,3
40,343,343,36,36,0,1,0
5,352,352,3,3,0,1,0
42,353,353,4,4,0,1,0
17,364,364,33,33,0,1,0
26,390,390,4,4,0,1,0
23,395,395,12,12,0,1,0
14,420,420,75,3,72,4,3
21,421,421,113,113,0,1,0
16,430,430,23,20,3,2,1
29,432,432,45,45,0,1,0
1,443,443,4,4,0,1,0
13,445,445,62,42,20,2,1
20,453,453,11,11,0,1,0
30,474,474,57,57,0,1,0
7,494,494,85,85,0,1,0
22,499,499,41,41,0,1,0

28,101,101,1,1,0,1,0
4,126,126,1,1,0,1,0
15,127,127,5,5,0,1,0
23,139,139,7,4,3,2,1
13,140,140,23,15,8,3,2
10,143,143,26,23,3,2,1
29,153,153,2,2,0,1,0
7,159,159,4,4,0,1,0
1,179,179,14,6,8,2,1
37,183,183,35,27,8,3,2
32,187,187,27,27,0,1,0
14,194,194,30,30,0,1,0
40,200,200,55,22,33,2,1
20,222,222,8,2,6,3,2
30,222,222,51,51,0,1,0
0,225,225,8,8,0,1,0
17,244,244,2,2,0,1,0
26,254,254,50,45,5,2,1
8,257,257,39,39,0,1,0
2,265,265,11,11,0,1,0
3,280,280,32,32,0,1,0
6,297,297,14,14,0,1,0
19,301,301,51,8,43,2,1
33,304,304,38,5,33,4,3
24,307,307,120,57,63,4,3
34,325,325,4,4,0,1,0
27,355,355,1,1,0,1,0
39,357,357,1,1,0,1,0
21,360,360,11,11,0,1,0
25,366,366,8,8,0,1,0
11,383,383,11,4,7,2,1
31,385,385,23,3,20,2,1
38,399,399,1,1,0,1,0
36,405,405,21,3,18,3,2
9,442,442,61,10,51,4,3
35,449,449,63,63,0,1,0
12,452,452,51,51,0,1,0
22,454,454,10,10,0,1,0
18,463,463,69,69,0,1,0
16,487,487,48,48,0,1,0
5,499,499,44,44,0,1,0

13,102,102,5,5,0,1,0
18,108,108,26,26,0,1,0
21,146,146,4,4,0,1,0
11,151,151,1,1,0,1,0
32,160,160,6,6,0,1,0
35,167,167,43,2,41,2,1
39,167,167,11,11,0,1,0
2,168,168,6,6,0,1,0
4,171,171,9,9,0,1,0
37,185,185,4,4,0,1,0
17,200,200,11,11,0,1,0
14,217,217,23,23,0,1,0
26,218,218,32,21,11,2,1
8,225,225,19,7,12,2,1
25,243,243,44,44,0,1,0
3,265,265,16,16,0,1,0
29,279,279,42,32,10,2,1
7,309,309,31,4,27,2,1
12,321,321,10,4,6,2,1
20,327,327,27,10,17,2,1
1,329,329,28,28,0,1,0
27,345,345,47,7,40,3,2
6,355,355,55,55,0,1,0
5,380,380,26,10,16,2,1
10,383,383,52,24,28,3,2
30,387,387,42,42,0,1,0
38,390,390,11,11,0,1,0
33,395,395,95,86,9,2,1
22,396,396,37,37,0,1,0
40,408,408,26,26,0,1,0
34,410,410,14,14,0,1,0
23,423,423,60,45,15,4,3
16,430,430,11,11,0,1,0
36,439,439,7,7,0,1,0
9,444,444,20,20,0,1,0
0,451,451,35,5,30,4,3
15,469,469,41,41,0,1,0
31,474,474,5,1,4,2,1
28,485,485,28,16,12,4,3
24,485,485,70,70,0,1,0
19,493,493,144,27,117,4,3

28,113,113,1,1,0,1,0
21,115,115,2,2,0,1,0
6,136,136,2,2,0,1,0
14,140,140,2,2,0,1,0
15,151,151,3,3,0,1,0
42,162,162,19,19,0,1,0
31,191,191,44,8,36,4,3
19,210,210,35,35,0,1,0
18,210,210,3,3,0,1,0
2,220,220,14,6,8,3,2
32,224,224,9,9,0,1,0
9,229,229,21,21,0,1,0
0,233,233,8,8,0,1,0
30,239,239,59,59,0,1,0
22,239,239,21,21,0,1,0
39,251,251,12,12,0,1,0
1,255,255,8,8,0,1,0
24,263,263,26,7,19,2,1
10,264,264,1,1,0,1,0
25,266,266,34,28,6,2,1
40,273,273,21,21,0,1,0
13,287,287,30,30,0,1,0
3,289,289,11,1,10,2,1
27,298,298,123,105,18,3,2
47,301,301,3,3,0,1,0
23,303,303,9,1,8,2,1
7,308,308,1,1,0,1,0
43,312,312,18,18,0,1,0
34,318,318,22,22,0,1,0
37,332,332,6,6,0,1,0
20,338,338,12,12,0,1,0
4,341,341,68,68,0,1,0
11,341,341,20,20,0,1,0
41,352,352,18,3,15,2,1
38,355,355,85,39,46,2,1
5,356,356,2,2,0,1,0
33,364,364,13,1,12,4,3
48,391,391,176,167,9,2,1
29,412,412,1,1,0,1,0
36,423,423,16,16,0,1,0
12,427,427,14,10,4,2,1
17,436,436,25,1,24,2,1
44,441,441,31,16,15,4,3
8,443,443,27,17,10,3,2
46,446,446,15,6,9,4,3
35,451,451,13,4,9,3,2
45,462,462,34,15,19,4,3
16,491,491,19,7,12,2,1
26,494,494,13,13,0,1,0

38,117,117,6,6,0,1,0
20,117,117,9,9,0,1,0
7,121,121,17,7,10,2,1
45,127,127,30,30,0,1,0
29,128,128,2,2,0,1,0
17,133,133,2,2,0,1,0
3,135,135,17,17,0,1,0
8,140,140,2,2,0,1,0
15,141,141,12,12,0,1,0
18,143,143,1,1,0,1,0
27,154,154,20,20,0,1,0
2,161,161,5,2,3,2,1
13,163,163,24,24,0,1,0
16,163,163,3,3,0,1,0
35,168,168,10,10,0,1,0
23,188,188,5,5,0,1,0
26,194,194,16,16,0,1,0
0,198,198,4,4,0,1,0
36,202,202,29,5,24,2,1
21,216,216,4,4,0,1,0
44,219,219,9,9,0,1,0
40,228,228,12,12,0,1,0
10,244,244,3,3,0,1,0
32,246,246,32,21,11,2,1
4,248,248,16,1,15,2,1
1,250,250,35,35,0,1,0
12,250,250,11,11,0,1,0
14,259,259,1,1,0,1,0
37,272,272,43,43,0,1,0
34,299,299,70,70,0,1,0
42,300,300,44,8,36,2,1
24,306,306,20,20,0,1,0
11,316,316,22,6,16,3,2
19,329,329,59,13,46,3,2
31,350,350,119,73,46,2,1
33,351,351,27,27,0,1,0
30,375,375,13,2,11,2,1
43,395,395,9,1,8,2,1
6,420,420,26,26,0,1,0
28,438,438,20,16,4,2,1
39,444,444,6,1,5,2,1
22,458,458,39,3,36,2,1
41,463,463,4,4,0,1,0
9,469,469,111,93,18,4,3
5,484,484,1,1,0,1,0
25,496,496,63,63,0,1,0

13,134,134,54,12,42,3,2
18,147,147,4,4,0,1,0
32,154,154,8,8,0,1,0
28,158,158,25,25,0,1,0
3,197,197,33,33,0,1,0
8,198,198,15,15,0,1,0
2,213,213,10,10,0,1,0
24,233,233,17,17,0,1,0
30,237,237,39,39,0,1,0
23,256,256,56,43,13,2,1
7,257,257,45,45,0,1,0
14,263,263,47,25,22,4,3
16,271,271,3,3,0,1,0
11,271,271,38,38,0,1,0
19,298,298,17,4,13,3,2
15,301,301,13,8,5,2,1
25,352,352,7,7,0,1,0
31,361,361,115,16,99,4,3
20,372,372,80,21,59,3,2
4,373,373,96,96,0,1,0
1,380,380,2,2,0,1,0
9,397,397,16,4,12,4,3
22,422,422,4,1,3,2,1
6,432,432,72,23,49,3,2
10,436,436,57,11,46,2,1
5,442,442,19,19,0,1,0
0,455,455,22,22,0,1,0
27,468,468,31,9,22,2,1
26,471,471,33,20,13,2,1
29,474,474,105,105,0,1,0
17,477,477,25,11,14,2,1
12,496,496,12,12,0,1,0
33,498,498,45,6,39,2,1
21,499,499,31,1,30,4,3

25,136,136,2,2,0,1,0
13,143,143,7,1,6,3,2
22,146,146,37,4,33,4,3
1,153,153,8,2,6,2,1
16,158,158,6,2,4,2,1
17,167,167,14,14,0,1,0
9,185,185,3,3,0,1,0
18,188,188,83,29,54,4,3
4,199,199,23,23,0,1,0
12,209,209,24,10,14,3,2
3,224,224,52,52,0,1,0
6,245,245,45,45,0,1,0
35,277,277,22,22,0,1,0
34,277,277,11,11,0,1,0
31,312,312,7,7,0,1,0
0,316,316,63,39,24,2,1
2,330,330,21,1,20,4,3
29,345,345,95,65,30,4,3
23,356,356,72,8,64,4,3
30,358,358,22,1,21,4,3
20,375,375,6,1,5,2,1
33,384,384,53,53,0,1,0
5,390,390,90,33,57,4,3
26,406,406,11,6,5,2,1
28,408,408,16,9,7,2,1
21,424,424,41,6,35,3,2
32,436,436,4,4,0,1,0
15,438,438,34,34,0,1,0
10,458,458,41,41,0,1,0
19,461,461,26,26,0,1,0
8,467,467,47,47,0,1,0
7,472,472,66,36,30,3,2
24,480,480,27,13,14,2,1
27,482,482,11,5,6,3,2
11,491,491,70,26,44,2,1
14,499,499,28,28,0,1,0

16,117,117,11,3,8,2,1
22,120,120,10,10,0,1,0
33,126,126,21,21,0,1,0
11,130,130,18,9,9,2,1
8,132,132,8,8,0,1,0
20,151,151,14,14,0,1,0
23,166,166,21,6,15,2,1
19,205,205,40,40,0,1,0
29,213,213,43,43,0,1,0
15,219,219,5,5,0,1,0
26,247,247,3,3,0,1,0
3,248,248,67,67,0,1,0
17,262,262,16,16,0,1,0
25,276,276,8,8,0,1,0
27,278,278,11,5,6,3,2
1,278,278,1,1,0,1,0
10,299,299,39,30,9,2,1
30,306,306,40,18,22,3,2
21,319,319,27,3,24,2,1
9,329,329,44,12,32,4,3
31,355,355,89,89,0,1,0
0,355,355,11,11,0,1,0
24,375,375,41,41,0,1,0
4,381,381,3,3,0,1,0
13,401,401,12,12,0,1,0
14,415,415,43,40,3,2,1
32,416,416,8,8,0,1,0
12,424,424,128,128,0,1,0
2,429,429,77,32,45,4,3
7,439,439,46,46,0,1,0
18,442,442,70,18,52,3,2
28,451,451,24,12,12,4,3
5,467,467,62,58,4,2,1
6,499,499,136,136,0,1,0

2,116,116,12,12,0,1,0
30,123,123,18,10,8,2,1
8,143,143,40,25,15,4,3
24,156,156,27,27,0,1,0
7,161,161,93,9,84,4,3
9,178,178,38,38,0,1,0
14,192,192,15,15,0,1,0
31,200,200,5,5,0,1,0
1,202,202,28,16,12,4,3
4,203,203,27,27,0,1,0
20,204,204,7,4,3,2,1
23,205,205,11,11,0,1,0
0,209,209,7,1,6,2,1
29,262,262,6,6,0,1,0
27,269,269,2,2,0,1,0
10,281,281,5,5,0,1,0
25,312,312,90,9,81,4,3
15,316,316,37,10,27,4,3
21,338,338,10,2,8,3,2
11,359,359,1,1,0,1,0
13,369,369,43,37,6,2,1
19,369,369,49,31,18,4,3
22,374,374,25,3,22,3,2
16,399,399,152,32,120,4,3
18,399,399,2,2,0,1,0
12,412,412,11,11,0,1,0
26,422,422,57,57,0,1,0
6,423,423,14,8,6,3,2
5,445,445,71,71,0,1,0
3,454,454,83,23,60,4,3
28,458,458,17,17,0,1,0
17,461,461,40,40,0,1,0

17,122,122,1,1,0,1,0
12,128,128,13,13,0,1,0
16,165,165,1,1,0,1,0
34,179,179,13,13,0,1,0
5,191,191,57,57,0,1,0
21,197,197,12,12,0,1,0
19,205,205,7,2,5,2,1
23,223,223,30,21,9,4,3
28,229,229,9,9,0,1,0
27,245,245,19,4,15,4,3
2,248,248,7,2,5,2,1
14,254,254,20,6,14,2,1
6,258,258,2,2,0,1,0
10,264,264,30,2,28,3,2
3,276,276,12,1,11,2,1
38,281,281,9,9,0,1,0
33,281,281,29,3,26,3,2
32,289,289,5,5,0,1,0
42,290,290,1,1,0,1,0
29,299,299,53,53,0,1,0
15,304,304,14,14,0,1,0
20,308,308,2,2,0,1,0
7,308,308,41,41,0,1,0
11,324,324,17,17,0,1,0
35,329,329,20,2,18,3,2
36,333,333,1,1,0,1,0
43,333,333,7,1,6,3,2
37,334,334,19,9,10,2,1
18,336,336,12,3,9,4,3
30,344,344,136,50,86,4,3
41,346,346,10,10,0,1,0
40,362,362,98,98,0,1,0
39,365,365,181,181,0,1,0
26,369,369,4,4,0,1,0
0,382,382,47,1,46,3,2
25,396,396,10,3,7,2,1
31,411,411,14,4,10,2,1
22,424,424,16,16,0,1,0
13,427,427,24,24,0,1,0
4,453,453,23,23,0,1,0
1,458,458,67,22,45,4,3
24,468,468,17,17,0,1,0
9,472,472,19,4,15,2,1
8,482,482,107,59,48,2,1

4,118,118,3,3,0,1,0
29,120,120,6,1,5,2,1
6,131,131,6,6,0,1,0
14,134,134,6,6,0,1,0
31,141,141,2,2,0,1,0
19,143,143,17,1,16,2,1
15,147,147,4,4,0,1,0
22,150,150,1,1,0,1,0
11,166,166,5,2,3,2,1
2,171,171,23,1,22,3,2
5,209,209,15,15,0,1,0
1,210,210,20,20,0,1,0
24,252,252,1,1,0,1,0
25,253,253,37,37,0,1,0
13,259,259,48,18,30,3,2
9,262,262,45,35,10,2,1
7,266,266,41,41,0,1,0
8,279,279,23,9,14,2,1
0,284,284,83,51,32,2,1
28,292,292,3,3,0,1,0
27,301,301,116,71,45,4,3
12,313,313,21,10,11,2,1
23,319,319,95,11,84,3,2
20,322,322,54,30,24,2,1
10,367,367,244,202,42,4,3
3,386,386,25,25,0,1,0
26,387,387,5,2,3,2,1
16,410,410,35,1,34,3,2
21,426,426,46,46,0,1,0
17,440,440,26,4,22,3,2
30,457,457,84,20,64,3,2
18,477,477,19,19,0,1,0

18,105,105,33,3,30,2,1
19,115,115,1,1,0,1,0
7,115,115,11,6,5,2,1
15,120,120,9,9,0,1,0
30,145,145,2,2,0,1,0
17,164,164,3,3,0,1,0
25,185,185,2,2,0,1,0
33,190,190,19,19,0,1,0
11,190,190,6,3,3,2,1
10,197,197,43,11,32,2,1
1,204,204,1,1,0,1,0
24,243,243,62,24,38,3,2
21,247,247,7,2,5,2,1
20,267,267,13,13,0,1,0
2,274,274,78,78,0,1,0
13,279,279,8,8,0,1,0
22,283,283,19,19,0,1,0
14,289,289,32,6,26,2,1
27,317,317,113,113,0,1,0
5,324,324,90,46,44,2,1
32,332,332,55,37,18,2,1
26,354,354,8,8,0,1,0
16,357,357,1,1,0,1,0
9,366,366,39,39,0,1,0
3,368,368,14,14,0,1,0
28,369,369,30,3,27,2,1
8,380,380,154,154,0,1,0
29,381,381,6,6,0,1,0
12,415,415,11,11,0,1,0
31,418,418,3,3,0,1,0
4,449,449,1,1,0,1,0
6,456,456,53,35,18,2,1
23,488,488,159,159,0,1,0
0,497,497,39,39,0,1,0
34,498,498,50,3,47,2,1

8,108,108,5,5,0,1,0
6,111,111,17,8,9,4,3
7,111,111,1,1,0,1,0
17,128,128,40,6,34,3,2
27,152,152,10,10,0,1,0
22,155,155,9,9,0,1,0
29,160,160,1,1,0,1,0
31,183,183,6,3,3,2,1
18,199,199,12,12,0,1,0
25,212,212,12,2,10,2,1
32,213,213,28,28,0,1,0
23,218,218,8,4,4,2,1
19,222,222,23,2,21,4,3
3,238,238,18,18,0,1,0
1,248,248,83,65,18,2,1
13,251,251,16,1,15,2,1
21,254,254,69,31,38,3,2
14,272,272,48,48,0,1,0
0,308,308,80,28,52,3,2
12,308,308,97,52,45,2,1
33,312,312,8,8,0,1,0
5,339,339,1,1,0,1,0
9,353,353,11,11,0,1,0
26,361,361,63,27,36,3,2
16,380,380,4,4,0,1,0
24,384,384,63,13,50,3,2
10,426,426,91,77,14,2,1
30,429,429,87,52,35,2,1
20,438,438,9,9,0,1,0
4,459,459,47,47,0,1,0
2,465,465,11,11,0,1,0
11,467,467,44,44,0,1,0
28,491,491,43,31,12,4,3
15,500,500,60,60,0,1,0

15,112,112,11,11,0,1,0
33,113,113,12,12,0,1,0
27,113,113,6,6,0,1,0
10,124,124,21,15,6,2,1
13,146,146,4,4,0,1,0
8,147,147,17,9,8,2,1
22,172,172,24,11,13,2,1
34,177,177,4,4,0,1,0
18,188,188,7,1,6,3,2
3,206,206,34,26,8,3,2
20,220,220,17,17,0,1,0
37,255,255,40,40,0,1,0
28,272,272,4,4,0,1,0
2,283,283,7,7,0,1,0
17,294,294,26,23,3,2,1
26,299,299,13,13,0,1,0
29,300,300,74,34,40,3,2
0,306,306,4,4,0,1,0
9,319,319,16,16,0,1,0
35,333,333,97,97,0,1,0
30,342,342,16,16,0,1,0
32,342,342,4,4,0,1,0
16,349,349,7,7,0,1,0
19,352,352,69,42,27,4,3
36,360,360,6,6,0,1,0
24,384,384,12,12,0,1,0
7,395,395,17,5,12,2,1
14,401,401,78,78,0,1,0
4,412,412,39,39,0,1,0
11,437,437,43,1,42,2,1
1,448,448,84,12,72,4,3
5,458,458,3,3,0,1,0
31,461,461,70,70,0,1,0
6,471,471,176,96,80,4,3
23,475,475,40,40,0,1,0
12,475,475,45,45,0,1,0
21,481,481,87,49,38,4,3
25,491,491,30,16,14,2,1

39,100,100,2,2,0,1,0
6,115,115,23,23,0,1,0
8,121,121,4,4,0,1,0
23,137,137,65,35,30,4,3
32,141,141,48,35,13,2,1
20,150,150,1,1,0,1,0
5,155,155,3,3,0,1,0
17,165,165,10,10,0,1,0
33,166,166,3,3,0,1,0
29,203,203,1,1,0,1,0
1,219,219,27,27,0,1,0
0,220,220,25,4,21,2,1
19,221,221,9,9,0,1,0
28,226,226,5,5,0,1,0
27,282,282,27,9,18,2,1
9,301,301,36,36,0,1,0
34,318,318,10,5,5,2,1
14,318,318,8,8,0,1,0
31,329,329,25,10,15,4,3
37,337,337,67,1,66,3,2
41,337,337,19,9,10,2,1
24,344,344,8,5,3,2,1
15,354,354,8,5,3,2,1
11,355,355,38,38,0,1,0
38,356,356,52,52,0,1,0
25,366,366,85,85,0,1,0
22,378,378,5,5,0,1,0
16,423,423,54,54,0,1,0
21,447,447,17,17,0,1,0
36,448,448,60,60,0,1,0
3,449,449,30,24,6,3,2
40,450,450,14,14,0,1,0
4,457,457,5,5,0,1,0
26,460,460,4,1,3,2,1
12,460,460,20,7,13,2,1
30,462,462,147,100,47,4,3
13,469,469,24,24,0,1,0
35,485,485,8,2,6,3,2
18,486,486,35,13,22,4,3
7,486,486,44,23,21,4,3
42,491,491,77,77,0,1,0
10,492,492,14,8,6,3,2
2,495,495,8,8,0,1,0

11,122,122,21,21,0,1,0
24,126,126,12,1,11,2,1
13,139,139,23,15,8,2,1
0,142,142,4,4,0,1,0
8,142,142,19,19,0,1,0
17,147,147,4,4,0,1,0
9,214,214,80,34,46,3,2
22,222,222,49,49,0,1,0
10,224,224,3,3,0,1,0
6,227,227,30,30,0,1,0
4,234,234,1,1,0,1,0
20,308,308,6,6,0,1,0
27,310,310,49,49,0,1,0
14,327,327,2,2,0,1,0
29,329,329,39,39,0,1,0
15,333,333,2,2,0,1,0
19,367,367,42,42,0,1,0
16,368,368,76,40,36,3,2
18,374,374,35,13,22,3,2
21,406,406,27,27,0,1,0
2,408,408,186,186,0,1,0
23,418,418,32,32,0,1,0
25,419,419,6,2,4,2,1
12,423,423,36,29,7,2,1
28,443,443,77,77,0,1,0
7,458,458,207,207,0,1,0
3,462,462,17,17,0,1,0
1,462,462,37,37,0,1,0
30,472,472,90,6,84,3,2
26,476,476,47,47,0,1,0
5,480,480,10,10,0,1,0

1,105,105,2,2,0,1,0
32,116,116,4,4,0,1,0
40,137,137,2,2,0,1,0
3,142,142,9,9,0,1,0
33,153,153,13,13,0,1,0
0,160,160,7,7,0,1,0
28,179,179,43,43,0,1,0
23,180,180,20,12,8,3,2
35,186,186,26,16,10,2,1
20,195,195,28,16,12,2,1
5,226,226,23,23,0,1,0
8,226,226,5,5,0,1,0
36,234,234,36,36,0,1,0
37,235,235,47,30,17,4,3
15,238,238,16,16,0,1,0
25,245,245,7,7,0,1,0
7,270,270,34,18,16,3,2
26,272,272,19,15,4,2,1
19,273,273,9,9,0,1,0
11,274,274,9,2,7,2,1
30,290,290,24,24,0,1,0
18,320,320,75,28,47,3,2
17,334,334,45,36,9,2,1
10,355,355,1,1,0,1,0
2,359,359,66,24,42,4,3
27,382,382,41,17,24,4,3
22,387,387,40,25,15,2,1
31,395,395,63,63,0,1,0
6,405,405,4,4,0,1,0
21,422,422,1,1,0,1,0
4,424,424,43,1,42,4,3
24,430,430,17,17,0,1,0
34,432,432,29,29,0,1,0
14,434,434,71,60,11,2,1
39,468,468,72,58,14,3,2
29,472,472,38,38,0,1,0
38,472,472,29,29,0,1,0
13,473,473,85,85,0,1,0
12,489,489,29,13,16,3,2
9,498,498,21,21,0,1,0
16,499,499,67,64,3,2,1

33,104,104,5,1,4,2,1
11,108,108,22,22,0,1,0
23,112,112,8,2,6,2,1
6,114,114,5,5,0,1,0
8,132,132,5,5,0,1,0
15,153,153,36,36,0,1,0
19,171,171,17,17,0,1,0
26,178,178,39,15,24,3,2
34,188,188,22,22,0,1,0
25,190,190,30,21,9,2,1
30,205,205,3,3,0,1,0
16,205,205,13,13,0,1,0
17,212,212,9,9,0,1,0
9,220,220,10,10,0,1,0
22,221,221,2,2,0,1,0
4,251,251,5,5,0,1,0
36,253,253,28,2,26,3,2
2,254,254,4,4,0,1,0
13,257,257,15,3,12,3,2
29,265,265,8,5,3,2,1
35,271,271,5,2,3,2,1
3,279,279,15,3,12,3,2
1,281,281,56,56,0,1,0
21,312,312,110,110,0,1,0
24,316,316,24,3,21,4,3
37,329,329,117,105,12,4,3
5,377,377,8,8,0,1,0
27,433,433,3,3,0,1,0
12,441,441,126,126,0,1,0
28,441,441,43,43,0,1,0
10,450,450,4,4,0,1,0
32,460,460,21,21,0,1,0
0,462,462,77,77,0,1,0
31,472,472,6,2,4,2,1
7,479,479,58,3,55,4,3
14,481,481,82,26,56,3,2
18,487,487,53,53,0,1,0
20,497,497,55,55,0,1,0

14,117,117,7,1,6,2,1
23,150,150,25,25,0,1,0
27,155,155,1,1,0,1,0
0,165,165,14,3,11,2,1
28,165,165,3,3,0,1,0
33,178,178,54,54,0,1,0
1,181,181,18,18,0,1,0
32,189,189,7,2,5,2,1
26,192,192,26,26,0,1,0
38,193,193,20,20,0,1,0
24,195,195,11,5,6,2,1
16,208,208,5,2,3,2,1
21,227,227,18,9,9,2,1
31,231,231,3,3,0,1,0
20,232,232,22,22,0,1,0
3,233,233,1,1,0,1,0
9,238,238,11,2,9,3,2
5,243,243,2,2,0,1,0
30,255,255,12,5,7,2,1
15,261,261,63,53,10,3,2
22,268,268,43,13,30,2,1
12,282,282,10,10,0,1,0
13,301,301,59,15,44,3,2
10,303,303,3,3,0,1,0
6,309,309,57,57,0,1,0
36,324,324,80,41,39,4,3
25,335,335,5,5,0,1,0
37,344,344,20,5,15,4,3
4,370,370,55,29,26,2,1
11,375,375,18,18,0,1,0
17,393,393,1,1,0,1,0
7,413,413,41,2,39,4,3
2,416,416,58,34,24,3,2
29,430,430,127,127,0,1,0
35,436,436,21,21,0,1,0
34,459,459,23,16,7,2,1
18,478,478,95,95,0,1,0
8,482,482,64,27,37,2,1
19,483,483,66,66,0,1,0

18,122,122,3,3,0,1,0
22,123,123,4,4,0,1,0
4,156,156,27,8,19,2,1
21,157,157,11,11,0,1,0
32,164,164,4,4,0,1,0
5,168,168,24,12,12,4,3
38,181,181,38,29,9,2,1
26,214,214,36,36,0,1,0
37,224,224,19,1,18,4,3
30,254,254,14,14,0,1,0
3,259,259,30,30,0,1,0
17,270,270,15,9,6,3,2
19,274,274,39,39,0,1,0
28,278,278,47,44,3,2,1
6,292,292,6,6,0,1,0
15,297,297,9,9,0,1,0
12,299,299,36,21,15,4,3
16,305,305,25,18,7,2,1
36,313,313,36,20,16,4,3
1,313,313,13,8,5,2,1
25,315,315,37,21,16,3,2
35,341,341,15,15,0,1,0
0,345,345,47,47,0,1,0
24,350,350,26,26,0,1,0
34,374,374,15,6,9,2,1
33,378,378,16,10,6,3,2
23,388,388,6,6,0,1,0
13,408,408,30,20,10,3,2
2,411,411,48,4,44,3,2
11,412,412,51,51,0,1,0
29,414,414,24,12,12,4,3
27,434,434,116,72,44,3,2
20,435,435,11,6,5,2,1
9,453,453,38,38,0,1,0
31,457,457,79,25,54,3,2
39,472,472,80,80,0,1,0
8,483,483,1,1,0,1,0
14,483,483,12,12,0,1,0
10,487,487,146,146,0,1,0
7,498,498,33,20,13,2,1

22,120,120,7,7,0,1,0
30,140,140,13,3,10,3,2
4,141,141,1,1,0,1,0
19,141,141,1,1,0,1,0
9,143,143,17,6,11,2,1
8,188,188,52,52,0,1,0
34,194,194,24,15,9,2,1
23,203,203,7,7,0,1,0
26,205,205,2,2,0,1,0
20,224,224,27,27,0,1,0
31,227,227,8,8,0,1,0
11,235,235,37,27,10,3,2
3,272,272,44,11,33,4,3
21,277,277,50,50,0,1,0
32,278,278,7,7,0,1,0
15,283,283,29,24,5,2,1
12,288,288,7,7,0,1,0
6,300,300,50,11,39,4,3
10,321,321,32,32,0,1,0
28,323,323,176,132,44,3,2
7,349,349,35,17,18,4,3
5,372,372,16,10,6,2,1
16,375,375,4,4,0,1,0
2,379,379,1,1,0,1,0
14,382,382,119,45,74,3,2
18,391,391,7,7,0,1,0
0,407,407,1,1,0,1,0
25,409,409,55,29,26,3,2
33,417,417,34,12,22,3,2
13,424,424,135,94,41,2,1
17,439,439,80,5,75,4,3
27,440,440,8,8,0,1,0
1,465,465,4,4,0,1,0
24,471,471,2,2,0,1,0
29,486,486,125,87,38,3,2

42,102,102,17,17,0,1,0
39,126,126,11,5,6,3,2
2,131,131,2,2,0,1,0
45,140,140,5,5,0,1,0
19,142,142,10,4,6,3,2
36,143,143,3,3,0,1,0
6,146,146,6,6,0,1,0
8,148,148,3,3,0,1,0
10,149,149,11,11,0,1,0
7,150,150,1,1,0,1,0
29,164,164,28,28,0,1,0
13,165,165,6,6,0,1,0
22,166,166,60,60,0,1,0
9,184,184,18,12,6,3,2
25,204,204,4,4,0,1,0
37,207,207,13,13,0,1,0
3,208,208,4,4,0,1,0
14,224,224,5,5,0,1,0
33,226,226,4,1,3,2,1
27,227,227,7,7,0,1,0
38,228,228,29,29,0,1,0
17,231,231,4,1,3,2,1
16,232,232,1,1,0,1,0
15,238,238,16,9,7,2,1
43,251,251,23,23,0,1,0
1,258,258,26,26,0,1,0
44,270,270,41,33,8,2,1
40,280,280,29,6,23,2,1
23,281,281,34,10,24,3,2
28,288,288,59,59,0,1,0
35,295,295,9,5,4,2,1
18,298,298,13,2,11,2,1
34,314,314,35,35,0,1,0
30,326,326,7,7,0,1,0
41,363,363,12,5,7,2,1
11,393,393,46,38,8,2,1
0,399,399,45,45,0,1,0
24,411,411,24,6,18,4,3
26,418,418,58,20,38,3,2
32,432,432,6,3,3,2,1
12,447,447,90,4,86,3,2
4,481,481,14,14,0,1,0
21,482,482,4,4,0,1,0
5,484,484,30,2,28,2,1
20,491,491,17,17,0,1,0
31,492,492,224,74,150,4,3

6,131,131,1,1,0,1,0
19,159,159,5,5,0,1,0
26,162,162,10,10,0,1,0
25,170,170,3,3,0,1,0
35,173,173,56,10,46,2,1
17,180,180,25,14,11,4,3
15,188,188,36,21,15,4,3
27,213,213,28,28,0,1,0
8,220,220,66,40,26,2,1
23,221,221,17,14,3,2,1
11,228,228,1,1,0,1,0
31,241,241,68,10,58,3,2
30,255,255,3,3,0,1,0
22,260,260,24,24,0,1,0
1,263,263,14,14,0,1,0
12,273,273,18,6,12,4,3
9,274,274,4,4,0,1,0
2,289,289,73,13,60,4,3
36,292,292,29,29,0,1,0
3,300,300,48,14,34,3,2
7,309,309,20,20,0,1,0
18,310,310,43,43,0,1,0
21,315,315,14,14,0,1,0
5,330,330,1,1,0,1,0
14,347,347,18,18,0,1,0
32,367,367,71,71,0,1,0
29,374,374,3,3,0,1,0
28,398,398,5,5,0,1,0
0,401,401,97,13,84,4,3
4,404,404,63,63,0,1,0
10,416,416,4,4,0,1,0
33,424,424,11,11,0,1,0
24,431,431,34,16,18,4,3
34,438,438,9,5,4,2,1
13,439,439,10,7,3,2,1
16,496,496,82,57,25,2,1
20,498,498,144,17,127,4,3

28,116,116,2,2,0,1,0
34,128,128,17,17,0,1,0
13,129,129,3,3,0,1,0
30,156,156,11,8,3,2,1
35,161,161,12,12,0,1,0
18,168,168,1,1,0,1,0
25,180,180,3,3,0,1,0
16,184,184,2,2,0,1,0
36,186,186,43,43,0,1,0
32,187,187,21,12,9,4,3
23,209,209,3,3,0,1,0
37,217,217,15,15,0,1,0
8,230,230,9,9,0,1,0
1,240,240,36,6,30,4,3
0,243,243,84,84,0,1,0
20,243,243,1,1,0,1,0
2,252,252,1,1,0,1,0
4,253,253,1,1,0,1,0
29,263,263,14,14,0,1,0
6,276,276,4,1,3,2,1
5,281,281,6,6,0,1,0
14,285,285,35,10,25,4,3
27,289,289,5,5,0,1,0
3,313,313,13,13,0,1,0
22,315,315,20,20,0,1,0
7,324,324,7,7,0,1,0
19,328,328,53,10,43,2,1
38,336,336,50,18,32,2,1
33,355,355,12,12,0,1,0
39,405,405,63,3,60,4,3
10,412,412,77,77,0,1,0
21,422,422,108,108,0,1,0
24,453,453,117,117,0,1,0
9,458,458,85,85,0,1,0
31,471,471,10,10,0,1,0
26,490,490,98,5,93,4,3
17,491,491,60,57,3,2,1
12,495,495,74,74,0,1,0
15,497,497,115,115,0,1,0
11,498,498,28,13,15,4,3

33,110,110,24,15,9,2,1
16,112,112,4,4,0,1,0
28,115,115,8,4,4,2,1
29,116,116,15,15,0,1,0
30,130,130,13,13,0,1,0
2,137,137,43,43,0,1,0
36,137,137,1,1,0,1,0
24,162,162,1,1,0,1,0
22,182,182,14,3,11,2,1
4,182,182,2,2,0,1,0
31,190,190,1,1,0,1,0
34,212,212,17,17,0,1,0
14,216,216,15,15,0,1,0
7,235,235,17,17,0,1,0
1,238,238,49,14,35,2,1
23,245,245,8,2,6,3,2
9,262,262,26,23,3,2,1
6,268,268,35,35,0,1,0
37,272,272,64,8,56,3,2
12,277,277,1,1,0,1,0
25,284,284,31,31,0,1,0
35,296,296,51,21,30,4,3
27,298,298,34,20,14,2,1
13,298,298,6,6,0,1,0
0,309,309,8,8,0,1,0
38,324,324,12,4,8,2,1
18,341,341,51,29,22,3,2
21,347,347,55,10,45,4,3
3,348,348,12,12,0,1,0
20,352,352,62,62,0,1,0
26,370,370,62,62,0,1,0
32,379,379,18,12,6,2,1
15,382,382,63,63,0,1,0
5,406,406,21,21,0,1,0
19,407,407,33,18,15,4,3
8,422,422,54,54,0,1,0
11,422,422,77,29,48,2,1
17,432,432,39,31,8,2,1
10,438,438,14,14,0,1,0

25,102,102,8,8,0,1,0
34,112,112,9,9,0,1,0
4,120,120,5,5,0,1,0
13,122,122,12,12,0,1,0
0,131,131,43,5,38,3,2
15,132,132,32,22,10,2,1
32,140,140,43,40,3,2,1
37,146,146,26,26,0,1,0
30,146,146,13,13,0,1,0
21,155,155,23,5,18,2,1
20,177,177,5,5,0,1,0
17,180,180,13,1,12,4,3
18,196,196,39,39,0,1,0
2,198,198,11,1,10,2,1
29,198,198,2,2,0,1,0
6,230,230,16,8,8,2,1
12,236,236,9,9,0,1,0
14,240,240,1,1,0,1,0
8,248,248,41,33,8,3,2
19,249,249,32,32,0,1,0
28,299,299,35,2,33,4,3
26,326,326,30,3,27,2,1
3,333,333,25,25,0,1,0
16,337,337,8,2,6,3,2
11,342,342,8,4,4,2,1
5,350,350,27,27,0,1,0
7,357,357,56,56,0,1,0
24,362,362,18,18,0,1,0
9,368,368,16,16,0,1,0
27,371,371,18,18,0,1,0
36,420,420,38,1,37,2,1
22,423,423,73,49,24,4,3
1,425,425,28,28,0,1,0
23,427,427,90,69,21,2,1
35,436,436,10,1,9,2,1
31,458,458,23,23,0,1,0
33,466,466,17,2,15,4,3
10,491,491,61,8,53,3,2

3,101,101,3,3,0,1,0
8,101,101,3,3,0,1,0
37,113,113,13,3,10,3,2
14,117,117,29,29,0,1,0
2,135,135,1,1,0,1,0
38,137,137,14,14,0,1,0
1,141,141,7,7,0,1,0
33,142,142,17,17,0,1,0
25,158,158,16,16,0,1,0
24,169,169,19,3,16,2,1
22,176,176,1,1,0,1,0
7,189,189,15,15,0,1,0
28,195,195,7,2,5,2,1
4,219,219,5,5,0,1,0
30,236,236,32,4,28,2,1
19,244,244,1,1,0,1,0
15,249,249,20,14,6,3,2
20,263,263,58,58,0,1,0
17,268,268,3,3,0,1,0
11,268,268,16,16,0,1,0
39,271,271,83,83,0,1,0
0,273,273,41,1,40,3,2
26,294,294,44,11,33,2,1
29,302,302,95,95,0,1,0
9,308,308,52,52,0,1,0
23,310,310,4,4,0,1,0
34,313,313,7,7,0,1,0
31,313,313,52,10,42,3,2
40,341,341,7,7,0,1,0
13,351,351,5,5,0,1,0
21,355,355,13,6,7,2,1
10,360,360,106,88,18,3,2
27,374,374,11,8,3,2,1
36,394,394,42,37,5,2,1
5,400,400,114,68,46,3,2
35,419,419,12,7,5,2,1
32,432,432,26,26,0,1,0
6,450,450,18,18,0,1,0
16,455,455,6,6,0,1,0
18,479,479,14,6,8,3,2
12,497,497,14,5,9,2,1

37,106,106,14,2,12,3,2
38,122,122,6,6,0,1,0
35,125,125,5,2,3,2,1
22,126,126,35,31,4,2,1
6,134,134,9,1,8,3,2
13,142,142,19,12,7,2,1
23,157,157,2,2,0,1,0
4,173,173,1,1,0,1,0
5,194,194,14,4,10,3,2
2,198,198,24,24,0,1,0
15,210,210,18,18,0,1,0
21,215,215,2,2,0,1,0
32,225,225,45,45,0,1,0
17,263,263,1,1,0,1,0
36,272,272,12,12,0,1,0
12,274,274,10,1,9,2,1
39,300,300,49,5,44,3,2
7,313,313,1,1,0,1,0
26,315,315,5,5,0,1,0
11,319,319,50,50,0,1,0
28,320,320,9,9,0,1,0
20,321,321,9,9,0,1,0
18,326,326,8,8,0,1,0
24,341,341,24,6,18,2,1
0,383,383,63,63,0,1,0
9,384,384,43,40,3,2,1
1,399,399,18,18,0,1,0
3,401,401,92,6,86,3,2
33,414,414,41,17,24,2,1
27,416,416,25,25,0,1,0
25,421,421,48,30,18,4,3
19,421,421,78,15,63,4,3
10,422,422,120,39,81,4,3
14,459,459,7,7,0,1,0
8,466,466,55,55,0,1,0
16,467,467,4,4,0,1,0
30,470,470,71,57,14,2,1
29,479,479,29,19,10,3,2
31,486,486,164,154,10,2,1
34,493,493,32,32,0,1,0

28,100,100,2,2,0,1,0
15,106,106,2,2,0,1,0
21,120,120,9,9,0,1,0
38,125,125,55,11,44,2,1
39,135,135,2,2,0,1,0
20,137,137,24,6,18,2,1
18,143,143,20,20,0,1,0
24,156,156,14,2,12,2,1
1,167,167,7,1,6,3,2
23,168,168,19,19,0,1,0
7,168,168,15,6,9,2,1
10,200,200,37,37,0,1,0
29,201,201,63,33,30,2,1
8,203,203,18,18,0,1,0
3,208,208,1,1,0,1,0
2,217,217,12,7,5,2,1
4,250,250,60,9,51,4,3
35,251,251,3,3,0,1,0
36,271,271,44,4,40,3,2
31,280,280,5,5,0,1,0
9,283,283,8,8,0,1,0
33,289,289,7,7,0,1,0
37,308,308,20,10,10,2,1
22,319,319,11,4,7,2,1
5,332,332,73,70,3,2,1
13,366,366,1,1,0,1,0
34,366,366,49,49,0,1,0
12,377,377,21,21,0,1,0
0,387,387,19,6,13,2,1
27,388,388,19,19,0,1,0
30,410,410,4,4,0,1,0
11,415,415,53,53,0,1,0
16,429,429,40,40,0,1,0
14,441,441,59,32,27,4,3
25,449,449,73,73,0,1,0
26,455,455,87,44,43,2,1
17,464,464,27,27,0,1,0
32,471,471,3,3,0,1,0
19,478,478,25,25,0,1,0
6,500,500,23,23,0,1,0

24,103,103,6,6,0,1,0
0,113,113,4,1,3,2,1
17,128,128,58,12,46,4,3
29,132,132,23,8,15,4,3
27,132,132,16,1,15,2,1
9,146,146,13,8,5,2,1
13,195,195,1,1,0,1,0
31,195,195,29,29,0,1,0
28,237,237,25,7,18,3,2
35,242,242,76,76,0,1,0
26,257,257,20,20,0,1,0
19,262,262,22,8,14,2,1
10,263,263,12,12,0,1,0
15,285,285,15,15,0,1,0
22,289,289,81,81,0,1,0
2,295,295,16,4,12,3,2
34,300,300,1,1,0,1,0
32,315,315,8,2,6,2,1
20,327,327,22,22,0,1,0
18,346,346,39,39,0,1,0
16,353,353,30,30,0,1,0
7,360,360,77,2,75,4,3
21,380,380,8,8,0,1,0
25,392,392,58,25,33,2,1
12,394,394,60,60,0,1,0
36,403,403,39,3,36,3,2
3,406,406,102,9,93,4,3
14,414,414,14,6,8,3,2
30,418,418,22,18,4,2,1
37,424,424,62,44,18,4,3
1,425,425,1,1,0,1,0
5,426,426,43,43,0,1,0
4,432,432,20,20,0,1,0
8,471,471,6,6,0,1,0
33,481,481,3,3,0,1,0
6,491,491,50,50,0,1,0
23,495,495,1,1,0,1,0
11,496,496,27,27,0,1,0

12,123,123,29,29,0,1,0
18,166,166,6,6,0,1,0
5,167,167,4,4,0,1,0
22,170,170,18,18,0,1,0
15,178,178,2,2,0,1,0
27,180,180,79,1,78,3,2
10,186,186,10,10,0,1,0
0,191,191,1,1,0,1,0
7,229,229,13,1,12,4,3
21,238,238,13,13,0,1,0
4,266,266,79,79,0,1,0
1,279,279,18,2,16,2,1
2,291,291,48,28,20,3,2
34,292,292,4,4,0,1,0
25,305,305,1,1,0,1,0
24,315,315,14,5,9,3,2
23,343,343,57,57,0,1,0
14,347,347,69,27,42,3,2
19,355,355,42,6,36,4,3
6,356,356,33,18,15,4,3
29,362,362,43,39,4,2,1
31,378,378,43,32,11,2,1
17,380,380,6,6,0,1,0
8,380,380,2,2,0,1,0
32,386,386,36,36,0,1,0
13,420,420,30,27,3,2,1
33,425,425,29,17,12,4,3
28,427,427,43,43,0,1,0
26,435,435,32,9,23,3,2
30,439,439,141,48,93,4,3
3,449,449,82,82,0,1,0
16,476,476,71,71,0,1,0
20,486,486,15,7,8,3,2
35,487,487,4,4,0,1,0
11,494,494,141,141,0,1,0
9,500,500,1,1,0,1,0

35,101,101,22,22,0,1,0
9,102,102,12,12,0,1,0
12,128,128,11,3,8,3,2
21,142,142,20,14,6,3,2
31,158,158,11,2,9,4,3
17,159,159,4,4,0,1,0
27,186,186,39,39,0,1,0
26,188,188,2,2,0,1,0
5,196,196,28,28,0,1,0
19,200,200,7,7,0,1,0
0,213,213,8,2,6,3,2
33,240,240,37,7,30,4,3
38,251,251,6,6,0,1,0
37,269,269,27,3,24,4,3
28,273,273,21,9,12,2,1
4,289,289,6,6,0,1,0
11,321,321,51,51,0,1,0
3,326,326,76,48,28,4,3
8,328,328,85,85,0,1,0
23,353,353,68,46,22,2,1
20,367,367,17,3,14,3,2
24,368,368,29,11,18,4,3
36,369,369,52,40,12,2,1
34,370,370,12,12,0,1,0
29,372,372,73,53,20,2,1
14,374,374,38,38,0,1,0
30,378,378,9,6,3,2,1
32,388,388,24,24,0,1,0
15,400,400,2,2,0,1,0
2,404,404,64,9,55,4,3
6,414,414,14,14,0,1,0
39,422,422,39,39,0,1,0
13,430,430,34,9,25,4,3
1,432,432,50,50,0,1,0
10,437,437,64,64,0,1,0
25,456,456,48,34,14,2,1
18,477,477,4,4,0,1,0
16,477,477,3,3,0,1,0
7,480,480,40,14,26,3,2
22,492,492,2,2,0,1,0

1,101,101,31,22,9,2,1
3,102,102,2,2,0,1,0
12,104,104,23,5,18,4,3
35,130,130,3,3,0,1,0
27,138,138,12,3,9,4,3
17,142,142,41,20,21,2,1
25,149,149,13,13,0,1,0
36,185,185,11,11,0,1,0
9,186,186,8,8,0,1,0
13,191,191,9,9,0,1,0
5,191,191,7,1,6,3,2
8,196,196,20,20,0,1,0
19,208,208,18,9,9,2,1
2,216,216,13,2,11,2,1
14,239,239,11,11,0,1,0
20,251,251,18,18,0,1,0
29,255,255,17,17,0,1,0
38,268,268,23,9,14,2,1
22,277,277,25,13,12,3,2
24,311,311,34,34,0,1,0
11,314,314,51,51,0,1,0
26,322,322,44,41,3,2,1
15,327,327,7,4,3,2,1
6,367,367,8,8,0,1,0
16,370,370,55,55,0,1,0
7,381,381,14,14,0,1,0
32,386,386,43,20,23,2,1
33,404,404,53,5,48,3,2
4,406,406,16,16,0,1,0
31,423,423,103,103,0,1,0
23,428,428,98,37,61,4,3
34,436,436,34,34,0,1,0
21,454,454,17,10,7,2,1
30,457,457,51,51,0,1,0
37,477,477,75,75,0,1,0
28,478,478,13,13,0,1,0
10,479,479,19,19,0,1,0
18,480,480,21,21,0,1,0
0,489,489,65,65,0,1,0

10,125,125,2,2,0,1,0
16,126,126,8,2,6,2,1
1,184,184,14,14,0,1,0
24,192,192,60,60,0,1,0
29,204,204,21,6,15,2,1
30,233,233,25,10,15,4,3
9,239,239,82,82,0,1,0
32,242,242,38,6,32,4,3
7,245,245,65,65,0,1,0
6,246,246,1,1,0,1,0
4,303,303,4,4,0,1,0
27,306,306,31,15,16,3,2
31,313,313,24,24,0,1,0
12,332,332,21,21,0,1,0
2,337,337,9,9,0,1,0
15,342,342,128,8,120,4,3
8,361,361,83,33,50,4,3
21,363,363,4,4,0,1,0
26,363,363,8,8,0,1,0
13,366,366,181,130,51,4,3
19,371,371,4,4,0,1,0
25,411,411,71,19,52,3,2
17,419,419,35,9,26,3,2
14,438,438,6,6,0,1,0
20,445,445,10,2,8,2,1
23,449,449,16,16,0,1,0
11,454,454,47,47,0,1,0
3,461,461,98,88,10,2,1
28,467,467,1,1,0,1,0
18,474,474,43,43,0,1,0
0,487,487,9,9,0,1,0
22,496,496,87,77,10,2,1
5,496,496,17,17,0,1,0

39,101,101,6,1,5,2,1
37,105,105,9,9,0,1,0
19,118,118,20,20,0,1,0
15,122,122,4,4,0,1,0
27,142,142,28,28,0,1,0
26,148,148,23,2,21,2,1
3,149,149,37,37,0,1,0
12,156,156,7,7,0,1,0
2,162,162,16,4,12,2,1
29,173,173,11,11,0,1,0
38,204,204,1,1,0,1,0
31,223,223,16,16,0,1,0
13,236,236,21,21,0,1,0
16,245,245,5,5,0,1,0
35,267,267,5,5,0,1,0
9,277,277,13,13,0,1,0
10,288,288,8,8,0,1,0
11,303,303,5,5,0,1,0
7,317,317,69,15,54,4,3
34,344,344,15,15,0,1,0
6,376,376,11,8,3,2,1
24,378,378,6,2,4,2,1
28,386,386,8,3,5,2,1
32,388,388,11,5,6,3,2
4,389,389,18,18,0,1,0
30,390,390,14,6,8,2,1
14,390,390,18,18,0,1,0
23,394,394,10,10,0,1,0
21,411,411,8,8,0,1,0
33,416,416,25,3,22,3,2
18,429,429,3,3,0,1,0
25,429,429,177,155,22,3,2
17,434,434,85,1,84,3,2
20,438,438,161,45,116,4,3
22,441,441,191,133,58,4,3
5,443,443,11,11,0,1,0
8,449,449,7,7,0,1,0
0,453,453,56,56,0,1,0
36,462,462,82,82,0,1,0
1,468,468,6,3,3,2,1
40,489,489,16,16,0,1,0

26,130,130,1,1,0,1,0
6,141,141,28,15,13,2,1
18,145,145,6,6,0,1,0
3,152,152,24,24,0,1,0
10,158,158,2,2,0,1,0
21,172,172,2,2,0,1,0
32,175,175,19,19,0,1,0
36,195,195,20,20,0,1,0
29,197,197,5,5,0,1,0
22,201,201,5,5,0,1,0
1,223,223,28,28,0,1,0
11,223,223,23,5,18,4,3
30,227,227,7,7,0,1,0
16,240,240,38,38,0,1,0
12,264,264,57,57,0,1,0
17,271,271,7,2,5,2,1
2,301,301,73,37,36,2,1
33,318,318,13,13,0,1,0
8,321,321,14,5,9,4,3
25,327,327,36,6,30,3,2
23,330,330,15,15,0,1,0
5,347,347,27,27,0,1,0
24,350,350,52,4,48,4,3
19,360,360,44,39,5,2,1
15,383,383,6,6,0,1,0
37,389,389,4,4,0,1,0
20,391,391,23,23,0,1,0
4,391,391,28,28,0,1,0
14,420,420,122,106,16,4,3
27,427,427,84,84,0,1,0
31,431,431,29,19,10,2,1
7,439,439,4,4,0,1,0
9,454,454,28,20,8,3,2
35,471,471,50,50,0,1,0
13,485,485,3,3,0,1,0
34,494,494,57,9,48,3,2
28,496,496,300,250,50,3,2
0,498,498,22,18,4,2,1

5,118,118,5,5,0,1,0
33,135,135,3,3,0,1,0
20,177,177,8,3,5,2,1
15,181,181,64,64,0,1,0
24,204,204,40,40,0,1,0
35,218,218,29,10,19,4,3
10,221,221,3,3,0,1,0
29,225,225,26,19,7,3,2
14,239,239,58,18,40,2,1
9,240,240,50,41,9,2,1
22,267,267,3,3,0,1,0
34,310,310,21,21,0,1,0
4,324,324,66,30,36,2,1
27,327,327,16,16,0,1,0
3,337,337,6,6,0,1,0
26,355,355,2,2,0,1,0
11,359,359,27,27,0,1,0
23,360,360,15,2,13,2,1
0,368,368,2,2,0,1,0
31,368,368,28,24,4,2,1
28,399,399,40,40,0,1,0
13,422,422,9,6,3,2,1
30,425,425,176,151,25,2,1
32,426,426,8,4,4,2,1
6,433,433,73,73,0,1,0
7,446,446,9,9,0,1,0
21,450,450,46,46,0,1,0
19,455,455,22,3,19,2,1
1,464,464,29,29,0,1,0
8,470,470,9,9,0,1,0
17,470,470,88,45,43,2,1
18,470,470,96,59,37,4,3
25,485,485,48,48,0,1,0
16,489,489,86,86,0,1,0
2,499,499,129,34,95,4,3
12,500,500,6,6,0,1,0

18,109,109,26,26,0,1,0
27,113,113,31,31,0,1,0
15,127,127,17,17,0,1,0
30,129,129,1,1,0,1,0
13,137,137,4,1,3,2,1
0,140,140,5,5,0,1,0
7,156,156,2,2,0,1,0
25,168,168,5,5,0,1,0
10,201,201,61,61,0,1,0
2,220,220,37,37,0,1,0
26,234,234,51,51,0,1,0
17,251,251,1,1,0,1,0
22,264,264,37,37,0,1,0
19,269,269,8,8,0,1,0
12,281,281,21,21,0,1,0
16,282,282,33,33,0,1,0
23,301,301,80,60,20,3,2
24,312,312,48,45,3,2,1
11,320,320,12,12,0,1,0
29,333,333,15,15,0,1,0
3,337,337,111,78,33,4,3
5,346,346,85,67,18,4,3
9,376,376,13,5,8,2,1
1,398,398,32,32,0,1,0
21,405,405,40,40,0,1,0
20,411,411,10,10,0,1,0
14,431,431,11,11,0,1,0
4,442,442,29,29,0,1,0
8,443,443,185,185,0,1,0
28,448,448,14,5,9,4,3
6,488,488,83,13,70,4,3

42,120,120,1,1,0,1,0
9,120,120,11,6,5,2,1
34,121,121,1,1,0,1,0
46,121,121,8,8,0,1,0
13,137,137,3,3,0,1,0
3,148,148,2,2,0,1,0
7,154,154,25,7,18,2,1
11,162,162,10,10,0,1,0
28,170,170,14,14,0,1,0
41,171,171,72,36,36,4,3
19,193,193,18,7,11,2,1
2,205,205,7,4,3,2,1
29,205,205,21,1,20,4,3
4,209,209,11,5,6,3,2
20,211,211,7,2,5,2,1
37,211,211,7,3,4,2,1
21,243,243,33,18,15,4,3
30,256,256,36,30,6,3,2
39,270,270,17,1,16,2,1
27,270,270,11,11,0,1,0
32,281,281,38,38,0,1,0
0,281,281,14,14,0,1,0
14,286,286,31,25,6,3,2
17,295,295,2,2,0,1,0
40,302,302,6,6,0,1,0
26,310,310,1,1,0,1,0
23,316,316,24,8,16,3,2
43,332,332,11,11,0,1,0
12,335,335,30,30,0,1,0
15,349,349,4,4,0,1,0
5,352,352,19,15,4,2,1
24,352,352,29,2,27,2,1
38,352,352,48,48,0,1,0
44,362,362,2,2,0,1,0
8,362,362,4,4,0,1,0
25,366,366,6,6,0,1,0
1,368,368,3,3,0,1,0
31,372,372,4,4,0,1,0
18,398,398,14,14,0,1,0
33,408,408,30,15,15,3,2
35,420,420,17,17,0,1,0
22,433,433,130,58,72,4,3
16,448,448,49,49,0,1,0
36,453,453,178,178,0,1,0
10,489,489,82,82,0,1,0
6,491,491,16,16,0,1,0
45,492,492,81,81,0,1,0

3,105,105,2,2,0,1,0
37,108,108,27,10,17,2,1
38,113,113,10,10,0,1,0
7,113,113,5,5,0,1,0
32,116,116,6,6,0,1,0
26,182,182,19,3,16,3,2
34,190,190,26,17,9,2,1
5,194,194,25,25,0,1,0
12,224,224,12,9,3,2,1
22,225,225,16,10,6,2,1
15,226,226,11,11,0,1,0
25,237,237,1,1,0,1,0
11,262,262,19,19,0,1,0
24,266,266,5,1,4,2,1
19,268,268,37,37,0,1,0
28,270,270,13,13,0,1,0
4,277,277,66,66,0,1,0
40,281,281,3,3,0,1,0
1,284,284,7,1,6,3,2
36,286,286,23,13,10,2,1
23,291,291,28,28,0,1,0
45,300,300,7,7,0,1,0
30,306,306,93,38,55,3,2
31,319,319,46,46,0,1,0
29,325,325,10,10,0,1,0
0,332,332,16,16,0,1,0
20,332,332,21,21,0,1,0
41,346,346,12,7,5,2,1
17,383,383,15,15,0,1,0
42,384,384,40,8,32,3,2
33,384,384,27,27,0,1,0
10,385,385,12,3,9,2,1
18,400,400,17,1,16,2,1
2,410,410,4,4,0,1,0
39,426,426,31,14,17,2,1
9,452,452,47,47,0,1,0
6,455,455,3,3,0,1,0
35,462,462,53,34,19,2,1
44,464,464,23,23,0,1,0
16,464,464,13,13,0,1,0
8,474,474,48,6,42,2,1
21,477,477,100,70,30,4,3
13,477,477,63,25,38,3,2
43,478,478,4,4,0,1,0
14,482,482,10,10,0,1,0
27,492,492,1,1,0,1,0
46,493,493,158,114,44,2,1

4,109,109,1,1,0,1,0
20,110,110,4,4,0,1,0
8,110,110,1,1,0,1,0
9,115,115,16,16,0,1,0
10,117,117,5,1,4,2,1
23,129,129,10,7,3,2,1
5,153,153,3,3,0,1,0
17,167,167,11,11,0,1,0
29,177,177,10,10,0,1,0
7,186,186,79,79,0,1,0
35,188,188,54,54,0,1,0
36,205,205,15,6,9,2,1
16,216,216,10,4,6,2,1
34,224,224,26,26,0,1,0
30,236,236,9,9,0,1,0
21,238,238,8,1,7,2,1
24,255,255,128,128,0,1,0
18,262,262,8,2,6,2,1
15,268,268,12,12,0,1,0
31,271,271,6,6,0,1,0
22,277,277,19,10,9,4,3
25,311,311,29,23,6,3,2
12,320,320,27,27,0,1,0
32,322,322,33,15,18,4,3
2,323,323,22,22,0,1,0
27,333,333,11,11,0,1,0
37,344,344,10,2,8,2,1
26,347,347,11,1,10,3,2
1,350,350,19,16,3,2,1
40,352,352,33,12,21,2,1
33,362,362,49,5,44,3,2
11,370,370,86,86,0,1,0
28,375,375,1,1,0,1,0
38,380,380,46,42,4,2,1
6,390,390,31,3,28,2,1
19,422,422,84,84,0,1,0
14,424,424,17,17,0,1,0
39,439,439,23,23,0,1,0
13,444,444,39,14,25,2,1
0,476,476,66,12,54,4,3
3,481,481,8,1,7,2,1

20,108,108,5,5,0,1,0
9,112,112,1,1,0,1,0
17,116,116,1,1,0,1,0
15,120,120,6,6,0,1,0
27,144,144,20,8,12,4,3
26,169,169,33,33,0,1,0
22,180,180,2,2,0,1,0
18,184,184,17,17,0,1,0
19,190,190,16,13,3,2,1
14,193,193,34,34,0,1,0
23,234,234,31,31,0,1,0
32,241,241,2,2,0,1,0
29,255,255,9,2,7,2,1
3,265,265,10,2,8,2,1
21,276,276,22,13,9,2,1
6,279,279,45,45,0,1,0
1,291,291,20,20,0,1,0
35,306,306,57,57,0,1,0
34,308,308,10,10,0,1,0
7,318,318,4,4,0,1,0
24,326,326,71,26,45,4,3
13,327,327,12,12,0,1,0
10,334,334,5,5,0,1,0
25,335,335,43,43,0,1,0
31,340,340,1,1,0,1,0
30,341,341,21,21,0,1,0
37,354,354,5,1,4,2,1
2,375,375,9,9,0,1,0
16,389,389,42,42,0,1,0
28,396,396,38,27,11,3,2
5,398,398,107,96,11,2,1
36,399,399,63,44,19,4,3
4,418,418,73,47,26,3,2
12,426,426,21,6,15,4,3
33,427,427,130,1,129,4,3
11,443,443,104,104,0,1,0
0,479,479,170,35,135,4,3
8,496,496,11,2,9,4,3

13,101,101,4,4,0,1,0
1,106,106,7,7,0,1,0
31,113,113,3,3,0,1,0
19,120,120,14,14,0,1,0
4,132,132,48,34,14,2,1
33,155,155,3,3,0,1,0
12,166,166,18,7,11,2,1
14,173,173,20,20,0,1,0
20,174,174,19,2,17,2,1
34,178,178,22,8,14,3,2
15,209,209,18,5,13,2,1
22,224,224,26,26,0,1,0
27,228,228,2,2,0,1,0
17,234,234,26,18,8,2,1
25,237,237,37,13,24,2,1
16,249,249,9,3,6,3,2
28,278,278,54,54,0,1,0
29,286,286,8,5,3,2,1
23,298,298,8,8,0,1,0
0,300,300,2,2,0,1,0
30,304,304,9,9,0,1,0
6,315,315,29,29,0,1,0
24,318,318,23,23,0,1,0
5,324,324,27,9,18,4,3
18,336,336,204,157,47,3,2
8,362,362,47,13,34,2,1
3,414,414,15,7,8,2,1
9,423,423,9,5,4,2,1
2,427,427,178,52,126,4,3
32,429,429,7,2,5,2,1
11,451,451,2,2,0,1,0
21,452,452,58,6,52,3,2
26,453,453,11,3,8,2,1
7,471,471,142,116,26,4,3
10,494,494,15,5,10,3,2

29,127,127,6,6,0,1,0
0,128,128,23,23,0,1,0
32,131,131,7,7,0,1,0
22,139,139,2,2,0,1,0
7,162,162,7,7,0,1,0
15,164,164,12,1,11,2,1
28,177,177,11,11,0,1,0
33,214,214,1,1,0,1,0
5,218,218,20,4,16,3,2
16,221,221,33,33,0,1,0
6,221,221,8,1,7,2,1
1,231,231,4,4,0,1,0
8,256,256,4,4,0,1,0
2,258,258,18,13,5,2,1
36,266,266,26,11,15,2,1
19,281,281,17,5,12,2,1
27,282,282,85,85,0,1,0
12,284,284,37,37,0,1,0
26,286,286,3,3,0,1,0
4,301,301,28,17,11,3,2
3,316,316,10,10,0,1,0
39,320,320,1,1,0,1,0
24,321,321,14,3,11,2,1
37,334,334,22,11,11,2,1
18,337,337,2,2,0,1,0
34,349,349,37,32,5,2,1
14,360,360,4,4,0,1,0
10,403,403,126,97,29,4,3
17,404,404,10,10,0,1,0
31,407,407,12,4,8,3,2
21,415,415,53,29,24,3,2
9,416,416,3,3,0,1,0
30,421,421,56,31,25,2,1
35,448,448,25,15,10,2,1
13,479,479,188,141,47,4,3
38,480,480,114,114,0,1,0
11,482,482,49,23,26,4,3
25,492,492,136,63,73,3,2
20,495,495,27,15,12,2,1
23,496,496,126,126,0,1,0

4,108,108,2,2,0,1,0
33,119,119,10,5,5,2,1
17,129,129,1,1,0,1,0
9,130,130,11,11,0,1,0
24,144,144,13,13,0,1,0
16,150,150,30,30,0,1,0
32,154,154,10,2,8,2,1
1,156,156,11,7,4,2,1
6,182,182,12,6,6,2,1
15,189,189,31,10,21,4,3
31,210,210,30,30,0,1,0
2,228,228,10,5,5,2,1
11,229,229,8,8,0,1,0
23,237,237,6,6,0,1,0
29,254,254,39,39,0,1,0
18,273,273,19,19,0,1,0
10,285,285,21,6,15,2,1
27,291,291,49,16,33,4,3
21,291,291,1,1,0,1,0
12,309,309,3,3,0,1,0
3,318,318,84,84,0,1,0
26,327,327,49,34,15,4,3
22,332,332,3,3,0,1,0
5,347,347,52,16,36,4,3
14,375,375,49,34,15,2,1
25,383,383,15,15,0,1,0
30,383,383,16,6,10,3,2
34,417,417,125,68,57,4,3
0,425,425,51,29,22,3,2
19,433,433,18,18,0,1,0
20,438,438,65,45,20,3,2
7,457,457,84,54,30,3,2
13,468,468,94,94,0,1,0
8,472,472,43,43,0,1,0
28,487,487,176,70,106,4,3
35,496,496,19,7,12,4,3

28,101,101,5,5,0,1,0
21,112,112,2,2,0,1,0
4,123,123,9,9,0,1,0
8,132,132,14,5,9,4,3
6,149,149,1,1,0,1,0
10,159,159,1,1,0,1,0
26,184,184,10,10,0,1,0
12,188,188,36,22,14,3,2
29,202,202,99,71,28,2,1
13,220,220,10,10,0,1,0
15,234,234,4,4,0,1,0
18,247,247,12,8,4,2,1
19,248,248,26,26,0,1,0
2,250,250,82,61,21,4,3
20,256,256,22,22,0,1,0
1,258,258,21,21,0,1,0
11,258,258,33,33,0,1,0
17,272,272,12,12,0,1,0
30,276,276,27,27,0,1,0
16,290,290,97,17,80,4,3
7,296,296,108,16,92,4,3
33,299,299,11,11,0,1,0
27,320,320,4,1,3,2,1
24,328,328,94,6,88,3,2
32,334,334,8,8,0,1,0
25,369,369,37,4,33,4,3
3,370,370,7,3,4,2,1
23,403,403,14,14,0,1,0
5,403,403,17,17,0,1,0
9,430,430,20,4,16,3,2
0,456,456,40,6,34,2,1
22,478,478,19,19,0,1,0
14,480,480,180,135,45,2,1
31,487,487,31,24,7,2,1

19,118,118,1,1,0,1,0
14,120,120,4,4,0,1,0
4,128,128,2,2,0,1,0
9,146,146,3,3,0,1,0
22,153,153,29,6,23,2,1
44,155,155,25,25,0,1,0
31,160,160,28,19,9,4,3
39,164,164,8,3,5,2,1
37,175,175,1,1,0,1,0
12,176,176,16,16,0,1,0
7,179,179,1,1,0,1,0
41,190,190,1,1,0,1,0
43,191,191,14,6,8,3,2
35,199,199,77,49,28,3,2
23,214,214,1,1,0,1,0
20,227,227,11,11,0,1,0
17,230,230,6,3,3,2,1
38,233,233,17,17,0,1,0
27,242,242,13,3,10,3,2
42,247,247,28,14,14,3,2
16,253,253,1,1,0,1,0
28,257,257,10,6,4,2,1
13,266,266,21,21,0,1,0
46,277,277,1,1,0,1,0
32,298,298,43,18,25,2,1
25,313,313,1,1,0,1,0
5,317,317,6,6,0,1,0
6,322,322,34,1,33,2,1
33,332,332,51,21,30,3,2
18,333,333,32,32,0,1,0
21,340,340,10,10,0,1,0
1,359,359,17,3,14,2,1
24,366,366,9,2,7,2,1
15,377,377,13,9,4,2,1
47,399,399,5,5,0,1,0
11,411,411,80,42,38,3,2
2,417,417,108,42,66,4,3
29,436,436,11,11,0,1,0
10,436,436,60,60,0,1,0
36,438,438,58,37,21,2,1
0,444,444,44,44,0,1,0
40,449,449,59,59,0,1,0
8,469,469,22,22,0,1,0
3,485,485,12,12,0,1,0
30,488,488,74,74,0,1,0
34,489,489,11,1,10,2,1
26,489,489,79,68,11,2,1
45,494,494,54,54,0,1,0

38,117,117,2,2,0,1,0
32,131,131,19,12,7,2,1
29,133,133,4,4,0,1,0
26,142,142,4,4,0,1,0
36,158,158,3,3,0,1,0
4,170,170,7,7,0,1,0
9,195,195,81,47,34,4,3
41,202,202,13,6,7,2,1
19,211,211,15,6,9,4,3
23,222,222,2,2,0,1,0
34,241,241,20,20,0,1,0
25,310,310,3,3,0,1,0
0,318,318,5,5,0,1,0
11,327,327,6,6,0,1,0
20,328,328,18,18,0,1,0
13,330,330,9,1,8,3,2
21,341,341,28,28,0,1,0
14,355,355,19,19,0,1,0
8,357,357,5,5,0,1,0
17,360,360,12,5,7,2,1
12,366,366,33,16,17,4,3
40,379,379,71,3,68,3,2
31,380,380,89,61,28,3,2
39,385,385,59,53,6,3,2
28,387,387,94,94,0,1,0
5,389,389,91,29,62,4,3
3,390,390,71,30,41,4,3
30,394,394,22,4,18,3,2
10,401,401,67,7,60,4,3
27,404,404,62,44,18,3,2
2,409,409,4,4,0,1,0
15,419,419,23,2,21,4,3
6,422,422,2,2,0,1,0
7,422,422,39,23,16,2,1
18,435,435,16,1,15,2,1
35,437,437,155,56,99,4,3
24,451,451,27,27,0,1,0
37,453,453,7,1,6,2,1
16,463,463,74,74,0,1,0
22,464,464,18,18,0,1,0
33,481,481,39,24,15,4,3
1,490,490,2,2,0,1,0

25,101,101,10,10,0,1,0
23,102,102,1,1,0,1,0
29,114,114,15,15,0,1,0
3,133,133,4,4,0,1,0
13,140,140,38,20,18,2,1
18,143,143,23,23,0,1,0
27,147,147,1,1,0,1,0
16,214,214,17,17,0,1,0
5,216,216,22,22,0,1,0
28,225,225,15,8,7,2,1
31,241,241,20,10,10,2,1
0,243,243,3,3,0,1,0
17,272,272,13,13,0,1,0
32,275,275,61,31,30,4,3
21,287,287,26,26,0,1,0
26,292,292,21,21,0,1,0
6,295,295,50,35,15,4,3
24,297,297,69,54,15,4,3
8,325,325,15,15,0,1,0
10,328,328,2,2,0,1,0
19,339,339,21,8,13,4,3
4,349,349,38,38,0,1,0
15,353,353,127,10,117,4,3
1,356,356,24,24,0,1,0
11,370,370,16,3,13,2,1
12,377,377,23,13,10,3,2
7,393,393,26,5,21,3,2
22,395,395,137,137,0,1,0
14,423,423,15,12,3,2,1
20,451,451,42,5,37,2,1
33,460,460,32,5,27,2,1
2,472,472,245,245,0,1,0
30,472,472,1,1,0,1,0
9,472,472,1,1,0,1,0
34,500,500,34,34,0,1,0

15,100,100,4,4,0,1,0
16,103,103,27,4,23,2,1
30,133,133,3,3,0,1,0
0,140,140,5,5,0,1,0
24,144,144,1,1,0,1,0
40,158,158,36,17,19,2,1
2,161,161,13,13,0,1,0
5,161,161,7,7,0,1,0
9,168,168,58,42,16,2,1
34,171,171,64,17,47,2,1
27,172,172,12,12,0,1,0
33,176,176,31,31,0,1,0
14,190,190,31,11,20,4,3
4,196,196,14,14,0,1,0
10,214,214,1,1,0,1,0
13,223,223,34,29,5,2,1
18,264,264,1,1,0,1,0
19,265,265,6,6,0,1,0
35,269,269,18,5,13,2,1
21,285,285,26,26,0,1,0
20,287,287,24,24,0,1,0
25,290,290,77,47,30,4,3
6,300,300,34,10,24,4,3
36,308,308,4,4,0,1,0
12,310,310,22,22,0,1,0
38,343,343,11,11,0,1,0
39,362,362,57,57,0,1,0
29,372,372,2,2,0,1,0
23,376,376,53,53,0,1,0
28,381,381,31,18,13,2,1
8,393,393,18,18,0,1,0
22,398,398,11,11,0,1,0
3,410,410,61,61,0,1,0
11,423,423,4,4,0,1,0
31,444,444,18,4,14,2,1
7,449,449,7,7,0,1,0
26,464,464,82,82,0,1,0
17,470,470,28,5,23,4,3
32,475,475,12,12,0,1,0
1,490,490,19,11,8,2,1
37,498,498,16,16,0,1,0

32,113,113,3,3,0,1,0
4,117,117,5,5,0,1,0
28,124,124,14,2,12,4,3
22,133,133,5,5,0,1,0
8,155,155,11,11,0,1,0
31,183,183,76,30,46,3,2
25,189,189,8,2,6,2,1
3,218,218,17,3,14,2,1
9,221,221,6,6,0,1,0
23,225,225,12,6,6,2,1
19,239,239,2,2,0,1,0
5,247,247,53,33,20,2,1
29,251,251,35,16,19,2,1
20,256,256,35,8,27,4,3
13,262,262,11,2,9,4,3
0,264,264,38,38,0,1,0
21,267,267,9,6,3,2,1
12,317,317,2,2,0,1,0
10,318,318,25,25,0,1,0
30,319,319,97,47,50,2,1
11,319,319,17,17,0,1,0
24,325,325,19,19,0,1,0
26,332,332,10,10,0,1,0
14,351,351,60,60,0,1,0
15,355,355,40,40,0,1,0
6,393,393,40,17,23,3,2
33,396,396,102,72,30,2,1
16,407,407,18,4,14,2,1
27,413,413,52,6,46,3,2
1,418,418,1,1,0,1,0
34,437,437,10,7,3,2,1
2,462,462,210,162,48,4,3
18,467,467,3,3,0,1,0
7,471,471,142,142,0,1,0
17,472,472,37,37,0,1,0

32,101,101,2,2,0,1,0
10,141,141,1,1,0,1,0
19,149,149,8,5,3,2,1
13,160,160,9,9,0,1,0
5,175,175,17,17,0,1,0
4,205,205,31,31,0,1,0
0,208,208,49,23,26,3,2
12,210,210,17,8,9,4,3
22,211,211,53,23,30,3,2
24,211,211,18,18,0,1,0
36,213,213,9,9,0,1,0
28,220,220,12,12,0,1,0
9,222,222,5,1,4,2,1
39,236,236,14,7,7,2,1
23,243,243,63,47,16,4,3
30,254,254,5,5,0,1,0
27,257,257,20,3,17,2,1
11,257,257,23,8,15,3,2
35,274,274,8,2,6,2,1
3,295,295,18,4,14,2,1
7,308,308,25,19,6,3,2
1,325,325,10,5,5,2,1
26,326,326,9,9,0,1,0
14,351,351,42,2,40,2,1
37,357,357,132,132,0,1,0
21,358,358,3,3,0,1,0
40,373,373,87,17,70,3,2
2,379,379,74,14,60,3,2
18,380,380,37,8,29,4,3
25,390,390,18,18,0,1,0
33,390,390,53,53,0,1,0
6,400,400,35,2,33,4,3
16,401,401,1,1,0,1,0
38,404,404,7,7,0,1,0
17,411,411,42,6,36,4,3
34,435,435,5,5,0,1,0
15,439,439,46,46,0,1,0
8,440,440,27,10,17,2,1
31,459,459,25,25,0,1,0
29,461,461,64,37,27,4,3
20,497,497,77,77,0,1,0

8,109,109,8,8,0,1,0
35,118,118,4,1,3,2,1
1,126,126,1,1,0,1,0
27,136,136,10,10,0,1,0
22,138,138,9,4,5,2,1
11,139,139,19,12,7,2,1
30,161,161,19,10,9,4,3
9,177,177,24,18,6,3,2
6,181,181,28,19,9,4,3
26,191,191,4,4,0,1,0
16,236,236,66,66,0,1,0
32,237,237,10,3,7,2,1
24,245,245,8,2,6,2,1
29,272,272,11,5,6,3,2
33,283,283,26,2,24,3,2
37,293,293,24,15,9,2,1
36,310,310,200,187,13,2,1
13,315,315,3,3,0,1,0
34,329,329,8,1,7,3,2
2,329,329,37,37,0,1,0
31,333,333,7,7,0,1,0
0,354,354,60,9,51,3,2
5,365,365,54,45,9,2,1
28,371,371,37,37,0,1,0
19,374,374,20,12,8,2,1
4,377,377,95,42,53,3,2
15,394,394,55,55,0,1,0
12,396,396,19,1,18,3,2
10,402,402,17,17,0,1,0
7,405,405,1,1,0,1,0
25,409,409,71,21,50,3,2
20,424,424,85,40,45,4,3
17,430,430,30,13,17,2,1
23,450,450,51,51,0,1,0
14,454,454,4,4,0,1,0
3,463,463,28,28,0,1,0
21,481,481,3,3,0,1,0
18,500,500,25,22,3,2,1

10,104,104,1,1,0,1,0
1,114,114,5,5,0,1,0
5,128,128,19,19,0,1,0
21,129,129,2,2,0,1,0
17,138,138,1,1,0,1,0
28,138,138,41,41,0,1,0
35,138,138,17,17,0,1,0
2,149,149,2,2,0,1,0
8,193,193,4,4,0,1,0
38,215,215,33,4,29,2,1
22,239,239,12,4,8,2,1
33,242,242,28,19,9,2,1
0,243,243,64,24,40,2,1
30,247,247,33,6,27,4,3
26,249,249,36,5,31,2,1
3,272,272,43,10,33,2,1
18,285,285,45,27,18,2,1
36,304,304,18,18,0,1,0
34,313,313,7,7,0,1,0
27,325,325,45,45,0,1,0
20,331,331,18,18,0,1,0
13,337,337,17,4,13,2,1
15,351,351,7,7,0,1,0
11,358,358,55,55,0,1,0
25,379,379,78,26,52,3,2
29,395,395,23,23,0,1,0
23,402,402,3,3,0,1,0
40,410,410,22,22,0,1,0
16,411,411,13,13,0,1,0
32,420,420,49,1,48,4,3
14,421,421,1,1,0,1,0
12,435,435,13,2,11,2,1
31,448,448,10,10,0,1,0
41,460,460,29,9,20,2,1
39,461,461,16,16,0,1,0
19,472,472,163,111,52,3,2
9,472,472,68,46,22,2,1
6,482,482,63,4,59,4,3
7,490,490,6,2,4,2,1
4,493,493,19,19,0,1,0
24,494,494,39,34,5,2,1
37,500,500,49,19,30,4,3

37,102,102,2,2,0,1,0
0,124,124,13,5,8,2,1
39,129,129,68,2,66,3,2
8,142,142,7,7,0,1,0
28,154,154,4,4,0,1,0
21,175,175,1,1,0,1,0
14,178,178,18,18,0,1,0
30,185,185,11,2,9,2,1
31,202,202,10,10,0,1,0
25,203,203,60,60,0,1,0
24,212,212,5,5,0,1,0
4,213,213,3,3,0,1,0
19,229,229,22,3,19,2,1
12,234,234,14,14,0,1,0
33,237,237,17,8,9,2,1
1,246,246,27,15,12,3,2
16,264,264,13,7,6,2,1
35,283,283,11,2,9,3,2
9,285,285,4,4,0,1,0
18,291,291,11,11,0,1,0
38,293,293,26,5,21,2,1
34,293,293,34,34,0,1,0
5,299,299,37,4,33,4,3
26,303,303,1,1,0,1,0
10,304,304,51,17,34,2,1
36,339,339,32,32,0,1,0
23,364,364,41,41,0,1,0
6,369,369,18,12,6,2,1
13,382,382,49,49,0,1,0
15,385,385,1,1,0,1,0
17,404,404,120,120,0,1,0
22,413,413,29,10,19,2,1
2,417,417,42,6,36,3,2
20,418,418,41,41,0,1,0
3,418,418,13,13,0,1,0
27,424,424,18,11,7,2,1
32,426,426,13,4,9,2,1
40,459,459,169,132,37,2,1
42,467,467,20,11,9,2,1
11,471,471,11,11,0,1,0
41,482,482,9,3,6,2,1
29,492,492,9,9,0,1,0
7,500,500,27,3,24,2,1

32,100,100,27,14,13,2,1
1,119,119,1,1,0,1,0
28,133,133,23,11,12,3,2
12,134,134,1,1,0,1,0
21,135,135,6,6,0,1,0
26,145,145,11,5,6,3,2
0,147,147,4,1,3,2,1
31,158,158,1,1,0,1,0
14,160,160,1,1,0,1,0
13,162,162,75,44,31,2,1
5,173,173,57,57,0,1,0
7,203,203,8,8,0,1,0
10,216,216,5,5,0,1,0
36,251,251,15,15,0,1,0
6,278,278,1,1,0,1,0
8,281,281,30,12,18,3,2
22,281,281,70,51,19,2,1
34,302,302,11,11,0,1,0
4,309,309,67,16,51,4,3
37,313,313,44,1,43,2,1
33,345,345,83,83,0,1,0
25,345,345,4,4,0,1,0
18,355,355,15,11,4,2,1
15,360,360,22,9,13,2,1
24,398,398,55,55,0,1,0
23,402,402,60,60,0,1,0
2,407,407,58,58,0,1,0
20,411,411,9,3,6,3,2
30,425,425,18,3,15,4,3
27,436,436,49,18,31,2,1
9,437,437,72,64,8,2,1
3,438,438,81,81,0,1,0
17,462,462,24,14,10,3,2
29,466,466,20,20,0,1,0
35,469,469,31,6,25,2,1
11,471,471,5,5,0,1,0
19,495,495,26,10,16,4,3
16,499,499,6,6,0,1,0

12,129,129,4,4,0,1,0
27,135,135,1,1,0,1,0
39,146,146,5,5,0,1,0
13,146,146,6,6,0,1,0
21,157,157,9,5,4,2,1
6,169,169,2,2,0,1,0
30,170,170,1,1,0,1,0
31,225,225,64,64,0,1,0
38,226,226,8,8,0,1,0
1,236,236,4,4,0,1,0
18,252,252,16,8,8,3,2
7,259,259,1,1,0,1,0
4,262,262,64,40,24,3,2
35,262,262,52,12,40,2,1
22,263,263,41,14,27,4,3
26,266,266,93,9,84,3,2
23,266,266,59,59,0,1,0
20,269,269,1,1,0,1,0
36,281,281,40,40,0,1,0
0,282,282,12,12,0,1,0
10,284,284,1,1,0,1,0
25,295,295,17,3,14,2,1
2,318,318,15,15,0,1,0
15,325,325,92,14,78,3,2
11,360,360,175,105,70,3,2
5,400,400,14,4,10,3,2
17,401,401,36,36,0,1,0
8,404,404,2,2,0,1,0
34,405,405,4,4,0,1,0
24,406,406,19,3,16,3,2
14,407,407,33,33,0,1,0
33,413,413,8,1,7,2,1
29,432,432,91,91,0,1,0
40,447,447,22,1,21,2,1
32,463,463,40,2,38,2,1
9,465,465,16,16,0,1,0
16,473,473,56,56,0,1,0
37,486,486,10,10,0,1,0
28,489,489,5,5,0,1,0
19,494,494,94,40,54,4,3
3,499,499,6,6,0,1,0

27,113,113,1,1,0,1,0
28,114,114,6,6,0,1,0
13,123,123,2,2,0,1,0
34,135,135,15,15,0,1,0
9,137,137,12,12,0,1,0
20,153,153,2,2,0,1,0
37,159,159,72,72,0,1,0
25,162,162,23,5,18,4,3
5,167,167,33,33,0,1,0
15,180,180,25,25,0,1,0
38,182,182,13,1,12,3,2
4,189,189,10,10,0,1,0
3,208,208,5,5,0,1,0
6,219,219,8,8,0,1,0
7,232,232,10,10,0,1,0
0,232,232,25,13,12,2,1
33,239,239,1,1,0,1,0
2,246,246,3,3,0,1,0
10,253,253,39,5,34,2,1
31,256,256,20,2,18,3,2
18,262,262,35,35,0,1,0
26,263,263,3,3,0,1,0
39,280,280,49,45,4,2,1
22,283,283,1,1,0,1,0
16,286,286,40,40,0,1,0
12,291,291,2,2,0,1,0
17,291,291,15,15,0,1,0
36,310,310,20,2,18,3,2
23,318,318,25,25,0,1,0
35,326,326,37,10,27,2,1
1,335,335,70,19,51,4,3
32,336,336,9,9,0,1,0
8,363,363,62,14,48,3,2
14,368,368,42,30,12,4,3
21,369,369,50,50,0,1,0
29,371,371,16,16,0,1,0
11,422,422,11,11,0,1,0
30,470,470,84,64,20,2,1
19,472,472,79,5,74,3,2
24,492,492,100,10,90,3,2

39,101,101,6,6,0,1,0
19,111,111,8,3,5,2,1
37,112,112,6,3,3,2,1
35,131,131,36,20,16,3,2
15,134,134,16,4,12,3,2
23,136,136,23,23,0,1,0
28,156,156,1,1,0,1,0
0,169,169,9,9,0,1,0
7,193,193,13,13,0,1,0
10,193,193,31,31,0,1,0
3,206,206,23,23,0,1,0
8,213,213,4,4,0,1,0
30,213,213,3,3,0,1,0
33,224,224,35,35,0,1,0
13,246,246,6,3,3,2,1
32,252,252,40,40,0,1,0
22,252,252,10,10,0,1,0
4,255,255,70,70,0,1,0
29,257,257,28,28,0,1,0
16,259,259,8,4,4,2,1
11,263,263,25,1,24,4,3
34,285,285,12,12,0,1,0
31,300,300,56,56,0,1,0
18,316,316,32,32,0,1,0
20,318,318,11,4,7,2,1
5,323,323,68,68,0,1,0
17,327,327,22,22,0,1,0
14,330,330,94,94,0,1,0
25,342,342,18,3,15,2,1
21,345,345,116,20,96,3,2
38,346,346,8,8,0,1,0
27,371,371,14,14,0,1,0
36,375,375,42,42,0,1,0
2,381,381,10,10,0,1,0
24,390,390,18,18,0,1,0
26,429,429,24,17,7,2,1
9,471,471,15,5,10,3,2
6,473,473,34,10,24,4,3
1,482,482,21,21,0,1,0
12,497,497,1,1,0,1,0

21,102,102,2,2,0,1,0
15,164,164,1,1,0,1,0
31,173,173,12,12,0,1,0
10,181,181,23,23,0,1,0
11,183,183,6,3,3,2,1
35,184,184,2,2,0,1,0
18,216,216,60,25,35,4,3
17,216,216,10,2,8,3,2
22,240,240,21,5,16,2,1
30,242,242,11,6,5,2,1
16,277,277,42,1,41,2,1
29,279,279,16,16,0,1,0
23,307,307,78,35,43,4,3
19,328,328,53,53,0,1,0
20,329,329,31,31,0,1,0
6,333,333,16,6,10,2,1
34,344,344,85,85,0,1,0
3,353,353,88,55,33,4,3
7,355,355,26,26,0,1,0
28,366,366,1,1,0,1,0
26,370,370,54,3,51,4,3
12,396,396,70,70,0,1,0
32,400,400,7,1,6,2,1
5,418,418,21,13,8,3,2
27,429,429,2,2,0,1,0
9,430,430,63,46,17,2,1
8,437,437,17,6,11,2,1
0,446,446,99,9,90,3,2
4,452,452,133,105,28,3,2
33,454,454,95,17,78,3,2
13,464,464,26,26,0,1,0
14,467,467,101,89,12,4,3
24,470,470,22,22,0,1,0
25,480,480,65,65,0,1,0
1,494,494,1,1,0,1,0
2,494,494,6,6,0,1,0

17,100,100,13,13,0,1,0
14,103,103,7,7,0,1,0
22,117,117,45,6,39,2,1
23,144,144,25,25,0,1,0
3,200,200,5,5,0,1,0
24,209,209,1,1,0,1,0
6,224,224,7,3,4,2,1
28,230,230,82,32,50,3,2
5,232,232,41,36,5,2,1
21,241,241,8,2,6,3,2
11,242,242,34,4,30,2,1
0,267,267,39,39,0,1,0
4,275,275,61,52,9,4,3
1,277,277,46,28,18,3,2
2,292,292,1,1,0,1,0
25,324,324,11,11,0,1,0
12,335,335,57,41,16,3,2
9,349,349,134,77,57,4,3
30,382,382,22,22,0,1,0
31,391,391,55,55,0,1,0
20,391,391,12,12,0,1,0
8,392,392,7,3,4,2,1
10,393,393,3,3,0,1,0
15,394,394,2,2,0,1,0
19,407,407,54,10,44,3,2
13,420,420,9,9,0,1,0
16,426,426,10,5,5,2,1
7,436,436,179,119,60,3,2
18,475,475,11,8,3,2,1
29,476,476,65,9,56,3,2
26,481,481,8,8,0,1,0
27,498,498,84,84,0,1,0

9,129,129,4,1,3,2,1
0,130,130,1,1,0,1,0
27,136,136,22,22,0,1,0
17,158,158,31,13,18,2,1
37,159,159,4,1,3,2,1
4,175,175,17,17,0,1,0
25,175,175,29,9,20,2,1
2,213,213,7,1,6,3,2
24,215,215,21,7,14,2,1
32,219,219,43,43,0,1,0
36,236,236,9,9,0,1,0
18,276,276,13,13,0,1,0
28,289,289,1,1,0,1,0
6,289,289,27,27,0,1,0
30,301,301,45,6,39,4,3
34,312,312,1,1,0,1,0
29,320,320,2,2,0,1,0
21,332,332,6,6,0,1,0
33,338,338,111,29,82,3,2
31,348,348,1,1,0,1,0
5,352,352,11,2,9,2,1
12,353,353,25,15,10,2,1
39,355,355,57,57,0,1,0
7,371,371,50,50,0,1,0
15,376,376,36,36,0,1,0
20,383,383,29,8,21,2,1
35,389,389,33,33,0,1,0
11,406,406,83,45,38,2,1
38,411,411,101,19,82,4,3
19,412,412,18,9,9,2,1
8,430,430,12,12,0,1,0
1,430,430,26,26,0,1,0
23,432,432,50,32,18,2,1
10,435,435,87,87,0,1,0
13,437,437,113,23,90,3,2
3,440,440,20,20,0,1,0
22,446,446,24,24,0,1,0
16,462,462,51,18,33,2,1
14,467,467,17,1,16,2,1
26,472,472,41,2,39,4,3

6,111,111,13,13,0,1,0
32,126,126,9,9,0,1,0
26,128,128,11,11,0,1,0
11,135,135,35,35,0,1,0
33,156,156,1,1,0,1,0
23,162,162,21,21,0,1,0
4,170,170,49,49,0,1,0
0,176,176,24,15,9,3,2
12,178,178,13,1,12,2,1
10,179,179,1,1,0,1,0
2,181,181,24,24,0,1,0
15,196,196,25,20,5,2,1
3,236,236,27,27,0,1,0
17,237,237,17,17,0,1,0
22,255,255,7,1,6,3,2
30,257,257,15,15,0,1,0
9,264,264,54,28,26,2,1
16,287,287,7,7,0,1,0
18,293,293,7,7,0,1,0
24,307,307,67,67,0,1,0
20,331,331,23,23,0,1,0
5,332,332,64,64,0,1,0
21,353,353,5,5,0,1,0
29,356,356,34,34,0,1,0
31,367,367,72,72,0,1,0
27,368,368,58,58,0,1,0
1,392,392,15,4,11,2,1
14,395,395,42,42,0,1,0
19,404,404,107,24,83,4,3
13,413,413,36,1,35,3,2
25,421,421,100,78,22,3,2
7,422,422,32,14,18,3,2
8,446,446,31,6,25,2,1
28,454,454,27,27,0,1,0

17,101,101,1,1,0,1,0
0,102,102,4,4,0,1,0
30,103,103,4,4,0,1,0
2,118,118,4,4,0,1,0
33,129,129,11,3,8,3,2
22,131,131,9,6,3,2,1
39,135,135,16,4,12,3,2
21,164,164,8,8,0,1,0
8,165,165,25,22,3,2,1
4,195,195,28,28,0,1,0
23,197,197,6,3,3,2,1
18,204,204,4,4,0,1,0
10,214,214,1,1,0,1,0
28,214,214,21,3,18,4,3
12,215,215,20,20,0,1,0
31,221,221,5,5,0,1,0
19,253,253,53,53,0,1,0
3,265,265,2,2,0,1,0
36,274,274,54,33,21,4,3
29,297,297,18,18,0,1,0
26,306,306,111,111,0,1,0
6,321,321,7,7,0,1,0
35,322,322,14,14,0,1,0
13,327,327,16,7,9,4,3
37,334,334,85,85,0,1,0
1,354,354,1,1,0,1,0
27,354,354,25,25,0,1,0
32,355,355,15,12,3,2,1
15,365,365,153,153,0,1,0
7,370,370,56,36,20,2,1
16,385,385,7,7,0,1,0
11,401,401,42,42,0,1,0
25,444,444,4,4,0,1,0
34,449,449,36,8,28,3,2
9,450,450,79,52,27,4,3
38,452,452,117,21,96,4,3
5,456,456,7,7,0,1,0
20,461,461,41,30,11,2,1
14,462,462,65,13,52,4,3
24,464,464,22,4,18,3,2

25,100,100,8,8,0,1,0
20,117,117,6,3,3,2,1
7,150,150,4,4,0,1,0
5,161,161,1,1,0,1,0
24,170,170,5,5,0,1,0
22,171,171,31,13,18,3,2
0,176,176,115,42,73,3,2
21,177,177,19,11,8,3,2
14,201,201,28,28,0,1,0
4,202,202,24,24,0,1,0
18,205,205,20,20,0,1,0
11,205,205,2,2,0,1,0
19,211,211,22,22,0,1,0
8,224,224,7,1,6,2,1
33,231,231,29,29,0,1,0
6,234,234,19,3,16,3,2
10,243,243,11,11,0,1,0
40,249,249,68,48,20,4,3
1,258,258,17,17,0,1,0
36,265,265,80,12,68,3,2
38,271,271,49,49,0,1,0
27,290,290,14,5,9,4,3
23,328,328,8,8,0,1,0
16,344,344,37,37,0,1,0
13,348,348,1,1,0,1,0
26,349,349,25,25,0,1,0
32,351,351,45,38,7,2,1
30,354,354,5,5,0,1,0
34,368,368,21,3,18,4,3
28,384,384,10,10,0,1,0
2,385,385,20,4,16,3,2
31,401,401,38,5,33,2,1
39,420,420,18,18,0,1,0
37,430,430,28,13,15,4,3
12,445,445,17,3,14,3,2
35,448,448,82,65,17,3,2
17,462,462,31,31,0,1,0
3,465,465,38,6,32,2,1
9,476,476,4,4,0,1,0
15,486,486,4,4,0,1,0
29,492,492,6,2,4,2,1

32,112,112,1,1,0,1,0
20,126,126,4,4,0,1,0
29,128,128,22,22,0,1,0
28,130,130,14,5,9,4,3
23,143,143,17,17,0,1,0
6,145,145,19,7,12,4,3
22,147,147,21,21,0,1,0
9,151,151,40,35,5,2,1
27,215,215,31,31,0,1,0
37,222,222,2,2,0,1,0
16,223,223,3,3,0,1,0
10,225,225,40,33,7,2,1
19,226,226,16,16,0,1,0
15,228,228,26,26,0,1,0
0,241,241,34,34,0,1,0
33,258,258,4,1,3,2,1
8,262,262,9,3,6,2,1
21,270,270,26,7,19,4,3
13,306,306,1,1,0,1,0
18,316,316,14,1,13,2,1
26,322,322,74,29,45,4,3
34,322,322,11,11,0,1,0
7,332,332,51,51,0,1,0
14,334,334,16,2,14,3,2
36,351,351,54,54,0,1,0
38,353,353,9,9,0,1,0
1,355,355,17,17,0,1,0
2,363,363,9,9,0,1,0
4,365,365,78,50,28,2,1
3,383,383,24,24,0,1,0
17,395,395,42,42,0,1,0
11,418,418,35,18,17,2,1
12,430,430,45,45,0,1,0
25,439,439,86,8,78,4,3
24,453,453,16,1,15,4,3
5,467,467,29,8,21,4,3
35,475,475,30,30,0,1,0
31,487,487,122,98,24,2,1
30,494,494,54,14,40,3,2

12,128,128,1,1,0,1,0
31,147,147,1,1,0,1,0
5,163,163,61,8,53,3,2
28,179,179,4,1,3,2,1
9,182,182,5,5,0,1,0
2,189,189,10,2,8,3,2
29,202,202,26,26,0,1,0
7,207,207,5,2,3,2,1
6,210,210,3,3,0,1,0
24,213,213,14,14,0,1,0
19,222,222,15,15,0,1,0
17,229,229,16,16,0,1,0
23,259,259,62,62,0,1,0
30,265,265,34,34,0,1,0
20,269,269,4,1,3,2,1
13,273,273,46,46,0,1,0
37,283,283,53,53,0,1,0
26,285,285,69,31,38,2,1
36,296,296,28,28,0,1,0
34,302,302,72,2,70,4,3
35,318,318,4,4,0,1,0
8,320,320,15,3,12,2,1
11,332,332,51,51,0,1,0
32,335,335,6,6,0,1,0
22,348,348,24,24,0,1,0
27,353,353,27,24,3,2,1
16,355,355,34,20,14,3,2
38,359,359,64,64,0,1,0
1,378,378,36,17,19,3,2
0,385,385,15,15,0,1,0
15,401,401,60,20,40,2,1
10,402,402,72,28,44,3,2
3,403,403,75,75,0,1,0
14,407,407,1,1,0,1,0
21,426,426,23,23,0,1,0
33,451,451,2,2,0,1,0
25,461,461,72,72,0,1,0
4,465,465,16,1,15,4,3
18,500,500,56,56,0,1,0

22,100,100,1,1,0,1,0
2,101,101,5,5,0,1,0
25,103,103,19,10,9,2,1
14,106,106,2,2,0,1,0
27,117,117,1,1,0,1,0
33,125,125,3,3,0,1,0
10,140,140,52,52,0,1,0
26,140,140,24,5,19,2,1
32,141,141,27,7,20,2,1
28,159,159,14,2,12,3,2
38,201,201,14,11,3,2,1
30,205,205,20,8,12,4,3
15,235,235,12,1,11,2,1
13,239,239,14,14,0,1,0
1,241,241,2,2,0,1,0
23,276,276,11,11,0,1,0
17,292,292,41,19,22,3,2
16,301,301,115,61,54,3,2
0,305,305,32,20,12,4,3
20,315,315,97,97,0,1,0
24,331,331,44,17,27,4,3
19,362,362,2,2,0,1,0
35,362,362,93,93,0,1,0
37,373,373,27,4,23,2,1
21,393,393,26,23,3,2,1
29,394,394,25,25,0,1,0
8,430,430,4,4,0,1,0
31,430,430,27,1,26,2,1
4,434,434,5,5,0,1,0
5,452,452,46,46,0,1,0
9,459,459,33,33,0,1,0
11,465,465,11,11,0,1,0
12,471,471,105,105,0,1,0
3,477,477,32,24,8,3,2
6,477,477,26,26,0,1,0
36,479,479,46,12,34,2,1
34,484,484,5,5,0,1,0
7,492,492,62,62,0,1,0
18,494,494,11,3,8,3,2

7,106,106,2,2,0,1,0
10,109,109,4,4,0,1,0
2,111,111,28,10,18,3,2
17,135,135,1,1,0,1,0
34,140,140,22,5,17,2,1
0,153,153,7,1,6,2,1
33,164,164,16,16,0,1,0
20,165,165,3,3,0,1,0
15,170,170,14,14,0,1,0
11,171,171,44,44,0,1,0
22,175,175,6,6,0,1,0
30,188,188,15,15,0,1,0
28,192,192,7,7,0,1,0
25,208,208,35,26,9,2,1
32,239,239,5,5,0,1,0
9,246,246,17,17,0,1,0
16,267,267,21,13,8,2,1
19,269,269,54,54,0,1,0
14,272,272,10,3,7,2,1
21,301,301,36,26,10,2,1
31,307,307,3,3,0,1,0
18,336,336,187,187,0,1,0
27,345,345,17,17,0,1,0
1,366,366,54,42,12,3,2
13,368,368,17,17,0,1,0
26,390,390,43,35,8,3,2
12,404,404,53,11,42,4,3
4,406,406,95,60,35,2,1
23,412,412,34,28,6,2,1
5,467,467,5,1,4,2,1
24,470,470,21,11,10,3,2
8,477,477,158,108,50,2,1
3,481,481,62,62,0,1,0
29,493,493,35,35,0,1,0
6,499,499,37,5,32,2,1

20,115,115,1,1,0,1,0
22,131,131,7,1,6,2,1
27,152,152,1,1,0,1,0
39,158,158,27,27,0,1,0
31,180,180,26,26,0,1,0
35,187,187,38,38,0,1,0
16,188,188,28,28,0,1,0
33,196,196,6,1,5,2,1
42,211,211,1,1,0,1,0
15,217,217,7,7,0,1,0
24,221,221,11,2,9,2,1
21,222,222,1,1,0,1,0
40,228,228,17,5,12,3,2
2,233,233,85,85,0,1,0
43,234,234,24,24,0,1,0
23,239,239,4,4,0,1,0
38,241,241,2,2,0,1,0
28,246,246,2,2,0,1,0
13,273,273,4,4,0,1,0
17,276,276,62,24,38,4,3
32,276,276,4,4,0,1,0
26,314,314,55,55,0,1,0
29,314,314,7,7,0,1,0
7,315,315,36,19,17,2,1
5,332,332,22,22,0,1,0
1,333,333,39,39,0,1,0
19,338,338,70,70,0,1,0
14,340,340,7,7,0,1,0
18,355,355,8,8,0,1,0
3,360,360,14,8,6,3,2
37,393,393,33,33,0,1,0
6,401,401,7,7,0,1,0
30,438,438,81,81,0,1,0
34,440,440,44,44,0,1,0
10,442,442,29,29,0,1,0
8,443,443,39,39,0,1,0
25,465,465,160,145,15,4,3
36,468,468,3,3,0,1,0
4,471,471,24,24,0,1,0
11,475,475,27,14,13,2,1
0,476,476,13,9,4,2,1
41,494,494,130,130,0,1,0
9,494,494,38,21,17,4,3
12,497,497,7,7,0,1,0

26,118,118,33,33,0,1,0
1,124,124,2,2,0,1,0
6,130,130,4,4,0,1,0
37,192,192,10,10,0,1,0
39,206,206,11,4,7,2,1
5,230,230,25,14,11,2,1
31,234,234,1,1,0,1,0
41,235,235,4,4,0,1,0
25,244,244,15,15,0,1,0
23,246,246,10,10,0,1,0
7,249,249,14,14,0,1,0
17,257,257,40,40,0,1,0
40,258,258,32,20,12,2,1
8,261,261,3,3,0,1,0
35,267,267,22,22,0,1,0
3,272,272,70,12,58,3,2
11,283,283,8,8,0,1,0
14,283,283,1,1,0,1,0
2,288,288,5,5,0,1,0
18,302,302,8,5,3,2,1
10,304,304,47,31,16,3,2
13,306,306,6,6,0,1,0
15,309,309,13,13,0,1,0
0,314,314,11,6,5,2,1
32,316,316,11,5,6,2,1
20,319,319,20,11,9,2,1
36,319,319,13,13,0,1,0
21,322,322,6,6,0,1,0
4,341,341,4,4,0,1,0
34,354,354,29,29,0,1,0
22,365,365,187,187,0,1,0
28,374,374,33,33,0,1,0
29,387,387,10,4,6,3,2
9,398,398,1,1,0,1,0
24,419,419,240,204,36,3,2
30,430,430,39,39,0,1,0
38,453,453,39,36,3,2,1
33,462,462,82,40,42,3,2
16,477,477,59,7,52,3,2
27,483,483,9,1,8,3,2
19,484,484,5,5,0,1,0
12,492,492,96,42,54,4,3

1,112,112,39,12,27,2,1
7,118,118,1,1,0,1,0
10,136,136,30,30,0,1,0
38,138,138,2,2,0,1,0
43,160,160,16,16,0,1,0
24,165,165,2,2,0,1,0
12,174,174,4,4,0,1,0
29,183,183,4,4,0,1,0
18,187,187,18,3,15,2,1
4,192,192,5,5,0,1,0
36,194,194,5,5,0,1,0
27,210,210,18,5,13,3,2
31,212,212,10,10,0,1,0
35,214,214,19,14,5,2,1
22,222,222,2,2,0,1,0
37,227,227,61,29,32,3,2
25,232,232,13,5,8,2,1
0,239,239,30,30,0,1,0
6,256,256,49,49,0,1,0
19,257,257,21,21,0,1,0
17,301,301,18,18,0,1,0
26,303,303,85,37,48,4,3
13,310,310,3,3,0,1,0
39,323,323,36,26,10,3,2
8,323,323,8,8,0,1,0
30,332,332,83,17,66,3,2
9,336,336,19,16,3,2,1
32,344,344,30,30,0,1,0
23,355,355,4,4,0,1,0
42,360,360,54,48,6,2,1
28,360,360,39,30,9,2,1
5,364,364,56,19,37,2,1
34,375,375,27,27,0,1,0
21,376,376,3,3,0,1,0
3,380,380,1,1,0,1,0
2,392,392,46,46,0,1,0
41,399,399,43,43,0,1,0
11,400,400,35,21,14,3,2
15,405,405,1,1,0,1,0
44,412,412,27,27,0,1,0
14,418,418,10,1,9,2,1
16,440,440,49,43,6,2,1
40,479,479,15,6,9,2,1
33,487,487,10,10,0,1,0
20,495,495,18,4,14,3,2

2,103,103,7,7,0,1,0
19,103,103,14,3,11,2,1
6,113,113,7,7,0,1,0
31,118,118,3,3,0,1,0
15,141,141,6,3,3,2,1
36,141,141,1,1,0,1,0
7,148,148,6,6,0,1,0
21,156,156,1,1,0,1,0
0,157,157,27,27,0,1,0
41,161,161,16,16,0,1,0
34,162,162,56,56,0,1,0
33,162,162,1,1,0,1,0
8,183,183,5,5,0,1,0
14,185,185,4,4,0,1,0
35,189,189,12,12,0,1,0
22,207,207,23,13,10,2,1
40,209,209,14,5,9,4,3
10,213,213,8,1,7,2,1
28,245,245,10,10,0,1,0
26,263,263,2,2,0,1,0
37,277,277,44,19,25,3,2
27,292,292,55,55,0,1,0
18,298,298,38,38,0,1,0
44,299,299,12,12,0,1,0
9,303,303,4,4,0,1,0
45,304,304,48,45,3,2,1
39,317,317,22,16,6,3,2
24,322,322,30,30,0,1,0
16,330,330,8,8,0,1,0
38,334,334,23,7,16,2,1
29,340,340,1,1,0,1,0
4,345,345,39,39,0,1,0
17,349,349,15,7,8,3,2
30,350,350,10,10,0,1,0
13,388,388,17,17,0,1,0
20,428,428,55,32,23,2,1
23,434,434,39,39,0,1,0
42,434,434,124,26,98,4,3
46,448,448,121,103,18,3,2
11,453,453,4,4,0,1,0
43,466,466,9,9,0,1,0
1,468,468,16,4,12,2,1
25,470,470,16,16,0,1,0
3,472,472,13,13,0,1,0
47,473,473,1,1,0,1,0
5,478,478,71,71,0,1,0
32,486,486,108,2,106,4,3
12,496,496,5,1,4,2,1

29,115,115,1,1,0,1,0
14,126,126,7,7,0,1,0
8,147,147,7,7,0,1,0
9,180,180,5,5,0,1,0
31,180,180,15,15,0,1,0
23,182,182,57,57,0,1,0
15,200,200,30,30,0,1,0
19,218,218,3,3,0,1,0
4,271,271,21,21,0,1,0
7,274,274,50,32,18,4,3
11,284,284,11,5,6,3,2
6,289,289,37,37,0,1,0
21,298,298,3,3,0,1,0
17,312,312,9,5,4,2,1
22,312,312,10,10,0,1,0
16,324,324,44,44,0,1,0
26,326,326,14,4,10,2,1
18,332,332,11,2,9,4,3
0,337,337,20,20,0,1,0
33,348,348,42,42,0,1,0
13,353,353,61,61,0,1,0
5,359,359,5,5,0,1,0
12,383,383,128,92,36,4,3
3,389,389,76,6,70,3,2
25,406,406,41,41,0,1,0
27,409,409,7,7,0,1,0
28,435,435,293,239,54,4,3
32,450,450,19,4,15,2,1
24,460,460,23,12,11,2,1
1,468,468,86,55,31,2,1
20,478,478,21,21,0,1,0
2,482,482,110,110,0,1,0
10,486,486,77,14,63,4,3
30,489,489,21,17,4,2,1

18,158,158,35,35,0,1,0
25,158,158,27,27,0,1,0
0,173,173,31,15,16,2,1
35,175,175,1,1,0,1,0
9,182,182,7,4,3,2,1
14,189,189,56,56,0,1,0
2,197,197,26,26,0,1,0
19,200,200,17,2,15,4,3
20,211,211,44,10,34,3,2
3,211,211,15,15,0,1,0
36,215,215,24,24,0,1,0
11,218,218,4,4,0,1,0
30,225,225,2,2,0,1,0
27,231,231,3,3,0,1,0
16,237,237,7,1,6,3,2
4,245,245,30,30,0,1,0
34,245,245,45,19,26,2,1
17,268,268,85,7,78,3,2
23,285,285,31,11,20,3,2
8,286,286,3,3,0,1,0
13,288,288,18,18,0,1,0
24,294,294,3,3,0,1,0
15,320,320,32,11,21,2,1
33,325,325,22,1,21,2,1
10,327,327,65,26,39,4,3
6,342,342,46,46,0,1,0
22,352,352,26,5,21,2,1
7,355,355,9,2,7,2,1
29,369,369,2,2,0,1,0
32,406,406,1,1,0,1,0
31,414,414,104,86,18,3,2
12,430,430,4,4,0,1,0
28,434,434,98,68,30,3,2
5,436,436,62,18,44,2,1
1,450,450,6,6,0,1,0
26,452,452,62,62,0,1,0
21,461,461,15,2,13,4,3

17,113,113,5,5,0,1,0
39,114,114,5,5,0,1,0
19,118,118,1,1,0,1,0
4,133,133,2,2,0,1,0
29,134,134,1,1,0,1,0
21,136,136,3,3,0,1,0
20,149,149,1,1,0,1,0
30,151,151,9,4,5,2,1
27,156,156,8,8,0,1,0
33,167,167,9,6,3,2,1
9,182,182,4,4,0,1,0
18,184,184,1,1,0,1,0
1,189,189,1,1,0,1,0
43,199,199,36,36,0,1,0
13,230,230,5,5,0,1,0
3,239,239,7,7,0,1,0
31,239,239,27,27,0,1,0
38,243,243,5,5,0,1,0
36,254,254,3,3,0,1,0
47,254,254,84,84,0,1,0
10,266,266,14,4,10,3,2
35,268,268,12,12,0,1,0
34,268,268,11,11,0,1,0
32,271,271,47,47,0,1,0
37,274,274,10,10,0,1,0
26,278,278,22,4,18,2,1
22,283,283,9,9,0,1,0
23,300,300,6,1,5,2,1
50,301,301,28,16,12,2,1
40,305,305,4,4,0,1,0
2,312,312,44,26,18,4,3
12,321,321,11,11,0,1,0
11,327,327,5,5,0,1,0
48,333,333,65,11,54,3,2
42,352,352,48,48,0,1,0
5,353,353,138,138,0,1,0
24,359,359,32,16,16,2,1
44,376,376,28,28,0,1,0
41,381,381,19,19,0,1,0
6,391,391,78,78,0,1,0
46,394,394,38,38,0,1,0
15,402,402,11,6,5,2,1
45,413,413,18,12,6,3,2
14,415,415,14,8,6,3,2
25,418,418,56,33,23,2,1
28,420,420,8,2,6,3,2
7,437,437,31,31,0,1,0
16,459,459,27,27,0,1,0
8,475,475,15,15,0,1,0
49,480,480,143,47,96,4,3
0,494,494,30,14,16,3,2

21,119,119,10,4,6,3,2
29,119,119,10,1,9,4,3
28,124,124,21,21,0,1,0
2,142,142,17,1,16,3,2
23,142,142,29,7,22,2,1
13,149,149,28,25,3,2,1
24,156,156,21,21,0,1,0
18,164,164,10,10,0,1,0
5,165,165,31,31,0,1,0
27,174,174,16,16,0,1,0
31,178,178,24,8,16,2,1
3,190,190,92,92,0,1,0
34,200,200,51,17,34,3,2
20,202,202,5,5,0,1,0
30,223,223,10,1,9,4,3
0,236,236,1,1,0,1,0
22,256,256,8,3,5,2,1
11,257,257,37,37,0,1,0
12,270,270,21,21,0,1,0
9,322,322,24,24,0,1,0
33,331,331,80,80,0,1,0
16,336,336,46,46,0,1,0
32,361,361,9,9,0,1,0
14,365,365,12,12,0,1,0
6,365,365,28,20,8,2,1
25,407,407,32,32,0,1,0
19,414,414,30,3,27,4,3
15,434,434,12,12,0,1,0
4,459,459,43,43,0,1,0
8,464,464,143,83,60,4,3
7,465,465,3,3,0,1,0
17,471,471,15,6,9,2,1
26,472,472,21,3,18,3,2
10,475,475,7,7,0,1,0
1,495,495,30,2,28,2,1

21,120,120,3,3,0,1,0
22,144,144,18,18,0,1,0
2,171,171,28,28,0,1,0
12,187,187,1,1,0,1,0
10,191,191,1,1,0,1,0
7,198,198,1,1,0,1,0
29,214,214,5,1,4,2,1
0,222,222,15,15,0,1,0
28,231,231,48,48,0,1,0
19,250,250,13,4,9,3,2
32,251,251,4,1,3,2,1
30,284,284,14,3,11,2,1
25,295,295,8,8,0,1,0
35,299,299,67,6,61,3,2
1,303,303,27,15,12,4,3
14,309,309,1,1,0,1,0
24,326,326,1,1,0,1,0
6,352,352,1,1,0,1,0
13,352,352,173,173,0,1,0
36,367,367,20,6,14,3,2
18,372,372,9,3,6,3,2
11,377,377,66,16,50,2,1
5,379,379,7,3,4,2,1
31,380,380,62,28,34,2,1
34,395,395,53,27,26,2,1
27,409,409,141,105,36,4,3
16,413,413,27,27,0,1,0
15,419,419,19,4,15,4,3
17,427,427,7,3,4,2,1
20,434,434,6,2,4,2,1
9,437,437,180,94,86,3,2
23,447,447,144,112,32,2,1
4,449,449,29,29,0,1,0
3,462,462,54,54,0,1,0
26,486,486,57,41,16,3,2
33,488,488,4,4,0,1,0
8,490,490,75,15,60,4,3

15,116,116,17,17,0,1,0
12,130,130,2,2,0,1,0
8,132,132,10,5,5,2,1
3,142,142,1,1,0,1,0
1,145,145,27,21,6,2,1
11,167,167,1,1,0,1,0
37,172,172,2,2,0,1,0
30,180,180,5,2,3,2,1
31,198,198,42,6,36,4,3
23,212,212,29,5,24,2,1
33,222,222,2,2,0,1,0
21,223,223,29,29,0,1,0
26,225,225,38,38,0,1,0
18,234,234,12,2,10,3,2
40,252,252,30,18,12,4,3
17,253,253,43,8,35,2,1
38,256,256,19,11,8,2,1
5,281,281,15,15,0,1,0
13,297,297,71,20,51,4,3
22,314,314,45,18,27,4,3
29,323,323,7,4,3,2,1
16,324,324,24,24,0,1,0
25,329,329,44,32,12,4,3
39,342,342,8,2,6,2,1
6,347,347,5,5,0,1,0
14,367,367,37,28,9,2,1
0,383,383,42,42,0,1,0
7,384,384,1,1,0,1,0
28,392,392,73,29,44,4,3
9,400,400,49,49,0,1,0
34,422,422,207,152,55,4,3
35,424,424,35,11,24,2,1
19,425,425,26,26,0,1,0
36,433,433,12,12,0,1,0
27,448,448,20,20,0,1,0
32,461,461,1,1,0,1,0
24,462,462,8,2,6,3,2
2,465,465,46,46,0,1,0
4,481,481,55,50,5,2,1
20,487,487,21,21,0,1,0
10,490,490,39,39,0,1,0

9,100,100,6,3,3,2,1
32,101,101,1,1,0,1,0
2,102,102,9,9,0,1,0
39,116,116,1,1,0,1,0
21,124,124,2,2,0,1,0
4,124,124,19,10,9,2,1
26,126,126,11,3,8,3,2
5,130,130,6,6,0,1,0
19,132,132,16,16,0,1,0
37,151,151,9,1,8,2,1
10,172,172,21,3,18,2,1
41,175,175,10,2,8,3,2
12,191,191,20,8,12,2,1
35,198,198,5,5,0,1,0
24,201,201,1,1,0,1,0
17,202,202,5,5,0,1,0
7,227,227,31,31,0,1,0
36,252,252,4,4,0,1,0
15,259,259,10,10,0,1,0
38,267,267,60,9,51,4,3
31,271,271,28,28,0,1,0
14,297,297,8,2,6,2,1
0,297,297,11,11,0,1,0
11,302,302,5,5,0,1,0
30,302,302,95,95,0,1,0
23,309,309,10,6,4,2,1
18,314,314,66,39,27,4,3
13,318,318,7,7,0,1,0
8,318,318,40,22,18,3,2
20,329,329,6,6,0,1,0
42,329,329,11,1,10,2,1
28,348,348,30,30,0,1,0
27,350,350,165,97,68,4,3
25,358,358,8,3,5,2,1
29,370,370,7,7,0,1,0
6,377,377,42,16,26,3,2
22,384,384,25,20,5,2,1
3,400,400,53,53,0,1,0
43,435,435,21,21,0,1,0
34,440,440,49,49,0,1,0
16,441,441,22,8,14,3,2
33,459,459,43,43,0,1,0
40,469,469,71,65,6,2,1
44,483,483,12,5,7,2,1
1,492,492,56,24,32,2,1

40,101,101,11,5,6,3,2
19,102,102,21,21,0,1,0
3,110,110,34,34,0,1,0
0,114,114,1,1,0,1,0
5,117,117,4,4,0,1,0
38,131,131,9,9,0,1,0
26,134,134,37,6,31,4,3
14,143,143,1,1,0,1,0
33,143,143,6,1,5,2,1
37,158,158,16,16,0,1,0
28,158,158,8,8,0,1,0
16,163,163,30,25,5,2,1
6,164,164,13,13,0,1,0
11,196,196,7,2,5,2,1
7,211,211,34,7,27,4,3
20,213,213,31,21,10,3,2
34,222,222,32,28,4,2,1
21,244,244,21,21,0,1,0
22,252,252,46,24,22,2,1
23,252,252,7,3,4,2,1
10,263,263,30,8,22,3,2
4,265,265,15,1,14,2,1
30,277,277,3,3,0,1,0
29,279,279,9,3,6,3,2
24,291,291,5,5,0,1,0
9,301,301,31,5,26,2,1
15,309,309,32,32,0,1,0
25,339,339,25,7,18,2,1
8,358,358,15,15,0,1,0
27,372,372,24,24,0,1,0
2,372,372,5,2,3,2,1
13,380,380,56,8,48,2,1
36,385,385,63,56,7,2,1
18,396,396,5,1,4,2,1
31,405,405,50,50,0,1,0
39,421,421,53,53,0,1,0
12,425,425,7,2,5,2,1
1,450,450,5,1,4,2,1
35,461,461,11,11,0,1,0
32,491,491,151,121,30,4,3
17,500,500,13,13,0,1,0

13,110,110,3,3,0,1,0
8,112,112,5,5,0,1,0
0,123,123,2,2,0,1,0
29,133,133,24,3,21,4,3
12,140,140,5,5,0,1,0
7,143,143,19,11,8,2,1
19,148,148,20,20,0,1,0
28,148,148,31,31,0,1,0
35,150,150,7,4,3,2,1
31,152,152,17,17,0,1,0
1,181,181,11,6,5,2,1
11,188,188,70,70,0,1,0
26,208,208,13,4,9,2,1
21,224,224,19,19,0,1,0
39,268,268,6,6,0,1,0
17,290,290,22,2,20,2,1
32,296,296,35,35,0,1,0
10,308,308,12,6,6,2,1
34,328,328,30,21,9,4,3
18,330,330,34,2,32,3,2
33,341,341,4,1,3,2,1
14,342,342,17,7,10,2,1
38,370,370,30,30,0,1,0
23,370,370,11,2,9,3,2
3,370,370,20,2,18,2,1
5,374,374,12,12,0,1,0
41,382,382,43,27,16,3,2
22,382,382,10,2,8,3,2
15,389,389,53,53,0,1,0
36,401,401,68,45,23,2,1
6,407,407,41,41,0,1,0
16,411,411,8,8,0,1,0
4,415,415,68,60,8,2,1
40,419,419,109,109,0,1,0
20,429,429,64,60,4,2,1
2,435,435,15,15,0,1,0
25,439,439,71,35,36,4,3
27,448,448,17,17,0,1,0
9,461,461,3,3,0,1,0
30,469,469,100,76,24,3,2
37,478,478,3,3,0,1,0
24,483,483,3,3,0,1,0

20,103,103,30,30,0,1,0
17,114,114,7,7,0,1,0
35,115,115,2,2,0,1,0
37,122,122,30,11,19,3,2
9,124,124,6,6,0,1,0
10,125,125,8,8,0,1,0
23,139,139,21,21,0,1,0
2,160,160,1,1,0,1,0
11,170,170,8,3,5,2,1
19,173,173,9,9,0,1,0
18,189,189,9,9,0,1,0
28,205,205,13,13,0,1,0
16,213,213,44,39,5,2,1
24,224,224,9,9,0,1,0
34,231,231,8,2,6,3,2
29,255,255,41,41,0,1,0
31,256,256,2,2,0,1,0
13,286,286,1,1,0,1,0
25,295,295,39,36,3,2,1
15,297,297,56,34,22,2,1
8,299,299,16,7,9,4,3
39,315,315,43,5,38,3,2
33,319,319,8,8,0,1,0
0,336,336,4,4,0,1,0
36,342,342,56,56,0,1,0
4,353,353,1,1,0,1,0
22,354,354,38,2,36,4,3
38,362,362,10,10,0,1,0
26,363,363,87,87,0,1,0
27,366,366,9,9,0,1,0
21,388,388,45,41,4,2,1
32,416,416,15,15,0,1,0
30,422,422,87,40,47,2,1
3,422,422,113,57,56,3,2
6,433,433,12,12,0,1,0
5,476,476,70,70,0,1,0
7,484,484,52,13,39,4,3
12,485,485,61,14,47,2,1
1,490,490,33,33,0,1,0
14,496,496,36,21,15,4,3

11,107,107,15,1,14,3,2
4,115,115,2,2,0,1,0
7,131,131,8,3,5,2,1
5,136,136,36,36,0,1,0
13,149,149,3,3,0,1,0
31,160,160,24,4,20,2,1
23,169,169,58,58,0,1,0
24,178,178,4,4,0,1,0
0,194,194,2,2,0,1,0
1,207,207,37,10,27,4,3
37,220,220,49,13,36,3,2
8,224,224,6,3,3,2,1
27,224,224,62,43,19,2,1
25,227,227,29,8,21,2,1
14,234,234,27,27,0,1,0
20,245,245,22,22,0,1,0
15,296,296,12,3,9,4,3
6,298,298,89,5,84,4,3
21,317,317,3,3,0,1,0
32,323,323,55,14,41,4,3
38,337,337,2,2,0,1,0
36,339,339,5,2,3,2,1
34,339,339,4,4,0,1,0
9,340,340,2,2,0,1,0
18,351,351,45,1,44,2,1
35,356,356,33,33,0,1,0
30,357,357,9,9,0,1,0
3,359,359,53,29,24,4,3
29,360,360,8,3,5,2,1
10,361,361,12,3,9,4,3
12,368,368,31,7,24,3,2
33,406,406,47,11,36,4,3
19,407,407,8,3,5,2,1
2,417,417,34,10,24,3,2
28,418,418,16,16,0,1,0
26,451,451,8,8,0,1,0
22,462,462,80,35,45,3,2
17,478,478,67,40,27,4,3
16,490,490,42,26,16,3,2

7,102,102,3,3,0,1,0
14,107,107,6,6,0,1,0
24,129,129,2,2,0,1,0
29,135,135,18,2,16,3,2
0,144,144,109,97,12,3,2
21,148,148,4,4,0,1,0
16,156,156,10,10,0,1,0
28,187,187,30,20,10,2,1
25,188,188,39,39,0,1,0
19,203,203,24,6,18,2,1
23,211,211,61,43,18,4,3
8,256,256,20,20,0,1,0
27,269,269,20,8,12,2,1
18,277,277,32,32,0,1,0
22,293,293,17,17,0,1,0
5,298,298,7,7,0,1,0
10,317,317,96,96,0,1,0
2,317,317,11,11,0,1,0
1,322,322,41,36,5,2,1
12,322,322,52,52,0,1,0
20,327,327,1,1,0,1,0
9,398,398,89,89,0,1,0
3,413,413,88,37,51,4,3
26,438,438,2,2,0,1,0
4,446,446,40,40,0,1,0
15,451,451,1,1,0,1,0
13,477,477,11,5,6,3,2
11,484,484,23,23,0,1,0
6,496,496,11,6,5,2,1
17,499,499,197,157,40,4,3

32,111,111,5,5,0,1,0
18,115,115,2,2,0,1,0
15,122,122,54,10,44,3,2
16,135,135,13,13,0,1,0
3,148,148,3,3,0,1,0
12,160,160,9,9,0,1,0
21,179,179,17,17,0,1,0
28,197,197,20,9,11,2,1
7,204,204,49,49,0,1,0
30,215,215,9,2,7,2,1
5,219,219,8,1,7,2,1
17,225,225,26,22,4,2,1
0,231,231,8,1,7,2,1
26,235,235,57,57,0,1,0
20,237,237,10,10,0,1,0
14,246,246,98,98,0,1,0
4,309,309,125,53,72,3,2
2,319,319,3,3,0,1,0
29,324,324,12,12,0,1,0
19,329,329,32,2,30,4,3
1,338,338,23,23,0,1,0
6,364,364,10,10,0,1,0
23,365,365,4,1,3,2,1
9,381,381,39,3,36,4,3
11,400,400,79,51,28,3,2
8,400,400,55,55,0,1,0
13,419,419,22,22,0,1,0
27,428,428,93,78,15,4,3
22,429,429,98,98,0,1,0
24,445,445,12,12,0,1,0
25,458,458,5,2,3,2,1
33,465,465,8,5,3,2,1
10,484,484,57,43,14,2,1
31,496,496,30,4,26,3,2

13,130,130,18,18,0,1,0
35,137,137,5,5,0,1,0
28,152,152,14,14,0,1,0
29,168,168,12,1,11,2,1
12,174,174,27,27,0,1,0
23,176,176,7,7,0,1,0
5,177,177,18,3,15,4,3
24,186,186,22,1,21,2,1
9,222,222,21,1,20,3,2
25,223,223,20,17,3,2,1
3,233,233,25,25,0,1,0
8,239,239,5,1,4,2,1
10,245,245,8,8,0,1,0
26,263,263,13,13,0,1,0
19,298,298,24,24,0,1,0
1,311,311,79,25,54,4,3
30,314,314,27,27,0,1,0
20,315,315,5,5,0,1,0
27,330,330,76,24,52,3,2
14,337,337,52,12,40,2,1
34,341,341,64,31,33,4,3
11,355,355,70,70,0,1,0
21,388,388,87,54,33,2,1
15,413,413,155,127,28,3,2
33,414,414,33,9,24,4,3
17,423,423,97,44,53,3,2
16,435,435,15,15,0,1,0
18,456,456,13,5,8,3,2
7,474,474,21,21,0,1,0
6,480,480,23,2,21,2,1
4,481,481,2,2,0,1,0
32,483,483,23,23,0,1,0
2,485,485,21,3,18,3,2
31,492,492,104,104,0,1,0
22,495,495,4,4,0,1,0
0,495,495,47,1,46,2,1

9,101,101,4,1,3,2,1
21,116,116,23,23,0,1,0
28,130,130,34,16,18,2,1
11,160,160,25,19,6,3,2
32,174,174,39,39,0,1,0
8,177,177,13,10,3,2,1
3,180,180,10,10,0,1,0
38,183,183,46,46,0,1,0
16,185,185,17,9,8,3,2
27,200,200,8,5,3,2,1
35,211,211,13,13,0,1,0
40,212,212,8,8,0,1,0
22,242,242,2,2,0,1,0
0,247,247,2,2,0,1,0
30,275,275,26,8,18,3,2
36,286,286,23,23,0,1,0
13,298,298,55,43,12,4,3
26,310,310,33,33,0,1,0
10,319,319,58,1,57,4,3
6,323,323,9,9,0,1,0
15,335,335,4,1,3,2,1
25,344,344,10,10,0,1,0
5,348,348,46,41,5,2,1
39,365,365,51,51,0,1,0
4,365,365,4,1,3,2,1
14,366,366,37,37,0,1,0
20,370,370,21,5,16,2,1
23,395,395,31,31,0,1,0
19,401,401,65,45,20,3,2
2,403,403,15,11,4,2,1
7,405,405,34,34,0,1,0
34,418,418,25,18,7,2,1
31,420,420,75,57,18,3,2
18,422,422,98,60,38,2,1
33,424,424,39,5,34,4,3
24,436,436,68,68,0,1,0
1,438,438,10,10,0,1,0
17,444,444,2,2,0,1,0
12,452,452,14,6,8,2,1
29,486,486,9,9,0,1,0
37,491,491,5,5,0,1,0

28,105,105,10,10,0,1,0
1,107,107,1,1,0,1,0
16,109,109,18,18,0,1,0
18,109,109,1,1,0,1,0
13,116,116,1,1,0,1,0
40,138,138,5,5,0,1,0
36,142,142,10,10,0,1,0
8,147,147,2,2,0,1,0
33,147,147,5,5,0,1,0
32,153,153,2,2,0,1,0
42,162,162,26,6,20,2,1
25,192,192,7,7,0,1,0
26,208,208,21,17,4,2,1
12,233,233,3,3,0,1,0
19,244,244,37,37,0,1,0
29,246,246,37,24,13,2,1
14,253,253,10,10,0,1,0
41,272,272,10,10,0,1,0
24,275,275,9,1,8,3,2
22,283,283,7,7,0,1,0
21,293,293,24,8,16,3,2
11,295,295,94,23,71,3,2
5,300,300,52,5,47,4,3
4,302,302,11,11,0,1,0
38,314,314,11,11,0,1,0
31,317,317,69,7,62,3,2
35,324,324,21,21,0,1,0
23,338,338,1,1,0,1,0
2,339,339,21,21,0,1,0
3,351,351,7,7,0,1,0
34,360,360,44,19,25,2,1
15,380,380,93,36,57,3,2
30,389,389,113,65,48,2,1
27,390,390,65,31,34,3,2
6,395,395,14,14,0,1,0
9,403,403,12,1,11,2,1
20,423,423,21,16,5,2,1
10,423,423,111,111,0,1,0
17,429,429,31,8,23,2,1
39,432,432,45,9,36,3,2
0,444,444,13,13,0,1,0
7,482,482,23,23,0,1,0
37,485,485,79,13,66,3,2

17,104,104,1,1,0,1,0
20,108,108,8,5,3,2,1
28,114,114,11,11,0,1,0
3,117,117,1,1,0,1,0
7,132,132,13,13,0,1,0
37,133,133,5,1,4,2,1
26,139,139,67,1,66,4,3
33,144,144,3,3,0,1,0
31,145,145,1,1,0,1,0
21,149,149,5,2,3,2,1
15,171,171,21,21,0,1,0
8,175,175,7,7,0,1,0
12,180,180,3,3,0,1,0
30,246,246,1,1,0,1,0
9,261,261,24,24,0,1,0
1,267,267,8,1,7,2,1
0,268,268,62,62,0,1,0
32,268,268,14,8,6,3,2
23,268,268,15,1,14,3,2
35,271,271,28,28,0,1,0
22,284,284,18,10,8,2,1
2,284,284,14,7,7,2,1
27,286,286,8,5,3,2,1
24,316,316,5,5,0,1,0
6,322,322,73,38,35,2,1
18,332,332,55,55,0,1,0
14,347,347,104,75,29,2,1
11,354,354,14,1,13,2,1
13,361,361,25,15,10,4,3
29,374,374,61,61,0,1,0
36,382,382,88,88,0,1,0
16,384,384,43,43,0,1,0
5,393,393,51,51,0,1,0
4,406,406,20,6,14,3,2
10,426,426,47,47,0,1,0
34,474,474,27,7,20,3,2
19,486,486,7,7,0,1,0
25,500,500,201,105,96,4,3

5,122,122,25,25,0,1,0
35,143,143,1,1,0,1,0
17,148,148,16,1,15,4,3
23,150,150,31,8,23,2,1
29,168,168,11,8,3,2,1
11,174,174,6,6,0,1,0
0,185,185,27,27,0,1,0
14,207,207,58,6,52,4,3
30,217,217,9,9,0,1,0
7,223,223,11,2,9,4,3
27,250,250,13,9,4,2,1
12,256,256,15,15,0,1,0
18,259,259,8,8,0,1,0
3,264,264,10,10,0,1,0
37,277,277,3,3,0,1,0
26,282,282,80,80,0,1,0
4,288,288,63,26,37,2,1
16,294,294,43,43,0,1,0
36,295,295,28,25,3,2,1
2,317,317,6,6,0,1,0
32,370,370,69,23,46,3,2
34,378,378,24,24,0,1,0
21,379,379,34,34,0,1,0
8,381,381,15,15,0,1,0
9,391,391,64,1,63,4,3
28,395,395,82,56,26,2,1
10,396,396,31,10,21,2,1
20,399,399,45,45,0,1,0
22,421,421,12,12,0,1,0
25,425,425,34,34,0,1,0
31,426,426,87,87,0,1,0
13,427,427,25,12,13,2,1
1,460,460,7,3,4,2,1
19,466,466,6,6,0,1,0
24,478,478,17,17,0,1,0
6,484,484,62,12,50,2,1
33,494,494,71,3,68,4,3
15,499,499,43,2,41,2,1

15,105,105,15,10,5,2,1
5,105,105,3,3,0,1,0
7,109,109,4,4,0,1,0
13,116,116,17,17,0,1,0
25,119,119,16,16,0,1,0
18,132,132,30,30,0,1,0
29,135,135,14,14,0,1,0
0,156,156,1,1,0,1,0
3,158,158,21,21,0,1,0
26,170,170,1,1,0,1,0
17,173,173,43,43,0,1,0
9,197,197,24,24,0,1,0
23,210,210,1,1,0,1,0
16,217,217,19,13,6,3,2
11,219,219,23,1,22,2,1
2,221,221,2,2,0,1,0
19,237,237,3,3,0,1,0
6,244,244,13,1,12,2,1
27,248,248,63,9,54,4,3
35,249,249,31,16,15,4,3
10,251,251,9,9,0,1,0
14,256,256,35,10,25,2,1
8,261,261,21,21,0,1,0
20,284,284,17,17,0,1,0
37,293,293,104,51,53,4,3
30,296,296,18,18,0,1,0
12,297,297,52,34,18,4,3
31,304,304,48,48,0,1,0
22,305,305,7,7,0,1,0
4,311,311,27,27,0,1,0
36,345,345,13,13,0,1,0
24,355,355,40,18,22,2,1
21,380,380,31,19,12,2,1
33,382,382,59,25,34,2,1
28,438,438,20,5,15,2,1
32,441,441,9,9,0,1,0
1,463,463,21,15,6,3,2
34,477,477,91,22,69,4,3

32,122,122,30,30,0,1,0
24,134,134,13,7,6,2,1
8,136,136,20,20,0,1,0
2,159,159,24,24,0,1,0
16,162,162,24,24,0,1,0
33,194,194,8,8,0,1,0
19,194,194,12,4,8,3,2
26,196,196,29,29,0,1,0
18,206,206,39,39,0,1,0
9,207,207,13,1,12,2,1
34,208,208,16,4,12,4,3
7,222,222,23,7,16,3,2
37,233,233,40,32,8,3,2
6,235,235,15,15,0,1,0
25,243,243,31,31,0,1,0
30,254,254,20,20,0,1,0
36,263,263,8,8,0,1,0
12,271,271,11,2,9,2,1
0,300,300,66,66,0,1,0
17,331,331,1,1,0,1,0
21,340,340,44,5,39,2,1
35,343,343,29,1,28,2,1
10,357,357,1,1,0,1,0
1,372,372,6,6,0,1,0
23,378,378,10,10,0,1,0
15,384,384,38,38,0,1,0
22,384,384,8,8,0,1,0
4,399,399,24,24,0,1,0
13,403,403,20,12,8,3,2
3,407,407,15,15,0,1,0
14,415,415,131,131,0,1,0
11,423,423,4,4,0,1,0
31,425,425,13,8,5,2,1
5,437,437,54,54,0,1,0
29,441,441,67,9,58,3,2
27,473,473,94,10,84,4,3
38,474,474,90,57,33,4,3
20,477,477,36,27,9,4,3
28,494,494,1,1,0,1,0

13,103,103,2,2,0,1,0
37,115,115,52,16,36,4,3
45,116,116,3,3,0,1,0
1,119,119,1,1,0,1,0
14,122,122,9,4,5,2,1
28,126,126,34,34,0,1,0
33,127,127,5,5,0,1,0
36,134,134,13,13,0,1,0
5,139,139,7,7,0,1,0
43,144,144,1,1,0,1,0
38,152,152,15,5,10,2,1
30,153,153,7,7,0,1,0
41,167,167,5,1,4,2,1
9,169,169,1,1,0,1,0
17,174,174,3,3,0,1,0
23,175,175,1,1,0,1,0
19,182,182,35,21,14,3,2
25,184,184,36,36,0,1,0
31,204,204,18,13,5,2,1
21,206,206,12,12,0,1,0
6,221,221,35,35,0,1,0
46,222,222,4,4,0,1,0
8,232,232,35,35,0,1,0
0,268,268,18,18,0,1,0
26,275,275,26,2,24,4,3
2,276,276,1,1,0,1,0
4,283,283,47,47,0,1,0
29,285,285,67,11,56,4,3
32,289,289,3,3,0,1,0
24,290,290,12,5,7,2,1
16,294,294,11,11,0,1,0
22,295,295,38,5,33,4,3
11,303,303,8,8,0,1,0
20,311,311,6,3,3,2,1
10,317,317,14,6,8,3,2
40,334,334,23,11,12,3,2
15,336,336,10,3,7,2,1
39,339,339,6,6,0,1,0
42,368,368,18,18,0,1,0
35,377,377,51,51,0,1,0
7,393,393,44,11,33,2,1
3,416,416,16,16,0,1,0
12,452,452,21,5,16,2,1
34,475,475,37,8,29,2,1
27,484,484,44,44,0,1,0
44,489,489,83,83,0,1,0
18,492,492,9,6,3,2,1

6,109,109,20,1,19,4,3
9,116,116,5,5,0,1,0
33,117,117,14,5,9,2,1
28,136,136,20,2,18,3,2
29,142,142,13,9,4,2,1
19,143,143,1,1,0,1,0
16,154,154,47,47,0,1,0
11,160,160,4,1,3,2,1
22,183,183,3,3,0,1,0
35,197,197,1,1,0,1,0
5,198,198,18,18,0,1,0
10,214,214,5,5,0,1,0
20,219,219,2,2,0,1,0
39,225,225,6,6,0,1,0
25,227,227,2,2,0,1,0
12,252,252,6,6,0,1,0
24,294,294,49,49,0,1,0
32,296,296,3,3,0,1,0
14,307,307,105,105,0,1,0
17,316,316,15,7,8,2,1
2,316,316,2,2,0,1,0
0,322,322,13,4,9,2,1
18,329,329,33,22,11,2,1
15,338,338,23,23,0,1,0
38,339,339,29,21,8,3,2
30,355,355,84,84,0,1,0
34,376,376,18,18,0,1,0
37,379,379,85,27,58,4,3
8,404,404,3,3,0,1,0
26,406,406,14,14,0,1,0
7,407,407,41,41,0,1,0
4,412,412,29,3,26,2,1
1,419,419,45,45,0,1,0
27,440,440,32,32,0,1,0
13,444,444,74,74,0,1,0
23,445,445,51,51,0,1,0
31,453,453,27,27,0,1,0
3,453,453,60,60,0,1,0
36,482,482,195,132,63,4,3
21,493,493,33,7,26,2,1

5,105,105,7,4,3,2,1
9,113,113,2,2,0,1,0
27,115,115,9,9,0,1,0
19,126,126,7,7,0,1,0
33,155,155,1,1,0,1,0
7,159,159,48,14,34,3,2
2,179,179,1,1,0,1,0
30,191,191,7,3,4,2,1
29,194,194,45,45,0,1,0
20,203,203,45,45,0,1,0
0,209,209,24,2,22,3,2
11,210,210,50,45,5,2,1
6,226,226,33,17,16,3,2
21,228,228,23,5,18,4,3
36,240,240,44,26,18,4,3
24,244,244,59,10,49,2,1
32,254,254,46,46,0,1,0
1,278,278,45,21,24,4,3
4,280,280,3,3,0,1,0
12,291,291,54,54,0,1,0
10,297,297,22,22,0,1,0
14,313,313,7,7,0,1,0
3,316,316,8,1,7,2,1
31,325,325,48,7,41,2,1
34,344,344,26,21,5,2,1
23,358,358,25,4,21,2,1
26,383,383,48,48,0,1,0
22,389,389,21,21,0,1,0
8,396,396,6,2,4,2,1
16,416,416,15,15,0,1,0
13,417,417,94,94,0,1,0
18,434,434,21,3,18,3,2
17,443,443,66,66,0,1,0
15,443,443,46,1,45,4,3
35,447,447,10,2,8,3,2
25,453,453,28,13,15,4,3
28,472,472,1,1,0,1,0

11,104,104,6,6,0,1,0
22,110,110,22,8,14,3,2
32,129,129,27,20,7,2,1
0,152,152,9,9,0,1,0
41,158,158,42,1,41,2,1
28,162,162,32,12,20,3,2
36,173,173,4,4,0,1,0
24,181,181,10,7,3,2,1
35,184,184,63,7,56,3,2
30,186,186,10,10,0,1,0
19,189,189,14,14,0,1,0
42,190,190,5,5,0,1,0
44,190,190,17,8,9,2,1
14,213,213,1,1,0,1,0
38,223,223,14,1,13,2,1
6,224,224,35,35,0,1,0
10,238,238,62,22,40,4,3
37,245,245,6,6,0,1,0
4,254,254,11,1,10,2,1
34,263,263,24,24,0,1,0
15,264,264,2,2,0,1,0
21,268,268,25,1,24,2,1
20,269,269,9,1,8,3,2
33,280,280,37,37,0,1,0
40,287,287,18,2,16,3,2
29,304,304,50,24,26,3,2
5,324,324,13,4,9,2,1
39,326,326,14,2,12,2,1
27,341,341,19,19,0,1,0
26,348,348,2,2,0,1,0
13,349,349,1,1,0,1,0
9,369,369,46,19,27,4,3
1,389,389,32,32,0,1,0
23,402,402,43,3,40,2,1
12,405,405,10,10,0,1,0
17,411,411,10,3,7,2,1
2,414,414,15,3,12,3,2
7,417,417,20,20,0,1,0
18,433,433,7,1,6,2,1
16,433,433,68,68,0,1,0
25,464,464,61,61,0,1,0
43,468,468,43,43,0,1,0
8,485,485,23,23,0,1,0
31,487,487,1,1,0,1,0
3,490,490,7,7,0,1,0

20,118,118,26,26,0,1,0
24,142,142,2,2,0,1,0
33,152,152,33,23,10,2,1
37,161,161,1,1,0,1,0
17,164,164,7,7,0,1,0
39,167,167,17,17,0,1,0
0,171,171,4,4,0,1,0
30,176,176,72,31,41,2,1
31,178,178,31,31,0,1,0
32,182,182,3,3,0,1,0
11,183,183,25,8,17,2,1
25,209,209,9,9,0,1,0
18,218,218,20,12,8,3,2
12,235,235,4,4,0,1,0
15,236,236,11,2,9,4,3
35,241,241,74,17,57,4,3
23,249,249,6,6,0,1,0
34,250,250,11,11,0,1,0
10,260,260,11,11,0,1,0
7,271,271,26,5,21,2,1
26,273,273,52,23,29,2,1
28,302,302,7,7,0,1,0
3,318,318,73,60,13,2,1
4,320,320,36,2,34,3,2
16,320,320,21,21,0,1,0
29,339,339,7,7,0,1,0
27,357,357,86,24,62,4,3
8,373,373,28,1,27,2,1
5,390,390,1,1,0,1,0
14,398,398,71,41,30,4,3
22,428,428,16,16,0,1,0
38,445,445,3,3,0,1,0
1,446,446,18,4,14,2,1
9,446,446,13,9,4,2,1
2,449,449,8,2,6,2,1
13,450,450,11,11,0,1,0
21,457,457,16,6,10,2,1
36,459,459,12,12,0,1,0
19,461,461,7,1,6,2,1
6,482,482,193,193,0,1,0

7,102,102,7,1,6,2,1
29,120,120,1,1,0,1,0
30,126,126,13,13,0,1,0
33,148,148,52,9,43,3,2
20,170,170,45,45,0,1,0
12,184,184,49,3,46,2,1
22,194,194,2,2,0,1,0
3,201,201,25,5,20,3,2
24,205,205,3,3,0,1,0
34,222,222,39,39,0,1,0
35,224,224,47,33,14,2,1
32,247,247,7,7,0,1,0
23,251,251,13,5,8,3,2
26,258,258,2,2,0,1,0
10,271,271,16,16,0,1,0
18,271,271,4,4,0,1,0
0,276,276,8,8,0,1,0
14,278,278,15,15,0,1,0
8,281,281,12,12,0,1,0
19,290,290,1,1,0,1,0
28,305,305,70,70,0,1,0
2,308,308,6,2,4,2,1
9,313,313,124,77,47,2,1
13,337,337,12,1,11,4,3
6,357,357,25,3,22,2,1
25,378,378,27,27,0,1,0
4,402,402,58,33,25,4,3
27,419,419,79,79,0,1,0
21,420,420,1,1,0,1,0
5,424,424,47,9,38,2,1
1,429,429,49,49,0,1,0
16,452,452,128,128,0,1,0
15,454,454,10,10,0,1,0
11,455,455,28,28,0,1,0
17,475,475,26,26,0,1,0
31,496,496,76,42,34,2,1

15,106,106,38,15,23,2,1
22,116,116,8,8,0,1,0
11,125,125,2,2,0,1,0
26,134,134,7,1,6,2,1
7,155,155,26,2,24,4,3
1,171,171,4,4,0,1,0
35,173,173,1,1,0,1,0
27,184,184,2,2,0,1,0
8,207,207,33,33,0,1,0
13,230,230,9,9,0,1,0
31,253,253,50,50,0,1,0
4,266,266,51,1,50,3,2
20,280,280,2,2,0,1,0
21,285,285,19,12,7,2,1
16,289,289,4,1,3,2,1
30,296,296,38,6,32,2,1
34,301,301,66,66,0,1,0
37,306,306,22,5,17,3,2
32,321,321,12,5,7,2,1
14,332,332,1,1,0,1,0
28,339,339,93,3,90,4,3
33,345,345,62,14,48,2,1
12,352,352,16,11,5,2,1
3,382,382,116,87,29,2,1
10,385,385,28,6,22,4,3
24,401,401,10,10,0,1,0
6,404,404,4,1,3,2,1
19,414,414,9,9,0,1,0
9,418,418,25,12,13,2,1
2,419,419,27,27,0,1,0
25,421,421,120,120,0,1,0
18,436,436,48,4,44,3,2
29,458,458,85,67,18,3,2
36,470,470,15,15,0,1,0
17,470,470,62,62,0,1,0
23,477,477,32,32,0,1,0
0,479,479,57,57,0,1,0
5,482,482,6,6,0,1,0

17,112,112,6,1,5,2,1
16,127,127,42,42,0,1,0
25,139,139,2,2,0,1,0
34,151,151,14,14,0,1,0
31,163,163,12,7,5,2,1
44,165,165,7,7,0,1,0
23,181,181,6,6,0,1,0
8,216,216,16,16,0,1,0
24,221,221,32,32,0,1,0
27,221,221,29,9,20,2,1
4,227,227,32,15,17,4,3
33,236,236,7,4,3,2,1
26,249,249,17,14,3,2,1
32,254,254,44,44,0,1,0
43,256,256,1,1,0,1,0
12,257,257,16,1,15,4,3
35,269,269,1,1,0,1,0
38,270,270,5,5,0,1,0
13,271,271,26,10,16,4,3
10,272,272,13,5,8,2,1
1,273,273,2,2,0,1,0
14,279,279,37,37,0,1,0
15,307,307,1,1,0,1,0
30,314,314,41,41,0,1,0
28,315,315,119,49,70,4,3
36,325,325,103,5,98,4,3
40,329,329,4,4,0,1,0
42,339,339,8,4,4,2,1
2,340,340,40,40,0,1,0
19,352,352,5,5,0,1,0
22,354,354,7,4,3,2,1
39,354,354,3,3,0,1,0
29,355,355,84,84,0,1,0
11,363,363,13,10,3,2,1
5,374,374,20,12,8,2,1
3,375,375,10,10,0,1,0
6,397,397,22,22,0,1,0
41,400,400,60,52,8,2,1
0,416,416,20,20,0,1,0
20,427,427,14,14,0,1,0
37,476,476,21,21,0,1,0
7,478,478,28,4,24,2,1
21,486,486,56,56,0,1,0
18,497,497,64,33,31,2,1
9,498,498,29,2,27,4,3

30,110,110,2,2,0,1,0
18,122,122,31,5,26,3,2
1,139,139,4,4,0,1,0
21,189,189,15,15,0,1,0
11,214,214,4,4,0,1,0
27,215,215,2,2,0,1,0
3,226,226,5,5,0,1,0
31,228,228,42,42,0,1,0
4,250,250,29,21,8,2,1
26,250,250,7,7,0,1,0
13,257,257,30,30,0,1,0
7,280,280,8,3,5,2,1
23,286,286,46,46,0,1,0
25,290,290,9,9,0,1,0
29,306,306,19,16,3,2,1
16,307,307,77,53,24,3,2
28,330,330,8,8,0,1,0
14,334,334,76,27,49,2,1
0,344,344,54,30,24,4,3
15,364,364,31,7,24,3,2
6,385,385,210,210,0,1,0
5,402,402,82,82,0,1,0
2,430,430,109,64,45,4,3
10,436,436,128,49,79,3,2
20,437,437,5,5,0,1,0
22,440,440,19,19,0,1,0
9,442,442,19,13,6,2,1
12,457,457,17,17,0,1,0
17,479,479,41,20,21,2,1
19,491,491,87,54,33,4,3
8,494,494,76,42,34,3,2
24,495,495,41,41,0,1,0

17,111,111,7,7,0,1,0
0,122,122,1,1,0,1,0
28,138,138,19,19,0,1,0
7,167,167,24,8,16,3,2
16,174,174,30,30,0,1,0
12,196,196,14,14,0,1,0
4,215,215,39,14,25,4,3
9,222,222,2,2,0,1,0
8,239,239,2,2,0,1,0
34,241,241,3,3,0,1,0
11,253,253,2,2,0,1,0
14,262,262,29,29,0,1,0
6,274,274,56,56,0,1,0
27,280,280,37,10,27,4,3
33,297,297,33,17,16,3,2
30,299,299,32,5,27,2,1
20,300,300,14,1,13,2,1
31,304,304,41,41,0,1,0
2,332,332,29,7,22,2,1
32,337,337,8,8,0,1,0
23,341,341,23,2,21,4,3
13,367,367,41,41,0,1,0
1,378,378,66,66,0,1,0
5,378,378,108,98,10,3,2
3,383,383,45,13,32,2,1
35,385,385,20,9,11,2,1
18,395,395,103,103,0,1,0
22,399,399,128,108,20,3,2
24,411,411,35,35,0,1,0
21,443,443,59,47,12,2,1
29,446,446,21,6,15,4,3
15,456,456,62,5,57,4,3
19,457,457,57,29,28,2,1
26,471,471,18,18,0,1,0
25,479,479,17,4,13,2,1
10,497,497,37,8,29,2,1

35,106,106,24,24,0,1,0
3,130,130,6,6,0,1,0
36,147,147,3,3,0,1,0
31,159,159,22,6,16,2,1
10,189,189,2,2,0,1,0
24,190,190,28,28,0,1,0
23,193,193,14,4,10,3,2
7,208,208,21,21,0,1,0
26,233,233,3,3,0,1,0
14,234,234,7,7,0,1,0
19,239,239,11,11,0,1,0
5,255,255,4,4,0,1,0
37,261,261,22,22,0,1,0
4,273,273,1,1,0,1,0
2,279,279,66,36,30,3,2
16,293,293,6,6,0,1,0
34,296,296,11,1,10,3,2
30,300,300,10,10,0,1,0
6,302,302,42,5,37,2,1
21,313,313,5,2,3,2,1
20,314,314,2,2,0,1,0
22,316,316,44,14,30,4,3
8,336,336,45,27,18,3,2
12,357,357,78,42,36,2,1
32,372,372,19,3,16,2,1
27,385,385,88,60,28,3,2
17,387,387,38,14,24,3,2
1,394,394,36,16,20,3,2
0,395,395,69,69,0,1,0
28,406,406,84,43,41,2,1
9,408,408,62,11,51,4,3
38,409,409,63,24,39,4,3
29,415,415,18,18,0,1,0
15,416,416,27,21,6,2,1
11,425,425,14,9,5,2,1
25,432,432,5,5,0,1,0
18,437,437,30,21,9,4,3
33,442,442,139,46,93,4,3
13,487,487,106,89,17,2,1

24,116,116,5,5,0,1,0
35,122,122,27,10,17,2,1
14,138,138,7,1,6,3,2
29,139,139,3,3,0,1,0
11,170,170,13,13,0,1,0
23,180,180,13,13,0,1,0
36,184,184,8,8,0,1,0
6,193,193,2,2,0,1,0
7,196,196,28,28,0,1,0
10,197,197,13,8,5,2,1
21,244,244,33,4,29,2,1
34,250,250,87,87,0,1,0
3,259,259,106,106,0,1,0
31,260,260,24,24,0,1,0
16,271,271,10,4,6,2,1
32,273,273,13,1,12,3,2
9,277,277,116,70,46,3,2
8,282,282,23,23,0,1,0
30,284,284,13,13,0,1,0
37,286,286,17,17,0,1,0
17,303,303,2,2,0,1,0
20,313,313,32,32,0,1,0
28,334,334,48,40,8,2,1
2,342,342,1,1,0,1,0
4,347,347,3,3,0,1,0
1,371,371,20,20,0,1,0
27,379,379,17,12,5,2,1
15,391,391,67,10,57,4,3
5,393,393,2,2,0,1,0
25,401,401,13,13,0,1,0
19,431,431,36,36,0,1,0
12,443,443,14,14,0,1,0
18,450,450,74,74,0,1,0
13,461,461,19,4,15,3,2
26,470,470,76,49,27,4,3
0,483,483,59,19,40,3,2
33,486,486,11,3,8,3,2
22,491,491,104,104,0,1,0

9,145,145,8,8,0,1,0
34,146,146,11,11,0,1,0
24,147,147,1,1,0,1,0
29,159,159,30,4,26,2,1
19,160,160,7,7,0,1,0
7,166,166,18,18,0,1,0
11,187,187,1,1,0,1,0
31,204,204,97,91,6,3,2
1,260,260,14,14,0,1,0
33,262,262,1,1,0,1,0
27,271,271,7,7,0,1,0
23,276,276,41,41,0,1,0
35,284,284,17,17,0,1,0
21,286,286,53,53,0,1,0
2,292,292,94,16,78,4,3
25,301,301,9,4,5,2,1
16,322,322,10,10,0,1,0
12,348,348,32,32,0,1,0
10,357,357,22,12,10,2,1
26,360,360,1,1,0,1,0
30,362,362,39,7,32,2,1
28,378,378,46,46,0,1,0
22,384,384,7,7,0,1,0
14,388,388,94,50,44,3,2
32,394,394,33,33,0,1,0
15,419,419,39,8,31,2,1
6,426,426,20,20,0,1,0
3,442,442,13,13,0,1,0
8,454,454,127,127,0,1,0
0,461,461,29,23,6,2,1
13,471,471,38,38,0,1,0
20,477,477,108,108,0,1,0
18,481,481,59,22,37,2,1
5,486,486,40,17,23,2,1
4,489,489,125,92,33,2,1
17,493,493,5,2,3,2,1

10,100,100,7,7,0,1,0
24,104,104,7,3,4,2,1
25,105,105,8,8,0,1,0
15,143,143,9,9,0,1,0
21,153,153,11,5,6,2,1
14,155,155,4,4,0,1,0
27,156,156,15,1,14,3,2
32,178,178,32,4,28,3,2
22,187,187,49,49,0,1,0
20,188,188,20,11,9,4,3
29,189,189,36,3,33,4,3
1,206,206,11,11,0,1,0
11,206,206,18,3,15,4,3
12,215,215,1,1,0,1,0
31,255,255,10,10,0,1,0
8,291,291,34,18,16,3,2
13,309,309,5,5,0,1,0
7,315,315,45,45,0,1,0
28,322,322,10,2,8,2,1
18,334,334,22,22,0,1,0
9,344,344,10,10,0,1,0
30,345,345,74,28,46,3,2
6,371,371,11,2,9,2,1
16,374,374,14,14,0,1,0
26,380,380,45,35,10,2,1
19,382,382,46,46,0,1,0
23,421,421,57,21,36,4,3
0,421,421,63,16,47,2,1
3,435,435,158,132,26,4,3
17,441,441,26,26,0,1,0
5,458,458,363,363,0,1,0
2,459,459,15,9,6,3,2
4,499,499,6,2,4,2,1

8,102,102,1,1,0,1,0
31,125,125,5,2,3,2,1
9,127,127,18,8,10,2,1
17,145,145,6,6,0,1,0
15,161,161,18,2,16,2,1
28,162,162,16,1,15,4,3
37,163,163,3,3,0,1,0
26,184,184,21,21,0,1,0
6,186,186,10,1,9,4,3
12,187,187,17,4,13,3,2
34,192,192,11,11,0,1,0
4,210,210,6,6,0,1,0
2,212,212,1,1,0,1,0
7,221,221,15,15,0,1,0
19,227,227,9,1,8,2,1
39,235,235,4,4,0,1,0
30,241,241,38,26,12,4,3
23,254,254,30,30,0,1,0
29,254,254,4,4,0,1,0
13,257,257,9,9,0,1,0
38,262,262,47,47,0,1,0
1,272,272,139,46,93,4,3
18,274,274,3,3,0,1,0
25,293,293,30,30,0,1,0
35,295,295,18,6,12,3,2
16,329,329,11,11,0,1,0
27,330,330,17,17,0,1,0
22,360,360,12,4,8,3,2
21,366,366,11,11,0,1,0
5,386,386,4,1,3,2,1
36,387,387,32,5,27,2,1
32,405,405,246,205,41,2,1
10,417,417,67,1,66,3,2
3,419,419,84,58,26,2,1
33,420,420,5,5,0,1,0
14,420,420,40,40,0,1,0
24,425,425,59,11,48,4,3
20,444,444,41,11,30,3,2
11,447,447,67,50,17,2,1
0,450,450,5,1,4,2,1

29,108,108,8,8,0,1,0
35,111,111,1,1,0,1,0
27,123,123,2,2,0,1,0
13,131,131,4,4,0,1,0
31,134,134,27,15,12,4,3
12,143,143,19,19,0,1,0
6,153,153,30,30,0,1,0
0,156,156,15,15,0,1,0
11,156,156,19,11,8,3,2
1,162,162,12,12,0,1,0
17,168,168,37,3,34,3,2
28,169,169,1,1,0,1,0
20,173,173,7,7,0,1,0
19,184,184,14,14,0,1,0
2,189,189,20,11,9,2,1
26,196,196,9,9,0,1,0
8,201,201,28,23,5,2,1
18,202,202,12,12,0,1,0
5,204,204,20,2,18,3,2
16,256,256,28,28,0,1,0
30,264,264,4,1,3,2,1
32,268,268,2,2,0,1,0
10,306,306,6,1,5,2,1
25,326,326,18,18,0,1,0
24,342,342,33,27,6,3,2
34,352,352,73,73,0,1,0
3,393,393,33,13,20,2,1
14,394,394,2,2,0,1,0
33,401,401,53,29,24,4,3
36,402,402,76,76,0,1,0
22,412,412,25,25,0,1,0
37,416,416,61,31,30,3,2
7,420,420,76,76,0,1,0
9,425,425,48,15,33,4,3
21,468,468,237,132,105,4,3
4,473,473,15,15,0,1,0
23,495,495,28,28,0,1,0
15,496,496,41,23,18,2,1

15,132,132,23,11,12,4,3
17,141,141,7,2,5,2,1
7,157,157,10,4,6,3,2
22,163,163,12,12,0,1,0
19,171,171,3,3,0,1,0
14,180,180,38,38,0,1,0
26,206,206,31,31,0,1,0
10,212,212,24,24,0,1,0
27,220,220,1,1,0,1,0
16,225,225,17,17,0,1,0
13,226,226,73,45,28,3,2
21,226,226,9,9,0,1,0
1,235,235,44,32,12,2,1
25,239,239,50,50,0,1,0
34,249,249,2,2,0,1,0
9,270,270,38,38,0,1,0
3,281,281,37,19,18,3,2
35,284,284,3,3,0,1,0
23,310,310,11,1,10,3,2
2,315,315,25,25,0,1,0
4,321,321,1,1,0,1,0
5,321,321,27,5,22,3,2
20,323,323,57,51,6,3,2
33,326,326,10,10,0,1,0
29,342,342,5,5,0,1,0
31,358,358,102,102,0,1,0
8,366,366,17,17,0,1,0
18,377,377,28,28,0,1,0
11,382,382,4,1,3,2,1
28,402,402,10,3,7,2,1
24,414,414,85,8,77,4,3
12,437,437,18,8,10,2,1
0,440,440,25,1,24,3,2
30,467,467,140,47,93,4,3
6,467,467,53,53,0,1,0
32,467,467,101,91,10,3,2
36,485,485,29,29,0,1,0

16,100,100,27,3,24,2,1
19,101,101,13,13,0,1,0
3,120,120,6,6,0,1,0
6,124,124,10,10,0,1,0
20,132,132,9,4,5,2,1
14,144,144,28,1,27,4,3
23,149,149,8,1,7,2,1
4,151,151,26,26,0,1,0
17,184,184,1,1,0,1,0
13,203,203,9,2,7,2,1
11,214,214,45,12,33,4,3
15,215,215,77,51,26,2,1
12,221,221,5,1,4,2,1
22,230,230,2,2,0,1,0
28,249,249,25,7,18,2,1
8,255,255,1,1,0,1,0
30,261,261,10,2,8,3,2
31,268,268,6,6,0,1,0
24,274,274,62,32,30,2,1
2,274,274,29,29,0,1,0
5,296,296,23,23,0,1,0
18,301,301,9,9,0,1,0
32,339,339,22,22,0,1,0
10,347,347,60,42,18,2,1
1,352,352,8,2,6,2,1
0,411,411,190,133,57,4,3
27,417,417,41,41,0,1,0
9,425,425,3,3,0,1,0
7,428,428,201,111,90,4,3
26,441,441,25,22,3,2,1
21,444,444,31,31,0,1,0
29,451,451,29,29,0,1,0
25,471,471,41,3,38,2,1

1,104,104,2,2,0,1,0
10,114,114,14,2,12,4,3
13,125,125,8,4,4,2,1
22,130,130,5,5,0,1,0
12,132,132,1,1,0,1,0
27,136,136,11,2,9,2,1
11,176,176,23,12,11,2,1
14,203,203,30,30,0,1,0
19,240,240,7,7,0,1,0
20,243,243,10,10,0,1,0
21,251,251,81,81,0,1,0
2,261,261,32,25,7,2,1
9,301,301,3,3,0,1,0
23,301,301,1,1,0,1,0
29,314,314,21,21,0,1,0
3,341,341,84,84,0,1,0
26,356,356,95,2,93,4,3
18,372,372,2,2,0,1,0
17,385,385,1,1,0,1,0
4,415,415,72,46,26,2,1
16,420,420,1,1,0,1,0
15,433,433,167,89,78,4,3
24,442,442,15,15,0,1,0
7,443,443,271,271,0,1,0
5,453,453,31,20,11,2,1
8,457,457,39,16,23,2,1
0,471,471,108,108,0,1,0
25,479,479,135,95,40,3,2
28,481,481,53,39,14,3,2
6,497,497,42,42,0,1,0
30,499,499,19,19,0,1,0

7,114,114,10,10,0,1,0
19,115,115,9,1,8,3,2
9,116,116,3,3,0,1,0
24,120,120,26,6,20,4,3
23,123,123,28,16,12,4,3
13,127,127,29,29,0,1,0
3,135,135,11,5,6,2,1
31,141,141,1,1,0,1,0
21,161,161,3,3,0,1,0
28,162,162,14,4,10,3,2
11,183,183,1,1,0,1,0
32,184,184,23,2,21,2,1
20,184,184,10,1,9,4,3
22,186,186,11,11,0,1,0
29,191,191,23,11,12,3,2
1,291,291,14,14,0,1,0
12,304,304,35,35,0,1,0
4,304,304,1,1,0,1,0
34,317,317,12,12,0,1,0
14,322,322,3,3,0,1,0
15,323,323,4,4,0,1,0
36,332,332,35,19,16,3,2
2,339,339,58,58,0,1,0
5,351,351,12,12,0,1,0
0,354,354,28,28,0,1,0
25,366,366,42,19,23,3,2
6,366,366,63,63,0,1,0
8,379,379,130,127,3,2,1
26,379,379,44,44,0,1,0
10,390,390,30,6,24,4,3
27,394,394,71,35,36,4,3
33,394,394,33,33,0,1,0
35,396,396,67,27,40,2,1
18,409,409,46,46,0,1,0
16,434,434,68,17,51,4,3
30,463,463,11,11,0,1,0
17,464,464,116,48,68,4,3

10,104,104,7,7,0,1,0
4,109,109,5,5,0,1,0
16,154,154,35,11,24,3,2
28,168,168,24,7,17,2,1
20,187,187,20,16,4,2,1
33,196,196,13,13,0,1,0
18,203,203,14,7,7,2,1
34,221,221,37,9,28,2,1
5,268,268,7,7,0,1,0
0,273,273,12,2,10,3,2
14,286,286,56,56,0,1,0
2,288,288,22,4,18,2,1
26,293,293,19,19,0,1,0
12,307,307,28,1,27,4,3
6,311,311,22,12,10,2,1
8,317,317,16,16,0,1,0
22,329,329,5,5,0,1,0
36,348,348,51,51,0,1,0
17,348,348,19,19,0,1,0
30,350,350,28,3,25,4,3
31,352,352,2,2,0,1,0
23,365,365,35,22,13,2,1
21,374,374,123,25,98,3,2
37,388,388,13,13,0,1,0
32,398,398,4,4,0,1,0
9,431,431,156,69,87,4,3
7,441,441,17,8,9,2,1
29,442,442,142,91,51,4,3
19,453,453,7,1,6,3,2
11,454,454,7,7,0,1,0
3,456,456,29,29,0,1,0
25,463,463,21,21,0,1,0
1,470,470,90,90,0,1,0
15,471,471,52,10,42,3,2
13,474,474,48,38,10,2,1
35,475,475,35,35,0,1,0
27,482,482,70,8,62,4,3
24,496,496,37,37,0,1,0

15,103,103,1,1,0,1,0
27,108,108,1,1,0,1,0
2,128,128,1,1,0,1,0
17,154,154,14,14,0,1,0
5,163,163,5,5,0,1,0
32,165,165,5,5,0,1,0
25,184,184,19,19,0,1,0
23,197,197,2,2,0,1,0
0,209,209,46,46,0,1,0
29,214,214,68,68,0,1,0
16,230,230,18,2,16,3,2
19,261,261,1,1,0,1,0
30,283,283,13,9,4,2,1
4,289,289,49,49,0,1,0
26,290,290,13,13,0,1,0
1,310,310,142,142,0,1,0
3,317,317,41,4,37,2,1
20,323,323,32,6,26,3,2
14,338,338,114,114,0,1,0
10,341,341,89,89,0,1,0
21,347,347,6,3,3,2,1
11,355,355,35,35,0,1,0
22,357,357,9,2,7,2,1
31,359,359,43,25,18,3,2
6,367,367,9,9,0,1,0
24,404,404,203,110,93,4,3
18,416,416,8,3,5,2,1
9,446,446,37,5,32,2,1
28,447,447,31,4,27,4,3
13,452,452,56,24,32,2,1
7,467,467,12,12,0,1,0
12,470,470,41,41,0,1,0
8,493,493,90,30,60,3,2

6,102,102,11,11,0,1,0
10,105,105,9,9,0,1,0
25,147,147,24,24,0,1,0
16,149,149,3,3,0,1,0
14,154,154,36,36,0,1,0
30,158,158,16,2,14,3,2
37,166,166,79,55,24,3,2
31,166,166,14,14,0,1,0
28,178,178,3,3,0,1,0
38,186,186,6,6,0,1,0
24,198,198,14,5,9,4,3
4,211,211,15,10,5,2,1
7,212,212,27,27,0,1,0
3,230,230,29,29,0,1,0
36,236,236,7,7,0,1,0
27,237,237,41,41,0,1,0
8,253,253,1,1,0,1,0
20,257,257,10,10,0,1,0
29,258,258,7,7,0,1,0
19,264,264,3,3,0,1,0
5,274,274,14,1,13,2,1
2,286,286,26,26,0,1,0
34,297,297,6,6,0,1,0
21,300,300,66,66,0,1,0
1,319,319,5,5,0,1,0
18,324,324,29,29,0,1,0
17,342,342,25,7,18,4,3
11,348,348,21,8,13,2,1
26,355,355,2,2,0,1,0
22,367,367,43,22,21,4,3
35,373,373,95,95,0,1,0
23,398,398,46,3,43,2,1
32,417,417,9,3,6,2,1
15,421,421,51,51,0,1,0
40,427,427,30,3,27,4,3
12,441,441,137,137,0,1,0
13,453,453,6,6,0,1,0
9,468,468,5,5,0,1,0
39,480,480,57,57,0,1,0
33,496,496,20,4,16,2,1
0,500,500,10,10,0,1,0

21,107,107,13,13,0,1,0
2,108,108,3,3,0,1,0
28,112,112,5,5,0,1,0
12,113,113,31,21,10,2,1
10,127,127,7,7,0,1,0
7,152,152,2,2,0,1,0
24,155,155,3,3,0,1,0
23,178,178,13,13,0,1,0
26,184,184,7,7,0,1,0
29,196,196,40,2,38,3,2
31,198,198,29,29,0,1,0
33,205,205,28,28,0,1,0
18,209,209,5,5,0,1,0
6,221,221,2,2,0,1,0
17,240,240,25,16,9,4,3
16,247,247,8,8,0,1,0
37,248,248,24,24,0,1,0
9,303,303,26,11,15,4,3
5,321,321,67,67,0,1,0
15,323,323,90,10,80,3,2
22,345,345,6,6,0,1,0
30,354,354,7,7,0,1,0
0,358,358,27,3,24,3,2
19,360,360,267,227,40,2,1
4,360,360,76,26,50,3,2
36,369,369,11,4,7,2,1
13,378,378,39,2,37,2,1
8,383,383,51,21,30,4,3
34,393,393,10,10,0,1,0
25,399,399,58,46,12,3,2
3,426,426,7,7,0,1,0
27,430,430,5,5,0,1,0
35,433,433,2,2,0,1,0
20,438,438,20,20,0,1,0
1,447,447,35,5,30,2,1
14,454,454,76,76,0,1,0
32,478,478,5,2,3,2,1
11,487,487,3,3,0,1,0

12,103,103,9,9,0,1,0
2,124,124,4,1,3,2,1
33,128,128,8,8,0,1,0
11,136,136,5,1,4,2,1
16,148,148,42,33,9,2,1
7,161,161,32,32,0,1,0
25,166,166,8,8,0,1,0
5,179,179,8,8,0,1,0
9,183,183,1,1,0,1,0
10,187,187,5,5,0,1,0
31,193,193,24,3,21,2,1
35,197,197,52,52,0,1,0
18,201,201,16,4,12,3,2
24,210,210,10,7,3,2,1
27,214,214,2,2,0,1,0
14,226,226,1,1,0,1,0
3,232,232,24,1,23,2,1
0,233,233,6,6,0,1,0
26,312,312,23,3,20,2,1
23,322,322,20,9,11,4,3
13,331,331,168,140,28,2,1
36,353,353,93,93,0,1,0
17,358,358,11,11,0,1,0
4,360,360,12,9,3,2,1
21,366,366,13,13,0,1,0
22,371,371,10,2,8,2,1
29,378,378,8,5,3,2,1
30,406,406,129,90,39,4,3
8,415,415,6,6,0,1,0
19,418,418,4,1,3,2,1
6,430,430,84,78,6,3,2
37,434,434,4,4,0,1,0
32,440,440,2,2,0,1,0
15,447,447,8,4,4,2,1
34,456,456,202,170,32,4,3
28,477,477,44,44,0,1,0
20,481,481,11,1,10,3,2
1,485,485,85,61,24,2,1

40,109,109,22,22,0,1,0
24,116,116,1,1,0,1,0
49,116,116,42,42,0,1,0
48,119,119,1,1,0,1,0
14,127,127,2,2,0,1,0
19,130,130,29,20,9,4,3
12,130,130,20,2,18,3,2
36,134,134,30,18,12,3,2
46,135,135,14,6,8,3,2
34,139,139,1,1,0,1,0
13,147,147,1,1,0,1,0
32,148,148,6,6,0,1,0
4,152,152,5,5,0,1,0
29,154,154,2,2,0,1,0
41,163,163,12,12,0,1,0
23,167,167,4,4,0,1,0
1,168,168,3,3,0,1,0
8,168,168,23,14,9,4,3
38,197,197,19,19,0,1,0
45,205,205,14,14,0,1,0
5,210,210,14,14,0,1,0
27,236,236,36,36,0,1,0
15,252,252,9,9,0,1,0
7,260,260,6,6,0,1,0
16,265,265,26,26,0,1,0
20,271,271,1,1,0,1,0
43,278,278,10,10,0,1,0
22,296,296,7,7,0,1,0
47,321,321,10,1,9,4,3
0,321,321,18,18,0,1,0
6,321,321,46,46,0,1,0
9,331,331,37,25,12,3,2
44,336,336,7,7,0,1,0
21,340,340,30,30,0,1,0
3,358,358,6,6,0,1,0
35,372,372,82,82,0,1,0
33,377,377,49,1,48,3,2
37,381,381,21,3,18,4,3
25,383,383,5,2,3,2,1
42,425,425,53,53,0,1,0
2,438,438,14,14,0,1,0
30,443,443,1,1,0,1,0
18,444,444,23,9,14,2,1
10,451,451,14,14,0,1,0
26,459,459,50,8,42,4,3
17,465,465,47,47,0,1,0
11,471,471,12,12,0,1,0
28,473,473,39,39,0,1,0
39,474,474,19,13,6,2,1
31,487,487,58,10,48,4,3

21,105,105,15,1,14,3,2
8,119,119,13,5,8,3,2
30,120,120,6,6,0,1,0
26,124,124,1,1,0,1,0
0,136,136,18,6,12,4,3
35,136,136,1,1,0,1,0
27,153,153,5,5,0,1,0
3,159,159,15,7,8,3,2
19,173,173,47,11,36,4,3
11,174,174,10,4,6,3,2
36,180,180,9,9,0,1,0
28,181,181,44,44,0,1,0
9,187,187,11,11,0,1,0
17,204,204,3,3,0,1,0
18,210,210,4,4,0,1,0
15,213,213,5,5,0,1,0
29,234,234,12,12,0,1,0
4,243,243,49,8,41,2,1
10,255,255,6,6,0,1,0
22,274,274,20,8,12,4,3
24,299,299,53,11,42,2,1
2,299,299,85,5,80,3,2
7,311,311,11,6,5,2,1
14,312,312,1,1,0,1,0
5,345,345,75,75,0,1,0
16,366,366,27,27,0,1,0
20,377,377,14,8,6,3,2
33,383,383,56,8,48,3,2
32,402,402,19,19,0,1,0
25,404,404,4,4,0,1,0
13,407,407,70,7,63,4,3
34,410,410,57,57,0,1,0
6,417,417,103,25,78,4,3
1,423,423,29,29,0,1,0
12,426,426,36,7,29,2,1
31,456,456,86,65,21,2,1
23,492,492,125,79,46,2,1

33,101,101,3,3,0,1,0
3,105,105,28,28,0,1,0
16,108,108,10,10,0,1,0
36,116,116,7,3,4,2,1
32,116,116,3,3,0,1,0
8,120,120,9,4,5,2,1
28,120,120,15,7,8,2,1
14,121,121,68,22,46,2,1
30,122,122,6,6,0,1,0
18,134,134,59,59,0,1,0
23,138,138,27,5,22,2,1
2,153,153,3,3,0,1,0
4,159,159,3,3,0,1,0
31,178,178,18,12,6,3,2
9,220,220,5,5,0,1,0
35,220,220,1,1,0,1,0
22,231,231,35,5,30,2,1
34,235,235,33,33,0,1,0
25,254,254,16,8,8,3,2
24,258,258,5,5,0,1,0
26,275,275,23,2,21,4,3
19,292,292,35,17,18,3,2
0,299,299,18,3,15,4,3
15,316,316,43,35,8,3,2
29,323,323,61,1,60,3,2
10,342,342,9,3,6,2,1
1,344,344,57,57,0,1,0
17,365,365,10,4,6,2,1
7,391,391,28,19,9,4,3
13,404,404,9,9,0,1,0
20,420,420,13,13,0,1,0
12,429,429,34,34,0,1,0
21,430,430,5,5,0,1,0
5,440,440,36,4,32,3,2
6,463,463,34,34,0,1,0
11,475,475,48,32,16,3,2
27,482,482,48,5,43,2,1

35,101,101,3,3,0,1,0
33,102,102,4,4,0,1,0
21,108,108,3,3,0,1,0
25,116,116,21,6,15,4,3
23,127,127,31,10,21,2,1
10,130,130,30,30,0,1,0
34,141,141,29,29,0,1,0
27,167,167,5,5,0,1,0
16,169,169,20,20,0,1,0
20,182,182,10,10,0,1,0
13,194,194,20,12,8,2,1
37,210,210,10,10,0,1,0
4,220,220,39,2,37,2,1
38,248,248,35,35,0,1,0
7,264,264,8,8,0,1,0
1,275,275,7,1,6,3,2
5,343,343,59,2,57,4,3
9,343,343,15,15,0,1,0
8,346,346,36,14,22,2,1
19,349,349,24,24,0,1,0
31,368,368,32,32,0,1,0
28,371,371,36,36,0,1,0
29,382,382,76,73,3,2,1
17,388,388,55,55,0,1,0
26,396,396,75,75,0,1,0
30,401,401,8,3,5,2,1
0,410,410,10,10,0,1,0
36,411,411,48,41,7,2,1
2,423,423,9,9,0,1,0
14,440,440,92,8,84,3,2
32,441,441,58,31,27,4,3
11,445,445,8,8,0,1,0
3,447,447,4,4,0,1,0
15,450,450,38,38,0,1,0
18,456,456,15,6,9,4,3
6,457,457,75,55,20,3,2
22,466,466,11,2,9,4,3
12,478,478,59,59,0,1,0
24,484,484,38,38,0,1,0

1,148,148,13,5,8,2,1
20,192,192,14,5,9,4,3
19,222,222,52,52,0,1,0
2,224,224,77,2,75,4,3
10,229,229,2,2,0,1,0
31,239,239,4,4,0,1,0
27,244,244,13,13,0,1,0
16,258,258,32,27,5,2,1
6,260,260,5,2,3,2,1
13,267,267,50,41,9,2,1
29,290,290,2,2,0,1,0
17,330,330,24,3,21,4,3
25,337,337,75,36,39,3,2
12,338,338,20,5,15,4,3
32,341,341,1,1,0,1,0
9,376,376,39,39,0,1,0
7,377,377,16,16,0,1,0
21,381,381,13,5,8,2,1
30,401,401,164,89,75,4,3
8,405,405,1,1,0,1,0
15,406,406,16,16,0,1,0
3,423,423,10,10,0,1,0
11,431,431,143,19,124,4,3
18,433,433,5,1,4,2,1
26,439,439,27,20,7,2,1
4,443,443,37,37,0,1,0
28,444,444,14,14,0,1,0
22,454,454,118,49,69,4,3
14,456,456,32,2,30,3,2
0,459,459,140,122,18,4,3
23,484,484,36,5,31,3,2
24,484,484,87,41,46,2,1
33,489,489,11,1,10,2,1
5,500,500,116,29,87,4,3

8,108,108,4,4,0,1,0
19,115,115,3,3,0,1,0
23,118,118,2,2,0,1,0
18,119,119,18,10,8,3,2
29,158,158,7,7,0,1,0
34,165,165,33,33,0,1,0
31,166,166,8,1,7,2,1
17,180,180,14,14,0,1,0
4,188,188,33,33,0,1,0
7,212,212,9,9,0,1,0
21,212,212,29,29,0,1,0
16,220,220,6,6,0,1,0
35,228,228,42,42,0,1,0
27,230,230,8,8,0,1,0
14,242,242,5,5,0,1,0
10,266,266,28,3,25,2,1
33,284,284,91,33,58,3,2
22,287,287,33,5,28,2,1
28,294,294,21,3,18,4,3
1,305,305,15,15,0,1,0
24,334,334,12,12,0,1,0
0,345,345,76,62,14,3,2
30,349,349,14,2,12,3,2
38,359,359,10,10,0,1,0
12,367,367,72,72,0,1,0
26,374,374,16,16,0,1,0
15,397,397,51,11,40,2,1
39,402,402,99,99,0,1,0
32,405,405,113,66,47,2,1
6,424,424,12,6,6,2,1
9,434,434,43,16,27,4,3
13,439,439,1,1,0,1,0
3,445,445,100,100,0,1,0
11,453,453,17,17,0,1,0
25,463,463,14,3,11,2,1
20,468,468,47,19,28,2,1
37,485,485,3,3,0,1,0
5,487,487,67,50,17,4,3
36,495,495,26,10,16,2,1
2,497,497,7,1,6,2,1

21,138,138,6,6,0,1,0
12,180,180,24,12,12,2,1
23,200,200,1,1,0,1,0
29,206,206,24,2,22,2,1
11,224,224,74,31,43,2,1
8,232,232,46,21,25,2,1
5,247,247,24,24,0,1,0
20,255,255,4,4,0,1,0
3,262,262,83,20,63,4,3
0,269,269,20,14,6,3,2
1,269,269,25,25,0,1,0
24,270,270,3,3,0,1,0
19,274,274,28,28,0,1,0
2,285,285,8,2,6,3,2
26,290,290,41,41,0,1,0
15,306,306,34,34,0,1,0
25,312,312,7,7,0,1,0
6,327,327,21,21,0,1,0
22,329,329,2,2,0,1,0
9,330,330,82,67,15,2,1
14,338,338,20,14,6,3,2
4,350,350,49,49,0,1,0
30,371,371,178,37,141,4,3
27,381,381,38,8,30,4,3
31,394,394,8,8,0,1,0
16,404,404,41,41,0,1,0
18,412,412,46,46,0,1,0
28,419,419,119,119,0,1,0
7,430,430,24,24,0,1,0
17,432,432,63,39,24,2,1
13,457,457,26,26,0,1,0
10,494,494,62,40,22,2,1

10,129,129,20,20,0,1,0
2,141,141,14,14,0,1,0
9,144,144,11,11,0,1,0
25,147,147,6,6,0,1,0
7,153,153,4,4,0,1,0
12,169,169,23,23,0,1,0
23,199,199,23,16,7,2,1
20,199,199,6,6,0,1,0
30,221,221,19,3,16,3,2
29,221,221,26,5,21,2,1
35,263,263,22,22,0,1,0
0,267,267,4,4,0,1,0
13,273,273,11,6,5,2,1
27,277,277,102,63,39,4,3
6,280,280,72,31,41,2,1
28,284,284,52,48,4,2,1
24,285,285,18,18,0,1,0
3,291,291,91,4,87,4,3
21,301,301,25,25,0,1,0
11,308,308,29,12,17,2,1
1,320,320,89,89,0,1,0
17,341,341,20,20,0,1,0
34,342,342,50,5,45,2,1
33,369,369,6,6,0,1,0
16,374,374,67,28,39,4,3
4,386,386,6,6,0,1,0
22,392,392,44,34,10,2,1
8,409,409,25,25,0,1,0
26,410,410,11,11,0,1,0
5,424,424,37,16,21,2,1
31,435,435,42,33,9,2,1
18,469,469,75,35,40,3,2
32,469,469,54,54,0,1,0
15,470,470,6,6,0,1,0
19,471,471,14,14,0,1,0
14,491,491,27,27,0,1,0

5,100,100,5,5,0,1,0
30,105,105,2,2,0,1,0
8,111,111,8,4,4,2,1
33,129,129,10,2,8,3,2
13,130,130,1,1,0,1,0
10,134,134,2,2,0,1,0
2,148,148,8,8,0,1,0
37,156,156,4,4,0,1,0
24,157,157,26,26,0,1,0
26,160,160,15,11,4,2,1
32,165,165,8,4,4,2,1
45,170,170,50,17,33,3,2
9,178,178,2,2,0,1,0
27,185,185,34,16,18,4,3
42,190,190,85,85,0,1,0
43,190,190,34,7,27,4,3
35,193,193,10,10,0,1,0
40,221,221,3,3,0,1,0
36,250,250,25,5,20,2,1
41,257,257,30,30,0,1,0
14,264,264,5,5,0,1,0
11,269,269,6,6,0,1,0
19,287,287,2,2,0,1,0
23,289,289,26,2,24,3,2
15,308,308,21,21,0,1,0
22,334,334,5,5,0,1,0
17,335,335,35,35,0,1,0
18,336,336,23,23,0,1,0
3,338,338,15,15,0,1,0
6,339,339,40,14,26,3,2
44,348,348,5,5,0,1,0
31,358,358,86,86,0,1,0
12,359,359,17,17,0,1,0
39,371,371,8,2,6,3,2
4,398,398,16,16,0,1,0
0,411,411,141,72,69,4,3
29,426,426,12,12,0,1,0
1,432,432,26,14,12,4,3
20,436,436,36,36,0,1,0
7,437,437,33,33,0,1,0
34,454,454,57,57,0,1,0
28,470,470,36,2,34,3,2
46,475,475,12,12,0,1,0
21,487,487,16,16,0,1,0
16,487,487,4,4,0,1,0
25,488,488,2,2,0,1,0
38,491,491,19,1,18,4,3

7,115,115,24,24,0,1,0
2,117,117,1,1,0,1,0
10,118,118,1,1,0,1,0
4,145,145,62,27,35,2,1
29,195,195,7,7,0,1,0
38,199,199,12,12,0,1,0
34,201,201,15,15,0,1,0
35,202,202,17,3,14,3,2
1,227,227,17,17,0,1,0
8,236,236,78,29,49,2,1
18,242,242,8,8,0,1,0
30,257,257,48,6,42,2,1
14,263,263,27,27,0,1,0
33,263,263,12,4,8,3,2
20,264,264,1,1,0,1,0
15,279,279,9,9,0,1,0
9,283,283,26,26,0,1,0
11,286,286,4,4,0,1,0
3,288,288,17,2,15,4,3
21,288,288,28,13,15,2,1
25,295,295,36,36,0,1,0
39,295,295,7,7,0,1,0
5,295,295,8,8,0,1,0
19,308,308,8,8,0,1,0
32,318,318,19,15,4,2,1
37,331,331,26,6,20,3,2
28,332,332,18,18,0,1,0
6,387,387,13,13,0,1,0
40,395,395,16,16,0,1,0
16,408,408,3,3,0,1,0
13,419,419,25,25,0,1,0
26,423,423,2,2,0,1,0
23,438,438,99,28,71,3,2
24,442,442,15,15,0,1,0
0,448,448,70,70,0,1,0
17,450,450,20,20,0,1,0
12,463,463,25,12,13,2,1
27,490,490,33,33,0,1,0
31,496,496,76,32,44,2,1
22,496,496,184,157,27,4,3
36,500,500,104,6,98,3,2

34,112,112,1,1,0,1,0
14,119,119,2,2,0,1,0
28,147,147,26,26,0,1,0
8,157,157,1,1,0,1,0
13,160,160,3,3,0,1,0
32,162,162,34,18,16,3,2
41,192,192,9,9,0,1,0
24,204,204,25,18,7,2,1
2,206,206,10,10,0,1,0
19,210,210,22,8,14,3,2
25,212,212,33,7,26,3,2
39,219,219,3,3,0,1,0
17,245,245,20,6,14,3,2
15,245,245,28,19,9,2,1
7,247,247,17,17,0,1,0
4,267,267,57,57,0,1,0
6,274,274,21,21,0,1,0
23,284,284,48,6,42,2,1
20,297,297,18,2,16,3,2
5,301,301,12,9,3,2,1
18,315,315,21,21,0,1,0
29,329,329,15,5,10,2,1
9,339,339,1,1,0,1,0
38,342,342,53,53,0,1,0
30,343,343,12,12,0,1,0
11,345,345,12,1,11,2,1
12,369,369,58,40,18,4,3
35,394,394,20,20,0,1,0
37,400,400,52,38,14,2,1
1,402,402,12,12,0,1,0
36,405,405,95,8,87,4,3
3,409,409,104,54,50,3,2
22,412,412,62,62,0,1,0
40,448,448,41,6,35,2,1
31,449,449,8,8,0,1,0
16,451,451,60,60,0,1,0
27,462,462,80,80,0,1,0
21,473,473,24,24,0,1,0
33,480,480,44,10,34,2,1
26,490,490,1,1,0,1,0
0,490,490,52,38,14,3,2
10,496,496,32,2,30,2,1

25,102,102,20,2,18,3,2
31,117,117,5,2,3,2,1
1,133,133,8,5,3,2,1
0,137,137,1,1,0,1,0
5,138,138,22,22,0,1,0
26,147,147,23,11,12,2,1
17,168,168,15,15,0,1,0
6,173,173,10,2,8,3,2
28,177,177,35,2,33,2,1
24,185,185,1,1,0,1,0
8,203,203,91,11,80,3,2
20,207,207,8,8,0,1,0
4,222,222,5,5,0,1,0
22,241,241,27,27,0,1,0
15,254,254,37,37,0,1,0
30,270,270,12,12,0,1,0
16,278,278,4,1,3,2,1
10,292,292,24,24,0,1,0
7,293,293,58,58,0,1,0
33,294,294,57,44,13,2,1
19,308,308,52,52,0,1,0
9,316,316,4,1,3,2,1
21,327,327,34,34,0,1,0
3,342,342,23,1,22,2,1
14,345,345,26,26,0,1,0
11,352,352,71,9,62,3,2
35,354,354,71,71,0,1,0
13,377,377,1,1,0,1,0
12,384,384,80,3,77,4,3
27,403,403,26,19,7,2,1
29,411,411,50,3,47,4,3
34,418,418,5,2,3,2,1
18,442,442,35,35,0,1,0
2,453,453,63,35,28,2,1
23,459,459,25,25,0,1,0
32,484,484,27,19,8,2,1

25,106,106,6,2,4,2,1
2,135,135,33,33,0,1,0
35,163,163,31,6,25,2,1
24,195,195,27,9,18,3,2
13,198,198,13,7,6,3,2
26,202,202,13,3,10,2,1
31,207,207,20,5,15,4,3
19,208,208,36,36,0,1,0
8,213,213,18,18,0,1,0
6,217,217,23,1,22,2,1
5,231,231,56,56,0,1,0
21,240,240,40,40,0,1,0
17,257,257,11,3,8,2,1
20,268,268,29,15,14,3,2
27,279,279,11,7,4,2,1
37,303,303,37,37,0,1,0
11,351,351,22,1,21,4,3
4,355,355,17,4,13,2,1
18,356,356,11,3,8,3,2
23,359,359,32,4,28,3,2
33,360,360,6,6,0,1,0
39,374,374,9,9,0,1,0
36,377,377,157,70,87,4,3
34,391,391,48,48,0,1,0
7,397,397,16,16,0,1,0
9,407,407,25,15,10,2,1
22,417,417,6,3,3,2,1
28,423,423,44,44,0,1,0
32,424,424,17,2,15,2,1
16,428,428,24,9,15,4,3
30,439,439,60,60,0,1,0
12,441,441,57,57,0,1,0
38,446,446,31,31,0,1,0
3,450,450,60,25,35,2,1
14,461,461,9,9,0,1,0
0,464,464,18,10,8,2,1
15,465,465,1,1,0,1,0
29,479,479,16,16,0,1,0
10,486,486,21,18,3,2,1
1,492,492,84,84,0,1,0

25,182,182,9,4,5,2,1
27,202,202,27,20,7,2,1
3,209,209,25,22,3,2,1
6,218,218,11,7,4,2,1
10,233,233,75,75,0,1,0
29,233,233,3,3,0,1,0
11,238,238,43,36,7,2,1
20,250,250,35,12,23,4,3
14,253,253,35,11,24,3,2
21,258,258,17,17,0,1,0
28,270,270,26,12,14,2,1
23,302,302,2,2,0,1,0
12,304,304,13,3,10,2,1
32,306,306,55,55,0,1,0
22,308,308,60,60,0,1,0
9,310,310,2,2,0,1,0
7,316,316,20,8,12,2,1
26,319,319,62,33,29,2,1
31,354,354,15,5,10,3,2
0,359,359,37,37,0,1,0
16,368,368,106,106,0,1,0
1,400,400,147,93,54,4,3
17,401,401,9,9,0,1,0
15,431,431,78,63,15,4,3
5,431,431,80,80,0,1,0
24,437,437,10,4,6,2,1
19,442,442,68,42,26,3,2
13,448,448,29,29,0,1,0
2,464,464,26,26,0,1,0
18,473,473,1,1,0,1,0
8,479,479,45,45,0,1,0
4,484,484,53,53,0,1,0
33,491,491,45,36,9,4,3
30,497,497,26,2,24,4,3

11,108,108,6,3,3,2,1
0,116,116,19,4,15,2,1
28,119,119,6,6,0,1,0
4,128,128,12,12,0,1,0
27,131,131,2,2,0,1,0
26,138,138,8,1,7,3,2
29,139,139,20,20,0,1,0
23,145,145,8,2,6,2,1
31,148,148,3,3,0,1,0
19,151,151,11,11,0,1,0
18,185,185,41,41,0,1,0
16,196,196,33,33,0,1,0
33,206,206,2,2,0,1,0
25,214,214,27,9,18,4,3
24,224,224,39,39,0,1,0
3,226,226,2,2,0,1,0
15,231,231,35,35,0,1,0
1,245,245,9,1,8,3,2
34,262,262,30,6,24,4,3
20,265,265,55,55,0,1,0
7,265,265,14,1,13,2,1
9,267,267,19,19,0,1,0
35,293,293,22,22,0,1,0
13,306,306,12,12,0,1,0
22,332,332,49,49,0,1,0
2,342,342,121,88,33,2,1
21,355,355,24,14,10,3,2
8,361,361,48,6,42,3,2
5,365,365,13,1,12,2,1
6,396,396,18,3,15,2,1
32,417,417,94,7,87,4,3
17,435,435,60,60,0,1,0
10,443,443,1,1,0,1,0
12,466,466,134,26,108,4,3
14,469,469,96,20,76,3,2
30,496,496,11,11,0,1,0

43,100,100,8,4,4,2,1
32,105,105,25,21,4,2,1
5,110,110,1,1,0,1,0
28,113,113,8,8,0,1,0
6,115,115,8,1,7,2,1
14,125,125,24,2,22,3,2
45,128,128,4,4,0,1,0
9,136,136,9,9,0,1,0
17,143,143,4,4,0,1,0
2,148,148,7,7,0,1,0
46,164,164,11,2,9,2,1
7,193,193,7,1,6,2,1
22,202,202,11,3,8,2,1
16,218,218,14,14,0,1,0
0,220,220,8,8,0,1,0
13,225,225,1,1,0,1,0
11,233,233,9,9,0,1,0
40,249,249,5,5,0,1,0
4,254,254,36,36,0,1,0
30,265,265,2,2,0,1,0
39,277,277,19,15,4,2,1
29,277,277,16,16,0,1,0
18,287,287,7,7,0,1,0
44,289,289,34,11,23,2,1
10,293,293,28,28,0,1,0
38,295,295,64,1,63,4,3
41,300,300,27,7,20,3,2
24,301,301,37,29,8,2,1
31,311,311,28,28,0,1,0
20,312,312,35,17,18,3,2
35,333,333,14,14,0,1,0
27,342,342,9,9,0,1,0
8,346,346,10,10,0,1,0
15,347,347,9,1,8,2,1
3,358,358,22,15,7,2,1
26,359,359,40,40,0,1,0
36,360,360,46,46,0,1,0
12,388,388,21,7,14,3,2
21,416,416,10,7,3,2,1
33,423,423,72,72,0,1,0
19,424,424,47,47,0,1,0
23,433,433,1,1,0,1,0
42,444,444,47,39,8,2,1
25,450,450,73,43,30,2,1
47,451,451,56,56,0,1,0
37,485,485,96,96,0,1,0
34,495,495,38,7,31,2,1
1,495,495,41,13,28,2,1

2,108,108,19,5,14,2,1
34,127,127,26,26,0,1,0
33,145,145,2,2,0,1,0
9,155,155,20,20,0,1,0
5,170,170,18,1,17,2,1
29,175,175,6,3,3,2,1
14,179,179,1,1,0,1,0
25,186,186,14,14,0,1,0
23,201,201,4,1,3,2,1
17,202,202,7,7,0,1,0
32,213,213,55,3,52,3,2
24,224,224,15,3,12,4,3
0,225,225,33,28,5,2,1
31,228,228,5,5,0,1,0
13,233,233,11,11,0,1,0
36,234,234,3,3,0,1,0
8,240,240,27,27,0,1,0
19,246,246,7,1,6,3,2
16,265,265,34,34,0,1,0
12,275,275,16,16,0,1,0
37,279,279,8,4,4,2,1
18,321,321,7,7,0,1,0
6,348,348,2,2,0,1,0
38,349,349,20,20,0,1,0
10,359,359,26,2,24,3,2
27,364,364,145,145,0,1,0
4,374,374,85,67,18,4,3
28,384,384,75,75,0,1,0
21,400,400,58,58,0,1,0
1,402,402,8,8,0,1,0
26,404,404,39,9,30,2,1
39,416,416,40,40,0,1,0
7,423,423,41,29,12,4,3
35,426,426,45,45,0,1,0
20,426,426,104,27,77,4,3
11,434,434,7,7,0,1,0
30,440,440,28,28,0,1,0
3,448,448,36,36,0,1,0
22,455,455,23,23,0,1,0
15,496,496,72,44,28,3,2

33,107,107,14,14,0,1,0
15,107,107,25,20,5,2,1
9,108,108,21,3,18,2,1
11,108,108,1,1,0,1,0
12,113,113,14,14,0,1,0
20,127,127,12,3,9,4,3
24,139,139,4,4,0,1,0
34,155,155,13,13,0,1,0
17,155,155,64,47,17,2,1
27,170,170,4,4,0,1,0
23,178,178,11,11,0,1,0
3,199,199,9,9,0,1,0
0,223,223,15,15,0,1,0
30,225,225,1,1,0,1,0
2,278,278,27,7,20,3,2
8,286,286,32,12,20,3,2
6,287,287,116,80,36,2,1
19,291,291,38,38,0,1,0
16,306,306,6,3,3,2,1
29,316,316,19,19,0,1,0
7,320,320,13,13,0,1,0
28,320,320,46,40,6,3,2
21,333,333,43,7,36,4,3
25,342,342,22,22,0,1,0
18,346,346,14,14,0,1,0
10,363,363,29,2,27,4,3
22,366,366,26,26,0,1,0
14,370,370,2,2,0,1,0
26,436,436,61,61,0,1,0
5,458,458,35,35,0,1,0
31,460,460,109,4,105,4,3
1,475,475,43,43,0,1,0
32,477,477,32,5,27,2,1
4,484,484,131,37,94,4,3
13,498,498,29,29,0,1,0

0,100,100,5,1,4,2,1
3,120,120,14,14,0,1,0
20,122,122,17,17,0,1,0
35,124,124,21,2,19,4,3
18,134,134,28,10,18,2,1
5,135,135,8,8,0,1,0
13,135,135,13,13,0,1,0
23,141,141,9,9,0,1,0
10,145,145,30,30,0,1,0
4,160,160,38,6,32,3,2
36,172,172,5,5,0,1,0
9,176,176,9,9,0,1,0
31,182,182,1,1,0,1,0
29,220,220,9,3,6,3,2
24,224,224,3,3,0,1,0
19,224,224,3,3,0,1,0
33,241,241,109,109,0,1,0
2,250,250,20,20,0,1,0
11,269,269,71,48,23,2,1
7,271,271,62,45,17,2,1
21,278,278,25,13,12,2,1
16,283,283,13,2,11,2,1
15,307,307,48,38,10,3,2
12,316,316,1,1,0,1,0
30,350,350,6,6,0,1,0
28,356,356,21,6,15,3,2
8,373,373,27,19,8,3,2
22,407,407,154,154,0,1,0
25,410,410,43,28,15,4,3
34,431,431,7,2,5,2,1
14,436,436,31,31,0,1,0
32,448,448,4,4,0,1,0
27,451,451,2,2,0,1,0
26,475,475,61,44,17,2,1
17,485,485,5,5,0,1,0
6,488,488,8,3,5,2,1
1,493,493,67,37,30,2,1

18,103,103,6,1,5,2,1
21,109,109,2,2,0,1,0
17,112,112,6,6,0,1,0
37,115,115,1,1,0,1,0
14,138,138,4,4,0,1,0
29,140,140,40,40,0,1,0
32,148,148,20,20,0,1,0
38,159,159,2,2,0,1,0
34,163,163,9,9,0,1,0
4,173,173,6,6,0,1,0
41,208,208,5,5,0,1,0
13,225,225,2,2,0,1,0
27,225,225,92,83,9,4,3
15,227,227,2,2,0,1,0
0,227,227,66,32,34,2,1
28,232,232,75,75,0,1,0
22,238,238,29,29,0,1,0
33,257,257,20,5,15,4,3
12,260,260,19,19,0,1,0
2,274,274,2,2,0,1,0
11,275,275,24,9,15,4,3
36,278,278,10,10,0,1,0
43,282,282,15,9,6,2,1
40,311,311,49,49,0,1,0
23,317,317,23,2,21,2,1
8,319,319,18,18,0,1,0
35,333,333,2,2,0,1,0
6,358,358,43,43,0,1,0
9,365,365,25,25,0,1,0
20,369,369,17,2,15,2,1
7,375,375,6,6,0,1,0
16,377,377,5,5,0,1,0
24,385,385,27,27,0,1,0
19,387,387,129,33,96,4,3
42,388,388,19,12,7,3,2
5,405,405,43,43,0,1,0
3,417,417,17,1,16,2,1
31,438,438,73,73,0,1,0
1,440,440,16,12,4,2,1
26,443,443,11,5,6,2,1
10,452,452,59,59,0,1,0
25,454,454,1,1,0,1,0
39,466,466,41,41,0,1,0
30,470,470,13,13,0,1,0

28,117,117,9,9,0,1,0
30,126,126,14,14,0,1,0
23,135,135,1,1,0,1,0
12,135,135,8,8,0,1,0
16,156,156,7,4,3,2,1
24,165,165,1,1,0,1,0
40,166,166,3,3,0,1,0
3,180,180,10,7,3,2,1
7,185,185,12,12,0,1,0
9,196,196,15,15,0,1,0
31,202,202,87,87,0,1,0
21,212,212,8,8,0,1,0
25,218,218,4,4,0,1,0
19,222,222,19,19,0,1,0
39,229,229,6,6,0,1,0
10,229,229,55,55,0,1,0
32,245,245,5,5,0,1,0
38,249,249,43,2,41,2,1
33,260,260,5,5,0,1,0
35,270,270,5,5,0,1,0
11,277,277,8,1,7,2,1
15,280,280,39,39,0,1,0
4,286,286,11,6,5,2,1
27,288,288,19,9,10,2,1
6,291,291,6,6,0,1,0
18,293,293,31,31,0,1,0
22,302,302,11,11,0,1,0
5,317,317,1,1,0,1,0
36,324,324,18,12,6,3,2
26,337,337,6,6,0,1,0
0,345,345,1,1,0,1,0
37,371,371,178,178,0,1,0
1,383,383,46,46,0,1,0
17,383,383,72,14,58,3,2
14,387,387,94,94,0,1,0
8,419,419,29,29,0,1,0
20,427,427,15,15,0,1,0
13,432,432,73,73,0,1,0
34,432,432,27,27,0,1,0
29,472,472,139,61,78,4,3
2,489,489,36,21,15,2,1

25,124,124,7,7,0,1,0
33,136,136,3,3,0,1,0
2,145,145,11,3,8,2,1
28,156,156,9,6,3,2,1
36,160,160,7,4,3,2,1
14,163,163,2,2,0,1,0
35,182,182,11,8,3,2,1
21,188,188,21,7,14,3,2
26,199,199,23,3,20,3,2
27,201,201,11,11,0,1,0
3,213,213,2,2,0,1,0
15,219,219,34,4,30,3,2
29,222,222,2,2,0,1,0
8,225,225,1,1,0,1,0
17,240,240,46,10,36,2,1
11,264,264,30,30,0,1,0
24,280,280,33,1,32,4,3
20,283,283,5,5,0,1,0
23,289,289,27,12,15,2,1
16,302,302,2,2,0,1,0
7,335,335,48,23,25,2,1
32,354,354,162,74,88,3,2
38,357,357,6,6,0,1,0
34,358,358,29,7,22,2,1
13,367,367,33,10,23,2,1
31,380,380,86,86,0,1,0
18,384,384,42,20,22,3,2
19,385,385,120,120,0,1,0
37,394,394,21,21,0,1,0
12,407,407,33,33,0,1,0
30,414,414,89,89,0,1,0
0,419,419,30,3,27,2,1
6,421,421,2,2,0,1,0
5,448,448,2,2,0,1,0
1,465,465,6,6,0,1,0
4,472,472,70,7,63,4,3
9,480,480,126,74,52,3,2
22,492,492,64,64,0,1,0
10,492,492,46,46,0,1,0

18,105,105,14,4,10,3,2
27,107,107,22,16,6,3,2
7,113,113,5,2,3,2,1
12,124,124,14,1,13,3,2
31,140,140,11,11,0,1,0
13,145,145,2,2,0,1,0
5,165,165,42,31,11,2,1
2,166,166,5,5,0,1,0
4,176,176,49,49,0,1,0
29,180,180,25,21,4,2,1
20,192,192,4,1,3,2,1
8,194,194,87,87,0,1,0
14,202,202,40,40,0,1,0
24,211,211,25,16,9,2,1
28,234,234,4,4,0,1,0
10,238,238,3,3,0,1,0
15,244,244,14,11,3,2,1
19,252,252,16,5,11,2,1
22,256,256,9,6,3,2,1
25,267,267,50,15,35,2,1
32,295,295,5,5,0,1,0
0,322,322,65,65,0,1,0
1,327,327,25,25,0,1,0
17,334,334,15,15,0,1,0
16,367,367,37,37,0,1,0
11,369,369,27,27,0,1,0
30,371,371,12,3,9,4,3
33,388,388,68,25,43,2,1
6,410,410,11,6,5,2,1
34,425,425,113,62,51,4,3
26,429,429,103,17,86,4,3
23,441,441,1,1,0,1,0
3,446,446,17,17,0,1,0
21,470,470,29,17,12,4,3
9,483,483,17,8,9,4,3

11,122,122,5,5,0,1,0
23,126,126,4,4,0,1,0
17,131,131,10,1,9,2,1
1,131,131,20,20,0,1,0
18,133,133,27,27,0,1,0
26,143,143,10,6,4,2,1
38,160,160,41,5,36,2,1
6,182,182,22,22,0,1,0
4,193,193,100,10,90,3,2
41,197,197,1,1,0,1,0
9,197,197,19,4,15,4,3
16,200,200,2,2,0,1,0
25,202,202,6,6,0,1,0
27,217,217,2,2,0,1,0
8,234,234,1,1,0,1,0
15,246,246,12,12,0,1,0
2,248,248,6,3,3,2,1
35,251,251,1,1,0,1,0
31,252,252,24,24,0,1,0
5,255,255,26,22,4,2,1
3,262,262,24,4,20,3,2
40,267,267,5,5,0,1,0
13,281,281,5,5,0,1,0
20,291,291,13,13,0,1,0
28,296,296,12,12,0,1,0
19,308,308,16,5,11,3,2
29,309,309,122,74,48,4,3
22,318,318,16,16,0,1,0
32,323,323,35,1,34,2,1
10,323,323,21,21,0,1,0
37,327,327,78,78,0,1,0
14,328,328,30,16,14,2,1
7,353,353,7,4,3,2,1
21,358,358,4,4,0,1,0
30,362,362,37,4,33,3,2
34,382,382,106,106,0,1,0
12,405,405,17,17,0,1,0
24,415,415,14,5,9,2,1
36,434,434,15,10,5,2,1
0,453,453,8,8,0,1,0
39,456,456,49,25,24,3,2
33,482,482,40,34,6,2,1

23,111,111,9,9,0,1,0
20,113,113,5,5,0,1,0
0,175,175,23,8,15,2,1
14,185,185,50,34,16,4,3
25,191,191,19,4,15,2,1
22,219,219,25,13,12,4,3
1,221,221,29,22,7,2,1
26,224,224,18,18,0,1,0
7,236,236,44,31,13,2,1
5,248,248,16,10,6,3,2
4,251,251,114,41,73,3,2
11,260,260,23,23,0,1,0
28,261,261,20,20,0,1,0
17,271,271,1,1,0,1,0
8,284,284,56,46,10,2,1
6,325,325,29,29,0,1,0
29,326,326,7,1,6,3,2
24,331,331,19,13,6,2,1
10,333,333,22,2,20,3,2
13,336,336,57,57,0,1,0
15,342,342,32,16,16,2,1
21,358,358,88,88,0,1,0
3,375,375,4,1,3,2,1
27,382,382,44,44,0,1,0
32,389,389,56,49,7,2,1
9,394,394,63,63,0,1,0
30,398,398,10,4,6,2,1
31,403,403,7,7,0,1,0
12,421,421,48,17,31,2,1
19,428,428,28,28,0,1,0
2,428,428,17,17,0,1,0
16,456,456,40,9,31,2,1
18,475,475,145,22,123,4,3

2,100,100,21,13,8,3,2
32,109,109,2,2,0,1,0
39,130,130,2,2,0,1,0
35,138,138,7,7,0,1,0
43,144,144,14,14,0,1,0
40,147,147,35,35,0,1,0
14,151,151,26,8,18,2,1
30,152,152,3,3,0,1,0
13,179,179,5,2,3,2,1
31,188,188,24,24,0,1,0
38,198,198,11,11,0,1,0
21,209,209,15,15,0,1,0
6,222,222,3,3,0,1,0
36,225,225,62,62,0,1,0
15,225,225,19,9,10,2,1
17,233,233,35,35,0,1,0
9,244,244,11,11,0,1,0
22,284,284,1,1,0,1,0
1,310,310,23,23,0,1,0
42,316,316,31,4,27,2,1
8,319,319,17,11,6,2,1
25,336,336,21,21,0,1,0
29,342,342,30,30,0,1,0
34,363,363,80,4,76,3,2
23,380,380,20,5,15,4,3
11,387,387,73,73,0,1,0
20,400,400,83,34,49,4,3
28,404,404,76,37,39,4,3
5,417,417,32,10,22,2,1
27,431,431,35,35,0,1,0
37,432,432,30,8,22,2,1
41,433,433,32,9,23,4,3
24,434,434,48,48,0,1,0
26,436,436,23,13,10,3,2
12,441,441,17,17,0,1,0
19,447,447,16,16,0,1,0
16,448,448,13,13,0,1,0
10,453,453,2,2,0,1,0
18,466,466,67,67,0,1,0
4,469,469,22,2,20,2,1
33,478,478,51,18,33,4,3
3,485,485,13,13,0,1,0
0,486,486,1,1,0,1,0
7,490,490,15,15,0,1,0

1,111,111,15,6,9,2,1
7,115,115,2,2,0,1,0
13,133,133,21,11,10,3,2
10,134,134,20,7,13,2,1
31,135,135,62,62,0,1,0
8,135,135,4,4,0,1,0
19,155,155,9,9,0,1,0
26,164,164,12,2,10,3,2
20,167,167,2,2,0,1,0
18,186,186,2,2,0,1,0
29,197,197,4,1,3,2,1
35,216,216,65,65,0,1,0
34,220,220,25,10,15,4,3
6,234,234,6,6,0,1,0
5,236,236,3,3,0,1,0
24,246,246,18,13,5,2,1
17,248,248,16,16,0,1,0
30,265,265,16,7,9,2,1
36,277,277,20,11,9,2,1
21,297,297,18,6,12,2,1
38,299,299,22,6,16,2,1
12,299,299,23,6,17,2,1
11,302,302,51,27,24,2,1
14,303,303,15,15,0,1,0
40,320,320,3,3,0,1,0
33,330,330,43,43,0,1,0
27,340,340,21,11,10,3,2
23,362,362,71,71,0,1,0
41,368,368,19,10,9,2,1
25,368,368,41,41,0,1,0
9,383,383,13,13,0,1,0
42,401,401,24,24,0,1,0
32,409,409,21,21,0,1,0
16,414,414,55,25,30,2,1
28,422,422,56,8,48,4,3
15,426,426,68,8,60,3,2
3,429,429,24,1,23,2,1
37,443,443,16,9,7,2,1
0,444,444,29,29,0,1,0
2,461,461,43,43,0,1,0
22,464,464,24,3,21,3,2
39,475,475,20,20,0,1,0
4,494,494,42,42,0,1,0

6,100,100,1,1,0,1,0
4,102,102,15,15,0,1,0
35,104,104,11,7,4,2,1
11,114,114,7,7,0,1,0
8,121,121,19,4,15,4,3
3,132,132,10,10,0,1,0
37,138,138,7,7,0,1,0
19,158,158,1,1,0,1,0
33,212,212,23,7,16,4,3
7,237,237,19,19,0,1,0
28,243,243,4,4,0,1,0
16,248,248,9,9,0,1,0
14,250,250,25,25,0,1,0
2,269,269,36,4,32,4,3
5,287,287,79,32,47,2,1
32,291,291,7,7,0,1,0
23,301,301,10,4,6,2,1
22,326,326,35,19,16,2,1
9,333,333,49,14,35,2,1
12,343,343,24,4,20,2,1
24,357,357,2,2,0,1,0
29,362,362,11,11,0,1,0
30,375,375,35,35,0,1,0
27,377,377,62,40,22,2,1
18,381,381,62,36,26,2,1
1,405,405,78,32,46,3,2
34,432,432,103,103,0,1,0
20,439,439,163,94,69,4,3
10,447,447,18,18,0,1,0
0,449,449,44,2,42,4,3
25,452,452,48,31,17,2,1
36,458,458,64,20,44,2,1
26,459,459,34,20,14,3,2
15,463,463,41,20,21,4,3
17,472,472,4,4,0,1,0
13,484,484,6,6,0,1,0
21,484,484,6,6,0,1,0
31,485,485,3,3,0,1,0
38,497,497,121,101,20,3,2

32,100,100,29,29,0,1,0
24,108,108,5,5,0,1,0
1,111,111,28,28,0,1,0
15,116,116,4,4,0,1,0
25,127,127,17,17,0,1,0
18,130,130,9,9,0,1,0
5,133,133,8,1,7,2,1
12,134,134,18,6,12,3,2
31,174,174,26,2,24,3,2
8,176,176,37,1,36,3,2
35,180,180,18,9,9,2,1
10,192,192,76,76,0,1,0
19,201,201,6,3,3,2,1
2,212,212,3,3,0,1,0
26,227,227,42,42,0,1,0
33,232,232,16,2,14,2,1
22,255,255,28,4,24,4,3
17,255,255,18,18,0,1,0
29,262,262,10,10,0,1,0
23,310,310,61,29,32,4,3
34,310,310,10,10,0,1,0
30,315,315,6,2,4,2,1
14,325,325,5,1,4,2,1
20,327,327,8,8,0,1,0
13,333,333,9,9,0,1,0
3,335,335,75,60,15,2,1
0,347,347,3,3,0,1,0
7,353,353,41,41,0,1,0
6,427,427,26,26,0,1,0
9,433,433,4,4,0,1,0
27,440,440,76,56,20,3,2
16,442,442,58,58,0,1,0
28,453,453,62,18,44,2,1
21,460,460,37,25,12,2,1
4,474,474,58,21,37,2,1
11,487,487,41,4,37,3,2

30,108,108,25,13,12,4,3
27,113,113,9,1,8,2,1
8,117,117,1,1,0,1,0
20,120,120,3,3,0,1,0
21,124,124,27,8,19,2,1
3,129,129,2,2,0,1,0
19,151,151,25,25,0,1,0
35,158,158,19,19,0,1,0
16,164,164,8,8,0,1,0
9,173,173,18,18,0,1,0
17,174,174,5,5,0,1,0
42,181,181,11,11,0,1,0
15,182,182,22,22,0,1,0
36,185,185,26,8,18,3,2
41,204,204,30,30,0,1,0
43,224,224,5,5,0,1,0
29,227,227,3,3,0,1,0
10,233,233,25,25,0,1,0
4,237,237,12,12,0,1,0
39,241,241,1,1,0,1,0
13,243,243,6,6,0,1,0
5,254,254,4,4,0,1,0
7,260,260,11,11,0,1,0
33,281,281,14,14,0,1,0
2,282,282,66,66,0,1,0
25,295,295,34,34,0,1,0
22,295,295,10,10,0,1,0
34,310,310,3,3,0,1,0
14,350,350,61,51,10,3,2
1,353,353,20,8,12,3,2
11,364,364,42,6,36,3,2
24,373,373,9,9,0,1,0
38,376,376,107,83,24,3,2
28,392,392,13,13,0,1,0
12,400,400,5,2,3,2,1
26,423,423,43,43,0,1,0
40,426,426,38,10,28,2,1
31,428,428,41,41,0,1,0
23,444,444,39,39,0,1,0
6,444,444,11,11,0,1,0
0,458,458,55,25,30,2,1
32,479,479,97,13,84,4,3
37,480,480,67,39,28,2,1
18,492,492,21,21,0,1,0

3,100,100,11,3,8,2,1
22,132,132,9,9,0,1,0
20,132,132,3,3,0,1,0
9,141,141,7,1,6,3,2
5,152,152,38,38,0,1,0
6,157,157,8,8,0,1,0
19,161,161,10,10,0,1,0
18,171,171,7,1,6,3,2
31,180,180,3,3,0,1,0
17,184,184,32,32,0,1,0
26,205,205,16,6,10,3,2
14,210,210,26,26,0,1,0
30,218,218,17,4,13,2,1
25,227,227,16,6,10,3,2
29,257,257,7,7,0,1,0
1,301,301,23,23,0,1,0
7,308,308,97,34,63,3,2
10,311,311,141,98,43,2,1
28,318,318,25,25,0,1,0
12,325,325,35,6,29,2,1
15,332,332,19,5,14,3,2
13,342,342,226,192,34,2,1
8,351,351,5,1,4,2,1
23,355,355,66,62,4,2,1
0,373,373,27,27,0,1,0
11,383,383,5,5,0,1,0
16,402,402,14,14,0,1,0
21,406,406,15,2,13,2,1
2,429,429,89,89,0,1,0
27,460,460,48,48,0,1,0
24,478,478,11,11,0,1,0
4,494,494,89,52,37,4,3

12,104,104,23,23,0,1,0
15,107,107,19,19,0,1,0
34,114,114,2,2,0,1,0
32,130,130,8,8,0,1,0
6,170,170,25,25,0,1,0
0,179,179,6,2,4,2,1
26,186,186,18,18,0,1,0
8,197,197,9,3,6,2,1
20,201,201,7,3,4,2,1
2,212,212,6,6,0,1,0
16,218,218,35,35,0,1,0
10,221,221,1,1,0,1,0
18,227,227,18,1,17,2,1
31,238,238,29,17,12,3,2
23,239,239,10,10,0,1,0
21,243,243,5,1,4,2,1
7,253,253,34,8,26,2,1
14,262,262,9,2,7,2,1
3,305,305,128,94,34,3,2
33,309,309,86,5,81,4,3
24,316,316,13,1,12,2,1
22,321,321,11,11,0,1,0
17,331,331,2,2,0,1,0
36,342,342,43,21,22,3,2
13,342,342,14,14,0,1,0
9,420,420,94,11,83,4,3
29,425,425,63,14,49,2,1
27,432,432,91,52,39,4,3
35,458,458,95,95,0,1,0
30,459,459,52,23,29,3,2
5,462,462,14,14,0,1,0
4,462,462,18,1,17,2,1
25,466,466,8,8,0,1,0
1,480,480,61,61,0,1,0
11,484,484,13,13,0,1,0
19,486,486,20,20,0,1,0
28,490,490,119,15,104,4,3

4,112,112,2,2,0,1,0
1,131,131,10,2,8,2,1
17,148,148,13,13,0,1,0
5,161,161,12,12,0,1,0
27,183,183,4,4,0,1,0
30,205,205,12,4,8,2,1
2,208,208,1,1,0,1,0
12,221,221,23,23,0,1,0
8,233,233,12,12,0,1,0
9,235,235,85,68,17,4,3
21,246,246,11,1,10,3,2
11,251,251,24,24,0,1,0
18,255,255,55,17,38,3,2
20,262,262,24,6,18,4,3
0,263,263,151,114,37,2,1
7,279,279,6,2,4,2,1
14,292,292,60,28,32,2,1
15,298,298,39,3,36,2,1
26,303,303,30,8,22,3,2
16,338,338,1,1,0,1,0
19,343,343,19,19,0,1,0
23,349,349,33,33,0,1,0
6,361,361,55,55,0,1,0
13,362,362,3,3,0,1,0
10,368,368,5,5,0,1,0
3,375,375,129,129,0,1,0
31,396,396,23,13,10,3,2
29,400,400,3,3,0,1,0
24,403,403,73,1,72,3,2
25,411,411,45,45,0,1,0
32,416,416,66,8,58,3,2
22,456,456,120,81,39,4,3
28,474,474,20,14,6,2,1

17,101,101,1,1,0,1,0
32,106,106,15,15,0,1,0
34,114,114,1,1,0,1,0
29,116,116,6,6,0,1,0
0,126,126,27,27,0,1,0
38,150,150,29,21,8,2,1
27,169,169,61,61,0,1,0
33,172,172,3,3,0,1,0
11,173,173,15,15,0,1,0
6,184,184,2,2,0,1,0
15,184,184,30,30,0,1,0
7,192,192,22,22,0,1,0
25,193,193,8,2,6,2,1
1,196,196,36,1,35,4,3
28,208,208,4,4,0,1,0
23,222,222,9,9,0,1,0
4,253,253,8,8,0,1,0
2,271,271,59,59,0,1,0
22,302,302,77,77,0,1,0
21,316,316,1,1,0,1,0
36,338,338,49,34,15,4,3
14,357,357,6,6,0,1,0
12,370,370,17,8,9,4,3
20,375,375,15,15,0,1,0
3,377,377,48,31,17,2,1
10,383,383,9,9,0,1,0
37,385,385,50,50,0,1,0
26,389,389,27,18,9,2,1
16,396,396,46,10,36,2,1
24,416,416,25,25,0,1,0
18,425,425,30,14,16,3,2
31,432,432,16,16,0,1,0
19,436,436,83,53,30,4,3
5,441,441,7,2,5,2,1
8,454,454,1,1,0,1,0
13,466,466,86,68,18,3,2
9,480,480,36,7,29,3,2
35,484,484,77,47,30,2,1
30,489,489,78,25,53,3,2

11,131,131,15,15,0,1,0
5,138,138,17,7,10,2,1
18,142,142,8,5,3,2,1
7,159,159,23,23,0,1,0
2,160,160,12,5,7,2,1
20,167,167,24,10,14,3,2
21,177,177,12,1,11,2,1
26,198,198,7,7,0,1,0
12,216,216,60,60,0,1,0
17,221,221,6,6,0,1,0
33,244,244,49,49,0,1,0
1,244,244,57,57,0,1,0
24,244,244,11,1,10,2,1
22,265,265,2,2,0,1,0
30,284,284,22,4,18,2,1
15,292,292,31,31,0,1,0
10,296,296,10,10,0,1,0
9,302,302,37,37,0,1,0
34,332,332,48,5,43,3,2
8,334,334,13,13,0,1,0
19,336,336,59,27,32,2,1
25,339,339,28,28,0,1,0
0,347,347,103,103,0,1,0
13,366,366,8,8,0,1,0
4,393,393,13,13,0,1,0
6,417,417,49,49,0,1,0
28,424,424,70,24,46,3,2
16,426,426,126,6,120,4,3
31,432,432,23,23,0,1,0
29,440,440,14,9,5,2,1
32,442,442,48,6,42,4,3
14,447,447,31,10,21,3,2
3,467,467,43,43,0,1,0
27,469,469,29,8,21,4,3
23,493,493,75,75,0,1,0

33,113,113,4,4,0,1,0
30,114,114,2,2,0,1,0
11,121,121,17,2,15,2,1
2,146,146,4,4,0,1,0
26,160,160,16,7,9,2,1
35,169,169,9,1,8,2,1
7,195,195,19,19,0,1,0
10,199,199,11,11,0,1,0
9,212,212,3,3,0,1,0
16,213,213,25,13,12,4,3
13,218,218,22,22,0,1,0
24,222,222,22,22,0,1,0
5,236,236,49,15,34,3,2
29,243,243,17,8,9,4,3
20,245,245,6,6,0,1,0
28,271,271,29,29,0,1,0
0,273,273,16,12,4,2,1
17,275,275,14,14,0,1,0
31,290,290,40,8,32,2,1
22,320,320,15,15,0,1,0
19,323,323,27,27,0,1,0
27,337,337,5,5,0,1,0
14,338,338,38,8,30,3,2
32,380,380,215,215,0,1,0
1,384,384,12,12,0,1,0
34,389,389,50,33,17,2,1
23,391,391,29,21,8,2,1
3,410,410,32,32,0,1,0
6,429,429,83,75,8,2,1
25,469,469,110,101,9,4,3
18,472,472,9,2,7,2,1
15,475,475,104,76,28,2,1
21,476,476,31,31,0,1,0
4,477,477,165,57,108,4,3
8,481,481,36,36,0,1,0
12,487,487,13,13,0,1,0

39,104,104,12,12,0,1,0
20,112,112,12,12,0,1,0
11,115,115,5,5,0,1,0
8,122,122,14,14,0,1,0
37,131,131,7,7,0,1,0
3,145,145,9,9,0,1,0
1,147,147,3,3,0,1,0
23,150,150,4,1,3,2,1
2,150,150,1,1,0,1,0
17,158,158,3,3,0,1,0
31,167,167,29,29,0,1,0
21,169,169,11,5,6,2,1
28,172,172,6,1,5,2,1
30,185,185,28,6,22,3,2
5,192,192,7,7,0,1,0
22,198,198,10,4,6,3,2
10,203,203,39,39,0,1,0
34,221,221,4,1,3,2,1
16,225,225,10,10,0,1,0
14,231,231,66,45,21,4,3
36,233,233,52,52,0,1,0
24,243,243,1,1,0,1,0
6,252,252,6,2,4,2,1
38,263,263,47,25,22,2,1
29,264,264,16,16,0,1,0
12,268,268,8,8,0,1,0
9,272,272,24,24,0,1,0
40,287,287,11,11,0,1,0
32,298,298,8,8,0,1,0
41,307,307,4,1,3,2,1
19,323,323,27,27,0,1,0
25,347,347,14,6,8,2,1
26,359,359,3,3,0,1,0
42,364,364,3,3,0,1,0
0,406,406,52,52,0,1,0
18,410,410,99,3,96,4,3
15,412,412,19,19,0,1,0
27,424,424,57,3,54,4,3
4,429,429,24,12,12,4,3
33,481,481,9,3,6,2,1
7,488,488,43,31,12,4,3
35,493,493,313,172,141,4,3
13,495,495,23,23,0,1,0

32,106,106,20,20,0,1,0
11,108,108,28,28,0,1,0
18,115,115,16,16,0,1,0
8,116,116,1,1,0,1,0
16,126,126,24,20,4,2,1
22,146,146,13,13,0,1,0
29,159,159,17,7,10,3,2
3,168,168,33,13,20,2,1
0,183,183,50,50,0,1,0
25,186,186,55,39,16,2,1
6,192,192,2,2,0,1,0
21,199,199,20,20,0,1,0
9,212,212,30,30,0,1,0
12,215,215,31,18,13,2,1
10,216,216,12,12,0,1,0
23,261,261,21,21,0,1,0
34,293,293,24,24,0,1,0
28,302,302,2,2,0,1,0
31,311,311,19,19,0,1,0
13,329,329,46,46,0,1,0
33,329,329,46,46,0,1,0
27,338,338,42,37,5,2,1
2,342,342,19,19,0,1,0
15,354,354,9,9,0,1,0
35,358,358,34,4,30,4,3
1,358,358,45,45,0,1,0
20,373,373,4,4,0,1,0
19,388,388,3,3,0,1,0
7,399,399,33,33,0,1,0
24,420,420,30,30,0,1,0
14,420,420,38,6,32,3,2
30,430,430,14,14,0,1,0
26,454,454,98,1,97,4,3
4,462,462,49,2,47,3,2
5,487,487,1,1,0,1,0
17,496,496,47,2,45,2,1

1,107,107,13,13,0,1,0
8,136,136,21,21,0,1,0
17,155,155,19,19,0,1,0
0,185,185,16,12,4,2,1
6,187,187,6,1,5,2,1
11,191,191,25,25,0,1,0
26,203,203,13,13,0,1,0
13,211,211,6,6,0,1,0
23,217,217,6,2,4,2,1
18,235,235,42,8,34,2,1
4,245,245,41,3,38,2,1
15,251,251,99,99,0,1,0
22,262,262,34,34,0,1,0
10,274,274,31,31,0,1,0
20,283,283,9,4,5,2,1
19,292,292,23,9,14,2,1
30,295,295,66,40,26,4,3
28,321,321,42,42,0,1,0
12,334,334,9,9,0,1,0
14,347,347,19,13,6,3,2
9,348,348,124,124,0,1,0
21,375,375,39,39,0,1,0
31,378,378,8,2,6,3,2
24,388,388,4,1,3,2,1
27,390,390,7,7,0,1,0
3,418,418,74,74,0,1,0
2,441,441,18,7,11,4,3
25,460,460,10,10,0,1,0
16,485,485,91,79,12,4,3
29,485,485,49,24,25,2,1
5,488,488,241,152,89,4,3
7,496,496,1,1,0,1,0

11,111,111,12,12,0,1,0
25,132,132,43,25,18,4,3
4,136,136,4,4,0,1,0
33,148,148,7,2,5,2,1
32,162,162,15,15,0,1,0
17,172,172,4,4,0,1,0
35,183,183,3,3,0,1,0
29,194,194,10,10,0,1,0
14,199,199,17,9,8,3,2
8,213,213,19,11,8,2,1
37,214,214,45,13,32,3,2
16,217,217,45,36,9,4,3
1,257,257,72,59,13,2,1
38,275,275,13,13,0,1,0
13,277,277,44,2,42,2,1
12,283,283,11,11,0,1,0
36,296,296,6,6,0,1,0
31,309,309,2,2,0,1,0
15,329,329,2,2,0,1,0
27,335,335,45,1,44,3,2
7,336,336,16,7,9,4,3
5,343,343,4,4,0,1,0
24,343,343,35,1,34,2,1
0,352,352,80,35,45,4,3
20,354,354,5,5,0,1,0
6,362,362,86,39,47,2,1
22,366,366,65,48,17,2,1
28,391,391,109,109,0,1,0
23,398,398,8,8,0,1,0
3,403,403,1,1,0,1,0
30,435,435,53,53,0,1,0
26,444,444,46,1,45,2,1
21,445,445,44,8,36,3,2
34,452,452,33,7,26,3,2
19,463,463,1,1,0,1,0
18,471,471,56,56,0,1,0
10,471,471,25,25,0,1,0
2,479,479,24,1,23,2,1
9,490,490,60,10,50,3,2

38,102,102,1,1,0,1,0
24,107,107,3,3,0,1,0
8,121,121,22,22,0,1,0
3,130,130,11,11,0,1,0
31,139,139,2,2,0,1,0
18,163,163,1,1,0,1,0
36,184,184,12,2,10,3,2
23,191,191,27,27,0,1,0
2,198,198,20,20,0,1,0
6,203,203,23,23,0,1,0
10,224,224,16,16,0,1,0
17,225,225,22,22,0,1,0
40,230,230,1,1,0,1,0
13,243,243,17,17,0,1,0
29,250,250,34,34,0,1,0
20,258,258,13,13,0,1,0
11,270,270,9,9,0,1,0
21,274,274,12,12,0,1,0
0,277,277,41,41,0,1,0
35,286,286,35,8,27,2,1
5,294,294,5,5,0,1,0
14,299,299,44,17,27,4,3
32,303,303,26,8,18,2,1
37,309,309,85,42,43,2,1
15,313,313,51,51,0,1,0
19,362,362,31,19,12,2,1
22,376,376,37,4,33,3,2
26,394,394,33,33,0,1,0
27,397,397,62,40,22,4,3
1,407,407,72,10,62,3,2
39,408,408,34,34,0,1,0
25,409,409,61,61,0,1,0
12,412,412,16,16,0,1,0
28,426,426,5,5,0,1,0
16,428,428,5,2,3,2,1
7,461,461,4,4,0,1,0
30,465,465,70,70,0,1,0
9,466,466,30,30,0,1,0
4,467,467,41,10,31,2,1
34,474,474,70,2,68,3,2
33,479,479,81,33,48,3,2
41,488,488,48,39,9,2,1

26,106,106,3,3,0,1,0
4,110,110,33,33,0,1,0
22,129,129,1,1,0,1,0
19,138,138,25,25,0,1,0
15,143,143,6,6,0,1,0
20,151,151,17,17,0,1,0
9,177,177,37,9,28,3,2
35,199,199,35,1,34,3,2
27,200,200,21,21,0,1,0
5,205,205,29,29,0,1,0
12,215,215,2,2,0,1,0
18,227,227,20,20,0,1,0
8,228,228,23,23,0,1,0
1,238,238,13,1,12,4,3
36,243,243,77,77,0,1,0
38,245,245,22,22,0,1,0
0,245,245,54,54,0,1,0
28,264,264,52,41,11,2,1
34,265,265,19,19,0,1,0
2,267,267,13,13,0,1,0
14,272,272,17,3,14,4,3
16,284,284,25,6,19,4,3
3,292,292,50,50,0,1,0
6,320,320,11,5,6,2,1
25,362,362,10,10,0,1,0
23,376,376,29,5,24,2,1
13,378,378,1,1,0,1,0
7,425,425,30,30,0,1,0
29,425,425,69,31,38,2,1
33,429,429,91,91,0,1,0
31,430,430,38,38,0,1,0
24,432,432,36,7,29,2,1
30,449,449,23,19,4,2,1
11,464,464,7,7,0,1,0
32,470,470,1,1,0,1,0
21,478,478,19,19,0,1,0
17,483,483,18,18,0,1,0
10,483,483,14,5,9,4,3
37,493,493,44,22,22,2,1

42,108,108,1,1,0,1,0
0,112,112,2,2,0,1,0
18,126,126,9,9,0,1,0
26,129,129,2,2,0,1,0
38,140,140,56,56,0,1,0
36,142,142,9,1,8,3,2
16,145,145,1,1,0,1,0
9,156,156,3,3,0,1,0
34,156,156,3,3,0,1,0
31,161,161,6,6,0,1,0
10,164,164,3,3,0,1,0
43,170,170,9,4,5,2,1
14,175,175,8,2,6,3,2
1,177,177,19,19,0,1,0
30,194,194,20,20,0,1,0
22,205,205,26,26,0,1,0
5,218,218,5,5,0,1,0
35,220,220,17,5,12,4,3
12,223,223,31,9,22,2,1
32,233,233,5,5,0,1,0
45,244,244,20,8,12,3,2
29,248,248,44,32,12,2,1
44,259,259,2,2,0,1,0
7,265,265,16,3,13,2,1
8,278,278,43,43,0,1,0
41,299,299,4,4,0,1,0
6,317,317,1,1,0,1,0
24,321,321,83,43,40,3,2
2,334,334,1,1,0,1,0
33,345,345,3,3,0,1,0
19,353,353,1,1,0,1,0
23,377,377,7,7,0,1,0
25,390,390,7,1,6,3,2
37,395,395,66,66,0,1,0
40,401,401,190,190,0,1,0
28,411,411,65,65,0,1,0
11,414,414,3,3,0,1,0
20,421,421,207,193,14,3,2
27,432,432,8,8,0,1,0
13,447,447,15,15,0,1,0
15,451,451,33,1,32,2,1
4,456,456,12,12,0,1,0
3,464,464,3,3,0,1,0
21,477,477,33,33,0,1,0
17,482,482,42,42,0,1,0
39,498,498,32,24,8,2,1

2,146,146,36,7,29,2,1
23,147,147,18,12,6,3,2
31,150,150,3,3,0,1,0
4,160,160,6,3,3,2,1
20,162,162,42,42,0,1,0
21,171,171,21,21,0,1,0
28,175,175,27,17,10,2,1
8,186,186,4,4,0,1,0
39,200,200,28,12,16,4,3
32,203,203,26,3,23,2,1
29,215,215,20,15,5,2,1
36,240,240,12,12,0,1,0
35,242,242,29,29,0,1,0
19,274,274,56,47,9,2,1
3,281,281,14,14,0,1,0
12,285,285,1,1,0,1,0
11,315,315,58,49,9,2,1
30,317,317,37,11,26,3,2
22,332,332,31,10,21,4,3
5,351,351,9,1,8,3,2
33,354,354,13,13,0,1,0
38,368,368,10,10,0,1,0
37,369,369,37,37,0,1,0
24,398,398,16,16,0,1,0
25,405,405,33,33,0,1,0
10,409,409,39,39,0,1,0
15,415,415,49,33,16,2,1
14,415,415,28,28,0,1,0
41,421,421,71,15,56,3,2
0,436,436,5,5,0,1,0
1,443,443,3,3,0,1,0
9,445,445,31,10,21,3,2
6,448,448,19,7,12,3,2
40,457,457,74,74,0,1,0
7,466,466,10,10,0,1,0
27,468,468,20,7,13,2,1
34,479,479,80,59,21,4,3
16,479,479,55,55,0,1,0
18,484,484,40,30,10,2,1
26,485,485,81,36,45,4,3
13,491,491,9,9,0,1,0
17,497,497,2,2,0,1,0

27,106,106,5,1,4,2,1
38,116,116,11,11,0,1,0
6,124,124,5,5,0,1,0
29,135,135,20,2,18,3,2
14,146,146,4,1,3,2,1
33,147,147,2,2,0,1,0
35,153,153,29,29,0,1,0
39,154,154,5,5,0,1,0
5,159,159,8,8,0,1,0
2,161,161,6,6,0,1,0
24,163,163,52,34,18,4,3
11,167,167,16,16,0,1,0
13,169,169,27,17,10,3,2
18,181,181,2,2,0,1,0
15,182,182,21,14,7,2,1
1,183,183,16,10,6,3,2
28,198,198,11,11,0,1,0
9,232,232,55,55,0,1,0
36,241,241,19,19,0,1,0
26,251,251,9,2,7,2,1
20,279,279,17,5,12,3,2
8,305,305,5,5,0,1,0
32,323,323,18,18,0,1,0
34,331,331,32,6,26,2,1
12,340,340,17,17,0,1,0
3,347,347,102,102,0,1,0
16,349,349,5,2,3,2,1
25,359,359,57,25,32,2,1
21,361,361,46,31,15,2,1
30,375,375,22,10,12,4,3
31,423,423,57,57,0,1,0
17,428,428,16,16,0,1,0
37,430,430,20,5,15,2,1
7,451,451,34,34,0,1,0
19,453,453,23,23,0,1,0
22,455,455,42,42,0,1,0
10,475,475,175,46,129,4,3
23,489,489,77,23,54,4,3
0,495,495,27,12,15,4,3
4,495,495,8,8,0,1,0

23,125,125,27,10,17,2,1
2,127,127,6,6,0,1,0
10,141,141,10,1,9,2,1
6,145,145,5,1,4,2,1
31,150,150,14,6,8,3,2
16,156,156,51,3,48,3,2
17,157,157,3,3,0,1,0
8,158,158,26,7,19,4,3
7,162,162,12,4,8,3,2
0,184,184,5,5,0,1,0
3,198,198,2,2,0,1,0
36,209,209,17,6,11,2,1
28,222,222,12,8,4,2,1
18,222,222,12,2,10,3,2
9,247,247,47,47,0,1,0
11,255,255,25,25,0,1,0
12,258,258,27,27,0,1,0
24,267,267,21,5,16,2,1
33,269,269,30,23,7,2,1
30,289,289,27,27,0,1,0
20,301,301,22,16,6,2,1
13,313,313,39,39,0,1,0
1,314,314,16,16,0,1,0
21,318,318,10,10,0,1,0
32,324,324,47,27,20,3,2
5,329,329,43,43,0,1,0
19,338,338,22,22,0,1,0
25,349,349,15,15,0,1,0
27,359,359,91,43,48,4,3
14,366,366,90,20,70,3,2
26,398,398,11,1,10,3,2
4,402,402,16,16,0,1,0
29,405,405,63,36,27,4,3
22,425,425,139,139,0,1,0
35,435,435,9,9,0,1,0
34,448,448,5,5,0,1,0
15,484,484,70,70,0,1,0

14,112,112,2,2,0,1,0
4,119,119,14,3,11,2,1
22,128,128,7,7,0,1,0
10,137,137,29,29,0,1,0
36,142,142,1,1,0,1,0
5,143,143,10,1,9,2,1
8,147,147,8,8,0,1,0
28,154,154,38,38,0,1,0
21,164,164,1,1,0,1,0
15,174,174,11,11,0,1,0
20,185,185,8,3,5,2,1
37,191,191,18,14,4,2,1
6,198,198,9,9,0,1,0
18,207,207,1,1,0,1,0
31,211,211,35,35,0,1,0
2,212,212,14,14,0,1,0
0,218,218,58,37,21,2,1
11,220,220,45,11,34,2,1
27,225,225,13,13,0,1,0
24,241,241,68,68,0,1,0
26,281,281,43,32,11,2,1
12,281,281,30,6,24,4,3
34,284,284,43,43,0,1,0
3,312,312,59,59,0,1,0
13,323,323,10,10,0,1,0
33,324,324,13,1,12,4,3
30,324,324,12,12,0,1,0
32,342,342,22,22,0,1,0
38,351,351,28,16,12,4,3
25,392,392,64,52,12,3,2
23,398,398,95,38,57,4,3
17,432,432,30,30,0,1,0
9,438,438,20,12,8,2,1
29,441,441,5,5,0,1,0
19,451,451,11,11,0,1,0
1,459,459,33,33,0,1,0
7,460,460,37,15,22,2,1
16,462,462,74,60,14,3,2
35,487,487,20,20,0,1,0

15,115,115,9,5,4,2,1
27,129,129,9,9,0,1,0
31,134,134,9,9,0,1,0
1,141,141,6,6,0,1,0
10,156,156,1,1,0,1,0
18,162,162,2,2,0,1,0
35,167,167,33,5,28,3,2
21,180,180,18,15,3,2,1
16,184,184,16,16,0,1,0
6,184,184,6,3,3,2,1
25,185,185,3,3,0,1,0
11,185,185,33,6,27,4,3
2,187,187,48,27,21,4,3
12,193,193,7,7,0,1,0
13,195,195,15,9,6,2,1
36,207,207,5,2,3,2,1
19,230,230,1,1,0,1,0
42,236,236,6,3,3,2,1
38,247,247,14,5,9,4,3
4,250,250,9,9,0,1,0
0,257,257,33,33,0,1,0
17,271,271,39,39,0,1,0
26,273,273,4,4,0,1,0
29,276,276,28,28,0,1,0
20,299,299,22,22,0,1,0
24,310,310,87,87,0,1,0
28,315,315,39,39,0,1,0
41,318,318,2,2,0,1,0
39,323,323,36,36,0,1,0
3,329,329,2,2,0,1,0
37,330,330,60,30,30,4,3
34,355,355,36,36,0,1,0
9,358,358,56,34,22,2,1
33,389,389,36,5,31,2,1
23,403,403,24,12,12,3,2
8,424,424,5,5,0,1,0
30,451,451,102,102,0,1,0
7,466,466,69,69,0,1,0
14,467,467,7,7,0,1,0
32,479,479,98,98,0,1,0
22,491,491,24,15,9,4,3
5,491,491,80,8,72,4,3
40,495,495,18,9,9,4,3

35,109,109,3,3,0,1,0
27,112,112,3,3,0,1,0
30,113,113,1,1,0,1,0
15,120,120,10,10,0,1,0
50,122,122,30,5,25,2,1
6,122,122,3,3,0,1,0
21,147,147,39,39,0,1,0
38,150,150,5,5,0,1,0
8,160,160,4,4,0,1,0
16,165,165,13,13,0,1,0
4,177,177,10,10,0,1,0
34,186,186,10,10,0,1,0
45,194,194,62,62,0,1,0
24,210,210,1,1,0,1,0
18,211,211,1,1,0,1,0
3,218,218,14,14,0,1,0
11,223,223,13,13,0,1,0
32,227,227,1,1,0,1,0
31,235,235,2,2,0,1,0
23,243,243,11,1,10,3,2
43,248,248,28,28,0,1,0
42,248,248,19,19,0,1,0
13,248,248,33,25,8,3,2
26,254,254,12,12,0,1,0
29,261,261,4,4,0,1,0
48,263,263,3,3,0,1,0
39,273,273,4,4,0,1,0
17,294,294,11,11,0,1,0
37,305,305,84,84,0,1,0
28,316,316,117,40,77,3,2
10,336,336,3,3,0,1,0
0,356,356,2,2,0,1,0
36,356,356,6,2,4,2,1
33,357,357,51,3,48,2,1
2,366,366,3,3,0,1,0
12,367,367,11,6,5,2,1
20,370,370,33,16,17,2,1
40,378,378,30,8,22,3,2
7,391,391,51,33,18,4,3
49,412,412,70,14,56,3,2
25,413,413,25,25,0,1,0
19,440,440,9,9,0,1,0
46,447,447,8,8,0,1,0
14,447,447,6,6,0,1,0
47,459,459,10,4,6,3,2
41,481,481,30,30,0,1,0
5,482,482,44,14,30,2,1
22,486,486,20,20,0,1,0
1,487,487,3,3,0,1,0
9,491,491,18,3,15,2,1
44,496,496,127,91,36,4,3

14,103,103,5,5,0,1,0
27,123,123,13,2,11,2,1
15,123,123,6,1,5,2,1
29,160,160,18,3,15,4,3
2,169,169,1,1,0,1,0
10,173,173,9,9,0,1,0
21,194,194,22,22,0,1,0
9,197,197,48,48,0,1,0
23,229,229,1,1,0,1,0
13,238,238,44,44,0,1,0
26,263,263,53,53,0,1,0
16,281,281,8,8,0,1,0
25,287,287,3,3,0,1,0
1,301,301,25,17,8,3,2
11,312,312,108,54,54,3,2
24,321,321,21,21,0,1,0
0,331,331,33,33,0,1,0
7,339,339,6,6,0,1,0
3,342,342,42,19,23,2,1
6,357,357,153,153,0,1,0
4,364,364,13,13,0,1,0
20,391,391,23,1,22,3,2
5,397,397,166,127,39,2,1
19,424,424,40,19,21,2,1
8,426,426,20,20,0,1,0
30,437,437,26,26,0,1,0
28,437,437,17,8,9,4,3
18,440,440,147,110,37,2,1
17,441,441,27,13,14,3,2
12,485,485,60,17,43,2,1
22,500,500,122,100,22,4,3

32,105,105,4,4,0,1,0
17,108,108,15,15,0,1,0
35,123,123,25,25,0,1,0
29,133,133,2,2,0,1,0
25,134,134,2,2,0,1,0
22,177,177,4,4,0,1,0
34,181,181,32,18,14,3,2
7,186,186,2,2,0,1,0
15,226,226,14,9,5,2,1
12,235,235,21,21,0,1,0
19,236,236,17,17,0,1,0
9,239,239,42,14,28,2,1
31,247,247,31,4,27,4,3
27,266,266,33,33,0,1,0
2,267,267,3,3,0,1,0
8,284,284,54,54,0,1,0
13,285,285,98,98,0,1,0
10,290,290,21,21,0,1,0
36,291,291,4,4,0,1,0
11,317,317,38,38,0,1,0
23,322,322,6,6,0,1,0
40,328,328,54,48,6,2,1
39,337,337,60,60,0,1,0
28,353,353,10,3,7,3,2
21,375,375,18,1,17,2,1
4,381,381,46,46,0,1,0
14,383,383,31,31,0,1,0
5,385,385,8,2,6,3,2
6,391,391,35,15,20,3,2
1,393,393,28,28,0,1,0
16,395,395,5,5,0,1,0
3,399,399,45,11,34,2,1
24,401,401,70,70,0,1,0
0,411,411,2,2,0,1,0
30,439,439,68,68,0,1,0
33,441,441,50,35,15,2,1
26,441,441,10,10,0,1,0
18,447,447,20,20,0,1,0
20,455,455,4,4,0,1,0
38,466,466,33,9,24,2,1
37,495,495,140,140,0,1,0

14,110,110,30,25,5,2,1
0,118,118,18,18,0,1,0
30,133,133,30,30,0,1,0
1,153,153,1,1,0,1,0
12,162,162,30,13,17,2,1
38,172,172,10,10,0,1,0
9,201,201,4,4,0,1,0
21,217,217,11,11,0,1,0
10,229,229,36,13,23,2,1
6,236,236,1,1,0,1,0
33,236,236,20,20,0,1,0
29,276,276,52,52,0,1,0
27,278,278,20,17,3,2,1
36,285,285,28,2,26,3,2
31,291,291,36,36,0,1,0
5,305,305,73,73,0,1,0
4,308,308,12,12,0,1,0
26,311,311,17,9,8,2,1
37,323,323,38,7,31,4,3
2,333,333,2,2,0,1,0
25,342,342,40,40,0,1,0
24,343,343,97,97,0,1,0
20,344,344,28,28,0,1,0
35,366,366,20,15,5,2,1
16,375,375,4,4,0,1,0
28,378,378,60,60,0,1,0
34,387,387,17,17,0,1,0
32,391,391,15,15,0,1,0
23,393,393,28,6,22,2,1
11,412,412,49,49,0,1,0
22,426,426,1,1,0,1,0
18,446,446,15,15,0,1,0
3,461,461,129,69,60,3,2
8,462,462,15,15,0,1,0
17,463,463,28,28,0,1,0
7,464,464,50,32,18,4,3
15,464,464,29,1,28,3,2
19,491,491,14,4,10,2,1
13,500,500,42,42,0,1,0

1,107,107,7,2,5,2,1
34,118,118,21,21,0,1,0
40,134,134,5,5,0,1,0
7,135,135,2,2,0,1,0
37,137,137,6,2,4,2,1
44,138,138,7,7,0,1,0
29,141,141,24,24,0,1,0
14,142,142,9,9,0,1,0
17,162,162,5,2,3,2,1
10,164,164,17,10,7,2,1
33,176,176,22,6,16,2,1
12,178,178,18,18,0,1,0
15,180,180,2,2,0,1,0
19,186,186,35,5,30,4,3
42,198,198,10,10,0,1,0
23,200,200,52,30,22,2,1
38,201,201,54,54,0,1,0
20,210,210,5,5,0,1,0
22,223,223,21,21,0,1,0
13,226,226,8,1,7,2,1
8,228,228,8,8,0,1,0
3,230,230,59,29,30,4,3
0,234,234,4,1,3,2,1
18,247,247,39,5,34,2,1
5,257,257,6,6,0,1,0
21,273,273,2,2,0,1,0
43,287,287,3,3,0,1,0
26,290,290,37,37,0,1,0
31,294,294,53,53,0,1,0
2,334,334,94,32,62,3,2
9,335,335,3,3,0,1,0
4,341,341,7,7,0,1,0
27,342,342,52,52,0,1,0
39,349,349,3,3,0,1,0
24,352,352,12,3,9,4,3
25,390,390,18,18,0,1,0
11,394,394,3,3,0,1,0
16,412,412,5,5,0,1,0
35,419,419,88,24,64,3,2
41,419,419,3,3,0,1,0
36,421,421,4,4,0,1,0
30,434,434,29,29,0,1,0
6,436,436,1,1,0,1,0
32,481,481,102,43,59,3,2
28,482,482,13,13,0,1,0

28,115,115,10,10,0,1,0
21,130,130,46,1,45,2,1
16,135,135,7,4,3,2,1
19,144,144,11,11,0,1,0
32,154,154,44,44,0,1,0
12,155,155,15,1,14,3,2
25,159,159,6,6,0,1,0
26,162,162,9,9,0,1,0
9,173,173,8,5,3,2,1
7,174,174,5,5,0,1,0
10,190,190,2,2,0,1,0
18,199,199,35,35,0,1,0
1,213,213,80,28,52,3,2
17,220,220,3,3,0,1,0
30,223,223,23,23,0,1,0
8,235,235,8,8,0,1,0
35,237,237,61,61,0,1,0
11,251,251,4,4,0,1,0
14,270,270,5,5,0,1,0
20,289,289,27,27,0,1,0
13,298,298,8,2,6,2,1
0,301,301,18,13,5,2,1
29,310,310,3,3,0,1,0
6,312,312,2,2,0,1,0
3,319,319,50,29,21,4,3
4,340,340,16,5,11,2,1
37,345,345,17,1,16,4,3
34,357,357,49,40,9,2,1
5,375,375,31,2,29,3,2
2,414,414,59,59,0,1,0
38,418,418,16,16,0,1,0
22,423,423,29,29,0,1,0
24,424,424,1,1,0,1,0
23,433,433,53,53,0,1,0
15,446,446,195,69,126,4,3
31,468,468,65,31,34,2,1
33,475,475,9,1,8,2,1
36,487,487,7,7,0,1,0
27,492,492,35,35,0,1,0

14,102,102,10,2,8,2,1
23,105,105,33,6,27,4,3
38,106,106,11,11,0,1,0
8,133,133,3,3,0,1,0
4,137,137,17,11,6,3,2
18,143,143,22,22,0,1,0
12,156,156,9,5,4,2,1
40,166,166,28,28,0,1,0
9,166,166,5,2,3,2,1
7,192,192,15,15,0,1,0
10,193,193,25,1,24,2,1
26,201,201,34,34,0,1,0
35,244,244,53,53,0,1,0
20,247,247,9,5,4,2,1
19,251,251,57,57,0,1,0
0,252,252,48,22,26,2,1
6,253,253,48,48,0,1,0
32,254,254,3,3,0,1,0
13,258,258,1,1,0,1,0
30,265,265,14,14,0,1,0
11,271,271,18,18,0,1,0
2,289,289,1,1,0,1,0
24,292,292,2,2,0,1,0
16,300,300,10,10,0,1,0
34,308,308,54,24,30,4,3
28,310,310,8,2,6,3,2
21,314,314,25,25,0,1,0
36,323,323,9,1,8,3,2
25,342,342,20,20,0,1,0
3,346,346,6,1,5,2,1
22,352,352,26,4,22,2,1
29,357,357,72,30,42,3,2
33,366,366,4,1,3,2,1
5,366,366,35,4,31,2,1
27,411,411,19,1,18,3,2
37,421,421,33,3,30,2,1
1,435,435,49,49,0,1,0
15,454,454,46,46,0,1,0
17,461,461,23,12,11,2,1
39,482,482,2,2,0,1,0
31,487,487,95,68,27,4,3

6,106,106,24,13,11,2,1
1,122,122,26,26,0,1,0
12,130,130,7,3,4,2,1
10,146,146,45,45,0,1,0
0,148,148,2,2,0,1,0
7,154,154,26,26,0,1,0
4,172,172,7,7,0,1,0
23,204,204,55,37,18,2,1
13,219,219,18,8,10,3,2
26,241,241,38,25,13,2,1
20,258,258,8,3,5,2,1
24,268,268,24,24,0,1,0
17,278,278,37,37,0,1,0
29,284,284,22,22,0,1,0
18,293,293,1,1,0,1,0
28,293,293,1,1,0,1,0
27,318,318,50,50,0,1,0
15,321,321,44,44,0,1,0
2,331,331,8,8,0,1,0
8,340,340,44,12,32,2,1
9,358,358,194,148,46,3,2
5,369,369,26,5,21,2,1
30,405,405,7,7,0,1,0
11,408,408,44,44,0,1,0
19,409,409,9,9,0,1,0
22,432,432,76,76,0,1,0
21,462,462,84,84,0,1,0
31,471,471,4,4,0,1,0
3,473,473,3,3,0,1,0
14,485,485,32,24,8,2,1
25,496,496,96,18,78,3,2
16,500,500,59,59,0,1,0

5,120,120,8,8,0,1,0
33,129,129,8,8,0,1,0
26,131,131,11,11,0,1,0
32,143,143,69,16,53,3,2
13,150,150,2,2,0,1,0
9,159,159,19,19,0,1,0
0,165,165,1,1,0,1,0
24,165,165,8,8,0,1,0
29,167,167,27,27,0,1,0
14,182,182,4,1,3,2,1
30,202,202,6,6,0,1,0
35,205,205,38,38,0,1,0
38,209,209,16,1,15,2,1
18,228,228,18,1,17,2,1
36,232,232,5,5,0,1,0
25,236,236,14,14,0,1,0
6,242,242,6,1,5,2,1
23,247,247,46,46,0,1,0
31,253,253,39,18,21,4,3
7,265,265,9,9,0,1,0
2,272,272,48,48,0,1,0
27,281,281,5,5,0,1,0
11,307,307,119,119,0,1,0
3,310,310,39,12,27,4,3
37,311,311,5,5,0,1,0
10,328,328,82,16,66,3,2
1,346,346,2,2,0,1,0
4,355,355,16,7,9,2,1
8,359,359,9,9,0,1,0
15,379,379,39,6,33,4,3
17,411,411,86,2,84,3,2
20,426,426,15,12,3,2,1
16,439,439,24,24,0,1,0
28,448,448,20,20,0,1,0
21,455,455,13,13,0,1,0
34,464,464,22,22,0,1,0
12,468,468,29,29,0,1,0
19,494,494,45,16,29,2,1
22,495,495,98,98,0,1,0

2,107,107,2,2,0,1,0
23,111,111,22,10,12,2,1
37,119,119,22,22,0,1,0
31,156,156,6,6,0,1,0
1,171,171,14,14,0,1,0
35,176,176,2,2,0,1,0
33,183,183,6,6,0,1,0
12,216,216,17,14,3,2,1
34,229,229,63,47,16,2,1
39,233,233,14,14,0,1,0
15,235,235,31,31,0,1,0
26,246,246,42,36,6,2,1
41,254,254,5,2,3,2,1
40,257,257,18,18,0,1,0
27,265,265,36,36,0,1,0
30,270,270,4,4,0,1,0
3,274,274,4,4,0,1,0
4,275,275,20,14,6,3,2
28,291,291,18,18,0,1,0
25,296,296,33,11,22,2,1
32,314,314,27,5,22,2,1
16,318,318,3,3,0,1,0
36,319,319,34,34,0,1,0
0,321,321,43,43,0,1,0
19,327,327,9,9,0,1,0
38,334,334,44,29,15,4,3
18,341,341,9,9,0,1,0
9,354,354,33,33,0,1,0
17,362,362,9,9,0,1,0
20,365,365,18,18,0,1,0
11,370,370,14,2,12,2,1
13,373,373,21,21,0,1,0
6,375,375,16,8,8,3,2
7,411,411,80,80,0,1,0
24,418,418,54,10,44,2,1
10,421,421,7,7,0,1,0
5,424,424,25,25,0,1,0
8,427,427,130,85,45,4,3
21,459,459,114,114,0,1,0
22,474,474,75,75,0,1,0
14,476,476,9,9,0,1,0
29,493,493,50,50,0,1,0

5,100,100,1,1,0,1,0
27,105,105,2,2,0,1,0
24,105,105,2,2,0,1,0
9,132,132,27,17,10,2,1
21,138,138,70,70,0,1,0
18,141,141,11,11,0,1,0
6,148,148,3,3,0,1,0
10,162,162,13,1,12,3,2
28,192,192,26,26,0,1,0
13,193,193,9,9,0,1,0
34,224,224,29,29,0,1,0
16,232,232,2,2,0,1,0
0,234,234,9,9,0,1,0
23,267,267,1,1,0,1,0
30,267,267,20,7,13,2,1
1,276,276,24,4,20,3,2
8,299,299,67,46,21,2,1
11,300,300,95,95,0,1,0
26,305,305,41,41,0,1,0
22,311,311,2,2,0,1,0
17,319,319,19,19,0,1,0
19,320,320,7,1,6,2,1
7,322,322,4,4,0,1,0
14,338,338,80,9,71,4,3
25,359,359,63,36,27,4,3
20,360,360,27,27,0,1,0
31,383,383,8,8,0,1,0
12,389,389,4,4,0,1,0
32,437,437,26,26,0,1,0
2,443,443,9,4,5,2,1
4,463,463,54,54,0,1,0
29,468,468,160,118,42,3,2
3,486,486,108,65,43,2,1
33,487,487,34,34,0,1,0
15,496,496,126,114,12,3,2

27,113,113,37,37,0,1,0
22,114,114,1,1,0,1,0
5,129,129,1,1,0,1,0
38,138,138,7,7,0,1,0
14,158,158,14,2,12,2,1
7,160,160,5,5,0,1,0
31,206,206,7,2,5,2,1
37,209,209,11,11,0,1,0
42,219,219,21,6,15,2,1
17,221,221,20,10,10,2,1
3,233,233,1,1,0,1,0
35,241,241,12,12,0,1,0
20,249,249,45,45,0,1,0
15,262,262,8,8,0,1,0
4,263,263,1,1,0,1,0
36,265,265,10,10,0,1,0
13,270,270,1,1,0,1,0
29,295,295,9,3,6,2,1
2,311,311,25,13,12,3,2
39,313,313,54,42,12,4,3
26,315,315,5,5,0,1,0
34,321,321,17,17,0,1,0
8,322,322,37,21,16,3,2
25,331,331,93,3,90,4,3
30,348,348,21,21,0,1,0
33,362,362,31,31,0,1,0
41,369,369,9,3,6,3,2
6,385,385,21,21,0,1,0
10,387,387,76,22,54,3,2
23,402,402,29,15,14,2,1
24,404,404,102,72,30,4,3
18,409,409,23,8,15,2,1
11,429,429,13,13,0,1,0
16,431,431,60,60,0,1,0
0,436,436,27,27,0,1,0
1,436,436,19,19,0,1,0
32,442,442,29,17,12,4,3
12,443,443,151,28,123,4,3
28,467,467,103,41,62,4,3
40,471,471,13,13,0,1,0
9,490,490,47,47,0,1,0
19,495,495,63,63,0,1,0
21,499,499,19,7,12,2,1

5,144,144,32,32,0,1,0
21,149,149,10,10,0,1,0
25,150,150,6,6,0,1,0
6,173,173,15,15,0,1,0
39,178,178,2,2,0,1,0
3,181,181,3,3,0,1,0
2,186,186,9,9,0,1,0
18,207,207,50,34,16,2,1
16,208,208,17,6,11,2,1
14,212,212,30,30,0,1,0
8,213,213,16,16,0,1,0
7,213,213,25,25,0,1,0
17,223,223,12,9,3,2,1
19,223,223,1,1,0,1,0
28,224,224,5,2,3,2,1
38,266,266,1,1,0,1,0
4,271,271,39,20,19,2,1
32,278,278,11,1,10,3,2
24,284,284,95,17,78,3,2
10,303,303,50,22,28,3,2
31,305,305,35,35,0,1,0
26,308,308,24,24,0,1,0
0,316,316,27,27,0,1,0
9,321,321,21,21,0,1,0
36,328,328,42,22,20,3,2
22,333,333,78,54,24,2,1
11,333,333,9,9,0,1,0
23,357,357,66,23,43,4,3
34,372,372,118,118,0,1,0
20,384,384,40,18,22,3,2
15,398,398,47,39,8,3,2
29,410,410,39,39,0,1,0
37,411,411,4,4,0,1,0
33,417,417,21,9,12,3,2
12,417,417,28,9,19,2,1
1,466,466,1,1,0,1,0
30,472,472,20,11,9,4,3
27,482,482,8,4,4,2,1
13,492,492,16,16,0,1,0
35,493,493,69,69,0,1,0

0,108,108,2,2,0,1,0
5,128,128,2,2,0,1,0
31,159,159,10,10,0,1,0
18,162,162,28,28,0,1,0
26,164,164,9,3,6,2,1
17,173,173,10,1,9,4,3
4,176,176,17,17,0,1,0
24,200,200,12,12,0,1,0
6,208,208,26,26,0,1,0
23,211,211,4,1,3,2,1
10,211,211,14,4,10,3,2
7,220,220,75,75,0,1,0
28,221,221,51,51,0,1,0
27,222,222,9,3,6,2,1
3,225,225,1,1,0,1,0
35,231,231,4,4,0,1,0
19,267,267,18,18,0,1,0
21,274,274,93,58,35,2,1
11,279,279,23,23,0,1,0
32,287,287,36,2,34,3,2
29,320,320,8,3,5,2,1
12,331,331,16,2,14,3,2
34,333,333,42,42,0,1,0
15,338,338,30,30,0,1,0
33,339,339,18,18,0,1,0
22,358,358,40,40,0,1,0
2,364,364,52,29,23,2,1
25,367,367,119,14,105,4,3
30,378,378,36,36,0,1,0
16,379,379,115,115,0,1,0
9,388,388,29,29,0,1,0
13,404,404,19,5,14,4,3
36,407,407,5,5,0,1,0
14,434,434,20,20,0,1,0
20,438,438,4,4,0,1,0
8,457,457,114,108,6,3,2
1,475,475,46,25,21,4,3

37,113,113,13,2,11,2,1
29,128,128,10,7,3,2,1
10,136,136,2,2,0,1,0
17,139,139,8,3,5,2,1
39,140,140,6,6,0,1,0
26,144,144,23,20,3,2,1
9,155,155,1,1,0,1,0
33,158,158,91,37,54,4,3
5,161,161,2,2,0,1,0
1,164,164,33,33,0,1,0
32,167,167,13,13,0,1,0
23,170,170,8,8,0,1,0
6,201,201,14,2,12,3,2
14,201,201,9,1,8,3,2
25,224,224,16,16,0,1,0
7,230,230,12,12,0,1,0
16,231,231,1,1,0,1,0
42,252,252,3,3,0,1,0
35,256,256,7,7,0,1,0
21,258,258,14,14,0,1,0
45,258,258,55,31,24,3,2
28,279,279,8,8,0,1,0
27,280,280,116,68,48,2,1
36,287,287,18,1,17,2,1
46,288,288,34,16,18,4,3
2,311,311,13,7,6,3,2
12,313,313,4,1,3,2,1
0,315,315,2,2,0,1,0
31,319,319,9,3,6,2,1
18,322,322,1,1,0,1,0
20,334,334,4,4,0,1,0
8,345,345,13,13,0,1,0
3,346,346,30,20,10,3,2
4,356,356,1,1,0,1,0
34,357,357,10,10,0,1,0
22,365,365,60,60,0,1,0
15,386,386,80,12,68,3,2
19,389,389,15,15,0,1,0
43,399,399,23,23,0,1,0
41,404,404,7,4,3,2,1
11,411,411,9,1,8,2,1
13,425,425,12,12,0,1,0
38,466,466,44,44,0,1,0
24,473,473,14,14,0,1,0
40,486,486,26,23,3,2,1
44,489,489,21,21,0,1,0
30,490,490,133,133,0,1,0

33,109,109,6,6,0,1,0
23,112,112,13,6,7,2,1
7,117,117,1,1,0,1,0
3,137,137,7,7,0,1,0
16,138,138,9,9,0,1,0
18,148,148,1,1,0,1,0
42,153,153,19,19,0,1,0
9,157,157,9,9,0,1,0
32,158,158,4,4,0,1,0
4,161,161,18,18,0,1,0
22,162,162,34,34,0,1,0
27,185,185,14,5,9,4,3
36,221,221,39,19,20,2,1
34,221,221,34,11,23,2,1
17,224,224,20,6,14,3,2
11,240,240,22,22,0,1,0
2,268,268,5,5,0,1,0
25,274,274,3,3,0,1,0
41,284,284,12,12,0,1,0
6,286,286,19,19,0,1,0
10,293,293,14,6,8,3,2
35,296,296,4,4,0,1,0
14,298,298,13,3,10,2,1
39,305,305,30,30,0,1,0
8,305,305,6,6,0,1,0
20,311,311,26,26,0,1,0
1,314,314,10,10,0,1,0
15,331,331,45,3,42,3,2
40,333,333,19,19,0,1,0
29,340,340,13,13,0,1,0
19,358,358,32,32,0,1,0
30,364,364,102,102,0,1,0
38,377,377,68,24,44,3,2
31,387,387,4,4,0,1,0
12,395,395,46,22,24,4,3
24,405,405,7,3,4,2,1
5,421,421,75,75,0,1,0
13,453,453,20,20,0,1,0
26,460,460,87,87,0,1,0
37,461,461,176,157,19,2,1
21,483,483,40,40,0,1,0
28,489,489,2,2,0,1,0
0,500,500,68,5,63,4,3

35,103,103,2,2,0,1,0
10,105,105,7,7,0,1,0
25,114,114,16,4,12,2,1
37,134,134,39,19,20,4,3
21,148,148,7,7,0,1,0
44,169,169,23,5,18,3,2
32,175,175,6,6,0,1,0
11,182,182,59,18,41,2,1
13,186,186,13,13,0,1,0
30,212,212,28,28,0,1,0
3,218,218,2,2,0,1,0
38,218,218,5,5,0,1,0
17,219,219,1,1,0,1,0
0,221,221,2,2,0,1,0
20,227,227,10,10,0,1,0
22,240,240,8,8,0,1,0
28,245,245,47,47,0,1,0
19,249,249,12,12,0,1,0
31,255,255,8,8,0,1,0
7,258,258,13,13,0,1,0
1,269,269,3,3,0,1,0
6,270,270,7,7,0,1,0
5,274,274,6,6,0,1,0
34,299,299,2,2,0,1,0
26,301,301,9,9,0,1,0
42,302,302,116,76,40,2,1
4,326,326,34,10,24,3,2
23,332,332,72,72,0,1,0
36,335,335,88,88,0,1,0
15,342,342,10,10,0,1,0
40,343,343,17,17,0,1,0
9,345,345,1,1,0,1,0
18,355,355,45,45,0,1,0
45,359,359,12,12,0,1,0
39,366,366,7,7,0,1,0
2,378,378,20,13,7,2,1
27,387,387,23,23,0,1,0
16,397,397,4,4,0,1,0
33,421,421,27,27,0,1,0
29,452,452,25,25,0,1,0
24,457,457,5,1,4,2,1
12,469,469,30,17,13,2,1
14,469,469,47,19,28,3,2
43,472,472,21,3,18,2,1
46,474,474,38,38,0,1,0
8,491,491,92,92,0,1,0
41,497,497,36,36,0,1,0

3,108,108,1,1,0,1,0
10,131,131,29,29,0,1,0
13,142,142,20,20,0,1,0
7,172,172,49,3,46,4,3
11,185,185,11,11,0,1,0
0,188,188,24,24,0,1,0
23,206,206,20,2,18,4,3
14,209,209,19,4,15,2,1
6,209,209,139,139,0,1,0
16,219,219,12,12,0,1,0
18,234,234,4,4,0,1,0
8,269,269,102,88,14,2,1
25,290,290,13,13,0,1,0
22,301,301,8,5,3,2,1
24,355,355,48,48,0,1,0
21,355,355,9,9,0,1,0
5,363,363,5,5,0,1,0
20,367,367,119,116,3,2,1
1,372,372,28,28,0,1,0
4,380,380,115,115,0,1,0
15,393,393,66,66,0,1,0
27,403,403,67,67,0,1,0
2,407,407,18,5,13,2,1
17,413,413,3,3,0,1,0
9,435,435,121,113,8,2,1
19,446,446,14,7,7,2,1
12,468,468,18,15,3,2,1
26,472,472,6,2,4,2,1

2,105,105,11,11,0,1,0
28,122,122,3,3,0,1,0
15,125,125,30,30,0,1,0
10,143,143,17,4,13,2,1
20,143,143,15,15,0,1,0
19,147,147,32,14,18,3,2
31,151,151,37,37,0,1,0
29,160,160,2,2,0,1,0
34,167,167,8,8,0,1,0
17,180,180,1,1,0,1,0
13,189,189,30,30,0,1,0
14,191,191,8,8,0,1,0
16,193,193,13,13,0,1,0
9,196,196,46,46,0,1,0
35,200,200,78,30,48,2,1
12,200,200,13,1,12,3,2
7,203,203,27,21,6,2,1
21,208,208,57,57,0,1,0
23,222,222,17,8,9,2,1
11,224,224,55,10,45,2,1
4,231,231,71,71,0,1,0
24,231,231,23,23,0,1,0
32,284,284,13,13,0,1,0
18,311,311,12,9,3,2,1
25,335,335,14,4,10,3,2
8,340,340,8,2,6,2,1
0,353,353,6,6,0,1,0
6,359,359,1,1,0,1,0
22,366,366,20,4,16,3,2
5,377,377,15,15,0,1,0
26,409,409,25,25,0,1,0
33,438,438,1,1,0,1,0
27,441,441,69,19,50,3,2
3,444,444,35,35,0,1,0
30,475,475,17,11,6,3,2
1,498,498,12,12,0,1,0

6,118,118,7,2,5,2,1
11,126,126,33,33,0,1,0
28,134,134,18,9,9,2,1
29,138,138,18,18,0,1,0
9,141,141,60,60,0,1,0
33,175,175,44,41,3,2,1
20,183,183,27,27,0,1,0
15,206,206,11,11,0,1,0
7,216,216,9,9,0,1,0
32,217,217,4,1,3,2,1
1,242,242,9,1,8,3,2
30,243,243,16,10,6,3,2
0,263,263,10,6,4,2,1
5,306,306,19,1,18,4,3
22,306,306,55,31,24,2,1
13,335,335,1,1,0,1,0
17,348,348,18,9,9,4,3
19,351,351,17,3,14,3,2
2,354,354,69,26,43,2,1
14,359,359,100,50,50,2,1
16,364,364,17,17,0,1,0
27,365,365,23,3,20,3,2
3,367,367,4,4,0,1,0
4,377,377,54,32,22,3,2
24,379,379,3,3,0,1,0
31,412,412,106,31,75,4,3
34,417,417,8,8,0,1,0
10,443,443,28,13,15,2,1
8,455,455,30,30,0,1,0
12,460,460,75,75,0,1,0
21,464,464,41,41,0,1,0
18,482,482,18,18,0,1,0
25,490,490,5,5,0,1,0
26,498,498,124,14,110,4,3
23,499,499,63,19,44,3,2

20,103,103,10,2,8,3,2
32,131,131,23,8,15,2,1
4,135,135,10,10,0,1,0
11,139,139,16,7,9,2,1
26,158,158,4,4,0,1,0
12,175,175,8,8,0,1,0
27,181,181,70,70,0,1,0
36,192,192,37,2,35,2,1
24,208,208,31,7,24,3,2
29,228,228,2,2,0,1,0
1,252,252,7,7,0,1,0
31,266,266,1,1,0,1,0
6,270,270,25,25,0,1,0
16,275,275,66,27,39,4,3
37,287,287,43,13,30,3,2
28,288,288,1,1,0,1,0
10,292,292,7,7,0,1,0
19,296,296,10,7,3,2,1
7,303,303,18,18,0,1,0
9,306,306,5,5,0,1,0
15,311,311,17,17,0,1,0
5,312,312,3,3,0,1,0
17,324,324,62,62,0,1,0
38,354,354,13,13,0,1,0
35,368,368,54,37,17,2,1
23,371,371,33,33,0,1,0
13,375,375,2,2,0,1,0
33,379,379,26,14,12,2,1
8,387,387,51,10,41,2,1
3,397,397,78,51,27,2,1
34,422,422,48,7,41,3,2
18,450,450,79,79,0,1,0
0,472,472,125,71,54,3,2
22,481,481,28,28,0,1,0
25,483,483,22,10,12,4,3
30,486,486,29,29,0,1,0
2,489,489,8,8,0,1,0
21,496,496,60,10,50,3,2
14,497,497,63,37,26,2,1

24,115,115,40,40,0,1,0
28,123,123,9,4,5,2,1
7,139,139,1,1,0,1,0
19,151,151,3,3,0,1,0
1,156,156,7,1,6,2,1
29,158,158,3,3,0,1,0
27,174,174,28,16,12,4,3
6,179,179,7,7,0,1,0
21,186,186,34,34,0,1,0
17,192,192,31,10,21,2,1
34,194,194,10,1,9,4,3
26,237,237,27,27,0,1,0
5,252,252,13,13,0,1,0
22,254,254,58,22,36,4,3
25,259,259,5,2,3,2,1
37,278,278,5,2,3,2,1
8,288,288,16,8,8,2,1
16,303,303,12,3,9,4,3
12,335,335,27,12,15,2,1
31,338,338,5,5,0,1,0
2,342,342,2,2,0,1,0
11,345,345,125,16,109,4,3
35,349,349,14,6,8,2,1
13,371,371,52,52,0,1,0
4,374,374,7,7,0,1,0
30,380,380,31,31,0,1,0
3,390,390,1,1,0,1,0
18,390,390,28,16,12,2,1
20,390,390,35,35,0,1,0
23,394,394,70,20,50,2,1
39,403,403,6,3,3,2,1
15,408,408,14,14,0,1,0
32,420,420,74,23,51,4,3
38,435,435,56,50,6,2,1
9,448,448,42,34,8,3,2
10,448,448,156,78,78,3,2
33,463,463,14,14,0,1,0
14,486,486,29,6,23,3,2
36,493,493,30,30,0,1,0
0,498,498,87,57,30,4,3

26,115,115,6,1,5,2,1
22,116,116,3,3,0,1,0
2,116,116,5,5,0,1,0
30,119,119,17,17,0,1,0
16,120,120,29,29,0,1,0
14,125,125,35,35,0,1,0
7,127,127,2,2,0,1,0
11,133,133,7,2,5,2,1
27,134,134,10,10,0,1,0
35,153,153,29,29,0,1,0
25,167,167,13,13,0,1,0
10,177,177,26,26,0,1,0
34,238,238,11,1,10,2,1
18,241,241,12,12,0,1,0
15,248,248,19,19,0,1,0
4,250,250,15,15,0,1,0
29,276,276,6,6,0,1,0
5,298,298,1,1,0,1,0
8,318,318,8,1,7,2,1
1,325,325,21,5,16,3,2
32,325,325,25,1,24,4,3
36,346,346,60,15,45,4,3
6,398,398,5,5,0,1,0
17,411,411,10,4,6,2,1
24,422,422,76,47,29,2,1
0,422,422,162,162,0,1,0
19,428,428,3,3,0,1,0
20,436,436,95,9,86,4,3
23,448,448,46,28,18,2,1
31,448,448,45,36,9,2,1
33,453,453,47,47,0,1,0
28,472,472,44,44,0,1,0
12,473,473,149,131,18,3,2
9,481,481,66,66,0,1,0
13,481,481,6,1,5,2,1
3,491,491,3,3,0,1,0
21,495,495,98,56,42,4,3

0,107,107,13,4,9,4,3
31,143,143,10,10,0,1,0
22,162,162,11,11,0,1,0
2,164,164,44,23,21,4,3
4,166,166,16,16,0,1,0
27,169,169,26,26,0,1,0
21,184,184,28,28,0,1,0
7,187,187,31,23,8,2,1
32,195,195,6,6,0,1,0
8,206,206,23,5,18,3,2
3,217,217,21,21,0,1,0
37,232,232,25,3,22,2,1
24,259,259,3,3,0,1,0
29,280,280,31,5,26,3,2
9,282,282,14,14,0,1,0
30,283,283,79,31,48,3,2
17,297,297,54,24,30,3,2
13,299,299,9,6,3,2,1
26,301,301,20,10,10,3,2
34,301,301,44,6,38,2,1
14,310,310,12,12,0,1,0
11,321,321,12,4,8,2,1
6,329,329,16,5,11,3,2
15,349,349,74,67,7,2,1
23,374,374,3,3,0,1,0
18,393,393,78,78,0,1,0
5,397,397,40,11,29,2,1
20,400,400,47,47,0,1,0
16,402,402,16,16,0,1,0
25,418,418,27,27,0,1,0
35,425,425,87,46,41,2,1
28,427,427,16,4,12,2,1
10,442,442,2,2,0,1,0
12,452,452,34,34,0,1,0
1,454,454,11,11,0,1,0
33,471,471,67,5,62,4,3
36,493,493,17,17,0,1,0
19,499,499,63,32,31,2,1

16,100,100,1,1,0,1,0
36,120,120,11,2,9,4,3
26,133,133,8,8,0,1,0
18,135,135,5,5,0,1,0
30,139,139,2,2,0,1,0
9,152,152,2,2,0,1,0
25,157,157,73,45,28,2,1
28,161,161,5,5,0,1,0
15,164,164,1,1,0,1,0
19,169,169,15,1,14,2,1
4,172,172,4,4,0,1,0
2,175,175,74,30,44,2,1
8,180,180,41,20,21,4,3
24,205,205,3,3,0,1,0
3,216,216,11,11,0,1,0
14,225,225,9,9,0,1,0
21,234,234,56,10,46,3,2
10,248,248,5,5,0,1,0
20,251,251,28,16,12,4,3
37,312,312,10,4,6,3,2
33,316,316,101,92,9,3,2
38,318,318,54,54,0,1,0
23,321,321,1,1,0,1,0
35,321,321,43,13,30,3,2
11,322,322,4,4,0,1,0
29,325,325,18,14,4,2,1
31,330,330,27,21,6,2,1
7,351,351,27,27,0,1,0
12,371,371,84,84,0,1,0
27,376,376,3,3,0,1,0
1,398,398,4,4,0,1,0
32,413,413,25,7,18,4,3
17,417,417,36,36,0,1,0
13,429,429,53,5,48,4,3
0,446,446,21,12,9,2,1
34,474,474,7,3,4,2,1
22,486,486,20,20,0,1,0
6,496,496,41,27,14,2,1
5,499,499,148,67,81,4,3

29,104,104,16,16,0,1,0
37,108,108,25,8,17,4,3
27,123,123,3,3,0,1,0
45,126,126,7,7,0,1,0
15,128,128,9,9,0,1,0
28,144,144,3,3,0,1,0
18,151,151,25,25,0,1,0
7,156,156,24,21,3,2,1
24,163,163,22,4,18,3,2
17,184,184,18,18,0,1,0
22,193,193,2,2,0,1,0
20,213,213,1,1,0,1,0
2,222,222,16,16,0,1,0
34,224,224,10,2,8,2,1
25,238,238,1,1,0,1,0
38,251,251,5,5,0,1,0
35,271,271,28,19,9,4,3
32,288,288,11,1,10,2,1
0,290,290,1,1,0,1,0
36,295,295,4,1,3,2,1
42,300,300,17,12,5,2,1
12,318,318,21,21,0,1,0
23,321,321,22,6,16,3,2
41,324,324,23,1,22,4,3
39,328,328,168,156,12,4,3
14,332,332,32,32,0,1,0
13,343,343,39,39,0,1,0
6,351,351,20,20,0,1,0
11,367,367,19,19,0,1,0
40,394,394,1,1,0,1,0
3,409,409,41,12,29,4,3
19,413,413,36,36,0,1,0
16,423,423,14,9,5,2,1
31,436,436,20,20,0,1,0
5,442,442,3,3,0,1,0
9,443,443,28,28,0,1,0
10,450,450,9,6,3,2,1
1,453,453,29,5,24,3,2
33,454,454,118,73,45,4,3
30,458,458,15,6,9,4,3
21,460,460,28,2,26,4,3
4,463,463,35,7,28,3,2
43,469,469,16,16,0,1,0
44,475,475,110,110,0,1,0
8,478,478,19,2,17,4,3
26,490,490,88,30,58,3,2

3,104,104,6,3,3,2,1
24,105,105,14,14,0,1,0
27,116,116,16,16,0,1,0
16,121,121,1,1,0,1,0
5,126,126,12,12,0,1,0
10,148,148,1,1,0,1,0
12,149,149,15,15,0,1,0
0,163,163,34,34,0,1,0
28,174,174,34,18,16,2,1
20,216,216,15,15,0,1,0
32,225,225,28,28,0,1,0
23,252,252,18,6,12,2,1
25,275,275,3,3,0,1,0
26,280,280,7,7,0,1,0
37,282,282,75,75,0,1,0
29,296,296,8,8,0,1,0
19,312,312,16,4,12,4,3
8,323,323,31,3,28,2,1
14,325,325,48,48,0,1,0
31,334,334,30,14,16,2,1
30,335,335,82,22,60,4,3
22,340,340,15,4,11,3,2
9,347,347,35,35,0,1,0
21,360,360,41,41,0,1,0
15,375,375,1,1,0,1,0
18,379,379,45,45,0,1,0
17,386,386,78,78,0,1,0
39,390,390,9,9,0,1,0
35,392,392,8,8,0,1,0
4,404,404,6,1,5,2,1
11,419,419,3,3,0,1,0
38,425,425,107,41,66,3,2
13,432,432,40,6,34,4,3
33,432,432,45,45,0,1,0
7,435,435,2,2,0,1,0
1,457,457,217,142,75,4,3
36,459,459,3,3,0,1,0
2,480,480,10,10,0,1,0
6,484,484,10,10,0,1,0
34,494,494,17,3,14,2,1

12,124,124,24,24,0,1,0
3,135,135,37,27,10,3,2
13,139,139,3,3,0,1,0
26,142,142,28,20,8,2,1
38,149,149,3,3,0,1,0
0,152,152,36,36,0,1,0
20,152,152,21,9,12,4,3
15,166,166,7,3,4,2,1
6,171,171,1,1,0,1,0
24,175,175,9,9,0,1,0
31,186,186,55,55,0,1,0
18,197,197,12,2,10,3,2
28,206,206,53,53,0,1,0
23,209,209,8,8,0,1,0
32,214,214,27,27,0,1,0
19,247,247,1,1,0,1,0
41,247,247,33,20,13,2,1
25,252,252,18,2,16,3,2
21,270,270,2,2,0,1,0
9,277,277,24,15,9,3,2
14,293,293,9,9,0,1,0
39,302,302,6,6,0,1,0
33,315,315,39,39,0,1,0
10,317,317,6,6,0,1,0
35,334,334,11,11,0,1,0
34,342,342,21,3,18,4,3
37,370,370,33,33,0,1,0
36,375,375,40,40,0,1,0
22,382,382,15,15,0,1,0
29,384,384,31,26,5,2,1
43,391,391,42,27,15,4,3
27,397,397,11,11,0,1,0
8,399,399,2,2,0,1,0
1,411,411,21,21,0,1,0
42,413,413,10,7,3,2,1
7,415,415,36,36,0,1,0
30,436,436,43,43,0,1,0
5,437,437,43,21,22,3,2
40,437,437,29,29,0,1,0
4,438,438,59,59,0,1,0
17,443,443,7,7,0,1,0
11,454,454,61,61,0,1,0
16,459,459,30,30,0,1,0
2,498,498,30,15,15,2,1

2,103,103,1,1,0,1,0
27,117,117,21,4,17,2,1
14,118,118,24,20,4,2,1
17,137,137,1,1,0,1,0
23,151,151,14,4,10,2,1
37,155,155,40,40,0,1,0
1,155,155,13,7,6,2,1
24,169,169,2,2,0,1,0
25,191,191,12,6,6,3,2
4,196,196,3,3,0,1,0
7,199,199,20,6,14,2,1
33,208,208,12,12,0,1,0
28,213,213,2,2,0,1,0
32,218,218,2,2,0,1,0
29,218,218,18,18,0,1,0
34,221,221,7,7,0,1,0
21,232,232,3,3,0,1,0
3,235,235,3,3,0,1,0
31,239,239,52,52,0,1,0
0,253,253,67,67,0,1,0
12,259,259,22,22,0,1,0
11,270,270,17,17,0,1,0
6,282,282,35,2,33,4,3
36,288,288,13,1,12,3,2
16,289,289,32,1,31,3,2
19,291,291,78,54,24,4,3
13,304,304,9,9,0,1,0
8,340,340,101,33,68,3,2
35,346,346,8,2,6,2,1
10,361,361,56,10,46,2,1
15,366,366,9,9,0,1,0
5,394,394,36,36,0,1,0
30,422,422,148,130,18,4,3
9,428,428,4,4,0,1,0
22,441,441,5,5,0,1,0
18,450,450,96,96,0,1,0
26,474,474,56,19,37,2,1
20,478,478,46,46,0,1,0

34,119,119,1,1,0,1,0
36,123,123,8,8,0,1,0
8,138,138,9,9,0,1,0
10,148,148,13,13,0,1,0
12,158,158,31,31,0,1,0
25,164,164,17,17,0,1,0
15,207,207,33,33,0,1,0
2,216,216,87,30,57,3,2
19,231,231,6,6,0,1,0
29,235,235,12,1,11,2,1
31,244,244,27,27,0,1,0
22,256,256,50,50,0,1,0
27,264,264,1,1,0,1,0
24,265,265,2,2,0,1,0
30,270,270,16,4,12,4,3
35,280,280,4,4,0,1,0
9,301,301,1,1,0,1,0
16,307,307,39,39,0,1,0
6,311,311,33,3,30,2,1
17,325,325,8,8,0,1,0
11,351,351,21,14,7,2,1
32,359,359,86,30,56,4,3
33,368,368,23,23,0,1,0
0,374,374,73,19,54,3,2
26,377,377,47,47,0,1,0
14,423,423,17,2,15,3,2
23,436,436,4,1,3,2,1
4,442,442,3,3,0,1,0
1,455,455,3,3,0,1,0
3,465,465,63,34,29,2,1
7,470,470,31,31,0,1,0
28,472,472,162,155,7,2,1
13,475,475,63,55,8,3,2
18,479,479,99,30,69,4,3
21,485,485,125,59,66,4,3
20,495,495,20,20,0,1,0
5,500,500,43,43,0,1,0

38,112,112,8,3,5,2,1
26,121,121,2,2,0,1,0
18,145,145,30,30,0,1,0
20,176,176,5,5,0,1,0
46,187,187,24,24,0,1,0
29,190,190,2,2,0,1,0
28,206,206,16,16,0,1,0
17,207,207,13,13,0,1,0
42,207,207,33,33,0,1,0
43,218,218,1,1,0,1,0
8,240,240,37,19,18,3,2
25,242,242,4,4,0,1,0
3,246,246,35,35,0,1,0
19,259,259,6,6,0,1,0
6,260,260,3,3,0,1,0
36,260,260,64,21,43,3,2
44,264,264,1,1,0,1,0
15,265,265,4,1,3,2,1
41,267,267,4,4,0,1,0
32,272,272,97,40,57,4,3
45,279,279,60,60,0,1,0
13,281,281,47,40,7,2,1
10,292,292,4,4,0,1,0
35,293,293,62,11,51,4,3
27,294,294,18,18,0,1,0
4,302,302,2,2,0,1,0
21,311,311,3,3,0,1,0
22,320,320,18,18,0,1,0
34,336,336,17,17,0,1,0
5,337,337,36,13,23,2,1
39,338,338,22,22,0,1,0
31,342,342,4,4,0,1,0
24,374,374,19,19,0,1,0
23,382,382,30,30,0,1,0
7,396,396,41,15,26,3,2
37,398,398,44,41,3,2,1
14,398,398,1,1,0,1,0
16,443,443,39,10,29,4,3
30,460,460,57,35,22,2,1
0,463,463,103,62,41,4,3
2,470,470,56,6,50,3,2
12,483,483,14,14,0,1,0
9,486,486,26,26,0,1,0
1,488,488,1,1,0,1,0
11,492,492,26,26,0,1,0
33,494,494,23,2,21,4,3
40,495,495,16,16,0,1,0

23,100,100,19,3,16,3,2
2,103,103,3,3,0,1,0
31,113,113,2,2,0,1,0
9,119,119,1,1,0,1,0
20,125,125,10,10,0,1,0
6,145,145,29,10,19,2,1
10,147,147,1,1,0,1,0
14,197,197,30,30,0,1,0
17,212,212,38,38,0,1,0
13,227,227,34,34,0,1,0
33,249,249,14,8,6,3,2
4,250,250,2,2,0,1,0
11,255,255,1,1,0,1,0
22,257,257,1,1,0,1,0
28,267,267,63,41,22,4,3
29,274,274,75,69,6,3,2
21,293,293,21,21,0,1,0
18,299,299,15,15,0,1,0
35,321,321,103,103,0,1,0
5,325,325,141,141,0,1,0
19,326,326,10,2,8,2,1
3,334,334,68,26,42,3,2
32,353,353,8,3,5,2,1
24,376,376,33,33,0,1,0
15,397,397,57,19,38,2,1
27,398,398,38,16,22,2,1
1,403,403,70,60,10,2,1
16,406,406,11,1,10,3,2
30,416,416,17,17,0,1,0
8,417,417,3,3,0,1,0
0,430,430,141,141,0,1,0
25,453,453,46,46,0,1,0
12,462,462,3,3,0,1,0
26,485,485,15,15,0,1,0
7,490,490,10,10,0,1,0
34,492,492,21,1,20,4,3

14,101,101,1,1,0,1,0
25,107,107,11,5,6,3,2
23,141,141,39,3,36,3,2
16,188,188,11,4,7,2,1
4,202,202,12,1,11,4,3
7,256,256,93,77,16,2,1
13,258,258,75,15,60,4,3
10,303,303,22,22,0,1,0
27,331,331,37,29,8,3,2
6,335,335,52,36,16,4,3
21,338,338,61,27,34,3,2
12,342,342,37,37,0,1,0
24,344,344,11,11,0,1,0
15,346,346,34,34,0,1,0
20,357,357,8,8,0,1,0
22,374,374,42,42,0,1,0
18,377,377,40,40,0,1,0
26,386,386,31,31,0,1,0
28,398,398,2,2,0,1,0
0,399,399,37,37,0,1,0
11,407,407,52,34,18,4,3
29,423,423,26,5,21,4,3
9,434,434,14,8,6,3,2
8,457,457,16,1,15,4,3
19,467,467,47,9,38,3,2
17,484,484,23,11,12,3,2
1,484,484,85,33,52,3,2
2,486,486,286,151,135,4,3
3,487,487,144,123,21,4,3
5,488,488,15,15,0,1,0

27,101,101,2,2,0,1,0
24,104,104,15,15,0,1,0
4,110,110,10,2,8,3,2
15,120,120,7,4,3,2,1
31,126,126,4,4,0,1,0
37,151,151,9,2,7,2,1
17,156,156,27,21,6,3,2
12,165,165,30,30,0,1,0
32,182,182,25,2,23,2,1
8,184,184,3,3,0,1,0
33,194,194,9,3,6,2,1
1,203,203,4,4,0,1,0
23,204,204,6,6,0,1,0
35,214,214,2,2,0,1,0
34,229,229,62,47,15,2,1
18,253,253,10,10,0,1,0
10,271,271,24,24,0,1,0
14,272,272,5,5,0,1,0
19,295,295,9,3,6,3,2
13,308,308,43,31,12,4,3
7,314,314,9,9,0,1,0
28,320,320,44,20,24,4,3
20,325,325,91,11,80,3,2
21,339,339,11,6,5,2,1
9,358,358,208,61,147,4,3
25,358,358,20,9,11,2,1
11,373,373,49,49,0,1,0
26,401,401,89,27,62,3,2
0,404,404,1,1,0,1,0
6,423,423,15,15,0,1,0
29,425,425,94,68,26,3,2
2,429,429,79,21,58,3,2
5,439,439,24,24,0,1,0
30,467,467,9,4,5,2,1
16,468,468,21,21,0,1,0
22,479,479,76,16,60,3,2
3,489,489,6,6,0,1,0
36,495,495,10,10,0,1,0

13,105,105,31,11,20,3,2
11,127,127,11,11,0,1,0
10,129,129,7,7,0,1,0
3,141,141,10,10,0,1,0
37,145,145,38,10,28,3,2
21,145,145,15,11,4,2,1
25,147,147,21,16,5,2,1
1,154,154,23,2,21,4,3
20,155,155,1,1,0,1,0
15,195,195,9,5,4,2,1
8,197,197,6,6,0,1,0
4,217,217,21,7,14,3,2
14,223,223,1,1,0,1,0
9,224,224,9,4,5,2,1
30,225,225,12,2,10,3,2
23,229,229,11,7,4,2,1
29,237,237,8,8,0,1,0
32,250,250,15,10,5,2,1
16,251,251,4,4,0,1,0
31,254,254,2,2,0,1,0
28,257,257,3,3,0,1,0
6,270,270,13,13,0,1,0
38,286,286,18,18,0,1,0
22,302,302,87,87,0,1,0
12,302,302,40,5,35,4,3
36,312,312,14,14,0,1,0
19,316,316,56,56,0,1,0
18,318,318,44,44,0,1,0
26,320,320,7,7,0,1,0
33,359,359,68,8,60,4,3
24,382,382,12,12,0,1,0
27,389,389,29,29,0,1,0
7,394,394,20,20,0,1,0
5,404,404,32,8,24,4,3
35,422,422,120,54,66,3,2
0,427,427,109,56,53,4,3
17,446,446,7,3,4,2,1
2,448,448,49,49,0,1,0
39,464,464,95,44,51,3,2
34,485,485,5,5,0,1,0

19,100,100,13,13,0,1,0
18,101,101,25,25,0,1,0
32,111,111,5,5,0,1,0
12,119,119,1,1,0,1,0
31,126,126,12,5,7,2,1
7,139,139,20,12,8,3,2
14,148,148,2,2,0,1,0
23,182,182,11,11,0,1,0
6,199,199,12,4,8,2,1
16,200,200,26,14,12,3,2
5,219,219,33,7,26,2,1
3,219,219,7,7,0,1,0
9,228,228,12,1,11,2,1
4,240,240,14,14,0,1,0
15,240,240,30,30,0,1,0
37,263,263,20,20,0,1,0
30,270,270,25,13,12,4,3
26,278,278,28,28,0,1,0
34,291,291,2,2,0,1,0
27,300,300,1,1,0,1,0
8,302,302,76,76,0,1,0
36,314,314,2,2,0,1,0
22,325,325,114,77,37,2,1
11,325,325,34,34,0,1,0
33,332,332,52,52,0,1,0
1,342,342,49,6,43,2,1
29,353,353,32,24,8,2,1
20,370,370,41,41,0,1,0
13,375,375,30,30,0,1,0
10,378,378,1,1,0,1,0
28,409,409,50,50,0,1,0
2,431,431,74,74,0,1,0
25,432,432,127,87,40,4,3
17,446,446,33,33,0,1,0
35,477,477,25,10,15,4,3
24,488,488,39,1,38,2,1
0,497,497,25,20,5,2,1
21,499,499,31,1,30,3,2

2,124,124,14,5,9,4,3
12,128,128,6,6,0,1,0
44,130,130,32,28,4,2,1
19,142,142,1,1,0,1,0
10,147,147,8,8,0,1,0
37,149,149,2,2,0,1,0
45,150,150,23,23,0,1,0
22,152,152,15,6,9,4,3
11,159,159,4,4,0,1,0
1,174,174,5,5,0,1,0
26,177,177,19,19,0,1,0
13,181,181,14,14,0,1,0
21,187,187,1,1,0,1,0
8,218,218,2,2,0,1,0
4,220,220,30,3,27,2,1
20,237,237,7,3,4,2,1
17,239,239,20,15,5,2,1
3,239,239,10,10,0,1,0
38,245,245,36,36,0,1,0
43,248,248,7,3,4,2,1
42,250,250,18,18,0,1,0
5,280,280,25,25,0,1,0
36,285,285,51,9,42,3,2
29,287,287,11,11,0,1,0
7,309,309,21,12,9,2,1
0,325,325,31,25,6,3,2
18,333,333,3,3,0,1,0
32,334,334,24,2,22,4,3
16,335,335,7,1,6,3,2
14,343,343,6,1,5,2,1
6,351,351,23,17,6,3,2
24,367,367,23,23,0,1,0
39,367,367,7,1,6,2,1
25,380,380,30,18,12,4,3
41,382,382,69,69,0,1,0
35,391,391,45,23,22,2,1
30,398,398,36,36,0,1,0
23,404,404,114,51,63,4,3
15,429,429,23,23,0,1,0
28,435,435,6,6,0,1,0
40,438,438,15,15,0,1,0
34,461,461,65,55,10,3,2
27,479,479,27,27,0,1,0
9,485,485,67,45,22,2,1
46,485,485,6,6,0,1,0
33,487,487,181,119,62,3,2
31,495,495,4,1,3,2,1

0,111,111,15,9,6,3,2
29,127,127,2,2,0,1,0
11,137,137,4,4,0,1,0
26,149,149,24,18,6,3,2
12,151,151,30,4,26,4,3
5,155,155,56,56,0,1,0
16,155,155,7,1,6,3,2
21,158,158,56,56,0,1,0
25,164,164,7,2,5,2,1
10,173,173,35,35,0,1,0
18,191,191,17,6,11,2,1
6,197,197,7,7,0,1,0
27,204,204,19,19,0,1,0
17,232,232,35,11,24,2,1
1,237,237,17,6,11,2,1
30,243,243,31,31,0,1,0
8,244,244,2,2,0,1,0
33,253,253,16,16,0,1,0
7,263,263,4,4,0,1,0
24,276,276,31,13,18,4,3
3,292,292,101,38,63,4,3
32,300,300,10,10,0,1,0
9,307,307,12,12,0,1,0
31,340,340,48,48,0,1,0
13,341,341,60,38,22,3,2
23,377,377,35,28,7,2,1
19,377,377,40,24,16,3,2
2,387,387,46,6,40,3,2
20,416,416,40,40,0,1,0
28,422,422,23,11,12,3,2
15,434,434,28,28,0,1,0
14,469,469,55,34,21,4,3
22,475,475,43,11,32,3,2
4,484,484,23,2,21,4,3

27,112,112,8,5,3,2,1
10,113,113,25,25,0,1,0
4,115,115,2,2,0,1,0
26,128,128,8,8,0,1,0
35,129,129,30,22,8,3,2
31,132,132,1,1,0,1,0
22,149,149,18,6,12,3,2
13,157,157,2,2,0,1,0
11,183,183,45,45,0,1,0
17,186,186,26,21,5,2,1
32,187,187,41,13,28,3,2
23,214,214,10,10,0,1,0
7,221,221,15,6,9,4,3
1,234,234,6,6,0,1,0
24,235,235,12,12,0,1,0
8,244,244,5,5,0,1,0
20,248,248,36,28,8,2,1
3,272,272,45,15,30,4,3
15,312,312,17,17,0,1,0
25,321,321,38,20,18,4,3
29,334,334,15,15,0,1,0
34,335,335,12,8,4,2,1
0,343,343,5,5,0,1,0
28,347,347,27,27,0,1,0
18,355,355,100,70,30,4,3
14,355,355,44,44,0,1,0
30,357,357,66,66,0,1,0
5,363,363,16,16,0,1,0
16,377,377,45,15,30,3,2
21,384,384,7,7,0,1,0
12,425,425,15,15,0,1,0
6,436,436,43,43,0,1,0
2,446,446,21,21,0,1,0
19,452,452,12,3,9,4,3
36,454,454,15,15,0,1,0
33,457,457,74,28,46,2,1
9,458,458,206,206,0,1,0

35,104,104,13,13,0,1,0
31,115,115,53,53,0,1,0
41,128,128,14,14,0,1,0
32,138,138,15,5,10,3,2
34,143,143,2,2,0,1,0
1,155,155,3,3,0,1,0
4,156,156,3,3,0,1,0
27,167,167,22,22,0,1,0
30,169,169,1,1,0,1,0
10,179,179,10,10,0,1,0
39,187,187,30,15,15,2,1
6,203,203,8,8,0,1,0
0,206,206,25,25,0,1,0
36,214,214,42,9,33,4,3
16,249,249,96,30,66,4,3
21,254,254,24,24,0,1,0
8,273,273,1,1,0,1,0
38,274,274,10,10,0,1,0
3,275,275,5,5,0,1,0
24,277,277,24,24,0,1,0
42,283,283,80,67,13,2,1
20,286,286,28,15,13,2,1
5,309,309,23,23,0,1,0
18,314,314,31,31,0,1,0
29,314,314,14,4,10,3,2
22,356,356,31,31,0,1,0
37,370,370,14,14,0,1,0
2,381,381,24,24,0,1,0
12,391,391,1,1,0,1,0
25,405,405,21,9,12,3,2
26,406,406,4,4,0,1,0
14,415,415,22,1,21,4,3
19,415,415,1,1,0,1,0
13,422,422,4,4,0,1,0
33,430,430,10,7,3,2,1
11,430,430,1,1,0,1,0
7,433,433,77,77,0,1,0
40,457,457,16,16,0,1,0
15,465,465,75,75,0,1,0
28,476,476,12,12,0,1,0
17,487,487,20,20,0,1,0
9,495,495,52,2,50,2,1
23,498,498,84,2,82,3,2

36,109,109,15,15,0,1,0
25,116,116,2,2,0,1,0
5,122,122,1,1,0,1,0
22,126,126,11,11,0,1,0
16,141,141,1,1,0,1,0
31,143,143,20,20,0,1,0
9,154,154,3,3,0,1,0
33,164,164,32,32,0,1,0
8,166,166,12,12,0,1,0
11,178,178,28,28,0,1,0
10,192,192,2,2,0,1,0
2,193,193,3,3,0,1,0
14,194,194,16,8,8,2,1
26,204,204,22,12,10,3,2
29,230,230,22,14,8,3,2
27,232,232,25,25,0,1,0
7,240,240,42,42,0,1,0
24,255,255,19,1,18,4,3
21,276,276,17,17,0,1,0
19,289,289,24,16,8,3,2
0,314,314,1,1,0,1,0
13,323,323,24,9,15,4,3
30,327,327,123,4,119,4,3
1,354,354,36,4,32,2,1
18,356,356,7,7,0,1,0
15,356,356,19,19,0,1,0
17,370,370,37,12,25,4,3
6,372,372,67,53,14,3,2
28,375,375,13,13,0,1,0
34,379,379,57,1,56,4,3
20,383,383,79,43,36,4,3
23,392,392,4,4,0,1,0
32,411,411,1,1,0,1,0
12,424,424,45,7,38,2,1
35,444,444,14,14,0,1,0
4,453,453,216,216,0,1,0
3,456,456,118,104,14,2,1

4,112,112,5,5,0,1,0
2,117,117,1,1,0,1,0
27,149,149,1,1,0,1,0
25,150,150,16,4,12,4,3
34,151,151,2,2,0,1,0
23,155,155,6,6,0,1,0
39,161,161,3,3,0,1,0
6,176,176,15,15,0,1,0
16,189,189,9,9,0,1,0
29,218,218,78,24,54,4,3
26,228,228,4,4,0,1,0
36,234,234,5,2,3,2,1
28,244,244,73,23,50,3,2
3,245,245,3,3,0,1,0
41,249,249,36,21,15,4,3
40,257,257,2,2,0,1,0
38,265,265,9,9,0,1,0
37,268,268,60,30,30,3,2
12,283,283,82,34,48,3,2
33,288,288,2,2,0,1,0
15,306,306,1,1,0,1,0
20,324,324,23,23,0,1,0
11,326,326,12,12,0,1,0
8,329,329,9,1,8,2,1
31,333,333,5,2,3,2,1
9,335,335,57,57,0,1,0
5,340,340,7,7,0,1,0
13,343,343,2,2,0,1,0
0,368,368,151,147,4,2,1
10,379,379,51,51,0,1,0
22,381,381,68,68,0,1,0
35,393,393,146,146,0,1,0
1,394,394,20,6,14,2,1
21,394,394,13,1,12,3,2
30,418,418,6,6,0,1,0
14,447,447,5,2,3,2,1
7,448,448,40,28,12,3,2
24,453,453,102,102,0,1,0
19,453,453,31,31,0,1,0
17,477,477,20,3,17,2,1
18,481,481,29,11,18,2,1
32,498,498,8,8,0,1,0

18,103,103,1,1,0,1,0
33,118,118,34,34,0,1,0
22,145,145,9,5,4,2,1
29,152,152,3,3,0,1,0
17,189,189,19,4,15,2,1
10,192,192,15,15,0,1,0
13,213,213,26,26,0,1,0
20,217,217,31,5,26,2,1
16,221,221,25,25,0,1,0
34,225,225,2,2,0,1,0
5,226,226,4,4,0,1,0
21,227,227,3,3,0,1,0
32,228,228,35,35,0,1,0
1,229,229,9,9,0,1,0
36,234,234,26,4,22,3,2
12,238,238,42,42,0,1,0
3,239,239,89,89,0,1,0
25,244,244,32,11,21,4,3
27,244,244,64,55,9,2,1
11,246,246,69,69,0,1,0
7,250,250,4,4,0,1,0
24,297,297,4,4,0,1,0
30,319,319,49,49,0,1,0
35,325,325,5,5,0,1,0
0,348,348,49,9,40,2,1
28,358,358,50,2,48,4,3
23,362,362,7,4,3,2,1
2,379,379,12,12,0,1,0
6,409,409,69,22,47,3,2
9,409,409,13,13,0,1,0
4,437,437,2,2,0,1,0
26,440,440,98,83,15,2,1
31,447,447,28,12,16,2,1
15,450,450,32,32,0,1,0
8,475,475,14,2,12,4,3
14,478,478,53,53,0,1,0
19,491,491,57,12,45,4,3

18,106,106,2,2,0,1,0
28,112,112,15,15,0,1,0
19,116,116,1,1,0,1,0
15,126,126,19,19,0,1,0
25,143,143,35,35,0,1,0
5,146,146,21,3,18,4,3
1,151,151,14,14,0,1,0
12,151,151,14,14,0,1,0
34,159,159,10,2,8,2,1
21,162,162,1,1,0,1,0
29,170,170,2,2,0,1,0
31,173,173,10,1,9,4,3
20,197,197,54,45,9,2,1
11,202,202,4,4,0,1,0
4,224,224,11,5,6,3,2
26,240,240,35,1,34,2,1
16,264,264,8,5,3,2,1
24,265,265,39,7,32,3,2
32,314,314,64,64,0,1,0
14,315,315,49,21,28,2,1
10,318,318,2,2,0,1,0
0,322,322,15,15,0,1,0
33,330,330,22,8,14,2,1
7,346,346,88,48,40,3,2
9,352,352,51,33,18,4,3
30,358,358,8,5,3,2,1
6,384,384,23,8,15,2,1
17,404,404,22,13,9,4,3
3,408,408,12,2,10,3,2
13,412,412,64,64,0,1,0
8,415,415,165,165,0,1,0
23,419,419,38,5,33,4,3
22,429,429,65,65,0,1,0
27,433,433,93,93,0,1,0
2,500,500,52,52,0,1,0

8,102,102,7,7,0,1,0
6,102,102,7,7,0,1,0
34,112,112,9,3,6,3,2
21,115,115,20,20,0,1,0
20,120,120,12,4,8,2,1
29,121,121,18,18,0,1,0
7,128,128,16,16,0,1,0
32,156,156,51,51,0,1,0
2,158,158,12,12,0,1,0
16,161,161,5,5,0,1,0
3,164,164,2,2,0,1,0
24,164,164,1,1,0,1,0
25,172,172,19,19,0,1,0
4,176,176,18,13,5,2,1
5,187,187,32,32,0,1,0
23,207,207,7,2,5,2,1
18,228,228,20,20,0,1,0
19,238,238,2,2,0,1,0
27,239,239,35,35,0,1,0
10,253,253,9,1,8,2,1
33,277,277,27,14,13,2,1
14,285,285,43,20,23,2,1
28,308,308,15,15,0,1,0
15,313,313,38,38,0,1,0
0,329,329,88,12,76,3,2
9,339,339,25,5,20,2,1
1,370,370,19,19,0,1,0
35,414,414,55,37,18,4,3
12,416,416,43,43,0,1,0
22,427,427,26,26,0,1,0
31,431,431,29,14,15,4,3
11,443,443,117,117,0,1,0
17,451,451,37,37,0,1,0
30,455,455,57,7,50,2,1
26,466,466,53,8,45,4,3
13,489,489,89,89,0,1,0

6,100,100,15,15,0,1,0
31,101,101,11,11,0,1,0
19,115,115,43,43,0,1,0
22,138,138,6,6,0,1,0
11,160,160,23,23,0,1,0
24,175,175,45,45,0,1,0
28,181,181,1,1,0,1,0
26,182,182,3,3,0,1,0
10,186,186,30,30,0,1,0
21,197,197,6,6,0,1,0
1,206,206,3,3,0,1,0
34,210,210,3,3,0,1,0
17,210,210,6,6,0,1,0
35,221,221,10,10,0,1,0
3,227,227,14,14,0,1,0
5,241,241,55,32,23,2,1
25,250,250,5,5,0,1,0
8,272,272,6,6,0,1,0
23,274,274,68,68,0,1,0
30,288,288,5,1,4,2,1
9,304,304,58,58,0,1,0
12,305,305,54,54,0,1,0
16,309,309,53,53,0,1,0
32,319,319,41,34,7,2,1
36,330,330,3,3,0,1,0
13,341,341,28,13,15,4,3
14,358,358,6,6,0,1,0
29,364,364,11,1,10,2,1
4,365,365,34,34,0,1,0
0,389,389,39,5,34,3,2
18,395,395,73,65,8,2,1
2,458,458,56,56,0,1,0
33,466,466,172,131,41,4,3
15,468,468,21,21,0,1,0
20,471,471,6,2,4,2,1
27,474,474,17,9,8,3,2
7,475,475,45,45,0,1,0

26,106,106,6,6,0,1,0
30,109,109,6,3,3,2,1
3,120,120,9,9,0,1,0
33,120,120,41,8,33,4,3
19,160,160,4,4,0,1,0
22,163,163,2,2,0,1,0
7,169,169,21,21,0,1,0
16,174,174,5,5,0,1,0
11,177,177,8,5,3,2,1
8,181,181,1,1,0,1,0
14,195,195,16,4,12,2,1
4,200,200,8,8,0,1,0
17,235,235,10,2,8,3,2
40,242,242,8,8,0,1,0
15,253,253,2,2,0,1,0
37,256,256,52,14,38,3,2
5,270,270,6,2,4,2,1
31,270,270,13,13,0,1,0
43,310,310,6,6,0,1,0
23,331,331,4,4,0,1,0
32,336,336,18,8,10,3,2
27,349,349,10,10,0,1,0
25,350,350,4,4,0,1,0
0,355,355,3,3,0,1,0
34,361,361,28,19,9,2,1
39,362,362,60,60,0,1,0
12,375,375,31,23,8,2,1
10,379,379,22,4,18,2,1
28,398,398,6,1,5,2,1
13,411,411,8,2,6,2,1
41,414,414,19,10,9,2,1
20,419,419,188,188,0,1,0
29,428,428,131,6,125,4,3
18,435,435,12,6,6,2,1
38,441,441,94,71,23,2,1
42,442,442,4,4,0,1,0
2,449,449,48,48,0,1,0
35,452,452,86,86,0,1,0
24,460,460,120,120,0,1,0
21,463,463,2,2,0,1,0
1,466,466,113,98,15,2,1
6,469,469,35,11,24,4,3
9,479,479,21,9,12,3,2
36,491,491,35,35,0,1,0

36,119,119,9,9,0,1,0
12,132,132,1,1,0,1,0
39,138,138,1,1,0,1,0
19,145,145,26,26,0,1,0
7,145,145,35,8,27,4,3
34,157,157,2,2,0,1,0
25,160,160,5,5,0,1,0
11,165,165,8,8,0,1,0
38,187,187,10,10,0,1,0
8,205,205,2,2,0,1,0
1,218,218,7,7,0,1,0
22,264,264,75,45,30,2,1
14,279,279,3,3,0,1,0
23,279,279,40,40,0,1,0
0,291,291,26,6,20,3,2
20,297,297,28,28,0,1,0
16,298,298,26,11,15,2,1
26,303,303,31,1,30,2,1
37,346,346,15,5,10,2,1
27,360,360,6,6,0,1,0
40,363,363,21,4,17,2,1
6,366,366,5,5,0,1,0
29,367,367,78,2,76,4,3
33,383,383,34,4,30,2,1
18,390,390,31,31,0,1,0
13,392,392,27,27,0,1,0
32,398,398,1,1,0,1,0
3,402,402,137,88,49,3,2
9,404,404,3,3,0,1,0
21,409,409,26,4,22,2,1
31,415,415,85,11,74,3,2
30,454,454,51,51,0,1,0
5,459,459,1,1,0,1,0
10,468,468,110,20,90,4,3
15,468,468,33,33,0,1,0
24,475,475,27,12,15,3,2
4,476,476,68,68,0,1,0
17,477,477,15,15,0,1,0
2,491,491,22,4,18,3,2
35,496,496,184,37,147,4,3
28,498,498,27,24,3,2,1

9,101,101,8,8,0,1,0
8,106,106,1,1,0,1,0
26,110,110,21,21,0,1,0
15,116,116,23,23,0,1,0
34,118,118,10,10,0,1,0
35,134,134,28,28,0,1,0
30,151,151,8,3,5,2,1
21,151,151,5,5,0,1,0
17,153,153,2,2,0,1,0
10,157,157,3,3,0,1,0
5,172,172,30,30,0,1,0
33,196,196,6,6,0,1,0
14,200,200,6,6,0,1,0
29,211,211,54,15,39,4,3
12,213,213,12,12,0,1,0
7,228,228,22,22,0,1,0
4,233,233,29,8,21,2,1
23,246,246,39,39,0,1,0
20,250,250,24,18,6,3,2
18,265,265,7,4,3,2,1
2,283,283,14,8,6,2,1
24,291,291,8,2,6,2,1
28,298,298,6,6,0,1,0
19,301,301,38,31,7,2,1
32,311,311,11,5,6,3,2
13,315,315,22,22,0,1,0
25,315,315,66,63,3,2,1
31,342,342,28,28,0,1,0
22,376,376,40,20,20,3,2
27,403,403,74,74,0,1,0
16,421,421,50,50,0,1,0
11,434,434,25,5,20,3,2
0,452,452,33,21,12,2,1
3,453,453,165,141,24,3,2
1,461,461,13,13,0,1,0
6,479,479,169,73,96,4,3

2,106,106,1,1,0,1,0
9,109,109,27,27,0,1,0
28,133,133,8,5,3,2,1
26,146,146,36,36,0,1,0
21,154,154,8,8,0,1,0
25,159,159,25,12,13,2,1
6,210,210,52,30,22,3,2
10,213,213,5,5,0,1,0
30,229,229,3,3,0,1,0
36,229,229,48,48,0,1,0
22,245,245,1,1,0,1,0
35,262,262,41,15,26,2,1
12,269,269,13,13,0,1,0
37,271,271,20,20,0,1,0
14,282,282,1,1,0,1,0
11,283,283,44,44,0,1,0
20,293,293,3,3,0,1,0
29,295,295,22,4,18,2,1
3,316,316,3,3,0,1,0
27,323,323,13,3,10,3,2
34,333,333,5,5,0,1,0
38,341,341,62,62,0,1,0
1,343,343,2,2,0,1,0
0,350,350,53,37,16,2,1
16,354,354,8,8,0,1,0
15,356,356,3,3,0,1,0
13,359,359,16,16,0,1,0
39,379,379,68,31,37,2,1
43,382,382,90,90,0,1,0
41,383,383,9,9,0,1,0
5,384,384,42,11,31,2,1
18,403,403,44,44,0,1,0
31,406,406,59,25,34,2,1
19,408,408,17,10,7,2,1
42,413,413,15,9,6,3,2
17,438,438,44,12,32,2,1
33,441,441,3,3,0,1,0
23,446,446,71,71,0,1,0
44,447,447,37,18,19,2,1
40,457,457,4,4,0,1,0
4,460,460,58,58,0,1,0
7,463,463,9,6,3,2,1
8,464,464,1,1,0,1,0
32,472,472,68,60,8,2,1
24,476,476,15,15,0,1,0

20,111,111,3,3,0,1,0
14,113,113,13,3,10,3,2
8,136,136,12,1,11,2,1
21,148,148,1,1,0,1,0
6,163,163,4,4,0,1,0
38,166,166,24,18,6,3,2
25,167,167,18,4,14,2,1
10,167,167,6,6,0,1,0
37,171,171,19,4,15,4,3
18,175,175,2,2,0,1,0
22,178,178,1,1,0,1,0
36,209,209,25,2,23,3,2
9,210,210,26,26,0,1,0
34,216,216,26,26,0,1,0
1,219,219,22,5,17,2,1
3,222,222,9,2,7,3,2
32,224,224,2,2,0,1,0
4,240,240,48,18,30,4,3
11,244,244,27,27,0,1,0
30,246,246,6,6,0,1,0
39,249,249,5,5,0,1,0
27,275,275,16,3,13,2,1
19,299,299,12,1,11,2,1
31,321,321,31,31,0,1,0
5,322,322,8,8,0,1,0
0,329,329,33,9,24,4,3
13,339,339,37,37,0,1,0
15,340,340,58,58,0,1,0
35,356,356,77,7,70,3,2
40,363,363,38,38,0,1,0
16,369,369,1,1,0,1,0
24,383,383,65,51,14,2,1
33,399,399,65,12,53,3,2
17,450,450,138,112,26,2,1
28,454,454,45,36,9,4,3
23,466,466,9,9,0,1,0
2,470,470,52,16,36,4,3
7,476,476,21,21,0,1,0
26,480,480,4,4,0,1,0
29,481,481,159,159,0,1,0
12,490,490,54,54,0,1,0

4,100,100,10,10,0,1,0
34,119,119,3,3,0,1,0
37,137,137,22,22,0,1,0
18,144,144,4,4,0,1,0
5,160,160,36,8,28,3,2
3,162,162,23,7,16,2,1
12,164,164,4,4,0,1,0
7,179,179,2,2,0,1,0
29,193,193,8,8,0,1,0
11,201,201,33,6,27,3,2
31,218,218,54,54,0,1,0
6,243,243,9,9,0,1,0
0,243,243,21,9,12,4,3
28,246,246,23,1,22,3,2
25,247,247,25,25,0,1,0
27,259,259,9,9,0,1,0
36,266,266,50,32,18,2,1
21,266,266,23,17,6,2,1
14,286,286,18,1,17,2,1
16,287,287,31,31,0,1,0
20,297,297,27,23,4,2,1
19,300,300,45,45,0,1,0
24,300,300,33,5,28,3,2
2,312,312,18,5,13,2,1
33,316,316,55,7,48,2,1
1,322,322,140,140,0,1,0
10,347,347,6,6,0,1,0
13,354,354,25,15,10,3,2
17,358,358,1,1,0,1,0
26,384,384,24,6,18,4,3
15,387,387,6,6,0,1,0
35,401,401,22,7,15,4,3
22,414,414,2,2,0,1,0
23,455,455,17,17,0,1,0
32,460,460,78,75,3,2,1
30,462,462,48,48,0,1,0
8,495,495,80,80,0,1,0
9,495,495,77,23,54,4,3

15,104,104,28,6,22,2,1
5,109,109,14,14,0,1,0
13,118,118,18,18,0,1,0
32,138,138,13,13,0,1,0
34,167,167,49,1,48,4,3
10,168,168,57,53,4,2,1
7,180,180,1,1,0,1,0
26,189,189,40,34,6,2,1
11,198,198,29,29,0,1,0
23,216,216,5,1,4,2,1
1,223,223,4,4,0,1,0
4,226,226,29,29,0,1,0
31,228,228,10,10,0,1,0
22,239,239,68,5,63,4,3
0,256,256,36,22,14,3,2
8,258,258,7,2,5,2,1
12,264,264,29,4,25,2,1
36,291,291,16,8,8,3,2
17,294,294,38,38,0,1,0
25,298,298,7,2,5,2,1
3,313,313,3,3,0,1,0
9,317,317,6,6,0,1,0
14,335,335,56,56,0,1,0
6,336,336,1,1,0,1,0
35,354,354,49,22,27,2,1
19,365,365,35,35,0,1,0
29,373,373,12,3,9,2,1
18,375,375,18,18,0,1,0
21,397,397,46,46,0,1,0
30,420,420,37,3,34,3,2
28,431,431,11,11,0,1,0
20,431,431,54,14,40,4,3
2,436,436,35,9,26,3,2
33,449,449,25,4,21,3,2
16,480,480,14,2,12,3,2
24,482,482,29,4,25,2,1
27,482,482,58,58,0,1,0

19,107,107,17,7,10,2,1
12,114,114,9,9,0,1,0
13,115,115,4,4,0,1,0
17,119,119,36,14,22,3,2
4,120,120,7,7,0,1,0
20,163,163,4,1,3,2,1
36,197,197,7,1,6,2,1
27,205,205,8,8,0,1,0
37,211,211,34,16,18,4,3
6,223,223,23,23,0,1,0
0,231,231,37,25,12,3,2
8,253,253,12,12,0,1,0
28,264,264,21,21,0,1,0
15,265,265,44,44,0,1,0
39,272,272,28,4,24,3,2
14,279,279,7,7,0,1,0
30,282,282,23,5,18,2,1
5,288,288,63,47,16,2,1
23,294,294,31,19,12,2,1
9,301,301,23,23,0,1,0
2,323,323,29,29,0,1,0
16,324,324,19,19,0,1,0
1,326,326,5,5,0,1,0
24,328,328,106,73,33,4,3
22,329,329,45,45,0,1,0
32,346,346,1,1,0,1,0
35,379,379,11,11,0,1,0
33,384,384,19,3,16,2,1
3,401,401,2,2,0,1,0
26,409,409,67,25,42,2,1
11,425,425,24,24,0,1,0
25,428,428,22,22,0,1,0
18,428,428,11,11,0,1,0
40,464,464,5,5,0,1,0
29,464,464,15,15,0,1,0
21,465,465,29,13,16,3,2
31,470,470,116,18,98,3,2
34,475,475,51,51,0,1,0
38,477,477,80,61,19,2,1
10,487,487,17,17,0,1,0
7,496,496,48,21,27,4,3

1,104,104,30,1,29,4,3
9,116,116,3,3,0,1,0
24,133,133,52,52,0,1,0
38,146,146,10,10,0,1,0
11,146,146,7,1,6,3,2
23,157,157,6,1,5,2,1
35,168,168,30,1,29,4,3
15,201,201,13,5,8,2,1
2,203,203,5,5,0,1,0
7,215,215,31,31,0,1,0
10,257,257,31,7,24,4,3
18,264,264,38,26,12,2,1
25,266,266,49,45,4,2,1
21,268,268,29,24,5,2,1
32,269,269,36,14,22,2,1
34,285,285,1,1,0,1,0
8,293,293,103,80,23,2,1
26,298,298,26,7,19,2,1
17,299,299,15,3,12,3,2
30,302,302,14,1,13,2,1
4,305,305,3,3,0,1,0
28,306,306,2,2,0,1,0
12,306,306,13,13,0,1,0
0,325,325,1,1,0,1,0
31,338,338,28,13,15,4,3
22,341,341,2,2,0,1,0
27,381,381,2,2,0,1,0
13,385,385,28,21,7,2,1
29,390,390,41,41,0,1,0
33,395,395,25,25,0,1,0
20,412,412,12,12,0,1,0
39,418,418,133,133,0,1,0
19,423,423,24,24,0,1,0
37,432,432,23,23,0,1,0
16,443,443,43,43,0,1,0
36,444,444,25,9,16,2,1
5,460,460,39,39,0,1,0
14,484,484,63,63,0,1,0
3,494,494,36,3,33,4,3
6,498,498,20,20,0,1,0

20,113,113,7,3,4,2,1
27,121,121,10,10,0,1,0
28,123,123,2,2,0,1,0
10,126,126,32,10,22,3,2
36,127,127,5,5,0,1,0
19,136,136,28,28,0,1,0
5,139,139,13,13,0,1,0
40,140,140,3,3,0,1,0
31,154,154,60,8,52,4,3
18,155,155,14,4,10,3,2
15,158,158,7,2,5,2,1
16,169,169,23,6,17,2,1
6,179,179,20,20,0,1,0
30,183,183,28,28,0,1,0
14,204,204,9,2,7,2,1
39,206,206,16,4,12,2,1
29,211,211,30,30,0,1,0
0,219,219,33,33,0,1,0
9,225,225,29,24,5,2,1
21,237,237,2,2,0,1,0
22,237,237,39,39,0,1,0
4,239,239,3,3,0,1,0
38,262,262,31,31,0,1,0
34,279,279,32,17,15,2,1
23,280,280,63,7,56,3,2
11,299,299,20,20,0,1,0
35,301,301,7,4,3,2,1
26,302,302,34,9,25,2,1
7,309,309,1,1,0,1,0
25,342,342,2,2,0,1,0
1,352,352,8,8,0,1,0
3,358,358,21,21,0,1,0
33,363,363,21,21,0,1,0
12,366,366,1,1,0,1,0
41,368,368,24,8,16,3,2
32,383,383,43,18,25,2,1
8,403,403,22,15,7,2,1
2,438,438,41,3,38,4,3
24,447,447,69,69,0,1,0
13,453,453,26,13,13,2,1
17,455,455,16,16,0,1,0
37,486,486,19,3,16,2,1

8,100,100,10,10,0,1,0
19,101,101,3,3,0,1,0
13,124,124,3,3,0,1,0
28,142,142,26,26,0,1,0
14,154,154,6,6,0,1,0
35,159,159,25,5,20,2,1
2,167,167,48,36,12,2,1
22,175,175,39,39,0,1,0
31,185,185,14,14,0,1,0
33,185,185,6,6,0,1,0
27,191,191,6,6,0,1,0
7,202,202,42,42,0,1,0
24,225,225,11,3,8,3,2
39,225,225,24,21,3,2,1
15,229,229,12,12,0,1,0
40,232,232,39,39,0,1,0
25,234,234,28,28,0,1,0
17,236,236,1,1,0,1,0
11,237,237,8,8,0,1,0
16,259,259,30,30,0,1,0
34,259,259,31,7,24,4,3
32,284,284,3,3,0,1,0
30,297,297,48,40,8,3,2
21,301,301,29,4,25,2,1
1,303,303,4,4,0,1,0
0,307,307,13,8,5,2,1
12,312,312,24,3,21,2,1
41,313,313,13,5,8,2,1
26,318,318,28,28,0,1,0
23,342,342,39,14,25,2,1
37,351,351,127,127,0,1,0
3,358,358,38,17,21,4,3
42,370,370,61,18,43,2,1
4,379,379,5,5,0,1,0
5,403,403,1,1,0,1,0
38,418,418,11,2,9,4,3
10,425,425,29,29,0,1,0
36,432,432,3,3,0,1,0
20,446,446,2,2,0,1,0
18,459,459,56,52,4,2,1
29,463,463,15,12,3,2,1
6,470,470,52,24,28,3,2
9,472,472,7,7,0,1,0

29,102,102,18,13,5,2,1
13,114,114,1,1,0,1,0
27,116,116,4,4,0,1,0
17,124,124,10,3,7,2,1
22,136,136,2,2,0,1,0
12,145,145,53,19,34,2,1
20,151,151,4,4,0,1,0
5,155,155,5,5,0,1,0
31,180,180,5,1,4,2,1
34,189,189,67,31,36,2,1
39,203,203,46,20,26,2,1
2,207,207,19,14,5,2,1
30,212,212,56,47,9,4,3
23,216,216,4,4,0,1,0
35,233,233,14,14,0,1,0
40,236,236,6,6,0,1,0
37,243,243,2,2,0,1,0
6,251,251,3,3,0,1,0
26,266,266,9,9,0,1,0
15,270,270,27,12,15,4,3
7,278,278,20,2,18,2,1
19,288,288,15,15,0,1,0
9,289,289,29,9,20,3,2
28,297,297,5,5,0,1,0
0,300,300,57,3,54,3,2
25,327,327,43,43,0,1,0
8,330,330,35,35,0,1,0
21,333,333,66,22,44,2,1
33,344,344,64,21,43,2,1
1,348,348,6,6,0,1,0
36,348,348,74,32,42,3,2
32,355,355,33,33,0,1,0
18,386,386,10,1,9,3,2
11,391,391,1,1,0,1,0
14,413,413,50,50,0,1,0
16,417,417,24,4,20,2,1
10,427,427,73,46,27,4,3
24,433,433,6,6,0,1,0
38,439,439,21,3,18,4,3
3,440,440,12,12,0,1,0
4,475,475,21,17,4,2,1

8,102,102,1,1,0,1,0
22,105,105,21,7,14,2,1
43,117,117,13,13,0,1,0
2,137,137,1,1,0,1,0
32,159,159,14,14,0,1,0
7,167,167,2,2,0,1,0
11,173,173,11,11,0,1,0
36,185,185,15,15,0,1,0
41,218,218,7,7,0,1,0
31,222,222,6,6,0,1,0
15,223,223,21,14,7,2,1
42,230,230,13,13,0,1,0
0,235,235,8,8,0,1,0
24,236,236,16,16,0,1,0
21,252,252,8,8,0,1,0
5,257,257,21,5,16,3,2
16,260,260,14,14,0,1,0
23,261,261,62,62,0,1,0
45,266,266,59,42,17,2,1
40,269,269,20,20,0,1,0
39,269,269,13,1,12,4,3
27,288,288,7,7,0,1,0
17,293,293,4,4,0,1,0
29,297,297,114,107,7,2,1
46,301,301,39,39,0,1,0
33,308,308,50,50,0,1,0
44,322,322,5,5,0,1,0
38,324,324,19,1,18,2,1
28,330,330,19,19,0,1,0
34,332,332,37,7,30,3,2
47,338,338,3,3,0,1,0
30,342,342,32,20,12,4,3
1,350,350,67,67,0,1,0
13,374,374,59,53,6,3,2
12,381,381,18,6,12,3,2
9,382,382,31,31,0,1,0
35,394,394,24,24,0,1,0
3,394,394,45,45,0,1,0
19,403,403,1,1,0,1,0
14,415,415,1,1,0,1,0
26,416,416,7,1,6,2,1
20,433,433,23,23,0,1,0
6,433,433,15,15,0,1,0
25,434,434,3,3,0,1,0
18,453,453,8,8,0,1,0
37,496,496,86,86,0,1,0
10,496,496,33,33,0,1,0
4,500,500,60,18,42,3,2

26,120,120,5,5,0,1,0
14,136,136,46,32,14,3,2
23,145,145,1,1,0,1,0
34,150,150,13,13,0,1,0
21,163,163,57,30,27,4,3
10,169,169,3,3,0,1,0
4,175,175,22,1,21,4,3
0,181,181,1,1,0,1,0
17,195,195,13,13,0,1,0
20,195,195,5,5,0,1,0
1,197,197,57,51,6,3,2
12,211,211,7,7,0,1,0
9,231,231,42,28,14,2,1
31,234,234,6,3,3,2,1
19,239,239,15,15,0,1,0
18,255,255,2,2,0,1,0
6,268,268,37,9,28,2,1
24,275,275,26,26,0,1,0
13,279,279,61,61,0,1,0
8,297,297,5,5,0,1,0
3,300,300,14,2,12,3,2
11,306,306,12,2,10,2,1
33,319,319,70,56,14,2,1
2,326,326,14,2,12,3,2
22,366,366,8,8,0,1,0
25,370,370,7,7,0,1,0
15,395,395,72,50,22,2,1
27,397,397,40,3,37,2,1
36,407,407,35,25,10,2,1
16,410,410,2,2,0,1,0
28,416,416,17,5,12,4,3
7,422,422,22,22,0,1,0
37,424,424,157,149,8,3,2
30,437,437,13,13,0,1,0
35,446,446,96,39,57,3,2
38,449,449,13,3,10,3,2
5,459,459,15,1,14,3,2
29,466,466,61,61,0,1,0
32,484,484,17,4,13,2,1

11,103,103,2,2,0,1,0
16,123,123,18,18,0,1,0
5,129,129,5,5,0,1,0
3,130,130,18,18,0,1,0
24,137,137,14,2,12,2,1
8,169,169,31,17,14,2,1
28,174,174,9,9,0,1,0
14,186,186,10,2,8,3,2
21,198,198,4,4,0,1,0
15,212,212,18,18,0,1,0
10,220,220,25,25,0,1,0
20,228,228,34,34,0,1,0
29,231,231,61,61,0,1,0
22,237,237,1,1,0,1,0
34,262,262,18,15,3,2,1
26,266,266,29,16,13,2,1
17,268,268,18,18,0,1,0
25,271,271,15,15,0,1,0
1,286,286,104,104,0,1,0
23,298,298,23,23,0,1,0
30,301,301,63,63,0,1,0
19,331,331,35,17,18,4,3
9,348,348,35,32,3,2,1
7,354,354,49,49,0,1,0
6,355,355,54,25,29,3,2
12,376,376,22,22,0,1,0
27,383,383,20,16,4,2,1
0,394,394,10,10,0,1,0
4,408,408,3,3,0,1,0
2,416,416,6,6,0,1,0
35,426,426,44,41,3,2,1
31,428,428,5,5,0,1,0
32,432,432,37,16,21,4,3
18,459,459,91,76,15,4,3
13,477,477,93,27,66,4,3
36,477,477,19,1,18,4,3
33,488,488,109,25,84,4,3

19,121,121,13,13,0,1,0
16,122,122,7,7,0,1,0
34,127,127,4,4,0,1,0
14,150,150,1,1,0,1,0
4,157,157,15,15,0,1,0
37,165,165,2,2,0,1,0
15,169,169,3,3,0,1,0
23,184,184,25,9,16,4,3
33,189,189,55,4,51,4,3
17,199,199,16,16,0,1,0
7,205,205,7,4,3,2,1
3,206,206,15,10,5,2,1
1,214,214,21,21,0,1,0
8,233,233,37,2,35,3,2
32,236,236,27,9,18,4,3
29,241,241,7,7,0,1,0
20,245,245,1,1,0,1,0
2,258,258,9,9,0,1,0
40,263,263,37,31,6,2,1
6,274,274,18,18,0,1,0
26,300,300,8,8,0,1,0
41,315,315,2,2,0,1,0
27,332,332,94,94,0,1,0
31,342,342,6,1,5,2,1
21,372,372,8,8,0,1,0
36,378,378,5,5,0,1,0
30,381,381,15,15,0,1,0
35,382,382,69,63,6,3,2
24,386,386,48,48,0,1,0
38,388,388,26,26,0,1,0
9,390,390,39,14,25,2,1
5,402,402,70,70,0,1,0
28,407,407,3,3,0,1,0
10,409,409,95,79,16,2,1
22,415,415,53,53,0,1,0
13,416,416,53,13,40,3,2
25,421,421,112,104,8,3,2
12,422,422,19,19,0,1,0
18,433,433,9,9,0,1,0
11,442,442,71,29,42,4,3
0,445,445,26,4,22,3,2
39,465,465,65,65,0,1,0

34,101,101,22,7,15,2,1
7,112,112,6,6,0,1,0
16,125,125,11,11,0,1,0
28,131,131,11,8,3,2,1
36,135,135,34,34,0,1,0
6,179,179,1,1,0,1,0
13,185,185,6,2,4,2,1
12,193,193,16,4,12,3,2
23,211,211,32,8,24,4,3
8,231,231,3,3,0,1,0
14,234,234,8,8,0,1,0
22,244,244,6,6,0,1,0
31,271,271,17,17,0,1,0
25,278,278,37,25,12,4,3
17,278,278,3,3,0,1,0
18,279,279,3,3,0,1,0
1,299,299,1,1,0,1,0
3,304,304,2,2,0,1,0
37,307,307,21,12,9,4,3
10,308,308,20,20,0,1,0
5,327,327,93,66,27,4,3
2,342,342,44,16,28,2,1
35,342,342,3,3,0,1,0
4,357,357,129,47,82,3,2
38,358,358,165,149,16,2,1
26,362,362,17,17,0,1,0
20,396,396,7,7,0,1,0
29,401,401,17,17,0,1,0
27,402,402,38,15,23,4,3
9,421,421,222,222,0,1,0
19,437,437,5,5,0,1,0
15,441,441,18,18,0,1,0
33,444,444,45,1,44,3,2
32,453,453,19,13,6,2,1
11,458,458,19,11,8,2,1
0,463,463,46,46,0,1,0
24,465,465,24,24,0,1,0
21,489,489,3,3,0,1,0
30,491,491,36,12,24,2,1

28,102,102,3,3,0,1,0
22,112,112,1,1,0,1,0
3,122,122,4,1,3,2,1
29,126,126,11,11,0,1,0
45,146,146,5,5,0,1,0
41,157,157,2,2,0,1,0
6,160,160,8,2,6,3,2
42,161,161,23,5,18,2,1
27,167,167,1,1,0,1,0
0,169,169,1,1,0,1,0
40,179,179,19,3,16,2,1
33,190,190,12,3,9,2,1
17,199,199,9,9,0,1,0
8,209,209,14,14,0,1,0
11,218,218,20,20,0,1,0
39,242,242,44,44,0,1,0
48,244,244,29,22,7,2,1
35,254,254,24,24,0,1,0
14,260,260,16,10,6,2,1
23,267,267,36,12,24,2,1
7,272,272,1,1,0,1,0
24,281,281,6,6,0,1,0
25,281,281,6,1,5,2,1
16,288,288,18,6,12,4,3
10,290,290,11,3,8,2,1
49,293,293,11,11,0,1,0
37,297,297,23,16,7,2,1
50,305,305,8,8,0,1,0
53,315,315,90,90,0,1,0
4,322,322,13,1,12,4,3
34,334,334,32,5,27,2,1
20,337,337,14,9,5,2,1
30,337,337,15,15,0,1,0
44,337,337,25,25,0,1,0
13,341,341,79,61,18,4,3
26,350,350,16,1,15,4,3
36,353,353,9,9,0,1,0
12,354,354,16,16,0,1,0
31,364,364,13,13,0,1,0
15,369,369,2,2,0,1,0
38,370,370,14,8,6,3,2
2,385,385,27,27,0,1,0
32,387,387,46,46,0,1,0
21,387,387,11,11,0,1,0
46,400,400,72,6,66,4,3
5,442,442,2,2,0,1,0
19,443,443,43,9,34,4,3
43,444,444,126,54,72,4,3
51,450,450,38,23,15,4,3
1,455,455,19,19,0,1,0
9,458,458,56,25,31,2,1
47,473,473,45,45,0,1,0
52,485,485,17,5,12,2,1
18,488,488,1,1,0,1,0

3,101,101,6,6,0,1,0
29,110,110,10,1,9,2,1
31,110,110,4,1,3,2,1
23,123,123,5,1,4,2,1
33,130,130,8,8,0,1,0
22,135,135,33,33,0,1,0
16,137,137,3,3,0,1,0
17,143,143,25,15,10,2,1
40,153,153,9,1,8,2,1
32,165,165,23,20,3,2,1
25,175,175,5,2,3,2,1
28,185,185,1,1,0,1,0
44,185,185,5,5,0,1,0
7,189,189,3,3,0,1,0
34,195,195,64,1,63,4,3
20,199,199,1,1,0,1,0
38,203,203,9,9,0,1,0
5,207,207,4,4,0,1,0
46,238,238,49,49,0,1,0
45,257,257,40,40,0,1,0
24,292,292,27,11,16,2,1
8,294,294,1,1,0,1,0
4,302,302,45,10,35,2,1
11,306,306,9,9,0,1,0
9,319,319,2,2,0,1,0
12,322,322,1,1,0,1,0
10,325,325,33,33,0,1,0
18,326,326,17,5,12,4,3
36,327,327,94,46,48,4,3
41,343,343,19,10,9,4,3
43,348,348,100,20,80,4,3
19,356,356,18,4,14,3,2
13,371,371,1,1,0,1,0
26,380,380,22,22,0,1,0
37,390,390,2,2,0,1,0
2,399,399,31,31,0,1,0
21,407,407,99,99,0,1,0
1,420,420,18,14,4,2,1
47,424,424,23,17,6,2,1
0,440,440,1,1,0,1,0
15,443,443,7,4,3,2,1
14,444,444,1,1,0,1,0
27,448,448,84,84,0,1,0
35,473,473,13,13,0,1,0
42,475,475,6,6,0,1,0
6,483,483,80,16,64,4,3
39,484,484,7,7,0,1,0
30,485,485,29,29,0,1,0

28,106,106,1,1,0,1,0
10,113,113,1,1,0,1,0
34,142,142,4,1,3,2,1
23,143,143,5,5,0,1,0
30,144,144,26,2,24,3,2
5,147,147,1,1,0,1,0
29,149,149,5,5,0,1,0
7,176,176,11,11,0,1,0
22,176,176,2,2,0,1,0
16,177,177,23,2,21,4,3
14,199,199,21,8,13,2,1
21,209,209,3,3,0,1,0
8,219,219,21,21,0,1,0
15,221,221,5,5,0,1,0
12,239,239,22,13,9,2,1
3,246,246,115,115,0,1,0
6,246,246,63,29,34,3,2
17,258,258,18,18,0,1,0
32,258,258,9,1,8,2,1
20,292,292,15,3,12,4,3
9,293,293,45,45,0,1,0
33,320,320,176,126,50,3,2
13,325,325,49,39,10,3,2
0,351,351,45,21,24,4,3
18,353,353,3,3,0,1,0
1,365,365,29,29,0,1,0
27,383,383,16,16,0,1,0
24,420,420,54,18,36,3,2
25,430,430,1,1,0,1,0
2,433,433,13,13,0,1,0
19,442,442,143,71,72,4,3
31,484,484,109,15,94,3,2
26,489,489,29,29,0,1,0
11,490,490,13,4,9,2,1
4,492,492,106,6,100,4,3

18,101,101,12,4,8,3,2
12,110,110,9,9,0,1,0
15,111,111,5,5,0,1,0
13,118,118,4,4,0,1,0
4,136,136,3,3,0,1,0
2,158,158,22,22,0,1,0
17,178,178,10,10,0,1,0
32,197,197,52,26,26,2,1
33,198,198,43,43,0,1,0
0,205,205,91,61,30,4,3
22,206,206,8,8,0,1,0
1,225,225,57,57,0,1,0
30,236,236,47,41,6,2,1
26,245,245,2,2,0,1,0
9,248,248,16,16,0,1,0
5,248,248,24,24,0,1,0
20,273,273,41,41,0,1,0
21,298,298,40,5,35,2,1
11,304,304,9,6,3,2,1
10,309,309,52,10,42,2,1
3,319,319,40,22,18,4,3
7,324,324,87,57,30,2,1
28,332,332,21,21,0,1,0
8,362,362,12,12,0,1,0
24,367,367,6,3,3,2,1
31,372,372,64,64,0,1,0
27,391,391,23,23,0,1,0
23,396,396,37,15,22,3,2
25,420,420,27,27,0,1,0
29,421,421,6,2,4,2,1
16,433,433,44,11,33,4,3
19,437,437,57,9,48,3,2
6,474,474,57,45,12,3,2
14,477,477,10,3,7,2,1

29,103,103,6,1,5,2,1
28,151,151,43,43,0,1,0
24,152,152,24,24,0,1,0
5,152,152,22,22,0,1,0
14,163,163,19,16,3,2,1
31,183,183,9,3,6,2,1
19,183,183,29,29,0,1,0
26,198,198,28,28,0,1,0
25,203,203,68,45,23,2,1
32,213,213,2,2,0,1,0
7,223,223,71,71,0,1,0
21,238,238,13,3,10,3,2
12,242,242,22,22,0,1,0
16,254,254,10,10,0,1,0
20,255,255,16,10,6,2,1
13,258,258,30,30,0,1,0
11,264,264,2,2,0,1,0
33,282,282,32,5,27,4,3
15,318,318,7,7,0,1,0
6,327,327,6,6,0,1,0
23,332,332,15,7,8,3,2
22,339,339,14,14,0,1,0
1,347,347,28,28,0,1,0
3,360,360,36,36,0,1,0
17,373,373,65,8,57,4,3
2,374,374,133,133,0,1,0
4,388,388,18,4,14,3,2
30,393,393,7,7,0,1,0
18,411,411,38,38,0,1,0
0,429,429,136,128,8,2,1
10,447,447,18,10,8,3,2
8,452,452,60,53,7,2,1
9,483,483,8,8,0,1,0
27,491,491,48,48,0,1,0

23,111,111,11,3,8,2,1
5,112,112,3,3,0,1,0
16,117,117,2,2,0,1,0
0,123,123,2,2,0,1,0
25,146,146,5,5,0,1,0
11,156,156,13,5,8,2,1
15,163,163,22,22,0,1,0
1,193,193,3,3,0,1,0
4,201,201,65,65,0,1,0
17,215,215,1,1,0,1,0
7,222,222,63,63,0,1,0
28,237,237,31,14,17,3,2
12,245,245,36,2,34,3,2
8,253,253,69,57,12,4,3
9,257,257,23,12,11,2,1
33,262,262,11,11,0,1,0
31,267,267,18,18,0,1,0
24,270,270,30,15,15,4,3
10,285,285,3,3,0,1,0
14,301,301,17,17,0,1,0
3,302,302,33,12,21,4,3
27,306,306,40,40,0,1,0
18,323,323,41,41,0,1,0
34,330,330,38,30,8,2,1
6,337,337,4,4,0,1,0
21,338,338,65,65,0,1,0
32,341,341,6,6,0,1,0
19,379,379,69,33,36,4,3
29,388,388,1,1,0,1,0
30,424,424,69,69,0,1,0
2,431,431,31,1,30,2,1
26,445,445,112,112,0,1,0
20,470,470,56,56,0,1,0
13,483,483,120,120,0,1,0
22,499,499,70,70,0,1,0

16,104,104,9,1,8,3,2
15,106,106,1,1,0,1,0
11,124,124,8,3,5,2,1
4,138,138,19,4,15,4,3
30,153,153,9,9,0,1,0
0,154,154,7,7,0,1,0
27,166,166,1,1,0,1,0
28,172,172,20,11,9,4,3
26,185,185,4,4,0,1,0
18,193,193,76,76,0,1,0
13,208,208,20,13,7,2,1
14,217,217,13,13,0,1,0
5,224,224,61,61,0,1,0
9,248,248,11,1,10,3,2
32,252,252,7,7,0,1,0
31,277,277,23,5,18,2,1
7,280,280,46,46,0,1,0
3,286,286,10,10,0,1,0
8,301,301,140,140,0,1,0
34,304,304,81,9,72,4,3
24,308,308,18,18,0,1,0
29,315,315,1,1,0,1,0
10,378,378,48,48,0,1,0
20,380,380,37,1,36,2,1
12,380,380,57,57,0,1,0
21,387,387,65,53,12,4,3
1,389,389,45,45,0,1,0
2,401,401,46,46,0,1,0
22,405,405,55,48,7,2,1
23,405,405,22,4,18,3,2
33,438,438,22,18,4,2,1
17,454,454,9,9,0,1,0
6,472,472,1,1,0,1,0
25,473,473,82,82,0,1,0
19,493,493,54,54,0,1,0

15,103,103,1,1,0,1,0
43,104,104,18,18,0,1,0
16,106,106,1,1,0,1,0
25,113,113,25,25,0,1,0
4,134,134,7,7,0,1,0
0,148,148,16,16,0,1,0
12,165,165,12,12,0,1,0
10,165,165,7,7,0,1,0
9,183,183,17,17,0,1,0
24,190,190,22,1,21,2,1
21,194,194,2,2,0,1,0
19,199,199,7,7,0,1,0
18,201,201,36,36,0,1,0
13,203,203,1,1,0,1,0
26,205,205,62,62,0,1,0
32,217,217,8,4,4,2,1
14,220,220,14,14,0,1,0
34,221,221,30,30,0,1,0
42,222,222,25,25,0,1,0
40,253,253,1,1,0,1,0
7,258,258,7,7,0,1,0
5,277,277,37,37,0,1,0
23,278,278,4,4,0,1,0
31,296,296,77,68,9,2,1
38,308,308,14,14,0,1,0
33,314,314,18,13,5,2,1
20,316,316,6,6,0,1,0
37,317,317,19,1,18,4,3
39,322,322,5,5,0,1,0
17,343,343,54,36,18,4,3
41,347,347,10,4,6,2,1
27,356,356,15,15,0,1,0
11,386,386,5,5,0,1,0
22,390,390,46,46,0,1,0
36,398,398,29,3,26,3,2
8,418,418,71,50,21,4,3
29,423,423,6,6,0,1,0
35,435,435,18,18,0,1,0
3,436,436,62,62,0,1,0
2,447,447,9,9,0,1,0
30,460,460,127,127,0,1,0
28,473,473,20,20,0,1,0
6,488,488,109,95,14,2,1
1,490,490,34,34,0,1,0

25,103,103,5,5,0,1,0
7,106,106,2,2,0,1,0
28,118,118,5,5,0,1,0
19,123,123,6,6,0,1,0
33,128,128,3,3,0,1,0
35,138,138,7,3,4,2,1
23,145,145,21,21,0,1,0
13,158,158,4,4,0,1,0
30,193,193,55,9,46,3,2
20,219,219,8,8,0,1,0
31,220,220,2,2,0,1,0
6,223,223,10,6,4,2,1
39,232,232,10,10,0,1,0
15,245,245,2,2,0,1,0
17,259,259,18,18,0,1,0
8,265,265,9,3,6,3,2
12,274,274,140,140,0,1,0
29,274,274,11,5,6,2,1
26,289,289,43,43,0,1,0
14,290,290,28,23,5,2,1
24,292,292,7,7,0,1,0
32,294,294,52,21,31,2,1
18,299,299,46,46,0,1,0
40,303,303,21,21,0,1,0
38,319,319,137,137,0,1,0
37,321,321,23,23,0,1,0
0,323,323,15,8,7,2,1
16,337,337,10,10,0,1,0
2,341,341,45,45,0,1,0
11,356,356,21,21,0,1,0
21,364,364,6,6,0,1,0
4,367,367,11,11,0,1,0
27,382,382,99,48,51,4,3
9,383,383,59,28,31,3,2
5,389,389,103,40,63,4,3
3,391,391,8,8,0,1,0
10,449,449,32,32,0,1,0
41,459,459,9,9,0,1,0
36,477,477,24,24,0,1,0
22,489,489,7,2,5,2,1
1,492,492,8,8,0,1,0
34,493,493,7,3,4,2,1

10,108,108,11,11,0,1,0
36,119,119,43,43,0,1,0
29,121,121,1,1,0,1,0
7,137,137,12,12,0,1,0
26,165,165,42,6,36,2,1
32,183,183,19,7,12,4,3
34,196,196,22,22,0,1,0
16,205,205,28,28,0,1,0
30,206,206,13,13,0,1,0
17,249,249,9,9,0,1,0
25,250,250,2,2,0,1,0
4,255,255,9,9,0,1,0
12,284,284,29,29,0,1,0
33,289,289,8,8,0,1,0
18,289,289,29,11,18,2,1
27,305,305,17,17,0,1,0
0,311,311,18,6,12,3,2
22,315,315,18,2,16,3,2
21,330,330,96,56,40,3,2
13,345,345,46,46,0,1,0
2,349,349,2,2,0,1,0
14,351,351,10,5,5,2,1
5,354,354,177,124,53,4,3
37,361,361,10,10,0,1,0
3,379,379,40,13,27,4,3
31,380,380,30,2,28,3,2
15,388,388,16,16,0,1,0
28,427,427,57,21,36,2,1
35,427,427,48,48,0,1,0
11,429,429,64,33,31,2,1
19,437,437,2,2,0,1,0
8,458,458,10,2,8,2,1
9,461,461,88,22,66,3,2
24,477,477,10,10,0,1,0
20,480,480,28,28,0,1,0
1,481,481,5,5,0,1,0
23,486,486,73,73,0,1,0
6,492,492,28,28,0,1,0

18,110,110,1,1,0,1,0
31,111,111,13,3,10,2,1
37,149,149,4,1,3,2,1
26,164,164,6,6,0,1,0
12,175,175,3,3,0,1,0
30,175,175,19,4,15,4,3
39,176,176,7,7,0,1,0
29,177,177,4,4,0,1,0
5,182,182,25,25,0,1,0
24,193,193,11,11,0,1,0
25,204,204,50,50,0,1,0
3,204,204,11,11,0,1,0
9,208,208,36,36,0,1,0
8,226,226,7,7,0,1,0
10,239,239,14,14,0,1,0
0,272,272,2,2,0,1,0
34,273,273,13,8,5,2,1
11,279,279,43,4,39,4,3
1,292,292,24,24,0,1,0
28,299,299,17,17,0,1,0
22,301,301,46,8,38,3,2
27,302,302,16,16,0,1,0
4,304,304,34,12,22,2,1
17,309,309,5,5,0,1,0
13,324,324,12,7,5,2,1
15,343,343,115,87,28,4,3
14,363,363,21,21,0,1,0
7,371,371,36,24,12,4,3
20,389,389,157,136,21,4,3
6,405,405,5,1,4,2,1
21,437,437,31,12,19,2,1
36,439,439,108,56,52,3,2
35,442,442,63,63,0,1,0
33,449,449,65,35,30,4,3
38,452,452,42,42,0,1,0
32,466,466,95,95,0,1,0
2,468,468,35,5,30,4,3
16,477,477,9,4,5,2,1
23,480,480,32,17,15,3,2
19,482,482,6,6,0,1,0

6,119,119,1,1,0,1,0
14,123,123,32,6,26,3,2
8,128,128,21,7,14,4,3
12,148,148,27,11,16,2,1
10,150,150,7,7,0,1,0
27,156,156,13,13,0,1,0
23,177,177,12,12,0,1,0
18,187,187,7,7,0,1,0
28,191,191,25,12,13,2,1
4,193,193,14,14,0,1,0
7,218,218,23,7,16,3,2
30,229,229,1,1,0,1,0
32,247,247,38,38,0,1,0
33,248,248,61,61,0,1,0
24,254,254,6,1,5,2,1
3,277,277,55,55,0,1,0
5,304,304,74,74,0,1,0
35,321,321,4,4,0,1,0
22,328,328,143,143,0,1,0
34,337,337,48,48,0,1,0
0,351,351,42,42,0,1,0
17,353,353,50,50,0,1,0
21,355,355,17,6,11,2,1
20,359,359,4,1,3,2,1
2,364,364,24,18,6,2,1
16,379,379,34,34,0,1,0
15,387,387,33,33,0,1,0
26,387,387,17,8,9,2,1
11,391,391,13,7,6,3,2
13,405,405,31,31,0,1,0
31,405,405,22,22,0,1,0
1,417,417,61,15,46,3,2
29,452,452,42,39,3,2,1
9,458,458,1,1,0,1,0
25,472,472,87,2,85,4,3
19,481,481,8,8,0,1,0

3,119,119,4,4,0,1,0
27,132,132,40,14,26,3,2
30,145,145,6,1,5,2,1
2,145,145,50,8,42,2,1
10,148,148,4,4,0,1,0
40,148,148,6,2,4,2,1
38,158,158,12,9,3,2,1
22,167,167,3,3,0,1,0
23,174,174,32,21,11,2,1
9,193,193,3,3,0,1,0
34,193,193,53,53,0,1,0
39,196,196,16,16,0,1,0
43,206,206,1,1,0,1,0
20,215,215,19,10,9,4,3
16,228,228,11,11,0,1,0
26,228,228,8,2,6,2,1
21,232,232,3,3,0,1,0
25,263,263,17,3,14,2,1
18,270,270,10,10,0,1,0
6,273,273,13,13,0,1,0
17,290,290,6,6,0,1,0
28,293,293,27,27,0,1,0
41,296,296,65,65,0,1,0
7,296,296,37,37,0,1,0
29,304,304,9,6,3,2,1
33,315,315,44,8,36,3,2
35,318,318,3,3,0,1,0
31,319,319,18,15,3,2,1
11,319,319,29,7,22,2,1
1,328,328,74,74,0,1,0
24,371,371,13,1,12,3,2
14,380,380,1,1,0,1,0
5,395,395,21,9,12,4,3
15,396,396,53,53,0,1,0
19,415,415,16,11,5,2,1
37,418,418,33,33,0,1,0
4,423,423,88,43,45,4,3
8,434,434,6,6,0,1,0
36,435,435,8,4,4,2,1
42,456,456,31,31,0,1,0
32,465,465,140,41,99,4,3
13,465,465,34,34,0,1,0
0,466,466,4,4,0,1,0
12,492,492,8,8,0,1,0

5,106,106,34,4,30,4,3
13,114,114,1,1,0,1,0
40,117,117,22,22,0,1,0
0,129,129,2,2,0,1,0
9,133,133,3,3,0,1,0
14,153,153,17,17,0,1,0
35,156,156,1,1,0,1,0
31,159,159,24,18,6,3,2
17,178,178,5,5,0,1,0
42,184,184,17,5,12,2,1
34,189,189,10,1,9,2,1
11,215,215,20,20,0,1,0
18,216,216,7,3,4,2,1
30,228,228,10,10,0,1,0
8,239,239,41,41,0,1,0
12,243,243,9,9,0,1,0
20,248,248,43,40,3,2,1
1,254,254,25,25,0,1,0
27,272,272,30,30,0,1,0
39,277,277,42,21,21,2,1
4,295,295,1,1,0,1,0
37,302,302,4,1,3,2,1
43,313,313,11,4,7,2,1
24,318,318,10,10,0,1,0
23,333,333,1,1,0,1,0
15,341,341,73,73,0,1,0
2,347,347,27,27,0,1,0
25,357,357,15,7,8,3,2
6,358,358,22,22,0,1,0
22,359,359,1,1,0,1,0
41,361,361,10,10,0,1,0
44,363,363,4,4,0,1,0
16,372,372,10,10,0,1,0
38,386,386,48,9,39,4,3
10,396,396,84,84,0,1,0
19,423,423,31,31,0,1,0
29,432,432,45,17,28,2,1
3,435,435,12,9,3,2,1
32,452,452,2,2,0,1,0
36,453,453,3,3,0,1,0
28,462,462,69,16,53,4,3
7,475,475,5,5,0,1,0
33,479,479,166,166,0,1,0
26,482,482,151,151,0,1,0
21,494,494,1,1,0,1,0

14,106,106,19,6,13,2,1
4,108,108,1,1,0,1,0
0,117,117,27,27,0,1,0
11,135,135,2,2,0,1,0
16,149,149,4,1,3,2,1
19,150,150,15,15,0,1,0
20,168,168,2,2,0,1,0
18,189,189,49,49,0,1,0
13,228,228,15,6,9,2,1
22,242,242,10,7,3,2,1
12,242,242,44,25,19,3,2
23,249,249,64,64,0,1,0
17,268,268,52,52,0,1,0
24,282,282,47,47,0,1,0
1,331,331,213,213,0,1,0
15,339,339,39,39,0,1,0
6,340,340,26,18,8,3,2
9,358,358,17,17,0,1,0
2,359,359,67,67,0,1,0
21,370,370,25,4,21,4,3
8,379,379,114,52,62,4,3
26,382,382,7,7,0,1,0
27,385,385,20,11,9,4,3
25,430,430,25,25,0,1,0
3,438,438,127,43,84,4,3
7,457,457,7,7,0,1,0
10,485,485,39,39,0,1,0
5,485,485,72,72,0,1,0

11,100,100,7,7,0,1,0
22,103,103,1,1,0,1,0
34,116,116,3,3,0,1,0
12,129,129,18,18,0,1,0
18,131,131,7,7,0,1,0
6,145,145,39,12,27,4,3
4,146,146,18,2,16,3,2
33,149,149,34,24,10,2,1
41,150,150,8,8,0,1,0
14,164,164,1,1,0,1,0
38,166,166,4,4,0,1,0
24,168,168,2,2,0,1,0
17,175,175,20,20,0,1,0
30,189,189,9,9,0,1,0
1,190,190,16,16,0,1,0
0,198,198,15,1,14,2,1
7,204,204,17,17,0,1,0
15,207,207,11,11,0,1,0
42,228,228,28,28,0,1,0
21,229,229,13,4,9,2,1
35,233,233,121,92,29,2,1
37,248,248,54,54,0,1,0
2,252,252,23,23,0,1,0
28,261,261,19,13,6,2,1
32,272,272,81,73,8,3,2
16,277,277,24,3,21,4,3
19,298,298,17,2,15,2,1
8,298,298,5,5,0,1,0
26,325,325,2,2,0,1,0
13,326,326,38,2,36,4,3
10,345,345,9,9,0,1,0
40,349,349,10,10,0,1,0
25,372,372,1,1,0,1,0
5,372,372,19,7,12,3,2
29,376,376,6,6,0,1,0
27,378,378,18,18,0,1,0
3,413,413,55,55,0,1,0
9,418,418,22,4,18,4,3
36,464,464,16,16,0,1,0
39,464,464,22,17,5,2,1
20,486,486,18,12,6,3,2
23,495,495,47,22,25,2,1
31,498,498,69,17,52,3,2

13,108,108,11,3,8,2,1
18,119,119,1,1,0,1,0
30,122,122,6,6,0,1,0
15,123,123,1,1,0,1,0
14,127,127,19,19,0,1,0
26,130,130,1,1,0,1,0
31,134,134,42,42,0,1,0
7,144,144,21,2,19,2,1
1,162,162,3,3,0,1,0
9,169,169,17,2,15,4,3
23,189,189,22,22,0,1,0
27,225,225,14,4,10,3,2
8,225,225,53,53,0,1,0
22,237,237,42,42,0,1,0
17,238,238,46,46,0,1,0
29,273,273,3,3,0,1,0
20,274,274,16,16,0,1,0
28,276,276,6,2,4,2,1
6,284,284,54,29,25,2,1
16,299,299,22,22,0,1,0
19,299,299,91,91,0,1,0
21,301,301,49,15,34,4,3
5,315,315,29,29,0,1,0
0,322,322,30,30,0,1,0
11,336,336,86,81,5,2,1
24,345,345,12,12,0,1,0
3,359,359,28,2,26,2,1
10,387,387,29,29,0,1,0
2,390,390,118,45,73,3,2
25,404,404,78,78,0,1,0
12,419,419,29,22,7,2,1
32,467,467,1,1,0,1,0
4,493,493,72,55,17,2,1

27,100,100,1,1,0,1,0
17,101,101,10,10,0,1,0
6,106,106,23,23,0,1,0
33,123,123,8,8,0,1,0
29,140,140,4,4,0,1,0
18,159,159,16,4,12,3,2
0,171,171,18,4,14,2,1
16,189,189,11,11,0,1,0
12,205,205,1,1,0,1,0
8,229,229,25,7,18,2,1
3,233,233,24,24,0,1,0
23,256,256,19,11,8,3,2
20,263,263,49,7,42,3,2
5,279,279,47,15,32,2,1
31,281,281,34,26,8,3,2
30,313,313,50,21,29,2,1
28,322,322,88,81,7,2,1
11,323,323,14,14,0,1,0
32,350,350,15,15,0,1,0
1,355,355,19,13,6,3,2
4,370,370,28,2,26,2,1
25,380,380,68,68,0,1,0
34,387,387,10,10,0,1,0
9,406,406,93,18,75,3,2
21,408,408,37,3,34,2,1
2,413,413,58,58,0,1,0
24,419,419,39,3,36,4,3
10,420,420,26,8,18,2,1
19,422,422,33,33,0,1,0
13,441,441,33,33,0,1,0
7,443,443,77,77,0,1,0
26,451,451,46,10,36,2,1
14,454,454,66,12,54,4,3
22,457,457,73,19,54,4,3
15,492,492,96,96,0,1,0

21,109,109,1,1,0,1,0
5,127,127,4,4,0,1,0
2,128,128,5,5,0,1,0
27,149,149,48,48,0,1,0
10,151,151,18,6,12,3,2
11,162,162,5,5,0,1,0
35,187,187,28,28,0,1,0
15,203,203,2,2,0,1,0
4,207,207,4,4,0,1,0
1,212,212,1,1,0,1,0
32,215,215,12,1,11,2,1
22,216,216,3,3,0,1,0
29,217,217,9,6,3,2,1
8,222,222,25,25,0,1,0
19,256,256,25,25,0,1,0
6,277,277,1,1,0,1,0
25,279,279,48,48,0,1,0
33,300,300,6,1,5,2,1
17,335,335,172,63,109,4,3
12,337,337,14,1,13,4,3
3,338,338,22,1,21,2,1
14,341,341,97,7,90,4,3
24,362,362,5,2,3,2,1
31,379,379,57,57,0,1,0
36,401,401,8,2,6,2,1
7,406,406,4,4,0,1,0
0,422,422,33,12,21,2,1
13,429,429,6,6,0,1,0
16,449,449,133,105,28,2,1
23,459,459,22,22,0,1,0
26,463,463,18,18,0,1,0
9,464,464,72,72,0,1,0
18,472,472,34,12,22,2,1
30,482,482,89,52,37,2,1
20,484,484,7,7,0,1,0
28,485,485,128,68,60,3,2
34,485,485,123,99,24,4,3
37,485,485,29,12,17,3,2

19,107,107,16,16,0,1,0
29,109,109,8,8,0,1,0
32,113,113,5,5,0,1,0
47,125,125,21,21,0,1,0
31,135,135,11,11,0,1,0
48,142,142,11,11,0,1,0
13,148,148,17,17,0,1,0
38,167,167,9,9,0,1,0
22,180,180,1,1,0,1,0
30,183,183,2,2,0,1,0
44,188,188,79,79,0,1,0
23,189,189,4,4,0,1,0
3,191,191,11,11,0,1,0
6,191,191,9,6,3,2,1
12,196,196,14,2,12,4,3
33,200,200,16,6,10,3,2
16,203,203,3,3,0,1,0
46,259,259,7,7,0,1,0
20,261,261,60,60,0,1,0
41,267,267,1,1,0,1,0
18,278,278,6,6,0,1,0
28,288,288,18,18,0,1,0
1,296,296,8,8,0,1,0
45,296,296,10,10,0,1,0
25,300,300,28,4,24,2,1
39,305,305,26,15,11,2,1
34,317,317,6,3,3,2,1
11,329,329,2,2,0,1,0
10,330,330,10,3,7,2,1
4,331,331,1,1,0,1,0
5,338,338,24,24,0,1,0
8,353,353,29,8,21,2,1
42,354,354,86,40,46,3,2
35,359,359,63,21,42,3,2
9,374,374,26,26,0,1,0
37,376,376,6,6,0,1,0
43,381,381,95,79,16,3,2
36,390,390,26,26,0,1,0
26,397,397,13,13,0,1,0
0,399,399,67,28,39,4,3
17,417,417,19,2,17,3,2
27,435,435,31,31,0,1,0
14,441,441,3,3,0,1,0
15,444,444,30,30,0,1,0
7,456,456,2,2,0,1,0
24,469,469,62,7,55,4,3
40,477,477,44,2,42,4,3
2,481,481,35,35,0,1,0
21,492,492,26,10,16,3,2

25,103,103,4,4,0,1,0
26,110,110,3,3,0,1,0
15,125,125,26,26,0,1,0
24,129,129,28,4,24,2,1
9,138,138,17,17,0,1,0
13,142,142,40,15,25,2,1
23,147,147,16,16,0,1,0
38,153,153,14,14,0,1,0
5,162,162,19,9,10,2,1
0,170,170,20,2,18,2,1
28,188,188,24,8,16,2,1
21,196,196,15,1,14,2,1
37,206,206,14,14,0,1,0
22,215,215,17,5,12,2,1
34,222,222,45,19,26,3,2
2,251,251,1,1,0,1,0
35,261,261,6,6,0,1,0
1,280,280,23,23,0,1,0
12,293,293,16,16,0,1,0
6,314,314,21,18,3,2,1
18,326,326,16,16,0,1,0
36,348,348,86,86,0,1,0
11,363,363,22,22,0,1,0
33,365,365,15,1,14,2,1
32,371,371,55,29,26,3,2
19,389,389,24,6,18,3,2
3,392,392,97,4,93,4,3
20,410,410,10,5,5,2,1
16,427,427,7,4,3,2,1
31,428,428,121,103,18,4,3
17,428,428,39,39,0,1,0
8,436,436,27,27,0,1,0
10,441,441,27,8,19,2,1
14,444,444,50,38,12,2,1
29,470,470,1,1,0,1,0
27,471,471,17,5,12,4,3
4,482,482,38,38,0,1,0
7,484,484,2,2,0,1,0
30,494,494,54,23,31,3,2

36,106,106,8,1,7,2,1
23,116,116,4,4,0,1,0
18,118,118,2,2,0,1,0
6,119,119,3,3,0,1,0
38,142,142,14,14,0,1,0
4,144,144,4,4,0,1,0
24,150,150,25,7,18,3,2
27,165,165,2,2,0,1,0
2,175,175,26,2,24,4,3
8,175,175,10,10,0,1,0
31,185,185,6,6,0,1,0
37,219,219,3,3,0,1,0
28,223,223,46,3,43,4,3
14,230,230,30,12,18,3,2
9,243,243,10,10,0,1,0
22,256,256,5,5,0,1,0
32,259,259,11,11,0,1,0
33,263,263,44,44,0,1,0
35,268,268,11,11,0,1,0
12,280,280,26,10,16,2,1
3,282,282,46,46,0,1,0
11,292,292,24,24,0,1,0
16,293,293,9,9,0,1,0
0,316,316,69,69,0,1,0
34,324,324,32,27,5,2,1
5,354,354,74,74,0,1,0
17,363,363,12,12,0,1,0
1,368,368,111,85,26,2,1
20,372,372,14,14,0,1,0
13,381,381,43,43,0,1,0
21,388,388,155,155,0,1,0
30,396,396,2,2,0,1,0
10,400,400,24,24,0,1,0
29,417,417,138,89,49,4,3
7,441,441,15,6,9,2,1
26,463,463,13,8,5,2,1
15,465,465,41,41,0,1,0
19,477,477,13,13,0,1,0
25,493,493,65,59,6,2,1

26,101,101,8,8,0,1,0
0,105,105,21,21,0,1,0
9,108,108,2,2,0,1,0
22,119,119,4,4,0,1,0
10,128,128,10,1,9,2,1
2,131,131,2,2,0,1,0
29,134,134,2,2,0,1,0
39,141,141,1,1,0,1,0
35,142,142,24,9,15,2,1
28,151,151,47,47,0,1,0
21,152,152,45,45,0,1,0
3,162,162,3,3,0,1,0
19,175,175,7,2,5,2,1
40,176,176,7,7,0,1,0
31,178,178,7,7,0,1,0
1,184,184,8,1,7,2,1
37,186,186,78,78,0,1,0
7,193,193,10,10,0,1,0
8,202,202,4,4,0,1,0
13,212,212,1,1,0,1,0
12,222,222,27,27,0,1,0
27,227,227,12,12,0,1,0
38,235,235,15,3,12,4,3
6,238,238,19,19,0,1,0
17,267,267,53,53,0,1,0
33,298,298,13,13,0,1,0
43,311,311,15,11,4,2,1
42,314,314,9,4,5,2,1
11,327,327,41,32,9,4,3
23,348,348,3,3,0,1,0
14,397,397,11,11,0,1,0
25,401,401,49,2,47,3,2
5,404,404,89,89,0,1,0
20,414,414,13,13,0,1,0
36,420,420,39,12,27,4,3
30,429,429,1,1,0,1,0
16,433,433,13,13,0,1,0
41,433,433,44,23,21,2,1
18,443,443,1,1,0,1,0
34,458,458,44,2,42,4,3
32,458,458,96,96,0,1,0
15,458,458,11,1,10,3,2
24,458,458,73,73,0,1,0
4,488,488,25,25,0,1,0

21,117,117,7,7,0,1,0
14,120,120,5,1,4,2,1
35,129,129,53,20,33,2,1
11,163,163,51,51,0,1,0
32,165,165,12,1,11,2,1
22,166,166,15,7,8,3,2
28,179,179,1,1,0,1,0
2,195,195,85,10,75,4,3
27,202,202,10,10,0,1,0
15,212,212,27,27,0,1,0
16,244,244,21,21,0,1,0
13,257,257,1,1,0,1,0
7,265,265,39,12,27,2,1
34,267,267,5,5,0,1,0
6,272,272,25,25,0,1,0
26,305,305,109,70,39,4,3
18,309,309,2,2,0,1,0
24,323,323,17,17,0,1,0
9,330,330,1,1,0,1,0
30,333,333,60,12,48,3,2
8,349,349,42,42,0,1,0
25,357,357,23,23,0,1,0
0,361,361,3,3,0,1,0
31,362,362,26,17,9,4,3
3,384,384,16,13,3,2,1
1,417,417,70,70,0,1,0
5,428,428,45,32,13,4,3
10,433,433,2,2,0,1,0
36,435,435,15,15,0,1,0
20,435,435,40,40,0,1,0
17,448,448,35,35,0,1,0
19,449,449,29,2,27,4,3
23,460,460,55,55,0,1,0
29,473,473,27,7,20,3,2
12,485,485,48,48,0,1,0
4,495,495,13,13,0,1,0
33,500,500,63,15,48,2,1

22,115,115,31,31,0,1,0
1,119,119,67,43,24,4,3
19,135,135,21,21,0,1,0
33,144,144,45,45,0,1,0
38,150,150,2,2,0,1,0
5,150,150,24,24,0,1,0
11,159,159,5,2,3,2,1
13,160,160,7,7,0,1,0
35,190,190,1,1,0,1,0
3,197,197,3,3,0,1,0
0,223,223,1,1,0,1,0
7,227,227,9,9,0,1,0
34,238,238,24,7,17,2,1
31,242,242,85,22,63,3,2
2,255,255,13,7,6,2,1
30,277,277,12,12,0,1,0
14,278,278,1,1,0,1,0
20,285,285,19,19,0,1,0
23,296,296,24,24,0,1,0
26,307,307,27,27,0,1,0
4,307,307,41,41,0,1,0
9,312,312,56,3,53,4,3
29,324,324,43,43,0,1,0
27,327,327,1,1,0,1,0
15,339,339,9,9,0,1,0
21,340,340,28,10,18,3,2
28,340,340,43,43,0,1,0
39,359,359,28,28,0,1,0
10,375,375,40,13,27,4,3
36,384,384,5,2,3,2,1
24,398,398,37,37,0,1,0
25,432,432,3,3,0,1,0
16,437,437,36,36,0,1,0
37,440,440,7,3,4,2,1
6,443,443,23,7,16,2,1
18,458,458,16,16,0,1,0
12,462,462,41,36,5,2,1
8,465,465,3,3,0,1,0
32,481,481,62,62,0,1,0
17,500,500,28,1,27,3,2

11,105,105,22,22,0,1,0
40,110,110,7,4,3,2,1
23,146,146,35,35,0,1,0
15,175,175,12,12,0,1,0
12,179,179,39,17,22,2,1
22,181,181,14,14,0,1,0
21,190,190,36,36,0,1,0
38,199,199,5,5,0,1,0
24,199,199,1,1,0,1,0
4,201,201,7,7,0,1,0
36,215,215,41,41,0,1,0
13,238,238,10,10,0,1,0
1,261,261,4,4,0,1,0
35,265,265,35,11,24,2,1
18,273,273,22,4,18,2,1
34,289,289,24,24,0,1,0
20,323,323,22,22,0,1,0
26,339,339,2,2,0,1,0
25,343,343,14,14,0,1,0
16,376,376,33,9,24,4,3
19,377,377,37,7,30,4,3
8,379,379,36,36,0,1,0
31,382,382,84,84,0,1,0
33,388,388,1,1,0,1,0
7,391,391,15,7,8,2,1
10,399,399,3,3,0,1,0
14,402,402,37,33,4,2,1
37,411,411,8,2,6,3,2
9,427,427,126,67,59,4,3
27,440,440,10,10,0,1,0
6,440,440,23,7,16,4,3
29,441,441,7,4,3,2,1
39,446,446,90,42,48,2,1
32,452,452,16,16,0,1,0
5,462,462,3,3,0,1,0
17,466,466,18,18,0,1,0
2,470,470,2,2,0,1,0
3,472,472,15,7,8,2,1
0,482,482,63,63,0,1,0
30,495,495,25,11,14,2,1
28,499,499,253,106,147,4,3

23,114,114,14,6,8,3,2
6,114,114,16,4,12,3,2
26,123,123,1,1,0,1,0
11,138,138,19,19,0,1,0
12,155,155,7,7,0,1,0
0,159,159,1,1,0,1,0
30,164,164,16,4,12,4,3
22,169,169,5,5,0,1,0
20,175,175,7,7,0,1,0
27,176,176,5,2,3,2,1
25,176,176,19,19,0,1,0
19,198,198,24,24,0,1,0
43,233,233,49,49,0,1,0
18,246,246,29,20,9,4,3
33,254,254,58,19,39,4,3
39,256,256,71,15,56,3,2
35,256,256,12,7,5,2,1
16,270,270,7,7,0,1,0
42,272,272,41,41,0,1,0
3,278,278,59,59,0,1,0
10,282,282,1,1,0,1,0
45,292,292,17,17,0,1,0
8,294,294,26,26,0,1,0
2,309,309,24,18,6,2,1
38,315,315,2,2,0,1,0
40,321,321,3,3,0,1,0
44,326,326,28,18,10,2,1
13,338,338,27,15,12,2,1
29,341,341,12,12,0,1,0
41,345,345,15,15,0,1,0
1,347,347,30,12,18,2,1
17,366,366,16,3,13,2,1
32,376,376,52,22,30,3,2
24,395,395,17,17,0,1,0
9,411,411,55,55,0,1,0
4,414,414,2,2,0,1,0
15,419,419,32,2,30,3,2
34,420,420,67,1,66,3,2
7,426,426,12,3,9,4,3
37,428,428,58,50,8,2,1
31,437,437,65,65,0,1,0
36,440,440,6,6,0,1,0
21,452,452,1,1,0,1,0
14,456,456,53,29,24,4,3
5,461,461,1,1,0,1,0
28,492,492,29,29,0,1,0

19,128,128,1,1,0,1,0
2,135,135,2,2,0,1,0
4,145,145,3,3,0,1,0
10,154,154,40,40,0,1,0
35,156,156,25,6,19,2,1
38,166,166,23,23,0,1,0
27,170,170,30,1,29,2,1
18,188,188,52,52,0,1,0
30,193,193,26,26,0,1,0
31,194,194,1,1,0,1,0
26,204,204,2,2,0,1,0
39,206,206,7,7,0,1,0
14,211,211,25,25,0,1,0
9,217,217,11,11,0,1,0
15,226,226,9,3,6,3,2
1,228,228,17,9,8,2,1
7,232,232,1,1,0,1,0
33,240,240,17,5,12,4,3
16,261,261,31,11,20,3,2
6,263,263,6,6,0,1,0
21,296,296,53,53,0,1,0
11,302,302,15,9,6,2,1
36,307,307,48,11,37,2,1
23,312,312,56,56,0,1,0
0,342,342,37,11,26,3,2
5,347,347,23,23,0,1,0
32,362,362,55,55,0,1,0
24,381,381,21,16,5,2,1
29,383,383,8,8,0,1,0
34,390,390,24,8,16,2,1
17,405,405,28,13,15,4,3
28,408,408,88,58,30,3,2
37,415,415,11,11,0,1,0
8,418,418,3,3,0,1,0
12,435,435,46,31,15,2,1
13,437,437,21,6,15,2,1
22,439,439,87,5,82,3,2
41,453,453,89,89,0,1,0
3,471,471,20,20,0,1,0
25,482,482,29,29,0,1,0
20,483,483,9,9,0,1,0
40,496,496,41,41,0,1,0

6,102,102,27,27,0,1,0
30,106,106,12,12,0,1,0
3,115,115,1,1,0,1,0
18,123,123,39,39,0,1,0
27,133,133,31,1,30,3,2
35,135,135,5,5,0,1,0
24,165,165,33,18,15,4,3
20,174,174,6,3,3,2,1
7,181,181,1,1,0,1,0
1,196,196,1,1,0,1,0
32,197,197,10,10,0,1,0
21,200,200,5,5,0,1,0
14,203,203,3,3,0,1,0
19,212,212,26,26,0,1,0
5,219,219,39,27,12,4,3
11,228,228,11,11,0,1,0
36,272,272,75,75,0,1,0
25,277,277,17,1,16,4,3
23,278,278,11,1,10,3,2
17,283,283,7,7,0,1,0
13,290,290,6,6,0,1,0
2,302,302,2,2,0,1,0
31,308,308,17,17,0,1,0
4,308,308,17,3,14,3,2
8,325,325,7,7,0,1,0
12,327,327,57,21,36,3,2
15,337,337,55,55,0,1,0
16,338,338,13,3,10,3,2
10,359,359,55,42,13,2,1
28,371,371,14,14,0,1,0
37,374,374,58,25,33,4,3
29,386,386,79,36,43,2,1
33,406,406,15,15,0,1,0
39,426,426,3,3,0,1,0
38,427,427,39,39,0,1,0
9,441,441,6,6,0,1,0
22,468,468,17,17,0,1,0
0,475,475,110,95,15,4,3
26,487,487,88,88,0,1,0
34,492,492,49,49,0,1,0

18,114,114,1,1,0,1,0
2,119,119,15,15,0,1,0
19,151,151,34,19,15,4,3
27,157,157,8,8,0,1,0
12,166,166,1,1,0,1,0
30,175,175,7,7,0,1,0
7,193,193,34,34,0,1,0
40,196,196,21,2,19,4,3
9,199,199,15,6,9,4,3
24,202,202,34,16,18,3,2
8,217,217,7,7,0,1,0
36,228,228,25,25,0,1,0
0,233,233,16,7,9,3,2
23,244,244,48,28,20,2,1
22,250,250,20,15,5,2,1
25,268,268,11,5,6,3,2
39,277,277,53,41,12,4,3
28,283,283,7,7,0,1,0
35,299,299,9,9,0,1,0
26,311,311,14,14,0,1,0
31,316,316,10,10,0,1,0
3,319,319,75,75,0,1,0
38,326,326,31,31,0,1,0
6,335,335,60,60,0,1,0
14,337,337,13,2,11,2,1
11,341,341,1,1,0,1,0
13,342,342,4,4,0,1,0
20,352,352,97,97,0,1,0
5,353,353,18,18,0,1,0
17,360,360,34,34,0,1,0
16,360,360,65,65,0,1,0
37,368,368,57,3,54,4,3
10,378,378,25,7,18,3,2
32,382,382,30,14,16,2,1
1,384,384,3,3,0,1,0
21,401,401,5,5,0,1,0
15,415,415,4,1,3,2,1
29,421,421,94,12,82,3,2
4,431,431,8,8,0,1,0
34,451,451,15,3,12,2,1
33,471,471,110,75,35,2,1

6,107,107,3,3,0,1,0
34,121,121,1,1,0,1,0
28,124,124,11,3,8,3,2
32,134,134,6,6,0,1,0
16,141,141,2,2,0,1,0
12,141,141,10,10,0,1,0
9,141,141,2,2,0,1,0
29,161,161,9,1,8,2,1
15,162,162,3,3,0,1,0
7,167,167,21,21,0,1,0
33,199,199,2,2,0,1,0
18,212,212,1,1,0,1,0
22,222,222,45,45,0,1,0
19,224,224,13,13,0,1,0
17,237,237,29,29,0,1,0
10,238,238,33,33,0,1,0
30,256,256,43,11,32,2,1
5,268,268,51,3,48,3,2
35,274,274,65,65,0,1,0
31,314,314,17,4,13,4,3
13,334,334,52,12,40,3,2
27,347,347,41,41,0,1,0
0,373,373,15,15,0,1,0
8,375,375,32,18,14,2,1
25,375,375,4,4,0,1,0
26,381,381,55,9,46,3,2
21,385,385,40,40,0,1,0
11,388,388,34,12,22,3,2
4,404,404,100,25,75,4,3
24,411,411,24,24,0,1,0
1,434,434,36,36,0,1,0
36,449,449,165,33,132,4,3
2,466,466,17,7,10,3,2
14,489,489,50,5,45,2,1
20,490,490,30,19,11,2,1
3,490,490,167,53,114,4,3
23,499,499,74,28,46,3,2

28,107,107,3,3,0,1,0
6,123,123,14,14,0,1,0
34,135,135,19,7,12,2,1
27,137,137,17,17,0,1,0
7,139,139,2,2,0,1,0
10,143,143,1,1,0,1,0
21,162,162,11,11,0,1,0
4,171,171,19,19,0,1,0
19,201,201,42,42,0,1,0
8,218,218,12,12,0,1,0
23,220,220,21,3,18,2,1
18,230,230,1,1,0,1,0
14,233,233,15,12,3,2,1
22,240,240,14,14,0,1,0
20,261,261,6,3,3,2,1
24,269,269,5,5,0,1,0
25,279,279,31,31,0,1,0
26,284,284,8,8,0,1,0
29,291,291,3,3,0,1,0
30,294,294,31,31,0,1,0
3,294,294,5,5,0,1,0
16,305,305,145,1,144,4,3
15,311,311,45,45,0,1,0
31,315,315,36,36,0,1,0
2,335,335,53,53,0,1,0
38,339,339,150,150,0,1,0
5,363,363,12,12,0,1,0
1,395,395,91,13,78,3,2
32,403,403,30,3,27,4,3
13,417,417,12,12,0,1,0
36,425,425,75,75,0,1,0
35,430,430,2,2,0,1,0
0,434,434,69,24,45,4,3
12,439,439,1,1,0,1,0
33,444,444,3,3,0,1,0
17,445,445,17,17,0,1,0
11,446,446,13,13,0,1,0
37,459,459,146,86,60,4,3
9,489,489,3,3,0,1,0

11,104,104,5,5,0,1,0
25,106,106,2,2,0,1,0
1,115,115,5,5,0,1,0
17,123,123,15,2,13,2,1
5,123,123,4,1,3,2,1
33,128,128,16,12,4,2,1
27,133,133,7,4,3,2,1
15,139,139,3,3,0,1,0
2,183,183,17,17,0,1,0
28,209,209,26,26,0,1,0
3,218,218,6,6,0,1,0
13,227,227,43,32,11,2,1
38,230,230,1,1,0,1,0
39,238,238,14,14,0,1,0
31,239,239,74,53,21,3,2
16,240,240,6,1,5,2,1
34,245,245,16,2,14,2,1
14,249,249,44,44,0,1,0
32,258,258,6,6,0,1,0
29,266,266,6,6,0,1,0
19,321,321,15,15,0,1,0
35,333,333,42,42,0,1,0
37,342,342,47,47,0,1,0
26,342,342,69,69,0,1,0
36,370,370,2,2,0,1,0
7,374,374,103,89,14,2,1
21,386,386,17,7,10,2,1
12,408,408,23,8,15,4,3
8,410,410,78,5,73,4,3
9,410,410,37,37,0,1,0
0,427,427,60,60,0,1,0
6,429,429,58,58,0,1,0
4,433,433,35,13,22,4,3
20,444,444,43,15,28,2,1
18,454,454,3,3,0,1,0
10,456,456,1,1,0,1,0
23,459,459,29,19,10,2,1
22,470,470,42,26,16,2,1
30,482,482,224,224,0,1,0
24,495,495,7,7,0,1,0

31,106,106,2,2,0,1,0
0,112,112,8,8,0,1,0
25,140,140,11,1,10,3,2
5,150,150,6,2,4,2,1
21,155,155,11,11,0,1,0
34,162,162,16,1,15,4,3
38,164,164,8,2,6,3,2
7,173,173,17,8,9,4,3
8,174,174,22,22,0,1,0
33,180,180,70,70,0,1,0
29,202,202,40,40,0,1,0
27,209,209,38,12,26,3,2
26,226,226,47,7,40,2,1
4,232,232,1,1,0,1,0
11,253,253,5,5,0,1,0
18,258,258,6,6,0,1,0
32,269,269,10,10,0,1,0
2,270,270,60,24,36,2,1
19,279,279,14,14,0,1,0
3,282,282,42,32,10,2,1
36,287,287,1,1,0,1,0
6,301,301,23,2,21,2,1
15,305,305,48,48,0,1,0
24,321,321,11,11,0,1,0
28,342,342,31,31,0,1,0
30,351,351,5,5,0,1,0
35,354,354,1,1,0,1,0
13,361,361,25,17,8,3,2
10,366,366,50,2,48,4,3
9,368,368,6,6,0,1,0
20,392,392,60,20,40,3,2
17,400,400,67,17,50,2,1
14,402,402,82,64,18,2,1
23,423,423,21,2,19,3,2
37,437,437,99,21,78,4,3
1,441,441,23,13,10,3,2
12,448,448,69,69,0,1,0
22,454,454,18,18,0,1,0
16,487,487,30,16,14,2,1

35,147,147,5,2,3,2,1
30,162,162,17,17,0,1,0
26,172,172,16,16,0,1,0
5,175,175,20,20,0,1,0
7,177,177,21,21,0,1,0
16,179,179,19,19,0,1,0
27,189,189,2,2,0,1,0
6,197,197,46,2,44,2,1
10,206,206,50,14,36,2,1
24,216,216,39,39,0,1,0
2,233,233,1,1,0,1,0
25,242,242,29,4,25,2,1
12,247,247,39,7,32,2,1
13,253,253,16,1,15,4,3
37,277,277,37,21,16,2,1
33,283,283,52,52,0,1,0
3,289,289,3,3,0,1,0
28,292,292,21,21,0,1,0
38,292,292,35,17,18,2,1
34,333,333,1,1,0,1,0
17,336,336,1,1,0,1,0
14,340,340,59,51,8,2,1
11,362,362,30,30,0,1,0
0,374,374,25,1,24,4,3
22,375,375,54,54,0,1,0
1,382,382,10,10,0,1,0
21,385,385,115,45,70,3,2
9,385,385,36,9,27,2,1
32,387,387,12,12,0,1,0
15,388,388,30,30,0,1,0
23,389,389,40,31,9,4,3
4,403,403,82,24,58,3,2
29,417,417,27,12,15,4,3
31,418,418,76,16,60,3,2
20,427,427,14,7,7,2,1
8,432,432,18,18,0,1,0
18,434,434,16,6,10,2,1
36,443,443,12,12,0,1,0
19,498,498,22,22,0,1,0

15,102,102,19,19,0,1,0
6,114,114,1,1,0,1,0
36,126,126,9,9,0,1,0
16,126,126,6,6,0,1,0
31,136,136,2,2,0,1,0
38,163,163,12,9,3,2,1
26,173,173,5,5,0,1,0
21,174,174,39,39,0,1,0
1,197,197,15,15,0,1,0
28,229,229,1,1,0,1,0
24,251,251,11,2,9,4,3
27,259,259,38,38,0,1,0
11,263,263,53,26,27,2,1
18,270,270,11,11,0,1,0
37,289,289,21,7,14,4,3
29,290,290,27,27,0,1,0
17,318,318,6,2,4,2,1
10,320,320,9,9,0,1,0
22,322,322,81,19,62,3,2
30,330,330,10,10,0,1,0
9,344,344,16,16,0,1,0
8,349,349,45,45,0,1,0
14,355,355,1,1,0,1,0
0,381,381,10,1,9,2,1
34,392,392,20,20,0,1,0
23,430,430,105,90,15,2,1
35,436,436,19,7,12,2,1
5,436,436,16,16,0,1,0
33,438,438,108,108,0,1,0
12,442,442,11,11,0,1,0
4,448,448,41,41,0,1,0
25,463,463,36,6,30,3,2
7,468,468,90,24,66,4,3
13,472,472,53,53,0,1,0
20,483,483,49,29,20,3,2
3,490,490,116,52,64,3,2
32,494,494,57,36,21,2,1
19,495,495,111,111,0,1,0
2,499,499,85,4,81,4,3

6,108,108,32,17,15,4,3
13,109,109,13,13,0,1,0
5,116,116,1,1,0,1,0
16,118,118,6,6,0,1,0
29,124,124,4,4,0,1,0
28,137,137,76,21,55,4,3
31,138,138,4,4,0,1,0
2,139,139,18,18,0,1,0
34,149,149,20,6,14,2,1
11,180,180,28,2,26,4,3
33,187,187,4,1,3,2,1
7,191,191,29,29,0,1,0
0,193,193,3,3,0,1,0
4,207,207,20,20,0,1,0
15,216,216,1,1,0,1,0
14,229,229,16,16,0,1,0
35,236,236,4,4,0,1,0
20,236,236,2,2,0,1,0
10,248,248,63,63,0,1,0
22,256,256,34,27,7,2,1
19,268,268,27,17,10,2,1
17,276,276,11,11,0,1,0
32,287,287,28,16,12,2,1
25,297,297,41,41,0,1,0
8,297,297,40,40,0,1,0
3,310,310,26,26,0,1,0
24,318,318,6,6,0,1,0
9,320,320,34,34,0,1,0
21,357,357,51,25,26,2,1
30,360,360,1,1,0,1,0
12,374,374,52,52,0,1,0
1,377,377,32,32,0,1,0
27,384,384,70,30,40,2,1
26,406,406,81,45,36,2,1
23,493,493,40,16,24,4,3
18,496,496,4,4,0,1,0

5,106,106,7,7,0,1,0
12,106,106,29,29,0,1,0
8,117,117,1,1,0,1,0
36,130,130,6,3,3,2,1
7,143,143,3,3,0,1,0
34,162,162,59,19,40,3,2
6,165,165,4,4,0,1,0
35,166,166,12,7,5,2,1
2,168,168,26,26,0,1,0
9,183,183,4,4,0,1,0
27,188,188,16,3,13,3,2
33,197,197,7,7,0,1,0
3,214,214,3,3,0,1,0
0,230,230,53,8,45,2,1
28,233,233,2,2,0,1,0
19,239,239,51,51,0,1,0
24,241,241,13,13,0,1,0
40,245,245,25,25,0,1,0
10,253,253,18,3,15,2,1
1,262,262,22,22,0,1,0
21,279,279,9,9,0,1,0
32,280,280,30,30,0,1,0
16,314,314,8,8,0,1,0
11,339,339,5,5,0,1,0
15,350,350,48,20,28,3,2
29,363,363,44,13,31,2,1
17,363,363,32,26,6,3,2
13,389,389,43,16,27,2,1
25,398,398,43,43,0,1,0
20,398,398,31,26,5,2,1
39,406,406,81,3,78,4,3
31,406,406,92,2,90,3,2
4,414,414,57,57,0,1,0
26,419,419,52,8,44,3,2
23,436,436,15,15,0,1,0
38,440,440,29,29,0,1,0
37,453,453,27,21,6,2,1
30,460,460,3,3,0,1,0
22,460,460,53,53,0,1,0
18,482,482,15,8,7,2,1
14,490,490,31,31,0,1,0

5,108,108,19,19,0,1,0
27,131,131,13,13,0,1,0
0,135,135,1,1,0,1,0
32,174,174,2,2,0,1,0
10,177,177,24,24,0,1,0
2,183,183,2,2,0,1,0
16,198,198,1,1,0,1,0
18,203,203,21,21,0,1,0
22,203,203,8,1,7,2,1
13,208,208,30,1,29,2,1
23,208,208,37,21,16,2,1
11,225,225,69,61,8,3,2
28,227,227,4,4,0,1,0
15,236,236,2,2,0,1,0
31,237,237,6,6,0,1,0
14,256,256,9,9,0,1,0
29,258,258,76,29,47,2,1
21,259,259,6,6,0,1,0
26,259,259,62,62,0,1,0
9,283,283,40,16,24,4,3
7,315,315,126,126,0,1,0
35,338,338,25,20,5,2,1
8,344,344,2,2,0,1,0
33,351,351,16,2,14,3,2
12,352,352,3,3,0,1,0
20,358,358,21,21,0,1,0
25,362,362,16,4,12,2,1
3,391,391,94,56,38,3,2
34,409,409,54,43,11,2,1
4,419,419,3,3,0,1,0
30,421,421,133,77,56,4,3
17,443,443,7,1,6,2,1
1,451,451,35,17,18,3,2
6,472,472,90,82,8,2,1
19,475,475,38,6,32,4,3
24,494,494,63,63,0,1,0

32,118,118,4,4,0,1,0
8,143,143,42,42,0,1,0
26,174,174,45,31,14,3,2
22,206,206,42,42,0,1,0
21,209,209,36,32,4,2,1
10,215,215,3,3,0,1,0
17,220,220,29,29,0,1,0
5,226,226,22,22,0,1,0
0,236,236,59,35,24,2,1
15,239,239,20,5,15,4,3
6,240,240,12,3,9,4,3
27,313,313,49,4,45,2,1
2,314,314,25,25,0,1,0
29,327,327,29,29,0,1,0
28,348,348,10,1,9,2,1
24,349,349,13,5,8,3,2
30,357,357,1,1,0,1,0
19,359,359,14,10,4,2,1
20,362,362,10,2,8,2,1
4,370,370,21,21,0,1,0
18,374,374,24,24,0,1,0
33,387,387,35,35,0,1,0
7,403,403,37,37,0,1,0
31,419,419,114,39,75,4,3
13,439,439,105,83,22,2,1
16,446,446,72,44,28,2,1
14,456,456,6,2,4,2,1
3,457,457,98,98,0,1,0
12,466,466,28,28,0,1,0
1,468,468,93,81,12,4,3
11,471,471,43,28,15,4,3
9,476,476,72,51,21,2,1
23,483,483,30,30,0,1,0
25,485,485,11,5,6,2,1

22,106,106,16,16,0,1,0
37,118,118,3,3,0,1,0
8,127,127,23,23,0,1,0
29,157,157,23,8,15,4,3
28,160,160,5,5,0,1,0
20,162,162,3,3,0,1,0
13,165,165,9,9,0,1,0
33,179,179,10,3,7,2,1
16,184,184,9,3,6,2,1
36,197,197,11,6,5,2,1
40,207,207,11,11,0,1,0
25,208,208,1,1,0,1,0
39,208,208,23,6,17,2,1
19,211,211,12,12,0,1,0
1,217,217,15,15,0,1,0
32,218,218,23,23,0,1,0
31,220,220,36,36,0,1,0
17,233,233,7,7,0,1,0
34,237,237,5,5,0,1,0
10,241,241,13,5,8,3,2
43,248,248,135,123,12,4,3
3,254,254,1,1,0,1,0
21,259,259,3,3,0,1,0
2,302,302,9,9,0,1,0
6,312,312,3,3,0,1,0
41,314,314,24,6,18,3,2
0,318,318,11,3,8,2,1
15,323,323,12,12,0,1,0
4,324,324,45,45,0,1,0
30,347,347,11,11,0,1,0
38,357,357,36,36,0,1,0
23,366,366,121,88,33,3,2
27,372,372,107,77,30,4,3
14,372,372,25,25,0,1,0
42,383,383,4,4,0,1,0
5,388,388,25,25,0,1,0
7,398,398,6,6,0,1,0
26,399,399,15,15,0,1,0
35,412,412,33,3,30,3,2
12,440,440,84,84,0,1,0
9,448,448,79,71,8,3,2
24,460,460,19,19,0,1,0
11,499,499,16,16,0,1,0
18,500,500,27,10,17,4,3

4,114,114,1,1,0,1,0
6,117,117,9,9,0,1,0
14,123,123,1,1,0,1,0
3,125,125,19,19,0,1,0
31,128,128,8,8,0,1,0
8,131,131,2,2,0,1,0
34,131,131,3,3,0,1,0
28,139,139,1,1,0,1,0
7,140,140,1,1,0,1,0
12,141,141,38,22,16,2,1
37,169,169,27,27,0,1,0
16,177,177,52,4,48,4,3
1,179,179,13,10,3,2,1
29,186,186,10,2,8,2,1
5,197,197,5,5,0,1,0
18,202,202,21,21,0,1,0
15,210,210,26,26,0,1,0
21,215,215,18,2,16,2,1
33,217,217,5,5,0,1,0
32,218,218,27,27,0,1,0
11,221,221,66,66,0,1,0
2,233,233,3,3,0,1,0
22,247,247,24,24,0,1,0
27,247,247,3,3,0,1,0
36,248,248,9,9,0,1,0
38,260,260,43,43,0,1,0
10,265,265,48,7,41,3,2
23,305,305,23,5,18,4,3
35,332,332,4,4,0,1,0
9,341,341,23,1,22,3,2
24,347,347,36,1,35,2,1
20,370,370,153,94,59,4,3
25,391,391,28,28,0,1,0
26,398,398,156,111,45,4,3
30,433,433,8,8,0,1,0
0,476,476,22,1,21,4,3
19,479,479,17,17,0,1,0
17,488,488,12,12,0,1,0
13,488,488,38,38,0,1,0

21,132,132,7,7,0,1,0
15,135,135,2,2,0,1,0
20,135,135,27,27,0,1,0
13,142,142,20,20,0,1,0
19,144,144,4,4,0,1,0
24,166,166,7,7,0,1,0
9,171,171,12,12,0,1,0
28,173,173,28,28,0,1,0
22,175,175,1,1,0,1,0
12,190,190,40,14,26,3,2
3,213,213,29,3,26,3,2
4,217,217,25,10,15,2,1
29,217,217,50,17,33,2,1
5,231,231,25,4,21,4,3
36,253,253,11,2,9,2,1
33,260,260,53,53,0,1,0
34,261,261,24,1,23,2,1
32,289,289,55,55,0,1,0
16,304,304,28,28,0,1,0
17,310,310,8,2,6,3,2
14,317,317,29,7,22,2,1
7,340,340,8,4,4,2,1
0,341,341,97,97,0,1,0
25,344,344,6,6,0,1,0
1,366,366,55,9,46,2,1
23,389,389,13,1,12,3,2
31,389,389,5,2,3,2,1
27,391,391,54,54,0,1,0
35,406,406,21,14,7,2,1
8,407,407,62,57,5,2,1
26,428,428,42,42,0,1,0
2,428,428,38,5,33,2,1
18,428,428,120,100,20,2,1
10,437,437,57,11,46,4,3
6,445,445,17,9,8,2,1
11,478,478,13,3,10,3,2
30,498,498,22,7,15,4,3

23,100,100,11,11,0,1,0
10,122,122,15,4,11,2,1
30,126,126,2,2,0,1,0
31,157,157,11,3,8,2,1
34,167,167,13,3,10,2,1
0,174,174,45,45,0,1,0
12,174,174,16,16,0,1,0
33,178,178,13,7,6,3,2
1,179,179,57,57,0,1,0
6,214,214,32,6,26,3,2
28,218,218,22,14,8,3,2
3,255,255,13,13,0,1,0
8,261,261,2,2,0,1,0
26,267,267,66,30,36,3,2
20,270,270,12,8,4,2,1
15,299,299,48,34,14,4,3
25,304,304,47,47,0,1,0
18,332,332,16,7,9,4,3
7,341,341,20,20,0,1,0
22,360,360,27,27,0,1,0
17,362,362,28,28,0,1,0
19,373,373,20,20,0,1,0
9,375,375,25,3,22,3,2
2,386,386,39,39,0,1,0
14,391,391,34,34,0,1,0
24,397,397,33,9,24,2,1
11,400,400,67,67,0,1,0
32,432,432,12,6,6,2,1
5,434,434,33,5,28,3,2
13,443,443,43,27,16,3,2
4,453,453,40,35,5,2,1
29,453,453,47,43,4,2,1
27,458,458,237,102,135,4,3
21,480,480,21,11,10,3,2
16,481,481,6,6,0,1,0

19,100,100,26,13,13,2,1
32,120,120,7,1,6,2,1
13,141,141,10,1,9,2,1
4,143,143,1,1,0,1,0
41,158,158,31,9,22,2,1
22,163,163,39,39,0,1,0
8,166,166,8,3,5,2,1
12,171,171,44,3,41,2,1
26,175,175,23,23,0,1,0
33,176,176,7,7,0,1,0
5,188,188,10,4,6,2,1
2,196,196,22,22,0,1,0
7,201,201,19,4,15,2,1
25,234,234,3,3,0,1,0
24,253,253,18,18,0,1,0
15,266,266,11,11,0,1,0
3,269,269,16,11,5,2,1
31,273,273,26,26,0,1,0
9,279,279,68,17,51,4,3
23,287,287,1,1,0,1,0
30,289,289,53,24,29,4,3
35,290,290,35,35,0,1,0
10,326,326,10,10,0,1,0
39,333,333,47,47,0,1,0
0,355,355,7,1,6,2,1
29,366,366,14,14,0,1,0
20,370,370,9,9,0,1,0
21,378,378,15,5,10,2,1
18,389,389,9,3,6,2,1
14,399,399,8,8,0,1,0
28,399,399,7,2,5,2,1
17,411,411,7,1,6,2,1
16,420,420,17,17,0,1,0
34,430,430,78,50,28,3,2
37,431,431,70,41,29,2,1
38,434,434,83,40,43,2,1
1,436,436,24,24,0,1,0
40,440,440,77,59,18,4,3
6,448,448,35,7,28,3,2
11,453,453,28,28,0,1,0
42,461,461,40,2,38,2,1
36,476,476,10,10,0,1,0
27,479,479,6,6,0,1,0

21,108,108,20,20,0,1,0
6,140,140,2,2,0,1,0
33,142,142,1,1,0,1,0
10,146,146,10,10,0,1,0
22,148,148,14,1,13,2,1
5,159,159,22,22,0,1,0
40,183,183,9,4,5,2,1
31,185,185,10,2,8,2,1
37,191,191,14,6,8,3,2
18,192,192,1,1,0,1,0
13,201,201,23,23,0,1,0
15,205,205,3,3,0,1,0
20,217,217,21,3,18,2,1
32,222,222,20,20,0,1,0
25,225,225,2,2,0,1,0
35,244,244,71,71,0,1,0
1,246,246,3,3,0,1,0
16,252,252,23,23,0,1,0
7,279,279,22,22,0,1,0
41,283,283,16,16,0,1,0
43,304,304,35,1,34,3,2
8,318,318,1,1,0,1,0
2,336,336,4,4,0,1,0
34,339,339,8,8,0,1,0
19,349,349,11,5,6,3,2
38,356,356,4,4,0,1,0
28,357,357,76,76,0,1,0
24,363,363,51,27,24,3,2
45,380,380,159,159,0,1,0
17,390,390,51,51,0,1,0
0,394,394,34,5,29,2,1
30,406,406,14,14,0,1,0
3,413,413,49,49,0,1,0
4,422,422,16,13,3,2,1
26,423,423,35,35,0,1,0
14,431,431,81,63,18,4,3
39,433,433,18,13,5,2,1
9,436,436,10,10,0,1,0
42,439,439,94,1,93,4,3
12,441,441,1,1,0,1,0
27,451,451,31,31,0,1,0
44,457,457,27,27,0,1,0
11,461,461,1,1,0,1,0
36,474,474,42,42,0,1,0
23,482,482,57,15,42,4,3
29,495,495,5,5,0,1,0

28,104,104,6,6,0,1,0
18,107,107,1,1,0,1,0
36,111,111,10,10,0,1,0
8,117,117,4,1,3,2,1
19,123,123,7,7,0,1,0
4,123,123,2,2,0,1,0
9,126,126,23,23,0,1,0
11,129,129,1,1,0,1,0
29,129,129,5,1,4,2,1
0,135,135,12,1,11,2,1
40,139,139,1,1,0,1,0
10,164,164,1,1,0,1,0
16,192,192,7,7,0,1,0
1,223,223,10,10,0,1,0
41,237,237,16,16,0,1,0
15,238,238,5,5,0,1,0
32,242,242,7,7,0,1,0
21,252,252,23,23,0,1,0
6,259,259,35,17,18,4,3
37,267,267,55,13,42,4,3
17,270,270,16,4,12,3,2
20,274,274,15,10,5,2,1
30,276,276,36,21,15,2,1
24,284,284,20,2,18,3,2
12,327,327,43,32,11,2,1
7,330,330,26,26,0,1,0
35,347,347,3,3,0,1,0
39,353,353,149,131,18,3,2
3,375,375,22,10,12,2,1
25,385,385,70,70,0,1,0
5,387,387,28,15,13,3,2
14,392,392,37,37,0,1,0
26,401,401,1,1,0,1,0
34,411,411,61,61,0,1,0
31,412,412,33,11,22,4,3
33,417,417,19,15,4,2,1
38,453,453,102,21,81,4,3
2,462,462,70,22,48,4,3
13,485,485,58,43,15,4,3
23,487,487,155,155,0,1,0
42,494,494,39,7,32,4,3
22,496,496,15,15,0,1,0
27,497,497,28,5,23,3,2

11,105,105,5,5,0,1,0
31,105,105,3,3,0,1,0
21,125,125,5,5,0,1,0
13,133,133,42,42,0,1,0
12,151,151,2,2,0,1,0
1,154,154,10,10,0,1,0
5,156,156,11,4,7,2,1
2,159,159,2,2,0,1,0
4,159,159,17,17,0,1,0
25,171,171,1,1,0,1,0
24,201,201,40,7,33,4,3
27,216,216,38,19,19,4,3
22,225,225,2,2,0,1,0
15,231,231,1,1,0,1,0
36,233,233,8,8,0,1,0
14,236,236,4,4,0,1,0
16,249,249,8,1,7,2,1
9,260,260,6,3,3,2,1
0,270,270,98,98,0,1,0
33,284,284,2,2,0,1,0
29,288,288,16,8,8,2,1
8,289,289,5,1,4,2,1
20,297,297,35,20,15,2,1
34,302,302,77,35,42,2,1
32,335,335,81,81,0,1,0
17,336,336,69,21,48,4,3
38,337,337,65,65,0,1,0
6,347,347,34,10,24,2,1
18,373,373,36,9,27,3,2
26,375,375,23,7,16,3,2
37,383,383,44,19,25,2,1
30,392,392,17,3,14,3,2
10,411,411,43,43,0,1,0
3,424,424,7,2,5,2,1
19,432,432,6,6,0,1,0
23,443,443,57,57,0,1,0
28,446,446,7,7,0,1,0
35,449,449,95,12,83,4,3
7,492,492,137,19,118,4,3

18,114,114,19,7,12,2,1
7,119,119,6,6,0,1,0
14,120,120,6,3,3,2,1
2,123,123,18,18,0,1,0
36,125,125,8,8,0,1,0
10,133,133,15,1,14,3,2
32,137,137,11,4,7,2,1
23,152,152,8,1,7,2,1
34,171,171,6,6,0,1,0
16,205,205,4,4,0,1,0
17,211,211,33,33,0,1,0
29,214,214,61,61,0,1,0
6,217,217,3,3,0,1,0
35,224,224,20,20,0,1,0
24,229,229,1,1,0,1,0
11,231,231,12,12,0,1,0
21,232,232,29,29,0,1,0
20,233,233,23,23,0,1,0
4,257,257,23,16,7,3,2
25,263,263,10,10,0,1,0
5,273,273,4,4,0,1,0
28,300,300,74,49,25,2,1
12,300,300,30,14,16,2,1
27,302,302,74,74,0,1,0
19,309,309,39,7,32,2,1
1,323,323,21,21,0,1,0
22,344,344,7,4,3,2,1
0,351,351,57,57,0,1,0
31,387,387,11,11,0,1,0
8,389,389,2,2,0,1,0
13,400,400,42,17,25,4,3
15,409,409,96,96,0,1,0
30,412,412,66,42,24,2,1
3,466,466,241,241,0,1,0
33,469,469,23,1,22,4,3
9,487,487,3,3,0,1,0
26,494,494,15,15,0,1,0

9,108,108,9,9,0,1,0
13,108,108,3,3,0,1,0
35,111,111,3,3,0,1,0
14,121,121,5,2,3,2,1
31,141,141,14,14,0,1,0
7,142,142,7,7,0,1,0
3,156,156,16,5,11,2,1
27,165,165,26,4,22,3,2
5,168,168,8,3,5,2,1
4,204,204,10,7,3,2,1
22,222,222,93,81,12,2,1
23,225,225,5,5,0,1,0
17,226,226,28,28,0,1,0
2,232,232,44,29,15,4,3
26,239,239,5,1,4,2,1
6,252,252,63,46,17,4,3
16,269,269,38,38,0,1,0
36,283,283,25,25,0,1,0
11,288,288,8,4,4,2,1
8,289,289,22,22,0,1,0
32,296,296,40,4,36,3,2
0,298,298,22,14,8,2,1
10,301,301,4,4,0,1,0
25,313,313,5,5,0,1,0
38,314,314,19,19,0,1,0
34,323,323,29,13,16,3,2
29,326,326,36,36,0,1,0
18,339,339,4,4,0,1,0
37,342,342,20,20,0,1,0
1,343,343,62,36,26,2,1
20,354,354,52,52,0,1,0
15,382,382,34,34,0,1,0
33,393,393,87,54,33,4,3
19,397,397,122,122,0,1,0
28,398,398,13,10,3,2,1
12,436,436,7,1,6,3,2
21,450,450,55,19,36,3,2
30,472,472,19,19,0,1,0
24,484,484,30,30,0,1,0

28,100,100,4,4,0,1,0
4,118,118,23,3,20,2,1
30,118,118,4,4,0,1,0
17,124,124,16,16,0,1,0
12,130,130,3,3,0,1,0
8,132,132,34,34,0,1,0
13,151,151,13,13,0,1,0
2,172,172,7,7,0,1,0
16,179,179,21,21,0,1,0
19,196,196,59,17,42,2,1
27,246,246,6,6,0,1,0
29,249,249,13,13,0,1,0
31,250,250,12,3,9,2,1
5,274,274,38,38,0,1,0
23,289,289,24,14,10,3,2
20,302,302,13,13,0,1,0
25,302,302,11,5,6,2,1
21,302,302,20,20,0,1,0
24,306,306,25,6,19,3,2
6,312,312,26,6,20,3,2
11,326,326,24,24,0,1,0
10,327,327,65,65,0,1,0
3,334,334,64,64,0,1,0
9,345,345,1,1,0,1,0
7,349,349,19,1,18,4,3
18,354,354,161,126,35,2,1
26,358,358,6,6,0,1,0
0,381,381,66,66,0,1,0
15,406,406,3,3,0,1,0
1,426,426,48,48,0,1,0
32,427,427,49,49,0,1,0
33,454,454,67,61,6,3,2
22,457,457,68,11,57,4,3
14,498,498,134,41,93,4,3

30,105,105,4,4,0,1,0
11,120,120,1,1,0,1,0
23,122,122,18,18,0,1,0
4,126,126,25,16,9,4,3
34,126,126,23,8,15,2,1
10,132,132,1,1,0,1,0
21,140,140,5,5,0,1,0
32,144,144,34,8,26,4,3
18,148,148,16,16,0,1,0
19,157,157,7,7,0,1,0
14,160,160,45,5,40,3,2
38,162,162,6,6,0,1,0
37,173,173,13,2,11,2,1
29,199,199,24,24,0,1,0
17,216,216,8,8,0,1,0
0,221,221,12,12,0,1,0
39,225,225,22,22,0,1,0
9,226,226,13,3,10,2,1
40,243,243,1,1,0,1,0
8,275,275,1,1,0,1,0
36,290,290,19,19,0,1,0
26,292,292,75,1,74,3,2
15,307,307,22,8,14,3,2
20,323,323,67,25,42,2,1
31,326,326,3,3,0,1,0
2,329,329,44,38,6,2,1
24,351,351,33,24,9,2,1
16,368,368,57,57,0,1,0
27,371,371,20,20,0,1,0
22,401,401,66,6,60,3,2
35,403,403,42,27,15,4,3
7,430,430,10,2,8,3,2
28,436,436,5,5,0,1,0
1,444,444,81,81,0,1,0
3,444,444,15,15,0,1,0
6,466,466,37,37,0,1,0
13,469,469,15,15,0,1,0
33,478,478,60,20,40,3,2
5,480,480,19,19,0,1,0
12,483,483,51,40,11,4,3
25,496,496,58,58,0,1,0

14,108,108,3,3,0,1,0
31,113,113,3,3,0,1,0
10,159,159,19,5,14,3,2
25,160,160,32,7,25,4,3
34,182,182,27,27,0,1,0
26,187,187,17,17,0,1,0
12,203,203,27,6,21,4,3
18,203,203,1,1,0,1,0
19,212,212,42,10,32,2,1
23,223,223,19,19,0,1,0
30,257,257,38,24,14,2,1
6,270,270,23,3,20,2,1
11,275,275,134,107,27,2,1
32,281,281,16,13,3,2,1
3,284,284,23,19,4,2,1
22,296,296,9,2,7,2,1
2,299,299,2,2,0,1,0
4,307,307,35,11,24,4,3
20,310,310,2,2,0,1,0
5,311,311,13,1,12,3,2
24,312,312,41,5,36,4,3
27,317,317,47,11,36,4,3
33,318,318,23,3,20,3,2
8,331,331,65,29,36,3,2
17,337,337,31,31,0,1,0
1,338,338,26,26,0,1,0
28,386,386,64,64,0,1,0
7,398,398,22,18,4,2,1
9,399,399,121,121,0,1,0
16,428,428,77,51,26,3,2
15,439,439,44,44,0,1,0
21,452,452,37,20,17,2,1
29,487,487,35,18,17,2,1
0,487,487,11,11,0,1,0
13,487,487,25,25,0,1,0

12,103,103,4,4,0,1,0
32,124,124,16,16,0,1,0
27,125,125,15,15,0,1,0
14,125,125,15,3,12,3,2
21,142,142,10,10,0,1,0
34,158,158,31,9,22,4,3
6,174,174,1,1,0,1,0
25,179,179,2,2,0,1,0
31,209,209,11,6,5,2,1
18,224,224,7,7,0,1,0
22,225,225,61,11,50,2,1
15,229,229,28,28,0,1,0
4,232,232,29,29,0,1,0
2,239,239,43,16,27,4,3
5,259,259,11,1,10,3,2
10,260,260,25,25,0,1,0
0,269,269,3,3,0,1,0
23,277,277,16,3,13,2,1
33,284,284,9,9,0,1,0
19,305,305,54,45,9,4,3
35,312,312,2,2,0,1,0
1,343,343,72,10,62,3,2
36,347,347,50,50,0,1,0
24,364,364,58,47,11,3,2
20,370,370,58,58,0,1,0
9,370,370,117,48,69,4,3
7,372,372,101,18,83,4,3
3,378,378,4,4,0,1,0
26,383,383,27,27,0,1,0
38,384,384,4,4,0,1,0
29,398,398,87,62,25,2,1
16,428,428,23,4,19,2,1
28,435,435,35,11,24,4,3
30,442,442,2,2,0,1,0
13,453,453,2,2,0,1,0
37,463,463,65,45,20,4,3
11,467,467,9,9,0,1,0
8,497,497,25,8,17,2,1
17,498,498,8,8,0,1,0

17,105,105,42,4,38,2,1
7,107,107,10,10,0,1,0
29,118,118,10,1,9,2,1
6,119,119,6,6,0,1,0
8,120,120,3,3,0,1,0
37,128,128,3,3,0,1,0
10,139,139,29,29,0,1,0
23,154,154,33,15,18,2,1
28,174,174,33,12,21,4,3
0,178,178,1,1,0,1,0
38,184,184,33,33,0,1,0
34,203,203,18,4,14,2,1
16,211,211,53,53,0,1,0
9,216,216,16,10,6,2,1
11,235,235,42,32,10,2,1
30,247,247,3,3,0,1,0
3,254,254,26,10,16,2,1
32,259,259,6,6,0,1,0
2,272,272,49,11,38,2,1
15,283,283,7,7,0,1,0
12,285,285,5,5,0,1,0
31,293,293,34,13,21,4,3
4,300,300,25,25,0,1,0
36,300,300,49,49,0,1,0
25,301,301,31,22,9,2,1
5,313,313,16,7,9,2,1
33,338,338,15,8,7,2,1
19,380,380,2,2,0,1,0
22,381,381,4,4,0,1,0
18,417,417,26,26,0,1,0
26,422,422,2,2,0,1,0
20,429,429,6,6,0,1,0
14,453,453,8,5,3,2,1
27,468,468,87,56,31,4,3
35,470,470,23,3,20,2,1
24,475,475,162,80,82,3,2
21,485,485,46,28,18,2,1
13,499,499,28,2,26,2,1
1,500,500,7,7,0,1,0

1,117,117,1,1,0,1,0
10,118,118,43,22,21,4,3
7,124,124,11,11,0,1,0
29,125,125,4,1,3,2,1
27,135,135,5,5,0,1,0
20,151,151,11,11,0,1,0
26,157,157,24,4,20,2,1
11,160,160,2,2,0,1,0
14,193,193,1,1,0,1,0
19,199,199,22,22,0,1,0
12,203,203,48,15,33,4,3
4,216,216,11,11,0,1,0
23,222,222,20,20,0,1,0
32,231,231,73,73,0,1,0
24,236,236,31,7,24,2,1
13,248,248,27,22,5,2,1
30,264,264,21,21,0,1,0
3,276,276,10,10,0,1,0
6,281,281,3,3,0,1,0
17,297,297,47,47,0,1,0
16,300,300,61,27,34,3,2
22,312,312,14,14,0,1,0
25,355,355,89,89,0,1,0
2,364,364,127,1,126,4,3
33,367,367,2,2,0,1,0
5,380,380,38,1,37,4,3
18,383,383,85,10,75,4,3
35,403,403,16,6,10,2,1
15,408,408,22,22,0,1,0
34,411,411,37,4,33,3,2
21,439,439,16,16,0,1,0
0,454,454,23,17,6,2,1
8,454,454,74,74,0,1,0
28,487,487,23,11,12,3,2
31,491,491,8,8,0,1,0
9,499,499,30,30,0,1,0

31,112,112,6,6,0,1,0
11,121,121,1,1,0,1,0
2,135,135,2,2,0,1,0
1,136,136,9,9,0,1,0
23,156,156,21,21,0,1,0
16,187,187,24,4,20,2,1
24,197,197,3,3,0,1,0
30,203,203,6,2,4,2,1
4,205,205,78,78,0,1,0
37,212,212,44,44,0,1,0
8,219,219,3,3,0,1,0
6,225,225,2,2,0,1,0
13,242,242,20,2,18,2,1
22,257,257,17,5,12,3,2
0,278,278,24,16,8,3,2
14,281,281,3,3,0,1,0
7,282,282,26,26,0,1,0
18,335,335,4,1,3,2,1
12,344,344,38,28,10,2,1
40,346,346,100,61,39,3,2
32,351,351,52,52,0,1,0
29,351,351,6,6,0,1,0
17,358,358,115,75,40,2,1
39,362,362,1,1,0,1,0
5,368,368,33,24,9,2,1
34,377,377,30,23,7,2,1
19,396,396,12,12,0,1,0
26,411,411,10,10,0,1,0
25,418,418,46,1,45,4,3
21,425,425,43,5,38,2,1
38,425,425,19,1,18,4,3
9,426,426,29,11,18,2,1
36,437,437,44,12,32,2,1
10,442,442,97,97,0,1,0
35,453,453,28,28,0,1,0
27,469,469,156,156,0,1,0
20,469,469,3,3,0,1,0
28,470,470,59,29,30,4,3
15,480,480,10,2,8,2,1
33,483,483,43,43,0,1,0
3,499,499,15,3,12,3,2

19,100,100,1,1,0,1,0
22,104,104,2,2,0,1,0
26,109,109,20,5,15,4,3
9,110,110,10,10,0,1,0
34,119,119,50,6,44,3,2
31,136,136,7,7,0,1,0
32,139,139,7,7,0,1,0
4,149,149,13,13,0,1,0
12,159,159,12,4,8,2,1
1,163,163,17,17,0,1,0
17,188,188,1,1,0,1,0
5,202,202,16,16,0,1,0
30,203,203,62,36,26,2,1
24,207,207,54,54,0,1,0
25,212,212,10,10,0,1,0
28,221,221,3,3,0,1,0
33,225,225,4,4,0,1,0
7,262,262,6,6,0,1,0
10,270,270,161,100,61,4,3
27,271,271,10,1,9,2,1
11,288,288,16,16,0,1,0
20,303,303,15,15,0,1,0
18,325,325,6,6,0,1,0
6,331,331,7,7,0,1,0
29,336,336,75,2,73,4,3
2,344,344,35,31,4,2,1
36,351,351,2,2,0,1,0
14,352,352,62,62,0,1,0
39,354,354,3,3,0,1,0
15,356,356,16,16,0,1,0
38,374,374,11,1,10,3,2
13,382,382,9,9,0,1,0
21,385,385,5,1,4,2,1
37,400,400,30,30,0,1,0
3,419,419,84,27,57,3,2
40,448,448,30,30,0,1,0
16,450,450,30,20,10,2,1
0,467,467,10,10,0,1,0
8,483,483,18,18,0,1,0
23,486,486,36,36,0,1,0
35,495,495,25,11,14,3,2

31,102,102,15,15,0,1,0
3,102,102,10,10,0,1,0
26,122,122,22,22,0,1,0
37,123,123,9,1,8,3,2
32,130,130,1,1,0,1,0
6,133,133,29,21,8,3,2
27,181,181,1,1,0,1,0
35,186,186,1,1,0,1,0
0,201,201,66,66,0,1,0
9,202,202,15,15,0,1,0
5,219,219,1,1,0,1,0
33,221,221,4,4,0,1,0
20,232,232,12,12,0,1,0
22,237,237,1,1,0,1,0
12,242,242,1,1,0,1,0
17,243,243,27,1,26,2,1
23,255,255,36,5,31,2,1
8,261,261,21,9,12,3,2
25,267,267,58,38,20,2,1
34,277,277,30,30,0,1,0
10,302,302,34,10,24,3,2
7,308,308,16,1,15,2,1
15,315,315,3,3,0,1,0
1,322,322,70,70,0,1,0
30,335,335,34,34,0,1,0
36,359,359,9,5,4,2,1
28,367,367,30,18,12,3,2
19,369,369,92,26,66,4,3
29,385,385,12,12,0,1,0
4,395,395,1,1,0,1,0
24,416,416,87,87,0,1,0
14,432,432,19,19,0,1,0
11,453,453,58,20,38,2,1
2,455,455,44,19,25,2,1
13,458,458,98,66,32,2,1
18,483,483,36,6,30,4,3
21,490,490,146,146,0,1,0
16,492,492,15,15,0,1,0

5,110,110,9,4,5,2,1
21,142,142,49,40,9,2,1
28,164,164,36,28,8,3,2
11,166,166,1,1,0,1,0
37,168,168,22,22,0,1,0
18,168,168,1,1,0,1,0
2,172,172,1,1,0,1,0
9,188,188,22,22,0,1,0
16,204,204,43,43,0,1,0
1,206,206,1,1,0,1,0
10,211,211,7,7,0,1,0
7,225,225,6,3,3,2,1
20,225,225,16,16,0,1,0
8,227,227,102,102,0,1,0
17,230,230,6,6,0,1,0
25,264,264,28,28,0,1,0
19,270,270,4,4,0,1,0
33,279,279,64,64,0,1,0
34,289,289,10,10,0,1,0
24,292,292,12,12,0,1,0
31,294,294,12,12,0,1,0
6,296,296,7,7,0,1,0
4,305,305,4,4,0,1,0
15,320,320,70,70,0,1,0
0,321,321,41,36,5,2,1
27,327,327,101,59,42,3,2
35,328,328,4,4,0,1,0
38,328,328,31,12,19,2,1
32,330,330,26,26,0,1,0
36,340,340,30,30,0,1,0
14,381,381,81,81,0,1,0
29,398,398,10,4,6,3,2
39,401,401,5,5,0,1,0
26,413,413,29,9,20,2,1
3,424,424,9,9,0,1,0
23,430,430,30,30,0,1,0
30,442,442,5,5,0,1,0
13,444,444,100,79,21,2,1
22,472,472,5,5,0,1,0
12,483,483,4,1,3,2,1

33,111,111,16,4,12,3,2
26,113,113,10,10,0,1,0
31,114,114,11,11,0,1,0
11,127,127,5,5,0,1,0
7,132,132,15,5,10,2,1
9,140,140,1,1,0,1,0
39,147,147,11,7,4,2,1
18,154,154,12,12,0,1,0
38,158,158,55,55,0,1,0
29,159,159,59,59,0,1,0
21,190,190,38,20,18,2,1
4,190,190,9,9,0,1,0
34,196,196,19,19,0,1,0
24,221,221,14,14,0,1,0
2,229,229,4,1,3,2,1
25,232,232,21,21,0,1,0
16,238,238,98,68,30,2,1
13,249,249,10,10,0,1,0
5,306,306,28,28,0,1,0
32,313,313,24,4,20,3,2
10,331,331,23,19,4,2,1
8,338,338,23,23,0,1,0
12,338,338,26,26,0,1,0
6,338,338,30,30,0,1,0
37,350,350,7,7,0,1,0
30,357,357,12,4,8,3,2
19,390,390,5,5,0,1,0
1,399,399,1,1,0,1,0
22,403,403,56,50,6,2,1
28,408,408,10,10,0,1,0
14,411,411,23,2,21,2,1
0,418,418,20,20,0,1,0
15,420,420,97,97,0,1,0
23,420,420,20,16,4,2,1
3,433,433,31,31,0,1,0
17,453,453,45,45,0,1,0
36,456,456,8,2,6,2,1
20,460,460,106,68,38,2,1
35,487,487,2,2,0,1,0
27,495,495,3,3,0,1,0

34,101,101,17,6,11,2,1
15,126,126,1,1,0,1,0
8,136,136,6,6,0,1,0
0,141,141,16,1,15,2,1
7,145,145,1,1,0,1,0
23,162,162,1,1,0,1,0
12,175,175,23,5,18,2,1
6,195,195,2,2,0,1,0
14,206,206,10,10,0,1,0
9,210,210,11,2,9,4,3
33,213,213,15,15,0,1,0
22,222,222,1,1,0,1,0
30,225,225,2,2,0,1,0
24,232,232,4,4,0,1,0
2,232,232,11,11,0,1,0
18,232,232,16,8,8,2,1
1,243,243,45,12,33,2,1
25,244,244,11,4,7,2,1
31,246,246,77,73,4,2,1
35,263,263,3,3,0,1,0
32,267,267,96,33,63,4,3
29,271,271,49,22,27,4,3
4,281,281,38,20,18,4,3
19,295,295,45,30,15,4,3
16,309,309,4,4,0,1,0
27,315,315,17,17,0,1,0
28,329,329,131,122,9,4,3
17,347,347,4,4,0,1,0
37,376,376,2,2,0,1,0
38,378,378,10,2,8,3,2
21,384,384,2,2,0,1,0
3,386,386,114,114,0,1,0
11,406,406,9,9,0,1,0
5,420,420,19,5,14,3,2
39,424,424,60,34,26,4,3
26,425,425,11,6,5,2,1
13,445,445,56,28,28,3,2
36,446,446,38,30,8,2,1
10,482,482,38,38,0,1,0
20,496,496,151,97,54,4,3

20,113,113,8,8,0,1,0
5,117,117,22,4,18,4,3
14,148,148,35,8,27,2,1
7,153,153,71,32,39,4,3
28,155,155,7,7,0,1,0
19,159,159,23,23,0,1,0
25,163,163,4,1,3,2,1
23,166,166,62,11,51,4,3
15,174,174,1,1,0,1,0
18,177,177,5,2,3,2,1
32,179,179,3,3,0,1,0
12,183,183,57,57,0,1,0
24,191,191,25,3,22,3,2
27,238,238,8,2,6,2,1
22,245,245,5,2,3,2,1
2,261,261,13,13,0,1,0
4,306,306,12,12,0,1,0
6,332,332,3,3,0,1,0
26,352,352,88,74,14,2,1
3,356,356,63,9,54,4,3
8,381,381,5,2,3,2,1
21,384,384,72,40,32,2,1
29,395,395,22,5,17,3,2
11,395,395,32,32,0,1,0
17,401,401,20,20,0,1,0
31,424,424,68,68,0,1,0
0,435,435,52,33,19,2,1
30,442,442,17,17,0,1,0
1,449,449,8,2,6,2,1
16,469,469,105,42,63,3,2
9,486,486,66,66,0,1,0
33,488,488,42,22,20,2,1
13,490,490,26,12,14,2,1
10,492,492,4,4,0,1,0

4,103,103,3,3,0,1,0
12,105,105,11,11,0,1,0
11,108,108,14,14,0,1,0
33,117,117,3,3,0,1,0
16,132,132,11,1,10,3,2
17,142,142,10,10,0,1,0
7,147,147,1,1,0,1,0
28,162,162,10,4,6,3,2
8,171,171,15,15,0,1,0
15,179,179,16,13,3,2,1
23,213,213,2,2,0,1,0
19,239,239,54,40,14,3,2
10,260,260,27,27,0,1,0
2,263,263,4,4,0,1,0
3,265,265,7,7,0,1,0
5,271,271,81,81,0,1,0
6,294,294,83,83,0,1,0
22,295,295,96,32,64,3,2
31,306,306,10,5,5,2,1
30,310,310,14,14,0,1,0
1,318,318,5,5,0,1,0
14,322,322,25,10,15,4,3
32,328,328,36,3,33,4,3
21,339,339,26,26,0,1,0
18,342,342,86,78,8,3,2
20,383,383,19,19,0,1,0
0,387,387,32,22,10,3,2
25,390,390,17,9,8,3,2
13,397,397,83,11,72,4,3
26,405,405,80,80,0,1,0
24,411,411,65,65,0,1,0
27,433,433,32,1,31,2,1
29,437,437,4,4,0,1,0
9,452,452,195,105,90,4,3

36,141,141,23,23,0,1,0
21,143,143,4,4,0,1,0
12,157,157,1,1,0,1,0
38,165,165,3,3,0,1,0
32,187,187,17,6,11,2,1
19,192,192,34,34,0,1,0
2,196,196,21,21,0,1,0
27,200,200,24,19,5,2,1
5,211,211,8,8,0,1,0
17,212,212,12,12,0,1,0
16,213,213,16,2,14,3,2
15,232,232,4,4,0,1,0
34,246,246,36,36,0,1,0
33,246,246,43,43,0,1,0
24,248,248,14,14,0,1,0
14,258,258,36,36,0,1,0
22,276,276,12,12,0,1,0
29,304,304,17,17,0,1,0
0,306,306,15,15,0,1,0
4,316,316,25,25,0,1,0
20,323,323,31,1,30,3,2
8,329,329,26,26,0,1,0
9,357,357,46,26,20,3,2
23,358,358,69,10,59,3,2
18,370,370,21,12,9,2,1
28,406,406,75,32,43,2,1
10,410,410,58,4,54,4,3
7,415,415,2,2,0,1,0
26,419,419,151,151,0,1,0
13,424,424,82,82,0,1,0
31,426,426,31,31,0,1,0
35,436,436,38,38,0,1,0
30,443,443,5,5,0,1,0
1,448,448,87,63,24,3,2
37,455,455,14,4,10,2,1
6,455,455,32,27,5,2,1
3,459,459,118,79,39,2,1
25,461,461,1,1,0,1,0
11,474,474,15,15,0,1,0

12,133,133,11,11,0,1,0
10,135,135,6,6,0,1,0
24,139,139,1,1,0,1,0
3,156,156,15,9,6,2,1
15,168,168,24,8,16,2,1
4,178,178,5,5,0,1,0
23,178,178,4,4,0,1,0
13,182,182,12,12,0,1,0
8,186,186,33,9,24,3,2
31,186,186,16,16,0,1,0
18,211,211,19,16,3,2,1
29,212,212,21,21,0,1,0
14,214,214,41,41,0,1,0
6,216,216,41,15,26,2,1
11,217,217,23,23,0,1,0
22,218,218,50,13,37,4,3
9,230,230,1,1,0,1,0
25,245,245,16,16,0,1,0
34,258,258,14,4,10,3,2
35,261,261,34,30,4,2,1
19,264,264,15,15,0,1,0
36,273,273,23,23,0,1,0
17,308,308,2,2,0,1,0
1,323,323,14,14,0,1,0
7,327,327,35,6,29,2,1
16,349,349,1,1,0,1,0
21,362,362,71,71,0,1,0
28,366,366,6,2,4,2,1
5,383,383,50,32,18,4,3
30,385,385,95,41,54,4,3
2,399,399,27,1,26,2,1
32,414,414,11,8,3,2,1
37,434,434,16,16,0,1,0
26,440,440,47,47,0,1,0
20,453,453,55,55,0,1,0
27,467,467,51,39,12,3,2
0,468,468,152,71,81,4,3
33,487,487,119,53,66,3,2

37,108,108,7,2,5,2,1
12,117,117,31,5,26,2,1
40,128,128,46,46,0,1,0
22,132,132,6,6,0,1,0
17,141,141,1,1,0,1,0
29,143,143,6,6,0,1,0
24,146,146,18,18,0,1,0
2,174,174,9,5,4,2,1
8,182,182,1,1,0,1,0
36,182,182,6,1,5,2,1
7,184,184,23,6,17,3,2
16,195,195,48,10,38,3,2
19,201,201,9,9,0,1,0
15,211,211,5,5,0,1,0
0,222,222,82,22,60,4,3
18,224,224,52,34,18,3,2
11,226,226,2,2,0,1,0
35,228,228,35,13,22,3,2
5,232,232,9,9,0,1,0
23,265,265,36,29,7,2,1
25,270,270,85,4,81,4,3
4,271,271,55,55,0,1,0
14,277,277,4,1,3,2,1
28,287,287,18,7,11,2,1
39,296,296,45,45,0,1,0
13,309,309,13,13,0,1,0
6,314,314,5,5,0,1,0
3,320,320,21,21,0,1,0
1,323,323,9,9,0,1,0
34,363,363,4,4,0,1,0
27,369,369,55,31,24,4,3
21,370,370,3,3,0,1,0
9,385,385,6,2,4,2,1
33,391,391,44,44,0,1,0
32,409,409,6,1,5,2,1
20,428,428,20,20,0,1,0
38,435,435,28,28,0,1,0
41,443,443,33,33,0,1,0
31,444,444,2,2,0,1,0
10,465,465,2,2,0,1,0
30,470,470,4,4,0,1,0
26,495,495,30,30,0,1,0

40,109,109,3,3,0,1,0
29,119,119,11,11,0,1,0
30,130,130,45,33,12,4,3
14,135,135,6,6,0,1,0
20,170,170,8,8,0,1,0
22,175,175,3,3,0,1,0
17,175,175,13,1,12,4,3
6,180,180,11,11,0,1,0
5,194,194,12,12,0,1,0
13,196,196,4,1,3,2,1
7,216,216,1,1,0,1,0
10,219,219,38,38,0,1,0
24,238,238,18,18,0,1,0
32,239,239,18,8,10,2,1
43,251,251,14,14,0,1,0
39,259,259,5,1,4,2,1
36,269,269,2,2,0,1,0
19,275,275,25,9,16,4,3
31,284,284,18,9,9,2,1
42,293,293,34,9,25,2,1
28,298,298,94,57,37,2,1
15,298,298,20,5,15,4,3
35,302,302,15,15,0,1,0
25,302,302,3,3,0,1,0
33,312,312,28,23,5,2,1
9,314,314,41,41,0,1,0
44,316,316,18,18,0,1,0
11,322,322,13,1,12,4,3
27,325,325,12,12,0,1,0
38,334,334,72,72,0,1,0
41,337,337,11,3,8,2,1
16,352,352,5,2,3,2,1
0,352,352,6,6,0,1,0
26,381,381,5,5,0,1,0
4,385,385,38,38,0,1,0
12,388,388,19,8,11,2,1
37,399,399,43,36,7,2,1
18,402,402,10,10,0,1,0
8,404,404,31,4,27,2,1
3,406,406,12,12,0,1,0
1,421,421,17,17,0,1,0
2,431,431,31,23,8,3,2
23,446,446,10,10,0,1,0
21,484,484,261,156,105,4,3
34,488,488,109,59,50,4,3

39,116,116,2,2,0,1,0
5,116,116,4,1,3,2,1
3,141,141,2,2,0,1,0
27,149,149,21,21,0,1,0
21,155,155,13,5,8,2,1
13,167,167,11,1,10,3,2
28,195,195,17,17,0,1,0
20,200,200,1,1,0,1,0
34,229,229,47,47,0,1,0
36,230,230,5,5,0,1,0
22,231,231,65,32,33,4,3
33,232,232,21,13,8,2,1
24,233,233,12,2,10,2,1
37,233,233,44,36,8,2,1
31,263,263,16,16,0,1,0
18,269,269,1,1,0,1,0
35,293,293,6,6,0,1,0
16,293,293,6,6,0,1,0
32,304,304,9,9,0,1,0
30,315,315,49,49,0,1,0
25,338,338,78,40,38,3,2
6,341,341,71,62,9,2,1
38,344,344,17,17,0,1,0
19,348,348,58,58,0,1,0
23,355,355,24,8,16,3,2
8,364,364,93,21,72,4,3
12,365,365,42,18,24,2,1
11,383,383,74,57,17,2,1
17,390,390,79,79,0,1,0
9,393,393,17,8,9,2,1
4,400,400,9,9,0,1,0
2,413,413,2,2,0,1,0
10,419,419,54,54,0,1,0
26,420,420,9,9,0,1,0
1,425,425,90,90,0,1,0
29,448,448,63,13,50,3,2
7,455,455,3,3,0,1,0
0,457,457,27,17,10,3,2
14,463,463,8,2,6,3,2
15,477,477,58,58,0,1,0

21,110,110,1,1,0,1,0
6,115,115,3,3,0,1,0
26,138,138,11,11,0,1,0
9,141,141,6,6,0,1,0
11,177,177,1,1,0,1,0
3,179,179,6,6,0,1,0
40,185,185,22,22,0,1,0
32,195,195,23,23,0,1,0
43,204,204,13,3,10,4,3
35,211,211,63,23,40,2,1
2,212,212,11,11,0,1,0
36,223,223,9,9,0,1,0
7,234,234,10,10,0,1,0
16,239,239,47,17,30,4,3
20,242,242,1,1,0,1,0
27,251,251,17,17,0,1,0
23,256,256,1,1,0,1,0
25,287,287,12,12,0,1,0
19,290,290,22,22,0,1,0
41,293,293,4,1,3,2,1
12,296,296,23,23,0,1,0
5,305,305,12,12,0,1,0
24,305,305,114,92,22,3,2
17,310,310,31,8,23,2,1
14,313,313,35,35,0,1,0
28,321,321,113,113,0,1,0
37,342,342,30,3,27,2,1
38,348,348,17,17,0,1,0
22,349,349,66,66,0,1,0
42,359,359,16,9,7,2,1
4,366,366,1,1,0,1,0
18,368,368,50,1,49,2,1
0,368,368,1,1,0,1,0
10,376,376,9,1,8,2,1
44,387,387,56,56,0,1,0
1,388,388,28,28,0,1,0
8,392,392,10,10,0,1,0
34,398,398,39,9,30,3,2
15,402,402,57,37,20,3,2
13,413,413,30,14,16,2,1
39,417,417,33,1,32,2,1
31,459,459,18,9,9,4,3
30,465,465,64,22,42,4,3
33,486,486,50,5,45,4,3
29,497,497,4,1,3,2,1

19,115,115,15,8,7,2,1
5,117,117,10,6,4,2,1
36,128,128,17,5,12,3,2
15,142,142,5,5,0,1,0
12,172,172,16,16,0,1,0
26,182,182,35,13,22,3,2
1,194,194,3,3,0,1,0
9,196,196,15,9,6,2,1
7,205,205,49,25,24,3,2
11,218,218,10,10,0,1,0
2,225,225,13,5,8,3,2
35,229,229,18,18,0,1,0
27,234,234,43,43,0,1,0
24,259,259,15,15,0,1,0
8,261,261,57,30,27,4,3
6,262,262,16,16,0,1,0
32,272,272,35,25,10,2,1
3,285,285,7,7,0,1,0
0,291,291,29,3,26,3,2
10,293,293,42,3,39,4,3
20,300,300,41,41,0,1,0
29,305,305,16,16,0,1,0
22,318,318,9,1,8,2,1
14,324,324,22,5,17,2,1
30,336,336,61,61,0,1,0
21,351,351,13,13,0,1,0
31,356,356,13,5,8,3,2
25,358,358,8,8,0,1,0
28,374,374,86,81,5,2,1
34,376,376,30,10,20,3,2
13,394,394,93,53,40,2,1
23,394,394,64,29,35,2,1
33,422,422,22,22,0,1,0
18,425,425,4,4,0,1,0
4,457,457,31,17,14,3,2
16,483,483,9,1,8,3,2
17,498,498,157,94,63,4,3

33,115,115,22,17,5,2,1
15,139,139,11,11,0,1,0
26,157,157,13,13,0,1,0
28,177,177,4,4,0,1,0
18,187,187,16,7,9,2,1
40,187,187,3,3,0,1,0
35,198,198,62,62,0,1,0
2,201,201,7,3,4,2,1
37,203,203,22,12,10,3,2
17,215,215,51,51,0,1,0
25,217,217,18,12,6,2,1
10,218,218,2,2,0,1,0
32,227,227,6,3,3,2,1
13,231,231,3,3,0,1,0
38,237,237,33,3,30,3,2
24,239,239,73,73,0,1,0
11,241,241,19,14,5,2,1
21,244,244,20,20,0,1,0
5,245,245,35,23,12,4,3
23,249,249,3,3,0,1,0
6,268,268,44,11,33,2,1
8,271,271,2,2,0,1,0
9,275,275,22,6,16,2,1
39,299,299,17,17,0,1,0
41,339,339,41,7,34,3,2
7,352,352,1,1,0,1,0
16,364,364,4,4,0,1,0
30,371,371,22,14,8,3,2
31,376,376,44,44,0,1,0
34,395,395,14,14,0,1,0
0,399,399,71,22,49,2,1
27,402,402,93,30,63,4,3
3,415,415,22,22,0,1,0
19,417,417,4,4,0,1,0
22,425,425,14,14,0,1,0
20,426,426,13,13,0,1,0
36,430,430,7,7,0,1,0
14,436,436,37,37,0,1,0
29,452,452,1,1,0,1,0
12,466,466,61,61,0,1,0
1,475,475,110,76,34,3,2
4,489,489,60,22,38,2,1

35,108,108,6,1,5,2,1
26,117,117,15,6,9,2,1
8,129,129,21,6,15,4,3
22,134,134,1,1,0,1,0
6,138,138,1,1,0,1,0
28,156,156,8,8,0,1,0
32,176,176,12,12,0,1,0
27,185,185,12,12,0,1,0
20,186,186,14,14,0,1,0
9,200,200,10,10,0,1,0
29,205,205,19,19,0,1,0
7,227,227,1,1,0,1,0
37,234,234,5,5,0,1,0
39,235,235,38,38,0,1,0
24,238,238,15,15,0,1,0
16,242,242,13,6,7,2,1
0,246,246,15,3,12,4,3
15,264,264,9,9,0,1,0
23,271,271,57,20,37,2,1
31,272,272,34,34,0,1,0
25,318,318,49,23,26,2,1
18,325,325,7,7,0,1,0
11,347,347,11,5,6,3,2
14,361,361,8,8,0,1,0
12,371,371,1,1,0,1,0
30,373,373,35,35,0,1,0
19,378,378,157,103,54,4,3
33,381,381,24,24,0,1,0
10,384,384,9,3,6,3,2
4,389,389,23,7,16,2,1
34,402,402,15,5,10,2,1
17,402,402,47,47,0,1,0
38,402,402,65,65,0,1,0
3,418,418,66,16,50,2,1
2,420,420,131,51,80,3,2
36,428,428,16,4,12,4,3
1,437,437,83,83,0,1,0
13,448,448,36,36,0,1,0
21,457,457,158,149,9,4,3
5,473,473,11,11,0,1,0

8,118,118,24,4,20,3,2
39,128,128,33,11,22,2,1
31,135,135,38,38,0,1,0
25,142,142,3,3,0,1,0
23,157,157,1,1,0,1,0
27,169,169,19,19,0,1,0
12,170,170,33,24,9,2,1
29,181,181,4,4,0,1,0
0,191,191,27,27,0,1,0
11,197,197,27,21,6,2,1
36,214,214,2,2,0,1,0
18,217,217,10,10,0,1,0
37,219,219,42,42,0,1,0
35,227,227,33,33,0,1,0
22,229,229,4,4,0,1,0
19,247,247,1,1,0,1,0
42,248,248,24,3,21,4,3
10,256,256,5,1,4,2,1
28,269,269,1,1,0,1,0
33,274,274,51,51,0,1,0
34,281,281,28,28,0,1,0
2,285,285,31,23,8,3,2
16,291,291,39,39,0,1,0
41,306,306,4,4,0,1,0
1,325,325,35,35,0,1,0
17,327,327,34,34,0,1,0
14,346,346,62,62,0,1,0
20,354,354,4,1,3,2,1
32,373,373,34,17,17,4,3
24,388,388,81,44,37,2,1
3,399,399,1,1,0,1,0
7,401,401,11,11,0,1,0
13,423,423,46,46,0,1,0
6,425,425,11,11,0,1,0
38,442,442,26,26,0,1,0
9,445,445,9,9,0,1,0
30,447,447,38,38,0,1,0
5,448,448,30,7,23,2,1
15,458,458,52,52,0,1,0
26,462,462,11,5,6,3,2
40,469,469,13,13,0,1,0
21,485,485,1,1,0,1,0
4,494,494,60,60,0,1,0

27,102,102,2,2,0,1,0
16,106,106,15,4,11,2,1
31,130,130,3,3,0,1,0
15,137,137,42,42,0,1,0
9,145,145,9,5,4,2,1
1,149,149,22,22,0,1,0
25,171,171,10,2,8,3,2
12,179,179,13,4,9,2,1
21,229,229,7,7,0,1,0
26,248,248,5,2,3,2,1
0,261,261,48,2,46,2,1
7,289,289,10,2,8,3,2
30,294,294,1,1,0,1,0
17,298,298,28,28,0,1,0
13,300,300,18,18,0,1,0
28,326,326,85,85,0,1,0
2,351,351,3,3,0,1,0
10,362,362,28,1,27,2,1
6,371,371,6,2,4,2,1
5,386,386,180,36,144,4,3
8,409,409,75,75,0,1,0
18,412,412,53,11,42,4,3
14,430,430,37,37,0,1,0
23,434,434,46,1,45,2,1
24,459,459,131,28,103,4,3
3,460,460,117,117,0,1,0
20,460,460,51,51,0,1,0
19,461,461,76,76,0,1,0
4,469,469,111,28,83,4,3
11,475,475,76,52,24,4,3
22,480,480,15,1,14,2,1
29,497,497,9,4,5,2,1

13,104,104,6,6,0,1,0
19,113,113,14,14,0,1,0
7,115,115,8,8,0,1,0
44,123,123,29,29,0,1,0
23,136,136,4,4,0,1,0
0,162,162,6,6,0,1,0
1,170,170,3,3,0,1,0
32,190,190,4,4,0,1,0
26,202,202,33,33,0,1,0
12,210,210,8,8,0,1,0
43,210,210,38,20,18,3,2
29,215,215,7,7,0,1,0
35,218,218,2,2,0,1,0
6,220,220,21,21,0,1,0
38,220,220,6,6,0,1,0
41,231,231,9,5,4,2,1
33,233,233,1,1,0,1,0
5,237,237,5,5,0,1,0
9,244,244,11,11,0,1,0
2,248,248,35,35,0,1,0
39,249,249,1,1,0,1,0
15,266,266,18,2,16,2,1
11,282,282,15,3,12,3,2
42,285,285,7,7,0,1,0
21,310,310,36,5,31,4,3
8,317,317,13,13,0,1,0
18,317,317,14,10,4,2,1
30,320,320,14,14,0,1,0
25,325,325,14,14,0,1,0
24,345,345,50,7,43,2,1
3,357,357,1,1,0,1,0
10,365,365,76,32,44,3,2
20,368,368,14,8,6,2,1
22,369,369,17,17,0,1,0
16,374,374,7,1,6,2,1
37,408,408,133,114,19,2,1
4,445,445,59,59,0,1,0
31,448,448,56,28,28,4,3
34,454,454,83,83,0,1,0
28,466,466,103,81,22,3,2
36,467,467,11,11,0,1,0
14,467,467,78,78,0,1,0
17,475,475,49,10,39,4,3
40,490,490,22,22,0,1,0
27,499,499,112,112,0,1,0

24,110,110,6,6,0,1,0
21,127,127,26,7,19,3,2
16,148,148,13,13,0,1,0
30,168,168,32,32,0,1,0
19,215,215,3,3,0,1,0
29,224,224,19,19,0,1,0
25,229,229,11,3,8,2,1
5,239,239,32,32,0,1,0
17,246,246,62,20,42,4,3
31,247,247,3,3,0,1,0
10,256,256,1,1,0,1,0
13,277,277,13,13,0,1,0
20,284,284,2,2,0,1,0
0,293,293,77,77,0,1,0
15,305,305,83,5,78,3,2
3,309,309,49,29,20,3,2
27,323,323,12,4,8,2,1
6,329,329,3,3,0,1,0
11,335,335,47,23,24,4,3
8,337,337,101,39,62,3,2
18,343,343,2,2,0,1,0
28,344,344,131,14,117,4,3
1,347,347,66,46,20,3,2
32,348,348,36,36,0,1,0
23,365,365,10,10,0,1,0
12,389,389,152,107,45,2,1
14,405,405,46,16,30,2,1
26,426,426,16,1,15,2,1
4,457,457,14,4,10,3,2
2,464,464,12,12,0,1,0
7,492,492,74,74,0,1,0
9,497,497,29,29,0,1,0
22,498,498,1,1,0,1,0

16,101,101,6,6,0,1,0
3,108,108,42,42,0,1,0
0,110,110,34,34,0,1,0
2,121,121,16,1,15,4,3
25,121,121,22,10,12,3,2
30,128,128,13,13,0,1,0
32,134,134,46,46,0,1,0
1,163,163,33,18,15,4,3
11,165,165,1,1,0,1,0
26,166,166,3,3,0,1,0
15,171,171,32,11,21,4,3
4,176,176,16,4,12,2,1
18,191,191,12,9,3,2,1
23,197,197,9,9,0,1,0
17,207,207,8,8,0,1,0
29,208,208,33,33,0,1,0
12,218,218,1,1,0,1,0
28,249,249,29,10,19,2,1
33,269,269,11,11,0,1,0
8,271,271,47,8,39,2,1
21,280,280,12,12,0,1,0
6,297,297,5,5,0,1,0
27,298,298,15,3,12,2,1
19,303,303,109,35,74,3,2
5,303,303,76,36,40,3,2
20,361,361,24,24,0,1,0
9,369,369,1,1,0,1,0
24,403,403,16,4,12,3,2
10,408,408,65,65,0,1,0
7,426,426,16,16,0,1,0
22,432,432,5,5,0,1,0
14,465,465,17,17,0,1,0
31,495,495,8,2,6,2,1
13,500,500,45,9,36,4,3

43,102,102,23,13,10,2,1
35,115,115,3,3,0,1,0
11,118,118,3,3,0,1,0
18,127,127,2,2,0,1,0
24,132,132,6,6,0,1,0
42,135,135,8,8,0,1,0
5,148,148,20,20,0,1,0
25,174,174,8,4,4,2,1
23,177,177,37,21,16,3,2
17,177,177,14,4,10,3,2
41,181,181,21,21,0,1,0
29,184,184,44,6,38,2,1
12,187,187,3,3,0,1,0
32,193,193,14,14,0,1,0
14,197,197,3,3,0,1,0
21,199,199,32,32,0,1,0
36,200,200,49,11,38,3,2
44,202,202,6,6,0,1,0
2,216,216,4,4,0,1,0
22,226,226,14,8,6,2,1
31,241,241,33,33,0,1,0
30,255,255,3,3,0,1,0
27,256,256,11,3,8,3,2
37,257,257,9,3,6,3,2
7,278,278,23,23,0,1,0
40,282,282,3,3,0,1,0
34,289,289,31,1,30,2,1
28,299,299,34,4,30,2,1
15,309,309,16,16,0,1,0
3,324,324,27,27,0,1,0
13,328,328,11,11,0,1,0
1,330,330,6,6,0,1,0
10,351,351,134,95,39,4,3
8,371,371,9,9,0,1,0
16,376,376,59,39,20,4,3
38,388,388,33,13,20,2,1
20,392,392,9,6,3,2,1
26,393,393,67,7,60,4,3
4,400,400,7,7,0,1,0
39,407,407,28,28,0,1,0
33,414,414,59,1,58,3,2
6,416,416,5,5,0,1,0
9,424,424,1,1,0,1,0
0,428,428,68,68,0,1,0
19,499,499,13,6,7,2,1

13,106,106,18,10,8,3,2
32,107,107,2,2,0,1,0
11,113,113,3,3,0,1,0
10,120,120,4,4,0,1,0
26,128,128,12,12,0,1,0
5,143,143,10,10,0,1,0
24,145,145,19,3,16,2,1
2,161,161,28,12,16,3,2
28,165,165,3,3,0,1,0
4,195,195,27,27,0,1,0
19,207,207,121,121,0,1,0
8,244,244,39,39,0,1,0
16,247,247,19,19,0,1,0
9,251,251,34,34,0,1,0
30,287,287,6,3,3,2,1
25,293,293,4,1,3,2,1
14,307,307,12,12,0,1,0
34,316,316,10,10,0,1,0
21,319,319,28,7,21,2,1
3,324,324,59,15,44,2,1
1,331,331,2,2,0,1,0
23,334,334,27,19,8,2,1
17,344,344,3,3,0,1,0
7,347,347,64,17,47,4,3
37,352,352,7,7,0,1,0
6,355,355,49,49,0,1,0
33,363,363,45,1,44,3,2
35,367,367,91,75,16,3,2
29,374,374,46,37,9,2,1
18,385,385,19,19,0,1,0
12,395,395,48,5,43,2,1
22,409,409,17,17,0,1,0
15,437,437,6,3,3,2,1
20,455,455,98,98,0,1,0
31,461,461,11,11,0,1,0
0,479,479,84,24,60,4,3
36,488,488,17,17,0,1,0
27,492,492,15,7,8,2,1

20,123,123,1,1,0,1,0
17,142,142,16,16,0,1,0
12,142,142,4,4,0,1,0
22,152,152,3,3,0,1,0
27,152,152,1,1,0,1,0
14,155,155,15,15,0,1,0
28,156,156,6,6,0,1,0
19,161,161,14,7,7,2,1
13,174,174,15,9,6,3,2
15,187,187,16,4,12,2,1
29,210,210,3,3,0,1,0
31,215,215,55,36,19,2,1
8,231,231,53,53,0,1,0
25,260,260,98,98,0,1,0
18,280,280,34,34,0,1,0
26,283,283,41,41,0,1,0
21,288,288,30,14,16,2,1
3,348,348,144,144,0,1,0
10,354,354,2,2,0,1,0
16,358,358,24,24,0,1,0
7,366,366,86,29,57,4,3
5,368,368,24,21,3,2,1
0,368,368,25,25,0,1,0
9,386,386,46,5,41,2,1
11,395,395,24,24,0,1,0
23,406,406,62,62,0,1,0
2,414,414,46,46,0,1,0
1,432,432,47,47,0,1,0
24,432,432,103,103,0,1,0
4,479,479,154,46,108,4,3
32,482,482,1,1,0,1,0
6,494,494,25,25,0,1,0
30,498,498,4,4,0,1,0

25,101,101,9,9,0,1,0
39,108,108,27,27,0,1,0
42,141,141,23,23,0,1,0
3,143,143,1,1,0,1,0
13,147,147,43,14,29,2,1
36,157,157,19,19,0,1,0
18,159,159,29,29,0,1,0
15,159,159,7,7,0,1,0
37,183,183,10,10,0,1,0
8,186,186,24,24,0,1,0
12,212,212,7,7,0,1,0
34,242,242,21,11,10,3,2
33,244,244,41,41,0,1,0
30,248,248,24,24,0,1,0
31,255,255,25,25,0,1,0
14,267,267,3,3,0,1,0
22,268,268,34,34,0,1,0
24,269,269,50,50,0,1,0
6,274,274,1,1,0,1,0
26,276,276,7,7,0,1,0
27,284,284,1,1,0,1,0
41,292,292,8,8,0,1,0
5,293,293,11,3,8,3,2
40,307,307,62,14,48,3,2
11,311,311,5,5,0,1,0
23,314,314,42,9,33,2,1
29,323,323,4,4,0,1,0
19,342,342,31,1,30,4,3
28,360,360,26,26,0,1,0
32,368,368,39,39,0,1,0
38,394,394,63,37,26,3,2
35,400,400,10,10,0,1,0
21,404,404,27,27,0,1,0
9,433,433,58,58,0,1,0
1,438,438,2,2,0,1,0
17,446,446,4,4,0,1,0
7,455,455,41,32,9,4,3
16,470,470,115,22,93,4,3
0,475,475,66,34,32,2,1
20,476,476,8,4,4,2,1
4,481,481,20,8,12,3,2
2,486,486,20,5,15,2,1
10,490,490,3,3,0,1,0

9,120,120,7,7,0,1,0
5,121,121,14,14,0,1,0
1,136,136,1,1,0,1,0
37,148,148,17,7,10,2,1
22,149,149,10,1,9,2,1
24,158,158,14,14,0,1,0
14,170,170,11,5,6,3,2
7,186,186,17,17,0,1,0
10,206,206,2,2,0,1,0
11,208,208,9,3,6,3,2
21,212,212,6,6,0,1,0
27,229,229,71,71,0,1,0
28,279,279,4,4,0,1,0
0,298,298,53,41,12,2,1
19,302,302,58,40,18,4,3
23,311,311,11,4,7,2,1
2,315,315,67,41,26,2,1
18,317,317,64,64,0,1,0
6,329,329,7,7,0,1,0
17,363,363,7,1,6,3,2
13,365,365,24,24,0,1,0
36,367,367,2,2,0,1,0
34,368,368,6,6,0,1,0
20,384,384,33,33,0,1,0
38,385,385,11,11,0,1,0
4,392,392,47,47,0,1,0
8,397,397,54,9,45,4,3
16,405,405,36,36,0,1,0
12,412,412,40,23,17,2,1
25,414,414,113,56,57,4,3
3,421,421,29,29,0,1,0
33,432,432,10,10,0,1,0
15,439,439,10,10,0,1,0
31,454,454,46,46,0,1,0
32,466,466,115,61,54,3,2
30,480,480,92,92,0,1,0
35,486,486,83,61,22,3,2
39,487,487,13,13,0,1,0
26,488,488,45,7,38,2,1
29,493,493,51,13,38,2,1

13,119,119,1,1,0,1,0
20,122,122,1,1,0,1,0
8,140,140,23,4,19,2,1
33,144,144,1,1,0,1,0
21,147,147,2,2,0,1,0
7,166,166,1,1,0,1,0
4,169,169,33,33,0,1,0
18,185,185,9,6,3,2,1
19,197,197,3,3,0,1,0
25,206,206,20,20,0,1,0
30,221,221,66,66,0,1,0
9,226,226,40,2,38,3,2
2,248,248,60,21,39,2,1
26,251,251,10,10,0,1,0
27,260,260,1,1,0,1,0
16,271,271,53,15,38,2,1
22,289,289,134,68,66,4,3
24,300,300,2,2,0,1,0
14,323,323,8,8,0,1,0
31,323,323,6,6,0,1,0
34,339,339,37,37,0,1,0
0,344,344,112,112,0,1,0
32,361,361,41,41,0,1,0
10,361,361,36,36,0,1,0
28,371,371,27,27,0,1,0
17,379,379,16,3,13,2,1
15,380,380,39,2,37,2,1
12,404,404,53,53,0,1,0
11,412,412,35,35,0,1,0
6,415,415,74,6,68,3,2
3,423,423,63,6,57,3,2
5,446,446,5,5,0,1,0
1,469,469,1,1,0,1,0
23,488,488,189,189,0,1,0
29,490,490,2,2,0,1,0

25,105,105,13,13,0,1,0
2,112,112,6,6,0,1,0
22,116,116,4,4,0,1,0
19,119,119,20,17,3,2,1
7,128,128,7,7,0,1,0
20,153,153,8,8,0,1,0
21,156,156,17,2,15,4,3
26,157,157,22,8,14,3,2
12,165,165,13,3,10,3,2
17,172,172,30,30,0,1,0
37,178,178,9,9,0,1,0
11,180,180,9,9,0,1,0
5,192,192,3,3,0,1,0
3,201,201,31,31,0,1,0
6,208,208,37,16,21,2,1
27,227,227,27,4,23,2,1
13,236,236,22,6,16,2,1
18,242,242,21,6,15,4,3
4,254,254,7,7,0,1,0
33,268,268,66,66,0,1,0
9,306,306,2,2,0,1,0
23,309,309,25,3,22,3,2
16,318,318,30,5,25,2,1
24,320,320,40,40,0,1,0
35,325,325,16,16,0,1,0
1,334,334,11,11,0,1,0
34,340,340,25,25,0,1,0
30,365,365,4,1,3,2,1
28,408,408,47,47,0,1,0
31,409,409,44,12,32,2,1
36,409,409,23,3,20,3,2
29,413,413,47,47,0,1,0
8,418,418,20,20,0,1,0
15,443,443,125,13,112,4,3
10,446,446,5,5,0,1,0
0,483,483,34,20,14,2,1
14,491,491,192,60,132,4,3
32,496,496,83,55,28,2,1

36,130,130,8,8,0,1,0
27,141,141,23,23,0,1,0
15,147,147,1,1,0,1,0
23,150,150,2,2,0,1,0
6,161,161,7,7,0,1,0
5,161,161,27,27,0,1,0
21,168,168,5,1,4,2,1
1,172,172,15,4,11,2,1
28,179,179,25,25,0,1,0
30,222,222,9,9,0,1,0
35,225,225,45,30,15,2,1
8,225,225,67,7,60,4,3
26,232,232,43,2,41,3,2
17,239,239,2,2,0,1,0
10,241,241,7,7,0,1,0
22,255,255,3,3,0,1,0
25,327,327,14,7,7,2,1
11,330,330,3,3,0,1,0
20,352,352,102,2,100,3,2
29,357,357,34,34,0,1,0
31,358,358,8,8,0,1,0
2,379,379,41,37,4,2,1
13,380,380,153,144,9,4,3
34,383,383,40,40,0,1,0
14,387,387,27,8,19,2,1
3,409,409,23,2,21,3,2
16,417,417,32,32,0,1,0
24,418,418,43,5,38,2,1
9,445,445,2,2,0,1,0
32,450,450,73,73,0,1,0
4,451,451,1,1,0,1,0
18,457,457,10,7,3,2,1
12,461,461,112,94,18,4,3
33,464,464,107,107,0,1,0
0,468,468,36,36,0,1,0
19,491,491,10,1,9,2,1
7,496,496,105,81,24,3,2

34,112,112,1,1,0,1,0
26,130,130,3,3,0,1,0
8,134,134,1,1,0,1,0
24,155,155,17,17,0,1,0
5,162,162,4,4,0,1,0
19,174,174,22,4,18,3,2
27,201,201,23,7,16,4,3
15,208,208,68,34,34,3,2
28,211,211,8,8,0,1,0
18,260,260,24,24,0,1,0
32,268,268,15,1,14,2,1
22,278,278,24,24,0,1,0
0,305,305,55,34,21,2,1
1,312,312,100,79,21,4,3
6,323,323,8,8,0,1,0
2,333,333,1,1,0,1,0
16,342,342,121,121,0,1,0
33,347,347,23,4,19,2,1
9,350,350,9,9,0,1,0
14,355,355,33,33,0,1,0
31,357,357,44,44,0,1,0
12,370,370,26,26,0,1,0
17,378,378,76,19,57,4,3
3,400,400,2,2,0,1,0
13,412,412,146,131,15,2,1
20,416,416,49,49,0,1,0
29,419,419,58,51,7,2,1
7,457,457,42,30,12,2,1
4,459,459,52,13,39,4,3
21,468,468,1,1,0,1,0
10,471,471,72,72,0,1,0
30,484,484,19,19,0,1,0
25,486,486,100,61,39,2,1
11,487,487,52,52,0,1,0
23,500,500,17,17,0,1,0

14,115,115,12,1,11,4,3
9,119,119,2,2,0,1,0
12,167,167,1,1,0,1,0
23,167,167,15,15,0,1,0
13,172,172,9,9,0,1,0
32,178,178,2,2,0,1,0
20,191,191,8,8,0,1,0
22,221,221,13,13,0,1,0
18,222,222,15,5,10,2,1
34,230,230,30,30,0,1,0
2,258,258,123,78,45,4,3
24,262,262,38,16,22,2,1
11,263,263,8,3,5,2,1
30,270,270,48,48,0,1,0
10,274,274,76,32,44,2,1
3,305,305,5,1,4,2,1
16,311,311,13,13,0,1,0
31,313,313,1,1,0,1,0
27,329,329,43,43,0,1,0
4,335,335,127,115,12,4,3
15,339,339,9,9,0,1,0
6,349,349,34,7,27,2,1
29,360,360,78,65,13,2,1
8,362,362,29,29,0,1,0
33,382,382,34,34,0,1,0
7,387,387,56,14,42,3,2
19,394,394,19,19,0,1,0
28,402,402,94,14,80,3,2
5,407,407,22,22,0,1,0
1,424,424,52,52,0,1,0
25,457,457,30,12,18,3,2
26,468,468,51,42,9,4,3
21,491,491,72,72,0,1,0
0,492,492,8,8,0,1,0
17,500,500,56,35,21,4,3

22,123,123,41,13,28,3,2
3,125,125,7,7,0,1,0
23,128,128,6,6,0,1,0
18,137,137,18,18,0,1,0
13,155,155,1,1,0,1,0
4,159,159,8,8,0,1,0
14,204,204,19,19,0,1,0
9,208,208,1,1,0,1,0
25,222,222,33,33,0,1,0
36,227,227,14,14,0,1,0
21,247,247,16,16,0,1,0
17,275,275,11,3,8,3,2
6,277,277,3,3,0,1,0
30,289,289,11,7,4,2,1
12,291,291,5,2,3,2,1
28,293,293,3,3,0,1,0
33,299,299,6,6,0,1,0
38,312,312,42,10,32,3,2
20,321,321,29,29,0,1,0
11,331,331,165,66,99,4,3
24,337,337,9,5,4,2,1
35,337,337,25,3,22,3,2
7,347,347,8,5,3,2,1
26,354,354,18,18,0,1,0
0,389,389,4,4,0,1,0
34,408,408,68,36,32,3,2
32,428,428,85,75,10,3,2
31,429,429,24,17,7,2,1
8,430,430,11,11,0,1,0
16,435,435,154,90,64,4,3
5,443,443,108,62,46,3,2
15,453,453,9,9,0,1,0
10,471,471,57,57,0,1,0
1,474,474,9,9,0,1,0
29,485,485,27,27,0,1,0
19,486,486,25,25,0,1,0
27,498,498,10,4,6,3,2
37,500,500,167,62,105,4,3
2,500,500,62,40,22,4,3

12,101,101,3,3,0,1,0
25,118,118,33,10,23,2,1
27,136,136,6,6,0,1,0
14,144,144,3,3,0,1,0
28,169,169,5,5,0,1,0
11,177,177,1,1,0,1,0
26,183,183,28,8,20,2,1
9,196,196,10,10,0,1,0
29,209,209,19,19,0,1,0
20,214,214,2,2,0,1,0
2,233,233,30,30,0,1,0
10,242,242,16,16,0,1,0
21,245,245,19,5,14,2,1
0,246,246,71,50,21,4,3
3,256,256,40,40,0,1,0
4,280,280,23,11,12,4,3
1,304,304,6,6,0,1,0
22,305,305,49,16,33,2,1
23,316,316,47,43,4,2,1
16,323,323,15,15,0,1,0
24,325,325,17,17,0,1,0
18,326,326,8,8,0,1,0
8,328,328,58,17,41,2,1
19,329,329,75,45,30,4,3
6,344,344,10,10,0,1,0
7,360,360,76,36,40,2,1
30,363,363,103,5,98,4,3
33,367,367,7,7,0,1,0
32,376,376,66,66,0,1,0
31,456,456,2,2,0,1,0
13,469,469,281,272,9,4,3
5,472,472,19,4,15,2,1
15,486,486,11,1,10,4,3
17,491,491,45,22,23,2,1

13,106,106,5,5,0,1,0
9,107,107,19,4,15,4,3
1,118,118,1,1,0,1,0
21,127,127,3,3,0,1,0
15,133,133,24,24,0,1,0
41,170,170,12,4,8,3,2
31,183,183,11,6,5,2,1
5,205,205,29,22,7,2,1
20,205,205,1,1,0,1,0
17,206,206,44,44,0,1,0
30,208,208,5,5,0,1,0
38,210,210,7,1,6,3,2
22,214,214,43,43,0,1,0
8,248,248,7,7,0,1,0
32,257,257,21,21,0,1,0
29,273,273,10,2,8,3,2
33,274,274,42,42,0,1,0
25,281,281,35,18,17,2,1
18,287,287,39,21,18,4,3
19,289,289,22,6,16,2,1
14,299,299,14,14,0,1,0
4,361,361,15,8,7,2,1
16,363,363,19,19,0,1,0
39,365,365,26,19,7,2,1
27,384,384,30,30,0,1,0
36,385,385,41,17,24,4,3
37,387,387,1,1,0,1,0
12,387,387,22,22,0,1,0
24,390,390,37,37,0,1,0
23,396,396,12,3,9,4,3
6,397,397,1,1,0,1,0
2,406,406,8,8,0,1,0
35,407,407,245,227,18,4,3
28,418,418,3,3,0,1,0
3,419,419,78,42,36,4,3
26,430,430,111,88,23,2,1
11,432,432,43,8,35,2,1
40,441,441,12,12,0,1,0
7,460,460,27,27,0,1,0
10,462,462,40,40,0,1,0
0,469,469,6,6,0,1,0
34,500,500,37,37,0,1,0

30,106,106,13,13,0,1,0
25,110,110,22,22,0,1,0
1,113,113,9,9,0,1,0
24,139,139,24,14,10,2,1
20,140,140,24,14,10,2,1
14,146,146,42,42,0,1,0
26,178,178,23,1,22,4,3
16,186,186,25,25,0,1,0
23,197,197,40,40,0,1,0
3,198,198,4,4,0,1,0
6,200,200,10,5,5,2,1
13,202,202,19,19,0,1,0
27,207,207,23,23,0,1,0
31,213,213,9,9,0,1,0
7,226,226,79,79,0,1,0
9,230,230,13,4,9,2,1
22,238,238,12,6,6,3,2
2,257,257,34,22,12,2,1
8,260,260,9,3,6,2,1
15,329,329,44,32,12,3,2
21,333,333,3,3,0,1,0
17,363,363,9,9,0,1,0
28,381,381,6,6,0,1,0
5,399,399,52,11,41,2,1
11,402,402,42,20,22,3,2
33,402,402,9,9,0,1,0
0,419,419,53,53,0,1,0
18,430,430,51,19,32,4,3
34,432,432,27,13,14,2,1
29,433,433,52,6,46,4,3
10,438,438,26,26,0,1,0
32,449,449,10,10,0,1,0
4,456,456,87,19,68,3,2
12,470,470,25,25,0,1,0
19,500,500,108,9,99,4,3

10,116,116,4,4,0,1,0
29,118,118,15,15,0,1,0
23,121,121,5,5,0,1,0
16,122,122,9,9,0,1,0
13,125,125,3,3,0,1,0
31,126,126,27,27,0,1,0
22,133,133,19,19,0,1,0
25,154,154,17,17,0,1,0
21,166,166,13,13,0,1,0
14,188,188,3,3,0,1,0
35,194,194,6,2,4,2,1
0,199,199,29,11,18,3,2
2,199,199,10,10,0,1,0
34,212,212,32,17,15,4,3
36,235,235,1,1,0,1,0
8,264,264,115,115,0,1,0
3,270,270,15,5,10,3,2
20,277,277,84,9,75,4,3
17,309,309,38,10,28,2,1
1,317,317,4,4,0,1,0
9,336,336,2,2,0,1,0
33,347,347,5,2,3,2,1
32,372,372,52,52,0,1,0
12,375,375,14,14,0,1,0
15,376,376,32,4,28,3,2
26,386,386,90,68,22,3,2
18,402,402,1,1,0,1,0
4,406,406,21,21,0,1,0
30,415,415,40,40,0,1,0
28,416,416,1,1,0,1,0
11,420,420,120,12,108,4,3
27,431,431,1,1,0,1,0
24,435,435,103,103,0,1,0
7,469,469,156,60,96,4,3
19,474,474,6,6,0,1,0
5,475,475,5,1,4,2,1
6,487,487,59,25,34,2,1

37,112,112,6,2,4,2,1
29,121,121,17,17,0,1,0
18,125,125,35,35,0,1,0
4,128,128,23,3,20,3,2
19,136,136,14,14,0,1,0
36,148,148,14,14,0,1,0
7,168,168,4,4,0,1,0
33,177,177,11,11,0,1,0
20,179,179,1,1,0,1,0
23,185,185,5,5,0,1,0
15,188,188,1,1,0,1,0
14,190,190,10,5,5,2,1
3,192,192,10,10,0,1,0
34,201,201,70,29,41,2,1
9,225,225,12,5,7,3,2
8,229,229,10,10,0,1,0
22,243,243,23,23,0,1,0
24,244,244,18,18,0,1,0
31,246,246,2,2,0,1,0
25,249,249,10,10,0,1,0
16,257,257,7,7,0,1,0
17,259,259,17,17,0,1,0
32,266,266,16,3,13,2,1
26,283,283,133,43,90,3,2
21,288,288,2,2,0,1,0
35,333,333,56,56,0,1,0
2,351,351,16,1,15,2,1
12,378,378,25,8,17,2,1
10,390,390,27,5,22,2,1
0,391,391,18,8,10,2,1
5,411,411,62,35,27,2,1
13,422,422,143,93,50,4,3
1,432,432,19,3,16,2,1
30,464,464,53,17,36,2,1
28,467,467,10,10,0,1,0
27,479,479,23,18,5,2,1
11,489,489,50,26,24,4,3
6,495,495,129,108,21,2,1

38,115,115,6,6,0,1,0
19,123,123,6,6,0,1,0
21,124,124,1,1,0,1,0
16,132,132,18,18,0,1,0
26,142,142,54,54,0,1,0
29,146,146,16,11,5,2,1
41,155,155,11,11,0,1,0
6,188,188,32,29,3,2,1
35,217,217,7,7,0,1,0
24,221,221,1,1,0,1,0
2,240,240,5,2,3,2,1
1,271,271,11,5,6,3,2
18,275,275,14,14,0,1,0
31,285,285,15,15,0,1,0
3,286,286,21,3,18,3,2
7,288,288,13,13,0,1,0
20,301,301,4,4,0,1,0
40,309,309,36,36,0,1,0
8,311,311,27,12,15,2,1
17,312,312,68,68,0,1,0
39,325,325,54,54,0,1,0
28,326,326,6,6,0,1,0
10,331,331,16,16,0,1,0
42,336,336,2,2,0,1,0
12,341,341,4,4,0,1,0
14,344,344,15,15,0,1,0
5,348,348,49,49,0,1,0
23,354,354,31,26,5,2,1
25,356,356,62,62,0,1,0
32,361,361,23,7,16,2,1
11,375,375,64,64,0,1,0
0,376,376,2,2,0,1,0
27,378,378,6,6,0,1,0
30,383,383,67,67,0,1,0
13,388,388,24,24,0,1,0
22,410,410,11,11,0,1,0
4,411,411,27,5,22,2,1
34,413,413,25,5,20,2,1
9,417,417,134,85,49,4,3
33,428,428,58,9,49,3,2
37,457,457,103,41,62,3,2
36,462,462,38,2,36,3,2
15,479,479,2,2,0,1,0

39,123,123,9,3,6,2,1
20,142,142,24,15,9,2,1
0,145,145,13,13,0,1,0
2,151,151,3,3,0,1,0
10,155,155,27,5,22,2,1
34,160,160,2,2,0,1,0
12,172,172,1,1,0,1,0
25,180,180,19,1,18,4,3
17,194,194,4,4,0,1,0
29,194,194,67,33,34,2,1
5,197,197,11,11,0,1,0
6,201,201,4,4,0,1,0
35,220,220,28,10,18,4,3
14,222,222,45,45,0,1,0
38,222,222,4,4,0,1,0
30,227,227,2,2,0,1,0
31,231,231,14,14,0,1,0
11,240,240,42,42,0,1,0
36,242,242,6,6,0,1,0
27,273,273,2,2,0,1,0
21,294,294,23,23,0,1,0
7,294,294,5,5,0,1,0
42,306,306,42,42,0,1,0
41,314,314,19,11,8,3,2
32,316,316,90,90,0,1,0
24,343,343,20,4,16,2,1
3,346,346,52,13,39,4,3
13,348,348,17,17,0,1,0
8,353,353,58,22,36,3,2
1,355,355,32,5,27,4,3
22,355,355,5,1,4,2,1
4,357,357,48,48,0,1,0
9,365,365,34,28,6,3,2
37,372,372,64,64,0,1,0
28,396,396,19,19,0,1,0
15,408,408,26,26,0,1,0
26,421,421,24,12,12,3,2
16,424,424,18,18,0,1,0
40,425,425,28,6,22,3,2
23,443,443,6,6,0,1,0
33,446,446,118,5,113,4,3
19,464,464,16,16,0,1,0
18,479,479,11,3,8,2,1

8,106,106,8,8,0,1,0
18,113,113,3,3,0,1,0
22,126,126,19,19,0,1,0
10,155,155,11,11,0,1,0
12,162,162,33,33,0,1,0
26,165,165,41,41,0,1,0
11,168,168,31,14,17,2,1
5,188,188,18,3,15,4,3
33,190,190,1,1,0,1,0
20,195,195,10,10,0,1,0
24,211,211,1,1,0,1,0
16,217,217,2,2,0,1,0
17,227,227,39,28,11,4,3
30,227,227,38,38,0,1,0
21,228,228,25,25,0,1,0
31,237,237,7,3,4,2,1
6,250,250,69,39,30,4,3
35,268,268,13,13,0,1,0
25,299,299,53,14,39,2,1
13,300,300,7,7,0,1,0
32,308,308,11,5,6,3,2
2,309,309,12,12,0,1,0
29,313,313,23,2,21,2,1
4,343,343,5,5,0,1,0
27,348,348,16,4,12,4,3
3,355,355,70,70,0,1,0
7,356,356,53,13,40,2,1
23,366,366,116,8,108,4,3
14,371,371,13,3,10,3,2
9,376,376,25,7,18,4,3
15,386,386,23,2,21,2,1
19,399,399,43,43,0,1,0
28,404,404,52,3,49,2,1
34,430,430,17,17,0,1,0
1,490,490,37,1,36,2,1
0,494,494,161,107,54,3,2

28,101,101,17,17,0,1,0
5,136,136,18,3,15,4,3
37,146,146,9,9,0,1,0
4,154,154,1,1,0,1,0
15,168,168,9,9,0,1,0
39,171,171,3,3,0,1,0
30,178,178,26,4,22,3,2
19,178,178,4,4,0,1,0
3,195,195,6,6,0,1,0
9,197,197,17,17,0,1,0
16,201,201,22,4,18,4,3
38,224,224,21,21,0,1,0
13,224,224,4,4,0,1,0
7,237,237,10,10,0,1,0
34,241,241,89,70,19,3,2
2,245,245,5,5,0,1,0
26,249,249,27,9,18,2,1
31,252,252,46,46,0,1,0
14,253,253,6,1,5,2,1
8,260,260,6,3,3,2,1
11,301,301,1,1,0,1,0
17,322,322,38,38,0,1,0
12,343,343,2,2,0,1,0
35,343,343,36,36,0,1,0
23,344,344,101,32,69,4,3
21,355,355,35,35,0,1,0
1,386,386,27,1,26,3,2
33,397,397,22,22,0,1,0
0,401,401,19,19,0,1,0
6,401,401,63,63,0,1,0
29,401,401,16,16,0,1,0
10,406,406,27,4,23,3,2
24,410,410,17,1,16,4,3
25,411,411,28,28,0,1,0
36,415,415,87,50,37,4,3
27,420,420,23,18,5,2,1
32,422,422,7,7,0,1,0
18,428,428,40,19,21,4,3
22,433,433,145,145,0,1,0
20,446,446,20,3,17,2,1
41,472,472,4,4,0,1,0
42,484,484,67,67,0,1,0
40,500,500,25,14,11,2,1

4,142,142,11,5,6,2,1
7,158,158,1,1,0,1,0
12,158,158,2,2,0,1,0
8,175,175,40,28,12,4,3
18,180,180,5,5,0,1,0
23,185,185,25,25,0,1,0
22,191,191,12,5,7,2,1
28,201,201,39,5,34,2,1
25,248,248,6,1,5,2,1
16,259,259,17,14,3,2,1
21,264,264,31,31,0,1,0
20,298,298,67,67,0,1,0
32,318,318,38,5,33,4,3
26,328,328,79,29,50,3,2
17,337,337,2,2,0,1,0
14,337,337,19,11,8,2,1
9,340,340,70,70,0,1,0
24,348,348,3,3,0,1,0
2,350,350,32,15,17,2,1
35,353,353,41,41,0,1,0
31,358,358,2,2,0,1,0
10,359,359,12,12,0,1,0
39,387,387,19,19,0,1,0
1,387,387,21,6,15,4,3
3,399,399,52,52,0,1,0
34,410,410,64,32,32,4,3
29,414,414,71,71,0,1,0
38,421,421,15,7,8,3,2
27,429,429,73,73,0,1,0
5,431,431,23,23,0,1,0
36,453,453,22,13,9,4,3
37,457,457,22,22,0,1,0
15,461,461,92,50,42,2,1
30,461,461,74,32,42,2,1
6,464,464,28,28,0,1,0
33,468,468,29,17,12,2,1
0,469,469,13,7,6,2,1
19,475,475,42,42,0,1,0
11,479,479,43,20,23,4,3
13,496,496,80,80,0,1,0

5,100,100,10,3,7,2,1
27,111,111,4,4,0,1,0
1,167,167,11,2,9,2,1
24,170,170,3,3,0,1,0
17,181,181,10,5,5,2,1
14,194,194,28,1,27,3,2
31,218,218,28,28,0,1,0
30,224,224,5,5,0,1,0
12,235,235,25,25,0,1,0
16,241,241,21,1,20,4,3
20,264,264,13,13,0,1,0
23,265,265,15,2,13,2,1
29,267,267,37,37,0,1,0
13,269,269,104,91,13,4,3
34,281,281,2,2,0,1,0
6,281,281,40,16,24,2,1
21,293,293,47,47,0,1,0
9,298,298,29,2,27,2,1
18,298,298,10,10,0,1,0
7,328,328,33,33,0,1,0
32,331,331,42,8,34,2,1
19,332,332,211,139,72,3,2
11,338,338,14,14,0,1,0
25,345,345,7,1,6,2,1
22,346,346,72,72,0,1,0
10,347,347,28,28,0,1,0
15,359,359,60,48,12,3,2
8,370,370,64,37,27,2,1
3,387,387,3,3,0,1,0
33,396,396,18,18,0,1,0
0,401,401,29,29,0,1,0
28,420,420,2,2,0,1,0
2,422,422,31,31,0,1,0
4,454,454,64,61,3,2,1
26,492,492,56,56,0,1,0

29,100,100,12,6,6,2,1
4,133,133,11,11,0,1,0
37,159,159,3,3,0,1,0
31,170,170,3,3,0,1,0
1,183,183,55,30,25,2,1
10,187,187,12,12,0,1,0
12,210,210,36,36,0,1,0
14,213,213,51,51,0,1,0
33,220,220,17,3,14,2,1
19,221,221,7,7,0,1,0
8,225,225,3,3,0,1,0
2,226,226,7,7,0,1,0
7,231,231,30,18,12,2,1
17,237,237,14,14,0,1,0
39,249,249,36,8,28,3,2
36,256,256,9,3,6,3,2
9,267,267,5,5,0,1,0
0,281,281,38,38,0,1,0
26,292,292,6,3,3,2,1
24,296,296,20,20,0,1,0
3,300,300,15,15,0,1,0
13,306,306,49,49,0,1,0
15,307,307,5,2,3,2,1
11,323,323,1,1,0,1,0
32,338,338,57,57,0,1,0
28,341,341,33,15,18,4,3
40,341,341,7,7,0,1,0
23,346,346,1,1,0,1,0
25,350,350,22,4,18,2,1
27,362,362,26,9,17,2,1
16,377,377,18,18,0,1,0
34,394,394,45,45,0,1,0
20,412,412,83,83,0,1,0
21,423,423,12,3,9,4,3
41,430,430,192,115,77,4,3
35,432,432,146,146,0,1,0
6,435,435,7,7,0,1,0
18,436,436,21,21,0,1,0
5,456,456,13,13,0,1,0
30,471,471,44,12,32,3,2
22,471,471,11,2,9,4,3
38,475,475,9,3,6,2,1

0,126,126,3,3,0,1,0
3,143,143,1,1,0,1,0
29,148,148,4,4,0,1,0
21,156,156,11,11,0,1,0
27,161,161,22,22,0,1,0
14,167,167,2,2,0,1,0
6,171,171,21,21,0,1,0
15,201,201,11,4,7,2,1
20,213,213,8,2,6,3,2
23,221,221,8,2,6,2,1
5,221,221,44,44,0,1,0
1,232,232,17,7,10,2,1
24,246,246,63,63,0,1,0
35,275,275,1,1,0,1,0
31,318,318,51,30,21,2,1
13,323,323,40,40,0,1,0
17,327,327,37,30,7,2,1
2,348,348,37,37,0,1,0
4,356,356,82,3,79,4,3
12,356,356,52,52,0,1,0
10,360,360,33,33,0,1,0
28,360,360,70,55,15,4,3
25,367,367,61,16,45,4,3
30,377,377,22,1,21,4,3
8,392,392,48,41,7,2,1
32,408,408,5,1,4,2,1
9,410,410,31,31,0,1,0
36,437,437,5,5,0,1,0
18,447,447,8,3,5,2,1
11,454,454,94,64,30,3,2
16,462,462,62,38,24,3,2
22,463,463,46,46,0,1,0
34,467,467,48,48,0,1,0
33,470,470,37,37,0,1,0
7,486,486,19,2,17,2,1
19,494,494,8,8,0,1,0
26,497,497,155,99,56,3,2
37,497,497,80,8,72,3,2

9,116,116,8,8,0,1,0
28,147,147,4,1,3,2,1
27,153,153,6,1,5,2,1
16,190,190,7,7,0,1,0
29,197,197,10,10,0,1,0
1,205,205,20,6,14,3,2
18,206,206,92,92,0,1,0
30,215,215,31,31,0,1,0
34,246,246,5,5,0,1,0
12,253,253,29,21,8,3,2
15,273,273,13,13,0,1,0
17,273,273,49,4,45,4,3
3,274,274,17,1,16,4,3
31,282,282,39,31,8,2,1
21,287,287,26,11,15,4,3
37,302,302,25,13,12,3,2
33,313,313,12,6,6,3,2
4,319,319,10,10,0,1,0
26,321,321,34,7,27,4,3
24,343,343,2,2,0,1,0
23,350,350,74,74,0,1,0
36,372,372,32,32,0,1,0
8,387,387,23,2,21,4,3
14,388,388,8,8,0,1,0
20,389,389,35,9,26,3,2
39,394,394,15,15,0,1,0
38,408,408,70,40,30,4,3
2,408,408,34,34,0,1,0
25,411,411,23,23,0,1,0
7,424,424,47,47,0,1,0
19,431,431,55,10,45,4,3
5,460,460,65,17,48,4,3
22,461,461,243,105,138,4,3
32,466,466,2,2,0,1,0
35,470,470,49,9,40,3,2
0,479,479,24,24,0,1,0
6,484,484,11,11,0,1,0
10,491,491,41,29,12,3,2
11,494,494,3,3,0,1,0
13,497,497,10,10,0,1,0

14,107,107,9,9,0,1,0
25,115,115,4,1,3,2,1
32,116,116,8,8,0,1,0
10,162,162,21,21,0,1,0
30,192,192,24,24,0,1,0
26,205,205,81,31,50,3,2
19,212,212,61,25,36,3,2
12,214,214,5,5,0,1,0
1,217,217,9,3,6,3,2
11,232,232,13,13,0,1,0
9,248,248,21,21,0,1,0
17,250,250,11,11,0,1,0
22,264,264,13,7,6,3,2
4,266,266,16,16,0,1,0
5,288,288,1,1,0,1,0
20,301,301,13,13,0,1,0
6,303,303,12,12,0,1,0
36,308,308,31,31,0,1,0
15,322,322,60,60,0,1,0
13,332,332,49,24,25,2,1
34,343,343,43,43,0,1,0
16,345,345,14,14,0,1,0
28,360,360,19,19,0,1,0
18,384,384,53,23,30,4,3
3,399,399,204,81,123,4,3
37,409,409,5,5,0,1,0
27,420,420,46,6,40,3,2
23,421,421,21,21,0,1,0
0,427,427,50,50,0,1,0
8,428,428,21,21,0,1,0
33,438,438,2,2,0,1,0
24,449,449,10,7,3,2,1
7,450,450,42,1,41,2,1
21,465,465,25,25,0,1,0
2,471,471,24,4,20,3,2
29,491,491,26,6,20,3,2
35,492,492,97,20,77,4,3
31,496,496,76,4,72,4,3

35,102,102,12,12,0,1,0
16,120,120,6,6,0,1,0
32,124,124,7,7,0,1,0
2,124,124,19,1,18,3,2
10,136,136,9,6,3,2,1
17,155,155,2,2,0,1,0
15,168,168,3,3,0,1,0
4,178,178,16,16,0,1,0
31,218,218,5,1,4,2,1
1,226,226,17,17,0,1,0
19,237,237,12,8,4,2,1
8,237,237,37,37,0,1,0
9,309,309,5,5,0,1,0
27,315,315,21,21,0,1,0
29,322,322,71,32,39,2,1
38,330,330,17,17,0,1,0
0,336,336,44,9,35,2,1
21,339,339,11,3,8,2,1
33,340,340,12,2,10,3,2
36,347,347,70,34,36,4,3
24,348,348,1,1,0,1,0
25,372,372,35,4,31,2,1
14,377,377,85,1,84,4,3
5,382,382,54,54,0,1,0
30,384,384,8,8,0,1,0
13,391,391,101,2,99,4,3
11,395,395,24,24,0,1,0
28,414,414,28,28,0,1,0
20,433,433,167,68,99,4,3
34,441,441,9,9,0,1,0
37,453,453,73,20,53,3,2
3,460,460,89,2,87,4,3
26,469,469,118,49,69,4,3
12,471,471,31,31,0,1,0
18,477,477,28,9,19,2,1
6,478,478,22,4,18,2,1
23,484,484,31,5,26,3,2
7,484,484,17,17,0,1,0
22,485,485,34,34,0,1,0

12,101,101,3,3,0,1,0
5,109,109,2,2,0,1,0
33,110,110,9,3,6,3,2
8,114,114,8,8,0,1,0
27,114,114,21,21,0,1,0
19,119,119,3,3,0,1,0
7,124,124,5,1,4,2,1
15,127,127,21,9,12,4,3
20,127,127,1,1,0,1,0
28,128,128,2,2,0,1,0
3,137,137,9,9,0,1,0
21,144,144,12,12,0,1,0
30,173,173,1,1,0,1,0
9,185,185,1,1,0,1,0
34,200,200,18,14,4,2,1
36,222,222,31,5,26,3,2
13,224,224,34,21,13,2,1
40,235,235,26,26,0,1,0
0,258,258,2,2,0,1,0
4,271,271,17,8,9,2,1
1,295,295,1,1,0,1,0
32,303,303,16,16,0,1,0
16,305,305,7,7,0,1,0
25,308,308,54,54,0,1,0
18,310,310,13,13,0,1,0
6,336,336,3,3,0,1,0
31,339,339,110,110,0,1,0
17,341,341,7,7,0,1,0
37,349,349,5,5,0,1,0
23,349,349,50,50,0,1,0
24,358,358,30,30,0,1,0
14,375,375,24,9,15,4,3
41,376,376,36,18,18,3,2
22,386,386,63,33,30,3,2
10,397,397,81,60,21,4,3
29,400,400,16,8,8,3,2
26,400,400,3,3,0,1,0
39,413,413,96,6,90,4,3
2,447,447,43,43,0,1,0
11,462,462,251,167,84,4,3
35,472,472,54,9,45,2,1
38,496,496,12,3,9,2,1

22,104,104,2,2,0,1,0
0,106,106,1,1,0,1,0
2,109,109,3,3,0,1,0
39,112,112,1,1,0,1,0
16,114,114,1,1,0,1,0
40,128,128,7,7,0,1,0
37,150,150,11,11,0,1,0
9,156,156,16,16,0,1,0
24,169,169,25,7,18,3,2
42,185,185,31,1,30,4,3
29,191,191,5,2,3,2,1
13,206,206,41,13,28,2,1
7,210,210,23,23,0,1,0
19,215,215,7,3,4,2,1
20,232,232,31,31,0,1,0
30,234,234,15,1,14,3,2
23,247,247,36,18,18,4,3
26,249,249,53,47,6,2,1
4,269,269,55,17,38,2,1
11,271,271,58,36,22,3,2
41,271,271,7,7,0,1,0
17,274,274,5,5,0,1,0
36,293,293,127,58,69,3,2
8,333,333,97,9,88,3,2
31,336,336,9,4,5,2,1
33,340,340,10,4,6,3,2
15,349,349,3,3,0,1,0
28,384,384,9,9,0,1,0
6,425,425,2,2,0,1,0
34,428,428,57,57,0,1,0
3,430,430,2,2,0,1,0
25,435,435,113,71,42,3,2
1,437,437,34,34,0,1,0
12,438,438,5,5,0,1,0
32,438,438,29,29,0,1,0
21,444,444,14,1,13,2,1
35,474,474,1,1,0,1,0
27,475,475,85,21,64,3,2
38,476,476,2,2,0,1,0
14,483,483,12,3,9,4,3
10,486,486,1,1,0,1,0
18,497,497,48,26,22,3,2
5,499,499,61,12,49,3,2

9,102,102,7,7,0,1,0
11,110,110,3,3,0,1,0
25,110,110,10,10,0,1,0
14,111,111,20,5,15,4,3
17,125,125,13,13,0,1,0
19,139,139,7,1,6,2,1
6,148,148,1,1,0,1,0
30,158,158,25,15,10,2,1
4,161,161,10,10,0,1,0
16,166,166,14,14,0,1,0
3,185,185,62,62,0,1,0
28,199,199,28,4,24,2,1
8,199,199,10,7,3,2,1
32,225,225,64,64,0,1,0
7,230,230,10,2,8,2,1
31,233,233,51,51,0,1,0
23,279,279,18,7,11,2,1
0,301,301,32,32,0,1,0
34,313,313,26,8,18,2,1
21,325,325,60,60,0,1,0
27,329,329,1,1,0,1,0
13,336,336,76,1,75,4,3
36,338,338,21,6,15,4,3
5,346,346,20,20,0,1,0
29,350,350,139,87,52,3,2
22,351,351,2,2,0,1,0
37,380,380,34,34,0,1,0
35,381,381,2,2,0,1,0
10,389,389,18,3,15,4,3
12,400,400,5,5,0,1,0
1,413,413,64,64,0,1,0
18,435,435,50,50,0,1,0
33,445,445,8,3,5,2,1
24,448,448,3,3,0,1,0
15,449,449,87,87,0,1,0
26,454,454,28,2,26,3,2
20,481,481,9,9,0,1,0
2,488,488,13,13,0,1,0

2,102,102,15,4,11,3,2
9,119,119,4,4,0,1,0
6,147,147,17,9,8,2,1
8,159,159,12,12,0,1,0
7,163,163,11,11,0,1,0
19,163,163,3,3,0,1,0
16,165,165,33,27,6,3,2
3,169,169,47,47,0,1,0
24,173,173,9,5,4,2,1
15,180,180,7,7,0,1,0
0,188,188,1,1,0,1,0
22,189,189,6,2,4,2,1
31,233,233,29,29,0,1,0
5,240,240,29,8,21,2,1
1,243,243,34,12,22,2,1
33,254,254,8,2,6,3,2
32,288,288,12,4,8,2,1
13,291,291,88,88,0,1,0
29,323,323,99,5,94,3,2
12,325,325,121,109,12,2,1
23,330,330,60,60,0,1,0
20,344,344,5,5,0,1,0
10,350,350,8,4,4,2,1
28,352,352,33,33,0,1,0
17,365,365,10,10,0,1,0
26,365,365,9,9,0,1,0
25,368,368,49,49,0,1,0
14,383,383,28,18,10,2,1
4,385,385,49,49,0,1,0
18,414,414,7,2,5,2,1
27,428,428,59,59,0,1,0
21,431,431,142,112,30,3,2
11,440,440,9,9,0,1,0
30,487,487,67,53,14,3,2

33,106,106,15,15,0,1,0
2,107,107,6,6,0,1,0
21,161,161,23,23,0,1,0
1,189,189,32,21,11,3,2
14,193,193,5,5,0,1,0
15,199,199,25,1,24,3,2
9,200,200,13,5,8,3,2
20,221,221,37,37,0,1,0
26,229,229,23,2,21,2,1
8,250,250,24,3,21,2,1
29,250,250,57,57,0,1,0
34,253,253,12,12,0,1,0
5,280,280,64,64,0,1,0
12,282,282,34,22,12,4,3
25,289,289,44,44,0,1,0
7,302,302,14,6,8,2,1
31,304,304,22,11,11,2,1
16,312,312,33,3,30,2,1
11,323,323,10,10,0,1,0
22,328,328,22,22,0,1,0
6,352,352,47,47,0,1,0
30,363,363,6,2,4,2,1
19,376,376,3,3,0,1,0
0,376,376,23,5,18,3,2
3,385,385,49,49,0,1,0
17,388,388,2,2,0,1,0
35,407,407,58,58,0,1,0
23,417,417,66,10,56,4,3
32,418,418,7,7,0,1,0
10,442,442,188,111,77,4,3
24,448,448,59,59,0,1,0
27,455,455,6,6,0,1,0
28,459,459,117,117,0,1,0
18,469,469,25,8,17,2,1
4,486,486,40,40,0,1,0
13,486,486,1,1,0,1,0

37,105,105,3,3,0,1,0
10,115,115,16,16,0,1,0
14,140,140,3,3,0,1,0
23,142,142,21,21,0,1,0
13,154,154,1,1,0,1,0
11,157,157,7,7,0,1,0
21,161,161,16,16,0,1,0
42,165,165,11,11,0,1,0
40,169,169,5,5,0,1,0
38,176,176,1,1,0,1,0
17,192,192,2,2,0,1,0
22,193,193,10,10,0,1,0
19,197,197,2,2,0,1,0
15,222,222,4,1,3,2,1
25,237,237,45,45,0,1,0
32,244,244,13,2,11,4,3
41,250,250,2,2,0,1,0
34,262,262,62,14,48,2,1
36,270,270,5,1,4,2,1
24,287,287,61,3,58,3,2
33,305,305,7,1,6,2,1
7,318,318,5,5,0,1,0
2,321,321,29,29,0,1,0
28,330,330,54,28,26,3,2
5,336,336,97,64,33,4,3
1,336,336,18,13,5,2,1
43,342,342,3,3,0,1,0
3,348,348,45,41,4,2,1
12,350,350,50,25,25,2,1
8,351,351,30,16,14,2,1
6,351,351,6,1,5,2,1
39,364,364,57,57,0,1,0
35,365,365,72,23,49,3,2
26,377,377,72,72,0,1,0
30,388,388,77,17,60,3,2
9,428,428,7,7,0,1,0
27,435,435,121,109,12,4,3
18,443,443,30,30,0,1,0
4,464,464,11,8,3,2,1
31,466,466,14,8,6,2,1
16,478,478,2,2,0,1,0
0,481,481,58,37,21,4,3
29,483,483,28,4,24,4,3
20,487,487,41,5,36,4,3

3,103,103,11,11,0,1,0
17,108,108,22,22,0,1,0
21,112,112,3,3,0,1,0
22,129,129,1,1,0,1,0
0,165,165,55,55,0,1,0
9,172,172,17,4,13,2,1
4,176,176,4,4,0,1,0
34,182,182,19,19,0,1,0
1,193,193,2,2,0,1,0
23,200,200,8,8,0,1,0
8,213,213,1,1,0,1,0
11,218,218,1,1,0,1,0
5,224,224,31,13,18,4,3
15,230,230,31,31,0,1,0
16,248,248,41,41,0,1,0
35,251,251,97,73,24,4,3
19,282,282,20,20,0,1,0
26,295,295,39,22,17,2,1
2,302,302,95,31,64,3,2
33,310,310,4,4,0,1,0
12,315,315,1,1,0,1,0
28,328,328,1,1,0,1,0
25,340,340,58,13,45,4,3
32,344,344,67,32,35,2,1
24,346,346,13,13,0,1,0
31,373,373,5,5,0,1,0
14,381,381,30,30,0,1,0
18,387,387,52,45,7,2,1
7,405,405,65,36,29,2,1
6,409,409,18,18,0,1,0
13,410,410,109,109,0,1,0
10,412,412,7,7,0,1,0
29,419,419,96,96,0,1,0
30,453,453,65,26,39,4,3
27,463,463,11,11,0,1,0
20,489,489,4,4,0,1,0

25,115,115,2,2,0,1,0
23,126,126,4,1,3,2,1
33,127,127,39,15,24,3,2
29,143,143,30,13,17,3,2
14,152,152,15,6,9,4,3
18,153,153,7,3,4,2,1
32,154,154,11,11,0,1,0
22,188,188,28,12,16,2,1
0,189,189,22,22,0,1,0
27,198,198,15,6,9,4,3
4,199,199,15,15,0,1,0
28,204,204,18,18,0,1,0
7,205,205,35,5,30,4,3
20,213,213,20,1,19,2,1
5,228,228,53,16,37,2,1
15,294,294,2,2,0,1,0
11,302,302,4,4,0,1,0
1,306,306,75,42,33,4,3
3,339,339,3,3,0,1,0
9,343,343,70,70,0,1,0
21,348,348,11,5,6,2,1
19,372,372,18,18,0,1,0
2,378,378,69,25,44,3,2
13,382,382,84,84,0,1,0
30,395,395,27,27,0,1,0
12,399,399,12,2,10,3,2
6,413,413,2,2,0,1,0
17,419,419,165,67,98,3,2
8,425,425,28,28,0,1,0
31,432,432,50,39,11,2,1
10,451,451,107,49,58,3,2
26,477,477,30,12,18,2,1
16,481,481,54,20,34,3,2
24,484,484,5,5,0,1,0

32,104,104,4,1,3,2,1
24,114,114,3,3,0,1,0
29,117,117,2,2,0,1,0
20,124,124,3,3,0,1,0
26,133,133,56,31,25,2,1
42,140,140,5,1,4,2,1
25,147,147,29,8,21,2,1
41,149,149,12,2,10,2,1
3,156,156,16,16,0,1,0
30,167,167,32,32,0,1,0
27,171,171,6,6,0,1,0
28,172,172,3,3,0,1,0
13,174,174,3,3,0,1,0
35,175,175,41,41,0,1,0
38,201,201,46,46,0,1,0
37,226,226,29,16,13,2,1
5,232,232,32,8,24,3,2
8,238,238,15,6,9,4,3
43,249,249,14,7,7,2,1
22,253,253,20,20,0,1,0
15,260,260,10,6,4,2,1
19,263,263,36,36,0,1,0
23,267,267,7,7,0,1,0
1,279,279,72,72,0,1,0
12,286,286,1,1,0,1,0
14,296,296,36,16,20,3,2
2,310,310,24,4,20,3,2
11,343,343,19,6,13,2,1
34,345,345,24,17,7,2,1
18,362,362,53,31,22,2,1
33,362,362,10,2,8,3,2
0,363,363,6,2,4,2,1
16,368,368,14,14,0,1,0
40,369,369,23,2,21,4,3
36,380,380,34,13,21,4,3
4,392,392,29,5,24,3,2
21,426,426,16,1,15,2,1
7,430,430,33,15,18,3,2
31,444,444,6,6,0,1,0
39,463,463,4,4,0,1,0
6,483,483,40,26,14,3,2
9,484,484,41,41,0,1,0
17,492,492,14,14,0,1,0
10,498,498,76,18,58,3,2

42,106,106,14,14,0,1,0
8,106,106,37,37,0,1,0
34,117,117,1,1,0,1,0
7,128,128,1,1,0,1,0
17,136,136,5,1,4,2,1
6,153,153,6,6,0,1,0
5,161,161,25,4,21,2,1
16,183,183,21,21,0,1,0
33,184,184,4,4,0,1,0
38,185,185,43,43,0,1,0
11,195,195,81,52,29,2,1
14,215,215,16,2,14,2,1
30,216,216,13,2,11,2,1
28,219,219,4,4,0,1,0
29,220,220,28,23,5,2,1
40,223,223,3,3,0,1,0
20,228,228,1,1,0,1,0
9,234,234,6,6,0,1,0
25,243,243,29,29,0,1,0
21,250,250,1,1,0,1,0
37,251,251,19,14,5,2,1
24,260,260,35,2,33,4,3
19,273,273,1,1,0,1,0
26,280,280,15,15,0,1,0
41,284,284,55,55,0,1,0
22,284,284,9,2,7,2,1
13,306,306,11,5,6,3,2
0,327,327,12,12,0,1,0
32,341,341,28,28,0,1,0
12,342,342,34,34,0,1,0
10,345,345,56,28,28,2,1
39,355,355,81,81,0,1,0
15,369,369,6,6,0,1,0
23,373,373,27,27,0,1,0
27,377,377,13,13,0,1,0
2,387,387,39,39,0,1,0
18,408,408,17,17,0,1,0
31,452,452,25,13,12,4,3
4,461,461,8,8,0,1,0
3,464,464,8,8,0,1,0
1,466,466,18,10,8,2,1
35,473,473,105,105,0,1,0
36,482,482,62,62,0,1,0

19,130,130,14,4,10,2,1
13,167,167,2,2,0,1,0
20,174,174,59,5,54,3,2
34,176,176,26,26,0,1,0
0,213,213,8,8,0,1,0
36,231,231,20,12,8,2,1
26,252,252,21,5,16,2,1
32,256,256,8,8,0,1,0
30,256,256,12,12,0,1,0
1,259,259,88,74,14,2,1
22,264,264,1,1,0,1,0
35,272,272,5,5,0,1,0
25,276,276,7,3,4,2,1
8,283,283,11,11,0,1,0
29,290,290,60,30,30,4,3
17,295,295,6,6,0,1,0
15,296,296,11,11,0,1,0
10,307,307,62,62,0,1,0
33,325,325,7,7,0,1,0
2,332,332,2,2,0,1,0
21,335,335,133,85,48,3,2
31,340,340,25,25,0,1,0
24,346,346,48,8,40,2,1
14,348,348,80,18,62,4,3
23,352,352,17,5,12,2,1
3,361,361,1,1,0,1,0
37,365,365,34,34,0,1,0
11,366,366,181,76,105,4,3
4,376,376,5,5,0,1,0
16,381,381,4,4,0,1,0
5,385,385,16,16,0,1,0
9,389,389,22,22,0,1,0
12,401,401,42,42,0,1,0
18,426,426,71,21,50,4,3
27,445,445,10,10,0,1,0
6,461,461,22,6,16,2,1
7,480,480,19,19,0,1,0
28,487,487,21,11,10,2,1

31,113,113,3,3,0,1,0
32,115,115,37,5,32,3,2
13,125,125,19,19,0,1,0
22,157,157,8,1,7,3,2
10,160,160,12,2,10,4,3
21,174,174,16,16,0,1,0
5,179,179,4,4,0,1,0
8,185,185,30,1,29,2,1
12,201,201,13,4,9,4,3
14,233,233,21,5,16,3,2
17,243,243,25,13,12,2,1
29,255,255,50,12,38,3,2
28,255,255,1,1,0,1,0
20,259,259,28,28,0,1,0
1,270,270,16,16,0,1,0
2,280,280,22,10,12,3,2
4,281,281,8,8,0,1,0
11,281,281,164,53,111,4,3
19,293,293,4,4,0,1,0
24,322,322,90,90,0,1,0
26,334,334,46,8,38,3,2
25,337,337,100,12,88,3,2
15,352,352,20,20,0,1,0
6,393,393,6,3,3,2,1
0,413,413,149,142,7,2,1
23,418,418,45,5,40,3,2
7,433,433,67,27,40,4,3
27,462,462,5,2,3,2,1
3,475,475,25,3,22,2,1
30,482,482,14,11,3,2,1
33,482,482,14,14,0,1,0
9,490,490,2,2,0,1,0
16,493,493,6,6,0,1,0
18,495,495,31,31,0,1,0

10,106,106,18,18,0,1,0
38,115,115,12,4,8,2,1
4,117,117,13,13,0,1,0
8,138,138,8,8,0,1,0
9,146,146,3,3,0,1,0
27,149,149,3,3,0,1,0
11,158,158,27,10,17,2,1
0,161,161,54,30,24,4,3
2,170,170,7,7,0,1,0
14,181,181,5,1,4,2,1
31,205,205,14,2,12,3,2
35,215,215,71,5,66,3,2
28,216,216,53,5,48,3,2
18,216,216,9,1,8,3,2
13,223,223,23,10,13,2,1
21,261,261,16,16,0,1,0
34,266,266,4,4,0,1,0
26,273,273,23,23,0,1,0
3,286,286,19,1,18,2,1
23,299,299,25,9,16,3,2
7,333,333,5,5,0,1,0
40,338,338,7,7,0,1,0
5,340,340,16,16,0,1,0
6,351,351,19,19,0,1,0
19,354,354,41,2,39,4,3
22,388,388,40,40,0,1,0
20,395,395,13,13,0,1,0
32,396,396,40,2,38,2,1
12,399,399,9,9,0,1,0
16,402,402,2,2,0,1,0
30,403,403,12,3,9,2,1
37,421,421,15,15,0,1,0
36,437,437,121,121,0,1,0
29,442,442,11,6,5,2,1
39,444,444,103,103,0,1,0
24,454,454,7,4,3,2,1
17,456,456,86,86,0,1,0
33,456,456,36,36,0,1,0
1,462,462,49,49,0,1,0
15,482,482,52,52,0,1,0
25,497,497,29,15,14,2,1

9,110,110,1,1,0,1,0
17,126,126,1,1,0,1,0
35,138,138,17,17,0,1,0
11,146,146,9,9,0,1,0
0,181,181,22,6,16,3,2
29,201,201,28,4,24,2,1
33,206,206,4,1,3,2,1
13,216,216,33,33,0,1,0
4,218,218,1,1,0,1,0
19,222,222,4,4,0,1,0
20,231,231,8,3,5,2,1
31,236,236,65,16,49,2,1
32,242,242,66,66,0,1,0
23,261,261,4,4,0,1,0
7,272,272,10,2,8,3,2
22,273,273,42,17,25,2,1
28,279,279,9,6,3,2,1
21,286,286,43,15,28,3,2
25,290,290,60,50,10,4,3
10,314,314,31,12,19,2,1
2,337,337,107,98,9,2,1
1,357,357,7,7,0,1,0
12,359,359,31,31,0,1,0
14,370,370,39,21,18,3,2
15,379,379,38,2,36,3,2
16,401,401,37,1,36,4,3
6,403,403,32,5,27,2,1
8,406,406,239,171,68,4,3
5,447,447,2,2,0,1,0
26,460,460,82,46,36,4,3
30,461,461,8,8,0,1,0
24,468,468,7,4,3,2,1
3,470,470,10,4,6,3,2
34,477,477,12,9,3,2,1
27,486,486,5,5,0,1,0
18,489,489,115,115,0,1,0

41,103,103,10,10,0,1,0
3,103,103,18,12,6,2,1
26,104,104,35,31,4,2,1
12,105,105,4,1,3,2,1
9,115,115,5,5,0,1,0
29,133,133,14,14,0,1,0
8,136,136,1,1,0,1,0
22,139,139,30,30,0,1,0
24,143,143,17,17,0,1,0
39,152,152,5,2,3,2,1
28,175,175,9,9,0,1,0
25,192,192,17,5,12,4,3
23,205,205,21,21,0,1,0
20,208,208,27,27,0,1,0
2,214,214,9,9,0,1,0
17,230,230,15,1,14,3,2
16,235,235,3,3,0,1,0
11,248,248,5,5,0,1,0
36,251,251,115,58,57,4,3
32,252,252,20,1,19,2,1
21,268,268,20,20,0,1,0
27,288,288,13,10,3,2,1
4,293,293,28,28,0,1,0
31,325,325,18,9,9,4,3
35,326,326,13,13,0,1,0
7,338,338,9,9,0,1,0
19,343,343,171,171,0,1,0
34,356,356,20,20,0,1,0
30,367,367,32,2,30,4,3
18,376,376,59,14,45,2,1
0,387,387,3,3,0,1,0
10,388,388,5,5,0,1,0
1,388,388,8,4,4,2,1
13,411,411,14,14,0,1,0
37,422,422,56,10,46,3,2
33,442,442,3,3,0,1,0
6,451,451,30,30,0,1,0
15,456,456,27,3,24,4,3
40,459,459,12,4,8,3,2
14,477,477,36,36,0,1,0
5,480,480,13,7,6,3,2
38,492,492,13,13,0,1,0

8,110,110,13,13,0,1,0
15,149,149,3,3,0,1,0
20,154,154,6,6,0,1,0
18,160,160,43,43,0,1,0
12,192,192,12,12,0,1,0
10,194,194,1,1,0,1,0
29,209,209,2,2,0,1,0
14,224,224,41,31,10,3,2
19,234,234,50,7,43,2,1
17,261,261,25,2,23,2,1
31,262,262,30,6,24,2,1
11,262,262,39,13,26,2,1
13,295,295,83,21,62,3,2
0,296,296,79,53,26,3,2
27,326,326,25,12,13,2,1
22,336,336,42,42,0,1,0
25,337,337,45,45,0,1,0
7,338,338,28,28,0,1,0
6,338,338,148,103,45,2,1
9,360,360,82,82,0,1,0
28,365,365,38,38,0,1,0
30,402,402,6,6,0,1,0
16,416,416,11,11,0,1,0
23,430,430,4,4,0,1,0
21,435,435,13,13,0,1,0
1,441,441,34,16,18,3,2
24,446,446,82,66,16,2,1
2,448,448,79,79,0,1,0
26,450,450,6,6,0,1,0
4,452,452,39,11,28,2,1
3,461,461,26,6,20,3,2
5,476,476,75,7,68,4,3

23,111,111,5,5,0,1,0
31,115,115,14,14,0,1,0
5,121,121,10,1,9,4,3
1,130,130,4,4,0,1,0
9,130,130,28,2,26,3,2
12,172,172,9,3,6,3,2
8,173,173,14,14,0,1,0
26,175,175,34,9,25,2,1
30,202,202,13,5,8,3,2
21,226,226,11,11,0,1,0
20,260,260,8,2,6,2,1
29,291,291,4,4,0,1,0
3,298,298,63,43,20,2,1
14,300,300,15,15,0,1,0
17,307,307,12,12,0,1,0
16,308,308,14,14,0,1,0
24,309,309,49,27,22,3,2
4,329,329,4,4,0,1,0
6,335,335,45,45,0,1,0
7,374,374,108,108,0,1,0
32,396,396,145,83,62,3,2
0,406,406,88,30,58,3,2
27,409,409,62,6,56,3,2
22,410,410,43,43,0,1,0
25,419,419,66,66,0,1,0
11,424,424,45,30,15,2,1
13,428,428,102,86,16,2,1
18,437,437,30,17,13,4,3
19,441,441,64,16,48,3,2
15,447,447,58,37,21,2,1
10,466,466,55,5,50,3,2
2,474,474,54,6,48,4,3
28,478,478,4,4,0,1,0

23,105,105,13,13,0,1,0
13,110,110,9,9,0,1,0
6,139,139,23,2,21,2,1
31,145,145,7,7,0,1,0
41,146,146,67,67,0,1,0
10,152,152,1,1,0,1,0
43,152,152,9,2,7,2,1
45,162,162,23,23,0,1,0
18,164,164,16,16,0,1,0
5,178,178,7,7,0,1,0
38,195,195,41,41,0,1,0
24,200,200,27,13,14,2,1
36,200,200,3,3,0,1,0
33,224,224,9,9,0,1,0
17,242,242,5,5,0,1,0
19,243,243,10,10,0,1,0
34,249,249,31,31,0,1,0
26,263,263,8,8,0,1,0
40,265,265,7,7,0,1,0
16,267,267,23,23,0,1,0
3,283,283,21,21,0,1,0
25,285,285,11,4,7,2,1
35,288,288,17,4,13,2,1
29,292,292,1,1,0,1,0
28,294,294,3,3,0,1,0
1,311,311,3,3,0,1,0
30,314,314,56,4,52,4,3
7,326,326,14,5,9,4,3
0,329,329,21,5,16,2,1
44,343,343,74,31,43,2,1
4,344,344,37,37,0,1,0
27,349,349,33,33,0,1,0
2,351,351,4,4,0,1,0
12,351,351,23,1,22,2,1
42,352,352,1,1,0,1,0
37,353,353,5,5,0,1,0
20,354,354,5,5,0,1,0
15,360,360,6,6,0,1,0
32,364,364,3,3,0,1,0
8,365,365,36,36,0,1,0
22,373,373,27,27,0,1,0
11,397,397,15,15,0,1,0
14,406,406,68,49,19,2,1
9,417,417,65,65,0,1,0
39,467,467,109,64,45,4,3
21,492,492,48,48,0,1,0

18,121,121,4,4,0,1,0
2,135,135,6,6,0,1,0
29,146,146,42,20,22,2,1
0,163,163,1,1,0,1,0
23,200,200,27,9,18,4,3
17,211,211,4,1,3,2,1
36,233,233,1,1,0,1,0
26,234,234,102,102,0,1,0
1,256,256,8,8,0,1,0
31,271,271,33,33,0,1,0
8,272,272,43,34,9,2,1
12,283,283,29,29,0,1,0
34,285,285,35,35,0,1,0
30,285,285,5,5,0,1,0
19,289,289,25,15,10,3,2
14,292,292,66,66,0,1,0
3,297,297,10,10,0,1,0
6,312,312,86,14,72,3,2
10,315,315,29,29,0,1,0
13,317,317,7,7,0,1,0
28,318,318,23,7,16,2,1
16,320,320,114,26,88,3,2
5,327,327,17,17,0,1,0
11,344,344,71,63,8,2,1
32,355,355,12,3,9,2,1
25,363,363,73,70,3,2,1
7,375,375,33,33,0,1,0
22,392,392,20,20,0,1,0
33,399,399,16,16,0,1,0
24,405,405,31,31,0,1,0
27,406,406,19,9,10,3,2
9,416,416,12,12,0,1,0
35,431,431,7,7,0,1,0
4,448,448,30,8,22,3,2
15,450,450,41,32,9,2,1
20,452,452,65,46,19,4,3
21,496,496,1,1,0,1,0

12,121,121,22,22,0,1,0
34,126,126,25,25,0,1,0
18,142,142,6,6,0,1,0
27,144,144,10,5,5,2,1
36,161,161,10,10,0,1,0
42,194,194,20,10,10,2,1
13,210,210,1,1,0,1,0
2,218,218,31,11,20,2,1
4,226,226,18,18,0,1,0
22,239,239,6,6,0,1,0
16,239,239,36,14,22,3,2
14,251,251,4,4,0,1,0
43,274,274,29,29,0,1,0
0,293,293,11,11,0,1,0
26,294,294,2,2,0,1,0
32,300,300,9,9,0,1,0
3,302,302,13,13,0,1,0
1,302,302,11,2,9,2,1
37,321,321,54,54,0,1,0
38,330,330,1,1,0,1,0
35,333,333,55,55,0,1,0
29,335,335,110,3,107,4,3
40,337,337,22,5,17,2,1
23,346,346,44,44,0,1,0
9,349,349,24,13,11,4,3
21,356,356,67,18,49,2,1
8,362,362,31,31,0,1,0
30,365,365,106,106,0,1,0
7,373,373,29,17,12,2,1
33,377,377,46,12,34,2,1
17,380,380,7,3,4,2,1
44,386,386,26,26,0,1,0
10,400,400,9,3,6,2,1
28,417,417,12,2,10,3,2
5,426,426,10,5,5,2,1
15,426,426,23,1,22,2,1
19,429,429,29,29,0,1,0
11,431,431,54,54,0,1,0
31,433,433,11,2,9,4,3
25,457,457,45,27,18,4,3
20,468,468,15,15,0,1,0
41,469,469,1,1,0,1,0
6,474,474,31,31,0,1,0
39,479,479,47,47,0,1,0
24,482,482,42,42,0,1,0

18,102,102,3,3,0,1,0
11,126,126,2,2,0,1,0
7,139,139,31,31,0,1,0
0,149,149,60,53,7,2,1
22,157,157,24,24,0,1,0
6,159,159,8,8,0,1,0
2,180,180,11,11,0,1,0
27,194,194,9,9,0,1,0
23,239,239,18,18,0,1,0
4,242,242,35,20,15,2,1
1,243,243,74,45,29,2,1
12,254,254,28,28,0,1,0
31,268,268,5,5,0,1,0
29,272,272,66,15,51,4,3
24,288,288,26,8,18,4,3
19,312,312,92,6,86,4,3
20,333,333,3,3,0,1,0
25,338,338,56,56,0,1,0
10,356,356,89,7,82,3,2
15,358,358,18,18,0,1,0
30,364,364,6,3,3,2,1
33,370,370,61,2,59,4,3
3,378,378,13,13,0,1,0
28,389,389,21,13,8,2,1
32,391,391,151,151,0,1,0
21,404,404,21,21,0,1,0
16,411,411,16,16,0,1,0
17,418,418,13,13,0,1,0
9,431,431,25,13,12,3,2
5,433,433,70,70,0,1,0
14,451,451,1,1,0,1,0
8,465,465,18,5,13,2,1
13,477,477,21,17,4,2,1
26,498,498,6,6,0,1,0

19,127,127,35,31,4,2,1
12,130,130,15,3,12,2,1
32,139,139,2,2,0,1,0
23,149,149,16,8,8,3,2
14,152,152,29,3,26,4,3
9,157,157,24,24,0,1,0
11,163,163,1,1,0,1,0
25,163,163,44,44,0,1,0
34,168,168,10,1,9,4,3
4,170,170,20,20,0,1,0
6,171,171,78,78,0,1,0
15,175,175,6,2,4,2,1
22,179,179,21,21,0,1,0
1,194,194,12,12,0,1,0
5,203,203,6,6,0,1,0
18,235,235,1,1,0,1,0
3,243,243,2,2,0,1,0
38,244,244,2,2,0,1,0
26,247,247,59,52,7,2,1
35,267,267,10,4,6,2,1
39,287,287,62,62,0,1,0
33,295,295,8,3,5,2,1
28,296,296,17,12,5,2,1
24,300,300,33,24,9,2,1
27,313,313,13,13,0,1,0
20,340,340,41,41,0,1,0
31,341,341,7,7,0,1,0
36,349,349,4,4,0,1,0
30,351,351,85,85,0,1,0
29,377,377,2,2,0,1,0
37,380,380,79,47,32,3,2
16,383,383,1,1,0,1,0
2,416,416,19,7,12,3,2
13,430,430,33,33,0,1,0
0,443,443,4,4,0,1,0
17,471,471,31,1,30,4,3
21,482,482,68,59,9,4,3
8,483,483,10,10,0,1,0
10,490,490,4,1,3,2,1
7,493,493,49,49,0,1,0

8,110,110,5,5,0,1,0
7,110,110,10,10,0,1,0
23,110,110,1,1,0,1,0
33,137,137,3,3,0,1,0
6,138,138,2,2,0,1,0
20,141,141,7,7,0,1,0
31,149,149,6,6,0,1,0
14,149,149,1,1,0,1,0
1,169,169,4,4,0,1,0
40,182,182,1,1,0,1,0
37,187,187,50,50,0,1,0
19,193,193,9,1,8,2,1
42,205,205,52,16,36,4,3
25,206,206,10,3,7,2,1
3,208,208,11,2,9,2,1
11,211,211,30,16,14,3,2
36,219,219,17,9,8,2,1
22,234,234,15,7,8,2,1
12,251,251,4,4,0,1,0
27,252,252,29,3,26,3,2
35,256,256,8,2,6,2,1
9,256,256,2,2,0,1,0
10,300,300,69,69,0,1,0
15,300,300,70,70,0,1,0
17,306,306,25,3,22,3,2
29,316,316,11,4,7,2,1
21,325,325,15,15,0,1,0
48,332,332,46,13,33,2,1
4,335,335,9,9,0,1,0
0,347,347,26,26,0,1,0
39,375,375,74,48,26,4,3
13,376,376,37,5,32,3,2
38,380,380,60,50,10,2,1
30,387,387,23,23,0,1,0
47,387,387,62,62,0,1,0
16,390,390,5,5,0,1,0
34,395,395,58,58,0,1,0
18,405,405,11,3,8,3,2
26,412,412,8,5,3,2,1
44,427,427,16,7,9,2,1
5,435,435,13,13,0,1,0
43,440,440,44,26,18,2,1
32,454,454,7,7,0,1,0
46,469,469,62,62,0,1,0
2,470,470,53,53,0,1,0
45,475,475,35,35,0,1,0
28,483,483,44,44,0,1,0
41,483,483,5,5,0,1,0
24,488,488,24,6,18,2,1

21,112,112,12,4,8,2,1
23,120,120,6,6,0,1,0
11,131,131,14,3,11,2,1
13,136,136,5,1,4,2,1
12,161,161,4,4,0,1,0
31,169,169,4,4,0,1,0
22,189,189,12,7,5,2,1
16,191,191,4,4,0,1,0
3,199,199,1,1,0,1,0
15,205,205,6,6,0,1,0
33,209,209,26,11,15,4,3
40,213,213,44,28,16,2,1
25,213,213,32,4,28,2,1
27,223,223,4,1,3,2,1
24,242,242,5,2,3,2,1
9,244,244,2,2,0,1,0
30,274,274,3,3,0,1,0
17,297,297,93,93,0,1,0
34,298,298,25,25,0,1,0
2,310,310,5,1,4,2,1
1,325,325,27,27,0,1,0
7,330,330,69,57,12,4,3
42,343,343,51,51,0,1,0
37,343,343,15,1,14,3,2
8,352,352,8,5,3,2,1
18,352,352,31,31,0,1,0
0,363,363,1,1,0,1,0
26,393,393,33,33,0,1,0
10,395,395,50,50,0,1,0
35,399,399,66,66,0,1,0
6,408,408,23,13,10,2,1
5,411,411,1,1,0,1,0
14,411,411,44,44,0,1,0
20,415,415,80,80,0,1,0
29,416,416,72,72,0,1,0
41,451,451,6,6,0,1,0
28,460,460,61,14,47,2,1
4,473,473,37,28,9,2,1
36,479,479,88,88,0,1,0
32,482,482,10,5,5,2,1
39,491,491,105,19,86,4,3
38,497,497,52,52,0,1,0
19,498,498,75,49,26,3,2

19,106,106,5,5,0,1,0
18,106,106,8,4,4,2,1
34,106,106,9,4,5,2,1
21,107,107,1,1,0,1,0
23,114,114,1,1,0,1,0
17,115,115,4,4,0,1,0
28,118,118,19,19,0,1,0
6,119,119,43,43,0,1,0
39,126,126,32,32,0,1,0
38,159,159,3,3,0,1,0
42,169,169,4,4,0,1,0
14,170,170,20,2,18,2,1
22,181,181,8,8,0,1,0
37,195,195,4,4,0,1,0
48,202,202,18,6,12,3,2
29,209,209,1,1,0,1,0
5,217,217,3,3,0,1,0
47,237,237,7,1,6,2,1
8,248,248,1,1,0,1,0
32,266,266,9,9,0,1,0
40,293,293,36,36,0,1,0
20,309,309,8,4,4,2,1
45,320,320,5,5,0,1,0
25,336,336,17,3,14,3,2
43,345,345,3,3,0,1,0
33,349,349,44,15,29,3,2
35,365,365,68,68,0,1,0
10,367,367,38,9,29,2,1
15,371,371,49,12,37,2,1
36,373,373,111,15,96,3,2
16,374,374,6,6,0,1,0
24,374,374,8,1,7,2,1
2,376,376,20,6,14,2,1
44,386,386,13,1,12,4,3
13,392,392,6,6,0,1,0
4,394,394,70,70,0,1,0
27,398,398,1,1,0,1,0
1,404,404,13,13,0,1,0
46,405,405,36,20,16,3,2
31,407,407,83,83,0,1,0
0,418,418,12,1,11,2,1
9,423,423,1,1,0,1,0
7,428,428,38,38,0,1,0
3,428,428,65,20,45,4,3
26,429,429,6,6,0,1,0
12,448,448,10,10,0,1,0
11,462,462,37,3,34,4,3
41,485,485,26,26,0,1,0
30,500,500,129,129,0,1,0

3,103,103,6,6,0,1,0
25,106,106,5,5,0,1,0
20,117,117,14,10,4,2,1
5,151,151,16,16,0,1,0
19,155,155,5,2,3,2,1
0,165,165,16,6,10,3,2
2,167,167,40,40,0,1,0
27,171,171,1,1,0,1,0
30,174,174,2,2,0,1,0
7,183,183,14,8,6,3,2
33,186,186,15,15,0,1,0
32,187,187,29,6,23,2,1
21,189,189,43,19,24,3,2
29,193,193,19,11,8,2,1
9,215,215,2,2,0,1,0
11,215,215,28,20,8,2,1
23,225,225,43,3,40,2,1
6,253,253,22,12,10,2,1
13,254,254,21,3,18,3,2
26,270,270,24,24,0,1,0
28,283,283,74,28,46,2,1
12,284,284,50,14,36,3,2
10,290,290,35,35,0,1,0
17,297,297,28,3,25,4,3
24,338,338,61,61,0,1,0
8,358,358,44,35,9,4,3
31,413,413,42,42,0,1,0
4,431,431,69,27,42,3,2
1,434,434,15,15,0,1,0
22,470,470,12,3,9,2,1
16,470,470,57,17,40,3,2
15,492,492,22,22,0,1,0
18,494,494,29,17,12,2,1
14,494,494,198,198,0,1,0

19,108,108,15,15,0,1,0
0,127,127,1,1,0,1,0
37,128,128,9,1,8,2,1
1,162,162,32,32,0,1,0
33,163,163,5,5,0,1,0
36,170,170,12,12,0,1,0
11,202,202,8,2,6,2,1
13,204,204,6,6,0,1,0
35,206,206,18,6,12,3,2
26,207,207,28,28,0,1,0
4,215,215,51,51,0,1,0
29,240,240,13,7,6,3,2
22,252,252,10,10,0,1,0
24,252,252,33,33,0,1,0
18,262,262,13,9,4,2,1
30,279,279,33,33,0,1,0
28,283,283,48,48,0,1,0
27,288,288,71,25,46,2,1
32,295,295,21,18,3,2,1
16,296,296,3,3,0,1,0
23,303,303,17,17,0,1,0
8,304,304,83,27,56,4,3
2,326,326,6,6,0,1,0
17,340,340,6,6,0,1,0
12,354,354,42,42,0,1,0
7,358,358,80,57,23,4,3
39,367,367,48,48,0,1,0
34,373,373,15,1,14,3,2
40,374,374,81,6,75,4,3
41,387,387,37,11,26,4,3
20,390,390,16,16,0,1,0
31,437,437,21,6,15,2,1
15,441,441,7,7,0,1,0
6,442,442,1,1,0,1,0
38,446,446,30,18,12,4,3
25,451,451,40,19,21,4,3
5,452,452,8,4,4,2,1
14,461,461,26,26,0,1,0
21,463,463,67,67,0,1,0
10,464,464,15,15,0,1,0
9,464,464,22,13,9,4,3
3,495,495,70,58,12,3,2

36,119,119,13,13,0,1,0
38,133,133,12,12,0,1,0
40,152,152,18,11,7,2,1
20,165,165,26,26,0,1,0
23,172,172,11,11,0,1,0
21,182,182,14,3,11,2,1
18,187,187,3,3,0,1,0
17,189,189,3,3,0,1,0
41,197,197,7,1,6,3,2
28,203,203,1,1,0,1,0
32,221,221,70,2,68,4,3
9,233,233,4,4,0,1,0
35,244,244,3,3,0,1,0
42,245,245,42,30,12,3,2
3,253,253,26,26,0,1,0
6,265,265,15,3,12,3,2
29,271,271,4,4,0,1,0
4,296,296,63,40,23,2,1
16,300,300,24,24,0,1,0
27,312,312,9,5,4,2,1
0,314,314,7,7,0,1,0
19,365,365,1,1,0,1,0
7,367,367,27,4,23,2,1
5,376,376,38,38,0,1,0
15,376,376,39,15,24,3,2
1,393,393,59,15,44,2,1
37,394,394,15,15,0,1,0
10,407,407,27,27,0,1,0
33,407,407,83,46,37,4,3
25,411,411,56,56,0,1,0
11,415,415,19,2,17,4,3
24,417,417,37,31,6,3,2
34,443,443,43,43,0,1,0
22,443,443,19,19,0,1,0
14,454,454,35,35,0,1,0
12,456,456,103,21,82,3,2
43,457,457,6,3,3,2,1
13,457,457,31,31,0,1,0
31,473,473,27,20,7,2,1
8,476,476,14,14,0,1,0
39,477,477,76,21,55,4,3
26,481,481,44,11,33,4,3
2,487,487,2,2,0,1,0
30,496,496,116,92,24,4,3

23,110,110,1,1,0,1,0
24,114,114,8,8,0,1,0
2,149,149,37,37,0,1,0
11,150,150,1,1,0,1,0
15,164,164,3,3,0,1,0
5,166,166,50,50,0,1,0
25,176,176,49,49,0,1,0
17,178,178,6,6,0,1,0
3,195,195,8,2,6,2,1
18,196,196,44,5,39,4,3
0,204,204,36,23,13,2,1
1,229,229,46,46,0,1,0
6,231,231,49,28,21,4,3
22,267,267,32,18,14,3,2
21,285,285,1,1,0,1,0
33,290,290,3,3,0,1,0
32,290,290,34,4,30,3,2
9,297,297,46,22,24,2,1
19,315,315,42,42,0,1,0
28,328,328,100,42,58,3,2
29,332,332,16,2,14,2,1
14,333,333,61,23,38,2,1
16,339,339,50,18,32,3,2
7,347,347,14,6,8,3,2
34,373,373,17,10,7,2,1
12,381,381,38,14,24,4,3
13,415,415,18,18,0,1,0
10,432,432,30,30,0,1,0
4,432,432,24,24,0,1,0
20,436,436,25,25,0,1,0
30,442,442,33,11,22,2,1
8,464,464,25,7,18,2,1
27,472,472,9,9,0,1,0
31,479,479,103,11,92,3,2
26,488,488,15,7,8,3,2

13,102,102,4,1,3,2,1
38,110,110,1,1,0,1,0
24,113,113,3,3,0,1,0
9,129,129,6,6,0,1,0
40,133,133,7,7,0,1,0
29,136,136,13,3,10,2,1
35,141,141,26,26,0,1,0
10,152,152,1,1,0,1,0
7,153,153,6,6,0,1,0
34,193,193,48,48,0,1,0
41,213,213,26,26,0,1,0
19,222,222,1,1,0,1,0
43,264,264,6,6,0,1,0
11,273,273,6,6,0,1,0
20,287,287,22,22,0,1,0
15,293,293,51,8,43,4,3
6,308,308,1,1,0,1,0
33,313,313,74,74,0,1,0
3,317,317,15,11,4,2,1
12,325,325,7,4,3,2,1
27,325,325,1,1,0,1,0
14,340,340,11,11,0,1,0
25,343,343,4,4,0,1,0
21,343,343,53,53,0,1,0
42,353,353,56,28,28,3,2
32,371,371,6,6,0,1,0
22,377,377,75,75,0,1,0
8,380,380,97,97,0,1,0
39,390,390,188,137,51,4,3
2,395,395,10,10,0,1,0
44,402,402,7,7,0,1,0
30,426,426,9,3,6,2,1
36,430,430,5,5,0,1,0
31,430,430,1,1,0,1,0
26,436,436,37,14,23,3,2
5,439,439,7,7,0,1,0
1,443,443,57,57,0,1,0
17,451,451,21,7,14,2,1
23,458,458,21,6,15,4,3
4,460,460,21,9,12,3,2
16,476,476,11,11,0,1,0
45,476,476,26,26,0,1,0
28,479,479,10,2,8,3,2
18,482,482,12,12,0,1,0
37,484,484,69,12,57,4,3
0,484,484,144,144,0,1,0
46,495,495,13,1,12,3,2

27,101,101,4,1,3,2,1
24,106,106,36,36,0,1,0
30,132,132,4,1,3,2,1
26,157,157,10,4,6,3,2
33,177,177,13,1,12,2,1
34,178,178,57,30,27,4,3
2,179,179,5,1,4,2,1
35,186,186,2,2,0,1,0
10,188,188,23,9,14,2,1
13,206,206,12,12,0,1,0
36,234,234,6,3,3,2,1
1,238,238,58,13,45,2,1
8,240,240,13,7,6,2,1
29,265,265,30,30,0,1,0
15,270,270,9,9,0,1,0
6,272,272,23,5,18,2,1
12,281,281,5,5,0,1,0
22,283,283,22,22,0,1,0
9,297,297,40,40,0,1,0
4,314,314,5,5,0,1,0
19,317,317,32,32,0,1,0
28,319,319,7,1,6,2,1
32,325,325,9,3,6,2,1
16,362,362,36,33,3,2,1
5,367,367,147,147,0,1,0
11,368,368,42,42,0,1,0
23,376,376,18,18,0,1,0
18,377,377,65,65,0,1,0
21,398,398,89,62,27,2,1
3,436,436,35,26,9,2,1
31,446,446,12,12,0,1,0
0,447,447,24,24,0,1,0
14,464,464,47,47,0,1,0
7,481,481,60,21,39,4,3
20,482,482,23,23,0,1,0
17,489,489,66,66,0,1,0
25,496,496,86,16,70,3,2

33,116,116,9,9,0,1,0
8,138,138,31,16,15,4,3
36,141,141,3,3,0,1,0
21,147,147,1,1,0,1,0
4,148,148,1,1,0,1,0
19,172,172,11,2,9,2,1
10,180,180,17,8,9,4,3
13,187,187,2,2,0,1,0
40,192,192,24,24,0,1,0
20,193,193,20,20,0,1,0
0,194,194,10,10,0,1,0
31,205,205,5,1,4,2,1
16,218,218,69,69,0,1,0
17,219,219,3,3,0,1,0
18,240,240,29,17,12,3,2
12,242,242,17,2,15,3,2
39,254,254,32,32,0,1,0
9,256,256,4,4,0,1,0
5,289,289,39,31,8,3,2
32,297,297,48,13,35,3,2
11,301,301,30,6,24,2,1
38,309,309,69,69,0,1,0
34,319,319,7,7,0,1,0
2,331,331,80,27,53,3,2
28,332,332,14,6,8,2,1
24,351,351,62,62,0,1,0
3,367,367,11,5,6,2,1
25,368,368,1,1,0,1,0
1,370,370,15,7,8,2,1
26,379,379,49,21,28,3,2
15,385,385,18,10,8,2,1
7,394,394,26,26,0,1,0
42,395,395,20,12,8,2,1
6,395,395,15,15,0,1,0
41,413,413,8,8,0,1,0
27,438,438,56,56,0,1,0
23,448,448,12,12,0,1,0
29,464,464,202,164,38,4,3
35,469,469,35,3,32,2,1
37,475,475,30,14,16,2,1
30,482,482,15,6,9,4,3
14,495,495,1,1,0,1,0
22,500,500,38,6,32,2,1

2,101,101,4,1,3,2,1
18,104,104,7,7,0,1,0
31,107,107,10,4,6,2,1
3,110,110,7,7,0,1,0
30,126,126,3,3,0,1,0
24,146,146,12,12,0,1,0
21,147,147,27,21,6,3,2
12,179,179,6,6,0,1,0
25,187,187,2,2,0,1,0
17,247,247,48,2,46,2,1
26,248,248,29,2,27,4,3
7,250,250,47,20,27,2,1
20,253,253,22,22,0,1,0
10,259,259,15,3,12,4,3
19,262,262,3,3,0,1,0
15,276,276,25,25,0,1,0
16,281,281,1,1,0,1,0
13,301,301,46,46,0,1,0
4,304,304,143,74,69,4,3
5,305,305,44,5,39,4,3
6,316,316,9,9,0,1,0
23,321,321,13,13,0,1,0
27,351,351,18,18,0,1,0
22,365,365,23,23,0,1,0
14,374,374,200,77,123,4,3
29,391,391,52,52,0,1,0
1,392,392,7,7,0,1,0
11,401,401,69,69,0,1,0
8,401,401,118,118,0,1,0
28,472,472,2,2,0,1,0
9,479,479,22,22,0,1,0
0,496,496,173,173,0,1,0

39,105,105,4,4,0,1,0
5,112,112,1,1,0,1,0
18,115,115,4,4,0,1,0
38,126,126,9,9,0,1,0
29,128,128,25,25,0,1,0
27,142,142,8,5,3,2,1
3,156,156,1,1,0,1,0
11,165,165,31,31,0,1,0
15,165,165,5,5,0,1,0
23,195,195,1,1,0,1,0
19,211,211,12,1,11,4,3
4,215,215,22,22,0,1,0
2,224,224,68,34,34,2,1
13,228,228,12,12,0,1,0
45,229,229,10,10,0,1,0
6,238,238,7,7,0,1,0
35,255,255,11,11,0,1,0
33,267,267,30,30,0,1,0
43,275,275,13,13,0,1,0
7,278,278,24,24,0,1,0
1,280,280,5,2,3,2,1
22,281,281,14,14,0,1,0
31,290,290,27,21,6,2,1
30,292,292,9,9,0,1,0
0,294,294,30,6,24,2,1
17,298,298,25,25,0,1,0
32,301,301,42,12,30,3,2
34,304,304,23,7,16,3,2
41,316,316,7,7,0,1,0
14,326,326,1,1,0,1,0
8,346,346,36,22,14,2,1
21,370,370,1,1,0,1,0
37,374,374,11,5,6,2,1
12,391,391,53,53,0,1,0
10,398,398,55,16,39,4,3
42,402,402,34,30,4,2,1
20,403,403,7,7,0,1,0
9,409,409,14,14,0,1,0
46,432,432,29,1,28,3,2
28,433,433,43,43,0,1,0
24,453,453,4,4,0,1,0
44,456,456,106,106,0,1,0
26,459,459,89,29,60,3,2
36,475,475,145,133,12,4,3
40,475,475,98,82,16,2,1
16,479,479,22,2,20,2,1
25,481,481,2,2,0,1,0

19,101,101,35,35,0,1,0
14,110,110,3,3,0,1,0
36,110,110,5,2,3,2,1
34,116,116,7,7,0,1,0
15,119,119,7,7,0,1,0
7,119,119,20,4,16,2,1
9,127,127,2,2,0,1,0
3,149,149,6,1,5,2,1
26,155,155,5,5,0,1,0
5,184,184,47,9,38,3,2
24,189,189,48,6,42,4,3
13,197,197,13,13,0,1,0
22,198,198,17,12,5,2,1
23,203,203,3,3,0,1,0
28,207,207,22,16,6,2,1
42,208,208,3,3,0,1,0
37,258,258,80,62,18,2,1
32,262,262,41,41,0,1,0
12,279,279,27,27,0,1,0
29,296,296,46,34,12,2,1
31,298,298,51,34,17,2,1
0,314,314,26,26,0,1,0
16,327,327,12,12,0,1,0
38,342,342,2,2,0,1,0
41,357,357,15,11,4,2,1
6,365,365,50,32,18,4,3
8,388,388,28,28,0,1,0
1,392,392,27,27,0,1,0
30,403,403,18,14,4,2,1
20,410,410,6,6,0,1,0
11,410,410,7,1,6,3,2
35,419,419,62,44,18,2,1
2,420,420,71,71,0,1,0
40,420,420,42,24,18,3,2
10,441,441,4,4,0,1,0
33,446,446,24,6,18,2,1
4,454,454,12,12,0,1,0
17,464,464,25,12,13,2,1
27,468,468,55,55,0,1,0
25,483,483,21,15,6,3,2
18,488,488,19,19,0,1,0
39,491,491,37,37,0,1,0
21,500,500,1,1,0,1,0

32,111,111,17,17,0,1,0
3,115,115,6,6,0,1,0
16,135,135,14,5,9,4,3
4,138,138,19,8,11,4,3
19,185,185,25,7,18,3,2
9,205,205,33,33,0,1,0
33,207,207,16,8,8,3,2
18,212,212,19,11,8,2,1
10,217,217,27,27,0,1,0
1,225,225,39,30,9,2,1
6,229,229,49,49,0,1,0
21,237,237,35,2,33,2,1
23,243,243,23,17,6,2,1
26,262,262,13,13,0,1,0
14,263,263,97,64,33,4,3
0,275,275,9,6,3,2,1
28,276,276,17,17,0,1,0
20,286,286,10,10,0,1,0
12,287,287,27,3,24,3,2
27,313,313,6,2,4,2,1
5,347,347,31,6,25,2,1
29,378,378,5,5,0,1,0
13,388,388,53,53,0,1,0
17,392,392,66,66,0,1,0
2,403,403,33,33,0,1,0
24,408,408,5,5,0,1,0
8,411,411,11,3,8,2,1
15,415,415,13,4,9,4,3
7,419,419,39,39,0,1,0
25,425,425,10,4,6,3,2
30,441,441,63,63,0,1,0
31,460,460,211,191,20,2,1
11,480,480,55,55,0,1,0
22,488,488,57,57,0,1,0

36,118,118,1,1,0,1,0
21,122,122,1,1,0,1,0
2,133,133,1,1,0,1,0
23,164,164,10,4,6,3,2
1,177,177,3,3,0,1,0
27,181,181,80,80,0,1,0
4,183,183,13,6,7,2,1
28,190,190,12,4,8,2,1
10,194,194,15,15,0,1,0
17,197,197,35,35,0,1,0
37,203,203,23,23,0,1,0
6,207,207,28,4,24,3,2
38,210,210,1,1,0,1,0
9,223,223,8,3,5,2,1
30,224,224,19,19,0,1,0
7,230,230,9,4,5,2,1
0,249,249,26,26,0,1,0
14,250,250,46,7,39,4,3
22,257,257,12,2,10,2,1
16,270,270,48,48,0,1,0
34,278,278,7,7,0,1,0
5,279,279,79,79,0,1,0
29,283,283,89,85,4,2,1
3,285,285,59,41,18,3,2
25,292,292,4,4,0,1,0
15,293,293,57,57,0,1,0
32,325,325,6,6,0,1,0
8,328,328,7,7,0,1,0
11,359,359,16,16,0,1,0
12,365,365,10,10,0,1,0
24,365,365,10,10,0,1,0
18,375,375,24,24,0,1,0
39,393,393,32,13,19,2,1
26,401,401,25,13,12,2,1
20,403,403,8,8,0,1,0
19,412,412,1,1,0,1,0
40,415,415,2,2,0,1,0
31,418,418,36,24,12,4,3
35,431,431,97,23,74,4,3
13,453,453,2,2,0,1,0
33,482,482,121,33,88,4,3

11,120,120,1,1,0,1,0
24,121,121,1,1,0,1,0
47,122,122,9,9,0,1,0
42,127,127,4,4,0,1,0
4,137,137,4,4,0,1,0
36,137,137,9,9,0,1,0
44,143,143,4,4,0,1,0
48,153,153,36,13,23,3,2
5,156,156,27,27,0,1,0
16,159,159,7,7,0,1,0
34,162,162,3,3,0,1,0
28,164,164,1,1,0,1,0
22,189,189,58,30,28,3,2
43,193,193,1,1,0,1,0
41,203,203,19,19,0,1,0
8,204,204,4,4,0,1,0
1,206,206,5,2,3,2,1
0,207,207,11,1,10,3,2
26,216,216,1,1,0,1,0
7,217,217,10,10,0,1,0
9,236,236,8,8,0,1,0
38,243,243,41,41,0,1,0
33,250,250,17,17,0,1,0
2,278,278,7,7,0,1,0
27,287,287,13,13,0,1,0
25,298,298,15,15,0,1,0
35,303,303,28,28,0,1,0
12,312,312,25,25,0,1,0
21,327,327,34,7,27,4,3
20,335,335,5,5,0,1,0
29,338,338,19,19,0,1,0
30,342,342,125,125,0,1,0
17,354,354,54,54,0,1,0
45,359,359,79,13,66,4,3
6,363,363,34,34,0,1,0
40,363,363,16,4,12,2,1
31,384,384,22,2,20,2,1
39,397,397,16,16,0,1,0
13,401,401,19,11,8,3,2
18,408,408,34,17,17,3,2
3,420,420,22,13,9,2,1
14,424,424,105,95,10,3,2
37,432,432,27,8,19,4,3
10,451,451,15,15,0,1,0
23,469,469,10,2,8,3,2
19,489,489,2,2,0,1,0
32,489,489,53,53,0,1,0
15,494,494,16,16,0,1,0
46,500,500,85,85,0,1,0

20,100,100,6,6,0,1,0
10,168,168,49,15,34,3,2
27,169,169,34,5,29,2,1
28,174,174,17,8,9,2,1
29,175,175,2,2,0,1,0
34,190,190,29,3,26,2,1
2,191,191,1,1,0,1,0
22,215,215,12,12,0,1,0
17,220,220,39,6,33,4,3
11,225,225,15,15,0,1,0
35,235,235,16,5,11,4,3
3,237,237,7,7,0,1,0
4,244,244,7,1,6,3,2
25,259,259,13,7,6,2,1
36,279,279,75,43,32,2,1
9,302,302,63,63,0,1,0
1,308,308,1,1,0,1,0
38,312,312,1,1,0,1,0
8,323,323,12,12,0,1,0
24,337,337,38,38,0,1,0
12,340,340,10,10,0,1,0
33,358,358,84,4,80,3,2
31,360,360,6,6,0,1,0
18,382,382,60,22,38,3,2
14,385,385,34,34,0,1,0
26,399,399,10,10,0,1,0
32,401,401,69,69,0,1,0
0,404,404,29,29,0,1,0
6,411,411,3,3,0,1,0
19,420,420,54,26,28,3,2
23,420,420,116,116,0,1,0
13,422,422,84,84,0,1,0
7,428,428,77,77,0,1,0
37,447,447,12,12,0,1,0
30,456,456,46,46,0,1,0
5,458,458,59,59,0,1,0
16,468,468,10,10,0,1,0
15,490,490,20,20,0,1,0
21,491,491,6,6,0,1,0

9,103,103,11,4,7,2,1
16,109,109,27,15,12,4,3
6,121,121,24,24,0,1,0
23,126,126,25,3,22,3,2
24,134,134,10,2,8,3,2
2,144,144,8,1,7,2,1
13,151,151,13,13,0,1,0
22,154,154,15,15,0,1,0
28,167,167,28,6,22,3,2
10,195,195,4,4,0,1,0
18,197,197,3,3,0,1,0
0,210,210,32,32,0,1,0
11,225,225,25,25,0,1,0
19,271,271,30,12,18,2,1
17,271,271,19,9,10,3,2
29,273,273,9,3,6,2,1
7,306,306,86,61,25,2,1
25,310,310,13,1,12,4,3
26,320,320,35,1,34,2,1
3,332,332,112,28,84,3,2
15,346,346,16,16,0,1,0
14,351,351,11,5,6,3,2
21,352,352,14,14,0,1,0
27,359,359,33,19,14,3,2
5,384,384,112,82,30,2,1
8,388,388,66,1,65,4,3
12,406,406,116,65,51,3,2
20,408,408,32,32,0,1,0
4,415,415,44,44,0,1,0
1,486,486,90,16,74,3,2

14,108,108,2,2,0,1,0
51,119,119,5,2,3,2,1
6,139,139,1,1,0,1,0
8,149,149,17,17,0,1,0
23,165,165,13,1,12,2,1
35,166,166,2,2,0,1,0
37,171,171,28,28,0,1,0
32,186,186,7,7,0,1,0
47,208,208,4,4,0,1,0
24,210,210,1,1,0,1,0
7,211,211,1,1,0,1,0
21,211,211,17,1,16,3,2
42,227,227,15,4,11,2,1
36,250,250,10,10,0,1,0
46,252,252,2,2,0,1,0
10,287,287,29,5,24,3,2
27,287,287,32,32,0,1,0
22,297,297,31,31,0,1,0
9,297,297,8,8,0,1,0
1,331,331,1,1,0,1,0
26,332,332,3,3,0,1,0
33,342,342,60,32,28,4,3
17,343,343,24,4,20,3,2
20,345,345,47,47,0,1,0
5,349,349,6,6,0,1,0
45,349,349,119,119,0,1,0
12,351,351,39,7,32,4,3
43,358,358,55,55,0,1,0
0,359,359,41,41,0,1,0
28,362,362,50,50,0,1,0
30,368,368,48,48,0,1,0
15,369,369,6,6,0,1,0
19,375,375,19,10,9,4,3
50,376,376,23,23,0,1,0
3,381,381,1,1,0,1,0
41,381,381,43,43,0,1,0
34,389,389,17,17,0,1,0
18,389,389,8,8,0,1,0
29,393,393,32,32,0,1,0
25,403,403,2,2,0,1,0
4,408,408,2,2,0,1,0
16,410,410,65,65,0,1,0
2,430,430,8,8,0,1,0
44,433,433,54,8,46,2,1
40,443,443,11,11,0,1,0
48,443,443,11,1,10,2,1
49,444,444,33,33,0,1,0
13,446,446,21,3,18,3,2
38,475,475,124,40,84,4,3
39,476,476,88,88,0,1,0
11,497,497,37,29,8,3,2
31,498,498,1,1,0,1,0

11,100,100,12,4,8,2,1
35,101,101,36,2,34,3,2
6,102,102,9,9,0,1,0
10,107,107,1,1,0,1,0
34,107,107,5,5,0,1,0
5,115,115,6,6,0,1,0
4,121,121,34,9,25,2,1
8,133,133,2,2,0,1,0
1,156,156,31,31,0,1,0
20,158,158,9,4,5,2,1
0,168,168,28,28,0,1,0
31,215,215,2,2,0,1,0
19,219,219,15,15,0,1,0
27,235,235,8,2,6,3,2
24,243,243,5,5,0,1,0
18,245,245,89,29,60,3,2
36,265,265,17,7,10,2,1
32,284,284,8,4,4,2,1
16,289,289,26,12,14,2,1
28,315,315,60,25,35,2,1
2,331,331,42,22,20,2,1
13,333,333,3,3,0,1,0
14,335,335,33,33,0,1,0
23,340,340,19,5,14,3,2
25,354,354,12,4,8,2,1
3,358,358,26,12,14,3,2
26,376,376,32,32,0,1,0
21,380,380,75,12,63,4,3
22,380,380,9,1,8,2,1
7,415,415,22,6,16,3,2
30,425,425,64,64,0,1,0
17,432,432,7,7,0,1,0
15,470,470,140,140,0,1,0
12,472,472,1,1,0,1,0
29,479,479,11,11,0,1,0
33,480,480,60,60,0,1,0
9,489,489,100,100,0,1,0

26,127,127,4,4,0,1,0
14,159,159,1,1,0,1,0
29,188,188,28,28,0,1,0
30,193,193,15,15,0,1,0
24,200,200,37,18,19,2,1
16,221,221,43,43,0,1,0
17,224,224,13,7,6,3,2
6,244,244,50,50,0,1,0
9,244,244,11,11,0,1,0
34,265,265,4,4,0,1,0
28,274,274,8,8,0,1,0
13,277,277,127,127,0,1,0
0,277,277,49,49,0,1,0
10,284,284,4,4,0,1,0
20,298,298,1,1,0,1,0
33,303,303,14,4,10,3,2
31,306,306,11,11,0,1,0
11,319,319,34,9,25,3,2
19,328,328,33,21,12,4,3
21,350,350,54,54,0,1,0
2,351,351,14,14,0,1,0
5,366,366,36,36,0,1,0
15,366,366,26,26,0,1,0
18,389,389,21,13,8,3,2
35,420,420,92,34,58,3,2
23,421,421,47,47,0,1,0
1,426,426,71,50,21,4,3
27,458,458,63,14,49,2,1
12,463,463,31,31,0,1,0
3,472,472,44,38,6,3,2
4,482,482,46,46,0,1,0
32,492,492,84,60,24,4,3
7,494,494,1,1,0,1,0
8,494,494,30,23,7,2,1
22,495,495,23,11,12,4,3
25,497,497,159,153,6,3,2

9,109,109,8,1,7,2,1
6,115,115,26,26,0,1,0
7,117,117,29,29,0,1,0
36,118,118,7,4,3,2,1
4,126,126,1,1,0,1,0
24,154,154,99,1,98,3,2
26,174,174,14,5,9,2,1
25,176,176,24,8,16,2,1
20,178,178,8,8,0,1,0
17,187,187,6,6,0,1,0
29,195,195,26,4,22,2,1
5,196,196,44,44,0,1,0
14,206,206,14,8,6,3,2
19,235,235,24,24,0,1,0
30,252,252,4,4,0,1,0
11,255,255,6,6,0,1,0
23,272,272,34,16,18,2,1
15,314,314,15,8,7,2,1
22,318,318,12,4,8,2,1
16,334,334,9,9,0,1,0
34,351,351,4,4,0,1,0
8,352,352,23,8,15,2,1
1,364,364,4,4,0,1,0
33,372,372,35,35,0,1,0
35,380,380,15,15,0,1,0
3,385,385,21,3,18,2,1
37,397,397,15,15,0,1,0
18,402,402,82,58,24,3,2
13,409,409,11,11,0,1,0
21,411,411,36,36,0,1,0
10,436,436,132,132,0,1,0
31,446,446,25,25,0,1,0
32,454,454,8,8,0,1,0
0,461,461,49,49,0,1,0
28,474,474,69,69,0,1,0
27,487,487,36,24,12,2,1
12,490,490,18,3,15,4,3
2,498,498,58,34,24,3,2

11,127,127,10,10,0,1,0
24,135,135,6,1,5,2,1
32,148,148,26,12,14,3,2
18,150,150,3,3,0,1,0
0,154,154,46,6,40,2,1
1,154,154,7,1,6,3,2
9,156,156,4,4,0,1,0
12,158,158,98,49,49,2,1
10,163,163,3,3,0,1,0
5,194,194,12,4,8,2,1
27,211,211,8,5,3,2,1
16,228,228,42,42,0,1,0
2,245,245,7,7,0,1,0
23,256,256,10,10,0,1,0
20,263,263,56,10,46,3,2
7,274,274,15,15,0,1,0
26,279,279,6,6,0,1,0
13,279,279,17,17,0,1,0
28,289,289,34,16,18,2,1
29,296,296,14,14,0,1,0
3,310,310,46,46,0,1,0
21,316,316,12,2,10,3,2
19,322,322,1,1,0,1,0
25,336,336,7,3,4,2,1
14,343,343,8,8,0,1,0
8,345,345,86,6,80,3,2
22,347,347,28,16,12,4,3
17,372,372,73,43,30,3,2
4,375,375,60,60,0,1,0
6,388,388,20,14,6,2,1
30,401,401,137,86,51,4,3
15,444,444,17,5,12,4,3
31,487,487,144,12,132,4,3

28,102,102,20,20,0,1,0
6,105,105,13,13,0,1,0
31,108,108,1,1,0,1,0
19,119,119,25,25,0,1,0
7,119,119,8,5,3,2,1
22,131,131,3,3,0,1,0
12,136,136,1,1,0,1,0
8,144,144,20,20,0,1,0
26,166,166,13,13,0,1,0
0,169,169,13,13,0,1,0
14,170,170,46,46,0,1,0
3,172,172,49,9,40,3,2
11,179,179,6,6,0,1,0
34,189,189,20,15,5,2,1
21,218,218,8,4,4,2,1
29,231,231,11,3,8,2,1
20,235,235,18,10,8,2,1
33,275,275,4,4,0,1,0
9,282,282,10,3,7,2,1
38,284,284,51,33,18,2,1
39,291,291,23,23,0,1,0
16,311,311,1,1,0,1,0
2,339,339,5,1,4,2,1
36,343,343,75,75,0,1,0
10,350,350,1,1,0,1,0
27,372,372,3,3,0,1,0
30,383,383,64,64,0,1,0
15,391,391,2,2,0,1,0
13,395,395,62,62,0,1,0
5,397,397,15,7,8,3,2
32,405,405,62,47,15,4,3
23,409,409,29,29,0,1,0
18,422,422,41,41,0,1,0
24,426,426,10,2,8,3,2
37,452,452,102,92,10,3,2
1,453,453,70,70,0,1,0
4,457,457,43,43,0,1,0
35,458,458,95,86,9,4,3
25,476,476,48,13,35,3,2
17,481,481,4,4,0,1,0

23,123,123,3,3,0,1,0
20,124,124,48,42,6,3,2
21,128,128,7,3,4,2,1
14,157,157,7,1,6,3,2
2,178,178,12,4,8,3,2
30,187,187,2,2,0,1,0
19,195,195,15,15,0,1,0
34,204,204,121,121,0,1,0
31,205,205,11,11,0,1,0
8,207,207,7,7,0,1,0
4,222,222,11,11,0,1,0
27,226,226,55,11,44,2,1
39,235,235,15,9,6,3,2
12,253,253,13,4,9,3,2
33,285,285,6,6,0,1,0
3,295,295,26,11,15,2,1
0,306,306,8,8,0,1,0
36,306,306,32,14,18,3,2
41,339,339,22,2,20,3,2
16,345,345,9,9,0,1,0
1,352,352,3,3,0,1,0
22,370,370,57,8,49,2,1
5,371,371,62,15,47,3,2
28,382,382,28,28,0,1,0
9,388,388,30,4,26,2,1
18,392,392,20,8,12,4,3
40,403,403,64,42,22,2,1
24,408,408,3,3,0,1,0
13,436,436,15,15,0,1,0
38,443,443,52,52,0,1,0
35,446,446,6,2,4,2,1
25,459,459,2,2,0,1,0
29,459,459,15,15,0,1,0
11,464,464,4,4,0,1,0
10,464,464,12,5,7,2,1
26,468,468,52,52,0,1,0
37,470,470,94,49,45,2,1
6,474,474,6,1,5,2,1
17,475,475,15,9,6,3,2
32,492,492,18,18,0,1,0
7,497,497,91,91,0,1,0
15,498,498,120,112,8,2,1

17,117,117,4,4,0,1,0
25,122,122,14,14,0,1,0
1,128,128,4,4,0,1,0
8,138,138,8,5,3,2,1
39,140,140,36,36,0,1,0
42,155,155,15,9,6,3,2
24,161,161,13,13,0,1,0
21,161,161,19,19,0,1,0
6,200,200,9,9,0,1,0
22,210,210,66,66,0,1,0
5,211,211,19,2,17,2,1
12,215,215,32,6,26,2,1
28,217,217,14,14,0,1,0
23,218,218,12,12,0,1,0
29,223,223,4,4,0,1,0
41,230,230,20,20,0,1,0
13,237,237,3,3,0,1,0
4,238,238,13,13,0,1,0
18,255,255,1,1,0,1,0
27,255,255,40,40,0,1,0
33,268,268,2,2,0,1,0
34,271,271,2,2,0,1,0
2,290,290,69,69,0,1,0
14,295,295,10,10,0,1,0
15,298,298,21,21,0,1,0
9,301,301,40,28,12,2,1
37,301,301,155,122,33,4,3
16,310,310,8,2,6,3,2
35,315,315,9,9,0,1,0
31,319,319,6,2,4,2,1
32,327,327,8,2,6,2,1
3,333,333,1,1,0,1,0
11,355,355,4,4,0,1,0
0,373,373,76,76,0,1,0
10,379,379,2,2,0,1,0
7,390,390,20,9,11,2,1
26,406,406,11,11,0,1,0
20,412,412,24,10,14,2,1
43,439,439,69,69,0,1,0
30,465,465,83,69,14,3,2
40,465,465,36,36,0,1,0
38,479,479,43,16,27,2,1
36,490,490,2,2,0,1,0
19,492,492,12,3,9,4,3

10,120,120,9,5,4,2,1
0,121,121,6,6,0,1,0
8,139,139,2,2,0,1,0
23,141,141,3,3,0,1,0
5,144,144,4,4,0,1,0
12,187,187,95,60,35,2,1
7,198,198,14,14,0,1,0
17,202,202,6,6,0,1,0
3,203,203,34,34,0,1,0
14,220,220,14,14,0,1,0
26,271,271,23,23,0,1,0
20,284,284,39,39,0,1,0
24,292,292,18,4,14,2,1
19,309,309,30,30,0,1,0
31,314,314,11,11,0,1,0
15,319,319,59,26,33,2,1
1,326,326,17,17,0,1,0
6,334,334,59,59,0,1,0
13,346,346,110,110,0,1,0
2,365,365,32,32,0,1,0
25,365,365,55,31,24,3,2
4,370,370,24,10,14,3,2
28,371,371,78,29,49,4,3
21,374,374,16,16,0,1,0
27,380,380,201,142,59,4,3
9,382,382,4,1,3,2,1
11,387,387,12,12,0,1,0
32,395,395,7,1,6,3,2
30,397,397,54,54,0,1,0
18,399,399,1,1,0,1,0
29,414,414,54,31,23,2,1
22,420,420,18,18,0,1,0
34,424,424,7,1,6,3,2
33,479,479,35,35,0,1,0
16,500,500,55,55,0,1,0

14,102,102,5,5,0,1,0
4,114,114,7,2,5,2,1
24,124,124,3,3,0,1,0
17,124,124,5,1,4,2,1
27,125,125,26,26,0,1,0
34,141,141,7,4,3,2,1
15,143,143,6,6,0,1,0
33,149,149,5,5,0,1,0
26,150,150,21,21,0,1,0
36,165,165,18,18,0,1,0
7,192,192,1,1,0,1,0
21,221,221,5,5,0,1,0
5,229,229,1,1,0,1,0
31,237,237,70,4,66,3,2
23,247,247,13,7,6,3,2
35,251,251,30,30,0,1,0
2,257,257,37,27,10,2,1
10,261,261,131,131,0,1,0
12,266,266,43,27,16,2,1
32,270,270,14,14,0,1,0
9,295,295,22,22,0,1,0
30,309,309,10,1,9,2,1
28,329,329,32,32,0,1,0
1,331,331,5,5,0,1,0
0,391,391,17,9,8,2,1
25,394,394,6,1,5,2,1
13,400,400,42,42,0,1,0
11,404,404,70,70,0,1,0
3,407,407,75,27,48,3,2
22,415,415,26,26,0,1,0
29,419,419,106,54,52,3,2
20,421,421,76,54,22,2,1
19,428,428,19,8,11,2,1
16,434,434,22,7,15,4,3
6,436,436,6,6,0,1,0
8,463,463,29,14,15,2,1
37,485,485,74,74,0,1,0
18,491,491,83,63,20,3,2

33,107,107,1,1,0,1,0
12,113,113,1,1,0,1,0
1,143,143,18,18,0,1,0
4,152,152,4,4,0,1,0
28,157,157,40,25,15,4,3
22,163,163,10,6,4,2,1
17,171,171,47,29,18,4,3
2,183,183,8,8,0,1,0
34,192,192,10,2,8,3,2
7,194,194,4,4,0,1,0
5,206,206,30,30,0,1,0
30,235,235,7,7,0,1,0
38,241,241,17,8,9,4,3
36,249,249,32,32,0,1,0
21,254,254,20,17,3,2,1
9,256,256,1,1,0,1,0
14,264,264,2,2,0,1,0
0,292,292,87,7,80,4,3
25,313,313,11,11,0,1,0
31,327,327,55,55,0,1,0
35,328,328,126,57,69,4,3
6,329,329,31,31,0,1,0
23,332,332,47,47,0,1,0
8,332,332,14,14,0,1,0
32,349,349,27,27,0,1,0
10,353,353,27,27,0,1,0
16,365,365,17,17,0,1,0
37,377,377,37,24,13,4,3
39,379,379,12,12,0,1,0
24,387,387,8,8,0,1,0
19,394,394,99,21,78,4,3
11,395,395,22,1,21,4,3
3,404,404,13,13,0,1,0
29,418,418,38,38,0,1,0
13,444,444,51,5,46,2,1
18,466,466,81,67,14,2,1
27,474,474,59,30,29,2,1
26,474,474,35,35,0,1,0
20,478,478,27,7,20,2,1
15,492,492,1,1,0,1,0

35,111,111,2,2,0,1,0
28,111,111,5,2,3,2,1
39,136,136,10,10,0,1,0
18,137,137,5,5,0,1,0
16,138,138,14,14,0,1,0
6,145,145,10,1,9,4,3
5,152,152,19,4,15,4,3
23,164,164,11,3,8,2,1
41,173,173,22,22,0,1,0
11,181,181,23,23,0,1,0
9,202,202,1,1,0,1,0
31,207,207,30,30,0,1,0
3,219,219,9,3,6,3,2
13,224,224,53,27,26,2,1
15,228,228,9,9,0,1,0
7,238,238,3,3,0,1,0
4,240,240,9,5,4,2,1
27,244,244,14,14,0,1,0
17,250,250,1,1,0,1,0
33,256,256,7,7,0,1,0
12,257,257,14,14,0,1,0
21,280,280,1,1,0,1,0
2,319,319,42,42,0,1,0
29,320,320,60,60,0,1,0
38,326,326,65,35,30,3,2
10,340,340,12,8,4,2,1
20,340,340,32,32,0,1,0
43,362,362,81,3,78,4,3
22,364,364,6,6,0,1,0
24,375,375,36,2,34,2,1
45,387,387,14,14,0,1,0
34,391,391,53,32,21,2,1
30,403,403,12,12,0,1,0
44,406,406,9,9,0,1,0
25,406,406,46,46,0,1,0
37,409,409,53,53,0,1,0
1,425,425,68,68,0,1,0
8,436,436,4,4,0,1,0
40,443,443,12,12,0,1,0
36,454,454,68,6,62,3,2
14,459,459,12,2,10,3,2
19,459,459,73,3,70,3,2
42,473,473,79,45,34,3,2
32,484,484,67,34,33,4,3
26,489,489,47,35,12,3,2
0,499,499,2,2,0,1,0

35,116,116,50,50,0,1,0
40,124,124,8,8,0,1,0
5,129,129,9,9,0,1,0
17,139,139,19,10,9,4,3
26,140,140,17,17,0,1,0
37,143,143,5,5,0,1,0
24,149,149,20,20,0,1,0
36,183,183,28,28,0,1,0
23,201,201,1,1,0,1,0
27,204,204,18,10,8,2,1
6,213,213,22,1,21,4,3
32,223,223,3,3,0,1,0
31,224,224,11,1,10,3,2
11,233,233,28,17,11,2,1
33,235,235,23,23,0,1,0
19,236,236,42,24,18,4,3
38,239,239,8,8,0,1,0
7,248,248,12,3,9,3,2
18,256,256,15,9,6,2,1
20,258,258,52,6,46,4,3
22,291,291,106,13,93,4,3
15,292,292,8,8,0,1,0
1,295,295,11,11,0,1,0
14,296,296,20,20,0,1,0
16,324,324,14,14,0,1,0
30,326,326,8,8,0,1,0
12,327,327,17,5,12,2,1
28,331,331,42,42,0,1,0
25,356,356,8,1,7,2,1
39,356,356,46,12,34,3,2
8,366,366,28,28,0,1,0
21,376,376,10,10,0,1,0
13,387,387,9,9,0,1,0
3,395,395,22,17,5,2,1
2,424,424,32,32,0,1,0
29,439,439,14,1,13,2,1
4,440,440,18,14,4,2,1
0,463,463,111,88,23,2,1
10,476,476,57,21,36,4,3
34,492,492,8,8,0,1,0
9,498,498,50,50,0,1,0

16,101,101,6,6,0,1,0
11,102,102,1,1,0,1,0
23,103,103,29,9,20,3,2
0,118,118,16,6,10,2,1
26,131,131,3,3,0,1,0
5,137,137,1,1,0,1,0
20,147,147,9,9,0,1,0
34,158,158,21,2,19,2,1
15,187,187,17,17,0,1,0
1,208,208,15,8,7,2,1
28,214,214,7,7,0,1,0
18,220,220,55,55,0,1,0
9,227,227,77,77,0,1,0
3,229,229,18,8,10,2,1
4,238,238,17,4,13,2,1
7,242,242,29,2,27,2,1
14,257,257,8,2,6,2,1
24,279,279,12,12,0,1,0
35,292,292,17,17,0,1,0
22,300,300,3,3,0,1,0
27,313,313,3,3,0,1,0
25,313,313,9,1,8,2,1
33,314,314,1,1,0,1,0
10,320,320,106,48,58,3,2
31,333,333,97,26,71,3,2
8,346,346,28,12,16,2,1
12,368,368,13,13,0,1,0
32,374,374,76,70,6,2,1
6,381,381,119,89,30,3,2
2,386,386,20,20,0,1,0
13,399,399,33,33,0,1,0
17,447,447,7,7,0,1,0
29,461,461,11,11,0,1,0
19,470,470,28,28,0,1,0
30,473,473,32,8,24,2,1
21,499,499,174,174,0,1,0

24,120,120,3,3,0,1,0
27,124,124,20,10,10,2,1
29,127,127,23,7,16,4,3
22,144,144,6,2,4,2,1
12,149,149,38,24,14,4,3
11,159,159,22,22,0,1,0
9,161,161,22,15,7,2,1
10,176,176,17,17,0,1,0
16,182,182,13,13,0,1,0
33,184,184,22,22,0,1,0
14,188,188,97,60,37,4,3
8,190,190,1,1,0,1,0
20,196,196,57,15,42,4,3
30,197,197,4,4,0,1,0
36,233,233,2,2,0,1,0
3,242,242,17,7,10,3,2
5,247,247,4,4,0,1,0
32,265,265,7,7,0,1,0
13,274,274,56,16,40,2,1
31,281,281,2,2,0,1,0
21,283,283,27,27,0,1,0
0,298,298,9,4,5,2,1
1,298,298,1,1,0,1,0
19,320,320,37,37,0,1,0
34,334,334,76,11,65,3,2
15,337,337,10,10,0,1,0
7,359,359,7,3,4,2,1
18,361,361,10,10,0,1,0
26,363,363,32,23,9,4,3
6,365,365,7,7,0,1,0
25,400,400,14,11,3,2,1
2,425,425,44,44,0,1,0
23,428,428,30,1,29,2,1
28,449,449,46,19,27,4,3
17,461,461,44,44,0,1,0
4,488,488,44,2,42,4,3
35,490,490,149,108,41,2,1

38,120,120,10,10,0,1,0
40,124,124,24,24,0,1,0
42,127,127,26,26,0,1,0
20,132,132,24,7,17,2,1
23,141,141,1,1,0,1,0
25,144,144,1,1,0,1,0
15,144,144,19,6,13,2,1
13,150,150,1,1,0,1,0
12,158,158,48,48,0,1,0
0,160,160,18,8,10,2,1
39,166,166,9,1,8,3,2
31,168,168,3,3,0,1,0
32,175,175,27,2,25,2,1
22,175,175,12,2,10,2,1
6,181,181,5,5,0,1,0
24,208,208,17,17,0,1,0
1,222,222,18,15,3,2,1
10,234,234,2,2,0,1,0
47,246,246,22,2,20,2,1
8,247,247,27,13,14,3,2
43,247,247,3,3,0,1,0
3,250,250,28,6,22,4,3
46,257,257,48,48,0,1,0
14,259,259,6,6,0,1,0
18,261,261,6,6,0,1,0
37,265,265,24,24,0,1,0
41,278,278,61,58,3,2,1
28,278,278,4,4,0,1,0
17,314,314,20,11,9,2,1
29,315,315,24,15,9,4,3
11,317,317,3,3,0,1,0
30,335,335,3,3,0,1,0
19,336,336,42,10,32,3,2
35,348,348,22,14,8,3,2
34,362,362,46,46,0,1,0
36,365,365,45,45,0,1,0
45,375,375,1,1,0,1,0
4,391,391,37,19,18,4,3
9,403,403,1,1,0,1,0
7,411,411,6,6,0,1,0
26,413,413,22,11,11,2,1
5,427,427,42,1,41,2,1
33,431,431,96,31,65,4,3
27,432,432,30,30,0,1,0
44,459,459,4,4,0,1,0
21,463,463,18,18,0,1,0
2,467,467,7,3,4,2,1
16,500,500,9,3,6,2,1

24,110,110,10,1,9,2,1
28,124,124,18,6,12,3,2
12,154,154,1,1,0,1,0
16,155,155,1,1,0,1,0
31,156,156,7,7,0,1,0
32,180,180,9,9,0,1,0
21,183,183,9,3,6,3,2
15,189,189,29,29,0,1,0
29,199,199,21,21,0,1,0
5,200,200,60,19,41,2,1
19,218,218,10,2,8,2,1
10,222,222,8,8,0,1,0
4,260,260,61,17,44,2,1
14,260,260,2,2,0,1,0
23,279,279,59,59,0,1,0
26,294,294,2,2,0,1,0
27,299,299,9,9,0,1,0
9,299,299,17,17,0,1,0
20,311,311,38,32,6,3,2
8,311,311,15,15,0,1,0
7,318,318,38,38,0,1,0
30,321,321,21,2,19,2,1
1,351,351,13,4,9,4,3
11,353,353,1,1,0,1,0
3,374,374,3,3,0,1,0
2,409,409,35,9,26,3,2
0,416,416,203,151,52,3,2
18,441,441,13,13,0,1,0
13,461,461,56,44,12,4,3
25,464,464,43,43,0,1,0
17,489,489,173,139,34,4,3
22,493,493,165,111,54,4,3
6,493,493,176,89,87,4,3

20,113,113,4,1,3,2,1
13,113,113,2,2,0,1,0
8,120,120,23,9,14,3,2
22,121,121,3,3,0,1,0
16,127,127,15,7,8,2,1
10,127,127,1,1,0,1,0
33,138,138,1,1,0,1,0
24,145,145,1,1,0,1,0
51,162,162,7,3,4,2,1
40,167,167,3,3,0,1,0
49,175,175,15,15,0,1,0
25,179,179,11,2,9,4,3
0,186,186,4,4,0,1,0
17,202,202,4,4,0,1,0
44,206,206,16,6,10,3,2
28,212,212,7,7,0,1,0
39,217,217,49,37,12,4,3
45,224,224,58,58,0,1,0
38,230,230,9,9,0,1,0
4,234,234,28,6,22,3,2
18,259,259,1,1,0,1,0
12,302,302,3,3,0,1,0
32,305,305,4,4,0,1,0
46,305,305,13,13,0,1,0
15,314,314,39,13,26,2,1
30,315,315,1,1,0,1,0
26,315,315,2,2,0,1,0
42,316,316,7,7,0,1,0
9,318,318,19,8,11,2,1
27,320,320,35,28,7,2,1
1,330,330,32,32,0,1,0
5,341,341,56,26,30,3,2
48,342,342,121,47,74,3,2
43,355,355,9,9,0,1,0
2,372,372,35,1,34,2,1
11,373,373,22,22,0,1,0
31,391,391,15,15,0,1,0
29,407,407,15,4,11,2,1
21,411,411,9,3,6,2,1
19,433,433,18,14,4,2,1
34,434,434,17,7,10,3,2
36,437,437,74,50,24,3,2
37,438,438,32,2,30,2,1
41,438,438,66,66,0,1,0
3,443,443,2,2,0,1,0
23,456,456,126,95,31,2,1
35,475,475,8,8,0,1,0
14,483,483,8,8,0,1,0
47,483,483,75,28,47,3,2
52,484,484,15,5,10,3,2
7,485,485,10,10,0,1,0
50,487,487,51,3,48,3,2
6,494,494,18,18,0,1,0

4,119,119,55,55,0,1,0
30,130,130,26,26,0,1,0
23,132,132,4,4,0,1,0
3,134,134,1,1,0,1,0
27,134,134,29,29,0,1,0
1,151,151,3,3,0,1,0
11,161,161,3,3,0,1,0
13,167,167,8,8,0,1,0
12,168,168,4,4,0,1,0
32,168,168,20,3,17,4,3
16,182,182,7,1,6,3,2
31,182,182,19,19,0,1,0
33,184,184,9,9,0,1,0
35,185,185,6,6,0,1,0
0,194,194,4,4,0,1,0
22,209,209,22,22,0,1,0
9,221,221,1,1,0,1,0
18,222,222,69,69,0,1,0
20,222,222,46,20,26,3,2
17,228,228,112,19,93,4,3
14,233,233,11,11,0,1,0
7,237,237,12,12,0,1,0
6,241,241,10,10,0,1,0
25,247,247,11,11,0,1,0
28,267,267,2,2,0,1,0
26,268,268,17,3,14,3,2
36,311,311,65,65,0,1,0
19,348,348,10,10,0,1,0
15,375,375,49,13,36,4,3
8,398,398,97,97,0,1,0
34,404,404,25,25,0,1,0
5,412,412,2,2,0,1,0
2,434,434,76,24,52,4,3
24,442,442,19,19,0,1,0
21,471,471,18,18,0,1,0
29,479,479,38,38,0,1,0
10,481,481,36,21,15,2,1

21,138,138,7,3,4,2,1
8,165,165,7,7,0,1,0
28,172,172,10,10,0,1,0
16,173,173,39,39,0,1,0
35,174,174,9,4,5,2,1
13,201,201,19,1,18,4,3
39,202,202,45,45,0,1,0
7,214,214,23,11,12,4,3
20,221,221,21,18,3,2,1
19,240,240,14,14,0,1,0
33,241,241,18,9,9,2,1
38,261,261,122,122,0,1,0
10,266,266,14,4,10,3,2
14,276,276,59,59,0,1,0
26,291,291,32,13,19,2,1
3,304,304,30,30,0,1,0
36,307,307,29,21,8,2,1
37,308,308,79,55,24,2,1
1,325,325,21,3,18,3,2
12,333,333,9,5,4,2,1
18,358,358,59,34,25,2,1
11,368,368,15,5,10,2,1
4,373,373,15,15,0,1,0
17,379,379,25,4,21,4,3
29,381,381,23,23,0,1,0
5,390,390,2,2,0,1,0
23,391,391,28,28,0,1,0
9,393,393,44,44,0,1,0
15,417,417,47,47,0,1,0
30,419,419,9,5,4,2,1
22,425,425,11,11,0,1,0
34,433,433,67,57,10,2,1
2,439,439,19,4,15,4,3
25,472,472,1,1,0,1,0
27,475,475,22,3,19,2,1
24,476,476,10,2,8,3,2
32,484,484,33,33,0,1,0
6,486,486,15,5,10,2,1
31,487,487,34,16,18,3,2
0,497,497,102,6,96,3,2

16,103,103,14,8,6,2,1
32,105,105,11,11,0,1,0
0,107,107,1,1,0,1,0
31,153,153,26,26,0,1,0
4,167,167,17,17,0,1,0
25,177,177,2,2,0,1,0
12,183,183,29,23,6,3,2
20,184,184,31,31,0,1,0
28,191,191,2,2,0,1,0
7,219,219,10,10,0,1,0
18,247,247,8,8,0,1,0
30,250,250,34,6,28,2,1
19,262,262,35,35,0,1,0
21,265,265,45,12,33,2,1
26,266,266,2,2,0,1,0
10,266,266,12,2,10,2,1
17,267,267,12,6,6,2,1
34,269,269,43,43,0,1,0
1,276,276,16,4,12,2,1
35,282,282,6,6,0,1,0
33,290,290,2,2,0,1,0
37,296,296,4,4,0,1,0
22,302,302,6,6,0,1,0
8,311,311,19,4,15,2,1
5,328,328,26,8,18,4,3
15,334,334,1,1,0,1,0
2,347,347,52,52,0,1,0
36,356,356,2,2,0,1,0
14,357,357,8,8,0,1,0
23,363,363,15,15,0,1,0
3,383,383,80,12,68,3,2
27,389,389,80,80,0,1,0
13,393,393,77,77,0,1,0
24,395,395,135,54,81,4,3
6,410,410,108,91,17,3,2
29,434,434,81,19,62,4,3
38,445,445,69,69,0,1,0
9,488,488,50,50,0,1,0
11,492,492,24,24,0,1,0

3,104,104,4,4,0,1,0
2,106,106,2,2,0,1,0
17,122,122,21,21,0,1,0
20,133,133,26,2,24,4,3
5,133,133,5,2,3,2,1
0,142,142,25,25,0,1,0
18,145,145,5,2,3,2,1
7,156,156,11,11,0,1,0
29,175,175,3,3,0,1,0
25,200,200,22,14,8,3,2
15,207,207,17,17,0,1,0
21,221,221,9,9,0,1,0
27,231,231,18,18,0,1,0
33,259,259,90,30,60,4,3
9,265,265,6,3,3,2,1
23,272,272,31,7,24,3,2
8,273,273,72,72,0,1,0
34,273,273,6,6,0,1,0
11,293,293,3,3,0,1,0
12,301,301,41,22,19,2,1
13,302,302,52,52,0,1,0
19,323,323,15,15,0,1,0
16,328,328,1,1,0,1,0
10,337,337,18,18,0,1,0
26,340,340,1,1,0,1,0
14,345,345,2,2,0,1,0
24,347,347,46,3,43,2,1
4,354,354,41,41,0,1,0
1,373,373,187,76,111,4,3
6,373,373,73,59,14,3,2
30,413,413,68,68,0,1,0
32,416,416,19,4,15,2,1
31,423,423,39,39,0,1,0
22,472,472,60,60,0,1,0
28,473,473,93,67,26,2,1

40,116,116,1,1,0,1,0
9,126,126,8,8,0,1,0
0,129,129,1,1,0,1,0
32,171,171,24,9,15,2,1
14,186,186,3,3,0,1,0
22,196,196,5,2,3,2,1
35,199,199,44,3,41,2,1
17,200,200,11,11,0,1,0
19,204,204,34,34,0,1,0
2,216,216,3,3,0,1,0
5,217,217,55,55,0,1,0
33,217,217,13,13,0,1,0
45,219,219,78,78,0,1,0
44,234,234,26,26,0,1,0
36,243,243,49,49,0,1,0
13,259,259,46,15,31,2,1
25,263,263,4,4,0,1,0
3,266,266,63,63,0,1,0
24,277,277,43,5,38,3,2
7,285,285,20,20,0,1,0
38,291,291,19,7,12,4,3
28,316,316,5,1,4,2,1
10,323,323,9,9,0,1,0
39,330,330,10,10,0,1,0
4,339,339,7,1,6,3,2
26,357,357,6,3,3,2,1
34,378,378,39,2,37,2,1
21,383,383,9,9,0,1,0
29,392,392,33,33,0,1,0
18,392,392,9,2,7,2,1
11,396,396,16,16,0,1,0
27,400,400,59,35,24,4,3
8,409,409,19,2,17,2,1
37,410,410,4,4,0,1,0
41,420,420,8,4,4,2,1
20,421,421,15,15,0,1,0
30,427,427,29,29,0,1,0
23,430,430,29,1,28,3,2
12,437,437,17,17,0,1,0
42,442,442,12,6,6,3,2
1,448,448,27,15,12,3,2
31,455,455,1,1,0,1,0
15,460,460,36,8,28,4,3
16,479,479,69,28,41,2,1
6,496,496,11,3,8,2,1
43,497,497,133,31,102,4,3

26,101,101,4,4,0,1,0
7,107,107,13,13,0,1,0
17,108,108,11,11,0,1,0
27,116,116,15,6,9,4,3
0,124,124,7,7,0,1,0
1,163,163,4,4,0,1,0
9,169,169,14,14,0,1,0
5,198,198,13,3,10,3,2
15,215,215,39,27,12,3,2
12,218,218,8,8,0,1,0
32,247,247,8,8,0,1,0
14,254,254,12,12,0,1,0
29,259,259,29,26,3,2,1
4,267,267,75,75,0,1,0
19,286,286,16,16,0,1,0
33,286,286,61,35,26,2,1
31,311,311,50,3,47,4,3
22,314,314,32,32,0,1,0
6,327,327,90,81,9,2,1
18,340,340,26,19,7,2,1
24,349,349,133,88,45,4,3
8,357,357,1,1,0,1,0
2,366,366,19,6,13,4,3
3,380,380,111,39,72,4,3
35,392,392,20,2,18,4,3
13,393,393,24,6,18,4,3
20,417,417,1,1,0,1,0
28,418,418,43,43,0,1,0
25,419,419,3,3,0,1,0
23,444,444,62,44,18,3,2
21,445,445,57,45,12,2,1
34,456,456,30,30,0,1,0
11,461,461,53,10,43,2,1
30,462,462,16,13,3,2,1
10,475,475,62,15,47,2,1
16,476,476,36,36,0,1,0

16,120,120,16,4,12,2,1
11,121,121,4,4,0,1,0
37,133,133,45,39,6,2,1
9,153,153,23,11,12,3,2
8,155,155,1,1,0,1,0
6,167,167,3,3,0,1,0
34,193,193,29,3,26,3,2
19,215,215,111,69,42,4,3
31,219,219,22,3,19,2,1
17,245,245,21,4,17,2,1
7,246,246,1,1,0,1,0
12,252,252,8,5,3,2,1
26,264,264,38,16,22,4,3
13,265,265,16,16,0,1,0
24,310,310,26,26,0,1,0
3,312,312,1,1,0,1,0
15,317,317,37,19,18,4,3
10,324,324,59,59,0,1,0
4,333,333,9,9,0,1,0
25,372,372,44,5,39,4,3
14,375,375,23,23,0,1,0
30,376,376,70,40,30,4,3
38,399,399,26,26,0,1,0
18,409,409,36,21,15,4,3
36,412,412,20,20,0,1,0
1,412,412,32,32,0,1,0
23,416,416,24,24,0,1,0
22,417,417,6,6,0,1,0
32,421,421,9,3,6,2,1
0,431,431,1,1,0,1,0
5,435,435,56,56,0,1,0
33,442,442,77,77,0,1,0
21,464,464,54,6,48,3,2
20,464,464,14,14,0,1,0
28,464,464,17,17,0,1,0
27,490,490,64,64,0,1,0
35,495,495,8,1,7,2,1
29,498,498,49,26,23,2,1
2,500,500,89,69,20,3,2

17,100,100,19,3,16,2,1
13,107,107,11,1,10,3,2
25,126,126,3,3,0,1,0
21,128,128,10,10,0,1,0
16,128,128,27,1,26,3,2
3,129,129,13,13,0,1,0
12,130,130,56,56,0,1,0
26,143,143,11,7,4,2,1
9,148,148,13,8,5,2,1
10,169,169,33,33,0,1,0
1,170,170,35,9,26,2,1
24,179,179,8,8,0,1,0
8,193,193,5,1,4,2,1
4,200,200,64,64,0,1,0
7,223,223,16,16,0,1,0
20,258,258,58,2,56,3,2
2,260,260,3,3,0,1,0
28,264,264,54,54,0,1,0
5,286,286,1,1,0,1,0
31,288,288,14,5,9,4,3
23,299,299,3,3,0,1,0
27,301,301,45,45,0,1,0
18,308,308,5,5,0,1,0
32,348,348,6,6,0,1,0
19,383,383,19,19,0,1,0
29,383,383,22,12,10,2,1
0,387,387,62,62,0,1,0
11,419,419,77,71,6,3,2
14,428,428,48,20,28,2,1
22,433,433,13,6,7,2,1
30,455,455,135,8,127,4,3
15,493,493,51,17,34,4,3
6,500,500,1,1,0,1,0

13,100,100,25,25,0,1,0
7,104,104,10,10,0,1,0
19,121,121,8,3,5,2,1
36,122,122,7,7,0,1,0
32,123,123,7,7,0,1,0
40,162,162,1,1,0,1,0
4,164,164,1,1,0,1,0
31,164,164,10,4,6,2,1
24,189,189,43,6,37,4,3
11,190,190,2,2,0,1,0
20,195,195,11,11,0,1,0
39,213,213,26,26,0,1,0
8,217,217,6,6,0,1,0
23,227,227,5,5,0,1,0
34,230,230,37,25,12,4,3
21,235,235,18,18,0,1,0
15,236,236,11,5,6,3,2
33,243,243,39,29,10,2,1
5,257,257,6,3,3,2,1
10,264,264,3,3,0,1,0
9,269,269,47,47,0,1,0
29,271,271,50,50,0,1,0
12,279,279,37,22,15,2,1
25,304,304,15,15,0,1,0
27,305,305,20,2,18,4,3
38,326,326,37,1,36,2,1
28,337,337,36,36,0,1,0
18,361,361,48,4,44,2,1
22,361,361,24,12,12,4,3
6,375,375,13,9,4,2,1
2,376,376,12,4,8,3,2
14,404,404,75,54,21,2,1
26,411,411,27,27,0,1,0
41,414,414,44,32,12,2,1
3,445,445,84,40,44,2,1
35,464,464,81,81,0,1,0
17,477,477,23,5,18,2,1
1,487,487,5,5,0,1,0
37,488,488,57,57,0,1,0
16,490,490,36,36,0,1,0
30,491,491,38,38,0,1,0
0,491,491,74,66,8,3,2

10,104,104,5,5,0,1,0
35,110,110,17,17,0,1,0
18,112,112,1,1,0,1,0
39,128,128,15,4,11,2,1
4,131,131,3,3,0,1,0
21,157,157,23,16,7,2,1
33,158,158,10,5,5,2,1
2,183,183,13,13,0,1,0
25,193,193,11,4,7,2,1
41,200,200,14,14,0,1,0
8,200,200,17,17,0,1,0
12,201,201,7,7,0,1,0
17,205,205,6,6,0,1,0
14,222,222,3,3,0,1,0
0,223,223,47,47,0,1,0
34,231,231,3,3,0,1,0
24,231,231,10,1,9,2,1
32,238,238,6,6,0,1,0
28,251,251,34,24,10,3,2
29,274,274,13,1,12,3,2
5,292,292,90,75,15,2,1
20,307,307,13,13,0,1,0
37,312,312,1,1,0,1,0
31,324,324,196,118,78,4,3
1,325,325,59,19,40,2,1
19,333,333,8,8,0,1,0
7,352,352,46,46,0,1,0
23,354,354,25,25,0,1,0
26,364,364,50,50,0,1,0
15,371,371,17,14,3,2,1
38,373,373,42,2,40,2,1
30,379,379,12,9,3,2,1
36,426,426,30,30,0,1,0
11,433,433,48,27,21,2,1
6,438,438,2,2,0,1,0
13,439,439,101,7,94,3,2
3,455,455,43,8,35,4,3
9,459,459,4,4,0,1,0
16,463,463,17,17,0,1,0
22,481,481,6,6,0,1,0
40,483,483,48,48,0,1,0
27,487,487,41,41,0,1,0

42,120,120,16,16,0,1,0
5,123,123,6,3,3,2,1
8,134,134,1,1,0,1,0
11,139,139,1,1,0,1,0
38,147,147,5,2,3,2,1
13,154,154,34,19,15,4,3
15,157,157,1,1,0,1,0
41,165,165,21,14,7,2,1
17,210,210,64,64,0,1,0
29,214,214,1,1,0,1,0
37,221,221,37,23,14,3,2
26,221,221,52,38,14,3,2
22,226,226,47,22,25,2,1
20,230,230,7,7,0,1,0
3,241,241,2,2,0,1,0
24,297,297,6,2,4,2,1
25,301,301,21,8,13,2,1
40,303,303,11,3,8,3,2
6,325,325,5,5,0,1,0
2,333,333,11,1,10,3,2
36,336,336,119,94,25,2,1
14,342,342,44,44,0,1,0
7,348,348,31,31,0,1,0
31,352,352,96,18,78,4,3
10,353,353,1,1,0,1,0
21,376,376,15,8,7,2,1
33,392,392,18,18,0,1,0
9,400,400,10,4,6,2,1
35,401,401,23,16,7,2,1
18,405,405,5,5,0,1,0
32,407,407,64,36,28,3,2
30,408,408,27,1,26,2,1
16,410,410,179,174,5,2,1
0,417,417,5,5,0,1,0
34,423,423,41,41,0,1,0
27,423,423,5,5,0,1,0
19,438,438,34,6,28,2,1
28,459,459,4,4,0,1,0
12,475,475,18,18,0,1,0
23,479,479,8,8,0,1,0
1,486,486,55,27,28,2,1
4,488,488,9,9,0,1,0
39,493,493,18,18,0,1,0

8,119,119,7,7,0,1,0
21,128,128,14,5,9,2,1
27,149,149,5,2,3,2,1
16,152,152,3,3,0,1,0
12,165,165,2,2,0,1,0
3,171,171,4,4,0,1,0
17,183,183,19,3,16,2,1
20,222,222,26,18,8,2,1
10,224,224,1,1,0,1,0
9,224,224,16,6,10,3,2
31,250,250,20,20,0,1,0
1,254,254,36,36,0,1,0
6,255,255,64,64,0,1,0
37,260,260,46,46,0,1,0
25,262,262,38,4,34,3,2
30,263,263,3,3,0,1,0
7,269,269,15,15,0,1,0
28,271,271,46,40,6,2,1
4,285,285,54,14,40,3,2
13,289,289,29,11,18,3,2
24,293,293,1,1,0,1,0
18,296,296,14,8,6,2,1
2,302,302,67,67,0,1,0
23,327,327,12,4,8,2,1
14,338,338,43,43,0,1,0
32,358,358,37,37,0,1,0
29,362,362,37,27,10,2,1
26,372,372,11,7,4,2,1
33,391,391,15,7,8,3,2
0,405,405,25,25,0,1,0
11,415,415,55,29,26,2,1
36,415,415,66,66,0,1,0
22,431,431,6,6,0,1,0
5,435,435,15,4,11,2,1
35,445,445,131,131,0,1,0
15,457,457,112,84,28,2,1
34,458,458,37,19,18,3,2
19,495,495,117,42,75,4,3

32,113,113,25,25,0,1,0
8,127,127,10,10,0,1,0
31,139,139,49,49,0,1,0
18,144,144,5,5,0,1,0
19,148,148,4,4,0,1,0
2,150,150,56,43,13,2,1
7,175,175,1,1,0,1,0
3,182,182,69,30,39,4,3
5,184,184,12,4,8,3,2
22,200,200,60,60,0,1,0
15,205,205,2,2,0,1,0
26,241,241,10,10,0,1,0
27,246,246,6,6,0,1,0
17,275,275,31,9,22,2,1
30,276,276,13,4,9,4,3
20,282,282,6,6,0,1,0
11,284,284,14,2,12,2,1
14,295,295,48,48,0,1,0
4,338,338,103,103,0,1,0
16,354,354,8,8,0,1,0
10,354,354,33,33,0,1,0
25,362,362,74,74,0,1,0
21,370,370,14,14,0,1,0
33,381,381,91,25,66,4,3
6,383,383,8,8,0,1,0
24,399,399,28,9,19,4,3
9,413,413,52,44,8,3,2
29,417,417,62,62,0,1,0
12,421,421,34,34,0,1,0
0,430,430,51,51,0,1,0
28,455,455,2,2,0,1,0
1,482,482,12,4,8,3,2
23,484,484,10,1,9,4,3
13,497,497,10,10,0,1,0

35,107,107,14,1,13,2,1
24,131,131,11,11,0,1,0
28,132,132,15,6,9,2,1
5,145,145,56,56,0,1,0
12,159,159,4,4,0,1,0
4,162,162,43,13,30,2,1
11,164,164,16,16,0,1,0
17,180,180,33,33,0,1,0
23,194,194,7,1,6,2,1
2,216,216,17,9,8,3,2
27,223,223,1,1,0,1,0
32,240,240,45,45,0,1,0
9,241,241,18,18,0,1,0
22,244,244,9,9,0,1,0
8,246,246,29,29,0,1,0
7,251,251,56,44,12,2,1
14,258,258,17,17,0,1,0
13,259,259,15,15,0,1,0
0,264,264,31,31,0,1,0
10,279,279,8,3,5,2,1
25,285,285,53,53,0,1,0
16,323,323,14,14,0,1,0
6,329,329,17,17,0,1,0
3,332,332,18,18,0,1,0
15,340,340,22,22,0,1,0
20,358,358,7,1,6,2,1
1,359,359,54,54,0,1,0
26,367,367,19,19,0,1,0
31,396,396,115,115,0,1,0
19,398,398,27,27,0,1,0
29,403,403,8,8,0,1,0
30,427,427,45,45,0,1,0
33,439,439,27,19,8,3,2
21,456,456,4,4,0,1,0
34,478,478,37,37,0,1,0
18,492,492,132,132,0,1,0

39,113,113,6,6,0,1,0
5,132,132,2,2,0,1,0
30,145,145,15,15,0,1,0
10,165,165,23,23,0,1,0
28,172,172,1,1,0,1,0
9,190,190,2,2,0,1,0
41,216,216,10,6,4,2,1
22,223,223,7,3,4,2,1
29,230,230,4,4,0,1,0
6,256,256,11,1,10,2,1
18,261,261,1,1,0,1,0
33,271,271,17,8,9,2,1
15,279,279,18,9,9,2,1
26,288,288,7,7,0,1,0
31,290,290,5,5,0,1,0
17,292,292,122,36,86,3,2
34,303,303,90,90,0,1,0
7,306,306,13,1,12,2,1
19,315,315,3,3,0,1,0
8,317,317,42,12,30,3,2
38,327,327,92,92,0,1,0
32,329,329,65,65,0,1,0
35,333,333,73,70,3,2,1
36,337,337,17,17,0,1,0
25,345,345,39,39,0,1,0
27,349,349,55,50,5,2,1
23,372,372,2,2,0,1,0
11,384,384,30,30,0,1,0
16,396,396,14,14,0,1,0
40,398,398,57,47,10,2,1
24,403,403,6,6,0,1,0
3,411,411,7,7,0,1,0
21,418,418,39,39,0,1,0
13,420,420,30,12,18,3,2
0,421,421,62,62,0,1,0
37,427,427,48,40,8,2,1
1,446,446,40,3,37,4,3
2,462,462,42,42,0,1,0
20,462,462,90,24,66,4,3
12,465,465,51,33,18,3,2
4,480,480,10,2,8,3,2
14,495,495,21,21,0,1,0

37,101,101,2,2,0,1,0
0,112,112,1,1,0,1,0
17,114,114,1,1,0,1,0
4,122,122,20,20,0,1,0
1,151,151,2,2,0,1,0
27,151,151,2,2,0,1,0
21,157,157,9,5,4,2,1
34,161,161,14,14,0,1,0
15,169,169,13,7,6,3,2
24,187,187,4,4,0,1,0
12,210,210,47,6,41,3,2
36,219,219,53,53,0,1,0
30,223,223,13,7,6,3,2
26,233,233,31,31,0,1,0
6,242,242,29,7,22,2,1
32,261,261,2,2,0,1,0
25,275,275,17,17,0,1,0
33,289,289,10,10,0,1,0
5,298,298,94,42,52,3,2
19,301,301,71,38,33,4,3
29,331,331,40,40,0,1,0
7,332,332,83,45,38,2,1
22,340,340,34,34,0,1,0
16,381,381,26,26,0,1,0
28,382,382,29,29,0,1,0
10,382,382,1,1,0,1,0
3,390,390,5,5,0,1,0
14,404,404,21,15,6,3,2
18,409,409,11,11,0,1,0
20,411,411,98,73,25,2,1
13,414,414,11,8,3,2,1
35,422,422,39,39,0,1,0
9,434,434,36,36,0,1,0
23,435,435,52,3,49,2,1
8,446,446,99,67,32,4,3
11,455,455,46,27,19,2,1
31,473,473,108,108,0,1,0
2,489,489,61,10,51,4,3

17,112,112,1,1,0,1,0
5,120,120,4,1,3,2,1
26,124,124,57,31,26,2,1
6,126,126,11,11,0,1,0
2,144,144,53,53,0,1,0
25,170,170,10,10,0,1,0
33,178,178,14,14,0,1,0
16,193,193,36,24,12,3,2
23,205,205,3,3,0,1,0
19,209,209,11,2,9,2,1
29,216,216,10,4,6,2,1
24,217,217,18,14,4,2,1
34,246,246,106,102,4,2,1
4,250,250,22,8,14,2,1
36,266,266,15,3,12,2,1
30,274,274,9,1,8,2,1
27,280,280,11,4,7,2,1
18,281,281,140,88,52,3,2
20,287,287,19,19,0,1,0
37,289,289,25,21,4,2,1
14,289,289,12,12,0,1,0
3,295,295,1,1,0,1,0
21,324,324,9,5,4,2,1
22,333,333,28,13,15,2,1
28,339,339,30,22,8,3,2
1,345,345,21,3,18,4,3
11,358,358,58,31,27,2,1
15,379,379,3,3,0,1,0
9,386,386,5,5,0,1,0
13,390,390,23,11,12,4,3
12,390,390,37,7,30,3,2
7,408,408,18,10,8,3,2
31,423,423,52,25,27,4,3
32,433,433,41,41,0,1,0
35,445,445,5,5,0,1,0
0,461,461,3,3,0,1,0
10,489,489,21,7,14,2,1
8,489,489,46,46,0,1,0

14,119,119,8,3,5,2,1
6,139,139,20,2,18,3,2
12,152,152,28,7,21,2,1
1,173,173,28,10,18,2,1
5,174,174,20,8,12,3,2
11,181,181,30,30,0,1,0
9,189,189,21,1,20,2,1
26,194,194,24,24,0,1,0
27,207,207,21,21,0,1,0
22,213,213,42,18,24,3,2
21,278,278,4,1,3,2,1
0,295,295,46,5,41,3,2
17,311,311,29,29,0,1,0
13,322,322,12,4,8,2,1
19,325,325,38,38,0,1,0
18,346,346,22,10,12,2,1
28,363,363,50,50,0,1,0
23,364,364,86,62,24,3,2
20,378,378,4,4,0,1,0
2,381,381,48,48,0,1,0
30,402,402,46,46,0,1,0
31,411,411,101,17,84,4,3
25,414,414,49,25,24,3,2
16,430,430,13,4,9,2,1
24,430,430,4,4,0,1,0
10,433,433,35,35,0,1,0
8,438,438,64,11,53,4,3
4,440,440,38,38,0,1,0
29,480,480,91,55,36,3,2
15,484,484,9,9,0,1,0
3,487,487,17,3,14,2,1
7,499,499,195,195,0,1,0

20,106,106,22,22,0,1,0
4,108,108,4,4,0,1,0
41,110,110,8,8,0,1,0
2,113,113,46,46,0,1,0
23,113,113,1,1,0,1,0
17,123,123,4,1,3,2,1
27,124,124,16,16,0,1,0
26,133,133,26,26,0,1,0
0,135,135,2,2,0,1,0
5,138,138,1,1,0,1,0
32,138,138,48,23,25,4,3
10,139,139,21,5,16,3,2
29,145,145,23,11,12,4,3
39,166,166,7,1,6,2,1
40,189,189,4,4,0,1,0
6,197,197,6,6,0,1,0
15,206,206,19,19,0,1,0
19,213,213,2,2,0,1,0
21,222,222,27,27,0,1,0
28,240,240,18,10,8,2,1
9,244,244,61,20,41,2,1
33,249,249,9,9,0,1,0
22,257,257,2,2,0,1,0
14,260,260,19,19,0,1,0
12,281,281,1,1,0,1,0
11,282,282,65,14,51,4,3
30,302,302,2,2,0,1,0
8,313,313,15,10,5,2,1
35,339,339,53,53,0,1,0
7,347,347,8,2,6,2,1
37,369,369,92,78,14,3,2
31,376,376,2,2,0,1,0
25,387,387,64,24,40,3,2
13,387,387,1,1,0,1,0
1,419,419,19,19,0,1,0
38,420,420,15,3,12,4,3
18,443,443,40,36,4,2,1
16,452,452,5,5,0,1,0
34,472,472,57,21,36,2,1
36,475,475,3,3,0,1,0
3,497,497,3,3,0,1,0
24,500,500,55,9,46,2,1

5,100,100,9,1,8,2,1
10,103,103,4,4,0,1,0
14,120,120,7,7,0,1,0
30,130,130,5,2,3,2,1
28,143,143,1,1,0,1,0
17,144,144,35,35,0,1,0
0,149,149,28,28,0,1,0
25,164,164,26,1,25,2,1
6,175,175,1,1,0,1,0
21,190,190,79,46,33,4,3
3,234,234,7,7,0,1,0
8,267,267,41,41,0,1,0
26,267,267,20,20,0,1,0
22,272,272,68,3,65,4,3
19,282,282,50,8,42,4,3
9,304,304,8,3,5,2,1
33,337,337,44,44,0,1,0
7,350,350,9,3,6,2,1
29,352,352,19,19,0,1,0
20,354,354,5,2,3,2,1
32,386,386,26,26,0,1,0
24,388,388,20,20,0,1,0
13,398,398,164,159,5,2,1
4,406,406,152,114,38,4,3
15,409,409,38,15,23,2,1
31,409,409,18,18,0,1,0
27,424,424,12,12,0,1,0
11,428,428,105,40,65,3,2
2,437,437,8,8,0,1,0
18,454,454,16,16,0,1,0
12,466,466,6,6,0,1,0
16,485,485,16,16,0,1,0
23,497,497,13,13,0,1,0
1,500,500,114,64,50,4,3

14,102,102,45,9,36,3,2
12,112,112,12,12,0,1,0
28,122,122,12,12,0,1,0
34,131,131,32,5,27,2,1
6,138,138,42,42,0,1,0
26,160,160,22,19,3,2,1
9,167,167,1,1,0,1,0
10,184,184,18,18,0,1,0
3,212,212,6,6,0,1,0
27,221,221,16,16,0,1,0
35,257,257,24,4,20,3,2
11,262,262,2,2,0,1,0
5,273,273,8,8,0,1,0
21,279,279,13,13,0,1,0
15,280,280,12,12,0,1,0
2,284,284,10,10,0,1,0
30,320,320,6,6,0,1,0
16,333,333,3,3,0,1,0
0,335,335,28,1,27,4,3
8,343,343,23,5,18,4,3
4,345,345,35,4,31,2,1
33,354,354,44,35,9,4,3
20,357,357,26,19,7,2,1
7,371,371,6,6,0,1,0
36,378,378,19,19,0,1,0
32,390,390,4,4,0,1,0
24,395,395,17,17,0,1,0
13,414,414,86,86,0,1,0
29,419,419,54,54,0,1,0
1,422,422,55,35,20,3,2
17,425,425,23,7,16,3,2
22,427,427,69,69,0,1,0
25,437,437,1,1,0,1,0
19,445,445,57,57,0,1,0
31,456,456,51,32,19,2,1
18,479,479,63,46,17,2,1
23,490,490,150,96,54,3,2
37,494,494,42,42,0,1,0

2,116,116,7,7,0,1,0
27,149,149,1,1,0,1,0
8,158,158,6,6,0,1,0
1,176,176,2,2,0,1,0
24,188,188,61,33,28,2,1
14,203,203,6,6,0,1,0
6,226,226,6,6,0,1,0
13,235,235,30,1,29,2,1
16,240,240,32,32,0,1,0
23,263,263,50,50,0,1,0
5,273,273,53,53,0,1,0
32,283,283,7,7,0,1,0
15,286,286,1,1,0,1,0
11,329,329,203,139,64,3,2
26,331,331,47,47,0,1,0
21,334,334,9,9,0,1,0
28,360,360,4,4,0,1,0
25,361,361,70,70,0,1,0
34,365,365,22,22,0,1,0
4,370,370,22,10,12,4,3
18,378,378,74,38,36,3,2
35,383,383,61,16,45,2,1
29,391,391,44,44,0,1,0
19,397,397,36,36,0,1,0
20,405,405,4,4,0,1,0
33,421,421,41,22,19,2,1
3,444,444,50,50,0,1,0
17,451,451,28,28,0,1,0
12,453,453,60,24,36,4,3
7,454,454,5,5,0,1,0
22,455,455,72,14,58,3,2
9,457,457,86,26,60,4,3
30,462,462,3,3,0,1,0
10,482,482,2,2,0,1,0
31,484,484,29,5,24,4,3
0,496,496,76,42,34,3,2

8,100,100,49,41,8,3,2
26,108,108,7,3,4,2,1
22,109,109,7,2,5,2,1
25,114,114,5,1,4,2,1
6,138,138,19,2,17,2,1
34,154,154,1,1,0,1,0
17,160,160,36,27,9,2,1
19,167,167,6,6,0,1,0
0,186,186,7,7,0,1,0
35,190,190,15,15,0,1,0
3,212,212,3,3,0,1,0
13,213,213,21,16,5,2,1
12,228,228,8,8,0,1,0
30,230,230,59,19,40,3,2
36,256,256,25,25,0,1,0
5,277,277,2,2,0,1,0
18,277,277,19,11,8,2,1
16,278,278,30,30,0,1,0
24,280,280,12,12,0,1,0
11,303,303,3,3,0,1,0
33,305,305,58,22,36,3,2
37,344,344,78,59,19,2,1
1,346,346,31,31,0,1,0
15,354,354,20,13,7,2,1
29,375,375,25,11,14,2,1
21,379,379,20,20,0,1,0
14,383,383,29,29,0,1,0
2,385,385,15,15,0,1,0
40,388,388,22,22,0,1,0
10,395,395,66,66,0,1,0
4,414,414,20,14,6,3,2
23,415,415,33,33,0,1,0
38,431,431,3,3,0,1,0
7,442,442,6,6,0,1,0
20,444,444,9,9,0,1,0
27,445,445,89,89,0,1,0
28,462,462,12,3,9,2,1
31,476,476,101,10,91,3,2
39,482,482,102,1,101,4,3
32,485,485,6,6,0,1,0
9,488,488,34,34,0,1,0

14,100,100,10,10,0,1,0
4,100,100,9,9,0,1,0
36,101,101,4,4,0,1,0
5,125,125,27,9,18,2,1
7,129,129,1,1,0,1,0
35,153,153,11,11,0,1,0
3,162,162,16,16,0,1,0
18,167,167,3,3,0,1,0
13,167,167,1,1,0,1,0
12,171,171,44,22,22,3,2
9,173,173,2,2,0,1,0
6,194,194,16,11,5,2,1
21,197,197,1,1,0,1,0
23,205,205,21,21,0,1,0
1,208,208,36,24,12,3,2
34,228,228,49,14,35,2,1
24,230,230,6,6,0,1,0
19,250,250,12,12,0,1,0
0,263,263,15,15,0,1,0
16,274,274,102,39,63,4,3
15,288,288,50,37,13,2,1
29,298,298,8,8,0,1,0
10,307,307,2,2,0,1,0
8,309,309,27,5,22,2,1
37,349,349,41,32,9,4,3
32,352,352,55,10,45,4,3
26,356,356,48,27,21,4,3
17,359,359,15,1,14,2,1
2,386,386,4,4,0,1,0
33,394,394,62,62,0,1,0
25,396,396,23,23,0,1,0
27,402,402,72,12,60,4,3
11,410,410,37,37,0,1,0
31,413,413,32,32,0,1,0
30,450,450,51,25,26,3,2
28,452,452,159,87,72,4,3
22,485,485,23,19,4,2,1
20,490,490,3,3,0,1,0

19,112,112,6,6,0,1,0
20,113,113,23,23,0,1,0
23,118,118,13,13,0,1,0
10,119,119,1,1,0,1,0
3,140,140,15,9,6,2,1
4,145,145,19,9,10,2,1
13,155,155,15,15,0,1,0
32,159,159,26,26,0,1,0
36,183,183,9,3,6,3,2
40,193,193,69,9,60,4,3
31,193,193,3,3,0,1,0
11,194,194,11,11,0,1,0
16,215,215,12,12,0,1,0
8,222,222,34,4,30,4,3
2,229,229,7,7,0,1,0
25,234,234,43,43,0,1,0
33,237,237,72,41,31,2,1
35,242,242,2,2,0,1,0
7,253,253,7,1,6,2,1
29,264,264,12,12,0,1,0
41,265,265,8,8,0,1,0
34,271,271,9,9,0,1,0
0,288,288,6,6,0,1,0
1,289,289,3,3,0,1,0
21,309,309,39,26,13,2,1
9,313,313,5,5,0,1,0
15,337,337,11,11,0,1,0
22,350,350,18,2,16,3,2
42,371,371,11,11,0,1,0
6,371,371,47,47,0,1,0
12,380,380,52,29,23,2,1
26,385,385,45,45,0,1,0
27,387,387,4,4,0,1,0
14,403,403,60,60,0,1,0
39,410,410,46,36,10,2,1
28,423,423,68,22,46,4,3
37,433,433,2,2,0,1,0
18,454,454,21,7,14,3,2
24,461,461,60,30,30,3,2
38,464,464,54,15,39,2,1
17,474,474,38,22,16,2,1
5,478,478,34,22,12,2,1
30,483,483,30,15,15,4,3

5,110,110,1,1,0,1,0
24,110,110,1,1,0,1,0
8,113,113,21,21,0,1,0
32,149,149,1,1,0,1,0
12,166,166,20,6,14,3,2
34,173,173,1,1,0,1,0
19,174,174,30,8,22,2,1
29,175,175,31,16,15,4,3
10,176,176,35,17,18,2,1
21,183,183,36,20,16,3,2
38,194,194,31,5,26,4,3
16,195,195,3,3,0,1,0
27,197,197,38,38,0,1,0
23,199,199,3,3,0,1,0
25,204,204,24,24,0,1,0
37,211,211,50,50,0,1,0
33,219,219,5,5,0,1,0
39,222,222,6,6,0,1,0
2,222,222,1,1,0,1,0
18,224,224,14,8,6,2,1
17,227,227,24,6,18,2,1
11,249,249,6,6,0,1,0
3,252,252,25,14,11,2,1
26,261,261,12,12,0,1,0
6,263,263,64,64,0,1,0
36,267,267,5,5,0,1,0
0,274,274,19,1,18,4,3
22,286,286,16,10,6,2,1
31,288,288,53,53,0,1,0
28,317,317,14,14,0,1,0
7,334,334,19,13,6,2,1
4,365,365,12,12,0,1,0
15,415,415,76,69,7,2,1
35,415,415,161,134,27,2,1
20,426,426,11,1,10,3,2
9,438,438,11,7,4,2,1
1,470,470,5,5,0,1,0
30,473,473,21,17,4,2,1
14,475,475,45,45,0,1,0
13,485,485,78,78,0,1,0

33,105,105,17,7,10,3,2
40,108,108,6,6,0,1,0
42,112,112,23,23,0,1,0
38,120,120,15,1,14,3,2
6,124,124,17,8,9,2,1
28,127,127,1,1,0,1,0
19,138,138,8,8,0,1,0
14,156,156,1,1,0,1,0
2,160,160,10,2,8,3,2
13,168,168,17,17,0,1,0
44,173,173,15,15,0,1,0
34,177,177,13,13,0,1,0
26,185,185,7,2,5,2,1
11,192,192,1,1,0,1,0
31,236,236,1,1,0,1,0
23,237,237,10,10,0,1,0
16,239,239,18,10,8,3,2
43,305,305,22,22,0,1,0
24,308,308,7,7,0,1,0
35,317,317,71,8,63,4,3
22,320,320,90,12,78,3,2
4,325,325,51,30,21,2,1
8,335,335,62,56,6,3,2
12,367,367,13,8,5,2,1
9,367,367,18,18,0,1,0
10,373,373,51,4,47,2,1
18,376,376,1,1,0,1,0
20,379,379,10,10,0,1,0
7,386,386,60,22,38,2,1
37,392,392,34,34,0,1,0
25,395,395,64,64,0,1,0
36,402,402,48,27,21,4,3
1,403,403,2,2,0,1,0
17,407,407,10,10,0,1,0
32,411,411,140,140,0,1,0
3,419,419,16,4,12,4,3
15,429,429,7,7,0,1,0
39,444,444,18,18,0,1,0
5,444,444,43,10,33,4,3
41,460,460,47,2,45,2,1
0,478,478,8,1,7,2,1
27,485,485,4,4,0,1,0
30,489,489,44,29,15,4,3
21,492,492,1,1,0,1,0
29,497,497,50,50,0,1,0

20,101,101,2,2,0,1,0
16,101,101,6,6,0,1,0
21,107,107,1,1,0,1,0
26,115,115,16,16,0,1,0
6,155,155,4,4,0,1,0
24,187,187,8,8,0,1,0
0,210,210,1,1,0,1,0
40,210,210,4,4,0,1,0
37,214,214,22,22,0,1,0
2,225,225,1,1,0,1,0
29,225,225,20,14,6,3,2
11,238,238,7,7,0,1,0
3,254,254,3,3,0,1,0
36,260,260,10,10,0,1,0
35,261,261,6,6,0,1,0
13,262,262,76,76,0,1,0
19,269,269,62,21,41,4,3
31,295,295,39,39,0,1,0
15,299,299,11,11,0,1,0
32,314,314,9,1,8,3,2
4,315,315,2,2,0,1,0
39,328,328,50,50,0,1,0
33,332,332,45,45,0,1,0
8,335,335,31,4,27,2,1
12,345,345,1,1,0,1,0
34,372,372,8,8,0,1,0
18,385,385,32,18,14,2,1
38,393,393,47,47,0,1,0
28,404,404,121,121,0,1,0
27,407,407,63,13,50,3,2
23,418,418,8,3,5,2,1
1,422,422,49,49,0,1,0
17,429,429,55,55,0,1,0
10,430,430,10,10,0,1,0
9,437,437,17,5,12,3,2
41,458,458,11,11,0,1,0
5,458,458,105,69,36,4,3
14,485,485,96,74,22,3,2
30,491,491,60,60,0,1,0
25,497,497,132,48,84,3,2
7,498,498,62,11,51,3,2
22,500,500,68,68,0,1,0

1,127,127,1,1,0,1,0
36,129,129,19,16,3,2,1
28,140,140,11,11,0,1,0
23,150,150,8,1,7,2,1
27,151,151,13,2,11,2,1
43,152,152,30,1,29,2,1
42,158,158,16,16,0,1,0
2,180,180,19,11,8,3,2
38,180,180,2,2,0,1,0
6,182,182,20,20,0,1,0
11,192,192,2,2,0,1,0
29,203,203,36,9,27,2,1
34,223,223,61,14,47,2,1
30,224,224,33,6,27,2,1
5,233,233,2,2,0,1,0
19,235,235,5,2,3,2,1
9,238,238,54,36,18,4,3
40,266,266,21,21,0,1,0
35,275,275,3,3,0,1,0
14,279,279,28,28,0,1,0
31,280,280,26,2,24,3,2
7,286,286,32,32,0,1,0
22,292,292,20,20,0,1,0
18,304,304,1,1,0,1,0
24,304,304,35,12,23,2,1
10,320,320,24,3,21,4,3
44,339,339,4,4,0,1,0
21,355,355,23,23,0,1,0
26,356,356,4,4,0,1,0
12,360,360,3,3,0,1,0
41,360,360,91,37,54,4,3
4,368,368,117,74,43,2,1
8,371,371,9,9,0,1,0
0,373,373,11,11,0,1,0
32,396,396,10,10,0,1,0
37,409,409,5,5,0,1,0
16,410,410,1,1,0,1,0
15,433,433,59,59,0,1,0
13,435,435,72,72,0,1,0
25,445,445,8,4,4,2,1
17,460,460,37,3,34,2,1
3,462,462,13,5,8,2,1
20,478,478,4,4,0,1,0
39,485,485,72,12,60,4,3
33,499,499,40,2,38,3,2

5,104,104,2,2,0,1,0
19,105,105,8,8,0,1,0
6,122,122,10,10,0,1,0
25,124,124,10,4,6,3,2
22,155,155,5,5,0,1,0
12,168,168,19,1,18,2,1
28,176,176,23,23,0,1,0
11,178,178,52,3,49,4,3
16,181,181,1,1,0,1,0
15,195,195,23,23,0,1,0
7,219,219,78,57,21,4,3
24,228,228,24,24,0,1,0
21,238,238,11,5,6,3,2
32,258,258,4,4,0,1,0
23,271,271,82,37,45,4,3
30,280,280,72,72,0,1,0
17,284,284,11,11,0,1,0
26,305,305,7,7,0,1,0
0,347,347,73,31,42,2,1
14,349,349,47,12,35,2,1
29,351,351,23,23,0,1,0
20,387,387,83,54,29,2,1
1,394,394,37,37,0,1,0
8,398,398,4,4,0,1,0
13,401,401,13,13,0,1,0
27,403,403,23,23,0,1,0
18,410,410,2,2,0,1,0
3,417,417,45,3,42,3,2
31,420,420,97,63,34,3,2
10,431,431,45,2,43,4,3
4,440,440,114,62,52,4,3
2,464,464,19,7,12,3,2
9,467,467,84,39,45,2,1

1,103,103,3,3,0,1,0
16,105,105,18,3,15,4,3
30,105,105,48,39,9,4,3
31,106,106,5,5,0,1,0
21,116,116,10,10,0,1,0
32,118,118,1,1,0,1,0
8,152,152,37,19,18,4,3
23,161,161,34,11,23,2,1
34,167,167,9,1,8,3,2
20,173,173,9,9,0,1,0
6,175,175,1,1,0,1,0
4,204,204,26,4,22,3,2
39,214,214,18,18,0,1,0
26,222,222,20,20,0,1,0
24,229,229,6,2,4,2,1
41,236,236,18,18,0,1,0
33,263,263,10,10,0,1,0
5,284,284,71,71,0,1,0
10,285,285,56,18,38,4,3
13,317,317,14,4,10,2,1
40,323,323,88,42,46,3,2
19,330,330,11,2,9,4,3
12,337,337,1,1,0,1,0
35,339,339,13,1,12,2,1
0,341,341,4,4,0,1,0
29,349,349,75,57,18,2,1
37,389,389,42,25,17,2,1
9,390,390,29,8,21,4,3
27,407,407,8,3,5,2,1
14,409,409,53,53,0,1,0
38,415,415,21,21,0,1,0
17,417,417,7,7,0,1,0
25,417,417,24,24,0,1,0
15,424,424,17,5,12,4,3
7,426,426,23,7,16,2,1
3,428,428,8,8,0,1,0
28,464,464,15,15,0,1,0
2,465,465,22,7,15,4,3
18,472,472,50,9,41,2,1
36,472,472,26,7,19,2,1
22,475,475,3,3,0,1,0
11,487,487,75,72,3,2,1

24,111,111,30,2,28,2,1
19,113,113,3,3,0,1,0
11,118,118,3,3,0,1,0
22,122,122,22,6,16,2,1
1,137,137,2,2,0,1,0
3,144,144,1,1,0,1,0
2,160,160,6,6,0,1,0
23,170,170,1,1,0,1,0
18,226,226,10,3,7,2,1
10,230,230,13,13,0,1,0
5,260,260,39,25,14,3,2
17,272,272,47,11,36,2,1
31,288,288,5,2,3,2,1
35,290,290,22,22,0,1,0
0,299,299,37,19,18,3,2
21,301,301,46,46,0,1,0
15,301,301,16,16,0,1,0
16,313,313,21,21,0,1,0
32,321,321,1,1,0,1,0
36,324,324,124,66,58,3,2
33,329,329,42,42,0,1,0
6,343,343,39,34,5,2,1
13,349,349,107,48,59,4,3
27,351,351,5,5,0,1,0
30,373,373,43,40,3,2,1
14,382,382,55,7,48,2,1
8,387,387,42,42,0,1,0
28,394,394,34,10,24,2,1
20,415,415,3,3,0,1,0
4,444,444,70,24,46,3,2
29,459,459,25,21,4,2,1
9,460,460,15,15,0,1,0
26,473,473,3,3,0,1,0
12,476,476,37,3,34,2,1
7,477,477,120,93,27,4,3
34,482,482,116,116,0,1,0
25,499,499,60,53,7,2,1

22,123,123,12,8,4,2,1
33,131,131,3,3,0,1,0
37,159,159,19,13,6,3,2
17,159,159,5,1,4,2,1
30,176,176,2,2,0,1,0
38,182,182,29,15,14,3,2
18,192,192,3,3,0,1,0
7,210,210,2,2,0,1,0
25,237,237,69,69,0,1,0
13,245,245,4,4,0,1,0
8,252,252,12,12,0,1,0
35,255,255,26,2,24,2,1
34,260,260,1,1,0,1,0
19,262,262,3,3,0,1,0
36,264,264,29,5,24,2,1
14,269,269,94,94,0,1,0
2,272,272,23,23,0,1,0
26,290,290,7,1,6,2,1
12,291,291,55,28,27,2,1
39,303,303,6,6,0,1,0
24,312,312,66,38,28,3,2
16,312,312,9,9,0,1,0
28,318,318,4,4,0,1,0
0,323,323,22,19,3,2,1
5,326,326,1,1,0,1,0
9,338,338,110,50,60,4,3
32,341,341,23,13,10,3,2
27,361,361,23,23,0,1,0
3,372,372,31,11,20,2,1
20,384,384,30,10,20,3,2
31,388,388,18,18,0,1,0
6,404,404,31,1,30,4,3
1,430,430,26,26,0,1,0
29,432,432,218,188,30,2,1
23,441,441,5,5,0,1,0
4,441,441,50,10,40,3,2
11,468,468,3,3,0,1,0
40,491,491,28,28,0,1,0
15,498,498,24,11,13,2,1
10,499,499,123,107,16,2,1
21,500,500,4,4,0,1,0

36,103,103,7,7,0,1,0
20,109,109,6,6,0,1,0
27,136,136,34,22,12,2,1
35,159,159,18,14,4,2,1
21,167,167,3,3,0,1,0
5,170,170,3,3,0,1,0
30,170,170,9,1,8,2,1
34,171,171,12,12,0,1,0
1,178,178,24,24,0,1,0
11,180,180,14,14,0,1,0
17,188,188,16,16,0,1,0
6,190,190,27,20,7,2,1
15,226,226,15,15,0,1,0
9,226,226,35,8,27,4,3
12,238,238,13,13,0,1,0
4,252,252,45,45,0,1,0
13,258,258,3,3,0,1,0
16,261,261,62,31,31,2,1
19,263,263,22,2,20,4,3
7,283,283,13,13,0,1,0
37,289,289,1,1,0,1,0
10,299,299,25,20,5,2,1
31,317,317,25,25,0,1,0
24,321,321,88,26,62,3,2
33,348,348,93,93,0,1,0
26,349,349,14,14,0,1,0
25,363,363,21,21,0,1,0
22,365,365,4,4,0,1,0
14,365,365,6,6,0,1,0
2,374,374,87,15,72,4,3
32,375,375,31,4,27,2,1
29,388,388,27,27,0,1,0
28,417,417,2,2,0,1,0
3,418,418,23,2,21,4,3
23,435,435,144,144,0,1,0
8,437,437,34,13,21,4,3
0,441,441,40,40,0,1,0
18,472,472,65,44,21,2,1

27,102,102,4,4,0,1,0
30,106,106,8,8,0,1,0
31,130,130,1,1,0,1,0
14,133,133,5,1,4,2,1
16,137,137,29,29,0,1,0
25,176,176,5,5,0,1,0
0,193,193,29,29,0,1,0
13,204,204,16,6,10,2,1
19,213,213,42,21,21,2,1
18,221,221,49,40,9,4,3
26,231,231,7,7,0,1,0
15,249,249,6,1,5,2,1
12,261,261,37,37,0,1,0
24,261,261,34,13,21,2,1
22,293,293,112,112,0,1,0
29,309,309,11,1,10,3,2
8,318,318,46,46,0,1,0
6,319,319,25,25,0,1,0
9,334,334,14,14,0,1,0
2,338,338,12,12,0,1,0
10,352,352,90,45,45,2,1
3,373,373,74,39,35,4,3
11,387,387,16,16,0,1,0
4,401,401,65,65,0,1,0
23,406,406,41,41,0,1,0
20,428,428,22,8,14,3,2
5,431,431,32,32,0,1,0
7,459,459,135,69,66,4,3
28,467,467,104,21,83,4,3
1,467,467,133,82,51,4,3
17,468,468,14,14,0,1,0
21,481,481,18,6,12,3,2

34,102,102,12,4,8,2,1
2,109,109,12,12,0,1,0
9,140,140,10,7,3,2,1
40,162,162,22,5,17,2,1
14,167,167,3,3,0,1,0
29,172,172,19,9,10,2,1
7,191,191,1,1,0,1,0
11,198,198,61,61,0,1,0
35,205,205,4,4,0,1,0
37,206,206,47,47,0,1,0
16,207,207,9,9,0,1,0
5,226,226,14,2,12,4,3
42,229,229,21,21,0,1,0
20,247,247,58,26,32,3,2
28,249,249,34,34,0,1,0
41,255,255,29,5,24,3,2
17,255,255,7,7,0,1,0
27,286,286,5,1,4,2,1
4,290,290,11,11,0,1,0
25,306,306,9,3,6,3,2
10,307,307,20,20,0,1,0
6,312,312,19,19,0,1,0
3,312,312,5,5,0,1,0
12,324,324,41,29,12,3,2
30,325,325,21,21,0,1,0
36,347,347,1,1,0,1,0
21,359,359,44,10,34,2,1
32,365,365,37,37,0,1,0
0,365,365,15,3,12,4,3
26,386,386,34,26,8,2,1
19,386,386,11,1,10,3,2
23,411,411,74,74,0,1,0
24,427,427,144,96,48,4,3
38,427,427,90,51,39,4,3
13,439,439,22,22,0,1,0
31,442,442,23,8,15,2,1
8,442,442,3,3,0,1,0
1,453,453,16,16,0,1,0
18,453,453,69,69,0,1,0
15,459,459,43,43,0,1,0
22,462,462,2,2,0,1,0
33,469,469,13,13,0,1,0
39,479,479,21,21,0,1,0

32,100,100,3,3,0,1,0
9,120,120,8,8,0,1,0
2,128,128,16,16,0,1,0
27,129,129,24,17,7,2,1
12,136,136,13,13,0,1,0
0,141,141,12,12,0,1,0
22,143,143,4,4,0,1,0
8,146,146,4,4,0,1,0
36,149,149,28,28,0,1,0
4,153,153,14,5,9,2,1
35,181,181,7,7,0,1,0
3,194,194,86,8,78,3,2
16,201,201,4,1,3,2,1
30,210,210,15,15,0,1,0
25,211,211,9,2,7,2,1
26,254,254,46,46,0,1,0
21,259,259,96,96,0,1,0
1,262,262,1,1,0,1,0
37,266,266,9,9,0,1,0
14,267,267,6,6,0,1,0
5,291,291,7,7,0,1,0
13,324,324,4,1,3,2,1
33,369,369,26,26,0,1,0
23,374,374,14,14,0,1,0
20,399,399,95,95,0,1,0
11,403,403,38,38,0,1,0
7,428,428,66,36,30,2,1
17,430,430,79,31,48,4,3
29,430,430,22,16,6,2,1
6,437,437,22,22,0,1,0
28,444,444,13,8,5,2,1
34,466,466,70,70,0,1,0
31,467,467,35,8,27,4,3
19,477,477,43,43,0,1,0
18,482,482,22,4,18,3,2
10,484,484,84,84,0,1,0
24,492,492,6,6,0,1,0
15,495,495,90,15,75,4,3

34,115,115,12,3,9,2,1
24,122,122,39,39,0,1,0
3,127,127,1,1,0,1,0
18,130,130,5,5,0,1,0
8,134,134,2,2,0,1,0
39,144,144,31,31,0,1,0
17,177,177,17,17,0,1,0
2,184,184,15,15,0,1,0
10,189,189,30,30,0,1,0
12,196,196,15,15,0,1,0
35,199,199,56,51,5,2,1
16,199,199,15,2,13,4,3
21,204,204,12,2,10,2,1
31,218,218,31,31,0,1,0
33,219,219,35,35,0,1,0
7,230,230,45,6,39,4,3
4,237,237,21,21,0,1,0
11,238,238,14,14,0,1,0
6,239,239,49,49,0,1,0
28,240,240,6,6,0,1,0
22,251,251,8,8,0,1,0
5,275,275,11,11,0,1,0
32,304,304,16,1,15,4,3
9,307,307,3,3,0,1,0
36,308,308,116,105,11,2,1
30,340,340,4,4,0,1,0
23,349,349,8,8,0,1,0
19,354,354,41,12,29,2,1
1,360,360,89,89,0,1,0
37,386,386,24,21,3,2,1
15,386,386,29,29,0,1,0
20,402,402,20,4,16,2,1
14,419,419,4,1,3,2,1
26,420,420,9,3,6,2,1
27,424,424,1,1,0,1,0
29,436,436,1,1,0,1,0
25,439,439,6,3,3,2,1
13,483,483,25,12,13,2,1
0,495,495,101,101,0,1,0
38,499,499,22,22,0,1,0

9,126,126,12,12,0,1,0
31,127,127,5,5,0,1,0
12,128,128,7,7,0,1,0
39,129,129,9,9,0,1,0
14,139,139,6,6,0,1,0
30,168,168,23,23,0,1,0
8,192,192,59,24,35,2,1
1,211,211,5,5,0,1,0
20,215,215,3,3,0,1,0
32,235,235,10,7,3,2,1
10,246,246,5,5,0,1,0
29,254,254,10,10,0,1,0
16,259,259,23,23,0,1,0
26,266,266,28,28,0,1,0
33,281,281,13,7,6,2,1
27,303,303,55,55,0,1,0
4,308,308,39,25,14,3,2
19,312,312,18,2,16,3,2
37,325,325,10,2,8,2,1
41,325,325,126,96,30,2,1
38,327,327,10,2,8,3,2
18,331,331,48,29,19,2,1
23,343,343,11,11,0,1,0
2,348,348,63,63,0,1,0
25,349,349,83,52,31,2,1
36,349,349,28,28,0,1,0
35,367,367,14,14,0,1,0
24,372,372,30,30,0,1,0
28,402,402,39,39,0,1,0
11,409,409,11,11,0,1,0
40,424,424,24,24,0,1,0
6,431,431,7,7,0,1,0
5,444,444,19,11,8,3,2
13,449,449,13,13,0,1,0
21,453,453,44,26,18,2,1
0,454,454,7,7,0,1,0
15,454,454,51,51,0,1,0
17,475,475,22,10,12,2,1
22,486,486,46,22,24,4,3
7,487,487,62,62,0,1,0
34,491,491,4,4,0,1,0
42,494,494,111,111,0,1,0
3,495,495,52,52,0,1,0

27,108,108,16,4,12,3,2
4,114,114,3,3,0,1,0
5,126,126,64,8,56,3,2
17,158,158,10,6,4,2,1
12,160,160,1,1,0,1,0
37,179,179,1,1,0,1,0
26,187,187,20,2,18,2,1
7,190,190,5,1,4,2,1
22,205,205,24,1,23,4,3
33,213,213,63,63,0,1,0
8,219,219,9,9,0,1,0
38,242,242,10,10,0,1,0
13,256,256,20,20,0,1,0
18,266,266,101,101,0,1,0
19,271,271,23,17,6,2,1
20,274,274,35,10,25,2,1
23,295,295,20,4,16,2,1
16,297,297,1,1,0,1,0
29,317,317,23,23,0,1,0
6,323,323,43,43,0,1,0
36,338,338,18,18,0,1,0
30,353,353,15,3,12,3,2
10,359,359,9,9,0,1,0
11,361,361,9,6,3,2,1
31,364,364,37,10,27,2,1
14,368,368,20,5,15,4,3
21,376,376,42,28,14,3,2
28,380,380,15,1,14,3,2
32,416,416,139,139,0,1,0
3,419,419,31,3,28,2,1
9,431,431,12,4,8,3,2
25,438,438,11,2,9,4,3
2,451,451,22,4,18,2,1
0,454,454,53,53,0,1,0
35,460,460,53,49,4,2,1
1,472,472,51,51,0,1,0
34,474,474,7,7,0,1,0
15,482,482,35,35,0,1,0
24,486,486,54,2,52,3,2

16,119,119,11,11,0,1,0
37,146,146,24,24,0,1,0
38,160,160,11,2,9,4,3
27,162,162,3,3,0,1,0
4,177,177,9,3,6,2,1
30,208,208,9,9,0,1,0
36,209,209,16,1,15,2,1
40,210,210,11,11,0,1,0
20,222,222,6,6,0,1,0
19,232,232,24,4,20,2,1
7,233,233,71,41,30,4,3
35,254,254,12,12,0,1,0
29,274,274,21,21,0,1,0
24,282,282,115,28,87,4,3
1,282,282,3,3,0,1,0
14,295,295,14,14,0,1,0
15,335,335,69,8,61,4,3
2,341,341,15,15,0,1,0
34,355,355,45,45,0,1,0
12,367,367,3,3,0,1,0
23,368,368,14,14,0,1,0
28,375,375,29,29,0,1,0
5,383,383,27,1,26,2,1
26,383,383,3,3,0,1,0
22,384,384,20,2,18,3,2
10,389,389,31,31,0,1,0
17,391,391,36,10,26,3,2
31,395,395,2,2,0,1,0
18,397,397,47,21,26,4,3
3,397,397,33,14,19,2,1
39,405,405,100,3,97,4,3
8,408,408,29,15,14,3,2
33,408,408,43,43,0,1,0
13,411,411,64,26,38,2,1
21,418,418,6,6,0,1,0
0,432,432,52,52,0,1,0
9,451,451,31,19,12,4,3
11,454,454,3,3,0,1,0
25,461,461,101,101,0,1,0
6,486,486,61,50,11,2,1
32,491,491,52,28,24,3,2

30,112,112,34,34,0,1,0
10,114,114,10,10,0,1,0
1,118,118,6,6,0,1,0
18,121,121,6,6,0,1,0
8,128,128,29,29,0,1,0
22,162,162,5,5,0,1,0
7,176,176,2,2,0,1,0
20,194,194,6,6,0,1,0
14,209,209,11,5,6,3,2
17,212,212,19,6,13,2,1
36,224,224,36,36,0,1,0
35,227,227,23,23,0,1,0
25,232,232,8,8,0,1,0
6,252,252,2,2,0,1,0
2,269,269,88,88,0,1,0
27,285,285,5,5,0,1,0
33,293,293,27,6,21,2,1
15,308,308,12,3,9,4,3
9,309,309,10,3,7,2,1
29,311,311,2,2,0,1,0
16,318,318,24,2,22,3,2
4,346,346,56,56,0,1,0
31,349,349,1,1,0,1,0
26,350,350,47,47,0,1,0
28,350,350,54,20,34,3,2
21,353,353,22,22,0,1,0
11,382,382,48,48,0,1,0
24,391,391,109,43,66,3,2
19,415,415,14,14,0,1,0
13,418,418,77,77,0,1,0
23,425,425,7,7,0,1,0
5,439,439,1,1,0,1,0
37,443,443,74,3,71,4,3
0,460,460,94,64,30,3,2
32,466,466,85,85,0,1,0
34,473,473,53,38,15,4,3
12,483,483,83,23,60,4,3
3,491,491,3,3,0,1,0

28,100,100,8,4,4,2,1
39,106,106,10,10,0,1,0
16,107,107,12,12,0,1,0
21,117,117,5,2,3,2,1
4,125,125,27,3,24,4,3
32,128,128,4,4,0,1,0
26,139,139,14,14,0,1,0
18,142,142,2,2,0,1,0
23,162,162,6,6,0,1,0
11,174,174,15,15,0,1,0
25,176,176,34,7,27,2,1
20,180,180,2,2,0,1,0
30,194,194,49,49,0,1,0
0,208,208,2,2,0,1,0
24,234,234,25,25,0,1,0
38,237,237,26,14,12,2,1
40,244,244,14,14,0,1,0
9,245,245,15,15,0,1,0
22,255,255,18,18,0,1,0
15,273,273,91,91,0,1,0
7,279,279,34,3,31,4,3
37,307,307,53,25,28,3,2
2,344,344,10,10,0,1,0
27,361,361,40,16,24,4,3
34,366,366,8,8,0,1,0
6,386,386,26,26,0,1,0
10,386,386,15,3,12,2,1
36,387,387,22,22,0,1,0
31,393,393,98,70,28,2,1
5,402,402,1,1,0,1,0
35,412,412,10,2,8,3,2
12,419,419,59,59,0,1,0
33,422,422,22,8,14,3,2
17,431,431,18,18,0,1,0
19,435,435,96,57,39,2,1
14,449,449,3,3,0,1,0
3,455,455,25,25,0,1,0
29,463,463,58,50,8,3,2
8,469,469,43,43,0,1,0
13,483,483,33,33,0,1,0
1,498,498,65,65,0,1,0

25,125,125,8,8,0,1,0
2,129,129,19,19,0,1,0
36,129,129,6,6,0,1,0
1,158,158,23,9,14,2,1
9,158,158,3,3,0,1,0
13,166,166,5,5,0,1,0
41,181,181,35,35,0,1,0
12,183,183,13,7,6,2,1
23,200,200,16,16,0,1,0
0,201,201,42,42,0,1,0
11,211,211,33,33,0,1,0
6,219,219,8,8,0,1,0
7,223,223,7,1,6,3,2
14,236,236,4,1,3,2,1
5,237,237,2,2,0,1,0
39,243,243,2,2,0,1,0
38,262,262,21,21,0,1,0
40,270,270,57,48,9,4,3
20,295,295,36,24,12,2,1
17,310,310,6,6,0,1,0
35,320,320,19,19,0,1,0
10,326,326,33,21,12,4,3
29,331,331,22,13,9,4,3
4,341,341,8,3,5,2,1
34,351,351,2,2,0,1,0
16,363,363,13,5,8,3,2
24,372,372,57,25,32,2,1
28,375,375,40,2,38,3,2
22,386,386,2,2,0,1,0
31,391,391,20,5,15,4,3
30,394,394,158,134,24,3,2
33,420,420,33,1,32,3,2
32,430,430,81,9,72,4,3
19,434,434,33,24,9,4,3
27,451,451,31,8,23,2,1
26,456,456,18,18,0,1,0
3,456,456,18,10,8,2,1
8,456,456,13,5,8,2,1
42,475,475,13,7,6,3,2
37,483,483,39,30,9,4,3
18,484,484,76,76,0,1,0
15,489,489,97,71,26,3,2
21,496,496,72,2,70,3,2

2,104,104,9,9,0,1,0
19,148,148,1,1,0,1,0
14,151,151,10,4,6,2,1
33,161,161,1,1,0,1,0
7,195,195,15,15,0,1,0
15,224,224,16,8,8,3,2
0,242,242,22,22,0,1,0
27,248,248,4,4,0,1,0
18,286,286,17,9,8,2,1
11,293,293,20,4,16,3,2
31,311,311,9,3,6,3,2
1,339,339,12,12,0,1,0
17,341,341,4,4,0,1,0
9,345,345,121,68,53,4,3
28,358,358,165,84,81,4,3
24,363,363,11,5,6,2,1
22,383,383,2,2,0,1,0
5,387,387,46,46,0,1,0
21,389,389,1,1,0,1,0
25,389,389,10,10,0,1,0
8,390,390,22,10,12,4,3
3,404,404,70,60,10,2,1
26,405,405,29,18,11,2,1
34,406,406,135,135,0,1,0
13,424,424,8,2,6,3,2
12,429,429,198,165,33,4,3
16,430,430,162,162,0,1,0
32,438,438,31,17,14,2,1
30,446,446,5,5,0,1,0
10,448,448,13,7,6,2,1
20,467,467,145,28,117,4,3
23,476,476,38,8,30,4,3
29,485,485,8,8,0,1,0
4,485,485,72,16,56,3,2
6,486,486,23,23,0,1,0

26,104,104,2,2,0,1,0
33,105,105,18,18,0,1,0
9,130,130,1,1,0,1,0
20,137,137,19,19,0,1,0
34,196,196,11,11,0,1,0
8,199,199,1,1,0,1,0
12,201,201,6,6,0,1,0
18,203,203,10,1,9,2,1
19,210,210,9,3,6,2,1
6,220,220,104,104,0,1,0
32,235,235,2,2,0,1,0
29,241,241,15,15,0,1,0
13,245,245,1,1,0,1,0
15,254,254,11,11,0,1,0
21,293,293,66,30,36,2,1
11,323,323,30,12,18,3,2
30,331,331,32,22,10,3,2
25,334,334,51,2,49,2,1
5,347,347,110,74,36,4,3
28,350,350,107,6,101,4,3
22,353,353,22,13,9,4,3
7,365,365,15,11,4,2,1
4,376,376,142,13,129,4,3
3,394,394,10,7,3,2,1
1,398,398,49,43,6,2,1
10,410,410,41,13,28,3,2
2,411,411,8,8,0,1,0
23,416,416,47,47,0,1,0
0,423,423,65,7,58,4,3
16,439,439,17,17,0,1,0
27,457,457,61,61,0,1,0
24,464,464,11,2,9,2,1
31,469,469,22,3,19,2,1
17,488,488,93,16,77,3,2
14,496,496,44,44,0,1,0

28,115,115,12,7,5,2,1
11,120,120,11,2,9,2,1
31,123,123,23,3,20,2,1
2,131,131,17,11,6,2,1
7,133,133,15,3,12,2,1
15,135,135,24,15,9,4,3
0,144,144,1,1,0,1,0
19,164,164,10,7,3,2,1
36,178,178,11,11,0,1,0
35,229,229,31,13,18,4,3
13,245,245,1,1,0,1,0
25,245,245,50,50,0,1,0
8,281,281,22,22,0,1,0
10,299,299,89,89,0,1,0
23,317,317,78,78,0,1,0
5,318,318,15,3,12,2,1
21,322,322,5,5,0,1,0
30,335,335,13,13,0,1,0
24,344,344,20,20,0,1,0
29,351,351,7,1,6,2,1
26,354,354,50,47,3,2,1
22,364,364,52,15,37,3,2
33,369,369,65,20,45,2,1
6,385,385,23,23,0,1,0
16,387,387,99,26,73,4,3
4,390,390,56,24,32,4,3
12,398,398,8,8,0,1,0
14,406,406,8,8,0,1,0
32,414,414,104,95,9,4,3
27,425,425,3,3,0,1,0
9,459,459,66,27,39,4,3
20,467,467,28,28,0,1,0
17,474,474,100,36,64,3,2
1,476,476,36,36,0,1,0
34,478,478,4,4,0,1,0
18,485,485,8,8,0,1,0
3,498,498,13,13,0,1,0

3,101,101,11,3,8,3,2
29,106,106,14,2,12,3,2
0,114,114,20,20,0,1,0
21,114,114,8,8,0,1,0
9,116,116,6,6,0,1,0
20,120,120,12,12,0,1,0
19,137,137,14,4,10,2,1
30,137,137,7,1,6,3,2
25,144,144,9,9,0,1,0
11,169,169,1,1,0,1,0
12,182,182,3,3,0,1,0
16,199,199,12,6,6,3,2
5,240,240,29,6,23,2,1
6,248,248,20,17,3,2,1
13,272,272,45,45,0,1,0
4,283,283,28,28,0,1,0
31,283,283,34,34,0,1,0
14,292,292,81,33,48,3,2
10,297,297,2,2,0,1,0
17,301,301,59,59,0,1,0
27,306,306,17,17,0,1,0
32,321,321,78,78,0,1,0
33,334,334,10,10,0,1,0
22,362,362,52,52,0,1,0
1,376,376,40,40,0,1,0
2,380,380,104,9,95,4,3
7,391,391,106,28,78,4,3
26,395,395,24,24,0,1,0
28,414,414,7,1,6,2,1
24,423,423,39,39,0,1,0
23,454,454,70,70,0,1,0
8,459,459,65,57,8,2,1
18,468,468,33,8,25,4,3
15,468,468,89,89,0,1,0

25,108,108,18,6,12,2,1
1,110,110,4,4,0,1,0
38,126,126,43,19,24,3,2
27,131,131,4,4,0,1,0
28,139,139,17,17,0,1,0
9,142,142,2,2,0,1,0
24,142,142,30,30,0,1,0
7,160,160,24,24,0,1,0
8,170,170,5,5,0,1,0
22,186,186,13,1,12,2,1
35,195,195,29,29,0,1,0
13,218,218,23,1,22,3,2
32,242,242,9,4,5,2,1
39,248,248,9,9,0,1,0
17,253,253,1,1,0,1,0
5,263,263,37,15,22,2,1
6,281,281,18,18,0,1,0
34,300,300,8,8,0,1,0
3,301,301,7,7,0,1,0
21,304,304,22,18,4,2,1
20,318,318,74,23,51,3,2
2,344,344,8,8,0,1,0
4,346,346,11,11,0,1,0
33,355,355,31,1,30,3,2
29,368,368,57,33,24,2,1
30,376,376,13,13,0,1,0
0,377,377,129,129,0,1,0
19,379,379,60,19,41,2,1
18,386,386,34,9,25,2,1
10,386,386,47,47,0,1,0
12,391,391,12,2,10,3,2
23,395,395,33,22,11,2,1
31,406,406,6,6,0,1,0
14,406,406,16,16,0,1,0
16,407,407,8,5,3,2,1
37,426,426,30,30,0,1,0
36,443,443,67,40,27,2,1
11,444,444,32,8,24,4,3
26,463,463,38,38,0,1,0
15,496,496,86,86,0,1,0

35,107,107,27,17,10,2,1
17,124,124,7,7,0,1,0
14,135,135,28,28,0,1,0
3,138,138,16,16,0,1,0
13,145,145,6,6,0,1,0
6,147,147,12,3,9,2,1
0,153,153,31,15,16,2,1
30,168,168,11,11,0,1,0
12,170,170,3,3,0,1,0
8,181,181,6,1,5,2,1
27,185,185,23,23,0,1,0
11,194,194,5,5,0,1,0
38,198,198,7,4,3,2,1
7,199,199,26,26,0,1,0
31,199,199,15,15,0,1,0
37,205,205,27,27,0,1,0
24,211,211,39,39,0,1,0
10,225,225,19,19,0,1,0
29,229,229,9,3,6,3,2
4,230,230,13,10,3,2,1
22,239,239,13,13,0,1,0
32,265,265,45,3,42,4,3
26,290,290,10,10,0,1,0
34,293,293,10,10,0,1,0
33,360,360,52,12,40,2,1
28,371,371,23,11,12,4,3
1,390,390,31,31,0,1,0
9,403,403,13,13,0,1,0
15,408,408,62,21,41,2,1
5,415,415,37,37,0,1,0
25,431,431,82,82,0,1,0
21,434,434,91,31,60,3,2
2,448,448,7,1,6,3,2
19,456,456,21,21,0,1,0
36,460,460,24,24,0,1,0
18,467,467,178,69,109,4,3
20,474,474,3,3,0,1,0
23,479,479,35,35,0,1,0
16,495,495,26,26,0,1,0

32,125,125,5,5,0,1,0
6,132,132,67,35,32,3,2
27,159,159,39,26,13,2,1
4,173,173,19,19,0,1,0
26,176,176,3,3,0,1,0
10,198,198,17,17,0,1,0
23,218,218,10,5,5,2,1
20,237,237,33,17,16,2,1
17,238,238,40,40,0,1,0
30,279,279,31,31,0,1,0
11,298,298,4,4,0,1,0
19,344,344,4,4,0,1,0
31,357,357,40,40,0,1,0
3,358,358,4,1,3,2,1
25,361,361,12,12,0,1,0
14,365,365,13,13,0,1,0
8,370,370,9,9,0,1,0
18,374,374,30,30,0,1,0
1,379,379,123,107,16,2,1
12,394,394,11,3,8,2,1
24,416,416,93,86,7,2,1
16,420,420,4,4,0,1,0
15,424,424,32,13,19,4,3
9,429,429,30,30,0,1,0
2,436,436,124,124,0,1,0
33,436,436,6,3,3,2,1
21,441,441,114,18,96,4,3
13,443,443,69,35,34,2,1
7,455,455,46,46,0,1,0
5,458,458,24,3,21,2,1
0,476,476,46,37,9,4,3
29,485,485,116,83,33,4,3
28,491,491,41,8,33,4,3
22,500,500,16,3,13,2,1

23,111,111,4,4,0,1,0
15,200,200,12,9,3,2,1
29,217,217,31,15,16,3,2
3,224,224,48,13,35,2,1
11,236,236,10,2,8,2,1
28,254,254,3,3,0,1,0
24,275,275,11,11,0,1,0
5,276,276,30,22,8,2,1
22,277,277,8,8,0,1,0
7,279,279,117,22,95,4,3
18,289,289,5,5,0,1,0
2,290,290,9,9,0,1,0
4,306,306,61,27,34,2,1
17,309,309,27,27,0,1,0
8,316,316,4,4,0,1,0
14,319,319,38,35,3,2,1
25,321,321,23,23,0,1,0
34,337,337,2,2,0,1,0
32,341,341,132,16,116,4,3
9,344,344,12,12,0,1,0
33,354,354,29,8,21,4,3
37,361,361,16,16,0,1,0
13,368,368,25,5,20,2,1
20,372,372,17,17,0,1,0
1,376,376,25,1,24,3,2
30,384,384,143,143,0,1,0
0,391,391,3,3,0,1,0
36,399,399,17,17,0,1,0
26,400,400,70,37,33,3,2
21,410,410,8,8,0,1,0
12,421,421,27,12,15,4,3
10,431,431,8,8,0,1,0
31,431,431,12,6,6,3,2
27,434,434,117,45,72,4,3
6,451,451,73,39,34,2,1
19,465,465,9,9,0,1,0
35,470,470,52,52,0,1,0
16,480,480,81,47,34,3,2

37,102,102,3,3,0,1,0
2,103,103,1,1,0,1,0
12,105,105,1,1,0,1,0
4,117,117,6,6,0,1,0
7,123,123,17,17,0,1,0
18,132,132,1,1,0,1,0
30,157,157,7,7,0,1,0
5,159,159,6,6,0,1,0
11,168,168,9,9,0,1,0
22,172,172,17,17,0,1,0
40,185,185,15,9,6,2,1
0,197,197,25,22,3,2,1
17,212,212,5,2,3,2,1
34,223,223,6,3,3,2,1
26,228,228,5,5,0,1,0
27,236,236,112,112,0,1,0
41,242,242,15,15,0,1,0
24,245,245,2,2,0,1,0
29,297,297,5,5,0,1,0
28,297,297,15,11,4,2,1
3,297,297,32,11,21,4,3
39,319,319,4,4,0,1,0
14,326,326,17,7,10,2,1
10,335,335,16,16,0,1,0
25,347,347,38,2,36,3,2
19,352,352,2,2,0,1,0
1,356,356,46,46,0,1,0
35,357,357,61,37,24,4,3
42,384,384,68,23,45,2,1
16,385,385,97,28,69,4,3
36,393,393,64,50,14,2,1
38,419,419,32,24,8,2,1
33,423,423,128,8,120,4,3
6,428,428,16,4,12,2,1
31,430,430,8,2,6,3,2
20,440,440,126,99,27,4,3
13,476,476,60,46,14,3,2
21,479,479,33,8,25,2,1
8,479,479,7,7,0,1,0
32,490,490,41,23,18,4,3
23,491,491,26,26,0,1,0
15,491,491,71,31,40,3,2
9,494,494,9,9,0,1,0

14,107,107,4,4,0,1,0
22,133,133,2,2,0,1,0
15,141,141,3,3,0,1,0
31,161,161,18,15,3,2,1
16,198,198,53,53,0,1,0
13,205,205,27,27,0,1,0
18,213,213,50,50,0,1,0
4,229,229,37,37,0,1,0
6,235,235,10,4,6,3,2
20,254,254,17,2,15,2,1
27,257,257,4,4,0,1,0
5,261,261,103,61,42,2,1
23,264,264,1,1,0,1,0
10,265,265,24,24,0,1,0
24,268,268,13,13,0,1,0
29,274,274,12,12,0,1,0
30,278,278,27,3,24,2,1
28,308,308,16,2,14,3,2
3,315,315,28,19,9,2,1
21,317,317,65,65,0,1,0
12,332,332,33,9,24,4,3
19,332,332,23,23,0,1,0
26,351,351,76,53,23,4,3
9,352,352,44,44,0,1,0
2,384,384,125,32,93,4,3
32,384,384,14,14,0,1,0
11,391,391,23,2,21,4,3
0,413,413,81,81,0,1,0
7,423,423,20,20,0,1,0
1,439,439,40,13,27,4,3
25,469,469,84,84,0,1,0
8,474,474,5,5,0,1,0
17,480,480,111,63,48,3,2
33,486,486,10,4,6,3,2

10,104,104,9,3,6,3,2
33,134,134,14,14,0,1,0
22,144,144,4,4,0,1,0
21,154,154,3,3,0,1,0
3,159,159,25,5,20,3,2
37,161,161,11,11,0,1,0
12,181,181,33,27,6,3,2
2,219,219,11,7,4,2,1
1,225,225,6,2,4,2,1
23,240,240,55,55,0,1,0
0,249,249,15,15,0,1,0
24,249,249,1,1,0,1,0
36,255,255,30,30,0,1,0
9,265,265,15,15,0,1,0
25,275,275,2,2,0,1,0
26,281,281,6,6,0,1,0
18,288,288,23,16,7,2,1
4,310,310,5,5,0,1,0
6,331,331,6,3,3,2,1
8,337,337,6,6,0,1,0
28,338,338,15,15,0,1,0
30,350,350,65,22,43,2,1
32,356,356,4,4,0,1,0
35,364,364,5,5,0,1,0
11,367,367,19,19,0,1,0
27,371,371,113,83,30,4,3
7,396,396,15,15,0,1,0
19,402,402,15,15,0,1,0
5,414,414,21,3,18,4,3
31,417,417,7,7,0,1,0
16,427,427,32,16,16,3,2
15,453,453,29,29,0,1,0
29,454,454,19,10,9,4,3
17,458,458,155,11,144,4,3
34,463,463,309,240,69,4,3
13,472,472,209,131,78,4,3
14,475,475,42,11,31,2,1
20,492,492,7,7,0,1,0

25,114,114,3,3,0,1,0
10,127,127,6,6,0,1,0
29,132,132,21,3,18,2,1
11,155,155,8,3,5,2,1
33,166,166,4,4,0,1,0
5,170,170,10,10,0,1,0
24,183,183,3,3,0,1,0
3,198,198,37,37,0,1,0
12,209,209,29,10,19,2,1
31,214,214,71,71,0,1,0
1,218,218,29,29,0,1,0
32,221,221,18,3,15,4,3
27,235,235,2,2,0,1,0
38,236,236,23,23,0,1,0
34,251,251,16,16,0,1,0
26,256,256,63,24,39,4,3
8,264,264,9,9,0,1,0
18,267,267,83,83,0,1,0
16,319,319,32,32,0,1,0
0,323,323,3,3,0,1,0
37,329,329,57,13,44,3,2
19,336,336,20,20,0,1,0
13,345,345,36,3,33,2,1
4,345,345,25,13,12,2,1
36,364,364,97,85,12,4,3
23,371,371,40,3,37,2,1
28,374,374,4,1,3,2,1
7,382,382,53,26,27,2,1
2,383,383,27,16,11,2,1
20,406,406,13,13,0,1,0
21,419,419,38,21,17,2,1
30,459,459,59,13,46,3,2
14,462,462,19,3,16,3,2
17,473,473,36,36,0,1,0
15,475,475,1,1,0,1,0
22,485,485,16,4,12,4,3
9,487,487,77,61,16,3,2
35,495,495,18,18,0,1,0
6,499,499,53,14,39,4,3

30,121,121,15,15,0,1,0
19,134,134,2,2,0,1,0
22,158,158,32,32,0,1,0
14,170,170,1,1,0,1,0
17,183,183,13,7,6,2,1
9,194,194,4,4,0,1,0
5,202,202,5,5,0,1,0
15,228,228,25,9,16,3,2
21,242,242,2,2,0,1,0
10,254,254,11,1,10,2,1
0,282,282,65,13,52,3,2
20,284,284,84,66,18,4,3
11,298,298,81,1,80,3,2
3,307,307,105,105,0,1,0
24,315,315,23,23,0,1,0
16,329,329,27,15,12,4,3
23,341,341,23,23,0,1,0
12,342,342,11,11,0,1,0
25,354,354,27,18,9,2,1
18,358,358,26,18,8,3,2
2,359,359,76,76,0,1,0
6,399,399,104,104,0,1,0
13,405,405,52,52,0,1,0
26,407,407,161,72,89,4,3
4,437,437,5,5,0,1,0
29,441,441,10,10,0,1,0
1,452,452,11,5,6,3,2
27,461,461,33,6,27,4,3
8,474,474,92,48,44,3,2
28,495,495,42,6,36,3,2
7,496,496,132,132,0,1,0

10,117,117,14,14,0,1,0
19,126,126,12,1,11,2,1
7,141,141,5,5,0,1,0
6,144,144,1,1,0,1,0
17,148,148,37,1,36,3,2
2,155,155,1,1,0,1,0
14,162,162,16,16,0,1,0
28,163,163,9,9,0,1,0
34,166,166,17,9,8,2,1
36,172,172,23,23,0,1,0
1,176,176,5,1,4,2,1
16,183,183,42,3,39,2,1
24,186,186,20,20,0,1,0
18,192,192,2,2,0,1,0
29,201,201,30,30,0,1,0
9,201,201,11,11,0,1,0
25,202,202,22,13,9,2,1
5,220,220,31,1,30,3,2
13,254,254,2,2,0,1,0
15,269,269,30,6,24,3,2
8,303,303,18,18,0,1,0
33,310,310,37,37,0,1,0
32,327,327,13,1,12,4,3
26,329,329,4,4,0,1,0
20,335,335,14,14,0,1,0
27,360,360,62,14,48,2,1
30,364,364,29,1,28,2,1
3,403,403,101,5,96,3,2
4,409,409,86,31,55,3,2
38,416,416,10,10,0,1,0
21,421,421,47,47,0,1,0
35,423,423,9,9,0,1,0
12,430,430,9,9,0,1,0
31,434,434,56,6,50,2,1
11,440,440,53,53,0,1,0
23,446,446,41,33,8,2,1
37,449,449,85,22,63,4,3
0,469,469,1,1,0,1,0
22,489,489,6,6,0,1,0
39,498,498,137,88,49,4,3

43,102,102,3,3,0,1,0
40,128,128,30,6,24,4,3
22,139,139,11,11,0,1,0
11,149,149,1,1,0,1,0
27,154,154,8,8,0,1,0
2,156,156,1,1,0,1,0
15,163,163,1,1,0,1,0
18,173,173,10,10,0,1,0
1,174,174,10,1,9,2,1
24,178,178,16,16,0,1,0
35,184,184,24,11,13,2,1
26,198,198,6,6,0,1,0
19,200,200,25,9,16,4,3
7,202,202,1,1,0,1,0
9,205,205,4,4,0,1,0
36,214,214,7,7,0,1,0
0,228,228,9,9,0,1,0
41,240,240,20,4,16,3,2
38,243,243,11,1,10,3,2
33,251,251,29,29,0,1,0
5,253,253,47,47,0,1,0
8,256,256,15,15,0,1,0
17,258,258,14,5,9,2,1
21,281,281,47,47,0,1,0
42,290,290,24,1,23,2,1
30,296,296,5,5,0,1,0
32,297,297,28,4,24,4,3
14,307,307,25,13,12,2,1
34,310,310,118,1,117,4,3
12,322,322,15,1,14,3,2
13,322,322,116,43,73,3,2
31,344,344,55,29,26,2,1
3,379,379,19,10,9,2,1
16,386,386,5,5,0,1,0
20,387,387,2,2,0,1,0
29,395,395,9,9,0,1,0
23,406,406,32,18,14,2,1
44,411,411,30,7,23,2,1
25,443,443,21,2,19,2,1
37,449,449,12,12,0,1,0
39,455,455,119,98,21,2,1
28,463,463,32,32,0,1,0
6,474,474,107,64,43,2,1
4,481,481,1,1,0,1,0
10,485,485,16,16,0,1,0

13,101,101,19,19,0,1,0
17,119,119,6,6,0,1,0
11,131,131,18,18,0,1,0
22,147,147,20,20,0,1,0
31,153,153,7,7,0,1,0
25,185,185,9,9,0,1,0
0,190,190,41,14,27,4,3
10,208,208,6,6,0,1,0
32,215,215,10,5,5,2,1
2,235,235,51,51,0,1,0
23,247,247,6,6,0,1,0
15,255,255,26,19,7,2,1
16,257,257,98,74,24,2,1
14,261,261,56,23,33,4,3
26,262,262,36,16,20,3,2
5,277,277,9,6,3,2,1
7,287,287,75,46,29,2,1
3,288,288,10,1,9,4,3
9,291,291,12,5,7,2,1
1,307,307,77,49,28,3,2
27,336,336,6,6,0,1,0
19,345,345,140,92,48,2,1
4,358,358,26,26,0,1,0
12,359,359,12,12,0,1,0
18,403,403,2,2,0,1,0
30,442,442,1,1,0,1,0
21,445,445,17,17,0,1,0
28,448,448,34,34,0,1,0
24,461,461,5,5,0,1,0
29,471,471,9,5,4,2,1
6,475,475,79,73,6,2,1
8,482,482,110,66,44,3,2
20,486,486,85,85,0,1,0

1,106,106,1,1,0,1,0
26,114,114,19,7,12,4,3
34,119,119,42,30,12,2,1
18,123,123,25,10,15,2,1
11,138,138,19,13,6,2,1
20,147,147,8,8,0,1,0
0,148,148,10,4,6,2,1
33,155,155,1,1,0,1,0
12,162,162,8,8,0,1,0
19,174,174,20,14,6,3,2
9,223,223,8,2,6,3,2
29,237,237,21,18,3,2,1
15,248,248,10,3,7,3,2
28,254,254,19,19,0,1,0
32,260,260,4,4,0,1,0
37,273,273,10,4,6,3,2
14,280,280,52,52,0,1,0
10,282,282,33,33,0,1,0
36,301,301,51,51,0,1,0
13,305,305,28,28,0,1,0
2,312,312,75,57,18,4,3
3,361,361,4,4,0,1,0
31,361,361,19,14,5,2,1
23,364,364,47,35,12,3,2
5,368,368,56,50,6,3,2
35,372,372,11,2,9,2,1
17,372,372,27,27,0,1,0
24,391,391,21,2,19,4,3
7,397,397,40,40,0,1,0
27,422,422,41,11,30,3,2
6,429,429,5,1,4,2,1
30,438,438,145,118,27,4,3
21,456,456,18,9,9,4,3
4,459,459,1,1,0,1,0
8,468,468,29,20,9,2,1
22,469,469,4,4,0,1,0
25,487,487,58,58,0,1,0
16,500,500,155,111,44,3,2

1,113,113,2,2,0,1,0
15,125,125,6,6,0,1,0
40,130,130,10,6,4,2,1
2,141,141,6,3,3,2,1
5,144,144,8,8,0,1,0
43,149,149,9,1,8,2,1
21,151,151,11,5,6,2,1
26,159,159,9,9,0,1,0
32,164,164,7,3,4,2,1
3,169,169,21,11,10,2,1
36,173,173,2,2,0,1,0
28,189,189,2,2,0,1,0
0,205,205,2,2,0,1,0
41,206,206,15,1,14,3,2
7,232,232,7,7,0,1,0
38,234,234,4,4,0,1,0
17,240,240,2,2,0,1,0
25,244,244,8,2,6,3,2
37,251,251,28,28,0,1,0
29,265,265,11,3,8,3,2
23,271,271,7,7,0,1,0
31,274,274,50,50,0,1,0
46,305,305,38,38,0,1,0
39,312,312,16,16,0,1,0
33,317,317,5,1,4,2,1
10,322,322,7,7,0,1,0
19,330,330,46,34,12,2,1
42,336,336,10,2,8,2,1
8,342,342,38,38,0,1,0
45,345,345,36,18,18,4,3
20,348,348,75,63,12,4,3
22,354,354,22,22,0,1,0
11,376,376,13,13,0,1,0
16,378,378,1,1,0,1,0
13,400,400,59,59,0,1,0
27,416,416,46,13,33,2,1
18,420,420,21,21,0,1,0
48,420,420,86,59,27,4,3
12,437,437,30,2,28,3,2
9,440,440,22,1,21,2,1
44,445,445,42,3,39,2,1
34,448,448,20,5,15,2,1
24,475,475,26,26,0,1,0
47,482,482,143,38,105,4,3
6,485,485,17,9,8,2,1
4,486,486,66,26,40,3,2
14,492,492,43,16,27,4,3
30,493,493,31,25,6,3,2
35,496,496,167,37,130,4,3

1,110,110,3,3,0,1,0
10,132,132,1,1,0,1,0
0,135,135,2,2,0,1,0
42,139,139,19,7,12,3,2
13,150,150,11,4,7,2,1
18,165,165,16,13,3,2,1
35,169,169,2,2,0,1,0
44,174,174,6,6,0,1,0
37,188,188,8,8,0,1,0
5,190,190,36,18,18,2,1
41,200,200,8,8,0,1,0
2,204,204,1,1,0,1,0
4,213,213,13,13,0,1,0
21,228,228,10,5,5,2,1
29,229,229,3,3,0,1,0
7,234,234,26,1,25,3,2
38,247,247,20,20,0,1,0
8,251,251,59,59,0,1,0
23,260,260,18,11,7,2,1
31,272,272,3,3,0,1,0
27,275,275,33,33,0,1,0
3,280,280,1,1,0,1,0
40,282,282,14,6,8,2,1
12,297,297,57,53,4,2,1
28,298,298,99,23,76,3,2
34,303,303,16,2,14,3,2
25,311,311,12,12,0,1,0
17,316,316,3,3,0,1,0
33,362,362,25,19,6,2,1
22,368,368,23,3,20,2,1
14,370,370,8,2,6,3,2
6,376,376,12,7,5,2,1
36,376,376,11,11,0,1,0
16,377,377,58,1,57,4,3
20,388,388,1,1,0,1,0
39,405,405,88,13,75,4,3
15,406,406,91,64,27,4,3
24,414,414,9,9,0,1,0
19,431,431,10,10,0,1,0
43,440,440,100,61,39,4,3
32,452,452,15,8,7,2,1
9,461,461,45,25,20,2,1
26,471,471,19,9,10,3,2
45,472,472,62,56,6,3,2
11,475,475,21,6,15,4,3
30,491,491,151,65,86,3,2

31,106,106,2,2,0,1,0
27,111,111,8,8,0,1,0
10,115,115,2,2,0,1,0
29,126,126,28,22,6,3,2
7,134,134,7,7,0,1,0
16,157,157,2,2,0,1,0
28,158,158,8,8,0,1,0
26,163,163,10,6,4,2,1
23,165,165,8,8,0,1,0
1,167,167,2,2,0,1,0
35,187,187,18,13,5,2,1
32,188,188,20,20,0,1,0
14,189,189,7,7,0,1,0
11,195,195,21,21,0,1,0
45,196,196,8,2,6,2,1
20,217,217,5,5,0,1,0
8,219,219,41,41,0,1,0
25,224,224,1,1,0,1,0
24,249,249,62,11,51,4,3
39,267,267,14,14,0,1,0
37,270,270,19,1,18,2,1
15,274,274,9,9,0,1,0
6,285,285,57,57,0,1,0
36,322,322,77,65,12,4,3
41,326,326,29,29,0,1,0
38,338,338,8,3,5,2,1
5,345,345,6,6,0,1,0
9,366,366,5,5,0,1,0
34,366,366,73,73,0,1,0
4,369,369,14,4,10,2,1
21,375,375,34,34,0,1,0
0,379,379,3,3,0,1,0
19,383,383,65,65,0,1,0
2,384,384,50,13,37,3,2
40,401,401,88,64,24,3,2
30,407,407,5,5,0,1,0
42,414,414,46,46,0,1,0
12,417,417,53,9,44,2,1
43,420,420,81,81,0,1,0
18,434,434,19,11,8,2,1
17,442,442,11,11,0,1,0
22,457,457,41,3,38,3,2
3,470,470,32,32,0,1,0
33,476,476,6,6,0,1,0
44,481,481,57,48,9,4,3
13,494,494,17,17,0,1,0

15,101,101,20,3,17,4,3
20,105,105,1,1,0,1,0
30,108,108,3,3,0,1,0
28,119,119,13,1,12,3,2
37,135,135,5,1,4,2,1
17,149,149,7,2,5,2,1
25,162,162,33,33,0,1,0
33,164,164,39,31,8,3,2
29,171,171,2,2,0,1,0
19,173,173,7,7,0,1,0
27,189,189,16,6,10,3,2
14,194,194,15,15,0,1,0
26,208,208,26,26,0,1,0
40,210,210,24,8,16,2,1
18,223,223,1,1,0,1,0
32,234,234,2,2,0,1,0
12,243,243,1,1,0,1,0
10,249,249,75,75,0,1,0
5,305,305,59,59,0,1,0
38,317,317,22,22,0,1,0
42,323,323,89,56,33,2,1
1,343,343,36,36,0,1,0
3,345,345,10,5,5,2,1
7,346,346,17,17,0,1,0
41,353,353,70,70,0,1,0
0,354,354,6,6,0,1,0
36,356,356,22,5,17,2,1
9,357,357,7,7,0,1,0
6,367,367,1,1,0,1,0
23,382,382,28,4,24,3,2
21,386,386,55,55,0,1,0
24,393,393,5,5,0,1,0
34,394,394,5,5,0,1,0
22,395,395,14,4,10,2,1
8,397,397,10,10,0,1,0
2,399,399,26,2,24,2,1
39,410,410,13,10,3,2,1
11,420,420,35,35,0,1,0
13,426,426,100,24,76,3,2
4,484,484,59,59,0,1,0
31,489,489,1,1,0,1,0
16,497,497,11,11,0,1,0
35,499,499,160,74,86,3,2

1,105,105,22,22,0,1,0
13,124,124,1,1,0,1,0
23,124,124,2,2,0,1,0
14,128,128,9,1,8,2,1
16,151,151,22,22,0,1,0
9,153,153,53,19,34,3,2
8,154,154,48,6,42,3,2
27,154,154,6,6,0,1,0
6,179,179,2,2,0,1,0
19,182,182,3,3,0,1,0
3,186,186,18,18,0,1,0
12,203,203,42,42,0,1,0
26,211,211,18,18,0,1,0
0,212,212,47,40,7,2,1
11,214,214,38,15,23,2,1
17,224,224,8,8,0,1,0
21,229,229,26,26,0,1,0
4,241,241,32,32,0,1,0
29,267,267,42,42,0,1,0
18,267,267,17,17,0,1,0
22,300,300,26,16,10,3,2
7,310,310,40,24,16,3,2
28,324,324,46,46,0,1,0
2,326,326,10,6,4,2,1
24,363,363,12,3,9,4,3
20,366,366,52,5,47,4,3
5,393,393,37,37,0,1,0
15,397,397,77,72,5,2,1
25,461,461,96,67,29,2,1
10,494,494,157,55,102,4,3

37,102,102,21,21,0,1,0
39,102,102,19,19,0,1,0
31,107,107,2,2,0,1,0
0,108,108,4,4,0,1,0
30,120,120,6,1,5,2,1
19,124,124,3,3,0,1,0
36,132,132,14,4,10,3,2
13,148,148,46,46,0,1,0
40,170,170,15,3,12,3,2
15,180,180,33,19,14,2,1
41,191,191,24,15,9,4,3
27,210,210,39,6,33,4,3
21,211,211,2,2,0,1,0
10,215,215,5,2,3,2,1
4,226,226,27,9,18,4,3
2,230,230,5,5,0,1,0
5,237,237,20,20,0,1,0
17,237,237,3,3,0,1,0
20,251,251,18,18,0,1,0
33,261,261,9,1,8,2,1
11,291,291,8,8,0,1,0
12,309,309,18,8,10,3,2
38,316,316,41,41,0,1,0
24,326,326,9,9,0,1,0
1,328,328,67,18,49,4,3
23,339,339,39,29,10,2,1
3,344,344,30,30,0,1,0
18,351,351,18,18,0,1,0
8,372,372,35,23,12,4,3
32,392,392,163,76,87,4,3
29,400,400,8,3,5,2,1
26,411,411,12,12,0,1,0
25,412,412,28,28,0,1,0
34,422,422,9,5,4,2,1
28,440,440,47,47,0,1,0
14,447,447,3,3,0,1,0
22,461,461,27,17,10,2,1
6,470,470,104,77,27,2,1
35,471,471,6,6,0,1,0
7,478,478,64,64,0,1,0
16,490,490,23,23,0,1,0
9,499,499,7,7,0,1,0

9,142,142,29,19,10,2,1
25,167,167,6,3,3,2,1
30,171,171,17,17,0,1,0
1,173,173,18,18,0,1,0
15,176,176,25,10,15,2,1
0,183,183,5,5,0,1,0
24,183,183,26,26,0,1,0
3,226,226,21,7,14,4,3
12,232,232,4,1,3,2,1
23,236,236,39,15,24,4,3
10,248,248,39,1,38,2,1
21,266,266,34,30,4,2,1
16,269,269,15,1,14,2,1
36,282,282,52,52,0,1,0
31,282,282,45,3,42,3,2
18,291,291,3,3,0,1,0
20,298,298,39,23,16,2,1
5,300,300,1,1,0,1,0
29,302,302,14,3,11,2,1
22,311,311,74,44,30,2,1
32,319,319,10,2,8,3,2
8,323,323,6,6,0,1,0
27,329,329,8,8,0,1,0
34,331,331,2,2,0,1,0
11,339,339,20,20,0,1,0
26,357,357,30,20,10,3,2
17,386,386,40,40,0,1,0
19,391,391,40,21,19,2,1
4,406,406,34,34,0,1,0
13,407,407,7,7,0,1,0
35,409,409,36,36,0,1,0
6,418,418,29,29,0,1,0
33,436,436,108,108,0,1,0
7,445,445,150,80,70,3,2
28,454,454,7,7,0,1,0
14,467,467,145,80,65,4,3
2,494,494,49,12,37,3,2

15,101,101,27,27,0,1,0
12,125,125,3,3,0,1,0
29,131,131,11,11,0,1,0
34,150,150,1,1,0,1,0
22,154,154,25,25,0,1,0
18,164,164,3,3,0,1,0
16,165,165,20,20,0,1,0
27,168,168,29,22,7,2,1
32,173,173,13,5,8,2,1
17,197,197,22,22,0,1,0
28,207,207,6,1,5,2,1
19,213,213,1,1,0,1,0
10,221,221,3,3,0,1,0
14,228,228,18,18,0,1,0
33,229,229,26,26,0,1,0
25,246,246,7,2,5,2,1
26,251,251,35,8,27,2,1
7,254,254,42,4,38,3,2
20,263,263,31,5,26,3,2
13,265,265,51,21,30,3,2
30,274,274,7,7,0,1,0
9,280,280,8,8,0,1,0
23,296,296,3,3,0,1,0
2,333,333,40,40,0,1,0
37,345,345,166,148,18,3,2
4,351,351,26,6,20,2,1
35,377,377,45,45,0,1,0
5,377,377,115,47,68,3,2
31,399,399,14,1,13,2,1
11,413,413,7,3,4,2,1
36,421,421,6,6,0,1,0
1,427,427,20,6,14,3,2
3,456,456,26,3,23,2,1
21,462,462,118,96,22,2,1
8,468,468,10,10,0,1,0
6,496,496,82,8,74,4,3
0,497,497,38,38,0,1,0
24,499,499,31,15,16,2,1

14,101,101,1,1,0,1,0
23,113,113,8,8,0,1,0
18,114,114,15,15,0,1,0
39,127,127,10,10,0,1,0
16,141,141,3,3,0,1,0
27,176,176,15,15,0,1,0
34,178,178,33,33,0,1,0
2,185,185,2,2,0,1,0
4,197,197,38,5,33,4,3
17,202,202,31,4,27,2,1
13,202,202,14,4,10,3,2
36,213,213,3,3,0,1,0
35,221,221,8,3,5,2,1
26,231,231,23,23,0,1,0
1,247,247,27,27,0,1,0
10,248,248,20,1,19,2,1
37,257,257,13,1,12,4,3
28,260,260,20,20,0,1,0
31,265,265,20,4,16,3,2
8,267,267,33,33,0,1,0
32,286,286,10,10,0,1,0
38,304,304,70,70,0,1,0
22,314,314,2,2,0,1,0
15,316,316,24,24,0,1,0
9,321,321,7,7,0,1,0
21,327,327,44,44,0,1,0
33,336,336,125,86,39,4,3
0,339,339,11,1,10,2,1
25,348,348,11,11,0,1,0
20,351,351,18,6,12,2,1
29,369,369,14,14,0,1,0
3,391,391,23,23,0,1,0
30,392,392,117,117,0,1,0
7,394,394,78,75,3,2,1
19,402,402,52,23,29,4,3
11,452,452,79,7,72,4,3
6,461,461,11,11,0,1,0
5,475,475,87,30,57,4,3
12,487,487,24,14,10,3,2
24,494,494,7,4,3,2,1

13,116,116,8,1,7,2,1
2,135,135,53,53,0,1,0
14,148,148,4,4,0,1,0
21,156,156,1,1,0,1,0
28,202,202,6,6,0,1,0
6,206,206,11,11,0,1,0
0,212,212,37,37,0,1,0
22,227,227,61,33,28,2,1
18,233,233,12,7,5,2,1
9,247,247,3,3,0,1,0
32,263,263,1,1,0,1,0
4,267,267,25,12,13,2,1
23,268,268,4,4,0,1,0
1,287,287,29,11,18,2,1
7,307,307,99,62,37,2,1
15,307,307,101,77,24,2,1
31,308,308,74,74,0,1,0
11,315,315,94,94,0,1,0
26,321,321,49,49,0,1,0
30,322,322,25,25,0,1,0
29,326,326,12,4,8,3,2
19,331,331,28,11,17,2,1
10,334,334,61,61,0,1,0
16,363,363,39,9,30,3,2
20,370,370,8,8,0,1,0
12,385,385,4,4,0,1,0
24,388,388,114,114,0,1,0
27,403,403,3,3,0,1,0
3,415,415,59,39,20,3,2
5,422,422,9,9,0,1,0
8,423,423,13,10,3,2,1
25,433,433,32,32,0,1,0
17,437,437,42,42,0,1,0

15,109,109,14,14,0,1,0
14,114,114,1,1,0,1,0
5,158,158,35,32,3,2,1
20,159,159,18,4,14,3,2
26,160,160,3,3,0,1,0
4,167,167,21,5,16,3,2
16,178,178,41,41,0,1,0
32,199,199,5,1,4,2,1
1,200,200,48,4,44,4,3
21,203,203,3,3,0,1,0
19,210,210,30,30,0,1,0
30,233,233,106,106,0,1,0
7,243,243,13,5,8,2,1
9,281,281,15,4,11,2,1
2,290,290,18,10,8,3,2
31,297,297,5,5,0,1,0
24,303,303,39,1,38,4,3
22,328,328,21,7,14,3,2
13,331,331,16,16,0,1,0
29,339,339,23,4,19,2,1
6,365,365,84,16,68,3,2
17,386,386,41,41,0,1,0
33,388,388,46,8,38,3,2
25,393,393,33,33,0,1,0
0,410,410,78,78,0,1,0
28,424,424,12,12,0,1,0
8,434,434,4,4,0,1,0
12,446,446,5,5,0,1,0
10,456,456,96,96,0,1,0
3,469,469,90,60,30,4,3
18,475,475,13,1,12,3,2
23,483,483,67,67,0,1,0
11,490,490,121,103,18,4,3
27,500,500,13,1,12,4,3

30,107,107,16,9,7,2,1
23,118,118,5,5,0,1,0
26,120,120,9,9,0,1,0
19,124,124,26,26,0,1,0
3,138,138,1,1,0,1,0
32,149,149,10,7,3,2,1
22,155,155,26,26,0,1,0
11,169,169,24,10,14,3,2
5,178,178,5,5,0,1,0
34,195,195,9,9,0,1,0
36,200,200,17,17,0,1,0
13,228,228,4,4,0,1,0
28,229,229,11,7,4,2,1
15,230,230,3,3,0,1,0
39,255,255,15,5,10,3,2
17,278,278,11,11,0,1,0
18,292,292,18,11,7,2,1
9,297,297,1,1,0,1,0
6,308,308,38,14,24,2,1
33,320,320,69,42,27,4,3
20,345,345,117,30,87,4,3
25,346,346,52,52,0,1,0
8,371,371,24,24,0,1,0
31,384,384,20,20,0,1,0
16,389,389,54,54,0,1,0
37,398,398,21,21,0,1,0
0,401,401,10,4,6,3,2
10,401,401,41,41,0,1,0
1,404,404,108,108,0,1,0
14,409,409,41,29,12,4,3
7,420,420,51,51,0,1,0
27,422,422,74,29,45,4,3
21,429,429,25,25,0,1,0
12,438,438,3,3,0,1,0
38,454,454,7,1,6,3,2
29,455,455,153,153,0,1,0
35,459,459,56,24,32,3,2
4,463,463,36,20,16,2,1
2,473,473,6,6,0,1,0
24,480,480,7,7,0,1,0

14,102,102,39,21,18,4,3
28,108,108,9,9,0,1,0
20,115,115,12,12,0,1,0
23,130,130,8,8,0,1,0
2,173,173,18,18,0,1,0
34,177,177,26,6,20,2,1
9,186,186,5,2,3,2,1
35,195,195,10,10,0,1,0
11,203,203,1,1,0,1,0
16,203,203,33,3,30,2,1
10,216,216,66,45,21,2,1
26,228,228,26,26,0,1,0
33,240,240,35,14,21,4,3
31,291,291,44,21,23,2,1
25,311,311,36,22,14,2,1
0,329,329,40,40,0,1,0
27,343,343,22,7,15,2,1
30,353,353,10,10,0,1,0
36,361,361,26,26,0,1,0
6,364,364,19,19,0,1,0
29,373,373,4,4,0,1,0
22,380,380,20,4,16,2,1
21,388,388,10,10,0,1,0
19,391,391,44,16,28,2,1
13,397,397,14,4,10,3,2
1,408,408,5,5,0,1,0
7,426,426,15,15,0,1,0
4,448,448,32,9,23,2,1
24,450,450,205,174,31,2,1
5,455,455,141,141,0,1,0
32,457,457,65,65,0,1,0
18,460,460,2,2,0,1,0
17,467,467,28,28,0,1,0
8,480,480,21,3,18,4,3
12,486,486,1,1,0,1,0
15,491,491,7,3,4,2,1
3,495,495,78,78,0,1,0

11,129,129,7,7,0,1,0
30,148,148,25,25,0,1,0
29,152,152,19,19,0,1,0
10,160,160,36,36,0,1,0
4,161,161,9,1,8,3,2
9,164,164,38,13,25,2,1
24,174,174,9,4,5,2,1
35,221,221,41,41,0,1,0
31,236,236,6,6,0,1,0
13,243,243,22,8,14,3,2
7,247,247,3,3,0,1,0
33,255,255,12,2,10,2,1
17,269,269,53,3,50,3,2
23,272,272,20,20,0,1,0
15,287,287,15,15,0,1,0
16,294,294,29,21,8,3,2
14,302,302,15,15,0,1,0
26,323,323,5,5,0,1,0
34,325,325,81,69,12,2,1
25,326,326,16,7,9,4,3
32,326,326,26,6,20,3,2
5,349,349,116,110,6,2,1
22,353,353,42,42,0,1,0
12,359,359,20,5,15,4,3
28,387,387,102,3,99,4,3
36,394,394,4,4,0,1,0
3,403,403,1,1,0,1,0
8,406,406,42,42,0,1,0
19,416,416,123,109,14,3,2
18,423,423,21,21,0,1,0
21,433,433,6,6,0,1,0
0,474,474,32,24,8,2,1
6,477,477,79,37,42,3,2
27,480,480,8,8,0,1,0
2,485,485,15,15,0,1,0
20,488,488,44,4,40,3,2
1,500,500,39,6,33,4,3

17,102,102,4,4,0,1,0
22,105,105,1,1,0,1,0
23,114,114,6,6,0,1,0
3,115,115,1,1,0,1,0
6,115,115,20,11,9,4,3
30,124,124,9,5,4,2,1
2,147,147,42,42,0,1,0
18,195,195,1,1,0,1,0
20,200,200,16,16,0,1,0
16,218,218,28,28,0,1,0
31,231,231,9,3,6,3,2
26,231,231,1,1,0,1,0
10,234,234,18,10,8,2,1
14,240,240,5,5,0,1,0
11,263,263,4,4,0,1,0
28,300,300,24,24,0,1,0
25,311,311,11,11,0,1,0
35,316,316,11,2,9,2,1
5,316,316,7,7,0,1,0
0,324,324,4,4,0,1,0
7,340,340,120,41,79,4,3
32,342,342,78,72,6,3,2
9,353,353,6,6,0,1,0
1,371,371,79,79,0,1,0
33,372,372,174,72,102,4,3
36,378,378,45,45,0,1,0
29,393,393,62,50,12,2,1
8,404,404,53,1,52,3,2
34,431,431,8,8,0,1,0
27,434,434,61,37,24,4,3
19,444,444,40,25,15,2,1
12,465,465,44,35,9,4,3
13,469,469,53,53,0,1,0
15,490,490,84,84,0,1,0
24,491,491,93,52,41,3,2
4,491,491,16,1,15,4,3
21,497,497,59,15,44,3,2

1,108,108,12,12,0,1,0
37,135,135,13,13,0,1,0
11,164,164,21,21,0,1,0
35,169,169,9,9,0,1,0
18,174,174,26,26,0,1,0
6,191,191,23,6,17,2,1
8,192,192,7,7,0,1,0
23,194,194,10,10,0,1,0
31,238,238,3,3,0,1,0
12,240,240,43,17,26,3,2
27,263,263,22,12,10,2,1
4,267,267,9,4,5,2,1
34,267,267,11,3,8,3,2
36,270,270,80,6,74,3,2
25,273,273,92,2,90,3,2
10,280,280,1,1,0,1,0
15,283,283,1,1,0,1,0
16,292,292,40,34,6,2,1
22,298,298,8,8,0,1,0
21,299,299,36,36,0,1,0
38,302,302,3,3,0,1,0
26,304,304,16,10,6,2,1
19,317,317,14,14,0,1,0
2,339,339,29,29,0,1,0
29,372,372,5,5,0,1,0
9,374,374,13,8,5,2,1
5,394,394,3,3,0,1,0
14,408,408,56,23,33,4,3
28,410,410,4,4,0,1,0
7,413,413,86,34,52,3,2
20,421,421,57,57,0,1,0
30,430,430,127,94,33,4,3
13,439,439,23,13,10,3,2
3,459,459,88,1,87,4,3
32,471,471,72,72,0,1,0
0,476,476,16,8,8,2,1
17,482,482,99,76,23,2,1
24,487,487,15,15,0,1,0
33,499,499,55,5,50,2,1

24,108,108,11,11,0,1,0
12,113,113,20,2,18,2,1
22,119,119,3,3,0,1,0
20,129,129,35,35,0,1,0
30,132,132,9,9,0,1,0
14,133,133,3,3,0,1,0
32,154,154,4,1,3,2,1
35,170,170,1,1,0,1,0
27,174,174,11,3,8,3,2
6,190,190,5,5,0,1,0
15,192,192,1,1,0,1,0
38,197,197,12,12,0,1,0
28,202,202,32,32,0,1,0
9,209,209,19,19,0,1,0
18,225,225,86,77,9,4,3
1,233,233,12,12,0,1,0
11,237,237,8,3,5,2,1
36,260,260,21,21,0,1,0
33,275,275,52,52,0,1,0
7,277,277,16,16,0,1,0
3,281,281,1,1,0,1,0
29,289,289,6,6,0,1,0
2,306,306,6,6,0,1,0
10,309,309,4,4,0,1,0
40,314,314,25,13,12,4,3
4,324,324,6,6,0,1,0
23,339,339,81,81,0,1,0
19,357,357,49,27,22,3,2
13,368,368,28,28,0,1,0
37,383,383,12,12,0,1,0
5,402,402,4,4,0,1,0
31,407,407,87,87,0,1,0
34,417,417,6,6,0,1,0
25,439,439,90,90,0,1,0
17,449,449,39,33,6,2,1
0,451,451,43,43,0,1,0
26,453,453,89,61,28,3,2
21,455,455,57,15,42,2,1
8,455,455,40,1,39,2,1
39,465,465,74,8,66,3,2
16,476,476,52,1,51,4,3

37,104,104,1,1,0,1,0
40,104,104,29,29,0,1,0
31,106,106,8,8,0,1,0
35,115,115,38,16,22,2,1
11,119,119,5,5,0,1,0
38,121,121,2,2,0,1,0
24,134,134,4,4,0,1,0
36,135,135,55,17,38,3,2
1,137,137,3,3,0,1,0
9,155,155,44,17,27,2,1
28,158,158,2,2,0,1,0
20,186,186,31,25,6,2,1
22,188,188,28,1,27,2,1
3,194,194,3,3,0,1,0
5,194,194,34,34,0,1,0
32,222,222,12,8,4,2,1
30,229,229,3,3,0,1,0
19,250,250,7,7,0,1,0
39,291,291,14,5,9,4,3
29,301,301,18,18,0,1,0
25,304,304,5,5,0,1,0
18,321,321,14,4,10,3,2
4,343,343,68,57,11,2,1
14,345,345,28,28,0,1,0
21,355,355,40,19,21,4,3
26,359,359,14,11,3,2,1
0,363,363,26,26,0,1,0
23,377,377,11,11,0,1,0
15,386,386,5,5,0,1,0
2,390,390,74,74,0,1,0
34,415,415,48,36,12,4,3
13,435,435,4,4,0,1,0
7,439,439,13,1,12,4,3
17,442,442,33,8,25,2,1
8,443,443,6,6,0,1,0
6,449,449,88,14,74,4,3
12,455,455,23,12,11,2,1
10,468,468,31,31,0,1,0
16,483,483,9,9,0,1,0
33,486,486,87,87,0,1,0
27,500,500,42,34,8,3,2

14,109,109,10,1,9,4,3
21,120,120,21,21,0,1,0
17,141,141,15,15,0,1,0
20,144,144,1,1,0,1,0
32,155,155,15,15,0,1,0
28,164,164,31,31,0,1,0
34,166,166,5,5,0,1,0
9,183,183,4,4,0,1,0
8,201,201,5,2,3,2,1
1,212,212,2,2,0,1,0
10,218,218,60,42,18,2,1
6,218,218,1,1,0,1,0
24,224,224,2,2,0,1,0
31,234,234,4,4,0,1,0
12,240,240,5,5,0,1,0
7,264,264,10,10,0,1,0
25,264,264,20,7,13,2,1
33,276,276,18,6,12,4,3
22,280,280,61,25,36,2,1
16,280,280,16,16,0,1,0
35,281,281,13,1,12,4,3
19,297,297,27,27,0,1,0
2,310,310,2,2,0,1,0
27,316,316,12,3,9,2,1
23,317,317,25,25,0,1,0
13,324,324,105,70,35,2,1
26,333,333,88,70,18,4,3
5,341,341,37,23,14,3,2
0,357,357,64,64,0,1,0
29,370,370,24,24,0,1,0
4,378,378,72,67,5,2,1
15,383,383,2,2,0,1,0
36,387,387,19,13,6,3,2
3,414,414,182,151,31,2,1
30,439,439,98,64,34,2,1
18,444,444,89,83,6,2,1
11,483,483,1,1,0,1,0

0,103,103,7,7,0,1,0
13,105,105,30,4,26,3,2
3,109,109,5,2,3,2,1
35,124,124,1,1,0,1,0
33,136,136,14,9,5,2,1
9,148,148,20,20,0,1,0
30,154,154,13,3,10,3,2
16,170,170,4,4,0,1,0
19,175,175,3,3,0,1,0
5,178,178,3,3,0,1,0
15,196,196,15,9,6,3,2
38,197,197,6,6,0,1,0
21,202,202,40,40,0,1,0
28,213,213,27,3,24,2,1
32,237,237,17,8,9,4,3
4,255,255,22,16,6,2,1
8,255,255,39,39,0,1,0
7,259,259,19,19,0,1,0
17,259,259,1,1,0,1,0
2,268,268,6,3,3,2,1
36,268,268,9,9,0,1,0
34,272,272,32,32,0,1,0
31,284,284,26,26,0,1,0
1,287,287,55,25,30,4,3
37,307,307,33,9,24,4,3
29,344,344,27,15,12,4,3
25,346,346,120,47,73,4,3
26,360,360,22,22,0,1,0
12,369,369,50,47,3,2,1
14,380,380,42,42,0,1,0
22,411,411,1,1,0,1,0
20,415,415,39,3,36,2,1
23,438,438,44,36,8,3,2
27,441,441,101,35,66,4,3
11,446,446,3,3,0,1,0
6,447,447,60,37,23,2,1
18,479,479,108,14,94,3,2
24,487,487,24,24,0,1,0
10,494,494,46,38,8,3,2

32,102,102,30,30,0,1,0
31,103,103,8,8,0,1,0
4,128,128,6,6,0,1,0
6,134,134,22,22,0,1,0
23,154,154,23,3,20,3,2
36,157,157,1,1,0,1,0
18,179,179,19,19,0,1,0
10,182,182,12,12,0,1,0
15,207,207,48,10,38,2,1
9,211,211,21,21,0,1,0
28,228,228,62,62,0,1,0
13,232,232,14,2,12,3,2
21,242,242,9,3,6,2,1
8,271,271,37,31,6,3,2
11,275,275,1,1,0,1,0
12,289,289,9,9,0,1,0
34,290,290,1,1,0,1,0
5,298,298,8,8,0,1,0
35,316,316,2,2,0,1,0
24,316,316,3,3,0,1,0
30,343,343,32,32,0,1,0
7,348,348,58,50,8,2,1
3,358,358,22,22,0,1,0
33,361,361,17,17,0,1,0
2,376,376,68,42,26,3,2
1,378,378,127,81,46,3,2
16,382,382,24,24,0,1,0
17,384,384,13,6,7,2,1
20,408,408,45,45,0,1,0
27,439,439,54,24,30,3,2
19,446,446,18,8,10,3,2
22,464,464,7,7,0,1,0
29,477,477,16,5,11,2,1
26,478,478,199,199,0,1,0
25,483,483,51,51,0,1,0
14,491,491,12,12,0,1,0
0,493,493,83,43,40,3,2

29,121,121,5,5,0,1,0
6,124,124,1,1,0,1,0
16,126,126,29,29,0,1,0
3,130,130,8,3,5,2,1
30,139,139,12,12,0,1,0
15,140,140,6,6,0,1,0
2,143,143,50,28,22,2,1
5,149,149,1,1,0,1,0
8,160,160,32,19,13,2,1
17,169,169,12,6,6,2,1
22,181,181,37,37,0,1,0
18,209,209,2,2,0,1,0
9,222,222,11,11,0,1,0
27,236,236,7,1,6,3,2
23,252,252,11,1,10,3,2
28,287,287,92,20,72,4,3
26,291,291,10,10,0,1,0
32,297,297,11,11,0,1,0
25,312,312,18,18,0,1,0
14,313,313,19,1,18,3,2
31,335,335,11,11,0,1,0
0,366,366,103,57,46,2,1
7,377,377,91,67,24,4,3
20,389,389,6,3,3,2,1
19,400,400,38,38,0,1,0
12,402,402,15,6,9,4,3
24,409,409,10,10,0,1,0
1,424,424,1,1,0,1,0
11,438,438,24,15,9,4,3
4,457,457,43,43,0,1,0
10,464,464,67,60,7,2,1
33,472,472,261,138,123,4,3
13,478,478,148,112,36,4,3
21,485,485,9,9,0,1,0

36,108,108,6,6,0,1,0
12,127,127,11,2,9,4,3
35,127,127,15,1,14,2,1
0,136,136,3,3,0,1,0
26,162,162,17,7,10,3,2
7,186,186,6,6,0,1,0
27,192,192,2,2,0,1,0
18,209,209,26,6,20,3,2
34,209,209,8,5,3,2,1
37,237,237,68,36,32,2,1
29,242,242,5,5,0,1,0
8,249,249,25,25,0,1,0
14,270,270,5,5,0,1,0
28,277,277,65,55,10,2,1
32,288,288,43,1,42,2,1
9,291,291,18,10,8,2,1
15,292,292,29,9,20,3,2
10,293,293,28,28,0,1,0
30,307,307,10,2,8,2,1
31,308,308,22,22,0,1,0
1,319,319,178,92,86,4,3
19,329,329,13,9,4,2,1
23,332,332,11,1,10,2,1
21,333,333,67,40,27,4,3
24,347,347,85,27,58,3,2
11,347,347,12,2,10,3,2
3,349,349,43,43,0,1,0
17,376,376,52,11,41,2,1
33,405,405,1,1,0,1,0
22,412,412,57,57,0,1,0
2,415,415,37,19,18,2,1
4,437,437,22,13,9,4,3
6,441,441,17,5,12,4,3
20,466,466,20,20,0,1,0
5,476,476,69,41,28,2,1
13,477,477,15,15,0,1,0
16,479,479,26,4,22,2,1
25,491,491,57,57,0,1,0

26,105,105,14,5,9,4,3
43,105,105,6,6,0,1,0
15,111,111,8,8,0,1,0
32,121,121,3,3,0,1,0
14,132,132,6,6,0,1,0
6,144,144,2,2,0,1,0
1,149,149,1,1,0,1,0
35,149,149,53,30,23,2,1
38,151,151,2,2,0,1,0
5,155,155,2,2,0,1,0
11,174,174,8,8,0,1,0
3,179,179,1,1,0,1,0
0,209,209,20,20,0,1,0
33,210,210,8,8,0,1,0
44,216,216,22,15,7,2,1
18,224,224,10,10,0,1,0
25,252,252,31,31,0,1,0
16,259,259,7,7,0,1,0
42,271,271,5,5,0,1,0
34,274,274,14,8,6,3,2
23,296,296,1,1,0,1,0
20,298,298,9,3,6,3,2
30,304,304,29,10,19,2,1
13,309,309,51,51,0,1,0
4,330,330,21,21,0,1,0
27,367,367,18,18,0,1,0
41,372,372,28,28,0,1,0
8,378,378,60,60,0,1,0
21,380,380,10,10,0,1,0
37,383,383,21,21,0,1,0
31,390,390,128,128,0,1,0
22,393,393,106,106,0,1,0
12,395,395,26,15,11,2,1
28,406,406,50,50,0,1,0
29,418,418,14,2,12,4,3
7,418,418,14,10,4,2,1
9,423,423,75,75,0,1,0
19,434,434,9,9,0,1,0
36,437,437,70,32,38,3,2
10,445,445,17,3,14,3,2
39,449,449,73,67,6,2,1
17,456,456,1,1,0,1,0
2,464,464,99,87,12,3,2
24,471,471,66,66,0,1,0
40,476,476,33,13,20,2,1

37,103,103,19,19,0,1,0
19,136,136,1,1,0,1,0
6,137,137,10,10,0,1,0
24,148,148,3,3,0,1,0
17,153,153,8,4,4,2,1
2,159,159,18,18,0,1,0
8,164,164,16,16,0,1,0
25,176,176,13,1,12,4,3
29,185,185,21,11,10,2,1
23,186,186,9,3,6,3,2
13,186,186,21,21,0,1,0
16,186,186,35,35,0,1,0
40,203,203,72,43,29,4,3
14,227,227,12,3,9,4,3
35,230,230,3,3,0,1,0
32,230,230,36,24,12,4,3
21,240,240,19,19,0,1,0
28,253,253,6,2,4,2,1
42,254,254,6,3,3,2,1
11,280,280,22,22,0,1,0
10,297,297,1,1,0,1,0
38,302,302,26,8,18,3,2
26,314,314,12,12,0,1,0
33,320,320,46,10,36,3,2
5,323,323,1,1,0,1,0
22,327,327,42,10,32,2,1
9,334,334,7,1,6,2,1
3,352,352,12,2,10,2,1
31,355,355,2,2,0,1,0
34,365,365,71,63,8,3,2
30,396,396,8,2,6,2,1
4,398,398,16,1,15,4,3
36,398,398,14,8,6,2,1
1,403,403,35,6,29,3,2
20,418,418,44,4,40,2,1
39,418,418,19,19,0,1,0
41,437,437,54,46,8,2,1
0,442,442,46,16,30,3,2
43,445,445,38,17,21,4,3
27,452,452,93,93,0,1,0
7,453,453,106,78,28,3,2
12,477,477,44,22,22,3,2
18,480,480,47,47,0,1,0
15,483,483,14,11,3,2,1

10,104,104,5,5,0,1,0
21,107,107,12,12,0,1,0
13,116,116,1,1,0,1,0
19,116,116,7,7,0,1,0
4,136,136,52,41,11,2,1
24,143,143,8,4,4,2,1
20,153,153,5,1,4,2,1
32,161,161,11,11,0,1,0
26,161,161,12,3,9,4,3
40,164,164,7,7,0,1,0
28,168,168,8,8,0,1,0
2,172,172,31,31,0,1,0
8,209,209,10,1,9,2,1
9,210,210,8,5,3,2,1
16,231,231,2,2,0,1,0
18,236,236,6,6,0,1,0
37,236,236,53,23,30,3,2
15,248,248,12,12,0,1,0
6,252,252,16,16,0,1,0
0,255,255,3,3,0,1,0
25,256,256,11,11,0,1,0
39,263,263,13,1,12,3,2
44,272,272,16,16,0,1,0
5,281,281,7,7,0,1,0
30,282,282,74,54,20,2,1
27,288,288,24,20,4,2,1
33,305,305,36,12,24,4,3
43,318,318,24,24,0,1,0
23,329,329,24,2,22,3,2
41,339,339,75,26,49,2,1
1,345,345,22,22,0,1,0
45,346,346,1,1,0,1,0
14,370,370,6,1,5,2,1
36,380,380,60,60,0,1,0
42,388,388,21,3,18,2,1
38,388,388,102,102,0,1,0
34,400,400,44,6,38,2,1
3,401,401,30,10,20,3,2
29,404,404,11,6,5,2,1
22,405,405,57,8,49,2,1
17,428,428,38,38,0,1,0
31,447,447,26,13,13,2,1
7,450,450,39,18,21,2,1
11,463,463,36,36,0,1,0
35,470,470,5,5,0,1,0
12,478,478,7,3,4,2,1

5,109,109,11,2,9,4,3
22,110,110,13,13,0,1,0
12,130,130,19,19,0,1,0
30,153,153,11,4,7,2,1
4,160,160,14,3,11,2,1
9,178,178,11,11,0,1,0
8,189,189,8,8,0,1,0
24,204,204,32,32,0,1,0
27,206,206,5,2,3,2,1
21,215,215,15,15,0,1,0
11,217,217,6,6,0,1,0
23,254,254,12,12,0,1,0
39,265,265,8,8,0,1,0
38,265,265,68,68,0,1,0
34,267,267,1,1,0,1,0
35,275,275,50,8,42,4,3
31,275,275,60,60,0,1,0
16,276,276,31,31,0,1,0
25,280,280,77,77,0,1,0
15,280,280,28,10,18,4,3
0,280,280,31,6,25,2,1
18,285,285,15,15,0,1,0
10,299,299,37,12,25,2,1
26,310,310,15,15,0,1,0
1,314,314,39,5,34,3,2
37,317,317,4,4,0,1,0
2,332,332,43,25,18,4,3
40,336,336,6,6,0,1,0
33,361,361,28,12,16,2,1
13,372,372,31,13,18,4,3
7,377,377,65,65,0,1,0
28,378,378,18,18,0,1,0
3,380,380,22,10,12,4,3
36,382,382,75,75,0,1,0
20,397,397,8,2,6,3,2
6,416,416,39,27,12,2,1
14,428,428,56,2,54,3,2
29,458,458,63,63,0,1,0
19,479,479,16,16,0,1,0
32,497,497,5,1,4,2,1
17,499,499,11,11,0,1,0

29,113,113,4,4,0,1,0
39,116,116,35,35,0,1,0
12,126,126,8,1,7,2,1
42,128,128,6,6,0,1,0
40,135,135,32,32,0,1,0
5,151,151,13,13,0,1,0
37,168,168,2,2,0,1,0
1,206,206,8,8,0,1,0
7,206,206,12,12,0,1,0
25,207,207,11,6,5,2,1
2,222,222,30,14,16,2,1
38,223,223,21,13,8,2,1
35,224,224,45,45,0,1,0
3,229,229,48,48,0,1,0
17,234,234,4,4,0,1,0
18,238,238,2,2,0,1,0
19,262,262,16,16,0,1,0
14,266,266,39,15,24,3,2
41,269,269,40,8,32,2,1
21,274,274,28,24,4,2,1
34,320,320,75,75,0,1,0
4,331,331,52,52,0,1,0
27,337,337,31,31,0,1,0
8,345,345,42,42,0,1,0
36,345,345,5,2,3,2,1
31,354,354,11,11,0,1,0
22,355,355,6,6,0,1,0
24,357,357,38,38,0,1,0
32,357,357,42,3,39,4,3
30,357,357,28,28,0,1,0
13,360,360,6,6,0,1,0
15,360,360,44,44,0,1,0
26,366,366,9,9,0,1,0
10,370,370,22,22,0,1,0
28,375,375,8,8,0,1,0
11,424,424,1,1,0,1,0
0,430,430,45,13,32,2,1
33,440,440,41,41,0,1,0
20,442,442,1,1,0,1,0
16,444,444,14,2,12,4,3
6,452,452,78,78,0,1,0
23,463,463,44,22,22,2,1
9,484,484,35,11,24,4,3

35,104,104,14,14,0,1,0
17,109,109,2,2,0,1,0
8,125,125,1,1,0,1,0
31,150,150,3,3,0,1,0
33,167,167,2,2,0,1,0
30,170,170,16,16,0,1,0
22,171,171,4,4,0,1,0
9,174,174,16,16,0,1,0
5,177,177,1,1,0,1,0
27,186,186,17,17,0,1,0
21,189,189,12,4,8,3,2
36,199,199,7,7,0,1,0
14,212,212,9,6,3,2,1
13,228,228,29,17,12,2,1
26,232,232,12,12,0,1,0
15,247,247,122,122,0,1,0
23,251,251,28,28,0,1,0
20,254,254,32,1,31,2,1
25,271,271,91,73,18,3,2
3,283,283,10,10,0,1,0
4,292,292,16,4,12,4,3
24,299,299,1,1,0,1,0
28,309,309,11,1,10,2,1
1,310,310,94,39,55,3,2
12,313,313,14,14,0,1,0
6,340,340,193,193,0,1,0
2,341,341,9,9,0,1,0
7,345,345,1,1,0,1,0
37,358,358,17,2,15,2,1
0,373,373,3,3,0,1,0
11,406,406,21,3,18,4,3
10,415,415,2,2,0,1,0
32,426,426,69,69,0,1,0
29,427,427,73,73,0,1,0
16,435,435,5,5,0,1,0
34,440,440,102,4,98,3,2
18,446,446,1,1,0,1,0
19,455,455,88,49,39,4,3

2,119,119,29,20,9,4,3
11,120,120,2,2,0,1,0
30,124,124,1,1,0,1,0
18,143,143,49,46,3,2,1
29,147,147,14,14,0,1,0
16,151,151,9,9,0,1,0
23,151,151,12,6,6,2,1
7,160,160,23,23,0,1,0
22,160,160,5,2,3,2,1
4,176,176,14,9,5,2,1
12,178,178,6,6,0,1,0
8,196,196,22,22,0,1,0
9,202,202,2,2,0,1,0
17,213,213,50,50,0,1,0
3,218,218,31,11,20,3,2
27,231,231,13,13,0,1,0
28,242,242,18,3,15,4,3
13,252,252,3,3,0,1,0
5,260,260,5,5,0,1,0
19,268,268,62,47,15,2,1
10,269,269,79,79,0,1,0
20,290,290,17,14,3,2,1
31,302,302,99,99,0,1,0
6,305,305,94,34,60,3,2
26,342,342,10,10,0,1,0
25,362,362,1,1,0,1,0
0,400,400,45,45,0,1,0
21,407,407,9,2,7,2,1
15,424,424,4,4,0,1,0
14,452,452,17,5,12,4,3
24,475,475,109,47,62,3,2
1,494,494,191,191,0,1,0

3,116,116,14,14,0,1,0
29,118,118,11,5,6,2,1
28,135,135,23,11,12,3,2
23,142,142,7,2,5,2,1
12,178,178,15,15,0,1,0
24,189,189,17,9,8,3,2
22,210,210,3,3,0,1,0
33,210,210,45,37,8,2,1
14,232,232,33,33,0,1,0
10,235,235,9,1,8,3,2
0,236,236,86,6,80,4,3
34,238,238,48,40,8,2,1
35,254,254,39,19,20,3,2
2,268,268,52,52,0,1,0
16,269,269,23,23,0,1,0
20,278,278,21,5,16,2,1
17,281,281,47,27,20,3,2
30,284,284,53,9,44,3,2
18,289,289,55,40,15,2,1
25,290,290,24,24,0,1,0
37,298,298,23,6,17,2,1
4,302,302,22,8,14,3,2
19,315,315,3,3,0,1,0
21,341,341,69,37,32,4,3
32,348,348,56,15,41,2,1
31,360,360,9,9,0,1,0
27,360,360,17,8,9,4,3
7,371,371,14,14,0,1,0
38,372,372,22,18,4,2,1
1,375,375,41,41,0,1,0
6,379,379,21,14,7,2,1
8,382,382,15,3,12,3,2
36,384,384,12,12,0,1,0
9,423,423,51,1,50,3,2
11,432,432,1,1,0,1,0
26,445,445,3,3,0,1,0
15,450,450,6,6,0,1,0
5,460,460,12,1,11,2,1
13,471,471,14,5,9,4,3

20,108,108,4,4,0,1,0
10,139,139,15,15,0,1,0
13,155,155,36,20,16,3,2
24,187,187,4,4,0,1,0
4,190,190,7,7,0,1,0
34,198,198,47,47,0,1,0
12,214,214,1,1,0,1,0
14,223,223,91,91,0,1,0
29,226,226,40,40,0,1,0
33,227,227,10,1,9,2,1
8,228,228,4,4,0,1,0
18,239,239,24,18,6,3,2
31,253,253,8,8,0,1,0
23,262,262,41,22,19,2,1
9,280,280,12,12,0,1,0
25,283,283,11,4,7,2,1
32,296,296,55,55,0,1,0
5,314,314,1,1,0,1,0
7,322,322,117,117,0,1,0
21,333,333,52,52,0,1,0
30,333,333,24,16,8,2,1
0,373,373,44,18,26,3,2
6,375,375,100,88,12,2,1
1,385,385,10,10,0,1,0
26,386,386,10,7,3,2,1
2,398,398,47,25,22,2,1
17,420,420,52,52,0,1,0
3,421,421,4,4,0,1,0
22,440,440,54,36,18,2,1
19,445,445,103,79,24,4,3
11,451,451,51,51,0,1,0
15,470,470,16,16,0,1,0
27,483,483,9,1,8,3,2
28,486,486,36,36,0,1,0
16,500,500,41,7,34,3,2

32,100,100,12,12,0,1,0
27,107,107,24,12,12,2,1
11,135,135,12,1,11,2,1
9,135,135,33,12,21,2,1
14,137,137,3,3,0,1,0
33,152,152,7,7,0,1,0
22,160,160,15,8,7,2,1
8,174,174,1,1,0,1,0
20,181,181,1,1,0,1,0
34,191,191,54,23,31,4,3
0,196,196,37,28,9,4,3
10,202,202,47,47,0,1,0
4,208,208,10,10,0,1,0
28,212,212,15,15,0,1,0
19,215,215,10,10,0,1,0
26,243,243,19,4,15,2,1
25,256,256,1,1,0,1,0
16,261,261,55,12,43,2,1
6,324,324,7,7,0,1,0
17,330,330,39,39,0,1,0
23,353,353,28,28,0,1,0
2,357,357,30,12,18,4,3
15,358,358,44,44,0,1,0
7,372,372,69,35,34,4,3
18,378,378,62,62,0,1,0
5,401,401,62,59,3,2,1
13,404,404,25,5,20,2,1
1,405,405,20,11,9,2,1
3,417,417,77,77,0,1,0
12,442,442,91,25,66,4,3
30,445,445,111,23,88,4,3
21,476,476,25,7,18,3,2
29,487,487,12,9,3,2,1
24,491,491,6,6,0,1,0
31,492,492,32,6,26,3,2

11,103,103,14,6,8,2,1
2,111,111,5,1,4,2,1
31,111,111,15,15,0,1,0
13,115,115,42,42,0,1,0
19,124,124,16,10,6,3,2
4,153,153,57,11,46,3,2
25,163,163,12,12,0,1,0
5,182,182,4,4,0,1,0
26,182,182,18,18,0,1,0
16,192,192,35,7,28,3,2
17,194,194,7,1,6,3,2
6,197,197,18,18,0,1,0
23,258,258,26,1,25,2,1
9,275,275,136,46,90,4,3
30,283,283,1,1,0,1,0
15,288,288,50,4,46,2,1
3,304,304,44,44,0,1,0
24,308,308,28,28,0,1,0
20,333,333,10,10,0,1,0
7,356,356,46,46,0,1,0
14,368,368,10,4,6,2,1
10,371,371,11,11,0,1,0
29,381,381,6,1,5,2,1
32,384,384,34,34,0,1,0
18,392,392,9,1,8,3,2
21,399,399,96,82,14,3,2
1,412,412,2,2,0,1,0
0,415,415,5,5,0,1,0
28,435,435,123,116,7,2,1
27,441,441,48,4,44,2,1
8,460,460,12,12,0,1,0
12,485,485,17,2,15,2,1
22,486,486,47,24,23,3,2

19,103,103,3,3,0,1,0
22,106,106,1,1,0,1,0
28,130,130,18,2,16,3,2
20,136,136,5,5,0,1,0
10,153,153,17,8,9,4,3
29,156,156,11,11,0,1,0
27,169,169,20,20,0,1,0
11,179,179,3,3,0,1,0
35,185,185,10,10,0,1,0
13,206,206,51,51,0,1,0
25,209,209,47,25,22,3,2
30,211,211,33,9,24,3,2
18,216,216,27,27,0,1,0
24,227,227,59,59,0,1,0
26,232,232,25,25,0,1,0
7,241,241,57,57,0,1,0
17,264,264,2,2,0,1,0
14,268,268,42,3,39,4,3
1,270,270,15,1,14,2,1
32,272,272,82,58,24,4,3
3,298,298,5,2,3,2,1
21,301,301,33,33,0,1,0
23,309,309,10,4,6,2,1
33,324,324,9,9,0,1,0
5,366,366,24,24,0,1,0
34,367,367,18,9,9,4,3
9,387,387,127,78,49,4,3
36,423,423,29,5,24,3,2
8,430,430,36,36,0,1,0
0,434,434,2,2,0,1,0
16,435,435,25,15,10,2,1
31,435,435,13,13,0,1,0
2,459,459,35,35,0,1,0
12,463,463,71,21,50,3,2
4,465,465,1,1,0,1,0
15,476,476,132,132,0,1,0
6,492,492,3,3,0,1,0

0,108,108,3,3,0,1,0
14,108,108,1,1,0,1,0
7,117,117,9,4,5,2,1
2,118,118,9,3,6,3,2
21,123,123,23,23,0,1,0
43,130,130,15,15,0,1,0
38,133,133,11,11,0,1,0
32,133,133,19,19,0,1,0
15,137,137,10,10,0,1,0
34,156,156,16,16,0,1,0
37,158,158,4,4,0,1,0
27,179,179,25,21,4,2,1
22,184,184,19,19,0,1,0
20,195,195,20,2,18,2,1
12,210,210,11,5,6,3,2
19,227,227,3,3,0,1,0
24,236,236,48,12,36,3,2
26,236,236,9,9,0,1,0
16,254,254,1,1,0,1,0
42,263,263,13,7,6,3,2
3,288,288,23,23,0,1,0
9,293,293,34,34,0,1,0
41,301,301,43,16,27,4,3
36,315,315,2,2,0,1,0
6,330,330,6,6,0,1,0
23,338,338,11,5,6,2,1
17,343,343,7,7,0,1,0
8,360,360,45,21,24,3,2
18,368,368,38,38,0,1,0
39,370,370,17,5,12,2,1
30,371,371,17,12,5,2,1
11,383,383,39,18,21,4,3
13,387,387,9,3,6,2,1
29,389,389,125,125,0,1,0
5,416,416,10,2,8,3,2
33,419,419,30,30,0,1,0
28,427,427,69,31,38,2,1
4,428,428,11,4,7,2,1
35,434,434,51,40,11,2,1
31,436,436,34,5,29,2,1
25,472,472,75,75,0,1,0
40,476,476,43,20,23,2,1
10,481,481,22,22,0,1,0
1,487,487,126,9,117,4,3

6,102,102,8,1,7,2,1
11,103,103,5,5,0,1,0
22,110,110,8,8,0,1,0
3,117,117,4,1,3,2,1
5,128,128,1,1,0,1,0
2,156,156,33,17,16,3,2
18,161,161,36,36,0,1,0
17,186,186,14,14,0,1,0
34,204,204,11,11,0,1,0
7,217,217,16,7,9,2,1
29,244,244,1,1,0,1,0
35,254,254,15,10,5,2,1
31,257,257,6,6,0,1,0
12,275,275,50,10,40,4,3
28,283,283,170,170,0,1,0
8,304,304,21,9,12,4,3
26,304,304,41,10,31,4,3
30,334,334,5,5,0,1,0
1,334,334,95,95,0,1,0
23,342,342,100,100,0,1,0
14,345,345,18,11,7,2,1
4,351,351,24,6,18,2,1
19,353,353,23,9,14,2,1
9,353,353,6,6,0,1,0
15,356,356,21,21,0,1,0
24,366,366,3,3,0,1,0
27,409,409,5,5,0,1,0
25,410,410,38,16,22,3,2
0,443,443,46,46,0,1,0
10,445,445,105,92,13,2,1
13,449,449,74,50,24,4,3
32,463,463,13,3,10,3,2
16,465,465,63,63,0,1,0
33,468,468,13,13,0,1,0
36,480,480,98,47,51,4,3
20,495,495,8,8,0,1,0
21,500,500,1,1,0,1,0

18,101,101,7,7,0,1,0
17,110,110,25,25,0,1,0
10,121,121,24,15,9,2,1
19,125,125,41,41,0,1,0
12,127,127,1,1,0,1,0
27,213,213,43,34,9,4,3
28,214,214,8,8,0,1,0
32,216,216,1,1,0,1,0
4,218,218,94,94,0,1,0
29,258,258,40,35,5,2,1
31,262,262,12,12,0,1,0
0,265,265,22,1,21,2,1
6,267,267,10,1,9,4,3
21,269,269,13,13,0,1,0
20,276,276,11,1,10,3,2
16,278,278,22,22,0,1,0
22,280,280,21,10,11,2,1
8,281,281,28,28,0,1,0
5,286,286,2,2,0,1,0
23,357,357,69,7,62,3,2
1,377,377,10,1,9,4,3
25,382,382,25,25,0,1,0
15,390,390,75,57,18,3,2
30,398,398,45,28,17,2,1
13,417,417,113,113,0,1,0
2,424,424,110,110,0,1,0
7,429,429,8,8,0,1,0
9,450,450,57,57,0,1,0
26,466,466,18,18,0,1,0
14,469,469,2,2,0,1,0
24,489,489,15,15,0,1,0
3,490,490,115,115,0,1,0
11,495,495,49,41,8,2,1

19,104,104,15,15,0,1,0
20,140,140,5,2,3,2,1
22,154,154,6,6,0,1,0
17,154,154,13,9,4,2,1
25,158,158,32,32,0,1,0
0,163,163,9,3,6,3,2
29,174,174,44,14,30,2,1
24,217,217,33,5,28,2,1
31,236,236,9,3,6,3,2
27,243,243,50,4,46,3,2
16,266,266,33,16,17,2,1
2,278,278,25,25,0,1,0
8,279,279,12,7,5,2,1
18,290,290,31,14,17,2,1
13,299,299,1,1,0,1,0
3,302,302,34,34,0,1,0
1,309,309,47,47,0,1,0
26,320,320,7,7,0,1,0
9,341,341,5,5,0,1,0
11,347,347,269,233,36,4,3
30,351,351,8,8,0,1,0
23,354,354,82,82,0,1,0
6,357,357,104,104,0,1,0
5,360,360,6,6,0,1,0
15,381,381,30,24,6,2,1
7,400,400,23,23,0,1,0
12,418,418,26,8,18,3,2
10,429,429,30,4,26,3,2
21,439,439,34,34,0,1,0
28,441,441,13,3,10,2,1
4,466,466,75,13,62,3,2
14,495,495,45,45,0,1,0

29,120,120,4,4,0,1,0
10,125,125,21,13,8,3,2
1,127,127,43,4,39,2,1
32,134,134,14,4,10,3,2
19,155,155,15,5,10,2,1
13,167,167,10,10,0,1,0
35,168,168,7,1,6,3,2
17,169,169,4,4,0,1,0
9,170,170,17,17,0,1,0
12,171,171,3,3,0,1,0
8,174,174,32,32,0,1,0
14,175,175,5,5,0,1,0
22,180,180,4,4,0,1,0
24,191,191,34,31,3,2,1
20,238,238,15,6,9,2,1
26,263,263,24,24,0,1,0
6,269,269,42,42,0,1,0
33,276,276,6,6,0,1,0
18,285,285,15,15,0,1,0
2,289,289,14,14,0,1,0
27,301,301,12,12,0,1,0
30,311,311,55,55,0,1,0
31,314,314,1,1,0,1,0
25,330,330,41,8,33,4,3
3,330,330,114,85,29,2,1
23,360,360,66,66,0,1,0
15,390,390,79,53,26,2,1
0,400,400,14,2,12,4,3
34,405,405,164,44,120,4,3
4,412,412,27,3,24,3,2
28,425,425,40,32,8,2,1
21,436,436,85,13,72,3,2
5,463,463,27,3,24,4,3
11,483,483,26,26,0,1,0
16,486,486,11,8,3,2,1
7,497,497,8,1,7,2,1

2,137,137,7,1,6,3,2
27,155,155,8,3,5,2,1
10,161,161,5,5,0,1,0
21,169,169,13,7,6,2,1
17,180,180,4,4,0,1,0
1,186,186,44,11,33,4,3
22,194,194,22,22,0,1,0
12,235,235,72,72,0,1,0
3,240,240,50,41,9,4,3
13,249,249,33,33,0,1,0
19,251,251,30,30,0,1,0
6,270,270,87,63,24,4,3
28,271,271,36,36,0,1,0
5,298,298,117,12,105,4,3
14,347,347,88,49,39,4,3
0,359,359,50,34,16,3,2
18,360,360,37,29,8,2,1
25,363,363,35,12,23,4,3
29,364,364,42,42,0,1,0
4,373,373,30,30,0,1,0
15,395,395,21,21,0,1,0
11,401,401,11,5,6,2,1
26,412,412,86,50,36,2,1
16,421,421,6,3,3,2,1
8,434,434,38,7,31,2,1
9,440,440,125,97,28,2,1
20,462,462,25,7,18,3,2
24,470,470,20,20,0,1,0
23,472,472,7,7,0,1,0
7,478,478,32,16,16,3,2

5,102,102,1,1,0,1,0
21,137,137,1,1,0,1,0
20,137,137,9,3,6,3,2
8,142,142,19,19,0,1,0
13,144,144,14,14,0,1,0
24,155,155,3,3,0,1,0
1,167,167,54,54,0,1,0
4,167,167,14,10,4,2,1
32,178,178,5,5,0,1,0
3,181,181,41,35,6,3,2
6,184,184,8,1,7,2,1
11,196,196,10,10,0,1,0
17,201,201,10,10,0,1,0
22,211,211,70,2,68,3,2
27,218,218,18,18,0,1,0
26,219,219,32,32,0,1,0
31,222,222,69,43,26,2,1
30,245,245,8,8,0,1,0
29,248,248,16,4,12,3,2
10,250,250,36,2,34,4,3
0,255,255,4,4,0,1,0
34,276,276,2,2,0,1,0
28,298,298,15,15,0,1,0
25,321,321,10,10,0,1,0
16,339,339,7,7,0,1,0
2,342,342,12,1,11,2,1
19,352,352,4,4,0,1,0
37,360,360,3,3,0,1,0
23,370,370,49,49,0,1,0
33,403,403,203,110,93,4,3
36,415,415,13,1,12,2,1
35,416,416,30,30,0,1,0
18,441,441,11,6,5,2,1
14,449,449,21,3,18,3,2
7,468,468,79,79,0,1,0
9,468,468,56,42,14,2,1
15,498,498,129,21,108,4,3
12,499,499,24,24,0,1,0

20,113,113,3,3,0,1,0
28,119,119,33,16,17,2,1
18,153,153,11,1,10,3,2
13,154,154,28,28,0,1,0
23,158,158,9,9,0,1,0
6,171,171,16,16,0,1,0
0,202,202,19,16,3,2,1
15,214,214,13,1,12,2,1
31,214,214,26,26,0,1,0
30,230,230,11,11,0,1,0
7,251,251,3,3,0,1,0
10,253,253,44,44,0,1,0
9,283,283,12,12,0,1,0
33,286,286,19,19,0,1,0
29,289,289,100,5,95,4,3
1,289,289,15,3,12,3,2
3,290,290,4,4,0,1,0
14,301,301,75,75,0,1,0
5,302,302,123,123,0,1,0
16,305,305,6,6,0,1,0
12,315,315,36,36,0,1,0
11,336,336,14,14,0,1,0
35,338,338,6,6,0,1,0
21,339,339,68,5,63,4,3
27,353,353,50,50,0,1,0
2,362,362,5,5,0,1,0
22,364,364,26,26,0,1,0
26,378,378,5,5,0,1,0
32,387,387,74,42,32,3,2
17,390,390,29,14,15,3,2
24,419,419,12,7,5,2,1
25,423,423,8,5,3,2,1
4,451,451,36,31,5,2,1
36,458,458,4,4,0,1,0
8,466,466,82,16,66,3,2
19,471,471,21,5,16,2,1
34,480,480,88,30,58,3,2

4,108,108,3,3,0,1,0
15,110,110,10,10,0,1,0
36,134,134,2,2,0,1,0
22,136,136,18,10,8,3,2
3,154,154,24,4,20,3,2
14,158,158,21,1,20,2,1
8,172,172,4,4,0,1,0
11,173,173,24,24,0,1,0
0,180,180,16,6,10,2,1
37,180,180,7,7,0,1,0
40,194,194,22,22,0,1,0
29,224,224,52,12,40,3,2
45,226,226,34,34,0,1,0
2,230,230,10,10,0,1,0
16,245,245,2,2,0,1,0
39,245,245,5,5,0,1,0
9,280,280,31,9,22,3,2
10,284,284,10,4,6,3,2
34,290,290,44,44,0,1,0
31,296,296,29,23,6,3,2
13,305,305,28,28,0,1,0
23,327,327,22,22,0,1,0
1,328,328,27,27,0,1,0
5,332,332,62,62,0,1,0
27,335,335,54,22,32,2,1
7,336,336,14,9,5,2,1
18,337,337,15,15,0,1,0
25,340,340,20,20,0,1,0
41,346,346,123,123,0,1,0
12,347,347,11,11,0,1,0
6,352,352,20,8,12,3,2
17,352,352,10,10,0,1,0
35,401,401,28,28,0,1,0
42,406,406,61,15,46,2,1
19,426,426,40,7,33,4,3
43,434,434,47,47,0,1,0
38,438,438,8,1,7,3,2
32,464,464,16,7,9,2,1
33,469,469,61,17,44,3,2
28,474,474,3,3,0,1,0
44,480,480,15,15,0,1,0
20,483,483,3,3,0,1,0
26,485,485,6,6,0,1,0
30,490,490,25,8,17,2,1
24,493,493,35,35,0,1,0
21,498,498,20,8,12,4,3

27,105,105,10,10,0,1,0
4,126,126,2,2,0,1,0
3,139,139,9,9,0,1,0
12,143,143,2,2,0,1,0
17,144,144,13,1,12,2,1
5,155,155,70,70,0,1,0
11,167,167,6,3,3,2,1
7,169,169,6,3,3,2,1
30,175,175,4,4,0,1,0
8,194,194,61,61,0,1,0
9,203,203,21,9,12,4,3
20,231,231,7,7,0,1,0
2,234,234,80,29,51,3,2
14,240,240,29,29,0,1,0
33,257,257,8,8,0,1,0
13,262,262,25,25,0,1,0
19,285,285,14,14,0,1,0
23,291,291,96,56,40,3,2
10,316,316,24,24,0,1,0
16,327,327,13,1,12,2,1
31,334,334,30,30,0,1,0
21,336,336,81,11,70,3,2
26,339,339,54,54,0,1,0
25,341,341,57,20,37,4,3
22,346,346,40,6,34,3,2
34,351,351,48,48,0,1,0
32,373,373,14,14,0,1,0
15,384,384,42,2,40,3,2
6,389,389,9,1,8,2,1
18,393,393,14,14,0,1,0
1,398,398,5,5,0,1,0
29,400,400,60,60,0,1,0
28,401,401,9,9,0,1,0
24,454,454,43,43,0,1,0
0,474,474,41,41,0,1,0

36,111,111,30,14,16,3,2
32,113,113,7,7,0,1,0
1,121,121,10,10,0,1,0
20,127,127,5,2,3,2,1
9,130,130,12,12,0,1,0
0,138,138,14,14,0,1,0
31,147,147,16,16,0,1,0
27,181,181,11,11,0,1,0
24,183,183,2,2,0,1,0
11,199,199,31,15,16,2,1
21,202,202,1,1,0,1,0
30,203,203,21,6,15,4,3
6,205,205,16,12,4,2,1
8,217,217,4,4,0,1,0
29,244,244,38,38,0,1,0
17,249,249,1,1,0,1,0
38,263,263,51,51,0,1,0
23,268,268,74,32,42,2,1
4,269,269,10,5,5,2,1
3,290,290,5,1,4,2,1
18,292,292,15,15,0,1,0
33,319,319,3,3,0,1,0
34,320,320,4,1,3,2,1
7,326,326,16,16,0,1,0
13,327,327,114,74,40,3,2
5,341,341,54,54,0,1,0
39,349,349,44,44,0,1,0
28,357,357,51,42,9,2,1
22,363,363,104,104,0,1,0
15,367,367,65,25,40,2,1
2,368,368,10,10,0,1,0
35,389,389,35,14,21,2,1
10,393,393,64,32,32,4,3
26,404,404,3,3,0,1,0
16,410,410,52,52,0,1,0
12,411,411,4,4,0,1,0
37,426,426,8,5,3,2,1
14,433,433,44,44,0,1,0
25,457,457,5,5,0,1,0
19,465,465,30,2,28,3,2

27,101,101,9,9,0,1,0
34,136,136,17,17,0,1,0
18,140,140,3,3,0,1,0
44,148,148,6,6,0,1,0
28,150,150,23,16,7,2,1
47,152,152,1,1,0,1,0
20,154,154,13,8,5,2,1
3,157,157,1,1,0,1,0
36,166,166,8,4,4,2,1
8,172,172,20,20,0,1,0
16,173,173,7,2,5,2,1
14,176,176,2,2,0,1,0
25,176,176,16,10,6,3,2
6,178,178,23,11,12,2,1
42,189,189,4,4,0,1,0
17,196,196,11,3,8,2,1
31,197,197,51,19,32,2,1
2,208,208,31,7,24,2,1
41,223,223,70,25,45,4,3
35,227,227,8,1,7,2,1
29,247,247,34,13,21,2,1
39,260,260,22,4,18,4,3
21,268,268,1,1,0,1,0
5,283,283,22,8,14,2,1
40,289,289,84,84,0,1,0
10,311,311,16,13,3,2,1
13,347,347,2,2,0,1,0
22,352,352,14,6,8,2,1
19,354,354,1,1,0,1,0
33,355,355,38,29,9,4,3
9,359,359,2,2,0,1,0
24,366,366,8,8,0,1,0
15,387,387,21,21,0,1,0
45,407,407,51,20,31,4,3
1,409,409,54,27,27,2,1
37,413,413,26,26,0,1,0
4,420,420,1,1,0,1,0
48,424,424,11,11,0,1,0
32,436,436,69,69,0,1,0
23,438,438,5,5,0,1,0
30,443,443,12,3,9,4,3
12,448,448,89,71,18,3,2
11,458,458,20,20,0,1,0
26,464,464,16,16,0,1,0
38,468,468,36,18,18,4,3
0,473,473,33,33,0,1,0
46,474,474,13,2,11,2,1
43,483,483,50,12,38,3,2
7,496,496,31,4,27,2,1

38,101,101,12,12,0,1,0
8,123,123,14,14,0,1,0
23,124,124,8,5,3,2,1
6,132,132,5,5,0,1,0
18,164,164,15,15,0,1,0
24,166,166,11,11,0,1,0
7,172,172,14,6,8,2,1
25,181,181,34,34,0,1,0
11,203,203,70,6,64,3,2
37,205,205,9,9,0,1,0
9,218,218,16,7,9,4,3
15,221,221,2,2,0,1,0
14,242,242,6,6,0,1,0
3,256,256,12,12,0,1,0
5,267,267,32,11,21,4,3
30,270,270,5,5,0,1,0
34,294,294,3,3,0,1,0
1,296,296,8,8,0,1,0
29,298,298,6,6,0,1,0
4,310,310,67,44,23,2,1
12,318,318,18,10,8,3,2
28,331,331,12,4,8,3,2
33,338,338,11,11,0,1,0
35,353,353,173,70,103,4,3
17,360,360,17,17,0,1,0
22,368,368,33,33,0,1,0
0,377,377,29,21,8,2,1
27,388,388,7,1,6,2,1
10,403,403,109,109,0,1,0
32,416,416,6,6,0,1,0
31,417,417,68,68,0,1,0
19,422,422,12,2,10,3,2
39,427,427,24,24,0,1,0
2,434,434,65,45,20,2,1
26,437,437,50,30,20,2,1
16,469,469,11,6,5,2,1
13,480,480,16,9,7,2,1
21,490,490,27,9,18,4,3
20,497,497,14,14,0,1,0
36,499,499,170,107,63,4,3

20,115,115,13,13,0,1,0
12,129,129,2,2,0,1,0
35,171,171,30,8,22,4,3
7,172,172,4,4,0,1,0
34,193,193,43,1,42,3,2
21,210,210,61,3,58,3,2
26,226,226,1,1,0,1,0
1,236,236,53,23,30,3,2
36,245,245,7,7,0,1,0
29,248,248,18,5,13,4,3
11,255,255,21,21,0,1,0
17,256,256,18,18,0,1,0
30,265,265,33,33,0,1,0
14,266,266,14,3,11,4,3
8,282,282,36,17,19,4,3
0,288,288,12,4,8,3,2
3,295,295,28,28,0,1,0
28,299,299,93,70,23,2,1
5,319,319,53,35,18,2,1
2,329,329,30,5,25,4,3
10,340,340,5,5,0,1,0
22,348,348,1,1,0,1,0
6,381,381,106,43,63,4,3
33,385,385,26,26,0,1,0
13,394,394,43,19,24,3,2
18,401,401,25,11,14,3,2
16,405,405,7,3,4,2,1
24,418,418,26,26,0,1,0
4,422,422,86,21,65,4,3
23,422,422,43,43,0,1,0
19,444,444,14,14,0,1,0
9,447,447,74,26,48,2,1
25,454,454,28,23,5,2,1
15,462,462,56,56,0,1,0
31,462,462,10,10,0,1,0
27,475,475,12,12,0,1,0
32,500,500,75,75,0,1,0

21,104,104,1,1,0,1,0
20,104,104,20,20,0,1,0
7,125,125,3,3,0,1,0
0,126,126,2,2,0,1,0
19,127,127,29,29,0,1,0
2,144,144,10,10,0,1,0
1,168,168,2,2,0,1,0
4,168,168,58,24,34,2,1
8,177,177,11,3,8,2,1
22,200,200,4,4,0,1,0
29,202,202,18,4,14,2,1
3,212,212,6,2,4,2,1
28,216,216,32,32,0,1,0
33,229,229,4,4,0,1,0
5,257,257,23,23,0,1,0
6,271,271,13,13,0,1,0
18,290,290,13,13,0,1,0
26,297,297,16,1,15,2,1
17,303,303,10,5,5,2,1
24,306,306,2,2,0,1,0
10,316,316,1,1,0,1,0
16,350,350,33,33,0,1,0
30,354,354,33,33,0,1,0
13,355,355,230,188,42,3,2
32,365,365,94,6,88,3,2
9,383,383,15,5,10,2,1
12,393,393,33,7,26,3,2
31,401,401,4,4,0,1,0
25,409,409,8,4,4,2,1
34,409,409,53,53,0,1,0
11,420,420,12,1,11,2,1
14,432,432,115,105,10,2,1
27,469,469,84,51,33,2,1
15,470,470,65,65,0,1,0
23,494,494,156,104,52,3,2

6,102,102,8,2,6,3,2
13,107,107,5,5,0,1,0
23,115,115,4,4,0,1,0
39,117,117,35,8,27,2,1
2,128,128,11,2,9,2,1
37,135,135,22,22,0,1,0
18,146,146,5,5,0,1,0
26,156,156,32,32,0,1,0
24,173,173,27,2,25,2,1
9,178,178,10,10,0,1,0
16,183,183,9,9,0,1,0
32,204,204,1,1,0,1,0
40,223,223,20,5,15,4,3
20,233,233,5,5,0,1,0
30,249,249,9,9,0,1,0
5,256,256,1,1,0,1,0
38,284,284,3,3,0,1,0
27,311,311,78,38,40,2,1
12,331,331,27,27,0,1,0
15,337,337,13,3,10,3,2
34,338,338,18,18,0,1,0
1,339,339,10,10,0,1,0
7,362,362,2,2,0,1,0
11,366,366,17,3,14,2,1
17,368,368,44,44,0,1,0
31,372,372,22,4,18,3,2
43,378,378,50,50,0,1,0
19,386,386,107,7,100,3,2
14,401,401,92,64,28,2,1
25,408,408,28,28,0,1,0
41,424,424,1,1,0,1,0
42,428,428,7,7,0,1,0
0,442,442,29,3,26,3,2
36,453,453,107,18,89,4,3
28,457,457,18,6,12,4,3
35,461,461,6,6,0,1,0
22,466,466,77,37,40,3,2
21,480,480,17,14,3,2,1
3,482,482,47,35,12,4,3
33,483,483,28,1,27,2,1
4,483,483,23,23,0,1,0
29,491,491,97,97,0,1,0
8,495,495,23,23,0,1,0
10,498,498,24,24,0,1,0

27,104,104,4,4,0,1,0
25,106,106,44,44,0,1,0
40,117,117,8,2,6,2,1
8,122,122,32,4,28,2,1
32,136,136,19,19,0,1,0
20,143,143,1,1,0,1,0
13,143,143,3,3,0,1,0
11,164,164,1,1,0,1,0
12,174,174,35,35,0,1,0
3,189,189,11,4,7,2,1
6,207,207,48,48,0,1,0
39,216,216,66,5,61,4,3
37,230,230,8,4,4,2,1
15,232,232,10,5,5,2,1
19,235,235,45,23,22,3,2
22,236,236,6,6,0,1,0
30,236,236,8,2,6,3,2
2,241,241,18,4,14,2,1
17,252,252,39,39,0,1,0
28,269,269,33,33,0,1,0
10,270,270,10,3,7,2,1
29,279,279,13,7,6,2,1
7,318,318,83,48,35,3,2
33,321,321,41,41,0,1,0
16,329,329,15,15,0,1,0
34,350,350,5,2,3,2,1
41,362,362,22,22,0,1,0
24,362,362,18,18,0,1,0
21,367,367,33,7,26,3,2
0,370,370,6,6,0,1,0
14,381,381,1,1,0,1,0
5,393,393,10,10,0,1,0
23,399,399,12,12,0,1,0
18,403,403,13,13,0,1,0
31,411,411,101,53,48,4,3
38,415,415,9,9,0,1,0
26,431,431,35,11,24,3,2
9,438,438,4,4,0,1,0
36,458,458,28,28,0,1,0
4,459,459,11,11,0,1,0
35,494,494,15,10,5,2,1
1,500,500,40,1,39,4,3

29,109,109,12,12,0,1,0
11,115,115,24,10,14,4,3
27,131,131,4,4,0,1,0
41,147,147,6,6,0,1,0
22,153,153,9,1,8,2,1
19,154,154,2,2,0,1,0
36,173,173,38,5,33,4,3
33,186,186,40,11,29,4,3
26,204,204,12,9,3,2,1
4,217,217,46,46,0,1,0
34,226,226,18,18,0,1,0
39,227,227,12,9,3,2,1
35,232,232,36,6,30,2,1
25,274,274,10,10,0,1,0
12,288,288,16,3,13,2,1
7,293,293,9,1,8,3,2
24,293,293,25,5,20,2,1
32,297,297,43,1,42,2,1
9,300,300,1,1,0,1,0
10,301,301,1,1,0,1,0
31,303,303,9,9,0,1,0
21,314,314,71,29,42,4,3
18,323,323,24,2,22,2,1
2,331,331,23,23,0,1,0
37,338,338,115,53,62,4,3
17,341,341,21,21,0,1,0
28,357,357,15,15,0,1,0
16,360,360,19,7,12,2,1
40,389,389,54,54,0,1,0
5,410,410,3,3,0,1,0
0,435,435,73,73,0,1,0
1,437,437,86,86,0,1,0
13,443,443,1,1,0,1,0
30,445,445,3,3,0,1,0
20,447,447,18,18,0,1,0
6,474,474,19,19,0,1,0
23,475,475,8,8,0,1,0
8,476,476,59,59,0,1,0
38,476,476,65,65,0,1,0
3,477,477,94,79,15,2,1
14,480,480,12,12,0,1,0
15,492,492,17,11,6,2,1

31,103,103,4,1,3,2,1
9,116,116,15,15,0,1,0
12,117,117,13,3,10,2,1
24,118,118,2,2,0,1,0
6,119,119,1,1,0,1,0
7,172,172,21,21,0,1,0
20,172,172,35,29,6,3,2
28,182,182,12,3,9,2,1
25,199,199,2,2,0,1,0
23,211,211,13,3,10,2,1
16,250,250,13,8,5,2,1
26,258,258,33,1,32,2,1
2,284,284,38,38,0,1,0
4,307,307,7,7,0,1,0
30,316,316,57,19,38,3,2
29,317,317,9,9,0,1,0
11,335,335,49,17,32,2,1
10,348,348,25,25,0,1,0
15,351,351,70,4,66,4,3
21,358,358,34,1,33,2,1
14,373,373,40,1,39,2,1
19,381,381,101,101,0,1,0
27,397,397,18,18,0,1,0
0,429,429,12,2,10,3,2
32,443,443,21,21,0,1,0
5,461,461,134,118,16,2,1
18,466,466,46,25,21,4,3
8,468,468,145,145,0,1,0
13,474,474,132,12,120,4,3
17,475,475,137,105,32,3,2
3,482,482,52,52,0,1,0
1,486,486,68,59,9,4,3
22,487,487,3,3,0,1,0

17,109,109,72,10,62,3,2
13,121,121,3,3,0,1,0
12,127,127,30,30,0,1,0
22,129,129,2,2,0,1,0
0,131,131,12,12,0,1,0
31,139,139,4,4,0,1,0
14,152,152,8,8,0,1,0
23,160,160,22,22,0,1,0
35,174,174,19,13,6,2,1
27,178,178,12,12,0,1,0
19,187,187,27,27,0,1,0
1,199,199,10,10,0,1,0
9,214,214,16,16,0,1,0
34,236,236,91,1,90,3,2
29,243,243,49,41,8,2,1
6,263,263,11,11,0,1,0
32,270,270,10,5,5,2,1
20,270,270,18,6,12,3,2
8,287,287,7,7,0,1,0
7,302,302,6,6,0,1,0
30,308,308,61,61,0,1,0
25,311,311,13,3,10,2,1
4,312,312,7,7,0,1,0
5,338,338,38,12,26,2,1
10,342,342,2,2,0,1,0
2,349,349,18,18,0,1,0
28,369,369,14,2,12,2,1
36,371,371,33,3,30,2,1
15,377,377,1,1,0,1,0
3,390,390,25,9,16,2,1
24,409,409,4,4,0,1,0
33,419,419,1,1,0,1,0
18,424,424,83,67,16,3,2
11,465,465,20,14,6,2,1
26,478,478,21,9,12,3,2
16,490,490,159,56,103,4,3
21,499,499,65,65,0,1,0

28,142,142,9,9,0,1,0
14,153,153,2,2,0,1,0
0,169,169,14,14,0,1,0
15,169,169,1,1,0,1,0
6,187,187,20,5,15,2,1
31,188,188,16,16,0,1,0
7,204,204,115,75,40,2,1
20,208,208,15,2,13,2,1
1,210,210,36,5,31,2,1
13,234,234,35,35,0,1,0
32,240,240,37,16,21,4,3
11,240,240,35,35,0,1,0
27,261,261,52,3,49,2,1
21,283,283,35,35,0,1,0
5,295,295,48,48,0,1,0
16,298,298,7,7,0,1,0
2,302,302,1,1,0,1,0
8,303,303,27,27,0,1,0
24,308,308,85,85,0,1,0
4,312,312,2,2,0,1,0
26,331,331,12,4,8,2,1
10,334,334,9,9,0,1,0
23,338,338,12,12,0,1,0
25,344,344,36,12,24,4,3
3,354,354,4,4,0,1,0
18,369,369,95,73,22,2,1
30,381,381,43,11,32,2,1
12,429,429,148,111,37,2,1
17,432,432,38,38,0,1,0
29,440,440,21,7,14,2,1
9,444,444,17,17,0,1,0
22,453,453,6,1,5,2,1
19,477,477,109,15,94,4,3

20,105,105,7,7,0,1,0
22,140,140,2,2,0,1,0
9,146,146,1,1,0,1,0
2,164,164,33,33,0,1,0
0,193,193,10,10,0,1,0
25,202,202,62,33,29,4,3
14,207,207,17,17,0,1,0
15,234,234,43,43,0,1,0
21,266,266,7,7,0,1,0
23,273,273,27,10,17,3,2
17,296,296,8,8,0,1,0
4,315,315,213,203,10,3,2
10,331,331,11,11,0,1,0
24,344,344,41,28,13,4,3
18,351,351,3,3,0,1,0
5,373,373,13,13,0,1,0
1,381,381,92,92,0,1,0
6,389,389,36,3,33,4,3
27,391,391,71,71,0,1,0
16,391,391,210,204,6,2,1
19,400,400,42,29,13,2,1
26,412,412,7,7,0,1,0
7,414,414,139,77,62,3,2
8,423,423,26,26,0,1,0
13,445,445,20,20,0,1,0
12,467,467,3,3,0,1,0
11,488,488,34,34,0,1,0
3,500,500,103,5,98,4,3

23,106,106,11,11,0,1,0
37,125,125,24,24,0,1,0
30,135,135,1,1,0,1,0
28,145,145,7,3,4,2,1
13,168,168,34,18,16,2,1
22,182,182,3,3,0,1,0
6,192,192,4,4,0,1,0
24,201,201,32,4,28,3,2
34,236,236,22,22,0,1,0
9,240,240,2,2,0,1,0
3,241,241,58,14,44,2,1
2,245,245,15,15,0,1,0
31,259,259,5,2,3,2,1
29,262,262,12,12,0,1,0
8,263,263,22,22,0,1,0
35,274,274,5,1,4,2,1
19,288,288,66,66,0,1,0
16,295,295,103,79,24,4,3
4,304,304,2,2,0,1,0
15,314,314,1,1,0,1,0
18,317,317,97,18,79,3,2
12,321,321,41,41,0,1,0
20,332,332,4,4,0,1,0
5,341,341,1,1,0,1,0
26,374,374,52,16,36,4,3
21,376,376,33,26,7,2,1
32,392,392,61,19,42,4,3
25,406,406,18,18,0,1,0
33,414,414,169,169,0,1,0
1,414,414,93,93,0,1,0
36,434,434,36,8,28,2,1
27,448,448,35,35,0,1,0
0,469,469,7,7,0,1,0
10,470,470,2,2,0,1,0
14,475,475,5,5,0,1,0
7,489,489,14,14,0,1,0
11,496,496,88,11,77,4,3
17,500,500,14,14,0,1,0

5,106,106,3,3,0,1,0
1,110,110,1,1,0,1,0
3,143,143,4,4,0,1,0
18,143,143,6,6,0,1,0
8,162,162,1,1,0,1,0
14,173,173,61,19,42,3,2
29,187,187,19,9,10,3,2
31,199,199,5,5,0,1,0
13,233,233,53,22,31,4,3
30,235,235,8,3,5,2,1
21,267,267,29,3,26,3,2
16,268,268,54,54,0,1,0
20,270,270,48,31,17,2,1
0,291,291,25,25,0,1,0
7,313,313,55,55,0,1,0
32,318,318,128,99,29,2,1
33,328,328,5,5,0,1,0
9,353,353,18,8,10,3,2
15,360,360,2,2,0,1,0
2,369,369,81,5,76,3,2
10,384,384,53,53,0,1,0
6,396,396,27,27,0,1,0
25,400,400,20,17,3,2,1
27,414,414,106,82,24,4,3
23,417,417,17,17,0,1,0
22,418,418,56,56,0,1,0
24,422,422,25,25,0,1,0
26,431,431,24,3,21,4,3
17,431,431,14,10,4,2,1
12,434,434,118,60,58,4,3
19,461,461,54,54,0,1,0
11,483,483,96,96,0,1,0
28,489,489,32,32,0,1,0
4,492,492,20,20,0,1,0

11,101,101,16,4,12,2,1
20,103,103,36,36,0,1,0
9,112,112,4,4,0,1,0
24,123,123,16,16,0,1,0
14,129,129,3,3,0,1,0
7,130,130,5,5,0,1,0
29,132,132,1,1,0,1,0
3,135,135,1,1,0,1,0
32,170,170,49,49,0,1,0
31,179,179,29,29,0,1,0
6,199,199,19,9,10,2,1
16,205,205,37,10,27,3,2
5,216,216,26,19,7,2,1
0,218,218,10,5,5,2,1
30,230,230,12,12,0,1,0
22,253,253,2,2,0,1,0
15,255,255,55,29,26,3,2
2,262,262,11,4,7,2,1
25,263,263,14,10,4,2,1
28,270,270,20,20,0,1,0
18,272,272,7,7,0,1,0
23,287,287,32,24,8,2,1
26,287,287,40,40,0,1,0
12,288,288,2,2,0,1,0
10,317,317,126,95,31,2,1
27,349,349,7,7,0,1,0
33,355,355,8,2,6,3,2
21,363,363,5,5,0,1,0
35,367,367,2,2,0,1,0
8,375,375,15,15,0,1,0
17,383,383,13,13,0,1,0
19,415,415,98,35,63,4,3
4,449,449,98,98,0,1,0
34,480,480,100,82,18,4,3
1,481,481,81,30,51,4,3
13,497,497,54,11,43,2,1

17,107,107,1,1,0,1,0
20,112,112,12,6,6,3,2
24,118,118,35,35,0,1,0
0,119,119,36,6,30,4,3
10,152,152,17,5,12,3,2
15,157,157,4,4,0,1,0
38,167,167,3,3,0,1,0
31,170,170,6,6,0,1,0
3,172,172,5,5,0,1,0
29,180,180,21,21,0,1,0
14,192,192,32,32,0,1,0
2,194,194,1,1,0,1,0
1,212,212,1,1,0,1,0
39,238,238,23,8,15,4,3
42,258,258,7,7,0,1,0
7,260,260,19,1,18,4,3
4,266,266,2,2,0,1,0
25,269,269,13,1,12,4,3
26,282,282,6,3,3,2,1
33,287,287,37,21,16,2,1
19,295,295,1,1,0,1,0
21,301,301,11,6,5,2,1
9,332,332,13,4,9,4,3
37,338,338,75,48,27,4,3
8,345,345,47,7,40,2,1
35,347,347,24,24,0,1,0
11,370,370,5,5,0,1,0
36,377,377,46,1,45,4,3
43,387,387,103,80,23,4,3
16,389,389,4,4,0,1,0
5,394,394,16,1,15,4,3
6,394,394,6,6,0,1,0
28,426,426,80,80,0,1,0
13,429,429,62,26,36,3,2
40,432,432,36,12,24,4,3
23,437,437,107,66,41,4,3
41,444,444,65,6,59,4,3
30,449,449,32,17,15,2,1
12,452,452,31,7,24,3,2
22,454,454,2,2,0,1,0
18,456,456,5,5,0,1,0
27,461,461,71,19,52,3,2
34,479,479,28,28,0,1,0
32,482,482,30,10,20,2,1

29,106,106,8,2,6,3,2
23,107,107,7,7,0,1,0
40,117,117,6,6,0,1,0
10,120,120,12,4,8,2,1
38,122,122,2,2,0,1,0
30,131,131,5,5,0,1,0
21,135,135,5,5,0,1,0
0,137,137,41,41,0,1,0
36,137,137,11,11,0,1,0
16,171,171,7,3,4,2,1
5,181,181,1,1,0,1,0
27,193,193,9,3,6,2,1
3,195,195,35,35,0,1,0
39,206,206,17,3,14,2,1
20,212,212,12,4,8,2,1
24,241,241,49,49,0,1,0
19,243,243,10,10,0,1,0
22,248,248,26,4,22,2,1
32,257,257,9,2,7,2,1
2,276,276,13,5,8,2,1
42,284,284,20,2,18,3,2
33,285,285,27,27,0,1,0
41,287,287,38,2,36,3,2
18,290,290,8,8,0,1,0
37,314,314,76,65,11,2,1
7,330,330,26,16,10,3,2
35,338,338,23,23,0,1,0
11,350,350,18,18,0,1,0
4,367,367,23,15,8,2,1
9,375,375,23,23,0,1,0
17,384,384,41,41,0,1,0
6,385,385,7,7,0,1,0
34,397,397,35,4,31,2,1
1,398,398,10,10,0,1,0
12,399,399,37,37,0,1,0
14,410,410,70,46,24,3,2
8,429,429,81,81,0,1,0
31,430,430,43,9,34,3,2
15,436,436,18,18,0,1,0
13,452,452,1,1,0,1,0
26,453,453,49,24,25,2,1
25,473,473,180,111,69,4,3
28,492,492,13,13,0,1,0

13,103,103,1,1,0,1,0
19,112,112,26,26,0,1,0
16,124,124,6,2,4,2,1
8,134,134,18,14,4,2,1
23,134,134,1,1,0,1,0
20,164,164,45,12,33,2,1
31,165,165,5,5,0,1,0
10,169,169,17,9,8,3,2
30,173,173,21,1,20,3,2
14,180,180,21,3,18,4,3
17,191,191,4,1,3,2,1
29,208,208,41,41,0,1,0
5,216,216,19,14,5,2,1
4,222,222,11,1,10,2,1
2,224,224,5,5,0,1,0
18,234,234,9,9,0,1,0
27,257,257,12,12,0,1,0
6,278,278,2,2,0,1,0
33,301,301,42,42,0,1,0
22,322,322,29,7,22,2,1
7,342,342,226,211,15,4,3
24,346,346,18,18,0,1,0
21,352,352,78,78,0,1,0
9,360,360,15,15,0,1,0
1,370,370,158,126,32,3,2
0,370,370,19,19,0,1,0
11,371,371,28,28,0,1,0
15,401,401,31,31,0,1,0
25,403,403,78,6,72,4,3
26,417,417,21,1,20,2,1
32,432,432,25,25,0,1,0
12,449,449,5,5,0,1,0
3,465,465,51,25,26,3,2
28,489,489,21,21,0,1,0

29,100,100,1,1,0,1,0
36,102,102,9,9,0,1,0
21,136,136,27,27,0,1,0
7,159,159,29,29,0,1,0
26,161,161,8,8,0,1,0
13,177,177,15,15,0,1,0
20,181,181,47,16,31,2,1
32,199,199,23,23,0,1,0
10,204,204,14,14,0,1,0
24,226,226,30,27,3,2,1
0,259,259,49,4,45,4,3
35,275,275,21,16,5,2,1
30,279,279,14,14,0,1,0
11,279,279,15,1,14,3,2
23,283,283,3,3,0,1,0
31,302,302,34,34,0,1,0
4,305,305,13,1,12,2,1
6,306,306,55,55,0,1,0
25,314,314,54,26,28,2,1
5,336,336,30,22,8,3,2
22,340,340,6,6,0,1,0
3,345,345,33,3,30,3,2
27,356,356,61,61,0,1,0
18,363,363,33,33,0,1,0
16,417,417,17,5,12,3,2
28,428,428,60,37,23,2,1
12,431,431,123,32,91,4,3
1,459,459,38,38,0,1,0
2,466,466,6,6,0,1,0
9,468,468,35,35,0,1,0
17,473,473,10,10,0,1,0
14,477,477,16,8,8,3,2
8,480,480,131,131,0,1,0
34,491,491,50,2,48,2,1
33,492,492,43,43,0,1,0
15,496,496,45,45,0,1,0
19,499,499,28,28,0,1,0

2,113,113,1,1,0,1,0
14,117,117,15,15,0,1,0
34,128,128,9,3,6,2,1
21,130,130,17,5,12,2,1
24,136,136,6,6,0,1,0
13,147,147,28,12,16,2,1
6,174,174,5,5,0,1,0
20,189,189,17,7,10,2,1
25,196,196,68,59,9,4,3
7,213,213,4,4,0,1,0
4,227,227,5,5,0,1,0
40,250,250,33,27,6,2,1
36,251,251,8,3,5,2,1
5,254,254,12,5,7,2,1
33,264,264,33,33,0,1,0
18,267,267,63,56,7,2,1
30,270,270,6,6,0,1,0
35,272,272,22,9,13,2,1
28,278,278,89,89,0,1,0
39,291,291,27,6,21,4,3
23,303,303,26,26,0,1,0
29,312,312,38,5,33,4,3
22,339,339,9,9,0,1,0
31,340,340,38,26,12,4,3
12,354,354,5,5,0,1,0
27,359,359,6,6,0,1,0
1,365,365,5,5,0,1,0
32,389,389,58,13,45,4,3
17,391,391,28,21,7,2,1
0,415,415,80,80,0,1,0
8,432,432,51,5,46,2,1
9,435,435,18,18,0,1,0
26,457,457,18,18,0,1,0
3,457,457,128,26,102,4,3
16,457,457,24,15,9,4,3
38,461,461,36,11,25,2,1
37,469,469,19,7,12,3,2
15,481,481,21,14,7,2,1
10,484,484,49,5,44,2,1
11,490,490,22,19,3,2,1
19,498,498,13,13,0,1,0

13,102,102,9,9,0,1,0
6,109,109,2,2,0,1,0
19,127,127,18,6,12,2,1
15,135,135,5,5,0,1,0
3,151,151,5,2,3,2,1
28,153,153,14,14,0,1,0
2,158,158,1,1,0,1,0
14,166,166,14,14,0,1,0
20,178,178,12,12,0,1,0
16,190,190,33,8,25,2,1
22,206,206,22,6,16,2,1
27,208,208,32,4,28,2,1
23,209,209,10,10,0,1,0
34,212,212,23,23,0,1,0
12,213,213,57,23,34,3,2
11,213,213,5,5,0,1,0
29,241,241,9,3,6,3,2
38,242,242,5,5,0,1,0
17,259,259,51,26,25,2,1
0,276,276,17,1,16,4,3
37,290,290,10,10,0,1,0
9,292,292,2,2,0,1,0
35,308,308,95,95,0,1,0
30,327,327,19,19,0,1,0
10,337,337,30,12,18,4,3
8,346,346,109,109,0,1,0
24,347,347,23,5,18,4,3
36,382,382,9,9,0,1,0
4,399,399,10,10,0,1,0
33,403,403,9,4,5,2,1
18,409,409,1,1,0,1,0
1,426,426,63,63,0,1,0
5,432,432,66,4,62,3,2
21,436,436,138,138,0,1,0
32,451,451,66,50,16,3,2
25,454,454,4,4,0,1,0
31,455,455,55,38,17,2,1
7,462,462,14,5,9,4,3
26,478,478,96,96,0,1,0

21,102,102,20,20,0,1,0
23,104,104,1,1,0,1,0
4,119,119,22,5,17,2,1
31,135,135,6,6,0,1,0
14,185,185,39,39,0,1,0
12,199,199,14,14,0,1,0
9,199,199,13,13,0,1,0
7,222,222,29,29,0,1,0
3,227,227,35,35,0,1,0
33,233,233,58,58,0,1,0
16,246,246,27,9,18,3,2
35,249,249,21,15,6,3,2
5,250,250,46,20,26,2,1
8,270,270,53,53,0,1,0
30,272,272,4,4,0,1,0
22,279,279,45,11,34,3,2
28,305,305,9,1,8,2,1
25,313,313,42,42,0,1,0
6,316,316,34,34,0,1,0
17,319,319,18,18,0,1,0
34,333,333,3,3,0,1,0
26,343,343,34,34,0,1,0
20,361,361,51,24,27,4,3
19,373,373,7,3,4,2,1
0,375,375,1,1,0,1,0
15,386,386,47,6,41,2,1
10,389,389,59,37,22,3,2
32,391,391,4,4,0,1,0
29,395,395,41,29,12,2,1
24,396,396,31,31,0,1,0
18,412,412,14,8,6,2,1
27,455,455,217,217,0,1,0
13,461,461,5,5,0,1,0
2,466,466,4,4,0,1,0
1,479,479,36,36,0,1,0
11,486,486,57,17,40,3,2

43,107,107,3,3,0,1,0
20,120,120,18,18,0,1,0
21,122,122,19,1,18,4,3
19,125,125,4,4,0,1,0
38,131,131,45,28,17,2,1
28,151,151,2,2,0,1,0
12,154,154,43,43,0,1,0
39,170,170,5,5,0,1,0
25,182,182,20,2,18,4,3
30,189,189,10,1,9,2,1
2,211,211,17,5,12,4,3
26,220,220,42,42,0,1,0
24,220,220,20,4,16,3,2
15,223,223,3,3,0,1,0
27,228,228,10,4,6,2,1
36,237,237,13,13,0,1,0
42,245,245,15,15,0,1,0
33,264,264,39,23,16,3,2
4,277,277,4,4,0,1,0
0,286,286,10,6,4,2,1
18,290,290,38,38,0,1,0
7,292,292,1,1,0,1,0
8,305,305,19,19,0,1,0
13,310,310,11,3,8,2,1
10,316,316,10,10,0,1,0
11,320,320,53,53,0,1,0
23,344,344,58,40,18,4,3
37,359,359,43,17,26,3,2
35,360,360,162,79,83,4,3
29,364,364,34,16,18,4,3
40,378,378,19,4,15,2,1
31,388,388,31,31,0,1,0
22,389,389,33,33,0,1,0
17,399,399,27,27,0,1,0
9,399,399,42,42,0,1,0
6,402,402,33,1,32,3,2
16,406,406,2,2,0,1,0
32,417,417,7,3,4,2,1
34,431,431,18,9,9,2,1
5,440,440,1,1,0,1,0
1,445,445,25,6,19,2,1
14,459,459,16,16,0,1,0
3,466,466,6,6,0,1,0
41,483,483,11,11,0,1,0

39,103,103,1,1,0,1,0
3,125,125,1,1,0,1,0
27,128,128,6,6,0,1,0
19,141,141,13,4,9,4,3
32,153,153,19,19,0,1,0
17,158,158,10,10,0,1,0
21,159,159,11,11,0,1,0
18,160,160,57,4,53,4,3
11,189,189,31,31,0,1,0
9,189,189,16,16,0,1,0
1,195,195,7,7,0,1,0
0,209,209,20,20,0,1,0
40,222,222,6,6,0,1,0
36,222,222,3,3,0,1,0
4,224,224,39,6,33,2,1
20,239,239,20,20,0,1,0
41,244,244,85,85,0,1,0
31,247,247,27,27,0,1,0
16,249,249,19,19,0,1,0
6,252,252,34,1,33,2,1
28,253,253,72,26,46,4,3
5,261,261,6,6,0,1,0
38,266,266,18,18,0,1,0
10,271,271,5,1,4,2,1
12,277,277,65,65,0,1,0
22,306,306,5,5,0,1,0
33,312,312,78,40,38,3,2
2,324,324,1,1,0,1,0
13,326,326,1,1,0,1,0
8,364,364,18,18,0,1,0
29,369,369,33,33,0,1,0
23,371,371,5,1,4,2,1
37,393,393,3,3,0,1,0
7,400,400,16,16,0,1,0
34,416,416,19,5,14,2,1
14,436,436,30,30,0,1,0
25,439,439,67,67,0,1,0
24,445,445,53,34,19,2,1
26,458,458,60,32,28,2,1
15,459,459,3,3,0,1,0
30,461,461,41,41,0,1,0
35,485,485,4,4,0,1,0

39,113,113,4,4,0,1,0
13,115,115,4,4,0,1,0
12,118,118,12,12,0,1,0
37,119,119,4,4,0,1,0
11,134,134,9,9,0,1,0
33,141,141,2,2,0,1,0
36,156,156,14,14,0,1,0
35,158,158,8,8,0,1,0
6,163,163,10,10,0,1,0
17,163,163,9,9,0,1,0
1,166,166,2,2,0,1,0
4,187,187,13,7,6,3,2
8,190,190,16,4,12,3,2
16,191,191,4,1,3,2,1
41,193,193,4,4,0,1,0
32,262,262,20,20,0,1,0
25,271,271,18,1,17,4,3
20,283,283,10,4,6,2,1
5,292,292,104,32,72,4,3
40,298,298,105,2,103,4,3
14,299,299,74,8,66,4,3
42,300,300,48,48,0,1,0
22,300,300,1,1,0,1,0
19,314,314,26,1,25,3,2
3,321,321,19,7,12,2,1
26,354,354,8,5,3,2,1
29,354,354,14,4,10,2,1
18,366,366,35,2,33,4,3
2,366,366,18,18,0,1,0
15,371,371,47,17,30,2,1
28,377,377,1,1,0,1,0
34,380,380,11,3,8,2,1
0,387,387,11,11,0,1,0
27,411,411,12,3,9,3,2
30,423,423,64,64,0,1,0
24,432,432,8,8,0,1,0
23,434,434,43,43,0,1,0
43,472,472,144,97,47,2,1
10,487,487,30,30,0,1,0
7,491,491,9,9,0,1,0
31,492,492,164,94,70,4,3
38,493,493,67,36,31,2,1
21,493,493,6,1,5,2,1
9,498,498,50,50,0,1,0

0,101,101,11,11,0,1,0
14,103,103,9,9,0,1,0
18,143,143,10,10,0,1,0
21,155,155,11,1,10,3,2
17,159,159,5,5,0,1,0
32,160,160,37,7,30,3,2
13,162,162,3,3,0,1,0
31,171,171,2,2,0,1,0
26,180,180,39,39,0,1,0
10,188,188,13,13,0,1,0
34,199,199,39,39,0,1,0
30,204,204,1,1,0,1,0
5,247,247,45,33,12,3,2
28,251,251,26,26,0,1,0
24,260,260,3,3,0,1,0
19,274,274,18,13,5,2,1
3,276,276,76,76,0,1,0
33,279,279,35,27,8,2,1
23,298,298,30,30,0,1,0
29,309,309,50,35,15,4,3
25,315,315,2,2,0,1,0
22,363,363,48,23,25,2,1
15,381,381,16,16,0,1,0
7,388,388,7,7,0,1,0
6,389,389,1,1,0,1,0
20,401,401,23,17,6,3,2
2,420,420,65,65,0,1,0
9,429,429,111,41,70,3,2
1,429,429,136,136,0,1,0
11,437,437,1,1,0,1,0
4,454,454,23,23,0,1,0
8,457,457,141,93,48,4,3
12,461,461,3,3,0,1,0
16,464,464,64,55,9,4,3
27,468,468,95,95,0,1,0

15,110,110,5,5,0,1,0
25,119,119,5,5,0,1,0
31,127,127,17,17,0,1,0
21,131,131,1,1,0,1,0
18,136,136,3,3,0,1,0
39,136,136,31,31,0,1,0
20,144,144,9,9,0,1,0
10,156,156,21,6,15,2,1
34,179,179,6,6,0,1,0
12,190,190,38,38,0,1,0
11,192,192,6,6,0,1,0
22,210,210,16,2,14,2,1
14,225,225,14,14,0,1,0
1,246,246,5,5,0,1,0
29,257,257,62,34,28,2,1
33,266,266,61,43,18,3,2
5,267,267,27,27,0,1,0
8,279,279,14,14,0,1,0
0,308,308,14,5,9,4,3
13,325,325,98,86,12,3,2
35,328,328,10,10,0,1,0
9,328,328,15,15,0,1,0
28,334,334,23,23,0,1,0
38,343,343,121,121,0,1,0
42,343,343,25,3,22,3,2
30,362,362,53,18,35,4,3
40,364,364,35,23,12,4,3
19,385,385,9,9,0,1,0
36,390,390,8,8,0,1,0
2,391,391,14,1,13,2,1
6,404,404,117,47,70,4,3
27,410,410,11,8,3,2,1
16,411,411,3,3,0,1,0
37,413,413,40,40,0,1,0
4,416,416,15,15,0,1,0
24,419,419,5,2,3,2,1
23,434,434,70,28,42,3,2
26,435,435,22,22,0,1,0
41,463,463,5,5,0,1,0
7,474,474,32,32,0,1,0
32,486,486,22,22,0,1,0
17,496,496,18,18,0,1,0
3,496,496,19,19,0,1,0

5,101,101,7,2,5,2,1
29,123,123,25,25,0,1,0
21,134,134,4,4,0,1,0
1,141,141,17,17,0,1,0
2,156,156,7,1,6,3,2
17,168,168,1,1,0,1,0
32,191,191,21,7,14,3,2
18,194,194,3,3,0,1,0
0,199,199,19,13,6,2,1
23,206,206,25,2,23,4,3
14,209,209,99,84,15,2,1
27,220,220,20,20,0,1,0
22,228,228,71,71,0,1,0
35,231,231,18,18,0,1,0
24,235,235,6,6,0,1,0
11,243,243,21,21,0,1,0
10,258,258,12,4,8,2,1
31,268,268,53,10,43,2,1
25,276,276,8,8,0,1,0
30,279,279,31,13,18,2,1
26,299,299,45,5,40,2,1
9,308,308,12,12,0,1,0
3,310,310,29,1,28,2,1
8,318,318,43,28,15,4,3
16,322,322,11,5,6,2,1
6,322,322,101,101,0,1,0
4,330,330,38,38,0,1,0
20,351,351,35,35,0,1,0
12,354,354,31,18,13,2,1
19,379,379,41,16,25,2,1
36,389,389,11,11,0,1,0
15,404,404,11,1,10,3,2
7,429,429,1,1,0,1,0
34,444,444,37,37,0,1,0
33,450,450,37,37,0,1,0
37,454,454,7,4,3,2,1
13,457,457,44,44,0,1,0
28,463,463,31,3,28,2,1

24,113,113,5,2,3,2,1
18,126,126,9,9,0,1,0
31,136,136,41,2,39,2,1
28,139,139,6,6,0,1,0
43,143,143,14,14,0,1,0
32,158,158,11,2,9,2,1
15,161,161,31,1,30,2,1
12,175,175,3,3,0,1,0
35,180,180,14,14,0,1,0
34,182,182,3,3,0,1,0
14,189,189,76,76,0,1,0
13,213,213,8,4,4,2,1
26,221,221,9,9,0,1,0
11,226,226,1,1,0,1,0
10,237,237,10,4,6,2,1
29,238,238,5,5,0,1,0
17,240,240,16,16,0,1,0
30,244,244,9,3,6,2,1
20,251,251,1,1,0,1,0
33,256,256,29,6,23,2,1
9,257,257,58,28,30,4,3
36,263,263,10,10,0,1,0
3,266,266,17,9,8,3,2
21,270,270,14,8,6,3,2
5,286,286,12,12,0,1,0
41,290,290,106,96,10,3,2
37,306,306,20,15,5,2,1
38,343,343,52,15,37,4,3
6,347,347,36,36,0,1,0
16,362,362,8,3,5,2,1
0,397,397,7,2,5,2,1
7,403,403,10,10,0,1,0
4,405,405,50,8,42,3,2
27,405,405,21,3,18,2,1
25,410,410,1,1,0,1,0
2,421,421,1,1,0,1,0
8,433,433,8,8,0,1,0
19,436,436,5,5,0,1,0
39,437,437,19,6,13,2,1
22,443,443,16,3,13,2,1
40,445,445,130,66,64,4,3
23,448,448,73,44,29,2,1
42,466,466,51,28,23,2,1
1,467,467,56,14,42,3,2

37,126,126,14,7,7,2,1
15,132,132,1,1,0,1,0
21,138,138,4,1,3,2,1
14,148,148,10,7,3,2,1
27,151,151,3,3,0,1,0
20,157,157,3,3,0,1,0
8,166,166,15,15,0,1,0
24,175,175,39,39,0,1,0
42,176,176,49,49,0,1,0
40,176,176,1,1,0,1,0
1,216,216,14,14,0,1,0
25,228,228,3,3,0,1,0
17,228,228,3,3,0,1,0
6,230,230,8,2,6,2,1
31,255,255,6,6,0,1,0
38,259,259,2,2,0,1,0
9,260,260,23,18,5,2,1
19,270,270,1,1,0,1,0
5,278,278,26,26,0,1,0
36,281,281,74,43,31,2,1
4,287,287,19,5,14,3,2
10,304,304,2,2,0,1,0
12,309,309,84,81,3,2,1
3,313,313,47,6,41,4,3
13,314,314,1,1,0,1,0
32,321,321,2,2,0,1,0
2,335,335,1,1,0,1,0
30,339,339,134,126,8,3,2
29,342,342,45,45,0,1,0
11,350,350,52,52,0,1,0
35,367,367,7,2,5,2,1
28,369,369,28,28,0,1,0
23,375,375,5,5,0,1,0
41,380,380,12,7,5,2,1
22,438,438,73,73,0,1,0
33,443,443,53,35,18,4,3
26,473,473,57,29,28,2,1
34,475,475,22,8,14,2,1
18,487,487,136,98,38,3,2
16,494,494,3,3,0,1,0
7,497,497,19,19,0,1,0
0,498,498,117,78,39,4,3
39,500,500,26,26,0,1,0

2,121,121,42,42,0,1,0
5,122,122,3,3,0,1,0
26,144,144,5,5,0,1,0
3,153,153,8,8,0,1,0
32,172,172,4,1,3,2,1
10,188,188,6,6,0,1,0
11,203,203,41,41,0,1,0
20,229,229,32,32,0,1,0
23,230,230,23,3,20,4,3
14,235,235,51,26,25,4,3
15,240,240,74,53,21,4,3
19,255,255,77,77,0,1,0
12,272,272,162,90,72,3,2
7,275,275,27,14,13,2,1
27,278,278,14,14,0,1,0
8,302,302,7,7,0,1,0
21,309,309,3,3,0,1,0
22,315,315,16,4,12,3,2
9,319,319,5,5,0,1,0
29,324,324,50,50,0,1,0
16,349,349,59,59,0,1,0
6,375,375,44,44,0,1,0
4,394,394,19,7,12,3,2
28,400,400,6,2,4,2,1
25,402,402,22,22,0,1,0
31,402,402,53,53,0,1,0
24,436,436,7,7,0,1,0
30,440,440,8,4,4,2,1
17,441,441,27,27,0,1,0
33,445,445,115,93,22,3,2
18,448,448,13,13,0,1,0
1,474,474,16,16,0,1,0
0,481,481,7,7,0,1,0
13,496,496,41,41,0,1,0

8,107,107,25,7,18,4,3
6,110,110,29,29,0,1,0
18,117,117,3,3,0,1,0
7,120,120,36,36,0,1,0
12,148,148,1,1,0,1,0
34,159,159,4,4,0,1,0
11,171,171,31,5,26,3,2
16,172,172,3,3,0,1,0
10,173,173,6,6,0,1,0
28,206,206,12,3,9,2,1
32,218,218,12,2,10,3,2
4,221,221,7,3,4,2,1
33,225,225,11,1,10,2,1
2,231,231,35,35,0,1,0
5,265,265,48,37,11,2,1
25,268,268,70,46,24,3,2
1,302,302,31,31,0,1,0
30,311,311,136,78,58,3,2
3,327,327,1,1,0,1,0
14,327,327,10,5,5,2,1
22,373,373,30,30,0,1,0
21,380,380,18,4,14,2,1
35,381,381,48,17,31,4,3
9,381,381,40,40,0,1,0
13,405,405,70,70,0,1,0
17,406,406,17,17,0,1,0
0,418,418,7,3,4,2,1
20,422,422,101,53,48,3,2
26,452,452,2,2,0,1,0
19,453,453,22,22,0,1,0
27,465,465,62,62,0,1,0
29,473,473,25,25,0,1,0
24,486,486,107,69,38,3,2
15,491,491,35,12,23,4,3
23,495,495,14,14,0,1,0
31,497,497,1,1,0,1,0

36,101,101,18,2,16,2,1
11,101,101,6,6,0,1,0
32,101,101,19,1,18,2,1
2,110,110,9,9,0,1,0
7,120,120,5,5,0,1,0
19,127,127,2,2,0,1,0
5,152,152,23,23,0,1,0
26,154,154,14,14,0,1,0
24,172,172,5,2,3,2,1
29,175,175,28,24,4,2,1
9,182,182,28,16,12,3,2
14,193,193,23,23,0,1,0
13,198,198,7,3,4,2,1
23,209,209,2,2,0,1,0
6,218,218,21,21,0,1,0
12,222,222,44,44,0,1,0
22,223,223,66,48,18,4,3
20,223,223,2,2,0,1,0
15,238,238,1,1,0,1,0
0,241,241,7,7,0,1,0
33,255,255,31,31,0,1,0
3,264,264,32,2,30,4,3
25,265,265,83,55,28,4,3
8,266,266,82,20,62,3,2
18,269,269,14,14,0,1,0
31,277,277,7,1,6,2,1
16,305,305,71,66,5,2,1
27,354,354,25,25,0,1,0
21,373,373,11,2,9,2,1
1,373,373,22,22,0,1,0
10,379,379,14,14,0,1,0
34,379,379,34,34,0,1,0
28,392,392,39,39,0,1,0
30,418,418,22,22,0,1,0
17,439,439,21,5,16,2,1
4,477,477,60,38,22,2,1
35,494,494,58,14,44,2,1

27,124,124,9,3,6,2,1
11,131,131,16,16,0,1,0
38,151,151,32,32,0,1,0
13,159,159,32,32,0,1,0
29,161,161,9,9,0,1,0
34,164,164,14,14,0,1,0
40,184,184,38,22,16,2,1
35,188,188,28,16,12,4,3
0,194,194,32,22,10,3,2
16,204,204,9,9,0,1,0
41,219,219,29,26,3,2,1
18,233,233,2,2,0,1,0
31,237,237,17,13,4,2,1
5,237,237,4,4,0,1,0
23,261,261,8,8,0,1,0
39,264,264,21,21,0,1,0
37,277,277,11,11,0,1,0
7,280,280,5,5,0,1,0
1,315,315,46,46,0,1,0
36,329,329,56,34,22,3,2
17,336,336,6,6,0,1,0
8,338,338,22,22,0,1,0
42,343,343,28,3,25,2,1
28,346,346,47,5,42,4,3
21,359,359,7,7,0,1,0
19,371,371,39,3,36,4,3
22,374,374,13,1,12,2,1
24,380,380,44,44,0,1,0
26,380,380,31,31,0,1,0
12,385,385,37,37,0,1,0
2,386,386,16,16,0,1,0
10,388,388,30,8,22,2,1
6,394,394,36,6,30,4,3
32,407,407,6,6,0,1,0
25,426,426,34,34,0,1,0
3,440,440,35,4,31,2,1
14,457,457,83,83,0,1,0
20,461,461,55,55,0,1,0
9,464,464,39,39,0,1,0
30,469,469,65,65,0,1,0
15,489,489,32,32,0,1,0
4,490,490,34,34,0,1,0
33,494,494,11,5,6,3,2

31,109,109,8,8,0,1,0
2,133,133,5,5,0,1,0
24,156,156,6,6,0,1,0
13,157,157,3,3,0,1,0
8,166,166,51,51,0,1,0
11,166,166,12,5,7,2,1
17,167,167,4,4,0,1,0
20,170,170,6,2,4,2,1
23,172,172,2,2,0,1,0
14,189,189,47,11,36,3,2
3,198,198,1,1,0,1,0
7,201,201,61,17,44,4,3
33,219,219,21,21,0,1,0
19,247,247,1,1,0,1,0
16,252,252,13,13,0,1,0
25,256,256,27,5,22,2,1
6,258,258,61,9,52,3,2
15,286,286,1,1,0,1,0
1,308,308,69,69,0,1,0
0,318,318,36,18,18,3,2
4,322,322,26,3,23,2,1
27,327,327,3,3,0,1,0
28,339,339,77,77,0,1,0
30,342,342,46,25,21,4,3
22,360,360,178,133,45,2,1
10,363,363,37,37,0,1,0
5,365,365,2,2,0,1,0
26,366,366,33,33,0,1,0
18,376,376,111,23,88,3,2
21,399,399,39,39,0,1,0
34,406,406,20,17,3,2,1
29,432,432,27,27,0,1,0
32,438,438,4,1,3,2,1
12,466,466,18,18,0,1,0
9,480,480,14,14,0,1,0
35,483,483,10,10,0,1,0
36,498,498,41,19,22,2,1

24,100,100,29,4,25,2,1
9,117,117,23,13,10,2,1
12,119,119,13,13,0,1,0
35,125,125,1,1,0,1,0
30,134,134,2,2,0,1,0
1,146,146,8,2,6,2,1
5,146,146,1,1,0,1,0
6,150,150,12,12,0,1,0
31,174,174,27,19,8,3,2
26,197,197,10,10,0,1,0
27,199,199,22,22,0,1,0
36,216,216,25,9,16,3,2
18,218,218,39,21,18,3,2
4,222,222,78,15,63,4,3
0,287,287,9,3,6,2,1
2,293,293,28,28,0,1,0
23,311,311,23,23,0,1,0
16,338,338,35,26,9,2,1
10,390,390,87,87,0,1,0
29,398,398,2,2,0,1,0
33,404,404,47,47,0,1,0
14,420,420,33,33,0,1,0
3,424,424,50,50,0,1,0
13,437,437,18,18,0,1,0
11,439,439,17,17,0,1,0
7,444,444,52,52,0,1,0
15,451,451,109,76,33,2,1
21,452,452,15,15,0,1,0
28,453,453,119,37,82,3,2
22,466,466,35,18,17,2,1
34,474,474,27,6,21,3,2
8,476,476,1,1,0,1,0
25,482,482,28,7,21,4,3
32,482,482,19,19,0,1,0
17,493,493,6,3,3,2,1
19,495,495,76,33,43,4,3
20,499,499,66,22,44,2,1

13,105,105,1,1,0,1,0
12,109,109,1,1,0,1,0
28,120,120,10,4,6,2,1
32,134,134,14,14,0,1,0
3,141,141,16,16,0,1,0
42,149,149,11,1,10,3,2
24,168,168,19,13,6,3,2
35,169,169,4,1,3,2,1
11,208,208,16,16,0,1,0
16,210,210,11,11,0,1,0
29,212,212,24,24,0,1,0
41,225,225,20,9,11,2,1
33,226,226,42,1,41,2,1
0,270,270,31,31,0,1,0
4,282,282,42,19,23,2,1
37,294,294,71,5,66,3,2
23,297,297,34,34,0,1,0
9,297,297,19,19,0,1,0
8,307,307,27,27,0,1,0
7,308,308,14,14,0,1,0
39,310,310,55,55,0,1,0
19,318,318,3,3,0,1,0
40,321,321,15,15,0,1,0
18,337,337,45,21,24,4,3
14,339,339,2,2,0,1,0
26,341,341,50,12,38,2,1
5,342,342,23,23,0,1,0
10,347,347,25,16,9,4,3
20,365,365,51,51,0,1,0
31,392,392,34,34,0,1,0
2,393,393,4,4,0,1,0
30,408,408,2,2,0,1,0
27,414,414,14,14,0,1,0
1,428,428,124,94,30,4,3
6,443,443,68,68,0,1,0
38,448,448,81,18,63,4,3
17,467,467,19,10,9,4,3
21,480,480,12,12,0,1,0
15,481,481,56,23,33,2,1
25,487,487,37,26,11,2,1
34,489,489,47,47,0,1,0
36,495,495,28,8,20,2,1
22,498,498,1,1,0,1,0

5,118,118,5,5,0,1,0
9,131,131,31,27,4,2,1
23,133,133,25,6,19,2,1
13,137,137,8,2,6,3,2
32,143,143,9,1,8,3,2
21,153,153,37,15,22,3,2
6,198,198,16,4,12,4,3
22,205,205,46,46,0,1,0
7,208,208,18,18,0,1,0
27,223,223,24,10,14,2,1
33,223,223,27,27,0,1,0
31,224,224,74,24,50,3,2
20,240,240,6,6,0,1,0
19,259,259,13,4,9,2,1
3,260,260,72,12,60,3,2
11,273,273,31,31,0,1,0
2,287,287,91,91,0,1,0
12,294,294,5,5,0,1,0
8,300,300,9,9,0,1,0
29,327,327,18,1,17,2,1
34,336,336,7,7,0,1,0
26,360,360,12,12,0,1,0
18,373,373,40,40,0,1,0
1,387,387,26,2,24,2,1
0,389,389,118,84,34,2,1
14,404,404,19,19,0,1,0
10,404,404,33,9,24,4,3
28,414,414,23,8,15,4,3
17,424,424,36,36,0,1,0
4,426,426,35,11,24,4,3
15,428,428,25,25,0,1,0
35,445,445,47,47,0,1,0
16,475,475,1,1,0,1,0
30,481,481,3,3,0,1,0
25,484,484,31,14,17,2,1
24,495,495,25,19,6,2,1

27,100,100,3,3,0,1,0
11,100,100,6,6,0,1,0
14,104,104,2,2,0,1,0
18,119,119,7,7,0,1,0
15,146,146,48,18,30,3,2
19,159,159,7,7,0,1,0
26,180,180,19,8,11,2,1
13,181,181,68,44,24,2,1
7,201,201,15,15,0,1,0
6,204,204,1,1,0,1,0
24,211,211,4,4,0,1,0
3,241,241,17,1,16,2,1
8,261,261,38,30,8,3,2
22,269,269,12,12,0,1,0
5,288,288,25,4,21,4,3
25,292,292,58,12,46,2,1
31,319,319,32,32,0,1,0
0,328,328,19,5,14,2,1
28,342,342,30,9,21,2,1
2,355,355,25,25,0,1,0
29,384,384,44,12,32,3,2
33,396,396,5,5,0,1,0
1,398,398,144,112,32,3,2
12,418,418,34,16,18,3,2
9,422,422,35,35,0,1,0
17,436,436,30,30,0,1,0
4,440,440,146,123,23,2,1
21,446,446,2,2,0,1,0
23,446,446,107,107,0,1,0
16,469,469,49,49,0,1,0
32,471,471,74,74,0,1,0
20,472,472,97,97,0,1,0
30,480,480,7,4,3,2,1
10,492,492,39,19,20,2,1

12,101,101,10,1,9,2,1
29,112,112,26,6,20,3,2
20,113,113,13,3,10,3,2
22,114,114,5,5,0,1,0
14,143,143,5,5,0,1,0
34,143,143,2,2,0,1,0
37,162,162,7,2,5,2,1
24,174,174,26,16,10,3,2
10,176,176,34,34,0,1,0
31,191,191,10,10,0,1,0
23,192,192,3,3,0,1,0
6,231,231,3,3,0,1,0
0,241,241,1,1,0,1,0
9,246,246,34,34,0,1,0
32,267,267,68,4,64,4,3
35,280,280,3,3,0,1,0
18,281,281,22,22,0,1,0
1,287,287,7,3,4,2,1
3,289,289,5,5,0,1,0
30,306,306,129,57,72,4,3
5,321,321,131,121,10,3,2
2,361,361,19,12,7,2,1
16,370,370,27,27,0,1,0
26,383,383,17,17,0,1,0
4,385,385,88,88,0,1,0
7,395,395,18,18,0,1,0
15,400,400,8,8,0,1,0
17,408,408,27,8,19,2,1
36,412,412,24,24,0,1,0
11,417,417,22,9,13,2,1
25,421,421,32,11,21,4,3
27,425,425,45,18,27,4,3
28,457,457,10,2,8,2,1
13,467,467,4,4,0,1,0
33,481,481,37,37,0,1,0
21,483,483,77,77,0,1,0
19,484,484,29,29,0,1,0
8,493,493,170,170,0,1,0

31,102,102,9,3,6,2,1
14,109,109,16,7,9,2,1
8,117,117,11,1,10,2,1
5,136,136,1,1,0,1,0
16,149,149,3,3,0,1,0
6,157,157,38,38,0,1,0
19,201,201,8,5,3,2,1
1,203,203,10,10,0,1,0
29,209,209,11,1,10,3,2
4,223,223,28,28,0,1,0
30,225,225,58,58,0,1,0
32,240,240,7,7,0,1,0
27,246,246,11,11,0,1,0
9,253,253,19,19,0,1,0
28,271,271,1,1,0,1,0
18,279,279,7,7,0,1,0
11,297,297,165,165,0,1,0
17,298,298,85,41,44,2,1
3,319,319,69,57,12,4,3
26,354,354,16,16,0,1,0
24,359,359,11,8,3,2,1
23,379,379,109,109,0,1,0
34,393,393,109,16,93,4,3
7,393,393,53,3,50,3,2
21,397,397,26,5,21,4,3
22,398,398,38,15,23,2,1
15,405,405,5,1,4,2,1
13,409,409,29,3,26,3,2
33,409,409,15,15,0,1,0
2,414,414,23,23,0,1,0
0,440,440,26,19,7,2,1
12,457,457,2,2,0,1,0
25,462,462,110,80,30,2,1
20,488,488,10,3,7,2,1
10,495,495,26,26,0,1,0

23,102,102,1,1,0,1,0
26,104,104,14,11,3,2,1
29,113,113,29,29,0,1,0
1,116,116,1,1,0,1,0
32,117,117,6,6,0,1,0
11,120,120,1,1,0,1,0
35,122,122,41,41,0,1,0
34,128,128,1,1,0,1,0
28,130,130,15,1,14,2,1
4,161,161,7,4,3,2,1
25,174,174,29,29,0,1,0
10,175,175,26,12,14,2,1
5,201,201,10,10,0,1,0
3,221,221,23,23,0,1,0
31,226,226,17,3,14,2,1
24,226,226,2,2,0,1,0
16,240,240,13,13,0,1,0
21,252,252,1,1,0,1,0
6,264,264,3,3,0,1,0
15,299,299,9,9,0,1,0
9,301,301,68,57,11,2,1
19,326,326,25,25,0,1,0
27,332,332,112,28,84,4,3
2,347,347,69,32,37,2,1
30,362,362,6,6,0,1,0
37,372,372,50,50,0,1,0
18,380,380,6,6,0,1,0
14,393,393,72,72,0,1,0
12,397,397,22,22,0,1,0
33,404,404,57,39,18,2,1
7,406,406,68,4,64,3,2
36,415,415,17,17,0,1,0
8,427,427,17,9,8,2,1
17,451,451,110,50,60,3,2
20,478,478,2,2,0,1,0
13,484,484,69,69,0,1,0
22,487,487,21,1,20,3,2
0,492,492,83,19,64,3,2

3,130,130,6,6,0,1,0
16,135,135,5,5,0,1,0
7,136,136,30,15,15,2,1
22,145,145,7,7,0,1,0
27,146,146,1,1,0,1,0
15,167,167,3,3,0,1,0
39,170,170,36,13,23,2,1
29,176,176,15,10,5,2,1
37,176,176,7,7,0,1,0
0,179,179,13,13,0,1,0
44,187,187,4,1,3,2,1
11,188,188,1,1,0,1,0
13,216,216,7,7,0,1,0
14,227,227,35,35,0,1,0
28,231,231,1,1,0,1,0
30,237,237,14,2,12,4,3
5,246,246,9,9,0,1,0
9,246,246,5,5,0,1,0
40,248,248,43,10,33,4,3
2,254,254,14,14,0,1,0
4,256,256,20,8,12,3,2
23,259,259,13,13,0,1,0
46,267,267,21,3,18,3,2
45,270,270,15,9,6,2,1
21,276,276,10,10,0,1,0
25,285,285,22,22,0,1,0
31,296,296,8,8,0,1,0
12,299,299,84,15,69,4,3
38,303,303,5,5,0,1,0
35,311,311,15,15,0,1,0
36,312,312,57,25,32,3,2
18,361,361,2,2,0,1,0
42,375,375,130,85,45,2,1
41,397,397,2,2,0,1,0
6,397,397,28,2,26,2,1
10,413,413,31,21,10,2,1
34,423,423,35,11,24,4,3
17,427,427,20,20,0,1,0
1,429,429,11,4,7,2,1
20,440,440,105,89,16,3,2
8,454,454,42,34,8,3,2
33,462,462,73,73,0,1,0
43,475,475,21,9,12,4,3
19,477,477,8,8,0,1,0
24,488,488,13,13,0,1,0
32,492,492,144,144,0,1,0
26,496,496,16,1,15,4,3

3,108,108,1,1,0,1,0
1,111,111,41,41,0,1,0
14,111,111,11,11,0,1,0
28,129,129,9,9,0,1,0
5,157,157,89,61,28,2,1
24,165,165,9,9,0,1,0
0,181,181,38,38,0,1,0
20,200,200,6,6,0,1,0
26,206,206,14,3,11,2,1
27,253,253,66,16,50,2,1
25,268,268,6,6,0,1,0
16,269,269,127,41,86,4,3
21,270,270,23,23,0,1,0
11,271,271,51,41,10,2,1
4,281,281,14,14,0,1,0
12,293,293,3,3,0,1,0
6,328,328,111,76,35,2,1
23,334,334,35,35,0,1,0
8,339,339,27,27,0,1,0
17,357,357,18,18,0,1,0
10,374,374,19,7,12,2,1
19,390,390,45,33,12,2,1
7,412,412,49,1,48,4,3
15,421,421,46,28,18,4,3
13,428,428,6,2,4,2,1
22,436,436,42,42,0,1,0
18,460,460,17,17,0,1,0
9,476,476,30,22,8,3,2
2,496,496,47,35,12,4,3

24,103,103,27,27,0,1,0
37,105,105,16,5,11,3,2
5,107,107,5,5,0,1,0
2,133,133,2,2,0,1,0
12,133,133,2,2,0,1,0
18,134,134,1,1,0,1,0
11,143,143,1,1,0,1,0
17,156,156,17,3,14,3,2
8,171,171,22,3,19,2,1
31,184,184,17,7,10,3,2
21,196,196,22,2,20,3,2
25,202,202,11,11,0,1,0
15,206,206,7,1,6,3,2
29,206,206,10,6,4,2,1
35,212,212,34,34,0,1,0
33,221,221,19,13,6,2,1
10,228,228,1,1,0,1,0
14,259,259,14,14,0,1,0
6,261,261,13,2,11,2,1
13,275,275,5,1,4,2,1
32,279,279,9,9,0,1,0
28,281,281,1,1,0,1,0
27,286,286,69,69,0,1,0
39,295,295,57,30,27,2,1
4,301,301,3,3,0,1,0
38,317,317,6,6,0,1,0
20,329,329,38,13,25,3,2
40,339,339,11,11,0,1,0
16,367,367,122,122,0,1,0
26,377,377,22,3,19,3,2
34,379,379,48,48,0,1,0
30,394,394,61,10,51,4,3
0,403,403,71,7,64,3,2
1,415,415,5,5,0,1,0
36,421,421,22,22,0,1,0
7,427,427,65,65,0,1,0
22,435,435,17,17,0,1,0
9,452,452,152,145,7,2,1
23,468,468,62,62,0,1,0
3,471,471,22,18,4,2,1
19,478,478,56,14,42,3,2

28,100,100,4,4,0,1,0
42,101,101,11,1,10,2,1
21,105,105,14,10,4,2,1
44,112,112,10,10,0,1,0
35,122,122,16,1,15,4,3
33,133,133,47,2,45,4,3
43,137,137,9,1,8,3,2
4,141,141,4,1,3,2,1
8,163,163,15,3,12,2,1
9,172,172,15,15,0,1,0
10,175,175,2,2,0,1,0
17,192,192,28,18,10,3,2
34,209,209,13,13,0,1,0
2,224,224,5,1,4,2,1
0,224,224,1,1,0,1,0
30,227,227,29,29,0,1,0
46,237,237,44,44,0,1,0
24,240,240,1,1,0,1,0
38,243,243,19,19,0,1,0
32,246,246,15,15,0,1,0
6,250,250,15,15,0,1,0
20,265,265,9,3,6,3,2
14,277,277,14,14,0,1,0
39,286,286,33,21,12,4,3
13,301,301,10,10,0,1,0
23,309,309,58,58,0,1,0
29,318,318,13,13,0,1,0
37,327,327,67,67,0,1,0
41,328,328,46,2,44,2,1
11,358,358,43,43,0,1,0
27,383,383,12,3,9,4,3
18,383,383,5,5,0,1,0
19,387,387,75,23,52,3,2
22,402,402,22,2,20,2,1
40,415,415,9,9,0,1,0
26,418,418,32,32,0,1,0
45,420,420,19,7,12,4,3
12,420,420,45,45,0,1,0
3,422,422,35,35,0,1,0
7,426,426,23,23,0,1,0
1,452,452,7,7,0,1,0
5,453,453,17,8,9,4,3
47,458,458,13,13,0,1,0
31,460,460,25,5,20,2,1
16,469,469,65,65,0,1,0
25,480,480,18,5,13,2,1
36,498,498,13,1,12,2,1
15,499,499,3,3,0,1,0

0,101,101,8,1,7,2,1
25,143,143,7,2,5,2,1
23,145,145,12,12,0,1,0
11,156,156,1,1,0,1,0
8,169,169,59,59,0,1,0
1,177,177,5,5,0,1,0
19,185,185,13,5,8,2,1
38,200,200,22,10,12,4,3
39,204,204,10,10,0,1,0
9,208,208,22,8,14,2,1
34,217,217,22,22,0,1,0
30,249,249,6,6,0,1,0
2,254,254,15,15,0,1,0
33,254,254,60,60,0,1,0
28,254,254,140,35,105,4,3
12,262,262,13,4,9,4,3
36,267,267,26,26,0,1,0
27,267,267,25,25,0,1,0
3,304,304,29,5,24,3,2
37,342,342,38,24,14,2,1
26,350,350,56,6,50,3,2
18,352,352,14,14,0,1,0
20,359,359,10,10,0,1,0
17,365,365,120,35,85,4,3
32,398,398,1,1,0,1,0
7,405,405,11,2,9,4,3
15,406,406,2,2,0,1,0
14,410,410,28,28,0,1,0
35,410,410,1,1,0,1,0
6,412,412,54,5,49,2,1
24,421,421,21,12,9,4,3
21,427,427,2,2,0,1,0
5,442,442,35,35,0,1,0
29,450,450,56,56,0,1,0
4,459,459,26,26,0,1,0
16,466,466,37,20,17,2,1
10,471,471,9,9,0,1,0
13,498,498,97,22,75,4,3
31,499,499,15,10,5,2,1
22,499,499,24,6,18,4,3

1,102,102,4,4,0,1,0
19,121,121,46,7,39,2,1
38,133,133,5,5,0,1,0
9,137,137,18,18,0,1,0
37,143,143,22,8,14,2,1
39,152,152,2,2,0,1,0
16,170,170,5,5,0,1,0
26,174,174,4,4,0,1,0
22,176,176,5,5,0,1,0
27,179,179,10,10,0,1,0
6,186,186,2,2,0,1,0
4,187,187,8,8,0,1,0
13,213,213,18,12,6,2,1
5,216,216,22,22,0,1,0
28,217,217,14,14,0,1,0
35,219,219,177,157,20,3,2
23,232,232,3,3,0,1,0
32,246,246,7,2,5,2,1
20,252,252,15,15,0,1,0
40,257,257,28,16,12,3,2
10,264,264,57,38,19,2,1
12,267,267,67,62,5,2,1
3,285,285,1,1,0,1,0
8,289,289,5,5,0,1,0
24,300,300,13,7,6,2,1
30,307,307,89,89,0,1,0
21,321,321,8,8,0,1,0
34,369,369,6,3,3,2,1
25,375,375,8,8,0,1,0
11,379,379,23,23,0,1,0
36,387,387,34,4,30,2,1
2,397,397,7,7,0,1,0
7,405,405,4,4,0,1,0
17,444,444,80,80,0,1,0
33,444,444,29,29,0,1,0
29,459,459,18,18,0,1,0
0,463,463,62,62,0,1,0
31,465,465,18,18,0,1,0
18,471,471,11,11,0,1,0
14,492,492,9,9,0,1,0
15,494,494,32,32,0,1,0

1,110,110,4,1,3,2,1
4,114,114,3,3,0,1,0
35,116,116,9,9,0,1,0
8,119,119,49,49,0,1,0
33,130,130,11,1,10,3,2
24,134,134,22,22,0,1,0
25,138,138,5,5,0,1,0
34,149,149,34,34,0,1,0
18,152,152,10,1,9,2,1
0,174,174,24,8,16,3,2
26,174,174,25,6,19,4,3
19,183,183,15,15,0,1,0
3,186,186,7,2,5,2,1
2,188,188,32,19,13,3,2
13,201,201,19,16,3,2,1
10,205,205,5,5,0,1,0
6,206,206,2,2,0,1,0
15,213,213,19,19,0,1,0
11,217,217,17,17,0,1,0
7,218,218,56,56,0,1,0
31,231,231,32,2,30,3,2
14,232,232,17,9,8,2,1
21,234,234,61,61,0,1,0
17,247,247,59,30,29,2,1
22,281,281,1,1,0,1,0
30,313,313,20,20,0,1,0
29,331,331,3,3,0,1,0
12,333,333,25,14,11,2,1
36,343,343,29,29,0,1,0
5,352,352,22,17,5,2,1
32,358,358,93,3,90,3,2
23,401,401,61,30,31,2,1
16,413,413,32,32,0,1,0
20,425,425,7,7,0,1,0
27,430,430,19,19,0,1,0
9,435,435,1,1,0,1,0
28,473,473,13,13,0,1,0

21,110,110,9,9,0,1,0
39,121,121,5,5,0,1,0
8,129,129,31,31,0,1,0
19,136,136,7,4,3,2,1
25,143,143,22,22,0,1,0
23,168,168,6,1,5,2,1
27,169,169,37,3,34,3,2
26,178,178,4,4,0,1,0
20,179,179,13,13,0,1,0
22,187,187,8,2,6,2,1
31,193,193,5,5,0,1,0
33,195,195,32,32,0,1,0
13,198,198,16,16,0,1,0
5,208,208,1,1,0,1,0
11,217,217,26,26,0,1,0
15,221,221,25,10,15,4,3
37,228,228,61,61,0,1,0
1,243,243,4,4,0,1,0
18,272,272,45,21,24,3,2
12,273,273,28,28,0,1,0
24,290,290,34,10,24,4,3
36,298,298,2,2,0,1,0
38,298,298,52,8,44,3,2
3,309,309,7,7,0,1,0
2,311,311,16,3,13,2,1
29,312,312,65,48,17,2,1
0,312,312,25,1,24,2,1
6,314,314,25,7,18,2,1
14,360,360,26,26,0,1,0
35,397,397,13,13,0,1,0
9,404,404,6,6,0,1,0
40,407,407,47,47,0,1,0
34,415,415,13,5,8,3,2
28,421,421,11,5,6,3,2
7,437,437,15,2,13,2,1
4,439,439,7,7,0,1,0
17,457,457,164,53,111,4,3
30,464,464,87,39,48,2,1
10,464,464,34,8,26,3,2
32,489,489,32,7,25,2,1
16,500,500,26,14,12,3,2

26,101,101,2,2,0,1,0
13,120,120,24,24,0,1,0
23,151,151,20,16,4,2,1
20,163,163,36,36,0,1,0
2,166,166,1,1,0,1,0
28,174,174,18,2,16,3,2
3,177,177,29,29,0,1,0
32,188,188,41,5,36,2,1
27,199,199,1,1,0,1,0
15,217,217,2,2,0,1,0
22,234,234,28,10,18,3,2
4,235,235,4,4,0,1,0
21,247,247,14,14,0,1,0
0,254,254,1,1,0,1,0
12,256,256,80,80,0,1,0
30,263,263,3,3,0,1,0
33,267,267,5,2,3,2,1
17,272,272,6,6,0,1,0
14,282,282,104,26,78,4,3
7,291,291,28,28,0,1,0
25,291,291,18,4,14,2,1
16,308,308,5,5,0,1,0
1,310,310,18,18,0,1,0
31,325,325,30,4,26,2,1
9,326,326,10,1,9,2,1
6,329,329,35,28,7,2,1
34,336,336,15,5,10,2,1
5,362,362,25,25,0,1,0
11,391,391,16,8,8,2,1
10,420,420,155,122,33,2,1
24,424,424,225,194,31,4,3
19,455,455,26,26,0,1,0
29,463,463,46,46,0,1,0
18,464,464,50,50,0,1,0
8,489,489,25,25,0,1,0

25,102,102,18,7,11,3,2
30,149,149,3,3,0,1,0
1,153,153,1,1,0,1,0
14,157,157,24,24,0,1,0
24,159,159,11,3,8,2,1
32,159,159,6,6,0,1,0
12,162,162,8,8,0,1,0
28,167,167,9,3,6,3,2
20,170,170,12,12,0,1,0
0,174,174,1,1,0,1,0
13,184,184,27,27,0,1,0
4,184,184,18,18,0,1,0
22,191,191,4,4,0,1,0
31,210,210,54,54,0,1,0
19,214,214,16,1,15,4,3
29,220,220,26,26,0,1,0
23,233,233,37,37,0,1,0
5,296,296,35,35,0,1,0
3,308,308,20,10,10,3,2
6,309,309,64,64,0,1,0
15,311,311,37,25,12,4,3
17,367,367,26,1,25,2,1
18,408,408,54,21,33,4,3
7,410,410,15,3,12,2,1
26,416,416,36,18,18,4,3
10,416,416,38,17,21,4,3
9,429,429,113,93,20,2,1
11,430,430,129,109,20,3,2
8,449,449,37,37,0,1,0
2,453,453,127,127,0,1,0
21,457,457,14,14,0,1,0
16,475,475,77,23,54,4,3
33,478,478,97,97,0,1,0
27,483,483,35,35,0,1,0

16,107,107,48,23,25,2,1
3,128,128,12,12,0,1,0
9,150,150,4,1,3,2,1
24,159,159,14,14,0,1,0
6,220,220,4,4,0,1,0
15,245,245,25,25,0,1,0
18,269,269,8,8,0,1,0
21,274,274,35,35,0,1,0
31,280,280,73,33,40,2,1
30,292,292,7,7,0,1,0
36,308,308,30,30,0,1,0
0,309,309,30,3,27,2,1
1,326,326,19,9,10,3,2
5,335,335,28,16,12,4,3
32,341,341,11,11,0,1,0
4,342,342,159,113,46,2,1
8,344,344,58,58,0,1,0
2,354,354,5,5,0,1,0
28,368,368,32,23,9,4,3
20,372,372,53,14,39,4,3
11,374,374,4,4,0,1,0
35,383,383,35,35,0,1,0
17,383,383,15,10,5,2,1
13,400,400,25,25,0,1,0
25,401,401,41,14,27,4,3
12,406,406,35,35,0,1,0
10,421,421,5,5,0,1,0
7,424,424,23,23,0,1,0
27,445,445,5,5,0,1,0
29,450,450,69,48,21,2,1
34,460,460,61,29,32,4,3
33,462,462,17,1,16,3,2
23,485,485,79,11,68,4,3
19,486,486,5,5,0,1,0
22,490,490,16,8,8,2,1
14,493,493,30,30,0,1,0
26,497,497,148,26,122,4,3

37,106,106,9,9,0,1,0
28,119,119,2,2,0,1,0
3,138,138,5,5,0,1,0
40,141,141,34,34,0,1,0
20,161,161,6,6,0,1,0
35,169,169,9,9,0,1,0
27,172,172,11,5,6,2,1
31,173,173,2,2,0,1,0
45,177,177,5,2,3,2,1
13,196,196,21,21,0,1,0
16,204,204,1,1,0,1,0
43,206,206,23,11,12,4,3
7,217,217,14,2,12,2,1
23,222,222,1,1,0,1,0
4,224,224,37,8,29,2,1
30,230,230,43,43,0,1,0
38,263,263,5,1,4,2,1
34,266,266,4,4,0,1,0
10,270,270,11,11,0,1,0
21,271,271,67,43,24,2,1
44,298,298,19,19,0,1,0
11,307,307,16,16,0,1,0
17,307,307,31,22,9,4,3
6,327,327,24,5,19,3,2
32,343,343,97,82,15,4,3
29,346,346,4,1,3,2,1
14,357,357,1,1,0,1,0
9,362,362,30,18,12,2,1
25,367,367,7,7,0,1,0
39,368,368,22,4,18,2,1
15,377,377,47,25,22,3,2
1,378,378,21,11,10,2,1
46,385,385,177,102,75,4,3
0,392,392,5,5,0,1,0
33,393,393,9,3,6,2,1
24,395,395,3,3,0,1,0
18,405,405,64,64,0,1,0
41,407,407,1,1,0,1,0
5,418,418,8,8,0,1,0
22,426,426,12,3,9,4,3
12,429,429,15,11,4,2,1
19,441,441,63,63,0,1,0
42,449,449,96,96,0,1,0
36,475,475,28,28,0,1,0
26,488,488,4,1,3,2,1
8,490,490,95,8,87,4,3
2,491,491,7,7,0,1,0

34,117,117,10,10,0,1,0
5,129,129,16,16,0,1,0
25,133,133,8,2,6,2,1
11,135,135,1,1,0,1,0
27,180,180,9,2,7,2,1
32,182,182,10,5,5,2,1
7,202,202,11,11,0,1,0
39,236,236,16,16,0,1,0
13,237,237,5,2,3,2,1
3,240,240,2,2,0,1,0
2,250,250,10,10,0,1,0
18,264,264,4,4,0,1,0
6,266,266,16,10,6,2,1
38,269,269,18,11,7,2,1
14,275,275,49,49,0,1,0
0,286,286,43,9,34,2,1
4,299,299,46,16,30,4,3
35,299,299,10,10,0,1,0
21,299,299,50,50,0,1,0
17,321,321,4,4,0,1,0
9,322,322,11,1,10,3,2
31,338,338,93,73,20,3,2
28,365,365,22,22,0,1,0
22,372,372,78,78,0,1,0
26,389,389,13,1,12,2,1
20,397,397,85,52,33,2,1
12,402,402,89,89,0,1,0
15,408,408,2,2,0,1,0
29,415,415,122,63,59,3,2
30,415,415,47,29,18,2,1
37,418,418,20,20,0,1,0
1,420,420,57,57,0,1,0
23,427,427,11,1,10,2,1
16,443,443,22,10,12,2,1
8,444,444,64,22,42,2,1
33,448,448,15,15,0,1,0
10,457,457,73,73,0,1,0
36,468,468,91,91,0,1,0
19,469,469,53,27,26,2,1
24,469,469,30,30,0,1,0

26,101,101,1,1,0,1,0
30,110,110,3,3,0,1,0
1,132,132,2,2,0,1,0
32,152,152,56,32,24,4,3
34,161,161,14,14,0,1,0
3,186,186,3,3,0,1,0
25,194,194,9,9,0,1,0
4,201,201,10,10,0,1,0
5,201,201,15,15,0,1,0
38,203,203,27,19,8,2,1
28,212,212,21,16,5,2,1
13,232,232,13,1,12,2,1
19,252,252,15,15,0,1,0
9,256,256,28,8,20,3,2
8,262,262,8,8,0,1,0
31,277,277,47,35,12,4,3
7,278,278,3,3,0,1,0
24,294,294,11,11,0,1,0
23,297,297,3,3,0,1,0
15,303,303,50,50,0,1,0
20,323,323,14,14,0,1,0
0,329,329,31,31,0,1,0
40,333,333,64,64,0,1,0
10,341,341,5,5,0,1,0
18,344,344,53,53,0,1,0
39,354,354,9,3,6,2,1
6,359,359,49,30,19,4,3
37,366,366,2,2,0,1,0
35,378,378,12,12,0,1,0
27,395,395,13,13,0,1,0
21,428,428,14,14,0,1,0
2,439,439,242,191,51,4,3
16,444,444,7,1,6,2,1
11,447,447,8,1,7,2,1
14,457,457,62,43,19,2,1
33,477,477,91,66,25,2,1
22,484,484,1,1,0,1,0
17,484,484,46,46,0,1,0
12,493,493,11,11,0,1,0
29,495,495,150,150,0,1,0
36,495,495,85,79,6,2,1

10,102,102,16,3,13,2,1
25,104,104,10,10,0,1,0
18,125,125,1,1,0,1,0
28,145,145,17,7,10,2,1
33,162,162,46,32,14,2,1
15,165,165,7,3,4,2,1
12,185,185,12,12,0,1,0
19,212,212,1,1,0,1,0
7,243,243,64,8,56,3,2
37,244,244,8,8,0,1,0
14,263,263,8,4,4,2,1
31,267,267,25,18,7,2,1
21,287,287,108,108,0,1,0
5,289,289,5,5,0,1,0
26,306,306,11,11,0,1,0
3,310,310,16,8,8,2,1
34,315,315,10,1,9,4,3
30,330,330,4,4,0,1,0
2,339,339,168,27,141,4,3
22,346,346,30,13,17,2,1
20,357,357,7,7,0,1,0
32,362,362,35,35,0,1,0
8,377,377,12,3,9,4,3
0,383,383,60,60,0,1,0
4,388,388,60,30,30,2,1
16,412,412,9,9,0,1,0
11,412,412,7,2,5,2,1
17,419,419,4,4,0,1,0
29,428,428,2,2,0,1,0
1,474,474,70,70,0,1,0
13,476,476,22,22,0,1,0
36,476,476,149,77,72,3,2
35,488,488,41,41,0,1,0
23,494,494,20,4,16,3,2
9,494,494,32,32,0,1,0
27,496,496,89,43,46,3,2
24,499,499,14,2,12,4,3
6,499,499,60,40,20,2,1

17,100,100,9,9,0,1,0
32,101,101,8,4,4,2,1
46,110,110,18,18,0,1,0
8,124,124,3,3,0,1,0
10,126,126,1,1,0,1,0
22,134,134,17,9,8,3,2
23,140,140,25,25,0,1,0
43,145,145,14,4,10,2,1
34,163,163,50,50,0,1,0
45,169,169,10,10,0,1,0
1,182,182,6,6,0,1,0
41,198,198,3,3,0,1,0
21,208,208,29,29,0,1,0
29,217,217,1,1,0,1,0
7,226,226,32,32,0,1,0
18,233,233,2,2,0,1,0
11,258,258,12,12,0,1,0
14,261,261,12,12,0,1,0
31,264,264,2,2,0,1,0
24,277,277,3,3,0,1,0
15,288,288,4,1,3,2,1
27,294,294,13,13,0,1,0
13,299,299,6,2,4,2,1
25,301,301,66,36,30,3,2
19,308,308,4,4,0,1,0
36,312,312,21,21,0,1,0
44,322,322,35,35,0,1,0
6,331,331,3,3,0,1,0
42,333,333,49,49,0,1,0
30,337,337,57,33,24,3,2
12,342,342,54,13,41,2,1
37,354,354,56,56,0,1,0
0,386,386,3,3,0,1,0
2,407,407,14,14,0,1,0
40,412,412,34,10,24,3,2
38,417,417,20,20,0,1,0
33,424,424,9,2,7,2,1
9,430,430,20,20,0,1,0
20,447,447,6,1,5,2,1
35,448,448,116,116,0,1,0
16,455,455,10,2,8,2,1
28,463,463,21,21,0,1,0
5,469,469,64,64,0,1,0
39,477,477,53,13,40,3,2
4,490,490,11,11,0,1,0
26,496,496,132,132,0,1,0
3,500,500,11,1,10,4,3

19,103,103,18,6,12,2,1
9,116,116,1,1,0,1,0
26,141,141,4,1,3,2,1
40,167,167,6,6,0,1,0
13,172,172,8,8,0,1,0
2,176,176,9,9,0,1,0
20,190,190,2,2,0,1,0
1,195,195,14,14,0,1,0
24,207,207,17,17,0,1,0
4,207,207,2,2,0,1,0
6,217,217,41,2,39,4,3
27,228,228,15,8,7,2,1
18,228,228,39,39,0,1,0
22,231,231,24,24,0,1,0
5,244,244,9,2,7,2,1
37,266,266,35,35,0,1,0
23,271,271,11,1,10,2,1
0,275,275,14,5,9,3,2
21,310,310,4,4,0,1,0
29,314,314,15,6,9,2,1
28,327,327,25,1,24,4,3
11,328,328,6,6,0,1,0
35,330,330,34,22,12,4,3
10,348,348,47,13,34,3,2
32,376,376,49,49,0,1,0
7,382,382,41,31,10,2,1
12,382,382,10,2,8,2,1
14,390,390,5,2,3,2,1
3,404,404,45,25,20,3,2
39,405,405,6,6,0,1,0
36,408,408,12,2,10,3,2
16,410,410,130,117,13,2,1
33,410,410,15,12,3,2,1
15,412,412,124,82,42,4,3
17,419,419,12,3,9,4,3
30,434,434,101,101,0,1,0
8,448,448,5,2,3,2,1
25,452,452,204,167,37,2,1
38,471,471,11,11,0,1,0
31,484,484,49,10,39,4,3
34,488,488,98,13,85,4,3

5,101,101,2,2,0,1,0
13,102,102,5,5,0,1,0
34,105,105,37,23,14,2,1
0,141,141,52,52,0,1,0
16,143,143,9,9,0,1,0
8,174,174,9,9,0,1,0
3,179,179,10,10,0,1,0
10,199,199,33,33,0,1,0
7,206,206,37,37,0,1,0
9,209,209,8,8,0,1,0
32,214,214,15,3,12,4,3
15,294,294,8,3,5,2,1
31,294,294,16,16,0,1,0
2,316,316,82,26,56,3,2
18,329,329,47,33,14,2,1
25,332,332,62,2,60,3,2
26,335,335,59,59,0,1,0
30,337,337,31,31,0,1,0
24,337,337,24,24,0,1,0
37,352,352,22,5,17,2,1
6,360,360,15,15,0,1,0
33,379,379,50,50,0,1,0
4,382,382,11,11,0,1,0
36,383,383,13,13,0,1,0
23,383,383,40,8,32,3,2
21,390,390,69,69,0,1,0
35,397,397,3,3,0,1,0
1,403,403,8,8,0,1,0
12,414,414,5,2,3,2,1
19,426,426,36,31,5,2,1
27,453,453,21,21,0,1,0
17,466,466,65,65,0,1,0
20,478,478,65,65,0,1,0
29,485,485,16,16,0,1,0
11,490,490,116,116,0,1,0
28,491,491,6,6,0,1,0
22,491,491,49,15,34,4,3
14,498,498,1,1,0,1,0

2,102,102,25,13,12,4,3
12,110,110,18,18,0,1,0
24,135,135,14,2,12,3,2
22,169,169,15,15,0,1,0
3,178,178,7,7,0,1,0
0,190,190,25,25,0,1,0
20,197,197,19,19,0,1,0
26,214,214,13,13,0,1,0
16,214,214,2,2,0,1,0
17,227,227,23,23,0,1,0
1,233,233,29,29,0,1,0
18,259,259,41,35,6,3,2
29,264,264,1,1,0,1,0
14,287,287,18,18,0,1,0
25,293,293,15,5,10,3,2
21,305,305,26,10,16,3,2
23,305,305,14,8,6,3,2
10,330,330,64,18,46,2,1
19,350,350,2,2,0,1,0
8,378,378,64,64,0,1,0
5,400,400,1,1,0,1,0
27,411,411,47,47,0,1,0
11,416,416,57,31,26,2,1
7,422,422,173,147,26,3,2
15,425,425,49,49,0,1,0
28,431,431,136,136,0,1,0
13,444,444,98,98,0,1,0
9,475,475,105,29,76,4,3
6,491,491,21,3,18,4,3
4,499,499,161,129,32,2,1

25,101,101,29,29,0,1,0
43,109,109,22,12,10,2,1
40,129,129,5,5,0,1,0
14,144,144,17,1,16,2,1
17,160,160,5,5,0,1,0
3,162,162,8,4,4,2,1
21,168,168,8,1,7,2,1
16,168,168,10,6,4,2,1
2,169,169,26,7,19,2,1
9,182,182,1,1,0,1,0
11,185,185,30,10,20,2,1
7,203,203,1,1,0,1,0
20,204,204,14,14,0,1,0
1,205,205,11,11,0,1,0
36,207,207,1,1,0,1,0
24,229,229,18,18,0,1,0
38,233,233,15,15,0,1,0
13,249,249,14,6,8,3,2
0,256,256,46,46,0,1,0
33,258,258,10,4,6,3,2
8,272,272,45,45,0,1,0
29,304,304,24,2,22,3,2
5,305,305,9,9,0,1,0
37,308,308,1,1,0,1,0
34,317,317,21,10,11,2,1
41,329,329,75,7,68,3,2
32,329,329,17,17,0,1,0
4,332,332,11,11,0,1,0
19,332,332,1,1,0,1,0
15,349,349,22,8,14,3,2
6,353,353,17,1,16,2,1
42,368,368,4,4,0,1,0
10,374,374,33,33,0,1,0
12,381,381,20,20,0,1,0
18,391,391,85,51,34,3,2
28,396,396,37,37,0,1,0
27,397,397,99,54,45,2,1
26,410,410,11,11,0,1,0
23,446,446,32,10,22,2,1
30,466,466,38,8,30,3,2
31,466,466,3,3,0,1,0
39,476,476,114,114,0,1,0
22,478,478,29,29,0,1,0
35,487,487,73,73,0,1,0

26,104,104,10,10,0,1,0
22,105,105,3,3,0,1,0
30,124,124,1,1,0,1,0
19,127,127,13,13,0,1,0
18,129,129,5,5,0,1,0
0,151,151,12,12,0,1,0
36,153,153,1,1,0,1,0
24,164,164,39,39,0,1,0
1,169,169,2,2,0,1,0
20,185,185,13,13,0,1,0
16,206,206,5,5,0,1,0
28,210,210,36,36,0,1,0
4,213,213,25,25,0,1,0
25,214,214,16,8,8,3,2
17,223,223,37,6,31,2,1
37,246,246,8,2,6,3,2
7,265,265,7,1,6,2,1
5,269,269,54,54,0,1,0
12,277,277,1,1,0,1,0
13,279,279,1,1,0,1,0
29,283,283,37,25,12,4,3
11,303,303,7,7,0,1,0
14,306,306,111,29,82,3,2
3,335,335,13,13,0,1,0
34,342,342,85,54,31,2,1
23,352,352,24,4,20,2,1
9,363,363,38,35,3,2,1
31,385,385,15,3,12,3,2
8,388,388,46,37,9,2,1
15,398,398,160,77,83,4,3
32,421,421,133,133,0,1,0
21,441,441,34,34,0,1,0
2,444,444,1,1,0,1,0
6,455,455,15,5,10,3,2
10,467,467,67,45,22,2,1
27,469,469,10,7,3,2,1
35,475,475,94,72,22,3,2
33,491,491,7,7,0,1,0

30,103,103,5,5,0,1,0
32,129,129,28,5,23,2,1
16,142,142,20,2,18,4,3
13,192,192,3,3,0,1,0
14,196,196,10,7,3,2,1
5,214,214,7,1,6,3,2
6,216,216,27,6,21,4,3
4,217,217,17,17,0,1,0
29,225,225,9,9,0,1,0
9,227,227,65,2,63,4,3
17,241,241,61,25,36,4,3
11,263,263,36,36,0,1,0
18,264,264,10,1,9,2,1
22,268,268,29,29,0,1,0
33,270,270,11,2,9,2,1
25,275,275,99,8,91,4,3
2,286,286,8,8,0,1,0
1,299,299,83,26,57,4,3
24,318,318,1,1,0,1,0
7,356,356,75,75,0,1,0
10,368,368,11,7,4,2,1
31,376,376,21,21,0,1,0
8,388,388,48,48,0,1,0
23,403,403,72,72,0,1,0
28,415,415,61,48,13,2,1
20,428,428,13,13,0,1,0
21,436,436,16,4,12,4,3
19,440,440,22,1,21,4,3
27,441,441,51,51,0,1,0
26,447,447,8,3,5,2,1
12,461,461,81,78,3,2,1
15,465,465,30,6,24,3,2
3,480,480,4,4,0,1,0
0,489,489,157,60,97,4,3

24,115,115,3,3,0,1,0
32,118,118,7,4,3,2,1
9,121,121,19,4,15,4,3
14,123,123,15,15,0,1,0
3,145,145,1,1,0,1,0
10,154,154,7,7,0,1,0
25,156,156,15,15,0,1,0
19,168,168,6,1,5,2,1
2,176,176,12,7,5,2,1
27,221,221,1,1,0,1,0
26,230,230,1,1,0,1,0
1,246,246,12,4,8,3,2
7,248,248,21,21,0,1,0
23,277,277,56,56,0,1,0
4,287,287,63,18,45,2,1
31,300,300,32,26,6,3,2
30,300,300,50,26,24,4,3
0,304,304,4,4,0,1,0
17,321,321,8,8,0,1,0
16,323,323,32,32,0,1,0
11,331,331,213,90,123,4,3
28,336,336,18,18,0,1,0
15,336,336,5,5,0,1,0
22,350,350,101,80,21,4,3
12,363,363,47,27,20,2,1
8,367,367,58,58,0,1,0
18,398,398,59,35,24,4,3
34,418,418,11,11,0,1,0
29,424,424,117,117,0,1,0
33,428,428,16,16,0,1,0
5,453,453,19,19,0,1,0
20,461,461,25,25,0,1,0
6,491,491,5,5,0,1,0
21,492,492,107,61,46,3,2
13,493,493,68,68,0,1,0

32,128,128,4,1,3,2,1
17,129,129,10,3,7,2,1
42,142,142,26,4,22,2,1
41,150,150,3,3,0,1,0
34,163,163,22,18,4,2,1
5,198,198,7,7,0,1,0
1,206,206,10,10,0,1,0
24,206,206,29,3,26,4,3
10,208,208,17,2,15,2,1
12,211,211,2,2,0,1,0
33,215,215,32,32,0,1,0
38,217,217,24,13,11,2,1
19,221,221,16,7,9,4,3
18,233,233,2,2,0,1,0
3,242,242,8,4,4,2,1
45,245,245,27,27,0,1,0
21,246,246,3,3,0,1,0
15,246,246,8,8,0,1,0
30,261,261,42,23,19,2,1
9,264,264,20,20,0,1,0
27,267,267,5,5,0,1,0
6,278,278,6,6,0,1,0
44,289,289,3,3,0,1,0
36,314,314,39,9,30,4,3
13,317,317,71,37,34,3,2
0,320,320,7,7,0,1,0
4,334,334,11,6,5,2,1
37,335,335,38,35,3,2,1
29,341,341,38,31,7,2,1
25,344,344,22,11,11,2,1
20,351,351,84,19,65,3,2
16,351,351,34,14,20,2,1
22,352,352,57,21,36,4,3
31,356,356,4,4,0,1,0
35,362,362,81,72,9,2,1
14,368,368,15,5,10,2,1
40,382,382,16,16,0,1,0
11,387,387,34,34,0,1,0
8,392,392,51,51,0,1,0
2,411,411,15,15,0,1,0
43,423,423,54,54,0,1,0
46,425,425,40,40,0,1,0
23,434,434,1,1,0,1,0
7,445,445,32,32,0,1,0
26,479,479,12,2,10,4,3
28,483,483,54,30,24,3,2
39,498,498,37,26,11,2,1

23,120,120,13,13,0,1,0
2,128,128,45,24,21,2,1
12,131,131,33,33,0,1,0
25,135,135,3,3,0,1,0
4,141,141,24,5,19,2,1
18,169,169,36,6,30,2,1
20,186,186,4,4,0,1,0
8,189,189,1,1,0,1,0
17,189,189,27,27,0,1,0
15,194,194,1,1,0,1,0
0,208,208,92,82,10,3,2
16,209,209,43,43,0,1,0
19,214,214,18,18,0,1,0
10,253,253,7,1,6,2,1
13,265,265,8,5,3,2,1
6,273,273,60,43,17,2,1
14,277,277,15,15,0,1,0
21,286,286,95,15,80,3,2
11,291,291,72,72,0,1,0
7,332,332,3,3,0,1,0
22,372,372,3,3,0,1,0
24,412,412,43,43,0,1,0
5,443,443,16,16,0,1,0
1,453,453,193,193,0,1,0
9,457,457,36,15,21,2,1
3,474,474,121,72,49,2,1

21,104,104,7,1,6,3,2
20,136,136,14,8,6,2,1
30,156,156,10,10,0,1,0
22,186,186,9,9,0,1,0
2,194,194,21,21,0,1,0
13,198,198,1,1,0,1,0
7,209,209,50,28,22,3,2
15,211,211,1,1,0,1,0
39,216,216,24,24,0,1,0
5,223,223,1,1,0,1,0
32,225,225,22,1,21,2,1
36,229,229,15,15,0,1,0
3,230,230,27,27,0,1,0
19,242,242,6,6,0,1,0
12,244,244,2,2,0,1,0
29,251,251,29,19,10,2,1
28,299,299,41,41,0,1,0
37,303,303,68,68,0,1,0
33,305,305,56,56,0,1,0
0,305,305,4,1,3,2,1
34,312,312,7,7,0,1,0
1,315,315,139,109,30,4,3
27,315,315,9,2,7,2,1
10,321,321,32,11,21,2,1
40,325,325,2,2,0,1,0
6,330,330,13,2,11,2,1
18,355,355,18,15,3,2,1
38,357,357,16,4,12,3,2
26,373,373,9,9,0,1,0
8,375,375,11,8,3,2,1
4,376,376,35,35,0,1,0
23,380,380,39,23,16,3,2
14,381,381,15,15,0,1,0
24,393,393,79,46,33,4,3
9,405,405,61,48,13,2,1
11,405,405,34,4,30,2,1
17,417,417,34,12,22,3,2
16,428,428,41,27,14,3,2
35,477,477,74,74,0,1,0
25,487,487,99,99,0,1,0
31,489,489,47,1,46,4,3

9,111,111,4,4,0,1,0
32,117,117,44,1,43,3,2
19,124,124,3,3,0,1,0
30,136,136,1,1,0,1,0
10,139,139,30,10,20,3,2
2,153,153,43,43,0,1,0
15,198,198,21,10,11,2,1
28,201,201,3,3,0,1,0
14,201,201,4,4,0,1,0
24,207,207,21,7,14,2,1
20,215,215,13,13,0,1,0
31,227,227,9,9,0,1,0
17,227,227,13,13,0,1,0
22,232,232,41,41,0,1,0
8,235,235,22,6,16,3,2
0,235,235,13,13,0,1,0
6,237,237,37,25,12,2,1
21,251,251,6,6,0,1,0
1,286,286,1,1,0,1,0
3,286,286,1,1,0,1,0
11,292,292,69,28,41,2,1
5,319,319,22,22,0,1,0
25,331,331,9,1,8,2,1
12,335,335,97,57,40,3,2
26,336,336,39,5,34,3,2
16,346,346,74,27,47,2,1
23,356,356,63,51,12,4,3
4,359,359,9,9,0,1,0
29,365,365,16,1,15,3,2
7,421,421,142,142,0,1,0
18,443,443,64,64,0,1,0
27,456,456,93,93,0,1,0
13,491,491,49,22,27,4,3

17,106,106,4,4,0,1,0
28,112,112,79,79,0,1,0
0,121,121,1,1,0,1,0
6,122,122,44,44,0,1,0
35,167,167,13,13,0,1,0
3,172,172,20,20,0,1,0
23,176,176,6,6,0,1,0
5,195,195,58,8,50,2,1
18,199,199,48,39,9,2,1
25,203,203,15,10,5,2,1
27,203,203,3,3,0,1,0
21,219,219,3,3,0,1,0
12,219,219,10,10,0,1,0
4,238,238,21,21,0,1,0
10,255,255,3,3,0,1,0
31,255,255,8,8,0,1,0
11,260,260,21,6,15,4,3
26,311,311,10,10,0,1,0
33,330,330,49,3,46,3,2
2,336,336,71,43,28,2,1
29,346,346,21,21,0,1,0
22,350,350,21,1,20,2,1
1,371,371,51,51,0,1,0
7,376,376,15,1,14,4,3
13,385,385,38,38,0,1,0
20,396,396,28,2,26,3,2
14,403,403,13,13,0,1,0
15,420,420,58,28,30,3,2
19,429,429,44,44,0,1,0
9,429,429,33,6,27,2,1
24,435,435,26,12,14,2,1
8,438,438,61,23,38,4,3
16,448,448,8,3,5,2,1
32,482,482,25,22,3,2,1
30,485,485,38,12,26,2,1
34,490,490,22,11,11,2,1

23,116,116,29,29,0,1,0
14,125,125,13,4,9,4,3
4,134,134,14,9,5,2,1
0,140,140,1,1,0,1,0
36,146,146,7,7,0,1,0
25,162,162,26,15,11,2,1
21,164,164,1,1,0,1,0
42,179,179,21,21,0,1,0
17,187,187,10,4,6,3,2
1,204,204,12,5,7,2,1
33,215,215,7,7,0,1,0
6,215,215,37,37,0,1,0
12,215,215,7,3,4,2,1
24,228,228,21,21,0,1,0
16,241,241,41,15,26,2,1
22,246,246,1,1,0,1,0
3,248,248,4,4,0,1,0
43,281,281,15,3,12,3,2
5,286,286,20,8,12,2,1
40,292,292,13,7,6,3,2
18,299,299,18,6,12,3,2
19,301,301,11,5,6,2,1
37,309,309,47,33,14,3,2
2,323,323,4,4,0,1,0
8,327,327,8,2,6,2,1
15,363,363,19,7,12,4,3
11,380,380,16,16,0,1,0
31,381,381,9,9,0,1,0
20,384,384,69,69,0,1,0
28,389,389,14,14,0,1,0
26,392,392,24,1,23,2,1
9,407,407,5,5,0,1,0
39,408,408,80,46,34,3,2
32,415,415,93,29,64,4,3
29,419,419,43,6,37,2,1
34,419,419,1,1,0,1,0
27,426,426,10,4,6,2,1
10,441,441,77,77,0,1,0
35,444,444,141,141,0,1,0
38,449,449,1,1,0,1,0
41,454,454,35,35,0,1,0
13,466,466,31,5,26,2,1
7,494,494,50,50,0,1,0
30,495,495,121,114,7,2,1

32,123,123,17,17,0,1,0
23,126,126,29,23,6,2,1
12,130,130,89,22,67,4,3
1,132,132,5,5,0,1,0
15,158,158,8,2,6,2,1
21,173,173,42,14,28,3,2
36,177,177,10,10,0,1,0
9,178,178,10,10,0,1,0
6,192,192,6,6,0,1,0
3,197,197,1,1,0,1,0
25,256,256,24,24,0,1,0
33,257,257,47,29,18,2,1
17,268,268,24,24,0,1,0
24,269,269,5,5,0,1,0
35,289,289,10,10,0,1,0
18,295,295,9,5,4,2,1
5,318,318,25,3,22,2,1
19,335,335,18,18,0,1,0
31,335,335,24,3,21,4,3
29,336,336,108,108,0,1,0
30,339,339,21,21,0,1,0
14,347,347,8,8,0,1,0
22,348,348,18,18,0,1,0
10,367,367,58,48,10,2,1
28,376,376,21,21,0,1,0
34,377,377,35,35,0,1,0
16,397,397,54,1,53,4,3
4,420,420,33,33,0,1,0
27,422,422,8,2,6,3,2
26,441,441,5,5,0,1,0
13,462,462,49,49,0,1,0
0,463,463,58,58,0,1,0
8,463,463,19,19,0,1,0
7,472,472,56,56,0,1,0
11,483,483,7,3,4,2,1
20,486,486,78,78,0,1,0
2,497,497,34,34,0,1,0

3,111,111,8,8,0,1,0
18,118,118,26,26,0,1,0
37,125,125,13,2,11,2,1
5,126,126,6,3,3,2,1
27,131,131,17,17,0,1,0
1,150,150,12,12,0,1,0
33,151,151,29,15,14,3,2
14,171,171,3,3,0,1,0
26,173,173,1,1,0,1,0
17,174,174,16,8,8,2,1
6,184,184,5,5,0,1,0
24,191,191,2,2,0,1,0
2,194,194,43,24,19,2,1
30,197,197,32,1,31,3,2
15,232,232,39,28,11,2,1
7,238,238,26,14,12,2,1
13,242,242,27,24,3,2,1
28,247,247,82,19,63,4,3
20,268,268,7,1,6,3,2
19,279,279,17,17,0,1,0
4,291,291,9,9,0,1,0
31,292,292,17,17,0,1,0
22,300,300,34,3,31,3,2
32,300,300,5,5,0,1,0
34,336,336,36,15,21,2,1
29,373,373,34,18,16,3,2
10,376,376,33,16,17,2,1
35,393,393,33,15,18,3,2
25,400,400,20,20,0,1,0
23,401,401,82,3,79,4,3
9,418,418,44,44,0,1,0
11,426,426,45,45,0,1,0
21,427,427,66,36,30,2,1
0,431,431,100,4,96,4,3
8,441,441,53,23,30,3,2
12,450,450,14,14,0,1,0
16,473,473,10,10,0,1,0
36,498,498,14,14,0,1,0

8,103,103,4,4,0,1,0
3,117,117,13,5,8,2,1
34,143,143,15,15,0,1,0
29,159,159,20,17,3,2,1
4,160,160,2,2,0,1,0
23,167,167,8,5,3,2,1
12,171,171,29,7,22,3,2
20,178,178,50,18,32,2,1
30,179,179,34,34,0,1,0
31,196,196,7,7,0,1,0
2,212,212,2,2,0,1,0
5,214,214,16,16,0,1,0
32,236,236,70,24,46,4,3
0,237,237,1,1,0,1,0
21,240,240,44,44,0,1,0
33,244,244,27,27,0,1,0
14,260,260,39,3,36,3,2
6,265,265,12,3,9,4,3
15,272,272,11,11,0,1,0
22,280,280,29,29,0,1,0
13,322,322,2,2,0,1,0
17,327,327,27,5,22,4,3
9,328,328,14,5,9,2,1
7,342,342,63,45,18,2,1
1,355,355,95,51,44,3,2
26,365,365,2,2,0,1,0
11,366,366,119,85,34,2,1
10,376,376,132,94,38,3,2
16,402,402,27,27,0,1,0
24,407,407,3,3,0,1,0
25,407,407,15,1,14,2,1
19,418,418,9,3,6,3,2
28,418,418,35,7,28,2,1
27,423,423,12,12,0,1,0
35,430,430,34,1,33,4,3
18,491,491,56,56,0,1,0

0,105,105,6,6,0,1,0
4,108,108,4,1,3,2,1
24,120,120,5,5,0,1,0
14,124,124,2,2,0,1,0
19,144,144,2,2,0,1,0
33,150,150,2,2,0,1,0
17,156,156,29,29,0,1,0
8,159,159,15,7,8,2,1
27,166,166,32,32,0,1,0
6,176,176,22,16,6,3,2
32,178,178,21,17,4,2,1
7,189,189,3,3,0,1,0
38,205,205,26,26,0,1,0
29,216,216,57,14,43,3,2
39,218,218,12,6,6,2,1
44,223,223,15,2,13,2,1
45,224,224,17,17,0,1,0
28,233,233,3,3,0,1,0
35,237,237,18,2,16,3,2
43,240,240,32,18,14,3,2
30,249,249,40,40,0,1,0
3,251,251,4,4,0,1,0
37,266,266,81,81,0,1,0
41,271,271,21,21,0,1,0
2,279,279,18,18,0,1,0
25,279,279,26,14,12,3,2
23,299,299,14,6,8,3,2
31,303,303,1,1,0,1,0
9,304,304,7,3,4,2,1
18,309,309,12,12,0,1,0
40,316,316,8,8,0,1,0
21,325,325,18,12,6,3,2
22,326,326,30,14,16,3,2
20,345,345,12,6,6,2,1
1,398,398,54,23,31,4,3
36,401,401,42,42,0,1,0
42,402,402,22,15,7,2,1
26,409,409,7,7,0,1,0
11,411,411,44,44,0,1,0
16,414,414,52,52,0,1,0
15,416,416,39,28,11,2,1
5,418,418,5,5,0,1,0
34,433,433,32,32,0,1,0
13,448,448,42,39,3,2,1
12,457,457,113,113,0,1,0
10,465,465,8,8,0,1,0

17,127,127,32,32,0,1,0
23,130,130,5,5,0,1,0
14,144,144,18,1,17,2,1
7,153,153,12,2,10,2,1
0,159,159,11,1,10,3,2
39,167,167,13,13,0,1,0
9,201,201,1,1,0,1,0
38,201,201,41,24,17,2,1
22,204,204,1,1,0,1,0
12,206,206,8,8,0,1,0
35,207,207,20,9,11,2,1
29,212,212,17,7,10,3,2
20,217,217,15,15,0,1,0
3,223,223,30,30,0,1,0
8,231,231,23,23,0,1,0
21,253,253,33,33,0,1,0
18,258,258,47,47,0,1,0
25,265,265,56,56,0,1,0
19,275,275,49,37,12,4,3
24,281,281,57,57,0,1,0
6,285,285,15,15,0,1,0
30,309,309,22,22,0,1,0
5,328,328,24,10,14,2,1
37,333,333,7,7,0,1,0
26,345,345,40,40,0,1,0
27,347,347,3,3,0,1,0
1,354,354,9,9,0,1,0
11,370,370,10,10,0,1,0
2,398,398,23,23,0,1,0
32,401,401,138,123,15,4,3
13,408,408,15,5,10,3,2
15,423,423,25,4,21,2,1
16,426,426,1,1,0,1,0
34,464,464,9,9,0,1,0
31,476,476,3,3,0,1,0
4,478,478,105,105,0,1,0
33,479,479,58,13,45,2,1
36,480,480,42,42,0,1,0
10,496,496,57,32,25,2,1
28,499,499,40,40,0,1,0

14,108,108,1,1,0,1,0
12,108,108,8,8,0,1,0
32,135,135,1,1,0,1,0
5,136,136,11,6,5,2,1
17,139,139,29,14,15,2,1
0,162,162,4,1,3,2,1
16,169,169,14,14,0,1,0
3,172,172,37,37,0,1,0
10,180,180,11,11,0,1,0
4,199,199,40,40,0,1,0
15,201,201,43,24,19,2,1
8,201,201,4,4,0,1,0
13,206,206,27,27,0,1,0
6,208,208,27,27,0,1,0
22,216,216,8,3,5,2,1
21,229,229,34,16,18,2,1
29,229,229,9,2,7,2,1
1,230,230,1,1,0,1,0
33,262,262,73,73,0,1,0
2,279,279,38,38,0,1,0
7,286,286,69,69,0,1,0
25,318,318,40,16,24,4,3
24,363,363,43,7,36,4,3
34,371,371,49,37,12,4,3
31,379,379,11,11,0,1,0
9,384,384,5,5,0,1,0
28,391,391,84,52,32,2,1
11,421,421,7,7,0,1,0
20,425,425,45,45,0,1,0
26,433,433,117,23,94,4,3
36,437,437,54,8,46,3,2
18,444,444,17,17,0,1,0
19,457,457,24,24,0,1,0
35,479,479,10,10,0,1,0
30,480,480,10,2,8,2,1
27,484,484,4,1,3,2,1
37,488,488,37,28,9,2,1
23,499,499,64,36,28,3,2

16,104,104,11,11,0,1,0
35,107,107,29,29,0,1,0
37,117,117,6,6,0,1,0
0,132,132,9,9,0,1,0
32,139,139,41,41,0,1,0
6,142,142,27,27,0,1,0
28,157,157,14,2,12,4,3
9,161,161,14,8,6,3,2
3,171,171,1,1,0,1,0
13,174,174,33,33,0,1,0
21,175,175,1,1,0,1,0
20,187,187,2,2,0,1,0
38,191,191,30,30,0,1,0
39,194,194,4,4,0,1,0
27,216,216,10,10,0,1,0
2,221,221,39,39,0,1,0
10,232,232,4,4,0,1,0
1,232,232,55,51,4,2,1
17,233,233,3,3,0,1,0
31,244,244,5,5,0,1,0
15,285,285,26,26,0,1,0
25,301,301,19,2,17,2,1
8,302,302,12,12,0,1,0
40,330,330,3,3,0,1,0
26,352,352,17,17,0,1,0
33,357,357,12,12,0,1,0
11,359,359,2,2,0,1,0
36,361,361,39,39,0,1,0
19,366,366,17,17,0,1,0
18,388,388,141,91,50,2,1
24,397,397,35,35,0,1,0
34,413,413,68,14,54,4,3
41,417,417,111,77,34,2,1
7,420,420,7,7,0,1,0
12,426,426,4,4,0,1,0
14,441,441,43,43,0,1,0
4,443,443,38,9,29,2,1
29,448,448,1,1,0,1,0
22,468,468,14,14,0,1,0
5,476,476,4,4,0,1,0
23,482,482,93,93,0,1,0
30,492,492,9,9,0,1,0

12,184,184,21,21,0,1,0
22,185,185,12,5,7,3,2
15,190,190,11,3,8,2,1
17,205,205,1,1,0,1,0
16,205,205,30,30,0,1,0
1,224,224,35,18,17,2,1
9,228,228,51,34,17,2,1
7,228,228,36,20,16,2,1
21,230,230,163,103,60,4,3
23,252,252,4,4,0,1,0
4,260,260,115,115,0,1,0
18,295,295,9,6,3,2,1
30,325,325,20,5,15,4,3
5,330,330,25,13,12,3,2
28,334,334,67,49,18,4,3
8,339,339,82,82,0,1,0
3,358,358,32,32,0,1,0
0,367,367,23,23,0,1,0
27,368,368,2,2,0,1,0
6,387,387,37,37,0,1,0
31,393,393,18,4,14,2,1
11,396,396,34,34,0,1,0
2,398,398,39,27,12,3,2
24,403,403,37,37,0,1,0
13,405,405,45,45,0,1,0
19,460,460,45,13,32,2,1
20,465,465,87,87,0,1,0
26,471,471,11,11,0,1,0
29,478,478,10,3,7,2,1
10,490,490,30,30,0,1,0
25,494,494,17,17,0,1,0
14,497,497,12,1,11,2,1

24,105,105,3,3,0,1,0
31,119,119,15,2,13,2,1
22,122,122,1,1,0,1,0
16,129,129,1,1,0,1,0
29,135,135,16,16,0,1,0
10,151,151,14,1,13,2,1
14,157,157,15,6,9,4,3
25,165,165,2,2,0,1,0
38,166,166,8,8,0,1,0
3,186,186,11,8,3,2,1
34,188,188,1,1,0,1,0
8,206,206,7,7,0,1,0
23,216,216,8,5,3,2,1
21,219,219,20,2,18,4,3
40,222,222,19,19,0,1,0
33,231,231,21,10,11,4,3
27,231,231,18,18,0,1,0
5,234,234,18,18,0,1,0
1,250,250,12,12,0,1,0
0,254,254,20,13,7,2,1
35,255,255,24,24,0,1,0
9,264,264,75,43,32,3,2
39,264,264,37,6,31,2,1
13,289,289,26,6,20,2,1
32,308,308,63,56,7,2,1
18,320,320,14,2,12,4,3
4,322,322,1,1,0,1,0
19,337,337,161,66,95,4,3
26,346,346,64,34,30,4,3
36,356,356,37,37,0,1,0
30,363,363,5,5,0,1,0
28,366,366,163,123,40,2,1
15,369,369,11,11,0,1,0
12,379,379,6,6,0,1,0
6,380,380,21,21,0,1,0
7,394,394,2,2,0,1,0
17,399,399,38,10,28,3,2
11,400,400,75,53,22,2,1
20,461,461,2,2,0,1,0
41,480,480,53,27,26,2,1
2,495,495,9,9,0,1,0
37,499,499,7,7,0,1,0

38,109,109,5,5,0,1,0
20,112,112,3,3,0,1,0
28,117,117,11,11,0,1,0
35,124,124,15,15,0,1,0
25,130,130,20,20,0,1,0
17,144,144,3,3,0,1,0
39,156,156,38,38,0,1,0
18,171,171,18,18,0,1,0
24,175,175,2,2,0,1,0
0,191,191,1,1,0,1,0
6,191,191,2,2,0,1,0
11,209,209,22,22,0,1,0
26,223,223,31,31,0,1,0
22,229,229,17,6,11,3,2
29,230,230,24,6,18,3,2
34,238,238,8,8,0,1,0
10,241,241,5,5,0,1,0
13,252,252,20,8,12,4,3
41,253,253,65,65,0,1,0
43,255,255,41,41,0,1,0
31,270,270,4,4,0,1,0
27,283,283,19,14,5,2,1
1,303,303,39,13,26,2,1
36,307,307,25,11,14,3,2
37,307,307,26,26,0,1,0
40,314,314,30,7,23,4,3
9,315,315,107,34,73,3,2
30,321,321,84,54,30,2,1
44,346,346,9,3,6,3,2
14,350,350,10,2,8,2,1
12,351,351,53,53,0,1,0
23,384,384,23,2,21,4,3
32,386,386,2,2,0,1,0
16,392,392,20,5,15,2,1
33,393,393,38,38,0,1,0
8,411,411,9,2,7,2,1
42,413,413,4,4,0,1,0
15,426,426,40,5,35,3,2
19,430,430,40,40,0,1,0
4,454,454,3,3,0,1,0
21,468,468,42,42,0,1,0
7,490,490,16,6,10,2,1
5,491,491,24,4,20,2,1
2,496,496,7,7,0,1,0
3,500,500,64,1,63,3,2

9,113,113,37,25,12,3,2
35,130,130,48,48,0,1,0
30,131,131,6,6,0,1,0
19,132,132,16,3,13,2,1
10,138,138,7,7,0,1,0
25,140,140,2,2,0,1,0
22,154,154,6,3,3,2,1
21,168,168,15,1,14,4,3
6,173,173,19,5,14,2,1
28,173,173,13,10,3,2,1
14,190,190,3,3,0,1,0
24,196,196,5,5,0,1,0
26,213,213,10,10,0,1,0
20,216,216,60,54,6,3,2
32,224,224,11,3,8,2,1
27,231,231,58,34,24,2,1
3,236,236,34,34,0,1,0
11,249,249,27,27,0,1,0
37,273,273,31,31,0,1,0
34,281,281,17,6,11,2,1
17,296,296,86,86,0,1,0
15,354,354,50,50,0,1,0
31,357,357,6,6,0,1,0
7,358,358,1,1,0,1,0
2,372,372,45,45,0,1,0
1,378,378,62,27,35,2,1
0,378,378,4,4,0,1,0
16,386,386,22,22,0,1,0
33,404,404,6,6,0,1,0
4,407,407,25,2,23,4,3
23,428,428,60,3,57,3,2
13,442,442,12,12,0,1,0
29,450,450,81,50,31,2,1
5,455,455,42,42,0,1,0
36,462,462,6,3,3,2,1
18,478,478,1,1,0,1,0
12,494,494,80,56,24,3,2
8,499,499,6,2,4,2,1

30,106,106,9,9,0,1,0
35,111,111,7,1,6,3,2
9,124,124,25,25,0,1,0
36,130,130,30,30,0,1,0
15,131,131,7,1,6,2,1
26,136,136,12,12,0,1,0
32,137,137,10,3,7,2,1
29,147,147,18,2,16,2,1
12,156,156,13,3,10,3,2
17,167,167,20,20,0,1,0
7,172,172,5,5,0,1,0
4,191,191,12,12,0,1,0
5,193,193,9,9,0,1,0
27,229,229,27,16,11,2,1
22,233,233,4,1,3,2,1
6,248,248,22,22,0,1,0
0,253,253,64,26,38,2,1
25,256,256,12,12,0,1,0
10,258,258,71,62,9,2,1
1,264,264,1,1,0,1,0
23,289,289,23,23,0,1,0
21,295,295,20,6,14,4,3
13,302,302,1,1,0,1,0
11,359,359,18,14,4,2,1
19,362,362,58,58,0,1,0
14,368,368,26,20,6,2,1
2,377,377,103,9,94,3,2
8,406,406,21,15,6,3,2
33,425,425,101,25,76,3,2
34,429,429,31,10,21,2,1
20,433,433,34,13,21,4,3
24,449,449,70,70,0,1,0
18,463,463,49,9,40,3,2
3,464,464,74,41,33,2,1
28,482,482,57,18,39,4,3
31,486,486,12,2,10,3,2
16,489,489,37,29,8,2,1

4,111,111,10,10,0,1,0
14,113,113,6,6,0,1,0
21,117,117,4,4,0,1,0
23,146,146,1,1,0,1,0
17,147,147,12,1,11,2,1
26,147,147,6,6,0,1,0
2,153,153,15,2,13,3,2
11,160,160,42,42,0,1,0
19,190,190,2,2,0,1,0
10,197,197,3,3,0,1,0
9,212,212,15,2,13,2,1
22,213,213,9,9,0,1,0
16,218,218,24,15,9,2,1
5,228,228,87,24,63,4,3
32,253,253,55,7,48,3,2
6,270,270,22,22,0,1,0
15,281,281,41,4,37,4,3
24,283,283,7,7,0,1,0
20,284,284,20,20,0,1,0
0,295,295,25,19,6,3,2
1,315,315,36,36,0,1,0
33,327,327,20,20,0,1,0
18,363,363,99,99,0,1,0
7,386,386,34,13,21,4,3
12,410,410,42,2,40,3,2
8,433,433,100,100,0,1,0
13,435,435,32,17,15,4,3
27,441,441,139,89,50,3,2
31,460,460,4,4,0,1,0
28,477,477,170,75,95,4,3
30,478,478,11,3,8,2,1
3,484,484,75,58,17,2,1
29,484,484,4,4,0,1,0
25,491,491,47,47,0,1,0

26,133,133,2,2,0,1,0
24,147,147,38,38,0,1,0
14,150,150,14,14,0,1,0
19,161,161,7,1,6,2,1
21,165,165,10,10,0,1,0
12,179,179,25,25,0,1,0
5,181,181,2,2,0,1,0
1,184,184,118,118,0,1,0
17,199,199,32,6,26,2,1
20,227,227,12,12,0,1,0
6,236,236,86,86,0,1,0
25,253,253,4,4,0,1,0
13,254,254,100,42,58,3,2
15,267,267,13,13,0,1,0
18,278,278,33,7,26,2,1
27,284,284,45,42,3,2,1
23,286,286,3,3,0,1,0
8,289,289,51,24,27,4,3
16,291,291,28,15,13,2,1
2,317,317,16,16,0,1,0
9,330,330,61,61,0,1,0
3,342,342,29,29,0,1,0
0,345,345,113,17,96,4,3
22,349,349,34,3,31,4,3
28,352,352,12,12,0,1,0
4,392,392,2,2,0,1,0
7,408,408,23,12,11,2,1
10,444,444,22,22,0,1,0
11,457,457,44,44,0,1,0

1,105,105,42,42,0,1,0
0,120,120,4,4,0,1,0
9,142,142,18,18,0,1,0
17,143,143,20,3,17,4,3
28,153,153,7,7,0,1,0
8,167,167,6,6,0,1,0
27,196,196,6,6,0,1,0
4,203,203,63,63,0,1,0
12,223,223,11,1,10,2,1
6,244,244,13,13,0,1,0
25,258,258,13,13,0,1,0
26,262,262,15,4,11,2,1
19,276,276,2,2,0,1,0
10,289,289,17,9,8,3,2
18,289,289,2,2,0,1,0
20,304,304,41,41,0,1,0
24,309,309,11,6,5,2,1
32,311,311,13,6,7,2,1
30,316,316,52,52,0,1,0
14,331,331,6,6,0,1,0
3,340,340,3,3,0,1,0
5,344,344,25,8,17,2,1
7,363,363,71,31,40,2,1
11,371,371,108,94,14,2,1
15,394,394,55,29,26,3,2
13,407,407,39,39,0,1,0
2,410,410,69,69,0,1,0
16,430,430,46,25,21,2,1
23,439,439,161,41,120,4,3
31,482,482,91,36,55,3,2
22,483,483,47,47,0,1,0
29,499,499,54,6,48,4,3
21,500,500,98,65,33,2,1

15,104,104,8,8,0,1,0
32,138,138,15,15,0,1,0
4,141,141,19,16,3,2,1
19,164,164,3,3,0,1,0
8,165,165,23,23,0,1,0
28,180,180,80,80,0,1,0
2,183,183,44,41,3,2,1
13,188,188,13,13,0,1,0
31,216,216,4,4,0,1,0
34,227,227,6,6,0,1,0
12,259,259,20,16,4,2,1
14,263,263,2,2,0,1,0
17,264,264,46,46,0,1,0
0,264,264,10,1,9,4,3
7,269,269,60,60,0,1,0
22,276,276,1,1,0,1,0
30,283,283,2,2,0,1,0
11,291,291,5,5,0,1,0
10,303,303,42,37,5,2,1
6,308,308,1,1,0,1,0
23,312,312,57,15,42,3,2
36,316,316,66,66,0,1,0
24,328,328,51,51,0,1,0
37,335,335,30,3,27,4,3
29,337,337,9,5,4,2,1
21,339,339,35,4,31,2,1
27,344,344,44,2,42,2,1
9,355,355,38,38,0,1,0
25,360,360,12,12,0,1,0
1,366,366,20,20,0,1,0
35,367,367,27,27,0,1,0
18,372,372,32,8,24,4,3
16,373,373,39,39,0,1,0
20,384,384,29,11,18,2,1
3,416,416,43,14,29,2,1
26,462,462,41,41,0,1,0
33,463,463,46,46,0,1,0
5,470,470,43,24,19,2,1
38,471,471,24,4,20,2,1

29,105,105,3,3,0,1,0
22,128,128,4,4,0,1,0
2,157,157,61,61,0,1,0
24,177,177,10,10,0,1,0
11,193,193,67,35,32,2,1
20,198,198,33,19,14,3,2
0,200,200,22,9,13,2,1
25,213,213,10,2,8,3,2
14,230,230,14,8,6,3,2
28,249,249,8,8,0,1,0
9,257,257,2,2,0,1,0
16,260,260,36,26,10,2,1
6,261,261,51,21,30,3,2
4,269,269,42,32,10,2,1
13,271,271,71,4,67,4,3
8,275,275,67,19,48,3,2
1,278,278,51,51,0,1,0
30,279,279,39,25,14,2,1
10,298,298,1,1,0,1,0
19,320,320,37,4,33,4,3
26,320,320,13,13,0,1,0
31,324,324,12,4,8,3,2
17,367,367,8,3,5,2,1
3,370,370,11,3,8,2,1
18,373,373,28,4,24,3,2
5,406,406,20,7,13,2,1
21,408,408,91,5,86,3,2
15,423,423,5,5,0,1,0
7,448,448,34,34,0,1,0
12,459,459,51,51,0,1,0
27,460,460,9,9,0,1,0
23,478,478,209,209,0,1,0

21,155,155,3,3,0,1,0
10,155,155,33,33,0,1,0
4,177,177,20,2,18,4,3
2,186,186,2,2,0,1,0
34,198,198,9,9,0,1,0
15,200,200,33,6,27,2,1
38,204,204,11,5,6,3,2
3,226,226,2,2,0,1,0
46,240,240,19,3,16,3,2
26,257,257,9,5,4,2,1
27,259,259,9,3,6,3,2
41,279,279,72,72,0,1,0
9,281,281,28,3,25,2,1
23,283,283,9,9,0,1,0
5,292,292,43,2,41,4,3
31,307,307,45,45,0,1,0
17,310,310,4,4,0,1,0
40,319,319,58,4,54,3,2
43,327,327,17,8,9,4,3
42,329,329,4,4,0,1,0
36,329,329,26,20,6,2,1
11,336,336,10,3,7,2,1
1,338,338,52,52,0,1,0
25,347,347,31,11,20,4,3
12,352,352,18,7,11,3,2
24,356,356,17,17,0,1,0
18,356,356,51,8,43,3,2
16,359,359,4,4,0,1,0
19,359,359,20,20,0,1,0
20,361,361,6,6,0,1,0
29,363,363,16,16,0,1,0
45,369,369,168,110,58,3,2
44,370,370,53,41,12,4,3
14,371,371,79,1,78,4,3
35,384,384,20,13,7,2,1
7,398,398,5,5,0,1,0
37,413,413,6,1,5,2,1
39,429,429,11,2,9,2,1
6,443,443,8,8,0,1,0
30,446,446,56,56,0,1,0
33,467,467,18,14,4,2,1
0,478,478,40,40,0,1,0
8,482,482,1,1,0,1,0
13,493,493,22,17,5,2,1
28,497,497,42,42,0,1,0
22,498,498,19,8,11,2,1
32,498,498,19,8,11,2,1

15,100,100,20,13,7,2,1
14,107,107,3,3,0,1,0
22,111,111,6,6,0,1,0
32,114,114,1,1,0,1,0
33,114,114,7,7,0,1,0
30,147,147,16,16,0,1,0
25,178,178,16,2,14,2,1
31,179,179,34,6,28,3,2
17,185,185,13,4,9,2,1
28,199,199,18,18,0,1,0
41,211,211,27,27,0,1,0
3,216,216,19,1,18,2,1
6,219,219,17,5,12,2,1
19,227,227,10,10,0,1,0
16,240,240,12,12,0,1,0
40,253,253,69,31,38,2,1
11,256,256,1,1,0,1,0
38,262,262,4,1,3,2,1
35,276,276,16,6,10,2,1
26,281,281,45,17,28,2,1
36,289,289,7,7,0,1,0
8,301,301,6,3,3,2,1
24,320,320,29,23,6,2,1
21,321,321,42,11,31,2,1
1,328,328,89,5,84,4,3
20,329,329,1,1,0,1,0
39,345,345,13,13,0,1,0
0,387,387,1,1,0,1,0
34,392,392,18,2,16,3,2
13,398,398,25,11,14,2,1
12,406,406,55,55,0,1,0
18,414,414,37,37,0,1,0
10,417,417,9,9,0,1,0
23,431,431,42,20,22,4,3
37,435,435,47,47,0,1,0
29,454,454,147,80,67,4,3
9,454,454,8,2,6,2,1
27,459,459,22,18,4,2,1
5,478,478,23,23,0,1,0
4,479,479,88,8,80,3,2
2,479,479,33,33,0,1,0
7,481,481,64,6,58,3,2
42,484,484,35,35,0,1,0

20,122,122,9,9,0,1,0
3,132,132,17,7,10,2,1
25,153,153,39,39,0,1,0
18,154,154,1,1,0,1,0
30,164,164,71,52,19,2,1
19,175,175,31,6,25,4,3
22,185,185,5,5,0,1,0
0,188,188,1,1,0,1,0
32,202,202,14,14,0,1,0
29,205,205,11,11,0,1,0
15,222,222,18,5,13,2,1
16,228,228,106,28,78,4,3
14,242,242,10,10,0,1,0
5,248,248,12,12,0,1,0
6,258,258,24,24,0,1,0
9,260,260,1,1,0,1,0
12,277,277,3,3,0,1,0
24,278,278,28,6,22,2,1
36,285,285,23,17,6,2,1
39,288,288,50,50,0,1,0
10,291,291,73,73,0,1,0
33,294,294,5,5,0,1,0
17,295,295,7,7,0,1,0
27,300,300,7,3,4,2,1
4,312,312,20,2,18,2,1
23,321,321,18,18,0,1,0
34,322,322,26,2,24,4,3
28,327,327,63,63,0,1,0
8,334,334,63,63,0,1,0
37,340,340,4,4,0,1,0
26,369,369,48,32,16,2,1
13,371,371,24,3,21,4,3
11,392,392,42,33,9,2,1
38,402,402,33,12,21,4,3
2,424,424,6,6,0,1,0
35,437,437,18,18,0,1,0
31,470,470,18,18,0,1,0
21,470,470,31,31,0,1,0
1,484,484,12,12,0,1,0
7,486,486,16,9,7,2,1

8,101,101,10,10,0,1,0
28,108,108,12,3,9,4,3
23,108,108,11,11,0,1,0
13,109,109,2,2,0,1,0
9,125,125,57,57,0,1,0
21,126,126,6,6,0,1,0
20,160,160,18,18,0,1,0
16,174,174,14,14,0,1,0
18,187,187,7,7,0,1,0
33,191,191,17,2,15,4,3
30,199,199,12,12,0,1,0
2,208,208,42,42,0,1,0
31,213,213,8,1,7,2,1
35,217,217,17,17,0,1,0
15,226,226,5,5,0,1,0
32,267,267,1,1,0,1,0
19,295,295,87,29,58,4,3
6,307,307,39,24,15,4,3
22,316,316,28,28,0,1,0
29,318,318,48,9,39,4,3
11,342,342,1,1,0,1,0
27,360,360,82,82,0,1,0
24,387,387,8,8,0,1,0
26,392,392,45,45,0,1,0
7,408,408,39,39,0,1,0
4,411,411,84,78,6,2,1
34,416,416,65,53,12,3,2
14,421,421,15,2,13,2,1
17,432,432,35,17,18,2,1
5,433,433,47,37,10,3,2
25,439,439,61,61,0,1,0
10,439,439,38,38,0,1,0
3,480,480,112,26,86,3,2
0,488,488,13,13,0,1,0
12,489,489,44,44,0,1,0
1,498,498,8,2,6,3,2

7,113,113,45,45,0,1,0
18,115,115,2,2,0,1,0
8,145,145,2,2,0,1,0
23,169,169,7,1,6,3,2
9,185,185,2,2,0,1,0
30,198,198,16,16,0,1,0
6,204,204,24,24,0,1,0
1,211,211,8,4,4,2,1
31,213,213,7,7,0,1,0
40,232,232,2,2,0,1,0
34,240,240,35,35,0,1,0
25,247,247,15,15,0,1,0
0,259,259,19,6,13,2,1
5,272,272,32,32,0,1,0
4,309,309,23,13,10,2,1
22,313,313,22,1,21,4,3
28,320,320,2,2,0,1,0
37,326,326,132,39,93,4,3
11,336,336,115,27,88,4,3
3,337,337,4,4,0,1,0
26,343,343,27,12,15,4,3
24,351,351,5,5,0,1,0
29,360,360,13,13,0,1,0
36,362,362,7,1,6,2,1
19,364,364,4,4,0,1,0
16,366,366,77,77,0,1,0
20,379,379,16,16,0,1,0
13,381,381,48,48,0,1,0
38,385,385,15,6,9,4,3
14,395,395,1,1,0,1,0
15,402,402,19,19,0,1,0
12,405,405,1,1,0,1,0
17,410,410,25,1,24,3,2
10,432,432,28,28,0,1,0
33,441,441,38,10,28,3,2
39,447,447,40,1,39,2,1
32,463,463,28,19,9,4,3
2,465,465,48,48,0,1,0
27,469,469,41,38,3,2,1
21,480,480,7,7,0,1,0
35,496,496,285,201,84,3,2

39,104,104,3,3,0,1,0
8,123,123,5,5,0,1,0
25,124,124,3,3,0,1,0
23,138,138,19,19,0,1,0
29,138,138,4,4,0,1,0
12,143,143,8,2,6,3,2
0,163,163,62,47,15,4,3
24,168,168,13,5,8,2,1
40,177,177,5,5,0,1,0
42,208,208,9,9,0,1,0
17,209,209,13,3,10,3,2
33,210,210,17,10,7,2,1
14,220,220,42,42,0,1,0
2,225,225,14,3,11,2,1
20,227,227,1,1,0,1,0
26,231,231,13,7,6,3,2
10,247,247,20,20,0,1,0
1,257,257,15,15,0,1,0
32,273,273,55,28,27,3,2
13,279,279,9,9,0,1,0
15,291,291,12,6,6,2,1
22,295,295,43,32,11,2,1
19,297,297,1,1,0,1,0
18,298,298,1,1,0,1,0
11,300,300,24,16,8,2,1
31,316,316,35,23,12,2,1
41,320,320,47,14,33,2,1
7,320,320,23,18,5,2,1
37,333,333,2,2,0,1,0
38,361,361,22,22,0,1,0
4,382,382,42,42,0,1,0
30,395,395,94,94,0,1,0
21,421,421,74,74,0,1,0
35,427,427,36,36,0,1,0
5,431,431,6,6,0,1,0
27,436,436,12,2,10,3,2
3,438,438,29,29,0,1,0
6,440,440,6,6,0,1,0
34,450,450,25,25,0,1,0
9,475,475,15,15,0,1,0
28,479,479,19,19,0,1,0
16,480,480,21,21,0,1,0
36,481,481,291,291,0,1,0

34,136,136,4,4,0,1,0
0,137,137,2,2,0,1,0
37,158,158,6,6,0,1,0
25,173,173,23,1,22,3,2
21,178,178,55,21,34,3,2
24,188,188,3,3,0,1,0
31,220,220,36,36,0,1,0
14,224,224,53,29,24,2,1
22,229,229,42,11,31,2,1
5,231,231,27,11,16,2,1
18,250,250,61,19,42,3,2
13,256,256,31,21,10,3,2
36,277,277,12,12,0,1,0
30,285,285,14,6,8,3,2
9,293,293,12,5,7,2,1
11,298,298,29,1,28,2,1
17,303,303,2,2,0,1,0
32,307,307,46,46,0,1,0
3,311,311,30,30,0,1,0
1,312,312,3,3,0,1,0
27,313,313,6,6,0,1,0
28,317,317,21,7,14,2,1
15,326,326,76,76,0,1,0
23,333,333,50,22,28,3,2
2,351,351,6,3,3,2,1
29,359,359,78,29,49,4,3
16,394,394,28,28,0,1,0
8,403,403,22,14,8,3,2
7,409,409,11,11,0,1,0
19,428,428,42,42,0,1,0
33,432,432,1,1,0,1,0
4,446,446,62,24,38,2,1
12,452,452,24,1,23,2,1
10,456,456,63,63,0,1,0
6,460,460,85,45,40,2,1
26,470,470,22,1,21,2,1
20,471,471,26,26,0,1,0
35,491,491,80,38,42,3,2

20,113,113,10,2,8,2,1
3,117,117,4,4,0,1,0
17,119,119,10,10,0,1,0
22,128,128,5,5,0,1,0
18,142,142,6,6,0,1,0
24,164,164,45,1,44,4,3
35,185,185,7,7,0,1,0
14,200,200,19,8,11,4,3
21,201,201,11,2,9,4,3
37,243,243,5,5,0,1,0
16,248,248,8,8,0,1,0
13,263,263,1,1,0,1,0
30,289,289,40,6,34,2,1
4,319,319,35,25,10,3,2
10,333,333,55,34,21,4,3
32,341,341,14,14,0,1,0
31,354,354,26,14,12,3,2
7,358,358,26,12,14,3,2
33,372,372,99,42,57,4,3
2,376,376,144,68,76,3,2
27,377,377,83,20,63,4,3
6,378,378,22,13,9,2,1
26,379,379,37,7,30,3,2
25,383,383,12,4,8,3,2
5,387,387,59,27,32,3,2
34,394,394,53,53,0,1,0
19,396,396,88,88,0,1,0
36,420,420,2,2,0,1,0
1,441,441,80,80,0,1,0
15,445,445,13,13,0,1,0
23,450,450,18,18,0,1,0
28,459,459,14,1,13,3,2
11,468,468,11,11,0,1,0
29,471,471,54,15,39,2,1
12,490,490,29,21,8,3,2
8,497,497,2,2,0,1,0
0,499,499,89,59,30,2,1
9,500,500,96,44,52,3,2

6,116,116,14,14,0,1,0
12,118,118,2,2,0,1,0
8,118,118,31,31,0,1,0
9,134,134,2,2,0,1,0
23,138,138,26,26,0,1,0
4,150,150,31,19,12,2,1
1,211,211,47,47,0,1,0
15,219,219,10,2,8,2,1
20,231,231,19,19,0,1,0
28,237,237,8,8,0,1,0
2,243,243,3,3,0,1,0
37,245,245,8,8,0,1,0
29,245,245,36,36,0,1,0
3,259,259,13,4,9,2,1
34,267,267,14,8,6,3,2
7,267,267,7,3,4,2,1
10,288,288,18,18,0,1,0
24,288,288,10,10,0,1,0
25,305,305,14,5,9,4,3
35,318,318,36,36,0,1,0
26,323,323,64,64,0,1,0
17,339,339,34,34,0,1,0
30,342,342,74,54,20,2,1
0,344,344,32,2,30,3,2
32,352,352,61,32,29,2,1
13,355,355,16,16,0,1,0
33,359,359,143,131,12,4,3
31,363,363,10,1,9,2,1
19,364,364,10,10,0,1,0
21,367,367,24,24,0,1,0
11,370,370,28,28,0,1,0
5,376,376,57,11,46,2,1
16,378,378,72,72,0,1,0
36,404,404,34,34,0,1,0
22,446,446,6,6,0,1,0
14,451,451,18,12,6,3,2
27,485,485,2,2,0,1,0
18,493,493,81,61,20,2,1

20,114,114,8,8,0,1,0
37,117,117,8,8,0,1,0
39,117,117,15,11,4,2,1
3,154,154,34,34,0,1,0
36,158,158,12,12,0,1,0
24,186,186,8,8,0,1,0
15,188,188,10,1,9,3,2
25,191,191,17,17,0,1,0
6,197,197,7,7,0,1,0
28,198,198,41,41,0,1,0
33,200,200,21,2,19,2,1
1,211,211,3,3,0,1,0
11,225,225,9,9,0,1,0
12,227,227,3,3,0,1,0
31,236,236,61,61,0,1,0
38,252,252,44,10,34,2,1
2,257,257,8,2,6,3,2
17,271,271,1,1,0,1,0
22,273,273,20,20,0,1,0
27,294,294,2,2,0,1,0
34,314,314,47,47,0,1,0
19,319,319,24,24,0,1,0
5,347,347,45,45,0,1,0
40,348,348,61,24,37,2,1
29,357,357,12,3,9,2,1
32,362,362,9,9,0,1,0
7,362,362,42,21,21,4,3
30,374,374,42,5,37,3,2
35,382,382,42,21,21,4,3
26,406,406,22,22,0,1,0
13,414,414,22,22,0,1,0
18,425,425,34,1,33,4,3
9,432,432,9,3,6,3,2
16,444,444,132,132,0,1,0
10,450,450,40,40,0,1,0
23,459,459,27,27,0,1,0
14,475,475,126,126,0,1,0
4,483,483,90,90,0,1,0
0,494,494,22,22,0,1,0
21,496,496,11,11,0,1,0
8,498,498,20,20,0,1,0

3,100,100,4,4,0,1,0
1,104,104,16,16,0,1,0
42,124,124,1,1,0,1,0
28,125,125,36,36,0,1,0
6,129,129,5,2,3,2,1
17,137,137,10,10,0,1,0
41,145,145,3,3,0,1,0
21,146,146,3,3,0,1,0
11,149,149,34,23,11,2,1
12,152,152,6,6,0,1,0
9,173,173,19,19,0,1,0
43,176,176,2,2,0,1,0
5,182,182,5,5,0,1,0
23,199,199,10,3,7,2,1
8,203,203,3,3,0,1,0
16,217,217,16,4,12,3,2
22,225,225,31,1,30,4,3
4,231,231,6,3,3,2,1
2,239,239,8,2,6,2,1
10,259,259,2,2,0,1,0
15,296,296,19,1,18,3,2
36,305,305,18,15,3,2,1
33,337,337,87,37,50,2,1
38,350,350,13,13,0,1,0
39,351,351,100,76,24,3,2
34,359,359,24,24,0,1,0
25,359,359,12,12,0,1,0
37,370,370,7,7,0,1,0
30,398,398,9,9,0,1,0
27,414,414,38,38,0,1,0
31,419,419,67,67,0,1,0
7,420,420,2,2,0,1,0
35,428,428,13,13,0,1,0
29,431,431,2,2,0,1,0
32,441,441,54,48,6,3,2
0,446,446,2,2,0,1,0
20,449,449,33,33,0,1,0
26,469,469,34,34,0,1,0
19,469,469,53,8,45,3,2
14,477,477,167,167,0,1,0
40,481,481,162,162,0,1,0
24,483,483,23,20,3,2,1
13,483,483,12,8,4,2,1
18,494,494,71,71,0,1,0

37,102,102,11,11,0,1,0
15,117,117,1,1,0,1,0
24,118,118,5,5,0,1,0
31,125,125,2,2,0,1,0
40,125,125,4,4,0,1,0
6,133,133,5,2,3,2,1
38,137,137,1,1,0,1,0
27,141,141,54,54,0,1,0
32,145,145,7,7,0,1,0
0,152,152,18,18,0,1,0
11,183,183,3,3,0,1,0
35,203,203,4,4,0,1,0
28,212,212,24,24,0,1,0
12,214,214,59,31,28,2,1
30,216,216,5,5,0,1,0
1,228,228,39,9,30,4,3
18,246,246,56,37,19,2,1
19,254,254,22,22,0,1,0
9,263,263,9,9,0,1,0
4,280,280,15,15,0,1,0
8,302,302,21,21,0,1,0
17,319,319,67,67,0,1,0
21,323,323,6,2,4,2,1
13,334,334,16,16,0,1,0
2,335,335,12,12,0,1,0
22,359,359,6,3,3,2,1
41,376,376,54,30,24,4,3
10,389,389,19,19,0,1,0
20,393,393,22,16,6,2,1
25,399,399,36,5,31,2,1
5,405,405,13,13,0,1,0
39,425,425,13,8,5,2,1
36,430,430,28,8,20,3,2
26,455,455,25,10,15,2,1
33,465,465,130,97,33,4,3
14,474,474,63,63,0,1,0
23,476,476,37,37,0,1,0
16,476,476,67,49,18,2,1
3,480,480,1,1,0,1,0
7,481,481,29,29,0,1,0
29,486,486,101,83,18,2,1
34,492,492,101,65,36,4,3

22,101,101,4,1,3,2,1
29,102,102,5,2,3,2,1
28,106,106,8,1,7,2,1
1,108,108,26,26,0,1,0
10,126,126,1,1,0,1,0
5,140,140,7,7,0,1,0
3,145,145,47,17,30,2,1
16,157,157,2,2,0,1,0
18,162,162,57,57,0,1,0
12,179,179,13,2,11,2,1
9,181,181,11,2,9,2,1
26,202,202,43,7,36,4,3
6,234,234,44,44,0,1,0
19,286,286,41,5,36,4,3
17,291,291,105,49,56,3,2
24,304,304,44,26,18,4,3
23,305,305,3,3,0,1,0
11,309,309,46,18,28,3,2
14,310,310,30,30,0,1,0
0,314,314,15,3,12,4,3
7,329,329,57,57,0,1,0
25,337,337,30,30,0,1,0
27,340,340,18,18,0,1,0
21,361,361,4,4,0,1,0
15,364,364,7,7,0,1,0
4,403,403,133,71,62,3,2
31,413,413,7,4,3,2,1
20,415,415,37,37,0,1,0
30,417,417,27,27,0,1,0
8,459,459,117,101,16,3,2
2,466,466,1,1,0,1,0
13,488,488,45,45,0,1,0

7,102,102,34,34,0,1,0
34,104,104,11,11,0,1,0
32,157,157,30,30,0,1,0
27,180,180,26,26,0,1,0
1,181,181,5,2,3,2,1
24,184,184,4,4,0,1,0
8,202,202,17,3,14,3,2
21,214,214,12,12,0,1,0
19,236,236,5,5,0,1,0
31,252,252,39,39,0,1,0
4,268,268,27,27,0,1,0
14,280,280,13,13,0,1,0
15,319,319,84,84,0,1,0
28,329,329,3,3,0,1,0
29,330,330,3,3,0,1,0
3,331,331,48,27,21,4,3
10,331,331,17,2,15,2,1
13,342,342,22,22,0,1,0
5,343,343,15,7,8,2,1
17,344,344,53,53,0,1,0
22,357,357,116,116,0,1,0
25,357,357,38,38,0,1,0
11,365,365,54,4,50,2,1
33,373,373,5,5,0,1,0
30,376,376,53,33,20,2,1
18,378,378,27,5,22,3,2
9,396,396,64,32,32,3,2
0,397,397,18,15,3,2,1
23,399,399,35,10,25,2,1
2,407,407,41,13,28,2,1
12,429,429,105,105,0,1,0
6,437,437,18,11,7,2,1
16,437,437,60,5,55,3,2
26,440,440,71,71,0,1,0
20,496,496,12,12,0,1,0

36,109,109,1,1,0,1,0
20,129,129,14,14,0,1,0
4,132,132,1,1,0,1,0
12,141,141,2,2,0,1,0
40,149,149,24,24,0,1,0
14,151,151,1,1,0,1,0
9,152,152,1,1,0,1,0
29,162,162,25,25,0,1,0
0,167,167,8,8,0,1,0
35,181,181,12,3,9,4,3
34,181,181,34,21,13,2,1
8,186,186,18,18,0,1,0
31,191,191,13,5,8,3,2
28,195,195,14,14,0,1,0
13,199,199,8,8,0,1,0
10,208,208,35,9,26,4,3
38,214,214,9,3,6,2,1
25,218,218,5,2,3,2,1
18,245,245,4,1,3,2,1
26,250,250,13,13,0,1,0
5,252,252,15,5,10,2,1
32,267,267,70,70,0,1,0
24,270,270,24,24,0,1,0
11,277,277,80,80,0,1,0
30,279,279,2,2,0,1,0
7,315,315,35,7,28,3,2
21,318,318,15,7,8,3,2
6,381,381,11,11,0,1,0
27,385,385,89,71,18,2,1
19,388,388,3,3,0,1,0
2,401,401,32,32,0,1,0
39,406,406,20,20,0,1,0
3,426,426,26,26,0,1,0
16,428,428,56,30,26,2,1
15,440,440,47,47,0,1,0
22,440,440,161,11,150,4,3
33,454,454,131,131,0,1,0
41,480,480,73,43,30,4,3
37,483,483,12,6,6,2,1
23,488,488,2,2,0,1,0
1,490,490,19,1,18,4,3
17,497,497,31,14,17,2,1

1,104,104,1,1,0,1,0
9,145,145,1,1,0,1,0
3,146,146,1,1,0,1,0
14,158,158,44,44,0,1,0
24,165,165,11,11,0,1,0
2,172,172,30,30,0,1,0
36,178,178,14,2,12,2,1
11,192,192,14,4,10,3,2
19,216,216,33,33,0,1,0
34,244,244,6,1,5,2,1
13,248,248,1,1,0,1,0
4,250,250,43,43,0,1,0
29,262,262,12,12,0,1,0
7,265,265,15,15,0,1,0
27,267,267,48,48,0,1,0
25,278,278,4,4,0,1,0
8,281,281,49,15,34,3,2
10,320,320,148,148,0,1,0
20,326,326,13,8,5,2,1
12,333,333,29,21,8,3,2
23,338,338,7,7,0,1,0
26,340,340,133,133,0,1,0
22,349,349,1,1,0,1,0
32,375,375,1,1,0,1,0
0,384,384,49,49,0,1,0
30,385,385,50,24,26,3,2
6,400,400,15,15,0,1,0
33,400,400,62,62,0,1,0
17,407,407,2,2,0,1,0
16,410,410,47,10,37,2,1
21,437,437,76,76,0,1,0
35,440,440,15,3,12,2,1
18,460,460,17,17,0,1,0
28,461,461,165,42,123,4,3
5,469,469,30,30,0,1,0
31,471,471,9,9,0,1,0
15,484,484,23,9,14,3,2

18,101,101,1,1,0,1,0
23,103,103,14,14,0,1,0
6,127,127,34,34,0,1,0
26,130,130,8,8,0,1,0
10,132,132,5,5,0,1,0
35,138,138,14,14,0,1,0
3,145,145,3,3,0,1,0
33,171,171,24,24,0,1,0
29,174,174,6,6,0,1,0
28,195,195,9,9,0,1,0
0,198,198,1,1,0,1,0
4,200,200,9,9,0,1,0
36,213,213,1,1,0,1,0
32,227,227,21,21,0,1,0
22,229,229,7,1,6,2,1
11,236,236,54,14,40,3,2
8,239,239,15,3,12,3,2
25,240,240,47,29,18,4,3
9,255,255,7,7,0,1,0
21,266,266,21,21,0,1,0
19,273,273,93,93,0,1,0
31,283,283,15,15,0,1,0
30,307,307,61,61,0,1,0
13,320,320,33,13,20,3,2
17,334,334,37,37,0,1,0
5,335,335,13,13,0,1,0
14,345,345,105,85,20,3,2
12,354,354,31,19,12,2,1
7,358,358,42,16,26,2,1
1,375,375,13,1,12,3,2
34,377,377,82,82,0,1,0
24,381,381,20,20,0,1,0
15,401,401,1,1,0,1,0
16,447,447,157,114,43,2,1
2,480,480,27,5,22,3,2
27,498,498,34,34,0,1,0
20,499,499,36,6,30,3,2

2,110,110,7,1,6,2,1
7,120,120,14,2,12,4,3
28,121,121,30,30,0,1,0
22,124,124,18,14,4,2,1
36,125,125,3,3,0,1,0
30,144,144,26,26,0,1,0
1,144,144,1,1,0,1,0
16,164,164,1,1,0,1,0
19,166,166,1,1,0,1,0
18,183,183,2,2,0,1,0
3,189,189,7,3,4,2,1
8,199,199,3,3,0,1,0
0,215,215,7,7,0,1,0
40,224,224,23,23,0,1,0
31,229,229,24,24,0,1,0
34,233,233,4,4,0,1,0
38,238,238,21,3,18,3,2
35,258,258,26,23,3,2,1
20,258,258,3,3,0,1,0
12,268,268,17,12,5,2,1
26,271,271,26,26,0,1,0
23,277,277,5,5,0,1,0
13,306,306,15,15,0,1,0
9,323,323,3,3,0,1,0
11,324,324,66,48,18,4,3
24,341,341,94,45,49,3,2
37,354,354,16,16,0,1,0
39,364,364,19,19,0,1,0
33,374,374,43,17,26,2,1
42,395,395,57,27,30,3,2
41,401,401,34,24,10,3,2
43,410,410,59,44,15,4,3
25,436,436,12,6,6,2,1
21,437,437,53,53,0,1,0
4,440,440,154,69,85,4,3
10,440,440,13,7,6,3,2
29,443,443,2,2,0,1,0
5,444,444,67,67,0,1,0
27,455,455,128,31,97,4,3
44,456,456,11,11,0,1,0
17,471,471,11,11,0,1,0
15,475,475,1,1,0,1,0
32,477,477,42,18,24,4,3
14,490,490,16,16,0,1,0
6,497,497,46,46,0,1,0

40,107,107,18,1,17,3,2
34,115,115,7,7,0,1,0
25,142,142,49,11,38,4,3
20,142,142,18,18,0,1,0
9,143,143,21,21,0,1,0
3,144,144,8,2,6,3,2
31,152,152,6,6,0,1,0
29,163,163,26,26,0,1,0
1,165,165,22,22,0,1,0
13,165,165,25,25,0,1,0
14,175,175,4,4,0,1,0
27,176,176,38,38,0,1,0
16,183,183,12,12,0,1,0
11,187,187,53,12,41,4,3
36,190,190,24,11,13,2,1
37,197,197,4,4,0,1,0
7,197,197,1,1,0,1,0
12,207,207,20,14,6,3,2
6,222,222,2,2,0,1,0
32,224,224,15,15,0,1,0
21,224,224,18,18,0,1,0
10,229,229,5,5,0,1,0
0,237,237,5,2,3,2,1
33,248,248,20,7,13,2,1
28,260,260,3,3,0,1,0
39,274,274,63,3,60,3,2
17,303,303,26,21,5,2,1
35,332,332,23,23,0,1,0
38,333,333,39,39,0,1,0
2,342,342,45,18,27,4,3
22,356,356,5,5,0,1,0
23,372,372,41,41,0,1,0
19,392,392,29,11,18,2,1
5,393,393,42,42,0,1,0
24,408,408,17,1,16,4,3
4,425,425,34,34,0,1,0
26,436,436,9,9,0,1,0
30,448,448,21,5,16,3,2
15,450,450,63,20,43,2,1
18,474,474,11,11,0,1,0
8,492,492,21,21,0,1,0

18,105,105,37,1,36,4,3
15,126,126,11,3,8,3,2
8,139,139,1,1,0,1,0
9,149,149,14,14,0,1,0
32,169,169,42,42,0,1,0
12,211,211,38,12,26,3,2
14,225,225,13,6,7,2,1
17,255,255,3,3,0,1,0
31,277,277,1,1,0,1,0
2,281,281,40,6,34,3,2
7,291,291,5,5,0,1,0
11,293,293,10,2,8,3,2
19,304,304,8,8,0,1,0
16,316,316,41,41,0,1,0
27,331,331,60,13,47,2,1
21,344,344,42,42,0,1,0
24,363,363,10,10,0,1,0
29,364,364,34,34,0,1,0
6,377,377,141,141,0,1,0
5,384,384,24,3,21,2,1
3,392,392,58,37,21,2,1
28,395,395,156,156,0,1,0
30,403,403,9,9,0,1,0
26,413,413,23,3,20,3,2
22,428,428,14,2,12,3,2
23,432,432,10,5,5,2,1
10,439,439,48,48,0,1,0
25,457,457,11,11,0,1,0
4,463,463,119,119,0,1,0
13,469,469,12,12,0,1,0
1,477,477,128,128,0,1,0
0,484,484,88,88,0,1,0
20,491,491,19,15,4,2,1

30,100,100,3,3,0,1,0
19,104,104,1,1,0,1,0
11,107,107,14,14,0,1,0
20,107,107,26,14,12,4,3
7,120,120,8,2,6,3,2
21,126,126,10,6,4,2,1
3,134,134,3,3,0,1,0
24,137,137,11,11,0,1,0
1,140,140,20,2,18,3,2
25,162,162,9,9,0,1,0
5,171,171,27,27,0,1,0
23,173,173,3,3,0,1,0
28,173,173,14,2,12,4,3
32,195,195,1,1,0,1,0
27,209,209,49,49,0,1,0
0,238,238,31,13,18,3,2
33,241,241,3,3,0,1,0
29,275,275,84,66,18,2,1
13,311,311,31,22,9,4,3
9,314,314,17,3,14,3,2
22,344,344,3,3,0,1,0
10,365,365,48,48,0,1,0
31,376,376,26,4,22,3,2
35,401,401,207,93,114,4,3
4,401,401,36,4,32,2,1
2,402,402,19,19,0,1,0
17,421,421,38,2,36,2,1
34,428,428,2,2,0,1,0
8,452,452,76,67,9,4,3
18,464,464,45,8,37,4,3
6,464,464,13,13,0,1,0
14,469,469,13,6,7,2,1
26,481,481,4,4,0,1,0
16,488,488,29,29,0,1,0
15,493,493,40,8,32,2,1
12,497,497,230,194,36,4,3

1,111,111,1,1,0,1,0
39,114,114,14,14,0,1,0
34,135,135,20,2,18,2,1
16,144,144,18,6,12,3,2
23,149,149,2,2,0,1,0
2,160,160,18,18,0,1,0
33,162,162,2,2,0,1,0
24,164,164,8,8,0,1,0
11,173,173,20,12,8,2,1
31,183,183,31,15,16,2,1
36,205,205,47,47,0,1,0
7,208,208,14,14,0,1,0
4,208,208,1,1,0,1,0
6,213,213,78,26,52,4,3
28,214,214,13,13,0,1,0
35,217,217,1,1,0,1,0
5,231,231,9,3,6,3,2
27,255,255,3,3,0,1,0
19,264,264,21,11,10,3,2
17,285,285,11,11,0,1,0
37,312,312,8,8,0,1,0
9,327,327,11,11,0,1,0
13,345,345,13,13,0,1,0
38,368,368,14,3,11,2,1
30,387,387,46,46,0,1,0
18,394,394,16,16,0,1,0
10,395,395,28,2,26,3,2
3,400,400,22,6,16,4,3
12,411,411,44,44,0,1,0
25,415,415,140,17,123,4,3
26,416,416,160,86,74,4,3
0,418,418,3,3,0,1,0
14,427,427,64,46,18,4,3
29,429,429,39,39,0,1,0
15,435,435,66,52,14,2,1
20,439,439,2,2,0,1,0
8,446,446,68,23,45,2,1
32,464,464,42,9,33,4,3
40,466,466,14,14,0,1,0
22,483,483,1,1,0,1,0
21,488,488,65,49,16,2,1

40,101,101,2,2,0,1,0
22,104,104,55,43,12,3,2
23,105,105,9,1,8,2,1
15,105,105,1,1,0,1,0
2,114,114,10,10,0,1,0
35,114,114,3,3,0,1,0
3,124,124,5,5,0,1,0
24,145,145,8,2,6,3,2
28,155,155,4,4,0,1,0
34,156,156,18,18,0,1,0
5,163,163,3,3,0,1,0
19,164,164,27,27,0,1,0
31,182,182,3,3,0,1,0
10,203,203,38,38,0,1,0
8,213,213,4,4,0,1,0
6,222,222,11,3,8,3,2
7,243,243,11,1,10,2,1
14,247,247,57,12,45,4,3
12,254,254,94,7,87,4,3
13,279,279,28,28,0,1,0
29,294,294,4,4,0,1,0
0,313,313,21,21,0,1,0
4,320,320,6,6,0,1,0
36,322,322,20,20,0,1,0
39,339,339,12,12,0,1,0
9,343,343,11,11,0,1,0
11,358,358,6,6,0,1,0
37,364,364,18,7,11,2,1
21,372,372,4,4,0,1,0
33,381,381,46,4,42,2,1
17,384,384,59,29,30,4,3
26,395,395,109,38,71,4,3
30,419,419,29,1,28,4,3
16,423,423,57,57,0,1,0
20,425,425,37,30,7,2,1
32,433,433,97,97,0,1,0
1,448,448,6,6,0,1,0
25,456,456,24,3,21,4,3
27,472,472,56,56,0,1,0
18,481,481,21,1,20,4,3
38,481,481,28,28,0,1,0

32,102,102,7,1,6,2,1
15,149,149,12,8,4,2,1
31,155,155,50,50,0,1,0
0,160,160,4,4,0,1,0
12,187,187,3,3,0,1,0
34,189,189,61,61,0,1,0
18,201,201,31,4,27,2,1
20,202,202,6,6,0,1,0
21,210,210,1,1,0,1,0
27,217,217,16,16,0,1,0
13,217,217,49,49,0,1,0
9,221,221,7,7,0,1,0
6,239,239,193,166,27,4,3
30,249,249,27,15,12,4,3
17,249,249,38,38,0,1,0
4,263,263,36,9,27,4,3
1,282,282,9,5,4,2,1
2,305,305,3,3,0,1,0
22,310,310,24,9,15,4,3
28,315,315,4,4,0,1,0
8,340,340,81,31,50,4,3
19,342,342,16,16,0,1,0
29,342,342,19,19,0,1,0
7,353,353,10,6,4,2,1
35,365,365,20,20,0,1,0
33,366,366,33,3,30,2,1
26,397,397,20,20,0,1,0
24,401,401,40,6,34,2,1
25,412,412,47,47,0,1,0
14,416,416,53,53,0,1,0
16,425,425,5,5,0,1,0
5,427,427,27,27,0,1,0
3,444,444,2,2,0,1,0
23,458,458,47,23,24,2,1
10,459,459,17,17,0,1,0
11,489,489,13,13,0,1,0

17,115,115,1,1,0,1,0
16,121,121,10,10,0,1,0
35,129,129,20,12,8,3,2
34,141,141,19,5,14,2,1
32,150,150,22,3,19,2,1
12,154,154,11,1,10,3,2
28,160,160,36,2,34,2,1
39,162,162,8,8,0,1,0
23,172,172,41,41,0,1,0
3,182,182,1,1,0,1,0
5,187,187,4,4,0,1,0
13,203,203,36,36,0,1,0
7,203,203,52,52,0,1,0
2,216,216,7,3,4,2,1
0,242,242,34,8,26,2,1
18,246,246,47,3,44,2,1
36,267,267,2,2,0,1,0
38,274,274,30,10,20,2,1
4,279,279,8,8,0,1,0
11,301,301,28,28,0,1,0
14,307,307,9,9,0,1,0
24,318,318,9,6,3,2,1
33,321,321,25,10,15,2,1
15,329,329,83,13,70,4,3
37,335,335,97,91,6,2,1
29,347,347,32,15,17,2,1
31,353,353,15,6,9,4,3
22,354,354,5,2,3,2,1
6,355,355,50,3,47,4,3
25,360,360,42,42,0,1,0
21,368,368,13,13,0,1,0
19,392,392,11,11,0,1,0
30,401,401,5,5,0,1,0
1,406,406,32,23,9,2,1
27,408,408,50,50,0,1,0
8,408,408,17,12,5,2,1
20,446,446,1,1,0,1,0
40,448,448,10,10,0,1,0
9,449,449,80,51,29,2,1
26,487,487,23,8,15,2,1
10,497,497,3,3,0,1,0

1,106,106,6,6,0,1,0
26,106,106,5,5,0,1,0
0,110,110,4,4,0,1,0
3,141,141,24,24,0,1,0
10,152,152,6,6,0,1,0
18,156,156,6,6,0,1,0
14,158,158,3,3,0,1,0
7,164,164,32,32,0,1,0
29,170,170,35,4,31,2,1
9,207,207,3,3,0,1,0
16,216,216,16,2,14,2,1
23,225,225,46,46,0,1,0
20,258,258,17,3,14,2,1
5,273,273,5,5,0,1,0
35,277,277,52,42,10,3,2
22,292,292,4,4,0,1,0
34,293,293,13,9,4,2,1
19,318,318,12,12,0,1,0
31,321,321,30,16,14,2,1
11,341,341,4,1,3,2,1
6,346,346,26,21,5,2,1
4,353,353,23,23,0,1,0
13,373,373,33,33,0,1,0
33,377,377,17,10,7,2,1
2,384,384,129,129,0,1,0
15,404,404,38,38,0,1,0
17,411,411,40,7,33,2,1
27,415,415,75,47,28,3,2
30,426,426,6,6,0,1,0
36,443,443,144,144,0,1,0
28,448,448,143,37,106,4,3
21,450,450,2,2,0,1,0
32,452,452,34,1,33,2,1
24,456,456,2,2,0,1,0
8,461,461,30,14,16,3,2
12,465,465,207,207,0,1,0
25,484,484,16,7,9,4,3

32,116,116,3,3,0,1,0
11,118,118,8,8,0,1,0
35,121,121,1,1,0,1,0
12,126,126,8,8,0,1,0
33,134,134,22,22,0,1,0
14,139,139,2,2,0,1,0
10,141,141,28,28,0,1,0
2,157,157,18,18,0,1,0
15,160,160,6,1,5,2,1
25,164,164,47,47,0,1,0
16,176,176,17,17,0,1,0
19,222,222,90,54,36,4,3
22,240,240,4,4,0,1,0
24,242,242,54,54,0,1,0
37,252,252,20,20,0,1,0
3,268,268,17,5,12,4,3
17,275,275,8,8,0,1,0
23,288,288,12,12,0,1,0
26,296,296,29,29,0,1,0
5,298,298,47,1,46,4,3
21,299,299,24,24,0,1,0
36,304,304,6,6,0,1,0
7,320,320,3,3,0,1,0
31,349,349,19,5,14,3,2
9,354,354,3,3,0,1,0
4,357,357,8,8,0,1,0
28,364,364,157,133,24,2,1
34,367,367,1,1,0,1,0
29,400,400,19,16,3,2,1
30,419,419,28,28,0,1,0
27,435,435,54,54,0,1,0
13,436,436,61,31,30,2,1
0,437,437,29,21,8,3,2
38,438,438,51,42,9,4,3
1,458,458,4,1,3,2,1
18,461,461,5,5,0,1,0
8,474,474,43,43,0,1,0
20,476,476,23,4,19,2,1
6,492,492,147,6,141,4,3

31,101,101,2,2,0,1,0
20,102,102,8,1,7,2,1
9,119,119,18,1,17,2,1
1,129,129,5,2,3,2,1
19,129,129,41,25,16,2,1
16,165,165,11,11,0,1,0
0,171,171,7,7,0,1,0
7,174,174,22,22,0,1,0
21,177,177,15,15,0,1,0
34,187,187,8,8,0,1,0
14,189,189,9,1,8,3,2
27,196,196,19,1,18,4,3
29,205,205,33,33,0,1,0
30,216,216,3,3,0,1,0
3,226,226,1,1,0,1,0
8,227,227,25,25,0,1,0
6,237,237,2,2,0,1,0
33,243,243,16,3,13,3,2
15,244,244,3,3,0,1,0
24,256,256,40,40,0,1,0
23,258,258,23,13,10,2,1
4,264,264,8,8,0,1,0
17,269,269,46,46,0,1,0
10,280,280,2,2,0,1,0
38,282,282,3,3,0,1,0
11,331,331,46,3,43,3,2
18,339,339,34,34,0,1,0
5,350,350,18,5,13,3,2
12,355,355,81,35,46,3,2
32,359,359,2,2,0,1,0
13,416,416,99,99,0,1,0
35,451,451,60,54,6,3,2
36,452,452,214,214,0,1,0
28,459,459,1,1,0,1,0
37,483,483,56,10,46,2,1
25,486,486,57,34,23,2,1
2,488,488,6,1,5,2,1
22,494,494,70,42,28,2,1
26,498,498,67,31,36,2,1

0,102,102,16,16,0,1,0
9,104,104,7,7,0,1,0
1,112,112,8,8,0,1,0
23,116,116,14,14,0,1,0
27,124,124,6,1,5,2,1
24,133,133,11,2,9,4,3
22,136,136,13,13,0,1,0
20,157,157,9,5,4,2,1
19,174,174,69,69,0,1,0
37,176,176,3,3,0,1,0
10,180,180,4,4,0,1,0
18,182,182,1,1,0,1,0
25,212,212,10,10,0,1,0
2,214,214,10,6,4,2,1
12,219,219,10,10,0,1,0
3,221,221,18,5,13,2,1
15,227,227,5,5,0,1,0
8,232,232,3,3,0,1,0
33,244,244,27,27,0,1,0
5,255,255,16,9,7,2,1
34,255,255,22,12,10,3,2
28,282,282,21,21,0,1,0
32,301,301,33,33,0,1,0
16,309,309,52,52,0,1,0
14,314,314,5,5,0,1,0
35,315,315,72,55,17,2,1
29,318,318,30,13,17,2,1
13,349,349,5,5,0,1,0
7,377,377,36,3,33,2,1
30,380,380,79,1,78,3,2
17,394,394,30,5,25,2,1
4,401,401,127,82,45,4,3
31,440,440,7,3,4,2,1
38,441,441,112,78,34,2,1
11,453,453,54,54,0,1,0
6,454,454,23,23,0,1,0
21,464,464,25,25,0,1,0
39,467,467,49,37,12,3,2
36,490,490,62,62,0,1,0
26,495,495,33,33,0,1,0

16,102,102,7,4,3,2,1
11,116,116,4,4,0,1,0
25,130,130,4,4,0,1,0
23,159,159,6,6,0,1,0
2,175,175,30,30,0,1,0
26,198,198,29,29,0,1,0
17,218,218,10,10,0,1,0
12,224,224,45,8,37,4,3
28,231,231,67,11,56,4,3
24,308,308,51,15,36,2,1
5,330,330,60,15,45,2,1
9,336,336,33,33,0,1,0
13,360,360,30,3,27,4,3
10,368,368,28,28,0,1,0
4,371,371,155,93,62,3,2
15,376,376,18,5,13,2,1
1,377,377,11,4,7,2,1
27,385,385,45,10,35,4,3
0,401,401,77,19,58,4,3
18,403,403,15,15,0,1,0
8,415,415,58,58,0,1,0
19,418,418,23,23,0,1,0
6,427,427,146,86,60,4,3
29,433,433,18,18,0,1,0
21,440,440,36,36,0,1,0
3,459,459,4,4,0,1,0
22,460,460,122,38,84,4,3
7,464,464,113,20,93,4,3
14,482,482,4,1,3,2,1
20,500,500,94,36,58,4,3

33,101,101,1,1,0,1,0
13,107,107,2,2,0,1,0
15,120,120,4,4,0,1,0
11,136,136,6,6,0,1,0
27,139,139,25,4,21,4,3
17,151,151,5,5,0,1,0
22,155,155,19,19,0,1,0
0,162,162,23,23,0,1,0
25,173,173,35,35,0,1,0
6,174,174,51,30,21,4,3
31,175,175,41,11,30,3,2
4,180,180,22,22,0,1,0
34,183,183,9,9,0,1,0
16,194,194,38,38,0,1,0
28,199,199,34,1,33,2,1
9,212,212,1,1,0,1,0
5,264,264,10,10,0,1,0
7,264,264,31,31,0,1,0
32,303,303,15,4,11,4,3
3,306,306,21,3,18,2,1
30,321,321,75,75,0,1,0
10,321,321,97,51,46,3,2
1,321,321,32,32,0,1,0
29,336,336,26,4,22,3,2
14,357,357,88,24,64,4,3
21,389,389,44,44,0,1,0
18,393,393,2,2,0,1,0
19,400,400,39,35,4,2,1
8,400,400,62,42,20,2,1
20,407,407,34,34,0,1,0
23,437,437,77,77,0,1,0
35,445,445,29,6,23,3,2
26,475,475,5,5,0,1,0
2,475,475,6,6,0,1,0
12,476,476,4,1,3,2,1
24,495,495,14,14,0,1,0

22,108,108,1,1,0,1,0
13,110,110,3,3,0,1,0
17,111,111,1,1,0,1,0
6,112,112,1,1,0,1,0
37,114,114,14,9,5,2,1
1,118,118,2,2,0,1,0
23,148,148,6,6,0,1,0
43,157,157,11,11,0,1,0
40,160,160,4,4,0,1,0
5,162,162,1,1,0,1,0
8,170,170,13,10,3,2,1
44,175,175,81,62,19,2,1
20,177,177,8,8,0,1,0
4,189,189,13,13,0,1,0
26,203,203,15,15,0,1,0
12,206,206,61,39,22,2,1
14,250,250,18,11,7,2,1
18,255,255,5,5,0,1,0
11,255,255,5,5,0,1,0
24,265,265,12,12,0,1,0
29,270,270,7,7,0,1,0
35,279,279,107,69,38,3,2
34,309,309,6,6,0,1,0
41,311,311,41,25,16,3,2
16,335,335,5,5,0,1,0
31,339,339,32,32,0,1,0
38,342,342,20,5,15,2,1
32,343,343,5,5,0,1,0
25,354,354,26,1,25,2,1
2,365,365,48,24,24,4,3
36,370,370,27,27,0,1,0
9,374,374,21,12,9,4,3
27,384,384,68,27,41,2,1
21,385,385,2,2,0,1,0
28,413,413,4,4,0,1,0
42,423,423,13,3,10,2,1
10,441,441,175,149,26,3,2
19,443,443,67,34,33,4,3
33,451,451,30,19,11,2,1
3,465,465,32,32,0,1,0
0,468,468,47,47,0,1,0
7,471,471,13,5,8,2,1
39,479,479,4,4,0,1,0
30,490,490,44,44,0,1,0
15,493,493,56,8,48,2,1

42,106,106,18,3,15,4,3
24,114,114,4,4,0,1,0
17,119,119,33,33,0,1,0
19,123,123,1,1,0,1,0
34,144,144,21,1,20,2,1
4,147,147,3,3,0,1,0
38,150,150,21,21,0,1,0
16,180,180,7,1,6,3,2
18,192,192,67,43,24,4,3
39,202,202,7,1,6,3,2
7,206,206,19,16,3,2,1
28,216,216,18,18,0,1,0
22,220,220,1,1,0,1,0
41,245,245,3,3,0,1,0
12,253,253,1,1,0,1,0
37,253,253,54,54,0,1,0
14,257,257,6,6,0,1,0
20,260,260,16,9,7,2,1
35,262,262,26,26,0,1,0
43,263,263,112,72,40,4,3
13,269,269,21,21,0,1,0
32,270,270,20,14,6,3,2
27,286,286,42,24,18,3,2
5,288,288,27,27,0,1,0
29,296,296,32,32,0,1,0
33,300,300,11,1,10,2,1
15,301,301,51,51,0,1,0
31,314,314,3,3,0,1,0
40,324,324,15,15,0,1,0
3,332,332,57,7,50,3,2
6,334,334,1,1,0,1,0
0,335,335,48,48,0,1,0
21,390,390,42,42,0,1,0
1,396,396,20,2,18,2,1
8,407,407,26,26,0,1,0
23,418,418,4,4,0,1,0
2,459,459,2,2,0,1,0
36,459,459,41,41,0,1,0
10,461,461,2,2,0,1,0
25,462,462,30,20,10,2,1
26,468,468,12,4,8,3,2
11,493,493,2,2,0,1,0
9,494,494,41,2,39,4,3
30,499,499,7,7,0,1,0

25,128,128,10,10,0,1,0
27,157,157,15,11,4,2,1
13,176,176,8,5,3,2,1
3,193,193,17,17,0,1,0
8,216,216,14,14,0,1,0
2,256,256,3,3,0,1,0
15,262,262,6,6,0,1,0
4,267,267,11,2,9,2,1
0,271,271,43,43,0,1,0
11,271,271,55,28,27,4,3
10,294,294,97,97,0,1,0
17,299,299,15,2,13,2,1
28,301,301,89,75,14,3,2
7,307,307,180,180,0,1,0
12,313,313,19,19,0,1,0
24,319,319,13,4,9,3,2
9,328,328,61,61,0,1,0
5,337,337,149,49,100,4,3
20,343,343,42,32,10,2,1
26,369,369,40,40,0,1,0
22,381,381,32,32,0,1,0
23,391,391,1,1,0,1,0
1,398,398,1,1,0,1,0
19,403,403,41,13,28,2,1
14,407,407,29,14,15,4,3
18,424,424,50,2,48,3,2
21,435,435,8,5,3,2,1
6,451,451,144,3,141,4,3
16,478,478,42,8,34,2,1

19,112,112,3,3,0,1,0
24,121,121,26,26,0,1,0
21,130,130,37,8,29,2,1
0,133,133,6,6,0,1,0
16,143,143,10,10,0,1,0
31,146,146,6,6,0,1,0
1,160,160,15,15,0,1,0
35,175,175,26,26,0,1,0
25,203,203,30,10,20,2,1
3,225,225,12,12,0,1,0
32,229,229,96,14,82,3,2
36,231,231,4,4,0,1,0
28,251,251,1,1,0,1,0
6,261,261,5,1,4,2,1
4,269,269,33,18,15,4,3
5,291,291,39,21,18,2,1
23,297,297,27,27,0,1,0
10,304,304,3,3,0,1,0
12,304,304,99,99,0,1,0
9,307,307,22,18,4,2,1
20,313,313,14,14,0,1,0
37,328,328,3,3,0,1,0
2,349,349,7,1,6,3,2
15,355,355,58,58,0,1,0
7,368,368,7,7,0,1,0
30,384,384,100,100,0,1,0
33,388,388,23,23,0,1,0
8,397,397,53,10,43,2,1
18,413,413,39,39,0,1,0
17,415,415,70,70,0,1,0
22,418,418,21,21,0,1,0
34,445,445,15,3,12,2,1
11,447,447,5,5,0,1,0
29,462,462,21,21,0,1,0
26,462,462,10,10,0,1,0
14,477,477,135,135,0,1,0
27,484,484,10,10,0,1,0
13,496,496,31,31,0,1,0

21,107,107,22,22,0,1,0
39,116,116,1,1,0,1,0
2,149,149,11,1,10,3,2
4,150,150,25,10,15,2,1
17,172,172,25,5,20,3,2
8,176,176,5,5,0,1,0
22,178,178,6,6,0,1,0
11,181,181,34,34,0,1,0
5,181,181,15,15,0,1,0
32,184,184,8,8,0,1,0
29,185,185,3,3,0,1,0
14,186,186,32,32,0,1,0
25,203,203,1,1,0,1,0
36,210,210,67,67,0,1,0
18,214,214,4,4,0,1,0
13,217,217,28,28,0,1,0
9,230,230,1,1,0,1,0
40,248,248,18,18,0,1,0
31,258,258,3,3,0,1,0
33,260,260,12,6,6,3,2
10,283,283,46,10,36,2,1
16,284,284,12,12,0,1,0
26,303,303,29,1,28,2,1
12,313,313,21,21,0,1,0
35,322,322,2,2,0,1,0
3,334,334,11,6,5,2,1
38,357,357,11,5,6,2,1
19,363,363,1,1,0,1,0
37,381,381,293,191,102,4,3
24,394,394,50,6,44,2,1
41,395,395,27,9,18,3,2
15,403,403,9,3,6,2,1
28,408,408,29,9,20,3,2
27,415,415,6,6,0,1,0
23,417,417,54,43,11,2,1
34,443,443,44,4,40,4,3
30,467,467,1,1,0,1,0
1,472,472,43,21,22,3,2
6,474,474,23,7,16,3,2
7,475,475,3,3,0,1,0
20,476,476,7,7,0,1,0
0,483,483,78,78,0,1,0

22,107,107,2,2,0,1,0
26,108,108,3,3,0,1,0
17,117,117,17,17,0,1,0
19,118,118,9,9,0,1,0
4,126,126,8,8,0,1,0
20,127,127,3,3,0,1,0
11,130,130,2,2,0,1,0
10,163,163,11,1,10,3,2
0,166,166,1,1,0,1,0
18,166,166,14,2,12,4,3
12,170,170,3,3,0,1,0
35,172,172,35,35,0,1,0
3,177,177,21,1,20,2,1
28,193,193,11,11,0,1,0
9,199,199,48,15,33,4,3
5,209,209,30,30,0,1,0
23,222,222,20,20,0,1,0
25,227,227,9,9,0,1,0
2,240,240,111,48,63,4,3
15,241,241,4,4,0,1,0
29,248,248,23,23,0,1,0
24,283,283,30,30,0,1,0
33,292,292,22,22,0,1,0
34,298,298,3,3,0,1,0
21,299,299,23,23,0,1,0
13,333,333,39,39,0,1,0
8,339,339,57,33,24,4,3
37,346,346,66,50,16,2,1
1,355,355,11,11,0,1,0
6,359,359,6,6,0,1,0
32,373,373,30,30,0,1,0
36,379,379,141,141,0,1,0
27,398,398,21,21,0,1,0
16,427,427,8,4,4,2,1
7,461,461,65,29,36,3,2
30,461,461,119,119,0,1,0
31,475,475,40,40,0,1,0
14,476,476,13,5,8,3,2

20,138,138,37,30,7,2,1
4,151,151,21,21,0,1,0
26,153,153,15,15,0,1,0
19,154,154,27,18,9,2,1
12,156,156,4,4,0,1,0
1,159,159,1,1,0,1,0
5,187,187,61,58,3,2,1
11,187,187,49,49,0,1,0
29,202,202,21,21,0,1,0
9,220,220,19,7,12,3,2
32,241,241,20,20,0,1,0
2,249,249,24,6,18,4,3
0,250,250,39,39,0,1,0
27,261,261,9,6,3,2,1
7,279,279,8,8,0,1,0
23,296,296,19,6,13,2,1
3,304,304,12,5,7,2,1
14,313,313,51,10,41,3,2
35,334,334,10,3,7,2,1
33,337,337,27,9,18,4,3
22,340,340,24,18,6,3,2
6,349,349,9,4,5,2,1
36,381,381,53,19,34,3,2
30,383,383,7,7,0,1,0
16,385,385,98,10,88,3,2
10,400,400,32,9,23,2,1
25,409,409,35,35,0,1,0
15,409,409,13,13,0,1,0
24,410,410,74,48,26,2,1
31,417,417,55,9,46,3,2
13,421,421,31,31,0,1,0
18,422,422,14,14,0,1,0
8,425,425,35,8,27,4,3
34,456,456,41,29,12,2,1
28,463,463,53,53,0,1,0
17,470,470,11,11,0,1,0
21,492,492,67,28,39,2,1

3,100,100,6,6,0,1,0
11,104,104,10,10,0,1,0
5,110,110,1,1,0,1,0
31,111,111,3,3,0,1,0
35,114,114,1,1,0,1,0
27,114,114,21,21,0,1,0
36,135,135,9,1,8,2,1
0,176,176,4,1,3,2,1
26,183,183,38,38,0,1,0
20,187,187,10,4,6,3,2
12,215,215,44,4,40,3,2
6,235,235,27,20,7,2,1
15,259,259,8,8,0,1,0
13,264,264,12,12,0,1,0
33,264,264,15,4,11,2,1
7,286,286,61,34,27,2,1
22,298,298,3,3,0,1,0
19,304,304,3,3,0,1,0
10,307,307,104,89,15,4,3
9,312,312,1,1,0,1,0
2,331,331,79,4,75,4,3
37,351,351,16,2,14,2,1
21,351,351,49,49,0,1,0
30,359,359,5,1,4,2,1
8,388,388,6,6,0,1,0
4,395,395,34,26,8,3,2
25,423,423,12,12,0,1,0
24,425,425,53,13,40,4,3
1,430,430,16,7,9,4,3
34,431,431,40,16,24,4,3
32,447,447,138,93,45,2,1
16,459,459,107,45,62,3,2
18,475,475,36,36,0,1,0
29,481,481,141,9,132,4,3
17,489,489,8,3,5,2,1
14,492,492,29,17,12,3,2
23,497,497,116,116,0,1,0
28,500,500,22,16,6,3,2

25,101,101,5,5,0,1,0
11,102,102,1,1,0,1,0
28,115,115,15,2,13,2,1
7,142,142,2,2,0,1,0
22,144,144,4,4,0,1,0
2,145,145,27,9,18,2,1
13,151,151,17,1,16,3,2
35,155,155,34,34,0,1,0
8,169,169,28,28,0,1,0
33,171,171,5,5,0,1,0
0,188,188,2,2,0,1,0
3,197,197,5,5,0,1,0
39,198,198,64,43,21,4,3
20,203,203,12,7,5,2,1
5,210,210,12,12,0,1,0
1,229,229,25,25,0,1,0
30,245,245,13,13,0,1,0
15,263,263,41,6,35,2,1
18,266,266,1,1,0,1,0
17,276,276,9,9,0,1,0
23,276,276,27,6,21,2,1
31,289,289,8,8,0,1,0
29,294,294,23,23,0,1,0
6,304,304,17,5,12,4,3
16,334,334,64,13,51,4,3
41,341,341,36,8,28,3,2
32,365,365,4,4,0,1,0
36,395,395,36,36,0,1,0
21,395,395,32,2,30,2,1
37,404,404,7,7,0,1,0
12,404,404,49,49,0,1,0
19,408,408,13,7,6,3,2
24,411,411,121,67,54,3,2
40,419,419,21,21,0,1,0
34,428,428,65,33,32,3,2
27,445,445,33,33,0,1,0
4,448,448,14,14,0,1,0
26,449,449,23,23,0,1,0
14,459,459,31,31,0,1,0
38,469,469,43,13,30,3,2
9,481,481,139,139,0,1,0
10,500,500,31,31,0,1,0

13,106,106,1,1,0,1,0
2,107,107,28,28,0,1,0
28,114,114,12,9,3,2,1
1,115,115,3,3,0,1,0
17,115,115,11,11,0,1,0
19,116,116,4,4,0,1,0
34,116,116,17,17,0,1,0
23,119,119,34,12,22,2,1
20,135,135,26,26,0,1,0
4,138,138,7,7,0,1,0
6,158,158,11,7,4,2,1
37,161,161,27,27,0,1,0
35,162,162,3,3,0,1,0
14,171,171,5,5,0,1,0
42,175,175,5,5,0,1,0
21,184,184,34,34,0,1,0
24,189,189,4,4,0,1,0
39,222,222,7,4,3,2,1
26,246,246,21,21,0,1,0
7,264,264,1,1,0,1,0
32,265,265,76,64,12,4,3
38,265,265,27,9,18,4,3
30,282,282,7,7,0,1,0
0,290,290,41,8,33,4,3
36,294,294,32,32,0,1,0
11,301,301,10,10,0,1,0
3,319,319,33,6,27,3,2
25,328,328,46,28,18,2,1
31,330,330,10,10,0,1,0
12,361,361,24,24,0,1,0
5,374,374,1,1,0,1,0
18,388,388,50,50,0,1,0
41,393,393,70,49,21,2,1
40,413,413,91,28,63,4,3
27,418,418,80,80,0,1,0
33,418,418,4,1,3,2,1
8,424,424,18,18,0,1,0
22,426,426,1,1,0,1,0
15,431,431,30,30,0,1,0
10,440,440,7,7,0,1,0
29,462,462,18,4,14,3,2
16,465,465,22,15,7,2,1
9,500,500,3,3,0,1,0

32,105,105,26,26,0,1,0
13,106,106,1,1,0,1,0
25,108,108,2,2,0,1,0
6,135,135,11,3,8,2,1
26,135,135,23,15,8,2,1
2,153,153,16,8,8,3,2
18,157,157,2,2,0,1,0
39,165,165,14,5,9,4,3
23,167,167,13,13,0,1,0
35,172,172,17,17,0,1,0
17,176,176,17,11,6,3,2
12,180,180,12,12,0,1,0
27,182,182,14,11,3,2,1
36,194,194,20,20,0,1,0
31,202,202,7,1,6,2,1
1,215,215,10,10,0,1,0
34,225,225,12,12,0,1,0
14,225,225,3,3,0,1,0
37,227,227,57,18,39,3,2
0,254,254,25,25,0,1,0
38,265,265,19,2,17,4,3
5,278,278,54,6,48,2,1
33,294,294,7,3,4,2,1
15,310,310,11,11,0,1,0
22,317,317,34,8,26,3,2
24,331,331,115,49,66,4,3
19,334,334,42,42,0,1,0
28,342,342,25,25,0,1,0
3,355,355,66,48,18,4,3
11,392,392,59,9,50,2,1
9,404,404,11,5,6,2,1
7,438,438,25,21,4,2,1
4,454,454,8,2,6,2,1
16,464,464,67,67,0,1,0
20,465,465,146,140,6,3,2
30,469,469,8,8,0,1,0
8,479,479,45,45,0,1,0
10,481,481,12,2,10,2,1
21,484,484,30,18,12,3,2
29,497,497,12,12,0,1,0

31,101,101,1,1,0,1,0
19,107,107,51,5,46,3,2
9,115,115,12,12,0,1,0
22,117,117,2,2,0,1,0
13,120,120,9,9,0,1,0
11,128,128,1,1,0,1,0
25,132,132,47,17,30,4,3
34,146,146,2,2,0,1,0
18,157,157,18,18,0,1,0
40,162,162,5,5,0,1,0
21,190,190,13,13,0,1,0
36,226,226,2,2,0,1,0
28,229,229,27,12,15,2,1
3,251,251,23,3,20,3,2
39,257,257,6,6,0,1,0
26,297,297,12,12,0,1,0
35,299,299,7,7,0,1,0
23,311,311,65,65,0,1,0
1,328,328,1,1,0,1,0
10,330,330,61,7,54,4,3
20,339,339,3,3,0,1,0
33,346,346,19,4,15,4,3
30,346,346,52,20,32,2,1
37,352,352,93,36,57,4,3
0,361,361,52,52,0,1,0
14,363,363,1,1,0,1,0
2,385,385,20,3,17,2,1
27,390,390,100,100,0,1,0
7,392,392,1,1,0,1,0
8,399,399,47,47,0,1,0
24,402,402,16,6,10,3,2
15,402,402,14,14,0,1,0
5,425,425,111,11,100,3,2
41,440,440,23,23,0,1,0
12,444,444,8,8,0,1,0
4,451,451,23,4,19,2,1
38,474,474,68,37,31,2,1
16,490,490,5,5,0,1,0
6,492,492,9,9,0,1,0
29,497,497,44,44,0,1,0
17,497,497,19,19,0,1,0
32,499,499,28,28,0,1,0

1,103,103,34,22,12,4,3
26,114,114,13,5,8,2,1
10,125,125,12,12,0,1,0
23,134,134,14,14,0,1,0
19,158,158,28,12,16,3,2
4,160,160,5,5,0,1,0
16,160,160,14,4,10,2,1
18,168,168,57,6,51,4,3
0,169,169,92,26,66,3,2
20,170,170,3,3,0,1,0
30,176,176,5,5,0,1,0
15,212,212,1,1,0,1,0
12,216,216,56,56,0,1,0
14,239,239,45,45,0,1,0
8,296,296,4,1,3,2,1
6,310,310,9,9,0,1,0
13,319,319,14,14,0,1,0
17,321,321,13,10,3,2,1
24,348,348,67,67,0,1,0
21,382,382,29,29,0,1,0
3,387,387,101,51,50,2,1
22,395,395,36,2,34,3,2
29,406,406,26,26,0,1,0
25,416,416,26,13,13,3,2
9,421,421,31,2,29,2,1
27,436,436,9,9,0,1,0
28,447,447,13,13,0,1,0
5,449,449,24,24,0,1,0
2,461,461,156,156,0,1,0
7,474,474,24,3,21,2,1
11,482,482,38,38,0,1,0

32,115,115,15,15,0,1,0
2,116,116,6,6,0,1,0
21,119,119,5,5,0,1,0
22,120,120,9,1,8,2,1
14,132,132,4,4,0,1,0
26,169,169,10,2,8,2,1
36,182,182,20,20,0,1,0
16,202,202,8,8,0,1,0
7,229,229,23,23,0,1,0
35,229,229,21,16,5,2,1
33,233,233,63,63,0,1,0
17,260,260,21,10,11,2,1
34,260,260,20,20,0,1,0
39,268,268,6,1,5,2,1
11,277,277,49,49,0,1,0
0,289,289,9,1,8,3,2
5,301,301,57,57,0,1,0
38,308,308,19,3,16,3,2
10,321,321,20,20,0,1,0
23,340,340,68,58,10,3,2
27,359,359,54,54,0,1,0
4,359,359,48,21,27,2,1
15,364,364,47,47,0,1,0
6,377,377,15,5,10,3,2
20,382,382,60,60,0,1,0
28,384,384,53,53,0,1,0
25,386,386,81,81,0,1,0
3,389,389,36,36,0,1,0
30,402,402,10,10,0,1,0
12,423,423,19,13,6,3,2
19,423,423,21,21,0,1,0
29,428,428,38,8,30,3,2
31,428,428,49,45,4,2,1
37,450,450,2,2,0,1,0
8,463,463,15,15,0,1,0
9,463,463,66,55,11,2,1
13,465,465,14,7,7,2,1
18,476,476,70,70,0,1,0
24,484,484,32,32,0,1,0
1,492,492,69,42,27,4,3

17,104,104,15,15,0,1,0
14,119,119,8,1,7,2,1
23,133,133,10,4,6,3,2
1,135,135,16,2,14,2,1
36,135,135,9,9,0,1,0
35,137,137,3,3,0,1,0
33,139,139,1,1,0,1,0
22,173,173,5,5,0,1,0
9,182,182,23,7,16,3,2
29,183,183,1,1,0,1,0
31,192,192,71,41,30,4,3
8,197,197,5,5,0,1,0
39,202,202,48,48,0,1,0
30,205,205,29,1,28,4,3
13,209,209,43,43,0,1,0
32,218,218,10,4,6,2,1
38,221,221,9,9,0,1,0
26,254,254,8,5,3,2,1
0,262,262,1,1,0,1,0
34,269,269,7,7,0,1,0
5,271,271,6,1,5,2,1
21,271,271,52,52,0,1,0
20,283,283,7,4,3,2,1
18,284,284,30,30,0,1,0
16,294,294,42,42,0,1,0
7,300,300,40,1,39,2,1
12,305,305,44,44,0,1,0
11,313,313,2,2,0,1,0
6,338,338,33,33,0,1,0
4,339,339,109,87,22,3,2
3,357,357,2,2,0,1,0
28,364,364,41,41,0,1,0
27,384,384,69,54,15,2,1
37,410,410,63,36,27,4,3
19,419,419,13,1,12,4,3
2,437,437,22,22,0,1,0
24,444,444,50,50,0,1,0
10,451,451,56,7,49,2,1
25,459,459,43,40,3,2,1
15,480,480,1,1,0,1,0

37,111,111,19,19,0,1,0
22,111,111,7,7,0,1,0
2,130,130,21,7,14,2,1
27,135,135,11,11,0,1,0
18,139,139,18,18,0,1,0
24,152,152,21,21,0,1,0
13,162,162,43,19,24,2,1
39,185,185,1,1,0,1,0
29,208,208,8,2,6,2,1
43,218,218,26,23,3,2,1
19,219,219,3,3,0,1,0
12,221,221,1,1,0,1,0
35,225,225,29,29,0,1,0
42,233,233,29,29,0,1,0
8,244,244,7,7,0,1,0
11,244,244,17,3,14,2,1
41,264,264,31,11,20,2,1
38,269,269,42,42,0,1,0
40,274,274,13,3,10,3,2
32,275,275,62,17,45,3,2
10,283,283,5,5,0,1,0
1,295,295,20,20,0,1,0
16,298,298,45,24,21,2,1
14,309,309,21,5,16,2,1
25,317,317,26,12,14,3,2
3,321,321,6,3,3,2,1
15,324,324,1,1,0,1,0
26,329,329,1,1,0,1,0
4,337,337,15,11,4,2,1
5,356,356,2,2,0,1,0
31,365,365,86,86,0,1,0
6,365,365,124,73,51,3,2
36,392,392,66,66,0,1,0
17,416,416,9,9,0,1,0
7,419,419,57,7,50,3,2
33,425,425,23,23,0,1,0
28,427,427,13,3,10,2,1
34,435,435,21,21,0,1,0
21,441,441,22,22,0,1,0
23,443,443,23,23,0,1,0
20,465,465,4,4,0,1,0
30,480,480,52,52,0,1,0
0,491,491,5,1,4,2,1
9,500,500,16,16,0,1,0

19,132,132,12,12,0,1,0
34,150,150,25,13,12,2,1
23,153,153,21,5,16,3,2
26,160,160,3,3,0,1,0
31,162,162,14,14,0,1,0
7,163,163,16,10,6,3,2
32,163,163,1,1,0,1,0
9,182,182,17,8,9,4,3
36,184,184,4,4,0,1,0
30,192,192,17,5,12,2,1
37,196,196,1,1,0,1,0
14,205,205,43,43,0,1,0
24,205,205,74,45,29,2,1
29,248,248,9,4,5,2,1
2,260,260,22,9,13,2,1
35,267,267,54,4,50,2,1
4,283,283,2,2,0,1,0
27,289,289,5,2,3,2,1
17,296,296,47,14,33,2,1
18,297,297,87,41,46,2,1
15,302,302,1,1,0,1,0
6,311,311,34,34,0,1,0
20,314,314,38,38,0,1,0
39,321,321,1,1,0,1,0
8,335,335,9,9,0,1,0
13,338,338,7,1,6,3,2
33,347,347,61,41,20,4,3
22,350,350,64,42,22,2,1
3,357,357,54,17,37,2,1
25,359,359,12,5,7,2,1
11,370,370,1,1,0,1,0
12,380,380,41,29,12,2,1
5,384,384,27,5,22,3,2
1,408,408,10,1,9,2,1
10,436,436,28,28,0,1,0
16,444,444,28,28,0,1,0
38,457,457,42,34,8,3,2
28,480,480,137,137,0,1,0
40,483,483,11,11,0,1,0
21,486,486,13,13,0,1,0
0,495,495,36,36,0,1,0

21,107,107,23,23,0,1,0
10,114,114,1,1,0,1,0
23,120,120,16,16,0,1,0
42,131,131,45,45,0,1,0
39,144,144,4,4,0,1,0
4,156,156,23,23,0,1,0
11,159,159,3,3,0,1,0
24,166,166,4,4,0,1,0
32,174,174,5,5,0,1,0
19,186,186,1,1,0,1,0
8,196,196,7,7,0,1,0
20,201,201,21,18,3,2,1
2,222,222,34,34,0,1,0
5,244,244,10,10,0,1,0
40,247,247,9,2,7,2,1
36,254,254,25,4,21,2,1
0,263,263,19,19,0,1,0
14,279,279,16,16,0,1,0
27,282,282,6,6,0,1,0
17,304,304,18,6,12,4,3
7,304,304,8,2,6,3,2
22,307,307,6,2,4,2,1
18,308,308,7,7,0,1,0
28,320,320,82,34,48,3,2
41,327,327,6,6,0,1,0
31,343,343,171,150,21,4,3
38,350,350,78,78,0,1,0
33,353,353,5,5,0,1,0
35,361,361,8,1,7,2,1
37,379,379,11,1,10,2,1
9,384,384,52,52,0,1,0
13,385,385,65,50,15,2,1
16,387,387,23,23,0,1,0
6,421,421,15,15,0,1,0
15,423,423,80,71,9,4,3
29,424,424,21,15,6,3,2
12,429,429,23,23,0,1,0
3,433,433,47,47,0,1,0
26,451,451,29,1,28,2,1
1,454,454,16,2,14,3,2
25,458,458,34,34,0,1,0
34,481,481,14,14,0,1,0
30,500,500,41,41,0,1,0

4,139,139,3,3,0,1,0
8,143,143,1,1,0,1,0
23,148,148,5,5,0,1,0
20,154,154,5,5,0,1,0
35,156,156,6,3,3,2,1
27,160,160,20,20,0,1,0
7,160,160,7,7,0,1,0
13,179,179,3,3,0,1,0
6,189,189,4,4,0,1,0
16,190,190,10,10,0,1,0
26,204,204,3,3,0,1,0
31,205,205,8,8,0,1,0
10,207,207,6,1,5,2,1
43,212,212,19,7,12,4,3
24,234,234,3,3,0,1,0
36,235,235,31,16,15,4,3
41,236,236,1,1,0,1,0
29,244,244,7,7,0,1,0
30,293,293,36,25,11,2,1
3,295,295,5,5,0,1,0
40,305,305,1,1,0,1,0
17,307,307,2,2,0,1,0
15,309,309,31,19,12,3,2
18,317,317,1,1,0,1,0
45,322,322,29,29,0,1,0
11,323,323,38,11,27,4,3
22,324,324,4,1,3,2,1
25,339,339,20,20,0,1,0
1,339,339,35,14,21,2,1
46,351,351,81,66,15,4,3
19,351,351,20,20,0,1,0
9,355,355,16,16,0,1,0
12,359,359,6,6,0,1,0
14,375,375,142,64,78,4,3
2,385,385,50,8,42,2,1
33,394,394,66,66,0,1,0
0,412,412,48,48,0,1,0
32,414,414,117,117,0,1,0
37,423,423,21,9,12,2,1
39,425,425,147,15,132,4,3
21,430,430,72,39,33,3,2
44,434,434,34,34,0,1,0
38,439,439,38,6,32,3,2
42,447,447,30,14,16,2,1
28,466,466,21,5,16,3,2
34,490,490,12,12,0,1,0
5,500,500,82,82,0,1,0

32,114,114,4,1,3,2,1
7,120,120,11,11,0,1,0
3,148,148,9,2,7,2,1
8,170,170,5,5,0,1,0
21,174,174,6,6,0,1,0
36,175,175,12,12,0,1,0
12,182,182,7,2,5,2,1
16,196,196,26,26,0,1,0
0,207,207,51,31,20,2,1
19,211,211,18,18,0,1,0
6,224,224,40,40,0,1,0
33,238,238,20,14,6,3,2
9,249,249,2,2,0,1,0
30,258,258,11,8,3,2,1
17,262,262,19,9,10,2,1
13,278,278,69,57,12,4,3
5,279,279,30,8,22,3,2
18,280,280,14,4,10,2,1
20,290,290,8,8,0,1,0
41,293,293,6,2,4,2,1
24,301,301,13,6,7,2,1
38,308,308,31,6,25,2,1
34,312,312,38,14,24,4,3
2,316,316,21,4,17,3,2
37,327,327,37,4,33,4,3
23,342,342,20,9,11,2,1
35,353,353,38,38,0,1,0
39,370,370,87,18,69,4,3
15,370,370,75,43,32,2,1
4,391,391,11,11,0,1,0
29,399,399,218,116,102,4,3
27,405,405,6,6,0,1,0
14,408,408,9,9,0,1,0
28,432,432,43,1,42,4,3
11,442,442,18,18,0,1,0
40,446,446,41,23,18,3,2
25,467,467,2,2,0,1,0
10,480,480,48,48,0,1,0
22,480,480,5,2,3,2,1
1,483,483,9,9,0,1,0
26,489,489,19,7,12,4,3
31,493,493,51,51,0,1,0

39,101,101,9,9,0,1,0
3,108,108,6,6,0,1,0
1,111,111,1,1,0,1,0
37,143,143,17,17,0,1,0
12,152,152,29,29,0,1,0
25,156,156,6,6,0,1,0
31,161,161,6,6,0,1,0
11,172,172,23,23,0,1,0
5,178,178,37,37,0,1,0
18,178,178,50,2,48,3,2
8,201,201,18,18,0,1,0
15,212,212,6,6,0,1,0
21,216,216,20,4,16,3,2
10,216,216,8,8,0,1,0
26,226,226,23,23,0,1,0
41,241,241,10,10,0,1,0
6,252,252,11,8,3,2,1
36,256,256,36,36,0,1,0
32,259,259,78,78,0,1,0
24,271,271,11,11,0,1,0
2,280,280,39,39,0,1,0
16,297,297,37,3,34,3,2
43,310,310,31,31,0,1,0
34,312,312,12,2,10,3,2
9,315,315,5,5,0,1,0
28,315,315,44,15,29,2,1
42,329,329,11,5,6,2,1
22,339,339,3,3,0,1,0
38,353,353,38,38,0,1,0
40,354,354,35,35,0,1,0
4,355,355,15,15,0,1,0
0,380,380,23,1,22,3,2
33,397,397,17,17,0,1,0
19,401,401,2,2,0,1,0
13,408,408,1,1,0,1,0
30,414,414,71,46,25,4,3
14,415,415,66,66,0,1,0
17,421,421,27,3,24,4,3
7,436,436,7,7,0,1,0
29,441,441,33,33,0,1,0
23,445,445,1,1,0,1,0
35,452,452,3,3,0,1,0
27,458,458,118,85,33,4,3
20,492,492,25,25,0,1,0

29,125,125,8,8,0,1,0
15,143,143,3,3,0,1,0
19,148,148,11,11,0,1,0
24,150,150,36,18,18,3,2
9,159,159,32,20,12,3,2
25,172,172,2,2,0,1,0
31,173,173,21,15,6,2,1
21,179,179,32,32,0,1,0
3,182,182,3,3,0,1,0
7,211,211,48,42,6,2,1
16,220,220,47,47,0,1,0
28,222,222,45,1,44,3,2
34,225,225,3,3,0,1,0
0,227,227,13,1,12,4,3
2,259,259,1,1,0,1,0
33,269,269,3,3,0,1,0
20,279,279,15,1,14,3,2
39,292,292,34,12,22,2,1
38,311,311,76,8,68,3,2
4,317,317,12,12,0,1,0
8,318,318,11,11,0,1,0
32,325,325,1,1,0,1,0
23,331,331,62,62,0,1,0
12,333,333,44,44,0,1,0
30,333,333,1,1,0,1,0
27,337,337,25,14,11,2,1
10,342,342,11,11,0,1,0
13,350,350,24,6,18,4,3
22,354,354,14,11,3,2,1
18,403,403,64,2,62,3,2
6,406,406,8,8,0,1,0
35,430,430,58,24,34,3,2
17,440,440,15,10,5,2,1
37,448,448,42,5,37,2,1
11,465,465,188,100,88,3,2
26,470,470,79,79,0,1,0
1,471,471,42,27,15,2,1
5,477,477,10,3,7,3,2
36,488,488,14,14,0,1,0
14,489,489,1,1,0,1,0

29,100,100,25,25,0,1,0
9,104,104,6,3,3,2,1
24,105,105,4,4,0,1,0
14,110,110,15,15,0,1,0
20,127,127,11,11,0,1,0
37,128,128,2,2,0,1,0
38,136,136,11,2,9,2,1
1,142,142,26,26,0,1,0
34,144,144,8,8,0,1,0
42,157,157,3,3,0,1,0
25,159,159,29,29,0,1,0
7,166,166,3,3,0,1,0
32,189,189,67,67,0,1,0
16,224,224,10,10,0,1,0
31,233,233,33,17,16,3,2
28,246,246,10,1,9,4,3
10,252,252,24,24,0,1,0
22,267,267,1,1,0,1,0
26,271,271,27,12,15,4,3
33,279,279,7,7,0,1,0
5,280,280,1,1,0,1,0
12,286,286,10,7,3,2,1
11,288,288,69,69,0,1,0
36,299,299,12,8,4,2,1
3,302,302,29,3,26,3,2
23,309,309,59,42,17,4,3
41,316,316,87,78,9,4,3
2,324,324,52,11,41,4,3
27,326,326,19,19,0,1,0
19,335,335,7,7,0,1,0
17,346,346,27,27,0,1,0
18,350,350,19,13,6,3,2
6,354,354,21,15,6,2,1
15,355,355,27,27,0,1,0
30,359,359,39,17,22,3,2
13,372,372,20,20,0,1,0
21,378,378,10,10,0,1,0
39,383,383,11,5,6,3,2
35,387,387,37,37,0,1,0
4,387,387,32,32,0,1,0
8,436,436,37,24,13,4,3
40,444,444,20,20,0,1,0
0,482,482,7,7,0,1,0

37,117,117,4,1,3,2,1
8,124,124,1,1,0,1,0
24,136,136,17,1,16,3,2
9,154,154,16,1,15,4,3
32,158,158,15,15,0,1,0
31,169,169,21,3,18,3,2
20,179,179,5,2,3,2,1
30,187,187,1,1,0,1,0
23,194,194,18,18,0,1,0
33,201,201,18,6,12,3,2
26,211,211,8,4,4,2,1
21,234,234,27,27,0,1,0
35,235,235,38,11,27,4,3
3,245,245,22,22,0,1,0
22,252,252,24,24,0,1,0
19,255,255,52,34,18,4,3
5,266,266,7,7,0,1,0
17,306,306,75,75,0,1,0
28,312,312,103,103,0,1,0
4,319,319,15,15,0,1,0
13,323,323,41,1,40,3,2
15,330,330,28,22,6,2,1
14,358,358,3,3,0,1,0
36,362,362,31,18,13,3,2
1,366,366,17,17,0,1,0
10,397,397,22,22,0,1,0
27,412,412,36,36,0,1,0
16,415,415,88,52,36,3,2
6,416,416,52,4,48,4,3
7,420,420,56,56,0,1,0
29,421,421,10,6,4,2,1
2,424,424,96,59,37,2,1
18,439,439,38,24,14,3,2
0,448,448,24,24,0,1,0
12,465,465,99,99,0,1,0
34,467,467,55,55,0,1,0
25,476,476,38,34,4,2,1
11,477,477,4,4,0,1,0

48,120,120,6,6,0,1,0
6,120,120,6,1,5,2,1
19,127,127,9,9,0,1,0
44,133,133,25,25,0,1,0
47,134,134,10,10,0,1,0
30,148,148,12,12,0,1,0
45,160,160,18,13,5,2,1
41,162,162,12,3,9,2,1
39,180,180,22,4,18,4,3
18,192,192,37,30,7,2,1
8,209,209,3,3,0,1,0
1,214,214,4,4,0,1,0
4,220,220,20,2,18,4,3
25,226,226,4,1,3,2,1
24,247,247,1,1,0,1,0
33,247,247,5,2,3,2,1
31,264,264,49,27,22,3,2
14,270,270,2,2,0,1,0
9,275,275,37,19,18,4,3
36,277,277,41,41,0,1,0
23,281,281,5,5,0,1,0
13,288,288,11,11,0,1,0
15,291,291,5,2,3,2,1
21,291,291,43,26,17,2,1
20,293,293,44,2,42,4,3
17,319,319,10,3,7,2,1
28,333,333,17,17,0,1,0
46,335,335,66,66,0,1,0
22,338,338,13,6,7,2,1
11,349,349,25,15,10,3,2
38,349,349,58,9,49,2,1
40,352,352,2,2,0,1,0
35,353,353,20,2,18,2,1
29,356,356,37,37,0,1,0
26,361,361,34,34,0,1,0
42,370,370,8,8,0,1,0
3,373,373,1,1,0,1,0
5,384,384,55,10,45,4,3
32,405,405,19,19,0,1,0
12,405,405,27,27,0,1,0
7,410,410,31,7,24,3,2
0,419,419,2,2,0,1,0
37,455,455,7,7,0,1,0
27,461,461,12,12,0,1,0
16,462,462,53,53,0,1,0
34,465,465,18,8,10,3,2
10,466,466,1,1,0,1,0
43,468,468,142,83,59,4,3
2,476,476,11,11,0,1,0
49,479,479,52,52,0,1,0

9,128,128,17,17,0,1,0
18,138,138,1,1,0,1,0
34,144,144,3,3,0,1,0
17,148,148,25,25,0,1,0
22,151,151,12,12,0,1,0
23,163,163,30,13,17,4,3
13,168,168,9,6,3,2,1
6,175,175,14,14,0,1,0
16,177,177,11,11,0,1,0
10,200,200,1,1,0,1,0
31,201,201,3,3,0,1,0
0,206,206,39,39,0,1,0
8,209,209,9,4,5,2,1
25,216,216,56,38,18,3,2
12,225,225,83,17,66,4,3
5,271,271,100,91,9,4,3
7,283,283,19,19,0,1,0
2,313,313,11,5,6,2,1
27,322,322,61,43,18,4,3
20,322,322,12,12,0,1,0
3,332,332,13,1,12,4,3
19,335,335,12,12,0,1,0
14,338,338,29,29,0,1,0
1,341,341,7,7,0,1,0
21,349,349,32,12,20,3,2
33,351,351,66,26,40,3,2
4,398,398,76,76,0,1,0
30,399,399,21,4,17,2,1
26,426,426,38,38,0,1,0
29,447,447,28,2,26,3,2
11,468,468,20,8,12,3,2
32,478,478,22,10,12,4,3
24,479,479,9,1,8,2,1
28,481,481,162,130,32,4,3
15,483,483,86,47,39,4,3

25,101,101,51,51,0,1,0
8,112,112,18,13,5,2,1
26,128,128,12,12,0,1,0
28,150,150,48,48,0,1,0
23,152,152,2,2,0,1,0
15,187,187,1,1,0,1,0
36,193,193,15,15,0,1,0
7,198,198,10,2,8,2,1
6,204,204,3,3,0,1,0
30,211,211,46,25,21,4,3
5,211,211,8,8,0,1,0
35,220,220,1,1,0,1,0
34,233,233,6,6,0,1,0
0,251,251,10,4,6,3,2
24,273,273,9,9,0,1,0
11,284,284,119,56,63,4,3
16,285,285,49,13,36,2,1
38,291,291,43,43,0,1,0
19,295,295,8,8,0,1,0
3,297,297,2,2,0,1,0
10,300,300,29,23,6,2,1
2,304,304,80,80,0,1,0
27,356,356,43,43,0,1,0
21,360,360,4,4,0,1,0
33,361,361,8,8,0,1,0
13,361,361,34,19,15,4,3
12,364,364,19,19,0,1,0
1,379,379,23,23,0,1,0
18,391,391,2,2,0,1,0
29,391,391,34,34,0,1,0
32,415,415,6,6,0,1,0
17,415,415,38,38,0,1,0
31,438,438,39,12,27,2,1
37,443,443,57,57,0,1,0
9,444,444,33,9,24,2,1
22,446,446,8,8,0,1,0
20,479,479,5,5,0,1,0
4,482,482,6,6,0,1,0
14,500,500,108,55,53,4,3

13,130,130,6,6,0,1,0
31,130,130,7,1,6,3,2
11,133,133,15,6,9,2,1
4,134,134,10,4,6,2,1
19,139,139,4,4,0,1,0
25,143,143,11,3,8,3,2
27,143,143,40,40,0,1,0
1,150,150,38,38,0,1,0
18,170,170,5,2,3,2,1
2,186,186,2,2,0,1,0
35,203,203,15,15,0,1,0
34,204,204,2,2,0,1,0
41,205,205,67,35,32,2,1
24,206,206,45,45,0,1,0
38,206,206,17,17,0,1,0
17,208,208,3,3,0,1,0
28,214,214,35,11,24,3,2
42,233,233,6,6,0,1,0
36,247,247,14,5,9,2,1
9,248,248,37,17,20,3,2
30,250,250,9,9,0,1,0
12,261,261,23,5,18,3,2
7,267,267,12,9,3,2,1
26,271,271,17,17,0,1,0
43,292,292,31,18,13,4,3
16,296,296,25,3,22,2,1
0,307,307,31,31,0,1,0
33,312,312,15,15,0,1,0
8,313,313,26,14,12,2,1
39,322,322,16,4,12,3,2
15,323,323,4,4,0,1,0
10,355,355,46,40,6,2,1
20,355,355,11,6,5,2,1
14,356,356,23,2,21,4,3
3,374,374,11,11,0,1,0
32,392,392,3,3,0,1,0
6,397,397,19,19,0,1,0
23,398,398,27,27,0,1,0
5,407,407,30,30,0,1,0
22,409,409,10,10,0,1,0
37,425,425,32,24,8,3,2
21,428,428,35,24,11,2,1
29,428,428,32,32,0,1,0
40,491,491,159,159,0,1,0

26,101,101,8,8,0,1,0
4,103,103,2,2,0,1,0
18,106,106,45,42,3,2,1
19,109,109,12,12,0,1,0
23,111,111,11,11,0,1,0
30,119,119,5,5,0,1,0
12,155,155,11,11,0,1,0
1,157,157,2,2,0,1,0
34,167,167,25,15,10,2,1
21,174,174,21,21,0,1,0
22,174,174,26,2,24,3,2
5,193,193,29,29,0,1,0
24,223,223,28,10,18,4,3
3,226,226,2,2,0,1,0
9,248,248,17,8,9,4,3
20,271,271,33,28,5,2,1
11,278,278,103,103,0,1,0
16,279,279,85,10,75,3,2
14,292,292,32,32,0,1,0
31,302,302,22,22,0,1,0
7,308,308,40,3,37,2,1
29,319,319,3,3,0,1,0
28,335,335,47,47,0,1,0
8,340,340,4,4,0,1,0
32,358,358,2,2,0,1,0
10,382,382,41,41,0,1,0
13,397,397,39,12,27,4,3
2,398,398,2,2,0,1,0
27,405,405,11,11,0,1,0
6,420,420,48,34,14,3,2
17,422,422,34,11,23,2,1
35,439,439,24,24,0,1,0
25,448,448,55,3,52,3,2
33,448,448,7,7,0,1,0
15,476,476,32,8,24,4,3
0,485,485,122,122,0,1,0

0,109,109,2,2,0,1,0
51,116,116,4,4,0,1,0
44,130,130,13,1,12,4,3
37,140,140,9,5,4,2,1
1,145,145,17,11,6,3,2
11,150,150,2,2,0,1,0
34,155,155,3,3,0,1,0
40,160,160,17,17,0,1,0
25,161,161,2,2,0,1,0
27,164,164,4,4,0,1,0
3,174,174,9,9,0,1,0
7,206,206,13,13,0,1,0
15,222,222,5,5,0,1,0
49,223,223,8,8,0,1,0
14,236,236,7,7,0,1,0
20,244,244,6,3,3,2,1
50,245,245,52,52,0,1,0
23,246,246,36,13,23,2,1
12,256,256,6,6,0,1,0
30,257,257,10,10,0,1,0
35,271,271,17,7,10,2,1
33,273,273,46,46,0,1,0
36,281,281,111,54,57,4,3
18,283,283,2,2,0,1,0
13,292,292,17,5,12,4,3
21,293,293,2,2,0,1,0
6,303,303,11,11,0,1,0
16,305,305,17,1,16,2,1
19,313,313,11,11,0,1,0
32,321,321,18,18,0,1,0
45,329,329,16,16,0,1,0
10,342,342,36,36,0,1,0
41,343,343,53,8,45,4,3
17,345,345,42,32,10,3,2
43,352,352,26,26,0,1,0
24,352,352,39,39,0,1,0
22,353,353,36,36,0,1,0
39,359,359,43,43,0,1,0
4,363,363,55,55,0,1,0
38,385,385,42,6,36,4,3
2,386,386,14,14,0,1,0
26,404,404,42,42,0,1,0
47,415,415,2,2,0,1,0
48,421,421,5,5,0,1,0
28,424,424,36,26,10,2,1
29,430,430,5,5,0,1,0
42,456,456,73,48,25,2,1
9,456,456,17,17,0,1,0
8,458,458,34,34,0,1,0
31,462,462,1,1,0,1,0
46,477,477,32,32,0,1,0
5,479,479,57,12,45,4,3

36,106,106,2,2,0,1,0
37,108,108,20,20,0,1,0
5,108,108,4,1,3,2,1
30,111,111,21,11,10,2,1
9,122,122,10,10,0,1,0
19,128,128,15,6,9,4,3
6,130,130,3,3,0,1,0
21,138,138,1,1,0,1,0
28,141,141,9,9,0,1,0
7,161,161,7,7,0,1,0
40,180,180,40,40,0,1,0
11,185,185,1,1,0,1,0
32,190,190,7,7,0,1,0
31,219,219,5,1,4,2,1
25,229,229,22,12,10,3,2
16,229,229,13,13,0,1,0
12,237,237,9,4,5,2,1
8,239,239,23,3,20,2,1
47,246,246,29,14,15,2,1
18,254,254,4,4,0,1,0
4,268,268,17,11,6,2,1
46,274,274,3,3,0,1,0
44,277,277,62,62,0,1,0
15,280,280,1,1,0,1,0
29,283,283,25,16,9,4,3
13,287,287,12,12,0,1,0
26,294,294,1,1,0,1,0
23,296,296,33,33,0,1,0
38,302,302,48,48,0,1,0
14,309,309,1,1,0,1,0
24,309,309,7,1,6,3,2
0,332,332,50,16,34,2,1
45,355,355,11,2,9,4,3
3,372,372,13,13,0,1,0
42,381,381,5,5,0,1,0
41,395,395,58,44,14,3,2
34,398,398,6,6,0,1,0
22,423,423,28,28,0,1,0
1,430,430,45,45,0,1,0
17,431,431,48,42,6,3,2
10,443,443,20,20,0,1,0
39,444,444,33,33,0,1,0
2,447,447,1,1,0,1,0
43,450,450,139,139,0,1,0
27,451,451,147,102,45,2,1
35,455,455,34,34,0,1,0
33,462,462,2,2,0,1,0
20,467,467,62,19,43,2,1

31,117,117,33,33,0,1,0
35,118,118,3,3,0,1,0
8,143,143,2,2,0,1,0
33,163,163,12,12,0,1,0
14,186,186,40,40,0,1,0
26,198,198,37,37,0,1,0
32,204,204,23,6,17,4,3
11,207,207,40,28,12,2,1
22,231,231,26,16,10,3,2
34,231,231,10,10,0,1,0
17,256,256,2,2,0,1,0
7,268,268,10,1,9,4,3
25,274,274,9,1,8,2,1
1,277,277,20,20,0,1,0
12,284,284,35,24,11,2,1
16,314,314,12,12,0,1,0
37,321,321,36,36,0,1,0
21,323,323,11,5,6,2,1
18,323,323,20,20,0,1,0
0,335,335,19,10,9,4,3
19,341,341,68,20,48,2,1
13,369,369,3,3,0,1,0
27,371,371,55,55,0,1,0
20,383,383,57,21,36,4,3
4,390,390,92,92,0,1,0
24,399,399,17,1,16,2,1
29,400,400,25,1,24,3,2
23,402,402,31,31,0,1,0
38,406,406,51,29,22,2,1
15,418,418,43,43,0,1,0
5,422,422,27,9,18,2,1
28,424,424,32,32,0,1,0
2,424,424,4,4,0,1,0
36,453,453,56,47,9,4,3
9,471,471,9,9,0,1,0
30,483,483,55,10,45,3,2
10,487,487,119,104,15,4,3
3,488,488,7,3,4,2,1
6,491,491,90,90,0,1,0

20,100,100,9,9,0,1,0
36,103,103,8,8,0,1,0
24,124,124,3,3,0,1,0
37,132,132,34,34,0,1,0
14,149,149,7,7,0,1,0
12,149,149,4,4,0,1,0
33,173,173,6,1,5,2,1
16,195,195,2,2,0,1,0
2,198,198,2,2,0,1,0
41,202,202,16,3,13,2,1
4,209,209,1,1,0,1,0
3,225,225,8,3,5,2,1
0,229,229,1,1,0,1,0
5,230,230,11,11,0,1,0
10,231,231,66,9,57,4,3
19,235,235,34,22,12,3,2
1,241,241,10,10,0,1,0
34,247,247,24,6,18,2,1
9,256,256,15,3,12,4,3
25,260,260,33,33,0,1,0
35,269,269,10,10,0,1,0
39,295,295,6,6,0,1,0
22,314,314,40,40,0,1,0
13,322,322,6,6,0,1,0
6,345,345,17,17,0,1,0
15,356,356,154,154,0,1,0
38,359,359,23,3,20,3,2
27,368,368,124,124,0,1,0
17,368,368,37,17,20,2,1
32,371,371,80,80,0,1,0
7,374,374,41,14,27,2,1
29,390,390,113,75,38,3,2
42,404,404,2,2,0,1,0
31,422,422,2,2,0,1,0
23,433,433,9,9,0,1,0
18,450,450,10,10,0,1,0
8,450,450,24,9,15,2,1
40,455,455,79,55,24,2,1
11,467,467,62,13,49,2,1
30,468,468,5,1,4,2,1
21,469,469,13,4,9,4,3
28,472,472,33,13,20,2,1
26,491,491,6,2,4,2,1

34,113,113,4,4,0,1,0
0,114,114,27,27,0,1,0
23,116,116,2,2,0,1,0
18,122,122,5,5,0,1,0
25,122,122,29,4,25,2,1
19,128,128,3,3,0,1,0
24,129,129,10,10,0,1,0
39,130,130,20,8,12,4,3
11,145,145,2,2,0,1,0
28,145,145,12,12,0,1,0
37,175,175,23,3,20,3,2
4,210,210,10,6,4,2,1
22,216,216,10,10,0,1,0
3,219,219,16,16,0,1,0
13,250,250,9,1,8,2,1
30,256,256,62,20,42,3,2
10,268,268,16,16,0,1,0
29,270,270,18,18,0,1,0
15,274,274,17,17,0,1,0
6,283,283,50,50,0,1,0
2,296,296,86,23,63,4,3
7,306,306,1,1,0,1,0
9,309,309,58,58,0,1,0
8,326,326,11,11,0,1,0
33,343,343,25,21,4,2,1
27,372,372,17,17,0,1,0
5,373,373,34,14,20,3,2
12,380,380,35,35,0,1,0
31,380,380,11,11,0,1,0
17,397,397,3,3,0,1,0
35,405,405,9,9,0,1,0
32,449,449,79,79,0,1,0
36,463,463,3,3,0,1,0
38,465,465,22,22,0,1,0
14,470,470,55,55,0,1,0
21,471,471,119,83,36,4,3
1,476,476,9,1,8,2,1
26,484,484,92,25,67,4,3
20,485,485,27,3,24,2,1
16,490,490,114,114,0,1,0

26,100,100,8,1,7,2,1
23,100,100,28,28,0,1,0
30,100,100,13,1,12,3,2
37,107,107,1,1,0,1,0
16,121,121,16,1,15,4,3
22,126,126,13,2,11,2,1
6,135,135,8,8,0,1,0
45,137,137,1,1,0,1,0
31,148,148,12,12,0,1,0
28,150,150,4,1,3,2,1
20,164,164,1,1,0,1,0
24,165,165,7,7,0,1,0
32,199,199,42,42,0,1,0
19,212,212,23,8,15,4,3
43,230,230,29,14,15,4,3
15,240,240,4,4,0,1,0
3,246,246,5,5,0,1,0
27,251,251,72,72,0,1,0
35,257,257,23,15,8,2,1
11,279,279,41,18,23,2,1
44,280,280,5,5,0,1,0
2,288,288,3,3,0,1,0
1,290,290,29,29,0,1,0
21,315,315,43,43,0,1,0
0,316,316,7,3,4,2,1
8,330,330,8,8,0,1,0
41,332,332,15,15,0,1,0
25,344,344,16,4,12,4,3
4,346,346,1,1,0,1,0
9,352,352,7,7,0,1,0
10,358,358,5,2,3,2,1
7,362,362,22,4,18,3,2
36,382,382,8,8,0,1,0
17,391,391,19,19,0,1,0
42,406,406,36,18,18,2,1
13,406,406,11,11,0,1,0
12,419,419,133,90,43,2,1
34,427,427,96,74,22,2,1
18,434,434,2,2,0,1,0
29,440,440,72,6,66,4,3
5,448,448,26,10,16,3,2
38,463,463,24,24,0,1,0
40,480,480,55,55,0,1,0
14,481,481,6,6,0,1,0
39,484,484,19,5,14,3,2
33,485,485,99,99,0,1,0

6,102,102,3,3,0,1,0
25,118,118,16,4,12,2,1
15,119,119,23,7,16,3,2
35,123,123,25,25,0,1,0
31,124,124,5,5,0,1,0
8,129,129,1,1,0,1,0
36,146,146,7,7,0,1,0
28,185,185,14,14,0,1,0
38,191,191,23,23,0,1,0
41,192,192,25,25,0,1,0
29,212,212,14,11,3,2,1
1,223,223,3,3,0,1,0
40,225,225,10,10,0,1,0
19,242,242,41,41,0,1,0
26,247,247,3,3,0,1,0
7,252,252,44,25,19,2,1
2,256,256,38,38,0,1,0
14,256,256,48,14,34,3,2
11,271,271,17,17,0,1,0
33,294,294,2,2,0,1,0
23,304,304,14,5,9,2,1
17,315,315,18,3,15,4,3
39,330,330,32,32,0,1,0
24,335,335,42,42,0,1,0
4,350,350,12,12,0,1,0
22,352,352,1,1,0,1,0
9,355,355,23,1,22,2,1
16,356,356,10,4,6,2,1
13,372,372,72,72,0,1,0
27,377,377,9,1,8,2,1
0,377,377,7,2,5,2,1
34,388,388,7,7,0,1,0
10,393,393,4,4,0,1,0
21,402,402,22,16,6,2,1
18,412,412,30,4,26,2,1
32,436,436,23,23,0,1,0
12,439,439,18,18,0,1,0
5,464,464,1,1,0,1,0
37,472,472,185,179,6,3,2
3,488,488,124,94,30,3,2
20,491,491,39,39,0,1,0
30,492,492,148,148,0,1,0

34,110,110,14,14,0,1,0
14,123,123,8,2,6,3,2
38,141,141,6,6,0,1,0
40,148,148,6,1,5,2,1
26,149,149,44,44,0,1,0
36,169,169,22,5,17,2,1
8,170,170,39,27,12,4,3
23,185,185,26,7,19,4,3
4,195,195,43,34,9,2,1
9,201,201,21,21,0,1,0
39,212,212,31,31,0,1,0
17,215,215,26,26,0,1,0
0,238,238,2,2,0,1,0
37,244,244,3,3,0,1,0
22,272,272,5,5,0,1,0
13,277,277,59,21,38,3,2
6,293,293,16,16,0,1,0
28,299,299,33,33,0,1,0
10,302,302,18,2,16,3,2
15,323,323,29,20,9,4,3
20,326,326,73,73,0,1,0
1,330,330,33,33,0,1,0
41,334,334,66,25,41,2,1
30,334,334,3,3,0,1,0
18,340,340,1,1,0,1,0
25,352,352,56,22,34,3,2
2,353,353,27,27,0,1,0
24,356,356,36,30,6,2,1
12,357,357,6,6,0,1,0
35,370,370,64,33,31,2,1
3,380,380,7,7,0,1,0
5,406,406,11,5,6,3,2
31,415,415,11,11,0,1,0
21,440,440,41,9,32,2,1
32,445,445,48,48,0,1,0
27,453,453,9,9,0,1,0
29,475,475,46,10,36,3,2
11,475,475,38,9,29,3,2
33,484,484,2,2,0,1,0
7,495,495,3,3,0,1,0
16,496,496,29,20,9,4,3
19,498,498,8,5,3,2,1

35,129,129,6,6,0,1,0
30,132,132,8,8,0,1,0
23,144,144,21,16,5,2,1
12,159,159,3,3,0,1,0
24,163,163,4,4,0,1,0
33,174,174,44,22,22,2,1
28,176,176,7,7,0,1,0
18,195,195,14,2,12,2,1
13,196,196,5,2,3,2,1
20,199,199,35,14,21,4,3
40,206,206,7,7,0,1,0
11,215,215,9,3,6,3,2
39,246,246,1,1,0,1,0
0,247,247,27,1,26,3,2
9,255,255,1,1,0,1,0
32,258,258,26,21,5,2,1
37,259,259,30,19,11,3,2
8,277,277,6,6,0,1,0
42,282,282,11,11,0,1,0
17,282,282,25,4,21,4,3
27,303,303,5,5,0,1,0
19,319,319,59,59,0,1,0
16,322,322,4,4,0,1,0
31,326,326,32,32,0,1,0
3,329,329,19,5,14,3,2
5,329,329,26,4,22,2,1
1,331,331,6,6,0,1,0
25,355,355,66,12,54,4,3
29,358,358,32,32,0,1,0
10,364,364,3,3,0,1,0
36,376,376,88,74,14,3,2
6,390,390,30,30,0,1,0
15,392,392,29,29,0,1,0
7,416,416,42,42,0,1,0
38,417,417,7,7,0,1,0
4,418,418,79,45,34,2,1
21,433,433,19,1,18,2,1
2,433,433,52,6,46,3,2
34,435,435,71,71,0,1,0
14,435,435,57,9,48,3,2
22,462,462,49,34,15,4,3
41,477,477,203,77,126,4,3
26,479,479,1,1,0,1,0

2,102,102,2,2,0,1,0
36,106,106,3,3,0,1,0
38,109,109,28,9,19,4,3
26,120,120,5,5,0,1,0
39,127,127,16,7,9,4,3
1,140,140,32,20,12,3,2
14,141,141,1,1,0,1,0
4,173,173,1,1,0,1,0
35,177,177,3,3,0,1,0
23,187,187,43,36,7,2,1
22,198,198,60,44,16,3,2
15,215,215,1,1,0,1,0
8,217,217,77,47,30,2,1
34,218,218,81,67,14,2,1
29,223,223,13,13,0,1,0
7,223,223,3,3,0,1,0
31,229,229,10,10,0,1,0
11,245,245,11,11,0,1,0
21,279,279,4,4,0,1,0
3,289,289,6,6,0,1,0
9,294,294,21,21,0,1,0
19,294,294,15,9,6,2,1
40,301,301,6,6,0,1,0
30,314,314,7,3,4,2,1
32,325,325,6,1,5,2,1
28,332,332,11,11,0,1,0
12,359,359,47,30,17,3,2
20,365,365,10,10,0,1,0
41,389,389,95,73,22,4,3
10,402,402,21,9,12,3,2
0,425,425,16,16,0,1,0
13,436,436,41,41,0,1,0
5,440,440,7,7,0,1,0
33,443,443,35,5,30,3,2
18,446,446,7,7,0,1,0
27,451,451,53,35,18,2,1
37,454,454,80,80,0,1,0
6,467,467,85,85,0,1,0
17,471,471,56,6,50,4,3
25,482,482,26,26,0,1,0
24,490,490,3,3,0,1,0
16,498,498,43,43,0,1,0

21,115,115,1,1,0,1,0
29,121,121,7,7,0,1,0
12,127,127,44,1,43,2,1
22,130,130,20,8,12,4,3
5,154,154,8,2,6,2,1
23,171,171,24,24,0,1,0
14,188,188,1,1,0,1,0
9,190,190,3,3,0,1,0
11,190,190,20,20,0,1,0
39,214,214,44,32,12,3,2
28,243,243,6,6,0,1,0
15,247,247,43,43,0,1,0
33,248,248,17,17,0,1,0
3,260,260,3,3,0,1,0
10,261,261,2,2,0,1,0
37,266,266,28,8,20,2,1
20,267,267,39,39,0,1,0
26,267,267,15,11,4,2,1
0,275,275,18,10,8,2,1
44,278,278,53,53,0,1,0
19,279,279,1,1,0,1,0
36,288,288,177,117,60,4,3
41,292,292,5,5,0,1,0
17,293,293,36,36,0,1,0
24,302,302,25,15,10,2,1
25,305,305,2,2,0,1,0
13,309,309,34,22,12,4,3
43,322,322,26,5,21,2,1
34,324,324,1,1,0,1,0
27,329,329,7,7,0,1,0
2,350,350,18,6,12,2,1
18,351,351,13,13,0,1,0
1,360,360,16,1,15,2,1
30,370,370,8,5,3,2,1
6,387,387,31,31,0,1,0
4,389,389,4,1,3,2,1
31,391,391,1,1,0,1,0
8,395,395,13,13,0,1,0
7,422,422,26,26,0,1,0
42,441,441,24,18,6,3,2
32,468,468,5,5,0,1,0
35,477,477,79,29,50,2,1
16,481,481,13,4,9,2,1
40,495,495,105,29,76,3,2
38,497,497,8,8,0,1,0

16,125,125,37,9,28,2,1
11,128,128,4,4,0,1,0
33,132,132,47,38,9,2,1
24,137,137,19,14,5,2,1
28,152,152,6,6,0,1,0
27,155,155,21,13,8,2,1
17,164,164,34,19,15,2,1
13,168,168,14,14,0,1,0
3,169,169,37,22,15,4,3
14,177,177,1,1,0,1,0
12,181,181,10,10,0,1,0
2,183,183,10,10,0,1,0
5,196,196,16,16,0,1,0
25,201,201,15,1,14,2,1
7,251,251,11,11,0,1,0
10,258,258,15,15,0,1,0
26,260,260,25,25,0,1,0
35,269,269,3,3,0,1,0
19,285,285,16,3,13,2,1
31,314,314,77,77,0,1,0
21,315,315,2,2,0,1,0
1,319,319,25,4,21,4,3
9,329,329,33,6,27,4,3
29,341,341,44,44,0,1,0
20,348,348,7,7,0,1,0
34,353,353,6,3,3,2,1
32,369,369,46,7,39,4,3
30,402,402,33,11,22,3,2
23,413,413,56,32,24,4,3
15,420,420,66,46,20,3,2
36,426,426,25,25,0,1,0
6,447,447,2,2,0,1,0
0,459,459,96,52,44,2,1
4,477,477,61,61,0,1,0
22,485,485,80,73,7,2,1
8,490,490,44,44,0,1,0
18,497,497,19,19,0,1,0

20,110,110,6,6,0,1,0
25,119,119,3,3,0,1,0
11,120,120,5,5,0,1,0
16,124,124,18,18,0,1,0
15,131,131,32,7,25,2,1
19,135,135,4,1,3,2,1
10,154,154,19,19,0,1,0
23,166,166,15,10,5,2,1
13,173,173,85,33,52,3,2
34,178,178,4,4,0,1,0
7,179,179,6,3,3,2,1
24,186,186,9,9,0,1,0
30,205,205,5,5,0,1,0
33,214,214,3,3,0,1,0
17,214,214,98,98,0,1,0
31,220,220,66,52,14,2,1
5,244,244,17,6,11,2,1
32,248,248,19,1,18,3,2
2,287,287,8,8,0,1,0
22,321,321,61,61,0,1,0
8,322,322,1,1,0,1,0
1,329,329,7,2,5,2,1
28,335,335,21,21,0,1,0
4,349,349,80,60,20,3,2
27,359,359,30,25,5,2,1
18,361,361,1,1,0,1,0
6,407,407,34,13,21,4,3
12,419,419,44,44,0,1,0
3,419,419,30,30,0,1,0
9,460,460,39,39,0,1,0
14,466,466,103,54,49,4,3
26,468,468,76,52,24,4,3
0,482,482,24,24,0,1,0
29,490,490,38,38,0,1,0
21,496,496,35,32,3,2,1

18,117,117,1,1,0,1,0
8,125,125,4,4,0,1,0
26,142,142,3,3,0,1,0
13,197,197,21,6,15,3,2
10,207,207,18,18,0,1,0
35,215,215,93,31,62,3,2
15,222,222,25,13,12,4,3
23,223,223,13,13,0,1,0
2,232,232,15,15,0,1,0
12,236,236,19,3,16,2,1
11,236,236,15,15,0,1,0
28,249,249,38,29,9,4,3
32,257,257,33,2,31,3,2
34,272,272,47,14,33,2,1
9,275,275,26,26,0,1,0
5,286,286,7,1,6,2,1
24,289,289,35,35,0,1,0
4,290,290,6,2,4,2,1
19,301,301,15,15,0,1,0
29,312,312,23,13,10,2,1
6,322,322,62,50,12,2,1
31,349,349,21,21,0,1,0
21,374,374,76,13,63,4,3
25,387,387,6,6,0,1,0
14,409,409,25,25,0,1,0
20,423,423,59,7,52,3,2
1,432,432,74,74,0,1,0
27,438,438,17,17,0,1,0
22,441,441,2,2,0,1,0
0,450,450,2,2,0,1,0
16,464,464,176,155,21,2,1
7,471,471,29,29,0,1,0
30,474,474,48,48,0,1,0
3,486,486,131,131,0,1,0
17,493,493,37,31,6,3,2
36,493,493,62,62,0,1,0
33,498,498,14,7,7,2,1

33,121,121,5,2,3,2,1
19,123,123,13,13,0,1,0
31,126,126,3,3,0,1,0
26,127,127,40,2,38,2,1
22,128,128,15,10,5,2,1
3,137,137,1,1,0,1,0
38,140,140,3,3,0,1,0
39,150,150,18,2,16,2,1
11,162,162,9,6,3,2,1
8,177,177,10,10,0,1,0
5,183,183,4,4,0,1,0
24,184,184,2,2,0,1,0
44,217,217,9,9,0,1,0
14,227,227,9,9,0,1,0
10,240,240,1,1,0,1,0
20,247,247,23,23,0,1,0
42,251,251,49,39,10,3,2
32,271,271,18,15,3,2,1
29,274,274,3,3,0,1,0
23,285,285,2,2,0,1,0
43,288,288,20,20,0,1,0
41,289,289,21,3,18,3,2
28,307,307,18,6,12,2,1
27,316,316,13,5,8,2,1
35,331,331,39,9,30,4,3
36,337,337,24,12,12,3,2
37,341,341,41,41,0,1,0
21,342,342,13,13,0,1,0
40,348,348,36,36,0,1,0
9,353,353,32,5,27,2,1
34,359,359,11,6,5,2,1
7,365,365,1,1,0,1,0
45,371,371,82,82,0,1,0
25,382,382,17,17,0,1,0
13,385,385,75,30,45,4,3
1,387,387,14,14,0,1,0
17,411,411,22,22,0,1,0
6,420,420,77,41,36,4,3
30,441,441,39,39,0,1,0
16,444,444,48,19,29,4,3
0,454,454,2,2,0,1,0
4,456,456,23,23,0,1,0
12,461,461,63,12,51,4,3
2,464,464,7,7,0,1,0
46,471,471,219,163,56,3,2
18,474,474,4,4,0,1,0
15,499,499,30,6,24,2,1

19,115,115,3,3,0,1,0
24,124,124,12,12,0,1,0
29,137,137,2,2,0,1,0
8,138,138,20,20,0,1,0
6,167,167,79,79,0,1,0
32,178,178,2,2,0,1,0
26,182,182,26,26,0,1,0
15,183,183,36,36,0,1,0
30,204,204,23,5,18,2,1
14,238,238,3,3,0,1,0
31,250,250,11,5,6,3,2
16,277,277,71,71,0,1,0
0,283,283,1,1,0,1,0
18,285,285,1,1,0,1,0
13,296,296,7,1,6,2,1
33,300,300,5,5,0,1,0
20,332,332,55,44,11,2,1
12,336,336,40,40,0,1,0
25,358,358,29,29,0,1,0
28,360,360,29,29,0,1,0
5,369,369,5,5,0,1,0
22,371,371,59,59,0,1,0
10,371,371,58,22,36,3,2
23,374,374,68,29,39,2,1
35,387,387,107,107,0,1,0
3,392,392,4,4,0,1,0
9,402,402,38,28,10,2,1
1,407,407,5,2,3,2,1
17,408,408,8,2,6,3,2
2,413,413,1,1,0,1,0
11,420,420,36,36,0,1,0
34,433,433,1,1,0,1,0
36,438,438,64,25,39,4,3
4,453,453,43,43,0,1,0
7,476,476,73,31,42,2,1
21,478,478,104,36,68,3,2
38,493,493,58,40,18,2,1
37,494,494,6,2,4,2,1
27,499,499,23,23,0,1,0

0,108,108,17,17,0,1,0
15,121,121,7,7,0,1,0
33,129,129,11,2,9,2,1
38,139,139,12,12,0,1,0
8,142,142,11,5,6,2,1
4,142,142,9,5,4,2,1
37,170,170,15,5,10,2,1
27,171,171,16,16,0,1,0
34,181,181,54,54,0,1,0
10,188,188,23,14,9,2,1
16,191,191,16,16,0,1,0
29,204,204,47,47,0,1,0
17,206,206,5,5,0,1,0
30,212,212,51,37,14,2,1
32,224,224,27,12,15,2,1
26,230,230,30,3,27,4,3
23,252,252,4,4,0,1,0
14,264,264,85,85,0,1,0
3,276,276,2,2,0,1,0
2,321,321,9,9,0,1,0
36,322,322,8,1,7,2,1
39,323,323,42,25,17,4,3
1,334,334,3,3,0,1,0
19,345,345,63,63,0,1,0
5,349,349,7,7,0,1,0
28,353,353,9,9,0,1,0
18,385,385,7,7,0,1,0
22,389,389,5,5,0,1,0
31,396,396,62,56,6,2,1
21,407,407,2,2,0,1,0
12,411,411,16,16,0,1,0
25,415,415,29,5,24,4,3
35,434,434,39,5,34,2,1
20,449,449,10,10,0,1,0
6,454,454,92,92,0,1,0
24,455,455,20,20,0,1,0
13,456,456,8,8,0,1,0
7,468,468,169,115,54,4,3
11,473,473,39,39,0,1,0
9,473,473,1,1,0,1,0

15,127,127,3,3,0,1,0
33,128,128,23,23,0,1,0
19,148,148,15,15,0,1,0
36,157,157,7,7,0,1,0
21,158,158,32,8,24,4,3
31,173,173,2,2,0,1,0
13,190,190,68,68,0,1,0
9,195,195,38,3,35,2,1
6,196,196,14,14,0,1,0
16,218,218,8,8,0,1,0
12,220,220,2,2,0,1,0
5,226,226,9,9,0,1,0
8,238,238,23,23,0,1,0
3,261,261,4,4,0,1,0
17,263,263,12,1,11,3,2
30,272,272,10,10,0,1,0
7,289,289,12,12,0,1,0
28,296,296,10,5,5,2,1
14,325,325,13,6,7,2,1
4,335,335,12,12,0,1,0
29,353,353,12,8,4,2,1
20,357,357,48,33,15,4,3
11,362,362,49,7,42,4,3
2,367,367,40,40,0,1,0
22,382,382,86,50,36,3,2
32,404,404,50,14,36,4,3
27,404,404,9,3,6,2,1
1,413,413,58,58,0,1,0
35,416,416,76,34,42,4,3
0,421,421,56,24,32,2,1
26,422,422,29,12,17,2,1
24,431,431,90,46,44,3,2
18,487,487,45,45,0,1,0
25,488,488,53,53,0,1,0
23,490,490,58,41,17,2,1
10,494,494,185,98,87,4,3
34,495,495,3,3,0,1,0

11,111,111,8,8,0,1,0
39,117,117,33,17,16,3,2
34,159,159,12,12,0,1,0
8,165,165,14,14,0,1,0
20,170,170,1,1,0,1,0
16,171,171,7,2,5,2,1
21,178,178,10,4,6,2,1
36,188,188,20,20,0,1,0
12,189,189,11,11,0,1,0
32,198,198,6,6,0,1,0
40,200,200,5,5,0,1,0
26,224,224,14,4,10,3,2
35,232,232,63,63,0,1,0
0,244,244,5,5,0,1,0
7,249,249,74,74,0,1,0
24,261,261,15,15,0,1,0
1,265,265,60,6,54,4,3
6,268,268,7,7,0,1,0
4,275,275,17,1,16,3,2
19,288,288,54,54,0,1,0
17,311,311,1,1,0,1,0
38,334,334,55,55,0,1,0
10,346,346,17,17,0,1,0
3,349,349,75,75,0,1,0
14,364,364,11,11,0,1,0
28,364,364,56,56,0,1,0
30,368,368,38,38,0,1,0
13,382,382,1,1,0,1,0
37,385,385,6,6,0,1,0
25,386,386,26,21,5,2,1
18,395,395,51,51,0,1,0
33,396,396,43,43,0,1,0
23,401,401,16,4,12,3,2
2,406,406,66,33,33,4,3
27,423,423,36,2,34,2,1
9,449,449,60,9,51,4,3
22,460,460,37,37,0,1,0
15,477,477,12,12,0,1,0
31,485,485,50,26,24,4,3
5,488,488,8,8,0,1,0
29,500,500,55,40,15,2,1

6,100,100,18,18,0,1,0
12,109,109,19,19,0,1,0
30,119,119,29,29,0,1,0
4,122,122,3,3,0,1,0
11,132,132,16,16,0,1,0
39,151,151,12,3,9,2,1
14,152,152,27,27,0,1,0
17,168,168,24,16,8,3,2
24,169,169,8,1,7,2,1
9,173,173,27,8,19,2,1
35,184,184,15,9,6,2,1
3,190,190,19,19,0,1,0
2,196,196,5,5,0,1,0
34,200,200,12,12,0,1,0
38,206,206,27,27,0,1,0
22,207,207,23,23,0,1,0
21,226,226,30,12,18,3,2
16,232,232,1,1,0,1,0
33,238,238,29,29,0,1,0
37,243,243,3,3,0,1,0
29,272,272,18,2,16,2,1
15,284,284,36,5,31,3,2
1,308,308,8,8,0,1,0
32,313,313,34,34,0,1,0
25,332,332,4,4,0,1,0
28,340,340,23,1,22,2,1
7,371,371,48,48,0,1,0
18,376,376,17,8,9,4,3
13,384,384,1,1,0,1,0
10,396,396,41,41,0,1,0
36,408,408,76,8,68,3,2
31,412,412,78,78,0,1,0
5,419,419,83,59,24,2,1
27,427,427,2,2,0,1,0
19,445,445,14,8,6,2,1
23,459,459,65,65,0,1,0
0,469,469,39,5,34,3,2
20,470,470,22,22,0,1,0
26,477,477,67,9,58,3,2
8,491,491,1,1,0,1,0

29,101,101,13,2,11,4,3
28,107,107,16,16,0,1,0
31,111,111,8,8,0,1,0
32,117,117,14,14,0,1,0
15,140,140,21,21,0,1,0
8,162,162,15,12,3,2,1
23,163,163,53,7,46,3,2
13,179,179,3,3,0,1,0
27,197,197,5,5,0,1,0
7,208,208,42,42,0,1,0
16,244,244,10,10,0,1,0
5,257,257,2,2,0,1,0
22,266,266,7,1,6,2,1
6,268,268,16,5,11,2,1
12,283,283,5,5,0,1,0
4,288,288,18,18,0,1,0
9,289,289,40,11,29,2,1
35,304,304,34,34,0,1,0
0,311,311,1,1,0,1,0
36,336,336,25,4,21,4,3
24,342,342,18,18,0,1,0
34,357,357,63,63,0,1,0
14,358,358,8,4,4,2,1
25,359,359,24,4,20,2,1
21,363,363,20,20,0,1,0
20,372,372,37,37,0,1,0
18,387,387,82,82,0,1,0
33,401,401,39,39,0,1,0
26,402,402,25,25,0,1,0
30,416,416,16,5,11,2,1
17,422,422,103,49,54,4,3
11,428,428,35,9,26,4,3
19,429,429,20,20,0,1,0
1,440,440,78,4,74,4,3
10,460,460,56,8,48,3,2
2,476,476,127,127,0,1,0
3,497,497,97,69,28,3,2

7,107,107,36,12,24,3,2
4,148,148,9,5,4,2,1
13,184,184,21,21,0,1,0
1,192,192,1,1,0,1,0
30,205,205,3,3,0,1,0
10,210,210,42,28,14,2,1
31,211,211,4,4,0,1,0
28,211,211,69,69,0,1,0
15,213,213,65,24,41,2,1
25,224,224,26,4,22,3,2
20,237,237,33,33,0,1,0
2,238,238,25,25,0,1,0
23,246,246,30,30,0,1,0
18,251,251,16,9,7,2,1
17,254,254,33,17,16,2,1
8,265,265,8,8,0,1,0
0,288,288,41,14,27,2,1
12,289,289,22,4,18,2,1
14,293,293,1,1,0,1,0
29,298,298,9,9,0,1,0
3,306,306,21,13,8,3,2
21,318,318,23,23,0,1,0
11,321,321,47,29,18,4,3
16,333,333,12,3,9,4,3
24,336,336,64,43,21,4,3
22,338,338,20,20,0,1,0
5,370,370,172,163,9,2,1
27,386,386,12,12,0,1,0
26,407,407,57,5,52,3,2
19,439,439,12,12,0,1,0
9,464,464,113,113,0,1,0
6,485,485,11,11,0,1,0

15,115,115,13,10,3,2,1
23,116,116,13,13,0,1,0
2,121,121,12,12,0,1,0
21,139,139,7,7,0,1,0
22,152,152,4,4,0,1,0
37,164,164,21,21,0,1,0
6,173,173,12,2,10,2,1
24,180,180,45,45,0,1,0
29,194,194,25,25,0,1,0
0,197,197,84,67,17,2,1
13,200,200,19,19,0,1,0
3,202,202,24,24,0,1,0
12,220,220,16,16,0,1,0
30,222,222,22,7,15,2,1
9,226,226,1,1,0,1,0
26,241,241,46,28,18,2,1
10,242,242,20,20,0,1,0
18,272,272,67,20,47,2,1
1,278,278,15,15,0,1,0
36,288,288,6,6,0,1,0
14,300,300,4,4,0,1,0
25,318,318,39,1,38,4,3
32,347,347,30,10,20,3,2
16,363,363,41,10,31,4,3
8,370,370,41,41,0,1,0
33,373,373,1,1,0,1,0
31,382,382,8,8,0,1,0
35,393,393,38,14,24,4,3
7,413,413,1,1,0,1,0
17,425,425,2,2,0,1,0
28,427,427,17,4,13,4,3
5,431,431,49,49,0,1,0
4,458,458,19,4,15,3,2
19,462,462,117,117,0,1,0
27,463,463,21,14,7,2,1
34,465,465,46,26,20,3,2
20,483,483,84,84,0,1,0
11,498,498,60,23,37,3,2

19,118,118,3,3,0,1,0
12,130,130,44,29,15,4,3
32,134,134,28,28,0,1,0
15,151,151,27,27,0,1,0
0,170,170,4,4,0,1,0
18,180,180,68,54,14,3,2
6,189,189,5,5,0,1,0
14,197,197,13,13,0,1,0
4,209,209,41,8,33,2,1
1,219,219,24,24,0,1,0
11,236,236,8,8,0,1,0
7,242,242,43,43,0,1,0
5,246,246,15,11,4,2,1
23,249,249,2,2,0,1,0
10,254,254,56,56,0,1,0
33,258,258,13,13,0,1,0
31,267,267,22,22,0,1,0
21,271,271,12,3,9,4,3
16,273,273,2,2,0,1,0
24,286,286,16,16,0,1,0
3,289,289,22,22,0,1,0
22,294,294,13,13,0,1,0
35,319,319,49,31,18,2,1
28,320,320,14,8,6,3,2
2,361,361,1,1,0,1,0
34,377,377,20,6,14,2,1
25,396,396,38,38,0,1,0
17,397,397,44,44,0,1,0
13,401,401,46,46,0,1,0
8,409,409,35,14,21,4,3
29,418,418,16,16,0,1,0
30,446,446,28,4,24,4,3
27,450,450,74,74,0,1,0
9,470,470,34,23,11,2,1
20,475,475,67,8,59,4,3
36,483,483,97,97,0,1,0
26,491,491,40,34,6,2,1

35,139,139,20,13,7,2,1
15,148,148,18,18,0,1,0
38,149,149,17,17,0,1,0
11,151,151,15,15,0,1,0
7,169,169,6,1,5,2,1
2,175,175,27,6,21,4,3
32,178,178,16,4,12,3,2
12,179,179,6,6,0,1,0
26,182,182,16,16,0,1,0
36,196,196,18,5,13,2,1
20,198,198,18,15,3,2,1
17,214,214,14,14,0,1,0
25,219,219,8,8,0,1,0
14,229,229,93,39,54,4,3
4,231,231,5,5,0,1,0
21,243,243,30,30,0,1,0
33,253,253,26,26,0,1,0
18,254,254,31,31,0,1,0
8,263,263,28,16,12,2,1
5,267,267,4,4,0,1,0
10,279,279,5,2,3,2,1
27,282,282,2,2,0,1,0
16,294,294,12,2,10,3,2
3,295,295,130,46,84,4,3
1,327,327,4,1,3,2,1
19,361,361,9,4,5,2,1
23,364,364,59,10,49,2,1
34,370,370,32,14,18,4,3
28,380,380,13,5,8,3,2
6,392,392,4,1,3,2,1
24,394,394,86,50,36,4,3
0,395,395,18,12,6,2,1
29,404,404,11,11,0,1,0
30,428,428,20,5,15,4,3
31,433,433,67,6,61,4,3
13,447,447,51,51,0,1,0
22,461,461,123,33,90,3,2
9,465,465,7,7,0,1,0
37,488,488,25,25,0,1,0

5,110,110,15,11,4,2,1
1,111,111,45,3,42,2,1
20,121,121,27,27,0,1,0
31,125,125,1,1,0,1,0
7,156,156,5,5,0,1,0
13,166,166,30,30,0,1,0
15,173,173,18,18,0,1,0
16,179,179,49,49,0,1,0
10,197,197,28,25,3,2,1
24,207,207,36,36,0,1,0
11,228,228,15,15,0,1,0
28,229,229,8,8,0,1,0
22,236,236,28,6,22,2,1
0,241,241,41,15,26,4,3
26,242,242,24,2,22,2,1
8,258,258,9,9,0,1,0
17,262,262,21,3,18,3,2
2,270,270,40,40,0,1,0
25,294,294,27,27,0,1,0
3,302,302,19,19,0,1,0
19,309,309,17,5,12,4,3
33,311,311,17,17,0,1,0
21,316,316,15,12,3,2,1
29,317,317,26,2,24,2,1
12,321,321,50,39,11,2,1
9,334,334,42,18,24,3,2
30,343,343,28,25,3,2,1
4,376,376,12,12,0,1,0
18,398,398,16,16,0,1,0
27,410,410,9,9,0,1,0
23,428,428,16,16,0,1,0
6,441,441,10,10,0,1,0
14,456,456,85,19,66,3,2
32,464,464,142,84,58,4,3

18,100,100,1,1,0,1,0
11,105,105,23,23,0,1,0
19,114,114,10,10,0,1,0
10,117,117,1,1,0,1,0
20,143,143,1,1,0,1,0
16,155,155,3,3,0,1,0
12,176,176,5,2,3,2,1
26,184,184,15,15,0,1,0
7,187,187,17,7,10,2,1
22,195,195,36,9,27,2,1
14,196,196,1,1,0,1,0
30,206,206,66,66,0,1,0
27,214,214,14,3,11,2,1
17,217,217,6,6,0,1,0
29,217,217,4,4,0,1,0
4,220,220,30,30,0,1,0
1,234,234,33,5,28,3,2
25,240,240,52,27,25,2,1
23,250,250,5,5,0,1,0
34,277,277,21,15,6,2,1
0,307,307,53,46,7,2,1
24,314,314,4,4,0,1,0
28,329,329,10,10,0,1,0
33,340,340,91,21,70,3,2
2,364,364,116,80,36,4,3
3,393,393,79,6,73,4,3
6,404,404,31,31,0,1,0
15,428,428,54,7,47,2,1
21,431,431,29,29,0,1,0
31,433,433,110,14,96,4,3
13,444,444,56,24,32,3,2
5,462,462,2,2,0,1,0
8,482,482,34,4,30,2,1
9,495,495,87,87,0,1,0
32,499,499,90,42,48,2,1

19,104,104,7,7,0,1,0
40,105,105,18,9,9,2,1
18,119,119,14,14,0,1,0
3,123,123,5,5,0,1,0
17,134,134,1,1,0,1,0
25,135,135,29,29,0,1,0
36,138,138,1,1,0,1,0
22,140,140,21,18,3,2,1
28,151,151,11,5,6,3,2
2,168,168,5,5,0,1,0
43,177,177,36,36,0,1,0
9,182,182,21,9,12,2,1
29,190,190,28,2,26,3,2
6,192,192,5,5,0,1,0
37,201,201,28,6,22,2,1
15,212,212,69,39,30,4,3
10,216,216,63,63,0,1,0
30,224,224,43,7,36,4,3
12,226,226,7,7,0,1,0
41,250,250,3,3,0,1,0
34,259,259,9,9,0,1,0
0,261,261,5,5,0,1,0
5,266,266,1,1,0,1,0
24,275,275,3,3,0,1,0
33,292,292,12,7,5,2,1
1,311,311,36,26,10,2,1
32,316,316,55,11,44,2,1
23,318,318,27,3,24,3,2
13,321,321,6,6,0,1,0
31,340,340,21,21,0,1,0
39,345,345,2,2,0,1,0
20,358,358,26,3,23,2,1
7,411,411,90,90,0,1,0
38,415,415,3,3,0,1,0
21,426,426,3,3,0,1,0
16,429,429,22,13,9,2,1
11,454,454,6,6,0,1,0
4,456,456,3,3,0,1,0
35,464,464,92,61,31,2,1
8,469,469,20,20,0,1,0
27,480,480,2,2,0,1,0
42,488,488,58,58,0,1,0
26,493,493,68,34,34,2,1
14,496,496,17,17,0,1,0

22,102,102,10,7,3,2,1
21,176,176,29,6,23,2,1
34,198,198,2,2,0,1,0
3,210,210,18,18,0,1,0
8,216,216,16,16,0,1,0
18,219,219,5,5,0,1,0
10,245,245,19,11,8,3,2
25,249,249,23,7,16,4,3
27,273,273,20,15,5,2,1
13,286,286,4,4,0,1,0
26,287,287,19,19,0,1,0
33,291,291,15,5,10,2,1
23,291,291,3,3,0,1,0
7,306,306,1,1,0,1,0
16,308,308,50,50,0,1,0
0,313,313,42,42,0,1,0
17,340,340,38,4,34,4,3
15,343,343,73,52,21,4,3
29,352,352,19,19,0,1,0
6,354,354,5,2,3,2,1
20,359,359,78,8,70,4,3
1,360,360,106,67,39,4,3
31,377,377,55,30,25,2,1
14,381,381,8,8,0,1,0
4,388,388,2,2,0,1,0
12,394,394,125,32,93,4,3
9,405,405,6,1,5,2,1
28,411,411,46,46,0,1,0
32,427,427,83,23,60,4,3
5,438,438,28,3,25,2,1
30,447,447,152,126,26,3,2
35,450,450,27,27,0,1,0
2,476,476,154,110,44,3,2
24,480,480,11,11,0,1,0
11,484,484,40,14,26,2,1
19,496,496,40,40,0,1,0

2,100,100,8,8,0,1,0
7,101,101,7,1,6,3,2
5,104,104,7,7,0,1,0
1,111,111,13,3,10,3,2
33,119,119,21,3,18,3,2
37,152,152,11,3,8,3,2
4,164,164,20,20,0,1,0
32,168,168,1,1,0,1,0
8,174,174,1,1,0,1,0
0,195,195,20,8,12,3,2
20,195,195,26,26,0,1,0
39,196,196,79,55,24,2,1
36,209,209,39,39,0,1,0
13,215,215,34,8,26,3,2
21,216,216,22,10,12,4,3
19,250,250,7,7,0,1,0
18,259,259,19,19,0,1,0
27,263,263,40,14,26,2,1
17,270,270,1,1,0,1,0
25,276,276,1,1,0,1,0
40,287,287,16,16,0,1,0
31,299,299,12,8,4,2,1
23,335,335,88,78,10,3,2
14,339,339,28,3,25,3,2
34,345,345,2,2,0,1,0
30,347,347,11,1,10,2,1
29,355,355,27,27,0,1,0
15,357,357,28,3,25,2,1
3,362,362,74,74,0,1,0
12,368,368,67,67,0,1,0
10,392,392,6,6,0,1,0
26,400,400,2,2,0,1,0
38,410,410,74,74,0,1,0
16,426,426,58,3,55,4,3
22,447,447,29,16,13,2,1
28,461,461,17,3,14,2,1
6,467,467,1,1,0,1,0
11,474,474,50,50,0,1,0
9,485,485,17,7,10,2,1
24,487,487,35,35,0,1,0
35,489,489,47,14,33,4,3

29,114,114,6,2,4,2,1
26,132,132,61,33,28,2,1
28,151,151,8,8,0,1,0
34,154,154,11,11,0,1,0
30,157,157,8,3,5,2,1
4,157,157,17,17,0,1,0
12,172,172,13,1,12,4,3
32,186,186,13,13,0,1,0
7,190,190,11,8,3,2,1
23,205,205,46,46,0,1,0
3,206,206,29,3,26,3,2
11,233,233,31,2,29,2,1
18,258,258,14,14,0,1,0
20,260,260,19,2,17,2,1
19,290,290,72,25,47,2,1
35,292,292,49,32,17,2,1
33,311,311,17,11,6,2,1
16,316,316,107,43,64,3,2
1,316,316,38,38,0,1,0
10,328,328,68,21,47,2,1
21,335,335,14,2,12,4,3
13,354,354,14,14,0,1,0
27,356,356,36,36,0,1,0
15,364,364,5,2,3,2,1
6,391,391,137,44,93,4,3
2,392,392,1,1,0,1,0
25,393,393,13,5,8,2,1
14,405,405,52,30,22,3,2
9,414,414,2,2,0,1,0
8,416,416,7,2,5,2,1
5,423,423,29,11,18,4,3
24,458,458,34,34,0,1,0
22,459,459,2,2,0,1,0
17,471,471,21,21,0,1,0
0,480,480,45,45,0,1,0
31,490,490,35,35,0,1,0

47,130,130,1,1,0,1,0
35,133,133,8,1,7,2,1
29,136,136,1,1,0,1,0
48,139,139,1,1,0,1,0
21,144,144,1,1,0,1,0
50,155,155,50,8,42,3,2
36,160,160,1,1,0,1,0
10,171,171,2,2,0,1,0
40,173,173,2,2,0,1,0
53,179,179,24,24,0,1,0
14,182,182,4,4,0,1,0
43,189,189,22,22,0,1,0
41,189,189,5,5,0,1,0
8,194,194,1,1,0,1,0
49,195,195,4,4,0,1,0
5,211,211,34,24,10,2,1
42,225,225,10,10,0,1,0
19,226,226,3,3,0,1,0
22,243,243,2,2,0,1,0
1,252,252,6,6,0,1,0
9,256,256,19,4,15,3,2
2,257,257,19,19,0,1,0
34,261,261,32,21,11,2,1
38,261,261,40,21,19,2,1
17,272,272,32,32,0,1,0
32,277,277,21,21,0,1,0
28,280,280,65,20,45,4,3
52,297,297,91,91,0,1,0
27,297,297,13,3,10,2,1
31,298,298,1,1,0,1,0
26,303,303,5,5,0,1,0
39,312,312,124,124,0,1,0
16,312,312,4,4,0,1,0
4,321,321,41,13,28,2,1
18,332,332,1,1,0,1,0
33,342,342,26,26,0,1,0
37,370,370,24,15,9,4,3
15,375,375,7,7,0,1,0
6,376,376,47,11,36,2,1
0,383,383,7,1,6,2,1
45,383,383,25,4,21,2,1
46,404,404,36,2,34,3,2
3,407,407,2,2,0,1,0
23,410,410,15,11,4,2,1
7,420,420,3,3,0,1,0
11,425,425,36,16,20,2,1
12,445,445,98,98,0,1,0
13,450,450,10,2,8,3,2
24,457,457,11,11,0,1,0
30,470,470,3,3,0,1,0
20,471,471,43,14,29,2,1
51,477,477,39,29,10,2,1
44,480,480,23,14,9,4,3
25,480,480,1,1,0,1,0

26,100,100,14,8,6,2,1
27,116,116,27,27,0,1,0
23,139,139,31,13,18,3,2
24,182,182,12,6,6,2,1
10,187,187,7,7,0,1,0
16,188,188,2,2,0,1,0
36,190,190,22,6,16,2,1
0,196,196,1,1,0,1,0
33,198,198,23,1,22,2,1
20,199,199,47,5,42,2,1
2,207,207,1,1,0,1,0
12,210,210,4,1,3,2,1
3,210,210,20,20,0,1,0
19,214,214,11,1,10,2,1
28,218,218,17,8,9,4,3
17,227,227,34,11,23,2,1
37,230,230,17,2,15,2,1
35,239,239,20,20,0,1,0
21,256,256,89,89,0,1,0
13,278,278,6,6,0,1,0
22,293,293,43,43,0,1,0
40,308,308,62,62,0,1,0
41,311,311,58,13,45,4,3
31,329,329,3,3,0,1,0
29,332,332,44,35,9,2,1
25,353,353,35,8,27,2,1
18,355,355,27,27,0,1,0
38,361,361,46,25,21,4,3
4,363,363,8,5,3,2,1
34,364,364,6,6,0,1,0
15,364,364,54,54,0,1,0
1,395,395,29,29,0,1,0
30,408,408,3,3,0,1,0
39,414,414,3,3,0,1,0
7,414,414,40,40,0,1,0
5,428,428,6,6,0,1,0
11,444,444,29,29,0,1,0
32,453,453,10,10,0,1,0
9,455,455,114,81,33,2,1
8,474,474,6,6,0,1,0
14,494,494,3,3,0,1,0
6,497,497,6,6,0,1,0

19,111,111,28,28,0,1,0
20,111,111,13,5,8,2,1
23,119,119,2,2,0,1,0
25,126,126,29,29,0,1,0
16,130,130,7,7,0,1,0
15,150,150,34,34,0,1,0
34,154,154,37,37,0,1,0
13,158,158,3,3,0,1,0
26,173,173,18,4,14,3,2
35,181,181,4,4,0,1,0
2,184,184,37,37,0,1,0
7,192,192,12,4,8,2,1
6,199,199,26,22,4,2,1
12,216,216,22,14,8,3,2
3,224,224,26,9,17,2,1
21,225,225,37,4,33,2,1
22,229,229,1,1,0,1,0
33,231,231,23,2,21,2,1
8,244,244,24,21,3,2,1
31,246,246,8,2,6,2,1
18,280,280,35,35,0,1,0
29,284,284,34,34,0,1,0
27,289,289,52,52,0,1,0
10,308,308,1,1,0,1,0
0,312,312,115,34,81,4,3
32,330,330,47,26,21,4,3
30,330,330,3,3,0,1,0
28,332,332,16,16,0,1,0
24,335,335,4,4,0,1,0
14,348,348,15,2,13,2,1
11,383,383,19,19,0,1,0
5,406,406,71,58,13,2,1
1,438,438,80,80,0,1,0
17,459,459,9,1,8,2,1
4,488,488,24,24,0,1,0
9,492,492,12,3,9,4,3

31,113,113,1,1,0,1,0
4,116,116,17,2,15,4,3
29,138,138,26,26,0,1,0
7,138,138,1,1,0,1,0
6,158,158,2,2,0,1,0
15,165,165,23,23,0,1,0
32,183,183,71,15,56,3,2
24,185,185,9,9,0,1,0
10,206,206,16,16,0,1,0
17,231,231,13,13,0,1,0
28,244,244,8,8,0,1,0
21,247,247,14,2,12,2,1
35,254,254,36,21,15,4,3
1,257,257,1,1,0,1,0
8,257,257,10,1,9,4,3
0,259,259,38,38,0,1,0
39,260,260,9,1,8,2,1
30,282,282,67,21,46,3,2
40,291,291,10,3,7,2,1
36,306,306,36,36,0,1,0
19,314,314,25,25,0,1,0
14,343,343,4,4,0,1,0
33,352,352,15,3,12,3,2
13,375,375,96,74,22,2,1
27,391,391,43,43,0,1,0
26,395,395,69,69,0,1,0
37,397,397,7,7,0,1,0
3,407,407,27,27,0,1,0
2,409,409,14,14,0,1,0
41,410,410,88,88,0,1,0
16,411,411,33,13,20,2,1
42,416,416,6,6,0,1,0
38,419,419,8,2,6,2,1
20,420,420,1,1,0,1,0
25,426,426,38,24,14,2,1
22,427,427,37,37,0,1,0
18,439,439,30,30,0,1,0
9,445,445,55,44,11,3,2
34,449,449,4,4,0,1,0
5,460,460,24,24,0,1,0
11,475,475,52,34,18,3,2
12,485,485,56,17,39,4,3
23,494,494,64,64,0,1,0

17,109,109,14,14,0,1,0
31,109,109,11,11,0,1,0
7,115,115,6,6,0,1,0
27,135,135,6,6,0,1,0
9,149,149,8,2,6,3,2
15,157,157,8,8,0,1,0
12,160,160,3,3,0,1,0
11,171,171,5,5,0,1,0
23,175,175,25,13,12,4,3
16,185,185,28,18,10,2,1
20,192,192,20,20,0,1,0
4,208,208,22,22,0,1,0
2,209,209,9,9,0,1,0
6,210,210,31,31,0,1,0
21,210,210,15,15,0,1,0
19,215,215,14,14,0,1,0
40,234,234,28,10,18,2,1
36,244,244,4,4,0,1,0
32,274,274,24,24,0,1,0
8,285,285,20,20,0,1,0
38,297,297,12,12,0,1,0
42,304,304,24,16,8,3,2
30,310,310,79,28,51,4,3
5,311,311,5,5,0,1,0
39,330,330,28,16,12,3,2
14,355,355,3,3,0,1,0
3,368,368,14,8,6,2,1
13,380,380,45,45,0,1,0
10,382,382,103,103,0,1,0
41,386,386,81,50,31,2,1
25,399,399,56,36,20,2,1
34,402,402,4,4,0,1,0
35,410,410,25,14,11,2,1
29,420,420,106,70,36,3,2
1,425,425,1,1,0,1,0
33,427,427,124,124,0,1,0
37,444,444,17,5,12,2,1
22,445,445,19,19,0,1,0
26,449,449,27,27,0,1,0
24,452,452,14,4,10,2,1
0,458,458,57,5,52,3,2
28,468,468,1,1,0,1,0
18,477,477,22,14,8,3,2

21,100,100,7,7,0,1,0
18,115,115,22,7,15,4,3
5,123,123,1,1,0,1,0
0,127,127,11,8,3,2,1
8,132,132,5,1,4,2,1
4,138,138,10,1,9,4,3
33,141,141,18,18,0,1,0
32,156,156,21,21,0,1,0
28,180,180,49,49,0,1,0
1,190,190,20,20,0,1,0
20,204,204,22,22,0,1,0
12,210,210,32,32,0,1,0
14,218,218,26,26,0,1,0
7,227,227,10,10,0,1,0
29,230,230,46,10,36,4,3
30,242,242,19,11,8,2,1
13,248,248,31,7,24,2,1
3,257,257,4,4,0,1,0
40,271,271,21,21,0,1,0
11,281,281,1,1,0,1,0
26,287,287,30,30,0,1,0
36,288,288,23,23,0,1,0
9,297,297,38,29,9,2,1
2,302,302,22,22,0,1,0
16,310,310,20,7,13,4,3
31,312,312,44,20,24,2,1
10,313,313,2,2,0,1,0
6,324,324,29,29,0,1,0
35,327,327,30,9,21,2,1
41,327,327,19,19,0,1,0
25,353,353,48,40,8,3,2
34,391,391,6,6,0,1,0
23,396,396,4,4,0,1,0
38,419,419,10,10,0,1,0
39,429,429,7,3,4,2,1
24,436,436,9,9,0,1,0
15,438,438,55,10,45,4,3
27,446,446,29,29,0,1,0
37,457,457,128,110,18,4,3
19,465,465,10,10,0,1,0
17,474,474,80,80,0,1,0
22,476,476,40,28,12,4,3

20,106,106,23,17,6,2,1
26,113,113,10,4,6,3,2
33,113,113,7,7,0,1,0
23,128,128,11,8,3,2,1
29,134,134,17,1,16,3,2
30,136,136,21,21,0,1,0
5,170,170,2,2,0,1,0
17,171,171,18,18,0,1,0
11,202,202,4,4,0,1,0
4,210,210,18,3,15,4,3
2,221,221,25,5,20,3,2
3,231,231,17,17,0,1,0
28,244,244,24,17,7,2,1
7,244,244,10,10,0,1,0
9,257,257,7,7,0,1,0
22,279,279,12,12,0,1,0
31,296,296,10,6,4,2,1
19,299,299,41,5,36,4,3
27,312,312,72,24,48,3,2
8,327,327,7,1,6,3,2
1,342,342,36,27,9,4,3
32,357,357,6,6,0,1,0
12,359,359,58,15,43,2,1
21,375,375,12,4,8,2,1
34,393,393,54,54,0,1,0
16,398,398,41,9,32,2,1
18,400,400,48,48,0,1,0
10,433,433,49,1,48,4,3
0,434,434,46,46,0,1,0
24,450,450,9,9,0,1,0
6,450,450,286,240,46,3,2
25,454,454,48,48,0,1,0
13,469,469,51,19,32,4,3
35,472,472,62,62,0,1,0
15,477,477,10,10,0,1,0
14,480,480,74,74,0,1,0

26,100,100,7,7,0,1,0
3,102,102,1,1,0,1,0
12,107,107,14,14,0,1,0
22,115,115,32,16,16,3,2
40,119,119,23,23,0,1,0
25,144,144,4,4,0,1,0
7,148,148,1,1,0,1,0
27,151,151,8,3,5,2,1
17,160,160,15,15,0,1,0
24,164,164,15,15,0,1,0
38,166,166,5,5,0,1,0
23,186,186,11,7,4,2,1
19,192,192,1,1,0,1,0
13,208,208,69,18,51,4,3
8,227,227,1,1,0,1,0
29,248,248,36,9,27,2,1
16,255,255,1,1,0,1,0
37,284,284,31,13,18,3,2
21,296,296,7,7,0,1,0
10,318,318,41,13,28,2,1
0,335,335,10,10,0,1,0
35,352,352,71,57,14,3,2
30,362,362,65,65,0,1,0
33,363,363,5,5,0,1,0
9,365,365,49,49,0,1,0
31,367,367,47,29,18,2,1
2,376,376,73,58,15,4,3
20,382,382,12,12,0,1,0
32,386,386,11,11,0,1,0
15,392,392,5,5,0,1,0
28,409,409,61,39,22,2,1
34,416,416,61,34,27,2,1
5,433,433,22,22,0,1,0
18,440,440,18,18,0,1,0
11,442,442,42,24,18,4,3
36,450,450,8,8,0,1,0
4,457,457,125,83,42,4,3
1,457,457,13,13,0,1,0
39,457,457,5,5,0,1,0
14,458,458,121,121,0,1,0
6,485,485,3,3,0,1,0

17,102,102,18,12,6,3,2
9,114,114,21,5,16,2,1
19,119,119,5,5,0,1,0
27,142,142,20,20,0,1,0
10,147,147,13,13,0,1,0
25,149,149,2,2,0,1,0
11,151,151,4,4,0,1,0
24,151,151,11,11,0,1,0
6,160,160,48,48,0,1,0
1,176,176,2,2,0,1,0
13,183,183,19,19,0,1,0
14,186,186,23,1,22,2,1
21,222,222,5,5,0,1,0
12,230,230,7,1,6,2,1
2,261,261,21,21,0,1,0
16,273,273,16,7,9,2,1
8,276,276,85,3,82,3,2
15,282,282,23,3,20,3,2
7,284,284,28,2,26,2,1
5,286,286,55,39,16,3,2
20,302,302,20,20,0,1,0
3,321,321,21,15,6,3,2
28,333,333,27,27,0,1,0
4,334,334,43,43,0,1,0
22,341,341,68,68,0,1,0
26,343,343,61,61,0,1,0
29,394,394,8,8,0,1,0
18,432,432,109,88,21,4,3
0,447,447,173,81,92,3,2
30,460,460,14,14,0,1,0
23,497,497,83,23,60,3,2
31,499,499,54,24,30,2,1

7,144,144,12,7,5,2,1
17,159,159,4,4,0,1,0
32,182,182,34,34,0,1,0
28,186,186,4,4,0,1,0
12,191,191,16,16,0,1,0
36,203,203,19,1,18,2,1
20,233,233,8,2,6,2,1
39,245,245,4,4,0,1,0
2,247,247,4,4,0,1,0
14,257,257,30,9,21,2,1
5,261,261,4,4,0,1,0
27,262,262,2,2,0,1,0
24,267,267,28,24,4,2,1
38,269,269,35,5,30,2,1
29,282,282,97,43,54,4,3
33,296,296,11,11,0,1,0
21,306,306,57,41,16,3,2
19,306,306,65,65,0,1,0
0,308,308,16,16,0,1,0
25,318,318,53,53,0,1,0
11,331,331,51,51,0,1,0
22,337,337,2,2,0,1,0
10,360,360,39,6,33,4,3
18,367,367,82,67,15,4,3
3,388,388,29,29,0,1,0
35,390,390,13,13,0,1,0
31,403,403,9,1,8,2,1
26,415,415,58,12,46,4,3
37,422,422,6,6,0,1,0
1,425,425,8,8,0,1,0
6,443,443,123,114,9,4,3
4,460,460,1,1,0,1,0
30,461,461,36,36,0,1,0
34,461,461,13,2,11,3,2
16,467,467,38,38,0,1,0
15,472,472,3,3,0,1,0
9,478,478,40,16,24,4,3
23,490,490,153,83,70,3,2
13,493,493,72,39,33,4,3
8,496,496,42,42,0,1,0

14,108,108,6,6,0,1,0
23,114,114,6,2,4,2,1
10,117,117,1,1,0,1,0
31,119,119,5,5,0,1,0
28,119,119,36,14,22,3,2
21,119,119,13,1,12,2,1
6,126,126,26,26,0,1,0
1,159,159,1,1,0,1,0
24,195,195,14,2,12,3,2
0,202,202,25,4,21,4,3
34,206,206,7,7,0,1,0
37,212,212,46,2,44,3,2
11,248,248,1,1,0,1,0
5,255,255,9,3,6,3,2
32,261,261,9,9,0,1,0
35,263,263,15,15,0,1,0
15,277,277,6,6,0,1,0
19,294,294,4,1,3,2,1
22,304,304,19,19,0,1,0
29,314,314,56,14,42,3,2
36,315,315,51,13,38,3,2
27,321,321,10,6,4,2,1
33,331,331,8,8,0,1,0
25,332,332,34,2,32,4,3
30,337,337,14,8,6,2,1
16,353,353,1,1,0,1,0
9,361,361,17,5,12,4,3
18,372,372,28,9,19,2,1
20,382,382,20,3,17,2,1
12,399,399,35,9,26,2,1
7,399,399,111,37,74,3,2
38,422,422,12,9,3,2,1
26,438,438,27,27,0,1,0
13,448,448,20,2,18,4,3
8,461,461,82,82,0,1,0
4,465,465,37,37,0,1,0
3,466,466,159,9,150,4,3
17,475,475,56,27,29,4,3
39,484,484,161,78,83,4,3
2,492,492,60,60,0,1,0

5,106,106,3,3,0,1,0
20,112,112,6,6,0,1,0
28,123,123,14,14,0,1,0
35,132,132,17,17,0,1,0
1,136,136,8,8,0,1,0
4,137,137,1,1,0,1,0
8,139,139,1,1,0,1,0
3,160,160,3,3,0,1,0
30,167,167,28,12,16,4,3
12,181,181,66,66,0,1,0
9,185,185,34,16,18,4,3
2,192,192,7,7,0,1,0
17,216,216,44,2,42,2,1
33,230,230,16,7,9,2,1
37,235,235,44,44,0,1,0
23,237,237,1,1,0,1,0
0,249,249,6,6,0,1,0
15,251,251,76,76,0,1,0
32,264,264,12,12,0,1,0
36,265,265,6,6,0,1,0
19,284,284,21,4,17,2,1
16,286,286,2,2,0,1,0
13,287,287,7,4,3,2,1
24,288,288,45,45,0,1,0
21,315,315,3,3,0,1,0
6,322,322,17,5,12,4,3
34,327,327,19,3,16,3,2
29,396,396,31,31,0,1,0
27,405,405,51,23,28,3,2
11,411,411,155,135,20,2,1
14,422,422,24,3,21,4,3
22,438,438,22,12,10,2,1
18,442,442,6,6,0,1,0
7,451,451,21,16,5,2,1
26,474,474,185,101,84,3,2
25,486,486,44,28,16,3,2
10,494,494,43,11,32,2,1
31,497,497,57,57,0,1,0

2,106,106,7,7,0,1,0
16,121,121,7,7,0,1,0
40,132,132,21,21,0,1,0
12,149,149,14,2,12,2,1
17,157,157,6,6,0,1,0
22,201,201,8,8,0,1,0
18,230,230,3,3,0,1,0
26,231,231,4,4,0,1,0
13,250,250,11,11,0,1,0
9,254,254,5,5,0,1,0
15,256,256,8,8,0,1,0
28,258,258,10,10,0,1,0
7,275,275,1,1,0,1,0
33,279,279,17,17,0,1,0
21,296,296,17,1,16,2,1
31,310,310,19,16,3,2,1
35,315,315,55,37,18,4,3
37,315,315,16,16,0,1,0
32,325,325,1,1,0,1,0
3,328,328,3,3,0,1,0
5,328,328,17,9,8,2,1
29,334,334,3,3,0,1,0
10,337,337,1,1,0,1,0
19,343,343,66,66,0,1,0
39,351,351,129,129,0,1,0
34,353,353,6,6,0,1,0
6,354,354,61,49,12,2,1
0,356,356,36,24,12,4,3
1,359,359,18,18,0,1,0
41,384,384,19,19,0,1,0
24,400,400,119,119,0,1,0
25,408,408,97,57,40,3,2
4,431,431,77,22,55,4,3
11,431,431,193,193,0,1,0
27,432,432,17,17,0,1,0
14,439,439,15,15,0,1,0
30,444,444,3,3,0,1,0
36,460,460,86,44,42,3,2
23,464,464,68,34,34,3,2
20,464,464,10,1,9,2,1
8,484,484,86,50,36,4,3
38,490,490,6,6,0,1,0

18,109,109,9,9,0,1,0
19,135,135,12,12,0,1,0
1,140,140,7,7,0,1,0
33,149,149,10,10,0,1,0
31,160,160,5,2,3,2,1
7,169,169,41,41,0,1,0
5,188,188,22,14,8,2,1
23,209,209,4,4,0,1,0
2,212,212,5,1,4,2,1
11,212,212,5,2,3,2,1
21,248,248,15,15,0,1,0
17,284,284,6,6,0,1,0
8,293,293,48,39,9,4,3
29,300,300,25,25,0,1,0
9,305,305,16,7,9,4,3
26,321,321,29,12,17,2,1
34,326,326,204,156,48,2,1
27,334,334,3,3,0,1,0
35,355,355,10,10,0,1,0
10,368,368,5,5,0,1,0
20,370,370,14,14,0,1,0
32,382,382,19,7,12,4,3
25,387,387,43,18,25,2,1
6,393,393,7,4,3,2,1
3,397,397,47,1,46,3,2
14,400,400,135,65,70,4,3
22,402,402,77,47,30,4,3
13,405,405,43,43,0,1,0
28,427,427,15,9,6,3,2
30,428,428,119,91,28,3,2
0,463,463,1,1,0,1,0
16,467,467,47,5,42,4,3
15,475,475,99,99,0,1,0
24,475,475,10,1,9,2,1
4,489,489,108,70,38,3,2
12,493,493,50,23,27,2,1

32,102,102,19,1,18,3,2
21,120,120,36,31,5,2,1
25,121,121,28,10,18,4,3
0,124,124,4,4,0,1,0
1,130,130,8,8,0,1,0
36,140,140,7,1,6,3,2
22,146,146,3,3,0,1,0
4,177,177,13,13,0,1,0
31,195,195,42,18,24,3,2
38,198,198,1,1,0,1,0
23,207,207,9,9,0,1,0
29,230,230,7,7,0,1,0
19,237,237,31,7,24,3,2
10,237,237,14,8,6,2,1
26,253,253,2,2,0,1,0
2,260,260,49,49,0,1,0
27,281,281,33,3,30,4,3
34,302,302,4,4,0,1,0
8,308,308,69,6,63,4,3
28,312,312,3,3,0,1,0
24,320,320,5,5,0,1,0
11,340,340,27,3,24,3,2
6,340,340,22,22,0,1,0
17,343,343,2,2,0,1,0
33,350,350,80,50,30,2,1
18,358,358,9,6,3,2,1
14,370,370,25,25,0,1,0
7,372,372,39,29,10,2,1
5,382,382,11,11,0,1,0
37,390,390,17,17,0,1,0
13,404,404,52,52,0,1,0
15,432,432,99,15,84,4,3
20,432,432,56,56,0,1,0
35,448,448,126,126,0,1,0
12,455,455,35,35,0,1,0
3,490,490,25,5,20,2,1
16,495,495,97,49,48,2,1
30,497,497,7,7,0,1,0
9,498,498,37,37,0,1,0

4,103,103,6,6,0,1,0
13,109,109,1,1,0,1,0
32,109,109,14,2,12,4,3
18,110,110,21,6,15,4,3
20,114,114,5,5,0,1,0
0,118,118,17,17,0,1,0
30,129,129,32,23,9,4,3
16,129,129,16,1,15,3,2
12,143,143,7,1,6,2,1
23,153,153,5,5,0,1,0
34,175,175,12,12,0,1,0
11,187,187,12,5,7,2,1
8,187,187,8,8,0,1,0
5,199,199,10,10,0,1,0
31,208,208,30,30,0,1,0
21,209,209,4,1,3,2,1
36,211,211,5,5,0,1,0
33,214,214,22,6,16,3,2
10,223,223,22,13,9,4,3
35,231,231,1,1,0,1,0
6,244,244,5,2,3,2,1
1,286,286,6,6,0,1,0
28,291,291,42,42,0,1,0
7,300,300,1,1,0,1,0
26,316,316,99,15,84,4,3
2,325,325,48,24,24,4,3
14,338,338,1,1,0,1,0
17,340,340,80,68,12,2,1
19,367,367,6,6,0,1,0
38,384,384,37,11,26,3,2
3,400,400,150,100,50,3,2
29,408,408,40,13,27,4,3
27,426,426,88,30,58,3,2
22,426,426,3,3,0,1,0
24,434,434,38,22,16,3,2
25,449,449,10,4,6,3,2
15,468,468,21,5,16,2,1
37,485,485,76,38,38,2,1
9,490,490,99,87,12,3,2

29,100,100,9,3,6,2,1
15,113,113,3,3,0,1,0
26,114,114,12,2,10,3,2
32,116,116,3,3,0,1,0
27,128,128,22,22,0,1,0
24,136,136,19,19,0,1,0
20,191,191,19,19,0,1,0
10,194,194,32,32,0,1,0
0,204,204,9,6,3,2,1
23,217,217,11,1,10,3,2
1,225,225,29,29,0,1,0
35,236,236,10,10,0,1,0
4,251,251,23,4,19,2,1
34,258,258,14,5,9,2,1
33,264,264,49,24,25,2,1
13,277,277,39,39,0,1,0
39,288,288,36,14,22,3,2
22,295,295,116,116,0,1,0
12,300,300,14,3,11,2,1
2,318,318,81,23,58,3,2
25,329,329,6,6,0,1,0
28,337,337,30,1,29,3,2
14,342,342,9,9,0,1,0
38,350,350,8,8,0,1,0
36,357,357,23,8,15,2,1
40,380,380,44,3,41,2,1
17,384,384,7,7,0,1,0
30,409,409,46,14,32,3,2
9,411,411,83,57,26,3,2
16,438,438,23,15,8,2,1
6,442,442,37,19,18,4,3
7,444,444,17,5,12,4,3
11,456,456,2,2,0,1,0
5,457,457,6,6,0,1,0
8,470,470,57,57,0,1,0
37,471,471,6,6,0,1,0
3,486,486,35,35,0,1,0
18,489,489,46,46,0,1,0
31,490,490,63,63,0,1,0
21,492,492,69,45,24,3,2
19,496,496,18,2,16,4,3

34,106,106,10,2,8,2,1
15,115,115,1,1,0,1,0
13,120,120,1,1,0,1,0
14,131,131,19,14,5,2,1
38,148,148,25,3,22,3,2
28,152,152,3,3,0,1,0
12,156,156,17,8,9,4,3
23,171,171,23,23,0,1,0
19,171,171,1,1,0,1,0
11,178,178,11,11,0,1,0
18,190,190,14,14,0,1,0
2,196,196,10,10,0,1,0
3,196,196,11,8,3,2,1
29,220,220,2,2,0,1,0
30,222,222,30,21,9,4,3
5,238,238,1,1,0,1,0
6,240,240,21,11,10,3,2
16,242,242,79,7,72,3,2
41,250,250,29,29,0,1,0
31,270,270,6,6,0,1,0
37,281,281,9,9,0,1,0
22,287,287,14,6,8,2,1
0,287,287,2,2,0,1,0
26,288,288,99,99,0,1,0
1,292,292,37,30,7,2,1
20,301,301,56,56,0,1,0
27,305,305,5,5,0,1,0
39,311,311,41,41,0,1,0
9,333,333,115,67,48,3,2
33,346,346,64,64,0,1,0
17,372,372,16,2,14,2,1
32,376,376,53,35,18,2,1
21,383,383,7,3,4,2,1
40,395,395,15,3,12,3,2
35,413,413,10,10,0,1,0
8,420,420,44,44,0,1,0
4,426,426,12,12,0,1,0
25,466,466,72,22,50,2,1
7,471,471,26,26,0,1,0
36,475,475,30,6,24,2,1
24,490,490,51,51,0,1,0
10,499,499,1,1,0,1,0

36,114,114,4,4,0,1,0
15,157,157,2,2,0,1,0
33,187,187,8,4,4,2,1
8,203,203,35,35,0,1,0
11,208,208,10,6,4,2,1
6,211,211,19,19,0,1,0
31,215,215,15,2,13,4,3
30,254,254,10,2,8,3,2
24,255,255,1,1,0,1,0
22,260,260,3,3,0,1,0
26,281,281,1,1,0,1,0
13,290,290,21,6,15,3,2
25,296,296,14,4,10,3,2
16,304,304,9,4,5,2,1
2,306,306,34,34,0,1,0
10,313,313,53,5,48,4,3
35,317,317,1,1,0,1,0
4,321,321,21,15,6,3,2
9,327,327,106,65,41,2,1
32,334,334,5,5,0,1,0
12,340,340,80,80,0,1,0
20,341,341,111,111,0,1,0
17,362,362,41,41,0,1,0
29,373,373,182,155,27,4,3
19,389,389,57,16,41,2,1
34,398,398,83,83,0,1,0
3,405,405,12,12,0,1,0
14,408,408,34,16,18,4,3
27,430,430,6,6,0,1,0
28,438,438,47,27,20,2,1
1,458,458,4,1,3,2,1
0,459,459,1,1,0,1,0
5,461,461,75,75,0,1,0
21,465,465,64,64,0,1,0
23,467,467,37,5,32,2,1
7,484,484,83,83,0,1,0
18,495,495,72,3,69,3,2

16,126,126,13,7,6,2,1
22,136,136,21,14,7,2,1
3,153,153,8,8,0,1,0
13,155,155,2,2,0,1,0
29,163,163,9,6,3,2,1
17,166,166,49,49,0,1,0
32,169,169,20,3,17,3,2
14,181,181,8,8,0,1,0
33,184,184,22,3,19,4,3
4,193,193,55,15,40,4,3
26,195,195,7,7,0,1,0
19,224,224,6,6,0,1,0
18,236,236,28,14,14,2,1
7,239,239,76,66,10,3,2
35,253,253,8,3,5,2,1
12,260,260,24,13,11,2,1
15,264,264,71,71,0,1,0
0,265,265,31,31,0,1,0
11,266,266,13,13,0,1,0
31,270,270,61,31,30,4,3
30,272,272,8,4,4,2,1
10,282,282,20,10,10,3,2
5,339,339,33,33,0,1,0
20,347,347,5,5,0,1,0
6,364,364,34,5,29,2,1
21,373,373,6,3,3,2,1
28,381,381,80,80,0,1,0
23,418,418,48,48,0,1,0
9,419,419,33,6,27,4,3
34,446,446,82,25,57,4,3
8,449,449,30,10,20,4,3
25,456,456,10,2,8,3,2
2,461,461,2,2,0,1,0
24,475,475,57,57,0,1,0
27,479,479,23,23,0,1,0
1,496,496,73,73,0,1,0

36,112,112,18,9,9,2,1
32,114,114,27,9,18,2,1
37,122,122,2,2,0,1,0
17,128,128,38,23,15,4,3
21,141,141,27,3,24,3,2
34,152,152,44,44,0,1,0
0,204,204,26,17,9,2,1
19,211,211,3,3,0,1,0
4,219,219,2,2,0,1,0
15,238,238,48,11,37,2,1
26,263,263,2,2,0,1,0
1,278,278,2,2,0,1,0
11,283,283,15,15,0,1,0
40,289,289,96,12,84,4,3
12,300,300,30,5,25,2,1
14,305,305,13,13,0,1,0
28,314,314,10,10,0,1,0
6,315,315,6,6,0,1,0
38,321,321,2,2,0,1,0
31,326,326,14,14,0,1,0
27,331,331,33,33,0,1,0
9,343,343,6,3,3,2,1
8,349,349,90,68,22,3,2
3,362,362,53,53,0,1,0
7,375,375,22,15,7,2,1
18,397,397,5,5,0,1,0
29,398,398,14,14,0,1,0
22,405,405,28,13,15,4,3
20,407,407,30,12,18,4,3
10,413,413,1,1,0,1,0
16,426,426,36,36,0,1,0
2,436,436,12,12,0,1,0
25,444,444,19,10,9,4,3
30,450,450,1,1,0,1,0
33,463,463,23,17,6,3,2
39,476,476,22,22,0,1,0
5,477,477,62,47,15,2,1
24,480,480,42,42,0,1,0
23,481,481,21,9,12,4,3
35,491,491,161,68,93,4,3
13,492,492,14,1,13,4,3

15,100,100,2,2,0,1,0
6,123,123,1,1,0,1,0
22,146,146,43,43,0,1,0
26,157,157,15,9,6,3,2
18,166,166,6,1,5,2,1
14,167,167,5,1,4,2,1
24,174,174,2,2,0,1,0
10,212,212,23,5,18,2,1
0,220,220,14,14,0,1,0
5,233,233,18,18,0,1,0
11,235,235,10,10,0,1,0
27,242,242,5,5,0,1,0
12,256,256,12,3,9,2,1
25,267,267,20,2,18,2,1
1,268,268,23,23,0,1,0
13,288,288,10,10,0,1,0
34,311,311,20,20,0,1,0
36,318,318,51,23,28,4,3
21,319,319,131,56,75,4,3
31,326,326,41,41,0,1,0
7,328,328,10,1,9,4,3
28,330,330,3,3,0,1,0
35,336,336,11,11,0,1,0
9,342,342,1,1,0,1,0
16,350,350,10,10,0,1,0
3,358,358,184,102,82,4,3
23,372,372,1,1,0,1,0
8,391,391,79,16,63,4,3
2,406,406,4,4,0,1,0
29,407,407,60,60,0,1,0
17,410,410,183,134,49,2,1
30,427,427,21,21,0,1,0
19,433,433,18,9,9,2,1
32,446,446,65,49,16,4,3
33,481,481,45,45,0,1,0
4,490,490,73,44,29,2,1
20,500,500,56,31,25,3,2

13,114,114,10,1,9,2,1
28,114,114,1,1,0,1,0
26,119,119,8,8,0,1,0
18,129,129,2,2,0,1,0
1,136,136,18,10,8,2,1
31,146,146,2,2,0,1,0
20,169,169,21,1,20,3,2
15,179,179,24,21,3,2,1
2,186,186,24,24,0,1,0
30,213,213,4,4,0,1,0
16,236,236,26,17,9,4,3
0,251,251,53,53,0,1,0
6,251,251,35,23,12,4,3
3,271,271,81,81,0,1,0
24,290,290,3,3,0,1,0
9,301,301,47,29,18,4,3
12,302,302,6,6,0,1,0
29,302,302,65,42,23,2,1
17,307,307,26,26,0,1,0
27,332,332,100,73,27,2,1
10,337,337,107,107,0,1,0
5,362,362,11,11,0,1,0
4,375,375,106,10,96,4,3
8,376,376,24,24,0,1,0
25,386,386,19,1,18,2,1
32,397,397,17,17,0,1,0
14,411,411,51,3,48,4,3
23,421,421,8,3,5,2,1
22,423,423,83,83,0,1,0
7,424,424,11,8,3,2,1
11,464,464,3,3,0,1,0
19,476,476,70,46,24,4,3
21,489,489,120,63,57,4,3

4,100,100,23,17,6,3,2
10,102,102,15,15,0,1,0
35,102,102,3,3,0,1,0
3,106,106,16,16,0,1,0
17,109,109,1,1,0,1,0
32,110,110,15,15,0,1,0
34,121,121,17,17,0,1,0
2,139,139,11,11,0,1,0
24,150,150,23,23,0,1,0
7,163,163,17,1,16,3,2
6,181,181,15,15,0,1,0
39,193,193,9,3,6,2,1
19,196,196,25,16,9,2,1
38,200,200,22,4,18,3,2
31,213,213,4,4,0,1,0
33,217,217,12,4,8,2,1
12,219,219,35,11,24,2,1
9,225,225,19,19,0,1,0
29,243,243,126,50,76,3,2
14,248,248,36,36,0,1,0
36,256,256,12,3,9,4,3
21,259,259,13,13,0,1,0
13,262,262,6,3,3,2,1
1,270,270,33,33,0,1,0
30,270,270,26,8,18,4,3
11,276,276,3,3,0,1,0
8,293,293,1,1,0,1,0
15,293,293,27,2,25,2,1
40,332,332,15,2,13,2,1
18,345,345,26,26,0,1,0
25,353,353,3,3,0,1,0
28,385,385,26,23,3,2,1
27,388,388,26,22,4,2,1
20,437,437,49,49,0,1,0
0,440,440,25,18,7,2,1
26,460,460,25,25,0,1,0
23,473,473,18,18,0,1,0
37,478,478,81,66,15,4,3
5,484,484,6,6,0,1,0
16,490,490,11,11,0,1,0
22,493,493,70,70,0,1,0

15,115,115,14,14,0,1,0
28,119,119,2,2,0,1,0
29,122,122,2,2,0,1,0
31,139,139,32,14,18,3,2
33,143,143,4,1,3,2,1
27,145,145,15,15,0,1,0
12,158,158,1,1,0,1,0
0,159,159,5,5,0,1,0
34,164,164,20,12,8,3,2
11,185,185,14,2,12,2,1
10,205,205,55,55,0,1,0
13,235,235,21,1,20,2,1
8,255,255,72,29,43,2,1
35,280,280,47,31,16,3,2
23,288,288,1,1,0,1,0
24,296,296,28,3,25,2,1
14,306,306,21,21,0,1,0
20,318,318,15,15,0,1,0
21,342,342,26,15,11,3,2
22,343,343,150,111,39,4,3
25,361,361,26,26,0,1,0
26,368,368,27,27,0,1,0
16,390,390,30,3,27,2,1
7,393,393,18,18,0,1,0
4,394,394,4,4,0,1,0
2,396,396,119,110,9,4,3
5,400,400,32,32,0,1,0
30,412,412,118,118,0,1,0
3,414,414,119,119,0,1,0
9,426,426,6,6,0,1,0
32,429,429,27,27,0,1,0
6,436,436,31,12,19,2,1
17,453,453,11,11,0,1,0
18,465,465,15,5,10,3,2
36,482,482,19,19,0,1,0
19,486,486,18,18,0,1,0
1,488,488,23,23,0,1,0

22,114,114,15,15,0,1,0
17,116,116,4,4,0,1,0
25,122,122,41,41,0,1,0
19,166,166,5,5,0,1,0
1,200,200,11,11,0,1,0
13,207,207,27,9,18,3,2
32,215,215,21,12,9,4,3
23,222,222,38,10,28,3,2
34,237,237,43,43,0,1,0
5,243,243,8,1,7,2,1
11,249,249,14,7,7,2,1
27,251,251,1,1,0,1,0
36,252,252,59,28,31,2,1
3,256,256,12,1,11,2,1
24,261,261,25,25,0,1,0
31,279,279,17,17,0,1,0
20,279,279,15,15,0,1,0
33,280,280,16,16,0,1,0
21,280,280,19,19,0,1,0
37,282,282,7,1,6,2,1
6,297,297,52,19,33,2,1
0,309,309,23,23,0,1,0
16,323,323,90,51,39,3,2
26,338,338,49,39,10,2,1
2,349,349,32,8,24,4,3
29,358,358,6,6,0,1,0
30,368,368,39,21,18,2,1
35,377,377,18,13,5,2,1
12,383,383,51,30,21,4,3
28,387,387,27,5,22,3,2
14,390,390,147,86,61,3,2
4,403,403,31,31,0,1,0
8,445,445,57,57,0,1,0
9,451,451,16,5,11,2,1
10,469,469,24,15,9,4,3
18,481,481,15,15,0,1,0
7,494,494,42,9,33,4,3
15,499,499,4,1,3,2,1

14,110,110,33,33,0,1,0
17,134,134,6,6,0,1,0
11,146,146,27,9,18,2,1
29,151,151,5,1,4,2,1
23,158,158,21,9,12,2,1
4,158,158,25,25,0,1,0
9,175,175,6,6,0,1,0
24,177,177,25,15,10,2,1
21,198,198,6,6,0,1,0
22,212,212,11,3,8,3,2
6,217,217,9,5,4,2,1
20,225,225,7,7,0,1,0
12,238,238,7,7,0,1,0
19,250,250,72,14,58,3,2
15,254,254,33,21,12,3,2
27,256,256,3,3,0,1,0
13,268,268,5,5,0,1,0
28,277,277,22,22,0,1,0
32,286,286,6,6,0,1,0
26,322,322,30,30,0,1,0
33,330,330,137,61,76,4,3
5,335,335,47,10,37,2,1
7,336,336,40,18,22,2,1
34,342,342,15,15,0,1,0
18,381,381,40,33,7,2,1
10,385,385,19,7,12,2,1
25,396,396,10,10,0,1,0
1,409,409,28,28,0,1,0
31,422,422,38,38,0,1,0
16,428,428,122,88,34,3,2
0,440,440,57,45,12,4,3
2,445,445,67,67,0,1,0
8,470,470,28,16,12,2,1
30,478,478,8,8,0,1,0
3,479,479,139,139,0,1,0

36,116,116,15,15,0,1,0
23,124,124,6,6,0,1,0
25,130,130,29,5,24,4,3
13,131,131,9,9,0,1,0
6,134,134,3,3,0,1,0
28,137,137,1,1,0,1,0
19,150,150,9,9,0,1,0
11,165,165,8,8,0,1,0
21,197,197,24,6,18,4,3
5,218,218,9,9,0,1,0
0,220,220,24,24,0,1,0
35,229,229,19,19,0,1,0
10,239,239,1,1,0,1,0
29,248,248,11,11,0,1,0
8,263,263,11,11,0,1,0
9,268,268,8,5,3,2,1
31,272,272,38,38,0,1,0
7,309,309,56,56,0,1,0
34,315,315,10,2,8,3,2
37,331,331,28,18,10,2,1
33,334,334,59,43,16,3,2
2,339,339,94,32,62,3,2
26,341,341,2,2,0,1,0
32,341,341,28,28,0,1,0
24,366,366,47,26,21,4,3
22,373,373,68,27,41,4,3
16,381,381,26,16,10,3,2
17,385,385,4,4,0,1,0
27,399,399,27,27,0,1,0
12,400,400,129,33,96,3,2
18,407,407,29,29,0,1,0
30,412,412,87,54,33,2,1
15,418,418,78,22,56,3,2
1,431,431,13,3,10,3,2
3,446,446,25,2,23,2,1
4,467,467,146,146,0,1,0
20,470,470,51,14,37,2,1
14,494,494,9,9,0,1,0

32,121,121,27,15,12,3,2
37,144,144,24,18,6,3,2
29,145,145,1,1,0,1,0
5,160,160,5,5,0,1,0
16,167,167,10,10,0,1,0
31,171,171,3,3,0,1,0
4,184,184,38,38,0,1,0
1,187,187,4,1,3,2,1
24,188,188,26,26,0,1,0
12,189,189,17,8,9,2,1
2,195,195,18,18,0,1,0
35,199,199,12,7,5,2,1
36,200,200,26,14,12,4,3
26,203,203,24,24,0,1,0
14,211,211,14,6,8,3,2
22,217,217,6,3,3,2,1
8,227,227,26,26,0,1,0
34,270,270,40,40,0,1,0
6,292,292,26,15,11,2,1
15,293,293,52,52,0,1,0
10,300,300,25,13,12,3,2
18,305,305,29,29,0,1,0
11,306,306,5,5,0,1,0
27,320,320,31,31,0,1,0
21,333,333,36,4,32,4,3
19,344,344,19,19,0,1,0
7,357,357,29,29,0,1,0
33,365,365,35,35,0,1,0
30,372,372,32,32,0,1,0
20,375,375,76,30,46,2,1
17,386,386,59,13,46,3,2
23,394,394,30,30,0,1,0
13,395,395,59,59,0,1,0
3,405,405,42,18,24,3,2
25,433,433,1,1,0,1,0
28,444,444,20,20,0,1,0
0,456,456,11,11,0,1,0
38,496,496,96,42,54,4,3
9,497,497,95,25,70,3,2

7,102,102,12,6,6,2,1
11,128,128,34,34,0,1,0
15,133,133,7,7,0,1,0
8,138,138,23,23,0,1,0
13,156,156,22,22,0,1,0
12,160,160,1,1,0,1,0
20,161,161,33,5,28,2,1
27,185,185,35,35,0,1,0
26,198,198,3,3,0,1,0
0,227,227,23,10,13,2,1
28,231,231,75,37,38,3,2
31,233,233,12,12,0,1,0
1,264,264,20,20,0,1,0
5,265,265,104,8,96,4,3
21,283,283,53,25,28,4,3
32,296,296,22,22,0,1,0
10,303,303,12,12,0,1,0
14,303,303,21,21,0,1,0
9,313,313,83,83,0,1,0
29,360,360,25,13,12,2,1
23,378,378,96,82,14,2,1
30,386,386,71,71,0,1,0
3,386,386,15,7,8,3,2
17,414,414,1,1,0,1,0
24,431,431,3,3,0,1,0
18,444,444,29,29,0,1,0
25,450,450,28,25,3,2,1
19,468,468,1,1,0,1,0
4,475,475,83,83,0,1,0
6,477,477,3,3,0,1,0
2,484,484,54,54,0,1,0
16,486,486,53,10,43,2,1
22,488,488,5,5,0,1,0

32,107,107,12,4,8,2,1
30,110,110,1,1,0,1,0
25,114,114,16,16,0,1,0
15,121,121,6,3,3,2,1
39,123,123,10,3,7,2,1
27,144,144,1,1,0,1,0
45,149,149,52,11,41,4,3
28,160,160,1,1,0,1,0
4,161,161,8,8,0,1,0
0,166,166,20,14,6,3,2
3,168,168,7,7,0,1,0
18,180,180,3,3,0,1,0
37,186,186,1,1,0,1,0
16,190,190,21,1,20,3,2
43,194,194,5,5,0,1,0
17,197,197,3,3,0,1,0
31,198,198,9,1,8,2,1
8,209,209,3,3,0,1,0
19,215,215,14,1,13,2,1
24,215,215,7,3,4,2,1
40,249,249,51,9,42,4,3
36,249,249,83,48,35,2,1
5,251,251,2,2,0,1,0
20,261,261,15,7,8,2,1
34,268,268,50,26,24,2,1
35,277,277,51,29,22,3,2
44,292,292,32,32,0,1,0
13,316,316,32,32,0,1,0
21,323,323,18,3,15,4,3
42,323,323,12,9,3,2,1
41,353,353,2,2,0,1,0
7,356,356,1,1,0,1,0
26,368,368,78,78,0,1,0
14,380,380,36,3,33,2,1
29,381,381,87,75,12,4,3
23,389,389,16,6,10,3,2
2,392,392,13,4,9,2,1
38,410,410,4,4,0,1,0
33,420,420,2,2,0,1,0
1,439,439,77,77,0,1,0
22,447,447,6,6,0,1,0
11,463,463,23,20,3,2,1
12,476,476,128,93,35,2,1
10,482,482,19,19,0,1,0
6,490,490,13,13,0,1,0
9,495,495,33,3,30,4,3

19,102,102,10,10,0,1,0
22,128,128,1,1,0,1,0
16,141,141,6,6,0,1,0
31,146,146,8,8,0,1,0
11,147,147,16,16,0,1,0
9,149,149,4,4,0,1,0
32,167,167,21,17,4,2,1
4,173,173,31,31,0,1,0
6,176,176,11,11,0,1,0
25,186,186,13,5,8,3,2
13,191,191,11,11,0,1,0
15,228,228,5,5,0,1,0
14,241,241,33,3,30,3,2
10,245,245,1,1,0,1,0
29,254,254,28,2,26,3,2
7,255,255,40,17,23,2,1
26,264,264,62,62,0,1,0
28,265,265,44,44,0,1,0
30,280,280,12,6,6,3,2
2,314,314,76,57,19,2,1
18,333,333,29,8,21,4,3
20,345,345,9,9,0,1,0
17,365,365,45,6,39,2,1
8,368,368,121,91,30,3,2
3,397,397,39,35,4,2,1
1,402,402,105,105,0,1,0
27,404,404,67,25,42,4,3
5,404,404,15,15,0,1,0
23,421,421,41,27,14,3,2
12,427,427,22,22,0,1,0
21,445,445,11,11,0,1,0
33,449,449,100,4,96,3,2
24,476,476,40,4,36,4,3
0,489,489,62,62,0,1,0
34,494,494,78,57,21,2,1

9,103,103,1,1,0,1,0
39,106,106,7,2,5,2,1
35,140,140,13,13,0,1,0
10,141,141,14,10,4,2,1
27,148,148,6,6,0,1,0
37,150,150,6,6,0,1,0
34,153,153,11,11,0,1,0
24,174,174,46,17,29,2,1
12,178,178,12,9,3,2,1
3,183,183,5,5,0,1,0
28,193,193,71,5,66,4,3
33,212,212,23,14,9,2,1
19,219,219,10,10,0,1,0
38,227,227,10,4,6,2,1
23,265,265,41,41,0,1,0
13,270,270,4,4,0,1,0
1,278,278,27,9,18,2,1
18,295,295,8,2,6,3,2
25,302,302,13,13,0,1,0
14,304,304,10,4,6,3,2
22,309,309,2,2,0,1,0
32,320,320,7,7,0,1,0
11,332,332,65,65,0,1,0
2,335,335,30,30,0,1,0
0,346,346,86,58,28,4,3
7,381,381,21,21,0,1,0
16,383,383,57,57,0,1,0
8,398,398,29,29,0,1,0
31,400,400,20,10,10,3,2
36,408,408,13,8,5,2,1
30,414,414,85,36,49,4,3
4,423,423,13,1,12,3,2
26,435,435,12,12,0,1,0
5,443,443,159,159,0,1,0
17,445,445,15,15,0,1,0
6,445,445,11,11,0,1,0
20,453,453,20,17,3,2,1
15,481,481,85,85,0,1,0
21,485,485,20,20,0,1,0
29,499,499,131,32,99,4,3

6,100,100,21,7,14,3,2
21,104,104,5,5,0,1,0
29,105,105,39,39,0,1,0
25,116,116,11,11,0,1,0
12,151,151,40,28,12,3,2
24,171,171,1,1,0,1,0
4,173,173,25,5,20,3,2
11,174,174,17,17,0,1,0
26,182,182,41,41,0,1,0
31,199,199,8,8,0,1,0
13,210,210,36,13,23,2,1
23,236,236,11,11,0,1,0
9,240,240,54,54,0,1,0
8,249,249,3,3,0,1,0
10,271,271,19,11,8,2,1
20,273,273,35,6,29,2,1
2,281,281,42,42,0,1,0
22,288,288,10,1,9,2,1
17,301,301,6,6,0,1,0
7,308,308,22,4,18,4,3
30,315,315,22,22,0,1,0
16,315,315,63,9,54,4,3
19,322,322,23,23,0,1,0
5,374,374,45,17,28,3,2
15,381,381,5,5,0,1,0
28,382,382,17,2,15,4,3
0,396,396,1,1,0,1,0
14,404,404,85,36,49,4,3
3,414,414,159,154,5,2,1
1,437,437,66,66,0,1,0
18,440,440,15,1,14,2,1
27,462,462,47,47,0,1,0

35,117,117,1,1,0,1,0
16,122,122,45,30,15,4,3
34,137,137,22,5,17,2,1
2,140,140,1,1,0,1,0
8,150,150,2,2,0,1,0
14,159,159,1,1,0,1,0
17,179,179,15,15,0,1,0
22,204,204,12,3,9,4,3
20,211,211,6,6,0,1,0
4,229,229,18,18,0,1,0
32,233,233,10,10,0,1,0
5,241,241,70,70,0,1,0
29,252,252,40,40,0,1,0
36,269,269,6,6,0,1,0
39,279,279,32,12,20,3,2
12,289,289,49,21,28,3,2
27,295,295,34,34,0,1,0
30,301,301,26,18,8,3,2
0,338,338,4,4,0,1,0
33,362,362,29,15,14,2,1
6,362,362,7,4,3,2,1
38,368,368,84,84,0,1,0
11,375,375,99,99,0,1,0
24,376,376,4,4,0,1,0
10,394,394,1,1,0,1,0
9,405,405,30,30,0,1,0
28,408,408,154,73,81,4,3
3,411,411,9,3,6,3,2
21,418,418,20,20,0,1,0
1,430,430,37,37,0,1,0
23,430,430,1,1,0,1,0
31,436,436,62,47,15,4,3
18,453,453,2,2,0,1,0
25,457,457,50,50,0,1,0
7,461,461,36,10,26,2,1
13,465,465,62,14,48,4,3
26,485,485,42,24,18,3,2
19,485,485,76,61,15,2,1
37,489,489,39,39,0,1,0
15,498,498,1,1,0,1,0

32,122,122,11,11,0,1,0
20,136,136,4,4,0,1,0
14,147,147,19,5,14,3,2
22,158,158,11,2,9,2,1
5,186,186,4,4,0,1,0
0,197,197,4,4,0,1,0
4,200,200,15,15,0,1,0
26,217,217,9,9,0,1,0
35,224,224,2,2,0,1,0
25,235,235,13,3,10,2,1
34,242,242,56,23,33,2,1
30,256,256,19,3,16,3,2
33,264,264,61,6,55,4,3
9,275,275,4,4,0,1,0
16,277,277,18,18,0,1,0
28,295,295,47,7,40,3,2
11,298,298,45,45,0,1,0
8,303,303,17,17,0,1,0
36,304,304,27,6,21,4,3
12,308,308,30,21,9,4,3
19,310,310,11,11,0,1,0
18,320,320,150,54,96,3,2
23,321,321,6,1,5,2,1
39,324,324,92,22,70,4,3
6,324,324,50,21,29,2,1
1,327,327,10,4,6,3,2
13,331,331,22,10,12,2,1
2,345,345,5,1,4,2,1
24,345,345,16,16,0,1,0
29,349,349,7,2,5,2,1
10,364,364,27,1,26,2,1
7,368,368,28,28,0,1,0
38,392,392,55,46,9,2,1
3,400,400,1,1,0,1,0
27,416,416,16,16,0,1,0
37,419,419,32,18,14,2,1
40,432,432,58,58,0,1,0
17,433,433,42,42,0,1,0
31,489,489,66,66,0,1,0
21,496,496,9,1,8,2,1
15,496,496,101,101,0,1,0

11,106,106,12,2,10,2,1
31,107,107,7,3,4,2,1
27,119,119,1,1,0,1,0
1,128,128,15,15,0,1,0
44,136,136,18,6,12,3,2
19,150,150,3,3,0,1,0
0,155,155,3,3,0,1,0
17,160,160,1,1,0,1,0
12,165,165,5,5,0,1,0
33,166,166,7,2,5,2,1
15,169,169,4,4,0,1,0
42,190,190,23,23,0,1,0
32,193,193,6,6,0,1,0
37,200,200,51,23,28,3,2
16,201,201,1,1,0,1,0
4,203,203,9,4,5,2,1
6,248,248,14,10,4,2,1
39,259,259,43,4,39,4,3
43,268,268,28,28,0,1,0
18,269,269,4,1,3,2,1
35,287,287,8,8,0,1,0
45,295,295,1,1,0,1,0
14,319,319,50,50,0,1,0
10,331,331,35,19,16,3,2
46,349,349,30,9,21,4,3
20,356,356,3,3,0,1,0
30,367,367,56,56,0,1,0
2,390,390,65,55,10,3,2
38,398,398,83,73,10,3,2
28,402,402,15,15,0,1,0
9,402,402,1,1,0,1,0
22,403,403,15,3,12,3,2
24,417,417,65,6,59,3,2
5,420,420,32,32,0,1,0
26,421,421,20,20,0,1,0
34,421,421,58,58,0,1,0
8,426,426,12,2,10,2,1
23,427,427,102,56,46,3,2
13,429,429,77,43,34,2,1
7,437,437,22,22,0,1,0
3,458,458,30,7,23,2,1
40,462,462,2,2,0,1,0
29,469,469,39,2,37,2,1
21,478,478,37,7,30,2,1
36,495,495,79,79,0,1,0
41,499,499,63,63,0,1,0
25,500,500,26,26,0,1,0

14,114,114,3,3,0,1,0
33,117,117,8,1,7,2,1
20,129,129,44,44,0,1,0
6,143,143,4,4,0,1,0
28,144,144,16,16,0,1,0
12,152,152,56,40,16,2,1
23,163,163,3,3,0,1,0
27,164,164,3,3,0,1,0
16,175,175,36,24,12,4,3
5,179,179,13,13,0,1,0
30,187,187,28,28,0,1,0
0,194,194,36,36,0,1,0
31,196,196,19,19,0,1,0
15,197,197,55,55,0,1,0
9,203,203,23,23,0,1,0
8,211,211,5,5,0,1,0
11,235,235,1,1,0,1,0
7,259,259,9,9,0,1,0
26,274,274,12,12,0,1,0
17,287,287,30,30,0,1,0
1,295,295,5,5,0,1,0
25,296,296,6,3,3,2,1
4,306,306,9,9,0,1,0
10,307,307,123,123,0,1,0
24,328,328,52,52,0,1,0
35,343,343,43,43,0,1,0
22,366,366,29,29,0,1,0
21,376,376,54,54,0,1,0
2,387,387,12,12,0,1,0
19,416,416,36,27,9,2,1
13,422,422,15,2,13,2,1
3,423,423,21,8,13,2,1
32,436,436,35,5,30,4,3
34,463,463,55,55,0,1,0
29,466,466,18,18,0,1,0
18,490,490,67,32,35,4,3

31,104,104,20,20,0,1,0
6,113,113,3,3,0,1,0
19,119,119,1,1,0,1,0
11,158,158,8,2,6,3,2
27,164,164,38,6,32,4,3
30,165,165,2,2,0,1,0
18,167,167,13,13,0,1,0
40,173,173,2,2,0,1,0
13,182,182,24,24,0,1,0
15,187,187,22,22,0,1,0
26,191,191,21,21,0,1,0
42,194,194,9,9,0,1,0
20,201,201,6,6,0,1,0
1,207,207,10,5,5,2,1
0,216,216,31,25,6,3,2
16,228,228,6,6,0,1,0
7,232,232,13,13,0,1,0
17,235,235,9,9,0,1,0
12,236,236,12,12,0,1,0
28,243,243,15,15,0,1,0
4,249,249,12,12,0,1,0
44,253,253,38,12,26,2,1
41,256,256,63,15,48,2,1
10,285,285,2,2,0,1,0
2,286,286,60,60,0,1,0
37,307,307,52,52,0,1,0
24,318,318,27,16,11,2,1
38,340,340,14,14,0,1,0
29,346,346,15,6,9,4,3
22,359,359,57,57,0,1,0
34,375,375,5,5,0,1,0
33,382,382,23,23,0,1,0
23,383,383,83,66,17,2,1
5,398,398,40,40,0,1,0
8,410,410,13,13,0,1,0
39,418,418,9,1,8,3,2
35,420,420,24,8,16,2,1
14,434,434,8,8,0,1,0
9,456,456,34,34,0,1,0
36,457,457,23,19,4,2,1
3,474,474,36,2,34,2,1
43,475,475,16,16,0,1,0
32,485,485,183,174,9,4,3
25,497,497,7,7,0,1,0
21,499,499,27,12,15,4,3

0,105,105,3,3,0,1,0
15,110,110,15,15,0,1,0
10,110,110,1,1,0,1,0
32,114,114,6,6,0,1,0
7,144,144,20,20,0,1,0
18,149,149,5,5,0,1,0
38,164,164,1,1,0,1,0
21,178,178,75,45,30,2,1
23,189,189,29,29,0,1,0
8,192,192,15,6,9,2,1
27,198,198,13,13,0,1,0
35,203,203,60,60,0,1,0
6,216,216,7,7,0,1,0
3,221,221,21,6,15,2,1
22,234,234,21,9,12,4,3
4,236,236,17,17,0,1,0
19,239,239,6,2,4,2,1
33,248,248,1,1,0,1,0
12,267,267,8,1,7,2,1
31,279,279,39,39,0,1,0
24,289,289,12,12,0,1,0
34,290,290,2,2,0,1,0
1,294,294,50,14,36,2,1
30,295,295,82,54,28,2,1
29,300,300,5,5,0,1,0
11,317,317,28,13,15,3,2
26,323,323,28,10,18,4,3
13,363,363,135,135,0,1,0
28,365,365,12,12,0,1,0
2,369,369,23,23,0,1,0
9,379,379,79,17,62,3,2
37,379,379,3,3,0,1,0
25,388,388,22,22,0,1,0
14,394,394,53,29,24,4,3
36,395,395,45,45,0,1,0
17,396,396,20,20,0,1,0
20,431,431,33,33,0,1,0
16,435,435,21,9,12,4,3
5,437,437,39,39,0,1,0

17,114,114,15,15,0,1,0
32,128,128,19,19,0,1,0
31,133,133,5,5,0,1,0
9,140,140,6,2,4,2,1
0,145,145,5,5,0,1,0
2,161,161,76,61,15,2,1
8,184,184,1,1,0,1,0
10,195,195,7,7,0,1,0
1,198,198,14,10,4,2,1
24,206,206,6,6,0,1,0
23,216,216,10,3,7,2,1
12,234,234,37,22,15,4,3
36,243,243,22,14,8,2,1
5,244,244,6,2,4,2,1
28,244,244,28,28,0,1,0
7,295,295,32,11,21,2,1
29,306,306,31,6,25,4,3
26,309,309,11,1,10,3,2
27,309,309,12,9,3,2,1
30,317,317,23,23,0,1,0
22,346,346,21,21,0,1,0
21,360,360,14,14,0,1,0
6,360,360,15,15,0,1,0
35,384,384,104,32,72,4,3
34,391,391,18,18,0,1,0
11,398,398,61,5,56,3,2
33,403,403,5,5,0,1,0
14,406,406,10,2,8,2,1
4,446,446,140,85,55,4,3
18,449,449,144,144,0,1,0
15,456,456,28,28,0,1,0
25,482,482,170,144,26,2,1
13,484,484,75,75,0,1,0
3,485,485,13,13,0,1,0
20,492,492,37,37,0,1,0
19,493,493,19,2,17,2,1
16,493,493,21,14,7,2,1

16,110,110,1,1,0,1,0
31,114,114,9,9,0,1,0
26,117,117,8,3,5,2,1
32,126,126,14,14,0,1,0
5,133,133,1,1,0,1,0
28,149,149,29,1,28,3,2
0,157,157,6,1,5,2,1
6,159,159,5,1,4,2,1
22,184,184,10,6,4,2,1
7,191,191,5,5,0,1,0
11,202,202,6,6,0,1,0
25,202,202,8,2,6,3,2
18,204,204,10,2,8,2,1
29,215,215,6,6,0,1,0
13,228,228,77,22,55,3,2
42,235,235,26,26,0,1,0
12,236,236,1,1,0,1,0
24,236,236,16,4,12,2,1
39,238,238,38,38,0,1,0
38,248,248,13,13,0,1,0
37,260,260,57,19,38,3,2
21,274,274,3,3,0,1,0
10,306,306,8,5,3,2,1
3,313,313,85,85,0,1,0
41,322,322,23,17,6,2,1
17,326,326,1,1,0,1,0
2,333,333,33,9,24,4,3
14,345,345,19,8,11,2,1
8,351,351,3,3,0,1,0
30,356,356,65,65,0,1,0
36,360,360,9,4,5,2,1
9,367,367,27,27,0,1,0
33,376,376,113,68,45,2,1
1,384,384,123,29,94,3,2
27,395,395,74,74,0,1,0
23,401,401,41,34,7,2,1
40,423,423,11,5,6,2,1
20,438,438,1,1,0,1,0
15,483,483,83,47,36,4,3
4,488,488,57,57,0,1,0
19,489,489,25,2,23,2,1
34,496,496,12,12,0,1,0
35,496,496,1,1,0,1,0

23,144,144,1,1,0,1,0
14,146,146,1,1,0,1,0
35,146,146,11,7,4,2,1
1,148,148,44,23,21,4,3
6,154,154,18,18,0,1,0
39,161,161,20,5,15,2,1
28,163,163,49,32,17,2,1
41,166,166,6,6,0,1,0
38,166,166,31,25,6,2,1
27,170,170,14,14,0,1,0
0,200,200,8,8,0,1,0
32,239,239,22,14,8,3,2
17,251,251,1,1,0,1,0
22,259,259,26,26,0,1,0
25,268,268,32,32,0,1,0
19,272,272,31,5,26,2,1
7,278,278,6,2,4,2,1
12,281,281,7,7,0,1,0
11,290,290,16,4,12,4,3
26,304,304,28,28,0,1,0
5,315,315,15,5,10,3,2
18,316,316,6,2,4,2,1
31,317,317,23,23,0,1,0
29,319,319,46,22,24,3,2
37,322,322,14,2,12,4,3
33,353,353,116,116,0,1,0
10,354,354,47,47,0,1,0
9,356,356,12,9,3,2,1
8,365,365,42,42,0,1,0
36,376,376,39,15,24,3,2
16,380,380,40,40,0,1,0
40,390,390,28,14,14,3,2
4,393,393,3,3,0,1,0
13,400,400,13,5,8,3,2
30,404,404,17,17,0,1,0
20,412,412,37,37,0,1,0
34,419,419,2,2,0,1,0
21,433,433,57,57,0,1,0
2,434,434,9,9,0,1,0
3,443,443,22,22,0,1,0
24,452,452,5,5,0,1,0
15,479,479,161,161,0,1,0

26,101,101,52,25,27,4,3
1,106,106,3,3,0,1,0
14,109,109,1,1,0,1,0
34,116,116,14,14,0,1,0
13,121,121,1,1,0,1,0
18,132,132,13,13,0,1,0
31,143,143,24,11,13,2,1
22,144,144,25,9,16,3,2
4,147,147,23,23,0,1,0
15,176,176,2,2,0,1,0
2,185,185,32,32,0,1,0
10,195,195,46,46,0,1,0
6,198,198,14,14,0,1,0
32,204,204,1,1,0,1,0
12,215,215,14,1,13,4,3
25,296,296,18,18,0,1,0
29,303,303,2,2,0,1,0
28,344,344,9,3,6,3,2
33,347,347,12,12,0,1,0
20,353,353,65,1,64,3,2
16,354,354,5,1,4,2,1
8,360,360,17,17,0,1,0
9,385,385,7,7,0,1,0
3,393,393,33,33,0,1,0
27,393,393,21,21,0,1,0
5,397,397,90,28,62,4,3
21,409,409,13,13,0,1,0
19,411,411,26,20,6,3,2
24,416,416,39,39,0,1,0
7,416,416,268,268,0,1,0
0,439,439,20,20,0,1,0
11,443,443,28,28,0,1,0
30,455,455,27,6,21,4,3
17,468,468,30,30,0,1,0
23,484,484,48,21,27,2,1
35,485,485,39,14,25,2,1

6,111,111,3,3,0,1,0
0,124,124,26,18,8,2,1
26,138,138,13,1,12,3,2
27,143,143,1,1,0,1,0
16,154,154,24,16,8,3,2
30,154,154,13,6,7,2,1
31,154,154,31,31,0,1,0
14,164,164,38,16,22,3,2
24,187,187,17,17,0,1,0
35,188,188,36,36,0,1,0
9,195,195,26,5,21,4,3
1,212,212,14,9,5,2,1
2,230,230,5,5,0,1,0
5,246,246,14,14,0,1,0
11,257,257,22,2,20,3,2
15,261,261,34,34,0,1,0
25,263,263,91,75,16,3,2
19,263,263,22,22,0,1,0
7,273,273,58,58,0,1,0
17,273,273,14,14,0,1,0
36,285,285,20,20,0,1,0
21,288,288,55,15,40,3,2
20,290,290,27,27,0,1,0
23,308,308,9,9,0,1,0
8,332,332,16,16,0,1,0
10,356,356,5,5,0,1,0
28,359,359,7,7,0,1,0
4,360,360,36,36,0,1,0
34,363,363,29,12,17,2,1
29,364,364,27,4,23,3,2
3,377,377,50,50,0,1,0
13,390,390,2,2,0,1,0
18,423,423,32,2,30,2,1
12,435,435,95,39,56,3,2
33,435,435,22,3,19,2,1
32,483,483,27,10,17,2,1
22,489,489,48,48,0,1,0

0,114,114,26,26,0,1,0
34,117,117,25,9,16,2,1
30,119,119,19,11,8,2,1
12,142,142,1,1,0,1,0
41,146,146,12,3,9,2,1
16,146,146,4,4,0,1,0
3,160,160,12,12,0,1,0
17,163,163,13,13,0,1,0
19,175,175,32,23,9,4,3
26,209,209,14,14,0,1,0
36,212,212,58,58,0,1,0
40,214,214,10,6,4,2,1
32,225,225,7,7,0,1,0
39,228,228,25,25,0,1,0
2,241,241,2,2,0,1,0
31,252,252,35,35,0,1,0
18,267,267,4,4,0,1,0
33,272,272,8,8,0,1,0
6,284,284,27,24,3,2,1
22,296,296,58,58,0,1,0
7,305,305,23,23,0,1,0
29,329,329,111,111,0,1,0
28,330,330,31,31,0,1,0
15,334,334,11,8,3,2,1
20,335,335,29,29,0,1,0
27,338,338,5,5,0,1,0
23,347,347,7,7,0,1,0
11,358,358,7,1,6,2,1
14,360,360,33,33,0,1,0
4,377,377,50,50,0,1,0
9,400,400,15,15,0,1,0
25,400,400,43,43,0,1,0
21,421,421,69,37,32,2,1
38,434,434,42,42,0,1,0
13,437,437,5,5,0,1,0
1,446,446,41,17,24,3,2
35,454,454,18,18,0,1,0
8,466,466,24,24,0,1,0
10,472,472,76,76,0,1,0
37,477,477,21,21,0,1,0
5,480,480,15,15,0,1,0
24,488,488,11,4,7,2,1

6,106,106,19,1,18,3,2
20,122,122,9,6,3,2,1
11,128,128,11,11,0,1,0
14,134,134,15,15,0,1,0
34,150,150,14,2,12,3,2
25,175,175,13,4,9,4,3
0,186,186,4,4,0,1,0
27,189,189,29,10,19,2,1
36,225,225,4,4,0,1,0
10,237,237,42,9,33,4,3
28,239,239,2,2,0,1,0
19,249,249,18,11,7,2,1
26,255,255,2,2,0,1,0
15,255,255,4,4,0,1,0
2,265,265,11,2,9,2,1
24,279,279,1,1,0,1,0
30,290,290,61,43,18,2,1
21,306,306,2,2,0,1,0
13,310,310,37,21,16,3,2
32,319,319,29,3,26,2,1
35,324,324,19,19,0,1,0
38,347,347,7,1,6,3,2
8,348,348,87,1,86,3,2
18,350,350,4,4,0,1,0
3,367,367,62,62,0,1,0
7,398,398,28,19,9,2,1
39,399,399,22,22,0,1,0
40,399,399,7,3,4,2,1
29,400,400,116,105,11,2,1
22,402,402,241,136,105,4,3
33,404,404,17,11,6,2,1
17,413,413,19,13,6,3,2
37,414,414,9,1,8,2,1
5,439,439,60,42,18,4,3
4,448,448,5,5,0,1,0
31,461,461,29,4,25,2,1
1,469,469,7,3,4,2,1
16,470,470,7,1,6,2,1
9,474,474,120,120,0,1,0
23,478,478,50,16,34,2,1
12,478,478,9,9,0,1,0

6,111,111,1,1,0,1,0
22,112,112,8,8,0,1,0
32,114,114,6,6,0,1,0
41,117,117,24,24,0,1,0
42,182,182,12,12,0,1,0
2,203,203,1,1,0,1,0
9,239,239,46,4,42,3,2
15,240,240,17,9,8,3,2
12,240,240,6,6,0,1,0
35,242,242,12,12,0,1,0
5,248,248,61,61,0,1,0
25,258,258,4,4,0,1,0
34,270,270,17,17,0,1,0
26,271,271,87,87,0,1,0
44,272,272,2,2,0,1,0
19,279,279,1,1,0,1,0
10,283,283,1,1,0,1,0
24,327,327,20,11,9,2,1
14,330,330,2,2,0,1,0
1,332,332,13,1,12,2,1
28,334,334,15,1,14,3,2
31,336,336,12,6,6,3,2
43,342,342,74,35,39,4,3
23,343,343,3,3,0,1,0
18,343,343,11,7,4,2,1
21,346,346,4,4,0,1,0
11,363,363,6,3,3,2,1
4,376,376,130,78,52,3,2
39,381,381,29,29,0,1,0
29,389,389,31,15,16,3,2
13,391,391,161,161,0,1,0
37,396,396,24,2,22,3,2
33,398,398,124,124,0,1,0
38,400,400,71,39,32,2,1
0,403,403,29,2,27,4,3
36,418,418,32,32,0,1,0
7,419,419,15,3,12,2,1
40,432,432,2,2,0,1,0
8,438,438,12,12,0,1,0
3,439,439,24,13,11,2,1
17,446,446,35,35,0,1,0
20,459,459,24,24,0,1,0
27,464,464,20,10,10,2,1
30,478,478,17,12,5,2,1
16,487,487,4,4,0,1,0

7,100,100,2,2,0,1,0
16,108,108,7,1,6,2,1
8,126,126,10,6,4,2,1
34,134,134,4,4,0,1,0
9,138,138,1,1,0,1,0
21,149,149,24,4,20,4,3
30,160,160,11,11,0,1,0
13,178,178,5,1,4,2,1
32,206,206,40,12,28,3,2
40,217,217,13,13,0,1,0
15,226,226,30,30,0,1,0
14,233,233,21,21,0,1,0
20,237,237,2,2,0,1,0
31,245,245,5,5,0,1,0
35,258,258,11,11,0,1,0
41,259,259,33,33,0,1,0
12,262,262,16,16,0,1,0
24,272,272,51,51,0,1,0
17,275,275,12,12,0,1,0
18,292,292,4,4,0,1,0
26,300,300,2,2,0,1,0
39,307,307,85,64,21,4,3
0,310,310,36,10,26,3,2
22,311,311,11,11,0,1,0
37,320,320,36,6,30,3,2
5,334,334,60,60,0,1,0
19,339,339,49,49,0,1,0
38,348,348,43,43,0,1,0
29,382,382,4,4,0,1,0
4,402,402,6,2,4,2,1
28,422,422,38,38,0,1,0
36,423,423,161,161,0,1,0
25,428,428,5,5,0,1,0
10,435,435,49,16,33,2,1
3,441,441,25,1,24,4,3
23,443,443,17,3,14,3,2
2,452,452,17,17,0,1,0
6,465,465,49,49,0,1,0
27,477,477,33,33,0,1,0
33,478,478,43,1,42,3,2
1,481,481,72,31,41,4,3
11,483,483,115,88,27,2,1

29,100,100,5,2,3,2,1
34,126,126,12,12,0,1,0
28,138,138,54,30,24,3,2
2,151,151,7,7,0,1,0
20,164,164,1,1,0,1,0
27,175,175,1,1,0,1,0
33,177,177,8,8,0,1,0
39,178,178,5,5,0,1,0
12,195,195,4,4,0,1,0
19,197,197,3,3,0,1,0
15,216,216,1,1,0,1,0
13,229,229,56,56,0,1,0
9,229,229,2,2,0,1,0
8,239,239,34,34,0,1,0
40,244,244,11,11,0,1,0
5,258,258,20,9,11,2,1
11,261,261,39,39,0,1,0
42,262,262,21,3,18,4,3
0,281,281,14,14,0,1,0
16,297,297,51,51,0,1,0
7,306,306,28,20,8,3,2
21,316,316,1,1,0,1,0
32,340,340,50,32,18,2,1
4,347,347,3,3,0,1,0
17,355,355,25,25,0,1,0
38,365,365,112,112,0,1,0
36,377,377,36,6,30,2,1
26,384,384,73,73,0,1,0
18,384,384,72,11,61,4,3
6,388,388,24,10,14,2,1
25,399,399,34,10,24,3,2
14,410,410,17,8,9,4,3
24,414,414,17,12,5,2,1
37,419,419,6,2,4,2,1
10,430,430,25,5,20,2,1
23,434,434,36,36,0,1,0
41,448,448,2,2,0,1,0
31,475,475,32,11,21,2,1
1,482,482,19,19,0,1,0
30,487,487,78,50,28,2,1
3,490,490,47,47,0,1,0
35,491,491,41,41,0,1,0
22,499,499,111,58,53,4,3

1,101,101,16,16,0,1,0
19,107,107,13,13,0,1,0
3,119,119,9,6,3,2,1
8,125,125,11,11,0,1,0
27,132,132,10,10,0,1,0
0,136,136,25,25,0,1,0
11,170,170,12,12,0,1,0
15,173,173,18,10,8,3,2
5,175,175,14,14,0,1,0
33,183,183,33,27,6,2,1
18,189,189,48,6,42,2,1
16,202,202,41,7,34,2,1
34,225,225,5,5,0,1,0
12,241,241,17,3,14,2,1
6,244,244,14,3,11,2,1
35,253,253,26,9,17,2,1
26,265,265,4,4,0,1,0
32,284,284,29,1,28,3,2
7,288,288,51,51,0,1,0
2,303,303,74,26,48,2,1
25,307,307,5,5,0,1,0
21,331,331,15,1,14,3,2
10,335,335,19,19,0,1,0
13,342,342,10,10,0,1,0
22,409,409,8,3,5,2,1
28,409,409,26,10,16,2,1
20,410,410,175,175,0,1,0
17,418,418,54,54,0,1,0
9,423,423,51,47,4,2,1
4,426,426,71,50,21,4,3
29,433,433,75,30,45,4,3
24,447,447,15,3,12,4,3
30,453,453,15,15,0,1,0
23,475,475,17,17,0,1,0
14,484,484,7,7,0,1,0
31,487,487,44,44,0,1,0

12,104,104,3,3,0,1,0
18,112,112,20,2,18,2,1
3,122,122,4,1,3,2,1
11,141,141,4,4,0,1,0
26,147,147,5,5,0,1,0
0,154,154,11,11,0,1,0
25,173,173,22,2,20,2,1
15,201,201,2,2,0,1,0
2,210,210,7,7,0,1,0
21,219,219,3,3,0,1,0
29,221,221,58,58,0,1,0
20,229,229,5,5,0,1,0
1,234,234,24,24,0,1,0
33,253,253,18,2,16,3,2
17,262,262,25,25,0,1,0
27,266,266,34,34,0,1,0
24,280,280,31,31,0,1,0
4,281,281,26,26,0,1,0
16,295,295,1,1,0,1,0
6,320,320,139,139,0,1,0
28,354,354,25,2,23,2,1
7,359,359,1,1,0,1,0
22,378,378,6,6,0,1,0
13,380,380,55,55,0,1,0
38,383,383,34,7,27,4,3
23,387,387,18,6,12,2,1
31,393,393,142,97,45,4,3
30,405,405,129,93,36,4,3
5,407,407,11,6,5,2,1
32,409,409,26,26,0,1,0
8,417,417,92,92,0,1,0
19,420,420,2,2,0,1,0
9,426,426,87,1,86,3,2
37,460,460,39,13,26,3,2
14,467,467,86,26,60,3,2
36,478,478,17,1,16,2,1
35,479,479,38,38,0,1,0
34,480,480,1,1,0,1,0
10,487,487,1,1,0,1,0

7,117,117,26,26,0,1,0
14,142,142,12,4,8,2,1
19,153,153,12,3,9,4,3
28,155,155,28,28,0,1,0
29,166,166,3,3,0,1,0
22,166,166,30,8,22,2,1
9,182,182,15,9,6,3,2
13,190,190,85,85,0,1,0
12,193,193,22,9,13,4,3
32,209,209,26,2,24,4,3
8,223,223,54,54,0,1,0
15,223,223,23,8,15,2,1
21,240,240,15,12,3,2,1
6,296,296,4,4,0,1,0
2,297,297,5,5,0,1,0
5,305,305,45,45,0,1,0
3,327,327,24,3,21,2,1
20,338,338,14,14,0,1,0
18,341,341,1,1,0,1,0
1,348,348,24,16,8,2,1
0,352,352,18,18,0,1,0
26,362,362,114,83,31,2,1
4,380,380,106,7,99,4,3
16,398,398,18,18,0,1,0
27,424,424,59,59,0,1,0
17,427,427,16,12,4,2,1
31,430,430,19,19,0,1,0
25,450,450,82,82,0,1,0
24,461,461,22,1,21,4,3
10,483,483,39,39,0,1,0
23,490,490,21,3,18,2,1
30,493,493,104,8,96,4,3
11,497,497,32,20,12,3,2

19,110,110,4,4,0,1,0
6,127,127,6,2,4,2,1
33,132,132,11,7,4,2,1
0,144,144,12,4,8,2,1
34,157,157,19,19,0,1,0
7,172,172,49,49,0,1,0
9,173,173,1,1,0,1,0
18,179,179,16,16,0,1,0
16,182,182,17,17,0,1,0
27,191,191,34,26,8,3,2
15,215,215,1,1,0,1,0
25,217,217,25,11,14,2,1
38,219,219,38,38,0,1,0
5,235,235,21,10,11,3,2
23,254,254,6,6,0,1,0
37,254,254,27,27,0,1,0
30,284,284,3,3,0,1,0
29,292,292,29,29,0,1,0
32,293,293,3,3,0,1,0
11,294,294,9,9,0,1,0
24,314,314,37,11,26,2,1
31,321,321,51,14,37,2,1
35,325,325,129,129,0,1,0
26,330,330,43,31,12,2,1
2,356,356,23,15,8,3,2
12,359,359,20,11,9,2,1
13,401,401,13,1,12,4,3
28,403,403,47,40,7,2,1
8,414,414,33,10,23,2,1
10,416,416,34,34,0,1,0
22,432,432,4,4,0,1,0
39,461,461,10,2,8,3,2
4,463,463,30,3,27,4,3
14,464,464,88,12,76,3,2
1,466,466,19,19,0,1,0
3,469,469,90,90,0,1,0
21,472,472,4,4,0,1,0
17,480,480,140,107,33,2,1
20,491,491,21,12,9,4,3
36,491,491,28,6,22,2,1

32,102,102,9,9,0,1,0
6,107,107,18,18,0,1,0
22,110,110,1,1,0,1,0
9,118,118,14,4,10,2,1
18,122,122,29,29,0,1,0
16,131,131,19,2,17,4,3
19,176,176,3,3,0,1,0
35,211,211,6,6,0,1,0
2,221,221,1,1,0,1,0
23,231,231,26,26,0,1,0
28,240,240,10,10,0,1,0
31,246,246,33,33,0,1,0
27,246,246,12,2,10,3,2
25,248,248,39,39,0,1,0
10,256,256,28,13,15,4,3
5,263,263,34,34,0,1,0
11,279,279,47,47,0,1,0
36,280,280,53,53,0,1,0
26,301,301,30,9,21,2,1
0,304,304,52,52,0,1,0
24,314,314,28,28,0,1,0
29,328,328,2,2,0,1,0
30,345,345,39,39,0,1,0
20,353,353,12,12,0,1,0
21,353,353,112,64,48,2,1
14,355,355,27,10,17,2,1
3,363,363,6,1,5,2,1
33,403,403,43,43,0,1,0
13,405,405,66,56,10,2,1
4,421,421,67,11,56,3,2
1,424,424,78,32,46,2,1
12,441,441,7,1,6,3,2
15,441,441,11,7,4,2,1
8,445,445,44,14,30,4,3
17,452,452,62,62,0,1,0
34,476,476,55,36,19,2,1
7,490,490,5,2,3,2,1

40,112,112,12,6,6,2,1
11,118,118,7,7,0,1,0
38,122,122,13,8,5,2,1
3,122,122,7,7,0,1,0
4,136,136,2,2,0,1,0
23,177,177,9,3,6,3,2
32,200,200,4,4,0,1,0
10,206,206,6,6,0,1,0
9,239,239,16,2,14,2,1
5,244,244,1,1,0,1,0
26,247,247,90,82,8,3,2
15,249,249,81,81,0,1,0
2,277,277,32,32,0,1,0
31,287,287,17,4,13,3,2
1,290,290,1,1,0,1,0
7,291,291,75,45,30,4,3
20,316,316,13,5,8,3,2
13,324,324,17,17,0,1,0
6,327,327,77,50,27,4,3
28,328,328,64,20,44,3,2
14,338,338,3,3,0,1,0
33,353,353,7,7,0,1,0
34,359,359,20,9,11,2,1
30,366,366,6,6,0,1,0
0,367,367,18,18,0,1,0
22,379,379,15,15,0,1,0
17,390,390,23,23,0,1,0
36,394,394,6,6,0,1,0
8,394,394,1,1,0,1,0
29,408,408,1,1,0,1,0
19,444,444,37,7,30,2,1
12,445,445,85,51,34,3,2
24,446,446,5,1,4,2,1
21,446,446,53,44,9,2,1
16,449,449,22,4,18,3,2
37,457,457,67,19,48,2,1
18,466,466,36,22,14,2,1
35,469,469,258,258,0,1,0
25,471,471,34,34,0,1,0
39,475,475,5,5,0,1,0
27,486,486,47,25,22,3,2

12,124,124,17,17,0,1,0
16,138,138,6,6,0,1,0
10,139,139,2,2,0,1,0
29,156,156,3,3,0,1,0
22,206,206,50,26,24,4,3
9,219,219,7,4,3,2,1
7,222,222,57,57,0,1,0
33,232,232,13,1,12,2,1
18,238,238,10,7,3,2,1
31,242,242,23,20,3,2,1
13,246,246,21,6,15,2,1
19,268,268,23,1,22,3,2
6,273,273,32,23,9,4,3
4,278,278,71,2,69,4,3
26,279,279,3,3,0,1,0
17,292,292,43,18,25,4,3
3,302,302,73,4,69,4,3
25,329,329,6,6,0,1,0
34,345,345,7,7,0,1,0
14,353,353,63,55,8,3,2
11,357,357,6,2,4,2,1
21,369,369,6,3,3,2,1
20,384,384,134,134,0,1,0
27,384,384,95,85,10,3,2
5,387,387,29,29,0,1,0
32,401,401,88,88,0,1,0
2,413,413,44,44,0,1,0
28,431,431,16,16,0,1,0
15,442,442,22,22,0,1,0
23,450,450,28,28,0,1,0
1,452,452,42,42,0,1,0
24,453,453,77,37,40,4,3
30,458,458,24,6,18,3,2
8,468,468,28,12,16,3,2
0,492,492,89,89,0,1,0

38,100,100,1,1,0,1,0
9,115,115,32,32,0,1,0
39,120,120,2,2,0,1,0
6,138,138,3,3,0,1,0
32,143,143,4,4,0,1,0
14,148,148,10,7,3,2,1
26,148,148,40,4,36,3,2
27,163,163,39,34,5,2,1
8,164,164,3,3,0,1,0
29,168,168,39,21,18,4,3
31,211,211,12,6,6,3,2
15,213,213,55,55,0,1,0
13,221,221,1,1,0,1,0
0,221,221,5,5,0,1,0
33,227,227,26,11,15,2,1
19,237,237,1,1,0,1,0
3,241,241,13,13,0,1,0
5,251,251,50,6,44,2,1
4,265,265,23,12,11,2,1
21,269,269,4,4,0,1,0
11,270,270,45,45,0,1,0
28,271,271,88,6,82,3,2
24,278,278,15,15,0,1,0
12,319,319,2,2,0,1,0
7,324,324,24,9,15,4,3
23,328,328,71,19,52,3,2
20,363,363,5,5,0,1,0
36,367,367,32,17,15,2,1
16,396,396,59,15,44,2,1
2,398,398,105,27,78,4,3
34,400,400,9,9,0,1,0
10,417,417,26,26,0,1,0
30,447,447,26,19,7,2,1
22,452,452,3,3,0,1,0
1,456,456,7,7,0,1,0
25,468,468,46,46,0,1,0
35,484,484,12,2,10,3,2
18,487,487,45,9,36,3,2
17,495,495,21,14,7,2,1
37,497,497,35,26,9,4,3

39,103,103,9,9,0,1,0
34,110,110,16,16,0,1,0
11,129,129,9,9,0,1,0
7,135,135,2,2,0,1,0
17,137,137,25,1,24,3,2
8,139,139,20,11,9,4,3
35,140,140,19,1,18,3,2
27,150,150,5,5,0,1,0
19,154,154,6,6,0,1,0
31,173,173,5,5,0,1,0
32,184,184,8,8,0,1,0
24,197,197,4,4,0,1,0
16,198,198,10,10,0,1,0
36,211,211,23,23,0,1,0
13,221,221,33,33,0,1,0
22,226,226,4,1,3,2,1
1,232,232,8,3,5,2,1
18,251,251,21,15,6,3,2
5,288,288,7,7,0,1,0
28,294,294,63,35,28,2,1
33,304,304,5,5,0,1,0
0,305,305,14,14,0,1,0
14,309,309,45,45,0,1,0
21,319,319,23,13,10,3,2
29,335,335,36,28,8,2,1
3,346,346,32,20,12,4,3
20,351,351,106,56,50,3,2
30,373,373,38,26,12,2,1
37,378,378,79,23,56,4,3
38,386,386,7,7,0,1,0
15,411,411,80,56,24,3,2
23,416,416,97,88,9,4,3
4,418,418,7,7,0,1,0
25,420,420,94,58,36,3,2
9,422,422,9,9,0,1,0
10,426,426,37,2,35,2,1
12,427,427,41,41,0,1,0
6,438,438,1,1,0,1,0
2,485,485,51,29,22,3,2
26,498,498,65,65,0,1,0

27,101,101,9,9,0,1,0
3,102,102,5,5,0,1,0
29,106,106,13,13,0,1,0
9,114,114,5,5,0,1,0
21,125,125,4,1,3,2,1
1,138,138,19,19,0,1,0
30,146,146,18,18,0,1,0
33,150,150,13,4,9,2,1
11,189,189,24,6,18,4,3
15,190,190,86,86,0,1,0
6,213,213,1,1,0,1,0
2,255,255,1,1,0,1,0
32,263,263,9,1,8,3,2
36,275,275,71,71,0,1,0
38,280,280,8,8,0,1,0
16,305,305,91,66,25,2,1
22,306,306,7,7,0,1,0
37,312,312,21,1,20,2,1
35,325,325,6,6,0,1,0
24,332,332,19,3,16,2,1
10,352,352,4,4,0,1,0
31,354,354,19,10,9,2,1
23,369,369,41,41,0,1,0
8,372,372,26,26,0,1,0
17,374,374,8,8,0,1,0
18,390,390,20,20,0,1,0
26,392,392,23,23,0,1,0
34,400,400,74,74,0,1,0
28,401,401,166,67,99,4,3
20,402,402,6,6,0,1,0
19,407,407,43,26,17,2,1
5,422,422,42,42,0,1,0
7,444,444,71,71,0,1,0
0,444,444,57,57,0,1,0
25,453,453,77,39,38,3,2
4,464,464,10,10,0,1,0
13,471,471,3,3,0,1,0
12,478,478,25,25,0,1,0
14,487,487,27,27,0,1,0

35,102,102,29,14,15,3,2
24,106,106,10,2,8,3,2
31,115,115,44,44,0,1,0
26,117,117,4,4,0,1,0
12,156,156,36,36,0,1,0
0,169,169,4,4,0,1,0
14,190,190,16,5,11,2,1
30,196,196,23,23,0,1,0
8,197,197,8,8,0,1,0
19,218,218,3,3,0,1,0
34,223,223,23,23,0,1,0
37,243,243,3,3,0,1,0
25,253,253,8,8,0,1,0
21,255,255,21,21,0,1,0
28,260,260,17,17,0,1,0
3,263,263,5,5,0,1,0
27,275,275,11,11,0,1,0
5,281,281,1,1,0,1,0
11,289,289,12,4,8,3,2
43,317,317,11,11,0,1,0
13,318,318,26,11,15,4,3
41,330,330,42,29,13,2,1
9,333,333,2,2,0,1,0
7,340,340,4,4,0,1,0
29,340,340,76,27,49,2,1
15,341,341,20,14,6,3,2
40,361,361,101,101,0,1,0
4,371,371,6,6,0,1,0
18,377,377,49,49,0,1,0
39,388,388,9,9,0,1,0
22,389,389,35,26,9,2,1
2,408,408,114,98,16,2,1
42,420,420,10,4,6,2,1
16,421,421,12,12,0,1,0
32,426,426,10,3,7,2,1
33,447,447,23,23,0,1,0
20,447,447,48,8,40,2,1
6,453,453,36,36,0,1,0
1,455,455,17,8,9,2,1
10,461,461,1,1,0,1,0
38,466,466,25,6,19,2,1
23,482,482,138,107,31,2,1
44,484,484,20,8,12,3,2
17,498,498,11,3,8,2,1
36,499,499,14,3,11,3,2

5,104,104,6,6,0,1,0
17,109,109,3,3,0,1,0
26,111,111,10,10,0,1,0
16,127,127,23,23,0,1,0
12,140,140,10,10,0,1,0
33,143,143,5,1,4,2,1
31,148,148,5,5,0,1,0
14,169,169,2,2,0,1,0
7,198,198,18,10,8,2,1
10,201,201,13,3,10,2,1
4,212,212,9,5,4,2,1
22,221,221,8,8,0,1,0
2,225,225,48,32,16,3,2
19,294,294,3,3,0,1,0
23,309,309,79,79,0,1,0
13,321,321,59,4,55,3,2
20,329,329,23,17,6,3,2
24,352,352,67,67,0,1,0
34,356,356,8,2,6,3,2
0,358,358,51,33,18,2,1
29,363,363,26,20,6,2,1
9,372,372,95,38,57,4,3
21,373,373,10,10,0,1,0
8,375,375,34,12,22,2,1
11,437,437,20,2,18,3,2
15,439,439,112,81,31,2,1
25,444,444,22,22,0,1,0
6,446,446,124,39,85,4,3
30,449,449,20,20,0,1,0
3,456,456,7,3,4,2,1
28,461,461,21,21,0,1,0
18,467,467,162,150,12,4,3
27,473,473,127,127,0,1,0
1,474,474,39,3,36,4,3
32,477,477,64,64,0,1,0

0,104,104,14,3,11,2,1
4,105,105,1,1,0,1,0
22,107,107,7,1,6,3,2
25,111,111,1,1,0,1,0
39,115,115,4,4,0,1,0
9,131,131,6,6,0,1,0
23,149,149,20,17,3,2,1
16,171,171,15,15,0,1,0
27,171,171,58,58,0,1,0
26,172,172,5,5,0,1,0
3,176,176,23,23,0,1,0
14,177,177,5,2,3,2,1
28,181,181,15,9,6,2,1
32,194,194,1,1,0,1,0
38,253,253,5,5,0,1,0
31,255,255,17,7,10,2,1
33,260,260,74,74,0,1,0
21,273,273,33,21,12,4,3
8,275,275,45,45,0,1,0
30,282,282,21,8,13,2,1
6,283,283,13,13,0,1,0
24,283,283,3,3,0,1,0
1,285,285,24,24,0,1,0
34,300,300,62,62,0,1,0
40,306,306,13,5,8,3,2
35,315,315,3,3,0,1,0
13,316,316,38,38,0,1,0
10,330,330,30,30,0,1,0
20,333,333,31,27,4,2,1
29,335,335,155,155,0,1,0
36,352,352,22,7,15,4,3
19,354,354,31,31,0,1,0
11,362,362,1,1,0,1,0
7,381,381,90,53,37,2,1
2,419,419,1,1,0,1,0
15,426,426,66,66,0,1,0
17,439,439,35,35,0,1,0
5,452,452,76,28,48,4,3
37,467,467,5,2,3,2,1
18,471,471,6,6,0,1,0
12,490,490,1,1,0,1,0

37,102,102,14,14,0,1,0
12,116,116,2,2,0,1,0
8,128,128,14,14,0,1,0
10,138,138,9,5,4,2,1
17,139,139,1,1,0,1,0
0,144,144,10,10,0,1,0
1,148,148,6,6,0,1,0
14,149,149,22,11,11,2,1
11,151,151,1,1,0,1,0
6,189,189,3,3,0,1,0
28,193,193,9,1,8,2,1
25,201,201,2,2,0,1,0
4,203,203,11,11,0,1,0
26,210,210,36,28,8,3,2
20,222,222,8,5,3,2,1
34,224,224,11,11,0,1,0
40,234,234,20,20,0,1,0
24,235,235,25,9,16,3,2
13,242,242,15,7,8,2,1
39,251,251,23,16,7,2,1
38,252,252,72,66,6,2,1
16,262,262,5,1,4,2,1
21,266,266,42,42,0,1,0
2,267,267,25,1,24,3,2
22,275,275,3,3,0,1,0
31,290,290,36,18,18,3,2
23,297,297,28,16,12,2,1
33,303,303,13,13,0,1,0
18,361,361,48,18,30,2,1
27,364,364,38,38,0,1,0
9,365,365,21,12,9,2,1
32,377,377,12,12,0,1,0
7,377,377,1,1,0,1,0
3,386,386,148,148,0,1,0
5,397,397,51,51,0,1,0
36,401,401,17,1,16,2,1
15,416,416,14,2,12,2,1
35,455,455,23,23,0,1,0
29,458,458,99,67,32,3,2
19,482,482,121,29,92,3,2
30,495,495,97,73,24,2,1
41,496,496,27,2,25,3,2

6,102,102,14,14,0,1,0
12,105,105,7,2,5,2,1
20,106,106,2,2,0,1,0
40,108,108,20,20,0,1,0
17,110,110,10,1,9,4,3
34,124,124,2,2,0,1,0
3,130,130,14,14,0,1,0
38,133,133,7,1,6,2,1
31,142,142,1,1,0,1,0
27,147,147,15,2,13,2,1
23,171,171,22,17,5,2,1
35,171,171,5,5,0,1,0
39,179,179,113,113,0,1,0
0,180,180,8,8,0,1,0
28,195,195,4,1,3,2,1
16,199,199,13,13,0,1,0
29,203,203,4,4,0,1,0
1,207,207,4,1,3,2,1
2,217,217,1,1,0,1,0
33,229,229,19,19,0,1,0
11,233,233,83,59,24,4,3
36,239,239,28,24,4,2,1
15,241,241,54,54,0,1,0
19,263,263,5,5,0,1,0
5,280,280,28,15,13,2,1
18,283,283,19,9,10,2,1
13,283,283,2,2,0,1,0
14,305,305,13,13,0,1,0
24,319,319,9,9,0,1,0
22,325,325,20,20,0,1,0
9,337,337,46,17,29,2,1
30,348,348,8,8,0,1,0
7,353,353,48,48,0,1,0
26,376,376,71,36,35,2,1
4,381,381,2,2,0,1,0
21,395,395,25,17,8,2,1
37,411,411,4,4,0,1,0
32,434,434,66,52,14,3,2
8,445,445,22,22,0,1,0
10,448,448,62,12,50,3,2
25,470,470,44,35,9,2,1

33,101,101,8,8,0,1,0
39,111,111,20,8,12,2,1
35,116,116,10,10,0,1,0
30,122,122,5,5,0,1,0
36,131,131,19,19,0,1,0
4,147,147,25,25,0,1,0
2,178,178,21,7,14,3,2
42,179,179,17,17,0,1,0
23,185,185,7,7,0,1,0
3,185,185,17,2,15,4,3
26,186,186,12,12,0,1,0
43,194,194,26,26,0,1,0
1,200,200,18,2,16,2,1
17,206,206,1,1,0,1,0
20,232,232,25,12,13,2,1
34,248,248,46,40,6,3,2
13,256,256,25,25,0,1,0
45,263,263,13,4,9,4,3
11,266,266,29,11,18,4,3
46,267,267,37,37,0,1,0
37,269,269,37,37,0,1,0
28,287,287,36,5,31,2,1
22,320,320,7,4,3,2,1
29,321,321,29,19,10,2,1
8,326,326,16,4,12,4,3
38,328,328,28,1,27,4,3
7,338,338,2,2,0,1,0
15,338,338,21,21,0,1,0
25,351,351,18,6,12,4,3
41,353,353,1,1,0,1,0
31,368,368,7,1,6,2,1
9,373,373,4,4,0,1,0
40,381,381,18,7,11,2,1
12,381,381,55,55,0,1,0
27,400,400,28,15,13,2,1
10,425,425,33,33,0,1,0
44,444,444,21,12,9,4,3
6,449,449,26,26,0,1,0
18,454,454,4,4,0,1,0
19,462,462,69,69,0,1,0
14,467,467,1,1,0,1,0
21,487,487,35,9,26,3,2
32,492,492,126,120,6,2,1
0,492,492,99,99,0,1,0
24,496,496,1,1,0,1,0
16,496,496,8,8,0,1,0
5,498,498,4,1,3,2,1

6,101,101,3,3,0,1,0
19,102,102,4,4,0,1,0
24,103,103,9,9,0,1,0
20,106,106,7,7,0,1,0
35,119,119,9,4,5,2,1
5,143,143,38,38,0,1,0
18,150,150,19,7,12,4,3
21,161,161,8,8,0,1,0
4,165,165,21,9,12,3,2
3,166,166,34,26,8,2,1
32,183,183,9,9,0,1,0
1,193,193,20,20,0,1,0
22,200,200,19,14,5,2,1
16,203,203,67,67,0,1,0
30,224,224,16,16,0,1,0
34,230,230,38,38,0,1,0
15,243,243,58,58,0,1,0
11,276,276,2,2,0,1,0
23,288,288,2,2,0,1,0
7,311,311,24,19,5,2,1
8,318,318,24,24,0,1,0
10,335,335,34,34,0,1,0
13,338,338,9,9,0,1,0
27,377,377,42,16,26,3,2
31,381,381,51,51,0,1,0
9,386,386,1,1,0,1,0
0,396,396,20,20,0,1,0
2,406,406,70,70,0,1,0
17,412,412,5,5,0,1,0
29,424,424,34,7,27,3,2
26,436,436,65,28,37,4,3
25,444,444,84,6,78,4,3
14,473,473,13,13,0,1,0
12,475,475,29,26,3,2,1
33,487,487,141,96,45,2,1
28,488,488,77,77,0,1,0

2,138,138,3,3,0,1,0
5,143,143,35,35,0,1,0
27,166,166,4,4,0,1,0
26,167,167,2,2,0,1,0
15,177,177,39,24,15,2,1
29,179,179,7,7,0,1,0
10,180,180,6,6,0,1,0
34,181,181,27,27,0,1,0
1,214,214,34,6,28,2,1
23,224,224,9,1,8,3,2
4,229,229,2,2,0,1,0
6,229,229,1,1,0,1,0
17,233,233,31,31,0,1,0
7,292,292,56,25,31,2,1
20,297,297,13,13,0,1,0
25,301,301,18,9,9,4,3
24,305,305,4,4,0,1,0
9,319,319,4,4,0,1,0
22,323,323,16,10,6,3,2
28,337,337,76,52,24,2,1
33,346,346,2,2,0,1,0
32,352,352,9,9,0,1,0
8,368,368,21,21,0,1,0
30,374,374,32,28,4,2,1
12,394,394,40,40,0,1,0
16,412,412,178,178,0,1,0
19,447,447,35,6,29,2,1
13,452,452,28,4,24,3,2
11,467,467,24,24,0,1,0
18,477,477,123,45,78,4,3
31,479,479,73,73,0,1,0
14,489,489,241,103,138,4,3
0,493,493,10,6,4,2,1
3,494,494,110,84,26,3,2
21,499,499,56,56,0,1,0

22,110,110,7,7,0,1,0
11,117,117,53,6,47,2,1
0,119,119,14,14,0,1,0
14,124,124,2,2,0,1,0
33,127,127,8,3,5,2,1
25,132,132,5,2,3,2,1
18,166,166,12,12,0,1,0
17,171,171,14,14,0,1,0
6,205,205,58,58,0,1,0
31,213,213,8,8,0,1,0
9,229,229,27,21,6,2,1
26,238,238,6,6,0,1,0
10,241,241,20,2,18,4,3
12,242,242,22,5,17,2,1
28,258,258,22,18,4,2,1
21,259,259,19,19,0,1,0
34,270,270,7,7,0,1,0
13,275,275,56,56,0,1,0
27,281,281,49,49,0,1,0
2,294,294,36,36,0,1,0
29,316,316,14,3,11,2,1
8,319,319,5,2,3,2,1
1,330,330,17,6,11,2,1
24,348,348,56,5,51,4,3
19,351,351,10,1,9,2,1
30,373,373,16,12,4,2,1
4,389,389,42,42,0,1,0
7,393,393,9,9,0,1,0
15,417,417,66,26,40,3,2
32,457,457,5,5,0,1,0
23,458,458,171,167,4,2,1
16,458,458,188,62,126,4,3
20,476,476,66,66,0,1,0
5,486,486,11,3,8,3,2
3,500,500,17,17,0,1,0

10,155,155,5,2,3,2,1
27,175,175,17,7,10,3,2
26,182,182,5,5,0,1,0
16,182,182,14,7,7,3,2
19,195,195,1,1,0,1,0
11,198,198,30,30,0,1,0
28,198,198,13,13,0,1,0
30,206,206,33,9,24,2,1
17,218,218,1,1,0,1,0
29,232,232,48,20,28,3,2
13,265,265,9,4,5,2,1
6,291,291,52,6,46,3,2
8,297,297,70,4,66,3,2
24,298,298,73,73,0,1,0
14,306,306,4,4,0,1,0
25,326,326,30,16,14,2,1
12,342,342,7,7,0,1,0
31,352,352,35,11,24,2,1
2,371,371,101,101,0,1,0
20,371,371,36,21,15,2,1
9,374,374,75,56,19,2,1
22,375,375,47,10,37,3,2
32,381,381,145,121,24,4,3
15,387,387,2,2,0,1,0
18,394,394,52,17,35,2,1
4,397,397,109,13,96,4,3
7,408,408,89,21,68,3,2
0,423,423,16,8,8,3,2
3,427,427,55,34,21,3,2
21,435,435,44,14,30,4,3
5,463,463,41,29,12,2,1
1,498,498,14,14,0,1,0
23,499,499,2,2,0,1,0

31,104,104,22,13,9,4,3
27,127,127,4,4,0,1,0
0,134,134,3,3,0,1,0
38,141,141,81,81,0,1,0
19,148,148,5,5,0,1,0
11,159,159,31,24,7,2,1
37,187,187,31,31,0,1,0
28,191,191,1,1,0,1,0
29,235,235,17,1,16,3,2
12,237,237,10,5,5,2,1
35,240,240,9,9,0,1,0
10,246,246,20,20,0,1,0
4,246,246,34,10,24,4,3
20,255,255,44,44,0,1,0
22,272,272,12,6,6,3,2
13,276,276,20,20,0,1,0
7,285,285,1,1,0,1,0
15,288,288,3,3,0,1,0
1,289,289,81,37,44,2,1
34,299,299,8,2,6,3,2
24,306,306,31,31,0,1,0
6,308,308,20,10,10,3,2
21,358,358,13,13,0,1,0
5,370,370,31,10,21,4,3
8,394,394,15,8,7,2,1
14,397,397,39,39,0,1,0
36,408,408,59,27,32,2,1
17,416,416,28,1,27,4,3
16,420,420,43,25,18,3,2
2,440,440,123,37,86,3,2
32,448,448,16,16,0,1,0
9,451,451,76,76,0,1,0
3,452,452,53,13,40,3,2
18,461,461,2,2,0,1,0
25,462,462,14,14,0,1,0
26,462,462,35,35,0,1,0
33,465,465,25,9,16,2,1
30,469,469,27,2,25,2,1
23,498,498,35,22,13,2,1

20,111,111,11,11,0,1,0
29,119,119,13,13,0,1,0
14,128,128,3,3,0,1,0
16,157,157,16,16,0,1,0
31,162,162,7,1,6,3,2
10,165,165,9,9,0,1,0
1,167,167,13,3,10,2,1
12,180,180,9,9,0,1,0
22,181,181,30,9,21,2,1
28,186,186,29,2,27,4,3
18,189,189,60,60,0,1,0
32,200,200,4,4,0,1,0
8,200,200,9,9,0,1,0
27,210,210,9,9,0,1,0
13,211,211,2,2,0,1,0
23,221,221,21,1,20,2,1
24,231,231,52,31,21,2,1
9,239,239,1,1,0,1,0
6,251,251,3,3,0,1,0
26,274,274,10,10,0,1,0
21,291,291,14,14,0,1,0
17,293,293,6,6,0,1,0
11,303,303,19,14,5,2,1
4,308,308,91,91,0,1,0
5,311,311,106,89,17,2,1
25,323,323,75,45,30,2,1
30,329,329,18,1,17,4,3
15,376,376,30,30,0,1,0
3,379,379,183,99,84,4,3
0,420,420,10,2,8,3,2
19,477,477,31,13,18,2,1
2,492,492,115,88,27,2,1
7,499,499,104,59,45,4,3

25,111,111,5,1,4,2,1
2,116,116,1,1,0,1,0
31,152,152,25,25,0,1,0
18,153,153,31,31,0,1,0
26,181,181,7,3,4,2,1
33,186,186,46,46,0,1,0
11,187,187,6,6,0,1,0
3,192,192,25,25,0,1,0
10,202,202,10,4,6,2,1
27,235,235,19,19,0,1,0
0,244,244,10,4,6,3,2
8,269,269,88,71,17,2,1
29,278,278,99,85,14,2,1
24,282,282,26,26,0,1,0
1,288,288,47,47,0,1,0
17,299,299,29,29,0,1,0
5,308,308,55,55,0,1,0
14,321,321,110,110,0,1,0
19,344,344,7,2,5,2,1
22,353,353,1,1,0,1,0
4,353,353,14,2,12,3,2
16,367,367,15,10,5,2,1
23,382,382,35,35,0,1,0
20,386,386,11,4,7,2,1
15,404,404,19,19,0,1,0
6,405,405,121,99,22,2,1
13,409,409,46,33,13,4,3
9,424,424,65,29,36,4,3
21,425,425,24,24,0,1,0
32,432,432,91,53,38,3,2
12,446,446,6,6,0,1,0
30,464,464,20,20,0,1,0
7,468,468,5,2,3,2,1
28,496,496,33,33,0,1,0

22,108,108,1,1,0,1,0
11,113,113,27,9,18,2,1
35,129,129,5,5,0,1,0
2,132,132,2,2,0,1,0
16,136,136,25,3,22,2,1
34,155,155,4,4,0,1,0
5,158,158,11,4,7,2,1
10,163,163,46,7,39,4,3
29,187,187,6,6,0,1,0
24,219,219,5,1,4,2,1
25,224,224,24,24,0,1,0
15,232,232,40,40,0,1,0
17,259,259,16,4,12,4,3
28,292,292,6,3,3,2,1
31,321,321,31,11,20,3,2
8,340,340,44,8,36,2,1
9,346,346,36,36,0,1,0
30,349,349,19,19,0,1,0
12,356,356,58,16,42,4,3
18,359,359,32,13,19,2,1
23,360,360,4,4,0,1,0
6,364,364,5,5,0,1,0
0,369,369,1,1,0,1,0
1,373,373,9,9,0,1,0
26,376,376,29,5,24,3,2
4,378,378,50,34,16,2,1
7,385,385,41,2,39,2,1
19,398,398,302,278,24,2,1
21,399,399,11,3,8,3,2
32,406,406,25,7,18,4,3
3,447,447,30,30,0,1,0
33,448,448,20,5,15,4,3
13,456,456,64,50,14,3,2
27,468,468,147,71,76,4,3
14,468,468,27,27,0,1,0
20,493,493,42,42,0,1,0

16,119,119,29,29,0,1,0
36,155,155,15,15,0,1,0
23,162,162,26,2,24,4,3
12,180,180,68,53,15,4,3
20,182,182,34,27,7,2,1
27,188,188,23,2,21,2,1
22,192,192,16,16,0,1,0
15,197,197,19,19,0,1,0
30,207,207,15,15,0,1,0
17,237,237,13,1,12,3,2
32,237,237,9,5,4,2,1
26,268,268,24,24,0,1,0
5,278,278,12,2,10,3,2
18,279,279,14,2,12,3,2
25,303,303,3,3,0,1,0
9,312,312,20,7,13,2,1
21,313,313,29,29,0,1,0
4,322,322,7,2,5,2,1
34,325,325,89,71,18,2,1
3,326,326,21,1,20,3,2
19,326,326,50,50,0,1,0
31,332,332,26,26,0,1,0
35,349,349,7,7,0,1,0
11,349,349,6,1,5,2,1
14,366,366,73,10,63,4,3
1,370,370,49,49,0,1,0
24,379,379,73,26,47,2,1
13,381,381,44,7,37,2,1
6,390,390,1,1,0,1,0
28,394,394,20,20,0,1,0
10,397,397,153,36,117,4,3
8,425,425,11,2,9,2,1
29,458,458,69,69,0,1,0
33,461,461,10,10,0,1,0
2,461,461,5,5,0,1,0
7,496,496,8,3,5,2,1
0,500,500,15,15,0,1,0

41,103,103,3,3,0,1,0
31,116,116,4,4,0,1,0
5,119,119,8,3,5,2,1
3,125,125,1,1,0,1,0
38,125,125,5,5,0,1,0
19,139,139,5,1,4,2,1
40,142,142,15,15,0,1,0
7,152,152,1,1,0,1,0
14,165,165,17,3,14,3,2
22,166,166,22,22,0,1,0
25,168,168,36,36,0,1,0
32,177,177,5,5,0,1,0
0,186,186,17,17,0,1,0
36,197,197,21,1,20,2,1
16,206,206,8,8,0,1,0
1,217,217,10,5,5,2,1
34,218,218,29,29,0,1,0
17,224,224,46,20,26,3,2
15,233,233,41,38,3,2,1
27,235,235,16,16,0,1,0
21,239,239,13,1,12,4,3
30,260,260,10,10,0,1,0
39,282,282,21,11,10,3,2
6,291,291,13,13,0,1,0
42,292,292,35,35,0,1,0
37,305,305,131,94,37,3,2
10,310,310,4,4,0,1,0
2,324,324,14,10,4,2,1
20,328,328,10,1,9,4,3
33,336,336,26,4,22,4,3
28,347,347,54,8,46,2,1
8,349,349,4,1,3,2,1
18,367,367,81,81,0,1,0
11,373,373,46,1,45,4,3
12,400,400,52,52,0,1,0
24,411,411,30,23,7,2,1
26,429,429,3,3,0,1,0
23,433,433,39,13,26,2,1
13,438,438,1,1,0,1,0
29,459,459,84,42,42,4,3
35,478,478,13,13,0,1,0
4,485,485,63,25,38,4,3
9,497,497,48,18,30,4,3

3,108,108,14,14,0,1,0
2,114,114,1,1,0,1,0
37,126,126,6,6,0,1,0
23,134,134,12,12,0,1,0
12,136,136,11,11,0,1,0
31,138,138,4,1,3,2,1
39,140,140,32,32,0,1,0
32,178,178,18,18,0,1,0
19,201,201,8,8,0,1,0
9,219,219,4,4,0,1,0
15,224,224,38,38,0,1,0
0,225,225,2,2,0,1,0
6,237,237,1,1,0,1,0
38,237,237,39,20,19,2,1
40,261,261,48,48,0,1,0
29,265,265,8,8,0,1,0
5,273,273,29,17,12,2,1
35,277,277,79,70,9,4,3
21,289,289,5,2,3,2,1
22,301,301,44,25,19,4,3
30,308,308,8,8,0,1,0
20,313,313,2,2,0,1,0
10,313,313,44,11,33,2,1
11,328,328,1,1,0,1,0
7,335,335,22,4,18,2,1
18,343,343,1,1,0,1,0
24,349,349,23,4,19,2,1
34,360,360,69,69,0,1,0
28,364,364,134,134,0,1,0
4,369,369,12,3,9,2,1
8,384,384,18,18,0,1,0
25,398,398,10,1,9,4,3
27,413,413,1,1,0,1,0
14,422,422,18,18,0,1,0
1,428,428,105,89,16,2,1
17,451,451,93,93,0,1,0
41,455,455,9,9,0,1,0
26,459,459,5,1,4,2,1
36,470,470,12,2,10,2,1
16,480,480,9,2,7,2,1
33,483,483,23,5,18,2,1
13,492,492,178,178,0,1,0

26,126,126,28,28,0,1,0
7,130,130,40,40,0,1,0
21,158,158,56,56,0,1,0
14,165,165,8,4,4,2,1
24,173,173,6,6,0,1,0
1,177,177,3,3,0,1,0
9,182,182,11,11,0,1,0
29,184,184,5,5,0,1,0
28,200,200,12,12,0,1,0
2,205,205,29,19,10,2,1
19,209,209,11,11,0,1,0
25,211,211,10,10,0,1,0
3,221,221,51,51,0,1,0
16,234,234,12,6,6,3,2
13,247,247,9,1,8,2,1
18,254,254,55,55,0,1,0
8,261,261,5,2,3,2,1
20,304,304,31,31,0,1,0
5,304,304,30,12,18,4,3
10,313,313,18,18,0,1,0
30,319,319,23,23,0,1,0
4,328,328,23,23,0,1,0
6,329,329,71,71,0,1,0
11,334,334,115,115,0,1,0
31,366,366,42,4,38,4,3
0,382,382,19,19,0,1,0
17,420,420,36,13,23,2,1
12,425,425,107,60,47,4,3
15,448,448,39,39,0,1,0
32,474,474,19,19,0,1,0
23,485,485,7,7,0,1,0
27,490,490,50,6,44,3,2
22,493,493,100,54,46,2,1

0,107,107,52,22,30,2,1
1,108,108,11,1,10,2,1
9,113,113,15,15,0,1,0
22,120,120,62,62,0,1,0
30,141,141,26,26,0,1,0
20,142,142,2,2,0,1,0
19,157,157,28,2,26,2,1
31,162,162,6,1,5,2,1
7,168,168,10,10,0,1,0
21,175,175,45,30,15,2,1
34,219,219,16,13,3,2,1
12,236,236,3,3,0,1,0
17,240,240,18,8,10,3,2
18,256,256,24,9,15,4,3
33,265,265,60,60,0,1,0
3,284,284,23,10,13,2,1
29,285,285,2,2,0,1,0
27,291,291,17,2,15,3,2
15,302,302,5,5,0,1,0
24,302,302,1,1,0,1,0
2,302,302,18,18,0,1,0
6,310,310,25,7,18,2,1
14,315,315,48,13,35,2,1
25,316,316,18,18,0,1,0
4,319,319,79,67,12,4,3
10,330,330,33,33,0,1,0
11,346,346,46,46,0,1,0
5,349,349,11,11,0,1,0
8,350,350,40,40,0,1,0
13,351,351,32,4,28,2,1
32,354,354,5,5,0,1,0
28,358,358,10,10,0,1,0
16,370,370,18,18,0,1,0
23,389,389,22,22,0,1,0
26,390,390,1,1,0,1,0

13,110,110,11,5,6,3,2
2,112,112,1,1,0,1,0
8,141,141,33,30,3,2,1
11,146,146,4,4,0,1,0
18,153,153,9,9,0,1,0
21,159,159,1,1,0,1,0
32,184,184,27,16,11,2,1
37,193,193,4,4,0,1,0
4,214,214,16,16,0,1,0
34,214,214,16,2,14,3,2
31,243,243,21,21,0,1,0
9,244,244,2,2,0,1,0
16,253,253,16,1,15,4,3
14,254,254,12,12,0,1,0
27,272,272,22,22,0,1,0
29,278,278,53,53,0,1,0
15,296,296,90,21,69,4,3
36,309,309,146,89,57,4,3
24,313,313,29,29,0,1,0
23,330,330,43,34,9,2,1
33,331,331,39,39,0,1,0
7,343,343,4,4,0,1,0
12,344,344,44,44,0,1,0
1,349,349,132,11,121,4,3
19,351,351,10,1,9,4,3
28,360,360,6,2,4,2,1
30,375,375,12,4,8,2,1
0,391,391,100,100,0,1,0
3,406,406,39,21,18,2,1
5,407,407,6,6,0,1,0
35,419,419,39,39,0,1,0
10,464,464,10,10,0,1,0
20,473,473,40,40,0,1,0
6,476,476,25,25,0,1,0
26,483,483,27,19,8,2,1
22,488,488,75,33,42,2,1
17,495,495,9,4,5,2,1
25,498,498,20,20,0,1,0

19,102,102,4,4,0,1,0
24,123,123,3,3,0,1,0
26,133,133,11,11,0,1,0
38,133,133,20,12,8,2,1
23,134,134,13,6,7,2,1
30,137,137,15,15,0,1,0
3,151,151,21,21,0,1,0
8,161,161,20,20,0,1,0
40,187,187,39,39,0,1,0
33,201,201,10,1,9,2,1
4,202,202,34,25,9,2,1
12,206,206,1,1,0,1,0
29,212,212,1,1,0,1,0
7,212,212,11,11,0,1,0
27,212,212,6,6,0,1,0
17,220,220,7,3,4,2,1
0,224,224,3,3,0,1,0
37,232,232,71,68,3,2,1
28,237,237,12,8,4,2,1
14,260,260,3,3,0,1,0
31,307,307,14,5,9,2,1
34,331,331,30,30,0,1,0
5,339,339,80,14,66,3,2
11,343,343,31,31,0,1,0
36,348,348,28,5,23,2,1
10,352,352,33,20,13,2,1
13,366,366,18,9,9,4,3
25,367,367,74,12,62,4,3
39,377,377,28,11,17,2,1
35,383,383,11,2,9,4,3
20,383,383,37,5,32,2,1
41,400,400,51,51,0,1,0
18,415,415,1,1,0,1,0
22,418,418,9,9,0,1,0
21,418,418,34,34,0,1,0
15,453,453,15,6,9,2,1
32,454,454,83,5,78,4,3
16,474,474,9,1,8,2,1
1,478,478,148,104,44,2,1
9,481,481,2,2,0,1,0
2,491,491,77,11,66,4,3
6,492,492,61,61,0,1,0

9,101,101,4,4,0,1,0
5,105,105,1,1,0,1,0
39,112,112,4,4,0,1,0
4,130,130,25,25,0,1,0
36,145,145,3,3,0,1,0
38,163,163,26,11,15,4,3
27,167,167,3,3,0,1,0
12,168,168,9,9,0,1,0
42,172,172,7,3,4,2,1
45,176,176,11,1,10,2,1
43,178,178,9,3,6,2,1
17,181,181,25,25,0,1,0
13,183,183,3,3,0,1,0
22,195,195,27,4,23,2,1
25,200,200,39,15,24,3,2
40,206,206,8,2,6,2,1
16,210,210,15,3,12,4,3
6,213,213,11,2,9,4,3
31,218,218,33,4,29,2,1
2,233,233,15,15,0,1,0
24,238,238,7,7,0,1,0
3,259,259,2,2,0,1,0
15,260,260,13,13,0,1,0
37,271,271,11,11,0,1,0
44,289,289,34,1,33,4,3
30,289,289,23,23,0,1,0
47,316,316,39,24,15,2,1
23,327,327,5,5,0,1,0
33,338,338,39,39,0,1,0
8,344,344,21,6,15,2,1
28,355,355,103,103,0,1,0
11,362,362,6,3,3,2,1
35,364,364,134,134,0,1,0
1,367,367,1,1,0,1,0
20,373,373,3,3,0,1,0
0,375,375,44,44,0,1,0
10,404,404,7,7,0,1,0
14,405,405,15,5,10,2,1
7,410,410,11,11,0,1,0
18,420,420,30,9,21,2,1
29,429,429,37,1,36,4,3
26,443,443,2,2,0,1,0
41,443,443,25,25,0,1,0
19,443,443,16,4,12,4,3
34,446,446,36,36,0,1,0
46,447,447,54,54,0,1,0
32,458,458,87,17,70,4,3
21,464,464,56,56,0,1,0

12,128,128,2,2,0,1,0
45,131,131,4,4,0,1,0
3,145,145,2,2,0,1,0
17,146,146,10,10,0,1,0
33,148,148,22,5,17,3,2
35,162,162,20,20,0,1,0
39,170,170,5,2,3,2,1
8,172,172,1,1,0,1,0
38,200,200,24,24,0,1,0
0,204,204,3,3,0,1,0
14,206,206,11,11,0,1,0
28,215,215,4,4,0,1,0
5,217,217,1,1,0,1,0
21,220,220,2,2,0,1,0
31,225,225,73,27,46,3,2
36,240,240,23,23,0,1,0
27,258,258,14,14,0,1,0
30,262,262,69,32,37,2,1
23,281,281,11,8,3,2,1
48,298,298,25,21,4,2,1
43,307,307,9,9,0,1,0
4,311,311,21,21,0,1,0
41,312,312,21,5,16,3,2
46,317,317,14,14,0,1,0
9,320,320,26,22,4,2,1
37,321,321,27,15,12,2,1
16,322,322,5,5,0,1,0
25,325,325,33,33,0,1,0
40,336,336,62,9,53,4,3
15,339,339,29,16,13,2,1
32,341,341,1,1,0,1,0
6,343,343,3,3,0,1,0
42,351,351,75,45,30,4,3
19,356,356,16,16,0,1,0
34,370,370,8,2,6,3,2
22,379,379,40,1,39,4,3
11,381,381,47,31,16,3,2
47,382,382,83,83,0,1,0
2,384,384,2,2,0,1,0
7,384,384,21,6,15,4,3
49,413,413,40,6,34,4,3
26,428,428,48,6,42,2,1
1,441,441,21,21,0,1,0
44,442,442,7,2,5,2,1
13,445,445,6,3,3,2,1
10,458,458,3,3,0,1,0
24,467,467,30,17,13,2,1
29,476,476,72,50,22,2,1
18,484,484,73,73,0,1,0
20,489,489,50,37,13,3,2

12,104,104,1,1,0,1,0
25,112,112,5,5,0,1,0
5,113,113,15,15,0,1,0
26,120,120,2,2,0,1,0
22,123,123,3,3,0,1,0
33,132,132,3,3,0,1,0
3,157,157,11,11,0,1,0
36,171,171,7,1,6,2,1
24,178,178,5,1,4,2,1
29,192,192,27,27,0,1,0
8,196,196,18,18,0,1,0
4,203,203,25,13,12,2,1
37,210,210,22,22,0,1,0
0,226,226,18,3,15,2,1
18,265,265,26,20,6,3,2
21,276,276,48,2,46,4,3
7,294,294,66,53,13,2,1
19,296,296,20,20,0,1,0
9,298,298,1,1,0,1,0
23,299,299,50,40,10,2,1
15,300,300,10,10,0,1,0
6,310,310,63,27,36,2,1
13,321,321,37,31,6,2,1
35,335,335,20,2,18,2,1
20,338,338,68,68,0,1,0
11,355,355,3,3,0,1,0
14,364,364,115,115,0,1,0
2,368,368,2,2,0,1,0
16,374,374,48,48,0,1,0
10,378,378,61,43,18,4,3
34,380,380,15,15,0,1,0
28,392,392,8,8,0,1,0
17,399,399,24,6,18,4,3
1,425,425,16,16,0,1,0
27,438,438,77,69,8,3,2
32,464,464,97,71,26,2,1
31,480,480,75,75,0,1,0
30,497,497,121,66,55,4,3

29,100,100,17,17,0,1,0
20,101,101,11,11,0,1,0
18,114,114,5,5,0,1,0
3,114,114,1,1,0,1,0
1,121,121,8,8,0,1,0
22,127,127,16,16,0,1,0
26,171,171,10,10,0,1,0
23,172,172,16,1,15,2,1
19,178,178,11,1,10,4,3
0,186,186,18,8,10,3,2
17,208,208,10,10,0,1,0
36,212,212,11,3,8,3,2
4,217,217,36,13,23,2,1
33,218,218,9,9,0,1,0
40,223,223,8,8,0,1,0
8,227,227,75,75,0,1,0
27,227,227,7,7,0,1,0
31,229,229,16,16,0,1,0
24,231,231,93,53,40,2,1
39,246,246,13,13,0,1,0
16,298,298,12,12,0,1,0
10,303,303,6,6,0,1,0
13,310,310,52,38,14,2,1
25,324,324,13,13,0,1,0
9,335,335,43,7,36,4,3
37,360,360,40,40,0,1,0
21,365,365,22,5,17,2,1
35,367,367,16,16,0,1,0
11,379,379,48,24,24,2,1
28,387,387,47,33,14,2,1
6,389,389,68,68,0,1,0
2,394,394,18,18,0,1,0
15,408,408,7,7,0,1,0
32,422,422,151,151,0,1,0
34,437,437,1,1,0,1,0
5,447,447,45,36,9,2,1
14,447,447,3,3,0,1,0
7,456,456,32,20,12,4,3
12,460,460,6,6,0,1,0
30,468,468,61,58,3,2,1
38,477,477,1,1,0,1,0

27,103,103,2,2,0,1,0
15,123,123,6,6,0,1,0
6,136,136,39,30,9,2,1
28,137,137,7,7,0,1,0
20,138,138,3,3,0,1,0
4,141,141,36,19,17,2,1
14,143,143,2,2,0,1,0
26,152,152,66,66,0,1,0
1,179,179,7,7,0,1,0
3,185,185,14,1,13,2,1
23,193,193,4,4,0,1,0
37,199,199,13,13,0,1,0
34,229,229,15,15,0,1,0
0,231,231,4,4,0,1,0
5,237,237,1,1,0,1,0
7,237,237,29,5,24,4,3
30,256,256,27,27,0,1,0
33,265,265,33,33,0,1,0
35,267,267,34,34,0,1,0
24,280,280,14,2,12,4,3
21,305,305,17,17,0,1,0
19,305,305,20,16,4,2,1
31,319,319,15,3,12,3,2
25,325,325,20,1,19,3,2
8,329,329,24,24,0,1,0
9,334,334,21,21,0,1,0
29,339,339,30,6,24,4,3
2,340,340,30,14,16,3,2
16,352,352,27,27,0,1,0
12,352,352,40,40,0,1,0
17,361,361,56,30,26,2,1
36,398,398,47,47,0,1,0
32,412,412,25,2,23,2,1
18,414,414,53,53,0,1,0
11,420,420,18,18,0,1,0
10,430,430,80,80,0,1,0
13,450,450,50,50,0,1,0
22,479,479,168,89,79,4,3

23,108,108,5,5,0,1,0
15,116,116,2,2,0,1,0
12,119,119,1,1,0,1,0
17,137,137,8,8,0,1,0
1,145,145,25,5,20,2,1
7,145,145,1,1,0,1,0
19,148,148,19,5,14,3,2
34,152,152,15,15,0,1,0
11,159,159,28,8,20,4,3
9,173,173,11,11,0,1,0
33,173,173,58,58,0,1,0
21,186,186,20,15,5,2,1
22,195,195,69,54,15,4,3
31,201,201,8,8,0,1,0
3,208,208,27,6,21,4,3
40,224,224,16,1,15,4,3
14,225,225,15,15,0,1,0
25,230,230,3,3,0,1,0
2,234,234,8,8,0,1,0
28,254,254,13,13,0,1,0
36,268,268,21,21,0,1,0
6,270,270,22,1,21,4,3
13,273,273,3,3,0,1,0
5,302,302,71,50,21,2,1
35,307,307,32,32,0,1,0
20,309,309,12,12,0,1,0
29,323,323,3,3,0,1,0
32,335,335,25,3,22,3,2
26,358,358,12,6,6,2,1
27,358,358,19,19,0,1,0
37,392,392,42,32,10,3,2
0,400,400,30,30,0,1,0
16,404,404,6,6,0,1,0
18,412,412,99,39,60,3,2
39,418,418,151,151,0,1,0
30,429,429,12,1,11,2,1
8,433,433,8,8,0,1,0
4,438,438,74,6,68,4,3
38,467,467,6,6,0,1,0
24,478,478,35,22,13,2,1
10,480,480,23,23,0,1,0

6,104,104,9,9,0,1,0
3,115,115,10,10,0,1,0
31,121,121,2,2,0,1,0
16,137,137,2,2,0,1,0
35,142,142,13,5,8,3,2
0,143,143,63,31,32,3,2
32,150,150,28,1,27,3,2
25,181,181,12,12,0,1,0
14,195,195,17,17,0,1,0
26,197,197,6,6,0,1,0
12,198,198,17,17,0,1,0
1,223,223,5,5,0,1,0
9,241,241,22,22,0,1,0
37,254,254,64,64,0,1,0
23,259,259,3,3,0,1,0
8,269,269,4,1,3,2,1
33,269,269,48,21,27,4,3
7,294,294,16,7,9,4,3
24,316,316,6,1,5,2,1
28,320,320,7,3,4,2,1
30,338,338,50,50,0,1,0
2,340,340,62,62,0,1,0
29,361,361,108,28,80,3,2
34,370,370,40,40,0,1,0
27,376,376,75,75,0,1,0
18,385,385,6,2,4,2,1
21,389,389,14,14,0,1,0
22,398,398,6,6,0,1,0
10,399,399,26,10,16,3,2
19,400,400,28,12,16,3,2
13,404,404,39,1,38,3,2
4,408,408,41,41,0,1,0
17,420,420,87,87,0,1,0
11,420,420,26,15,11,4,3
15,441,441,14,14,0,1,0
38,448,448,33,19,14,3,2
5,463,463,40,2,38,3,2
20,476,476,11,11,0,1,0
36,482,482,80,38,42,3,2

38,105,105,15,3,12,4,3
18,106,106,10,10,0,1,0
31,120,120,8,8,0,1,0
17,123,123,4,4,0,1,0
22,124,124,7,7,0,1,0
9,133,133,26,11,15,4,3
6,135,135,35,35,0,1,0
0,148,148,1,1,0,1,0
27,154,154,6,6,0,1,0
20,170,170,5,5,0,1,0
28,179,179,6,6,0,1,0
15,196,196,3,3,0,1,0
29,200,200,11,11,0,1,0
23,209,209,59,29,30,4,3
2,218,218,2,2,0,1,0
12,221,221,5,5,0,1,0
11,226,226,5,5,0,1,0
19,252,252,12,12,0,1,0
37,296,296,32,32,0,1,0
21,298,298,11,11,0,1,0
36,298,298,9,9,0,1,0
34,314,314,44,14,30,4,3
16,327,327,10,10,0,1,0
24,350,350,14,9,5,2,1
7,373,373,6,6,0,1,0
8,373,373,24,15,9,4,3
1,385,385,29,29,0,1,0
3,386,386,23,23,0,1,0
26,399,399,14,2,12,4,3
35,402,402,32,32,0,1,0
13,403,403,33,28,5,2,1
4,412,412,164,164,0,1,0
25,413,413,55,48,7,2,1
30,429,429,17,17,0,1,0
14,434,434,26,26,0,1,0
33,438,438,27,3,24,4,3
39,449,449,165,165,0,1,0
10,450,450,33,33,0,1,0
5,457,457,124,24,100,3,2
32,462,462,104,104,0,1,0
40,487,487,1,1,0,1,0

22,107,107,5,5,0,1,0
25,120,120,3,3,0,1,0
4,126,126,12,8,4,2,1
15,134,134,25,12,13,2,1
21,153,153,12,12,0,1,0
18,164,164,7,7,0,1,0
8,192,192,6,1,5,2,1
30,194,194,22,4,18,2,1
29,234,234,28,13,15,4,3
5,234,234,17,8,9,4,3
24,240,240,105,27,78,4,3
6,255,255,31,31,0,1,0
32,258,258,3,3,0,1,0
0,267,267,21,21,0,1,0
10,301,301,2,2,0,1,0
17,314,314,29,8,21,4,3
20,336,336,3,3,0,1,0
11,342,342,45,45,0,1,0
2,345,345,45,45,0,1,0
19,347,347,19,4,15,4,3
26,367,367,47,47,0,1,0
13,369,369,18,18,0,1,0
12,397,397,5,5,0,1,0
9,407,407,14,14,0,1,0
3,415,415,2,2,0,1,0
23,419,419,82,54,28,2,1
27,421,421,10,1,9,2,1
33,434,434,65,5,60,4,3
1,436,436,68,68,0,1,0
34,446,446,59,59,0,1,0
35,447,447,14,14,0,1,0
16,450,450,35,35,0,1,0
7,454,454,319,319,0,1,0
31,472,472,59,47,12,4,3
28,473,473,56,8,48,2,1
14,486,486,5,5,0,1,0

24,126,126,5,1,4,2,1
16,137,137,2,2,0,1,0
13,145,145,15,15,0,1,0
9,161,161,9,9,0,1,0
18,169,169,7,4,3,2,1
8,178,178,39,39,0,1,0
3,216,216,79,19,60,3,2
11,247,247,20,10,10,3,2
25,254,254,14,1,13,3,2
14,267,267,30,30,0,1,0
12,291,291,4,4,0,1,0
17,319,319,2,2,0,1,0
28,347,347,22,22,0,1,0
4,354,354,111,111,0,1,0
21,363,363,45,45,0,1,0
20,364,364,2,2,0,1,0
7,365,365,175,175,0,1,0
19,372,372,15,3,12,3,2
23,385,385,92,61,31,2,1
1,404,404,26,6,20,2,1
6,411,411,103,103,0,1,0
10,428,428,18,4,14,3,2
0,430,430,2,2,0,1,0
5,431,431,44,44,0,1,0
22,433,433,171,45,126,4,3
26,449,449,99,99,0,1,0
27,472,472,82,82,0,1,0
15,487,487,82,82,0,1,0
2,491,491,22,22,0,1,0

25,102,102,60,13,47,2,1
26,120,120,3,3,0,1,0
5,128,128,23,23,0,1,0
18,132,132,2,2,0,1,0
23,132,132,6,1,5,2,1
27,143,143,7,2,5,2,1
20,156,156,15,1,14,3,2
6,189,189,5,5,0,1,0
38,199,199,20,20,0,1,0
15,210,210,44,44,0,1,0
33,212,212,28,7,21,4,3
37,217,217,25,18,7,2,1
0,232,232,77,27,50,2,1
9,236,236,50,43,7,2,1
30,254,254,8,8,0,1,0
16,291,291,5,5,0,1,0
17,294,294,30,18,12,4,3
11,303,303,3,3,0,1,0
4,333,333,5,5,0,1,0
24,352,352,1,1,0,1,0
12,361,361,42,9,33,4,3
14,378,378,6,6,0,1,0
32,392,392,21,21,0,1,0
7,397,397,25,25,0,1,0
10,397,397,33,30,3,2,1
35,401,401,49,49,0,1,0
2,407,407,8,2,6,2,1
8,421,421,7,3,4,2,1
34,426,426,45,1,44,2,1
28,427,427,5,5,0,1,0
36,451,451,8,8,0,1,0
21,455,455,55,55,0,1,0
3,464,464,63,48,15,4,3
1,467,467,5,5,0,1,0
19,469,469,40,3,37,3,2
13,471,471,111,33,78,4,3
31,472,472,126,117,9,4,3
22,477,477,16,16,0,1,0
29,498,498,9,9,0,1,0

24,103,103,5,5,0,1,0
0,106,106,6,6,0,1,0
10,141,141,3,3,0,1,0
9,178,178,56,56,0,1,0
26,179,179,1,1,0,1,0
28,199,199,11,11,0,1,0
31,217,217,5,2,3,2,1
13,221,221,1,1,0,1,0
12,229,229,41,6,35,2,1
29,233,233,3,3,0,1,0
16,271,271,55,31,24,4,3
4,275,275,15,15,0,1,0
8,280,280,25,25,0,1,0
25,281,281,39,12,27,3,2
30,284,284,27,27,0,1,0
11,290,290,14,14,0,1,0
20,300,300,14,1,13,2,1
17,305,305,85,85,0,1,0
5,312,312,66,28,38,2,1
1,312,312,26,26,0,1,0
21,314,314,18,6,12,4,3
7,315,315,13,13,0,1,0
6,327,327,35,35,0,1,0
18,380,380,97,97,0,1,0
23,384,384,7,4,3,2,1
2,384,384,33,7,26,3,2
19,393,393,9,9,0,1,0
14,404,404,90,8,82,4,3
15,419,419,27,27,0,1,0
32,454,454,11,4,7,2,1
22,454,454,115,115,0,1,0
3,468,468,284,256,28,3,2
27,494,494,53,53,0,1,0

21,103,103,10,2,8,3,2
34,108,108,11,2,9,2,1
0,131,131,8,8,0,1,0
26,142,142,5,5,0,1,0
18,152,152,4,4,0,1,0
24,154,154,10,7,3,2,1
25,175,175,28,20,8,2,1
33,191,191,13,13,0,1,0
9,195,195,9,9,0,1,0
16,196,196,27,27,0,1,0
20,203,203,23,6,17,2,1
8,204,204,7,7,0,1,0
5,208,208,3,3,0,1,0
17,211,211,1,1,0,1,0
31,228,228,26,26,0,1,0
1,249,249,31,13,18,4,3
30,301,301,14,2,12,3,2
28,317,317,1,1,0,1,0
23,324,324,30,15,15,4,3
11,324,324,18,18,0,1,0
19,328,328,22,12,10,2,1
38,332,332,19,9,10,2,1
32,333,333,92,2,90,4,3
29,343,343,37,37,0,1,0
13,345,345,24,2,22,3,2
10,392,392,78,34,44,2,1
15,396,396,43,43,0,1,0
4,399,399,21,11,10,3,2
36,403,403,10,1,9,4,3
12,404,404,36,13,23,2,1
39,422,422,63,27,36,2,1
14,424,424,34,34,0,1,0
2,434,434,1,1,0,1,0
6,438,438,66,66,0,1,0
35,444,444,105,105,0,1,0
3,451,451,154,7,147,4,3
22,455,455,21,21,0,1,0
37,455,455,111,111,0,1,0
7,465,465,57,6,51,4,3
27,482,482,6,6,0,1,0

15,100,100,10,1,9,4,3
17,109,109,4,4,0,1,0
32,161,161,4,4,0,1,0
7,162,162,1,1,0,1,0
14,201,201,48,48,0,1,0
29,214,214,36,36,0,1,0
27,238,238,3,3,0,1,0
34,246,246,65,65,0,1,0
25,262,262,2,2,0,1,0
4,265,265,59,59,0,1,0
16,265,265,13,4,9,2,1
8,269,269,14,14,0,1,0
11,271,271,39,39,0,1,0
18,273,273,48,24,24,3,2
24,278,278,72,3,69,4,3
1,291,291,8,8,0,1,0
0,296,296,71,71,0,1,0
22,308,308,27,1,26,3,2
5,335,335,27,27,0,1,0
23,338,338,49,43,6,2,1
30,344,344,29,29,0,1,0
9,361,361,50,50,0,1,0
10,367,367,56,56,0,1,0
31,368,368,15,15,0,1,0
12,369,369,24,24,0,1,0
19,372,372,23,23,0,1,0
26,389,389,17,17,0,1,0
21,396,396,8,2,6,2,1
3,417,417,16,8,8,3,2
6,419,419,102,37,65,3,2
33,432,432,112,112,0,1,0
13,445,445,42,42,0,1,0
20,464,464,17,17,0,1,0
2,472,472,27,27,0,1,0
28,479,479,77,8,69,4,3

1,117,117,6,6,0,1,0
9,126,126,14,3,11,2,1
22,137,137,11,3,8,3,2
14,160,160,8,8,0,1,0
10,181,181,4,1,3,2,1
24,190,190,7,7,0,1,0
39,190,190,13,13,0,1,0
17,203,203,14,14,0,1,0
35,203,203,24,15,9,2,1
38,205,205,3,3,0,1,0
6,208,208,57,57,0,1,0
11,215,215,24,2,22,2,1
4,221,221,1,1,0,1,0
41,240,240,25,18,7,2,1
5,246,246,4,4,0,1,0
33,269,269,110,110,0,1,0
26,270,270,3,3,0,1,0
21,273,273,47,47,0,1,0
40,284,284,28,28,0,1,0
34,288,288,28,28,0,1,0
13,299,299,28,28,0,1,0
37,311,311,51,11,40,3,2
19,324,324,10,10,0,1,0
42,325,325,5,1,4,2,1
3,326,326,65,54,11,2,1
25,338,338,11,1,10,3,2
15,340,340,9,9,0,1,0
32,344,344,114,57,57,4,3
0,364,364,4,4,0,1,0
31,365,365,34,23,11,2,1
8,368,368,13,2,11,2,1
20,370,370,61,15,46,2,1
2,400,400,40,13,27,4,3
27,401,401,37,11,26,2,1
28,402,402,5,5,0,1,0
36,406,406,47,47,0,1,0
29,410,410,10,7,3,2,1
18,412,412,7,1,6,3,2
43,415,415,13,3,10,3,2
16,426,426,13,7,6,3,2
23,439,439,1,1,0,1,0
30,459,459,48,38,10,3,2
7,464,464,60,3,57,4,3
12,493,493,31,5,26,2,1

31,101,101,3,3,0,1,0
8,116,116,5,1,4,2,1
14,139,139,27,27,0,1,0
7,141,141,32,32,0,1,0
21,155,155,7,7,0,1,0
13,164,164,1,1,0,1,0
33,192,192,12,12,0,1,0
17,205,205,32,1,31,2,1
0,236,236,43,43,0,1,0
19,253,253,7,7,0,1,0
3,267,267,4,4,0,1,0
22,277,277,56,56,0,1,0
6,283,283,12,1,11,2,1
34,286,286,28,2,26,4,3
32,292,292,42,6,36,4,3
24,295,295,73,8,65,4,3
4,302,302,1,1,0,1,0
29,308,308,23,4,19,4,3
25,314,314,13,13,0,1,0
5,314,314,91,35,56,3,2
30,330,330,23,1,22,3,2
10,349,349,58,58,0,1,0
2,357,357,100,54,46,2,1
18,376,376,29,5,24,3,2
28,377,377,62,45,17,2,1
26,381,381,90,66,24,3,2
23,402,402,29,29,0,1,0
16,417,417,24,4,20,3,2
27,426,426,6,6,0,1,0
9,431,431,15,15,0,1,0
15,459,459,15,15,0,1,0
1,469,469,8,8,0,1,0
35,471,471,32,8,24,2,1
20,473,473,101,27,74,3,2
12,482,482,45,19,26,3,2
36,495,495,21,7,14,3,2
11,496,496,31,21,10,2,1

1,101,101,6,2,4,2,1
19,106,106,11,1,10,3,2
10,113,113,1,1,0,1,0
26,115,115,7,7,0,1,0
8,132,132,3,3,0,1,0
28,140,140,20,14,6,2,1
22,146,146,21,18,3,2,1
31,152,152,13,8,5,2,1
13,155,155,17,1,16,2,1
24,173,173,12,9,3,2,1
16,198,198,35,13,22,3,2
27,202,202,25,25,0,1,0
21,231,231,1,1,0,1,0
29,255,255,67,13,54,4,3
9,261,261,47,23,24,3,2
4,269,269,7,7,0,1,0
5,292,292,21,21,0,1,0
18,300,300,11,11,0,1,0
12,307,307,17,17,0,1,0
17,343,343,46,18,28,2,1
15,368,368,4,4,0,1,0
2,370,370,56,35,21,2,1
0,392,392,108,68,40,2,1
25,393,393,4,4,0,1,0
23,417,417,103,71,32,3,2
30,418,418,39,9,30,4,3
14,440,440,18,6,12,2,1
7,446,446,200,134,66,3,2
3,463,463,167,127,40,3,2
6,471,471,47,47,0,1,0
11,480,480,68,68,0,1,0
20,499,499,40,26,14,3,2

1,108,108,1,1,0,1,0
28,113,113,2,2,0,1,0
29,114,114,9,9,0,1,0
32,137,137,12,12,0,1,0
10,146,146,4,4,0,1,0
6,155,155,23,13,10,2,1
27,172,172,7,7,0,1,0
24,186,186,5,5,0,1,0
16,190,190,46,46,0,1,0
15,195,195,10,10,0,1,0
11,196,196,6,1,5,2,1
2,197,197,10,10,0,1,0
5,208,208,2,2,0,1,0
34,232,232,15,6,9,4,3
3,238,238,21,4,17,3,2
21,244,244,96,96,0,1,0
14,247,247,3,3,0,1,0
37,255,255,35,35,0,1,0
35,273,273,45,45,0,1,0
4,280,280,24,21,3,2,1
25,303,303,3,3,0,1,0
9,352,352,5,5,0,1,0
39,358,358,87,65,22,3,2
41,368,368,89,7,82,4,3
8,369,369,1,1,0,1,0
33,373,373,57,57,0,1,0
40,373,373,13,4,9,2,1
19,377,377,31,31,0,1,0
7,383,383,33,4,29,4,3
31,396,396,70,70,0,1,0
17,411,411,21,7,14,3,2
20,423,423,21,21,0,1,0
12,426,426,1,1,0,1,0
13,435,435,92,24,68,4,3
18,444,444,17,17,0,1,0
23,448,448,40,19,21,4,3
36,460,460,81,81,0,1,0
0,467,467,70,70,0,1,0
30,469,469,28,28,0,1,0
22,477,477,31,8,23,2,1
38,484,484,40,40,0,1,0
26,499,499,24,9,15,2,1

27,121,121,20,1,19,2,1
15,131,131,12,12,0,1,0
3,149,149,22,3,19,4,3
2,153,153,1,1,0,1,0
29,165,165,22,22,0,1,0
9,181,181,9,6,3,2,1
1,192,192,50,15,35,2,1
31,192,192,49,25,24,4,3
0,204,204,91,80,11,2,1
26,210,210,13,13,0,1,0
13,212,212,51,11,40,3,2
11,237,237,37,37,0,1,0
14,241,241,17,14,3,2,1
21,254,254,13,13,0,1,0
30,263,263,28,28,0,1,0
32,280,280,12,8,4,2,1
23,290,290,30,30,0,1,0
25,296,296,45,25,20,2,1
28,302,302,36,36,0,1,0
17,308,308,17,17,0,1,0
18,309,309,49,49,0,1,0
22,315,315,1,1,0,1,0
16,328,328,8,8,0,1,0
10,340,340,41,18,23,2,1
19,341,341,9,9,0,1,0
12,356,356,22,22,0,1,0
4,374,374,68,68,0,1,0
24,405,405,69,69,0,1,0
20,408,408,61,23,38,3,2
8,418,418,3,3,0,1,0
5,431,431,31,31,0,1,0
7,450,450,17,17,0,1,0
33,477,477,33,33,0,1,0
6,487,487,22,11,11,2,1

33,102,102,6,6,0,1,0
18,105,105,10,6,4,2,1
26,110,110,2,2,0,1,0
5,129,129,1,1,0,1,0
21,143,143,5,5,0,1,0
10,149,149,17,17,0,1,0
31,149,149,29,29,0,1,0
6,150,150,1,1,0,1,0
1,172,172,28,28,0,1,0
19,173,173,13,5,8,3,2
4,181,181,20,20,0,1,0
28,224,224,4,4,0,1,0
41,225,225,1,1,0,1,0
30,227,227,43,43,0,1,0
20,235,235,3,3,0,1,0
37,239,239,8,8,0,1,0
40,241,241,6,6,0,1,0
14,243,243,7,7,0,1,0
25,243,243,51,51,0,1,0
15,257,257,13,6,7,2,1
32,263,263,13,4,9,4,3
8,270,270,45,45,0,1,0
29,289,289,44,44,0,1,0
27,293,293,9,9,0,1,0
17,322,322,133,121,12,4,3
7,337,337,13,13,0,1,0
16,340,340,1,1,0,1,0
24,352,352,90,52,38,3,2
2,359,359,37,37,0,1,0
9,368,368,25,25,0,1,0
38,381,381,12,12,0,1,0
23,382,382,27,27,0,1,0
0,387,387,35,9,26,3,2
34,395,395,116,5,111,4,3
35,397,397,39,18,21,4,3
22,398,398,8,8,0,1,0
11,398,398,100,12,88,3,2
39,401,401,13,13,0,1,0
12,412,412,3,3,0,1,0
13,445,445,14,14,0,1,0
36,459,459,75,75,0,1,0
3,461,461,4,1,3,2,1

26,152,152,21,5,16,2,1
19,153,153,12,12,0,1,0
13,162,162,8,8,0,1,0
12,186,186,19,19,0,1,0
18,188,188,39,1,38,2,1
10,196,196,29,4,25,2,1
20,220,220,17,13,4,2,1
2,222,222,89,75,14,2,1
3,222,222,11,5,6,2,1
24,245,245,37,13,24,3,2
6,264,264,49,49,0,1,0
23,273,273,1,1,0,1,0
21,285,285,10,1,9,4,3
27,294,294,2,2,0,1,0
30,297,297,48,34,14,3,2
22,331,331,18,5,13,4,3
8,351,351,50,17,33,4,3
16,369,369,26,26,0,1,0
9,378,378,66,66,0,1,0
7,387,387,86,2,84,3,2
15,401,401,26,26,0,1,0
28,415,415,32,32,0,1,0
29,422,422,2,2,0,1,0
14,423,423,111,111,0,1,0
17,426,426,15,3,12,2,1
5,440,440,74,50,24,3,2
1,453,453,6,6,0,1,0
4,465,465,75,14,61,4,3
0,470,470,106,70,36,2,1
11,486,486,5,5,0,1,0
25,490,490,176,97,79,3,2

11,113,113,6,6,0,1,0
19,120,120,40,25,15,2,1
16,148,148,17,17,0,1,0
13,150,150,27,15,12,3,2
9,151,151,35,9,26,3,2
25,151,151,30,30,0,1,0
27,154,154,24,17,7,2,1
26,174,174,17,5,12,3,2
7,185,185,37,37,0,1,0
33,186,186,29,29,0,1,0
1,190,190,1,1,0,1,0
15,198,198,8,2,6,2,1
23,200,200,2,2,0,1,0
8,203,203,21,21,0,1,0
21,204,204,16,3,13,2,1
6,208,208,3,3,0,1,0
20,216,216,34,34,0,1,0
2,224,224,7,7,0,1,0
3,228,228,7,1,6,2,1
17,245,245,7,4,3,2,1
12,255,255,27,4,23,3,2
5,320,320,12,5,7,2,1
32,341,341,60,19,41,2,1
24,346,346,44,11,33,4,3
22,374,374,16,8,8,2,1
14,405,405,94,94,0,1,0
31,415,415,4,1,3,2,1
28,449,449,12,12,0,1,0
18,458,458,46,37,9,4,3
34,458,458,21,21,0,1,0
0,464,464,146,146,0,1,0
10,473,473,73,25,48,4,3
4,484,484,26,3,23,2,1
30,487,487,25,25,0,1,0
29,489,489,28,28,0,1,0
35,495,495,44,44,0,1,0

32,146,146,24,18,6,2,1
36,150,150,20,1,19,3,2
1,153,153,2,2,0,1,0
4,177,177,1,1,0,1,0
24,191,191,27,27,0,1,0
7,195,195,1,1,0,1,0
23,209,209,32,15,17,2,1
28,244,244,35,35,0,1,0
35,244,244,31,10,21,4,3
3,245,245,1,1,0,1,0
0,256,256,24,24,0,1,0
21,283,283,11,2,9,2,1
16,283,283,73,48,25,4,3
10,288,288,66,8,58,4,3
18,288,288,17,17,0,1,0
26,298,298,10,2,8,2,1
15,308,308,13,9,4,2,1
17,323,323,29,1,28,3,2
11,330,330,114,114,0,1,0
25,336,336,20,20,0,1,0
34,350,350,6,6,0,1,0
6,352,352,12,12,0,1,0
5,368,368,93,93,0,1,0
8,369,369,16,7,9,4,3
14,374,374,15,4,11,2,1
22,375,375,14,14,0,1,0
31,379,379,110,110,0,1,0
19,381,381,16,16,0,1,0
29,388,388,15,15,0,1,0
2,392,392,11,11,0,1,0
13,418,418,77,9,68,4,3
33,425,425,4,4,0,1,0
20,430,430,102,16,86,3,2
37,431,431,16,12,4,2,1
30,455,455,11,1,10,3,2
9,466,466,73,67,6,2,1
12,476,476,9,9,0,1,0
27,479,479,95,38,57,4,3

34,118,118,8,8,0,1,0
25,140,140,8,8,0,1,0
18,146,146,28,28,0,1,0
8,155,155,25,25,0,1,0
16,158,158,4,1,3,2,1
22,172,172,1,1,0,1,0
3,180,180,12,1,11,2,1
29,184,184,5,5,0,1,0
14,211,211,28,28,0,1,0
12,247,247,16,16,0,1,0
15,268,268,19,19,0,1,0
32,274,274,29,24,5,2,1
35,278,278,40,40,0,1,0
33,281,281,53,53,0,1,0
27,309,309,37,5,32,2,1
19,319,319,75,75,0,1,0
20,329,329,51,27,24,4,3
24,356,356,19,19,0,1,0
4,369,369,32,18,14,3,2
7,390,390,13,1,12,4,3
5,396,396,41,41,0,1,0
26,404,404,12,4,8,3,2
11,410,410,48,1,47,2,1
1,427,427,10,4,6,2,1
28,435,435,18,10,8,2,1
23,437,437,84,84,0,1,0
13,439,439,26,26,0,1,0
17,446,446,15,15,0,1,0
2,448,448,139,107,32,3,2
30,459,459,30,30,0,1,0
6,464,464,35,27,8,3,2
10,466,466,46,32,14,2,1
31,470,470,75,54,21,4,3
21,486,486,33,33,0,1,0
9,492,492,52,43,9,4,3
0,492,492,180,160,20,2,1

0,106,106,12,2,10,2,1
5,116,116,62,26,36,3,2
15,158,158,22,22,0,1,0
22,176,176,49,19,30,4,3
31,179,179,1,1,0,1,0
13,187,187,10,10,0,1,0
12,215,215,3,3,0,1,0
21,216,216,30,30,0,1,0
1,220,220,5,5,0,1,0
18,226,226,9,9,0,1,0
17,245,245,30,6,24,3,2
32,266,266,4,4,0,1,0
30,273,273,73,73,0,1,0
2,279,279,30,30,0,1,0
3,283,283,21,21,0,1,0
29,287,287,5,5,0,1,0
19,296,296,6,2,4,2,1
16,297,297,33,7,26,4,3
4,308,308,44,24,20,4,3
20,317,317,28,28,0,1,0
25,321,321,7,7,0,1,0
8,323,323,87,36,51,4,3
7,355,355,4,4,0,1,0
24,393,393,57,57,0,1,0
23,407,407,65,55,10,3,2
26,436,436,81,21,60,4,3
27,441,441,55,5,50,3,2
11,445,445,29,29,0,1,0
10,447,447,8,8,0,1,0
28,480,480,12,3,9,4,3
14,488,488,9,6,3,2,1
6,489,489,214,214,0,1,0
9,498,498,20,4,16,2,1

29,105,105,55,34,21,2,1
27,109,109,6,6,0,1,0
12,110,110,2,2,0,1,0
37,153,153,35,35,0,1,0
3,162,162,13,13,0,1,0
26,163,163,14,14,0,1,0
9,170,170,2,2,0,1,0
23,172,172,20,14,6,2,1
38,175,175,7,7,0,1,0
44,179,179,4,4,0,1,0
34,216,216,15,15,0,1,0
5,231,231,10,10,0,1,0
42,234,234,7,1,6,3,2
11,264,264,8,3,5,2,1
14,265,265,92,45,47,2,1
13,268,268,7,7,0,1,0
17,275,275,41,41,0,1,0
6,281,281,3,3,0,1,0
33,295,295,4,4,0,1,0
25,302,302,1,1,0,1,0
19,307,307,41,36,5,2,1
24,308,308,18,18,0,1,0
43,321,321,14,1,13,2,1
31,356,356,70,70,0,1,0
21,361,361,57,44,13,3,2
30,382,382,17,17,0,1,0
39,388,388,111,111,0,1,0
10,388,388,16,12,4,2,1
15,399,399,8,5,3,2,1
40,412,412,8,1,7,2,1
41,425,425,9,1,8,2,1
8,436,436,4,4,0,1,0
18,439,439,12,12,0,1,0
7,439,439,38,38,0,1,0
32,442,442,75,75,0,1,0
2,455,455,30,30,0,1,0
20,459,459,42,19,23,4,3
0,468,468,59,59,0,1,0
22,469,469,81,44,37,2,1
1,472,472,7,7,0,1,0
36,473,473,12,12,0,1,0
4,473,473,16,5,11,2,1
28,493,493,8,2,6,2,1
16,495,495,13,7,6,3,2
35,497,497,24,17,7,2,1

11,110,110,13,13,0,1,0
29,115,115,1,1,0,1,0
21,117,117,7,1,6,2,1
32,131,131,7,3,4,2,1
27,135,135,33,33,0,1,0
19,157,157,2,2,0,1,0
6,159,159,11,11,0,1,0
15,172,172,15,12,3,2,1
0,176,176,13,10,3,2,1
14,208,208,7,1,6,3,2
31,211,211,13,13,0,1,0
23,217,217,4,4,0,1,0
7,228,228,18,14,4,2,1
2,263,263,10,10,0,1,0
12,268,268,44,12,32,3,2
5,272,272,121,42,79,4,3
22,279,279,16,16,0,1,0
17,303,303,92,68,24,4,3
30,325,325,38,18,20,3,2
35,339,339,18,8,10,3,2
34,350,350,68,16,52,3,2
13,373,373,58,58,0,1,0
25,376,376,11,3,8,2,1
16,390,390,20,4,16,2,1
28,396,396,35,28,7,2,1
26,432,432,18,6,12,4,3
1,438,438,41,41,0,1,0
18,440,440,110,86,24,3,2
3,450,450,4,4,0,1,0
20,464,464,65,46,19,2,1
8,472,472,83,83,0,1,0
24,476,476,50,50,0,1,0
10,487,487,80,80,0,1,0
33,490,490,51,15,36,4,3
9,492,492,9,9,0,1,0
4,497,497,63,42,21,2,1

9,111,111,3,3,0,1,0
8,114,114,14,5,9,4,3
39,126,126,23,14,9,2,1
14,131,131,3,3,0,1,0
40,132,132,14,8,6,3,2
23,135,135,6,6,0,1,0
29,135,135,15,15,0,1,0
19,141,141,33,29,4,2,1
18,145,145,10,10,0,1,0
5,149,149,16,16,0,1,0
38,150,150,32,32,0,1,0
28,154,154,38,38,0,1,0
20,157,157,10,10,0,1,0
32,186,186,1,1,0,1,0
1,189,189,52,18,34,4,3
22,191,191,1,1,0,1,0
15,195,195,14,14,0,1,0
4,208,208,20,20,0,1,0
10,223,223,9,9,0,1,0
6,253,253,7,1,6,3,2
2,253,253,59,59,0,1,0
3,254,254,9,9,0,1,0
12,275,275,1,1,0,1,0
37,301,301,15,1,14,3,2
30,303,303,63,40,23,2,1
0,317,317,5,5,0,1,0
27,324,324,1,1,0,1,0
26,348,348,9,9,0,1,0
31,367,367,20,7,13,2,1
34,369,369,15,11,4,2,1
25,374,374,9,2,7,2,1
11,393,393,5,5,0,1,0
33,402,402,40,40,0,1,0
17,406,406,1,1,0,1,0
21,414,414,13,13,0,1,0
35,428,428,145,76,69,4,3
16,432,432,45,45,0,1,0
7,457,457,26,6,20,2,1
13,460,460,111,63,48,4,3
24,476,476,1,1,0,1,0
36,480,480,36,36,0,1,0
41,492,492,56,56,0,1,0

12,102,102,25,7,18,2,1
13,142,142,21,21,0,1,0
2,151,151,5,2,3,2,1
25,160,160,25,25,0,1,0
4,167,167,2,2,0,1,0
14,167,167,7,1,6,3,2
9,180,180,51,42,9,2,1
11,190,190,4,4,0,1,0
0,201,201,56,56,0,1,0
18,227,227,3,3,0,1,0
8,232,232,13,13,0,1,0
17,242,242,72,4,68,3,2
29,255,255,12,5,7,2,1
10,268,268,28,28,0,1,0
27,271,271,30,30,0,1,0
20,282,282,2,2,0,1,0
3,285,285,39,11,28,3,2
16,287,287,29,12,17,3,2
26,319,319,8,8,0,1,0
21,321,321,4,4,0,1,0
5,322,322,125,43,82,3,2
1,327,327,61,41,20,3,2
15,356,356,19,19,0,1,0
7,361,361,7,1,6,2,1
28,363,363,48,25,23,2,1
24,390,390,81,69,12,4,3
22,414,414,20,6,14,3,2
30,452,452,6,1,5,2,1
23,460,460,112,92,20,2,1
6,461,461,176,176,0,1,0
19,485,485,11,11,0,1,0

26,102,102,12,6,6,2,1
5,128,128,2,2,0,1,0
10,129,129,13,7,6,2,1
31,138,138,16,16,0,1,0
6,156,156,24,9,15,4,3
28,162,162,13,13,0,1,0
16,166,166,36,36,0,1,0
25,166,166,10,5,5,2,1
29,182,182,8,3,5,2,1
13,185,185,2,2,0,1,0
30,187,187,12,8,4,2,1
7,199,199,11,11,0,1,0
34,201,201,26,26,0,1,0
23,214,214,8,5,3,2,1
14,221,221,11,1,10,3,2
1,228,228,6,6,0,1,0
0,235,235,51,51,0,1,0
3,261,261,12,4,8,3,2
11,291,291,12,4,8,3,2
24,300,300,95,35,60,4,3
12,321,321,58,43,15,4,3
36,338,338,115,57,58,3,2
22,342,342,9,9,0,1,0
18,354,354,32,32,0,1,0
32,365,365,32,17,15,2,1
9,367,367,43,13,30,2,1
20,378,378,10,10,0,1,0
8,384,384,65,65,0,1,0
35,396,396,51,51,0,1,0
2,405,405,1,1,0,1,0
4,416,416,48,48,0,1,0
17,437,437,46,26,20,3,2
27,438,438,57,5,52,3,2
37,450,450,19,19,0,1,0
15,467,467,87,24,63,4,3
21,469,469,39,39,0,1,0
33,471,471,45,8,37,2,1
19,493,493,11,4,7,2,1

28,116,116,23,23,0,1,0
1,132,132,9,9,0,1,0
37,135,135,40,4,36,3,2
7,135,135,1,1,0,1,0
24,137,137,4,1,3,2,1
19,159,159,7,7,0,1,0
5,166,166,2,2,0,1,0
10,166,166,11,5,6,3,2
23,174,174,1,1,0,1,0
29,179,179,23,12,11,2,1
3,181,181,51,11,40,2,1
27,191,191,3,3,0,1,0
8,193,193,7,3,4,2,1
17,227,227,27,27,0,1,0
18,227,227,1,1,0,1,0
0,239,239,19,11,8,2,1
32,257,257,42,23,19,2,1
12,272,272,52,31,21,2,1
16,274,274,73,73,0,1,0
30,282,282,12,6,6,3,2
22,306,306,38,38,0,1,0
35,336,336,74,74,0,1,0
9,347,347,39,39,0,1,0
40,348,348,7,3,4,2,1
34,360,360,41,41,0,1,0
39,362,362,42,42,0,1,0
26,369,369,32,26,6,2,1
2,380,380,33,33,0,1,0
11,382,382,8,2,6,3,2
33,382,382,12,12,0,1,0
21,409,409,36,18,18,3,2
13,427,427,33,33,0,1,0
31,440,440,34,2,32,2,1
38,441,441,7,1,6,2,1
15,444,444,1,1,0,1,0
14,448,448,40,40,0,1,0
36,451,451,55,48,7,2,1
25,461,461,60,44,16,3,2
6,476,476,57,57,0,1,0
4,487,487,43,28,15,4,3
20,500,500,20,7,13,2,1

4,105,105,2,2,0,1,0
36,107,107,1,1,0,1,0
5,123,123,11,11,0,1,0
30,128,128,22,22,0,1,0
2,132,132,2,2,0,1,0
31,141,141,2,2,0,1,0
41,141,141,1,1,0,1,0
42,153,153,29,9,20,3,2
22,160,160,15,15,0,1,0
40,162,162,75,75,0,1,0
43,171,171,2,2,0,1,0
29,183,183,5,1,4,2,1
12,185,185,1,1,0,1,0
39,185,185,8,8,0,1,0
7,186,186,22,22,0,1,0
15,197,197,1,1,0,1,0
21,200,200,4,4,0,1,0
19,201,201,65,23,42,2,1
16,212,212,1,1,0,1,0
14,218,218,15,15,0,1,0
26,223,223,7,7,0,1,0
34,229,229,19,7,12,4,3
10,233,233,5,5,0,1,0
13,236,236,42,42,0,1,0
37,237,237,58,40,18,4,3
45,246,246,34,16,18,4,3
17,256,256,13,13,0,1,0
3,269,269,7,1,6,2,1
6,273,273,72,72,0,1,0
33,303,303,45,45,0,1,0
11,325,325,22,22,0,1,0
0,345,345,5,5,0,1,0
35,348,348,28,19,9,4,3
1,352,352,2,2,0,1,0
9,354,354,21,21,0,1,0
20,370,370,7,7,0,1,0
18,395,395,11,5,6,3,2
28,408,408,3,3,0,1,0
27,412,412,4,4,0,1,0
32,414,414,50,20,30,2,1
38,415,415,50,8,42,2,1
24,461,461,80,33,47,2,1
25,472,472,8,1,7,2,1
8,486,486,27,27,0,1,0
23,488,488,62,41,21,4,3
44,490,490,32,2,30,4,3

35,103,103,8,2,6,3,2
33,104,104,24,15,9,2,1
14,110,110,32,26,6,3,2
25,119,119,4,1,3,2,1
1,122,122,31,31,0,1,0
26,144,144,11,2,9,4,3
12,172,172,6,6,0,1,0
23,194,194,3,3,0,1,0
27,203,203,17,17,0,1,0
34,212,212,23,9,14,2,1
11,215,215,29,29,0,1,0
9,220,220,26,11,15,4,3
22,228,228,17,17,0,1,0
36,237,237,101,25,76,3,2
5,242,242,18,18,0,1,0
7,264,264,9,3,6,2,1
17,283,283,12,7,5,2,1
29,297,297,71,26,45,2,1
31,318,318,4,4,0,1,0
20,325,325,10,7,3,2,1
4,327,327,29,29,0,1,0
13,334,334,11,11,0,1,0
21,336,336,16,16,0,1,0
32,346,346,2,2,0,1,0
30,346,346,30,1,29,2,1
2,347,347,29,10,19,2,1
37,359,359,11,11,0,1,0
0,361,361,37,15,22,3,2
10,368,368,6,6,0,1,0
16,384,384,59,52,7,2,1
15,392,392,14,14,0,1,0
6,402,402,64,64,0,1,0
19,403,403,62,62,0,1,0
8,419,419,32,14,18,3,2
3,428,428,49,9,40,3,2
24,433,433,32,20,12,4,3
28,442,442,62,15,47,2,1
18,468,468,25,25,0,1,0

6,102,102,18,4,14,3,2
12,104,104,2,2,0,1,0
19,117,117,10,1,9,4,3
2,210,210,161,141,20,3,2
20,243,243,20,20,0,1,0
23,245,245,20,20,0,1,0
4,253,253,1,1,0,1,0
18,258,258,8,8,0,1,0
26,270,270,1,1,0,1,0
21,276,276,9,3,6,2,1
5,284,284,73,73,0,1,0
0,289,289,9,9,0,1,0
7,291,291,65,41,24,2,1
14,291,291,20,20,0,1,0
22,297,297,45,28,17,2,1
1,302,302,12,12,0,1,0
27,303,303,48,48,0,1,0
17,312,312,100,31,69,4,3
29,317,317,14,5,9,2,1
24,330,330,71,32,39,2,1
16,363,363,57,57,0,1,0
25,368,368,7,7,0,1,0
28,370,370,60,51,9,4,3
11,422,422,26,26,0,1,0
3,424,424,20,4,16,2,1
15,445,445,5,5,0,1,0
8,463,463,15,15,0,1,0
10,478,478,11,11,0,1,0
9,489,489,147,114,33,4,3
13,499,499,120,75,45,4,3

8,114,114,2,2,0,1,0
24,119,119,6,1,5,2,1
1,121,121,25,9,16,2,1
10,122,122,1,1,0,1,0
25,127,127,12,6,6,3,2
32,133,133,3,3,0,1,0
14,149,149,24,24,0,1,0
30,160,160,38,38,0,1,0
22,162,162,3,3,0,1,0
6,174,174,1,1,0,1,0
17,205,205,7,7,0,1,0
27,227,227,69,35,34,2,1
9,243,243,86,49,37,2,1
19,248,248,31,31,0,1,0
21,269,269,1,1,0,1,0
7,273,273,101,63,38,3,2
13,274,274,41,36,5,2,1
34,278,278,14,10,4,2,1
33,309,309,8,8,0,1,0
18,321,321,19,19,0,1,0
5,324,324,50,50,0,1,0
15,330,330,14,5,9,4,3
2,338,338,48,48,0,1,0
26,339,339,38,38,0,1,0
3,340,340,2,2,0,1,0
4,344,344,23,5,18,4,3
31,356,356,9,9,0,1,0
20,372,372,15,15,0,1,0
23,390,390,11,2,9,2,1
0,410,410,3,3,0,1,0
28,412,412,13,4,9,4,3
12,423,423,32,4,28,2,1
16,426,426,25,25,0,1,0
29,450,450,43,43,0,1,0
35,465,465,264,183,81,4,3
11,488,488,37,11,26,4,3

7,122,122,2,2,0,1,0
18,129,129,16,16,0,1,0
10,132,132,3,3,0,1,0
14,141,141,34,34,0,1,0
16,194,194,20,20,0,1,0
42,195,195,34,10,24,3,2
20,202,202,12,12,0,1,0
1,213,213,21,21,0,1,0
40,246,246,35,3,32,2,1
32,247,247,3,3,0,1,0
6,248,248,11,3,8,3,2
15,254,254,24,24,0,1,0
9,255,255,3,3,0,1,0
31,256,256,10,2,8,3,2
0,258,258,21,5,16,3,2
27,279,279,8,1,7,3,2
21,284,284,8,8,0,1,0
3,292,292,14,14,0,1,0
30,295,295,76,42,34,2,1
12,301,301,12,12,0,1,0
37,305,305,1,1,0,1,0
33,317,317,6,6,0,1,0
36,320,320,100,20,80,3,2
19,321,321,34,34,0,1,0
5,348,348,7,2,5,2,1
17,370,370,63,19,44,2,1
2,371,371,22,22,0,1,0
22,384,384,96,96,0,1,0
8,385,385,21,21,0,1,0
11,413,413,9,9,0,1,0
26,423,423,24,12,12,2,1
4,423,423,2,2,0,1,0
29,436,436,75,23,52,3,2
38,436,436,38,16,22,2,1
28,440,440,25,25,0,1,0
35,448,448,68,8,60,3,2
23,453,453,47,47,0,1,0
24,458,458,53,9,44,2,1
34,463,463,3,3,0,1,0
39,478,478,34,34,0,1,0
13,489,489,48,48,0,1,0
41,494,494,30,30,0,1,0
25,499,499,80,80,0,1,0

2,107,107,3,3,0,1,0
14,113,113,2,2,0,1,0
10,124,124,11,11,0,1,0
3,134,134,8,8,0,1,0
0,139,139,25,25,0,1,0
41,140,140,1,1,0,1,0
29,141,141,34,34,0,1,0
27,156,156,7,2,5,2,1
24,184,184,44,41,3,2,1
21,192,192,1,1,0,1,0
4,196,196,11,11,0,1,0
22,230,230,26,26,0,1,0
16,240,240,1,1,0,1,0
39,241,241,4,4,0,1,0
32,242,242,87,1,86,3,2
25,243,243,3,3,0,1,0
40,262,262,22,9,13,3,2
1,267,267,35,35,0,1,0
18,270,270,45,45,0,1,0
36,272,272,14,14,0,1,0
30,297,297,47,47,0,1,0
26,299,299,21,12,9,2,1
33,299,299,37,25,12,2,1
20,317,317,9,3,6,2,1
38,326,326,59,32,27,4,3
23,329,329,11,11,0,1,0
12,338,338,63,63,0,1,0
15,347,347,16,16,0,1,0
6,366,366,7,2,5,2,1
13,403,403,9,9,0,1,0
19,405,405,109,101,8,2,1
28,418,418,3,3,0,1,0
17,418,418,30,30,0,1,0
34,419,419,32,6,26,2,1
35,419,419,33,2,31,2,1
11,426,426,8,8,0,1,0
31,444,444,34,20,14,3,2
9,445,445,92,53,39,4,3
8,450,450,13,1,12,3,2
7,471,471,36,36,0,1,0
37,486,486,35,29,6,2,1
5,495,495,39,12,27,2,1

11,121,121,37,37,0,1,0
5,129,129,1,1,0,1,0
31,130,130,4,4,0,1,0
3,144,144,1,1,0,1,0
34,150,150,28,28,0,1,0
18,153,153,6,3,3,2,1
28,153,153,60,10,50,3,2
33,155,155,38,8,30,3,2
32,160,160,12,4,8,3,2
26,163,163,3,3,0,1,0
38,171,171,10,10,0,1,0
25,208,208,12,3,9,2,1
8,211,211,22,8,14,2,1
20,218,218,8,2,6,2,1
1,228,228,12,3,9,2,1
9,241,241,8,8,0,1,0
19,243,243,29,29,0,1,0
4,247,247,4,4,0,1,0
0,250,250,38,20,18,4,3
37,250,250,3,3,0,1,0
27,267,267,12,2,10,2,1
41,276,276,33,33,0,1,0
6,302,302,9,9,0,1,0
16,304,304,25,25,0,1,0
29,306,306,43,29,14,3,2
35,309,309,6,6,0,1,0
21,329,329,33,24,9,4,3
22,383,383,27,27,0,1,0
23,386,386,1,1,0,1,0
10,408,408,162,27,135,4,3
13,413,413,29,29,0,1,0
40,419,419,28,28,0,1,0
36,429,429,25,25,0,1,0
17,433,433,16,16,0,1,0
12,435,435,16,2,14,4,3
24,452,452,46,2,44,2,1
15,460,460,25,25,0,1,0
7,464,464,6,1,5,2,1
39,465,465,78,53,25,2,1
30,488,488,68,68,0,1,0
14,489,489,5,1,4,2,1
2,496,496,62,26,36,3,2

9,105,105,10,10,0,1,0
35,123,123,6,6,0,1,0
18,128,128,1,1,0,1,0
28,128,128,6,6,0,1,0
24,174,174,7,7,0,1,0
25,177,177,48,16,32,3,2
34,192,192,42,32,10,2,1
14,204,204,32,32,0,1,0
33,206,206,12,12,0,1,0
36,210,210,8,8,0,1,0
30,235,235,19,19,0,1,0
31,253,253,15,15,0,1,0
3,258,258,16,16,0,1,0
5,258,258,23,5,18,4,3
1,263,263,21,13,8,3,2
15,264,264,26,4,22,4,3
7,277,277,9,9,0,1,0
19,334,334,1,1,0,1,0
26,337,337,4,4,0,1,0
6,359,359,1,1,0,1,0
16,362,362,39,9,30,3,2
0,386,386,134,88,46,2,1
11,396,396,133,109,24,4,3
21,401,401,67,67,0,1,0
10,423,423,12,12,0,1,0
8,431,431,16,16,0,1,0
23,432,432,22,22,0,1,0
17,438,438,28,28,0,1,0
4,441,441,96,81,15,4,3
32,442,442,8,8,0,1,0
13,452,452,4,4,0,1,0
22,463,463,237,227,10,2,1
27,473,473,73,73,0,1,0
12,475,475,45,25,20,2,1
20,485,485,47,47,0,1,0
2,497,497,21,21,0,1,0
29,499,499,25,16,9,4,3

30,128,128,30,30,0,1,0
5,135,135,1,1,0,1,0
14,143,143,13,1,12,2,1
27,143,143,7,7,0,1,0
37,172,172,12,12,0,1,0
15,179,179,12,9,3,2,1
7,192,192,6,6,0,1,0
33,208,208,5,5,0,1,0
28,216,216,96,46,50,2,1
31,229,229,25,25,0,1,0
18,243,243,52,18,34,2,1
10,249,249,11,5,6,2,1
29,254,254,8,5,3,2,1
17,275,275,3,3,0,1,0
38,288,288,46,36,10,2,1
32,291,291,74,56,18,4,3
12,295,295,20,16,4,2,1
39,305,305,10,3,7,2,1
20,307,307,112,74,38,2,1
2,307,307,8,8,0,1,0
1,316,316,39,21,18,4,3
0,316,316,13,5,8,2,1
40,320,320,4,4,0,1,0
11,329,329,1,1,0,1,0
22,346,346,31,31,0,1,0
24,350,350,24,10,14,3,2
36,351,351,9,9,0,1,0
41,388,388,52,28,24,3,2
23,401,401,12,4,8,3,2
3,404,404,14,14,0,1,0
35,438,438,16,6,10,4,3
9,450,450,45,16,29,3,2
21,452,452,9,9,0,1,0
34,453,453,37,37,0,1,0
4,458,458,13,9,4,2,1
8,458,458,11,4,7,2,1
16,459,459,149,144,5,2,1
13,462,462,14,14,0,1,0
26,467,467,32,8,24,3,2
25,475,475,33,9,24,3,2
6,475,475,31,31,0,1,0
19,485,485,45,31,14,3,2

10,103,103,18,6,12,4,3
8,111,111,1,1,0,1,0
18,136,136,5,5,0,1,0
14,155,155,8,3,5,2,1
28,157,157,2,2,0,1,0
23,175,175,2,2,0,1,0
31,178,178,22,2,20,2,1
12,211,211,18,18,0,1,0
32,216,216,52,52,0,1,0
0,230,230,77,77,0,1,0
24,241,241,13,13,0,1,0
16,247,247,31,31,0,1,0
21,273,273,2,2,0,1,0
5,278,278,41,8,33,4,3
1,291,291,33,33,0,1,0
22,294,294,7,3,4,2,1
19,298,298,137,87,50,3,2
20,308,308,11,11,0,1,0
29,310,310,36,36,0,1,0
33,325,325,38,25,13,2,1
15,342,342,139,58,81,4,3
27,355,355,54,26,28,3,2
30,369,369,15,15,0,1,0
17,371,371,19,19,0,1,0
6,371,371,51,51,0,1,0
11,404,404,47,20,27,4,3
34,420,420,25,25,0,1,0
7,422,422,8,8,0,1,0
2,436,436,33,3,30,4,3
25,438,438,37,25,12,3,2
4,440,440,23,5,18,3,2
3,445,445,3,3,0,1,0
13,451,451,18,18,0,1,0
26,469,469,14,2,12,3,2
35,477,477,135,51,84,4,3
9,479,479,3,3,0,1,0

30,109,109,25,25,0,1,0
6,115,115,20,20,0,1,0
17,118,118,17,9,8,2,1
27,119,119,9,9,0,1,0
34,139,139,4,4,0,1,0
38,141,141,2,2,0,1,0
35,164,164,18,18,0,1,0
18,179,179,16,8,8,2,1
31,190,190,8,8,0,1,0
40,199,199,21,21,0,1,0
11,201,201,1,1,0,1,0
21,209,209,36,36,0,1,0
2,210,210,75,75,0,1,0
24,211,211,6,6,0,1,0
3,243,243,25,10,15,2,1
8,244,244,3,3,0,1,0
9,246,246,1,1,0,1,0
22,248,248,3,3,0,1,0
36,285,285,29,29,0,1,0
29,287,287,104,88,16,3,2
39,289,289,41,2,39,4,3
12,317,317,8,8,0,1,0
28,335,335,11,5,6,2,1
1,336,336,27,27,0,1,0
23,336,336,21,21,0,1,0
15,350,350,32,32,0,1,0
20,352,352,14,2,12,2,1
10,371,371,79,79,0,1,0
37,379,379,7,2,5,2,1
25,381,381,7,7,0,1,0
14,404,404,14,5,9,4,3
5,417,417,35,35,0,1,0
13,428,428,12,12,0,1,0
32,430,430,78,68,10,2,1
4,433,433,27,27,0,1,0
33,447,447,171,48,123,4,3
0,459,459,5,5,0,1,0
16,468,468,26,26,0,1,0
7,481,481,11,2,9,4,3
19,491,491,45,45,0,1,0
26,495,495,2,2,0,1,0

19,114,114,1,1,0,1,0
38,120,120,15,15,0,1,0
34,135,135,4,1,3,2,1
3,146,146,15,15,0,1,0
24,154,154,5,5,0,1,0
7,159,159,8,8,0,1,0
40,164,164,5,5,0,1,0
20,174,174,1,1,0,1,0
25,177,177,37,37,0,1,0
30,192,192,12,4,8,2,1
14,197,197,3,3,0,1,0
9,212,212,16,16,0,1,0
11,216,216,9,9,0,1,0
8,217,217,1,1,0,1,0
33,226,226,7,7,0,1,0
18,236,236,67,16,51,4,3
37,251,251,3,3,0,1,0
21,255,255,6,6,0,1,0
12,257,257,1,1,0,1,0
5,267,267,4,4,0,1,0
2,276,276,3,3,0,1,0
1,276,276,181,138,43,2,1
23,280,280,4,4,0,1,0
36,281,281,38,38,0,1,0
43,282,282,3,3,0,1,0
13,308,308,55,19,36,3,2
29,311,311,66,33,33,4,3
15,313,313,1,1,0,1,0
28,324,324,39,39,0,1,0
26,327,327,2,2,0,1,0
41,337,337,70,40,30,4,3
0,346,346,19,19,0,1,0
32,352,352,79,48,31,4,3
27,371,371,41,41,0,1,0
35,379,379,5,5,0,1,0
31,386,386,49,49,0,1,0
22,396,396,26,7,19,4,3
16,396,396,3,3,0,1,0
6,410,410,19,19,0,1,0
10,415,415,47,33,14,2,1
4,448,448,20,12,8,2,1
17,487,487,23,12,11,2,1
42,491,491,112,103,9,2,1
39,495,495,21,21,0,1,0

5,117,117,23,8,15,4,3
33,121,121,11,11,0,1,0
3,139,139,15,15,0,1,0
19,148,148,5,1,4,2,1
36,161,161,2,2,0,1,0
7,185,185,28,28,0,1,0
14,185,185,8,8,0,1,0
0,187,187,8,8,0,1,0
27,198,198,7,7,0,1,0
24,199,199,6,6,0,1,0
30,213,213,12,7,5,2,1
13,237,237,1,1,0,1,0
20,240,240,6,6,0,1,0
6,249,249,9,9,0,1,0
32,249,249,16,16,0,1,0
29,260,260,12,12,0,1,0
9,274,274,21,21,0,1,0
12,278,278,136,103,33,4,3
23,283,283,23,9,14,3,2
28,302,302,130,47,83,4,3
15,338,338,21,4,17,4,3
11,341,341,23,10,13,2,1
22,342,342,31,15,16,3,2
31,346,346,2,2,0,1,0
2,365,365,44,44,0,1,0
8,385,385,55,55,0,1,0
10,404,404,33,33,0,1,0
16,419,419,14,14,0,1,0
1,429,429,28,10,18,3,2
17,429,429,33,33,0,1,0
18,435,435,169,88,81,4,3
4,447,447,46,31,15,2,1
26,448,448,12,12,0,1,0
35,466,466,79,7,72,3,2
21,491,491,8,8,0,1,0
34,491,491,126,66,60,3,2
25,499,499,37,37,0,1,0

7,113,113,2,2,0,1,0
30,126,126,4,1,3,2,1
37,130,130,14,14,0,1,0
21,149,149,1,1,0,1,0
5,151,151,5,5,0,1,0
34,152,152,6,2,4,2,1
23,166,166,1,1,0,1,0
13,167,167,30,30,0,1,0
10,168,168,6,3,3,2,1
26,181,181,27,7,20,2,1
18,184,184,3,3,0,1,0
16,186,186,20,20,0,1,0
22,187,187,25,12,13,2,1
32,195,195,7,4,3,2,1
24,198,198,8,1,7,2,1
38,198,198,44,44,0,1,0
1,203,203,1,1,0,1,0
41,211,211,8,8,0,1,0
15,213,213,24,24,0,1,0
36,219,219,17,2,15,4,3
14,233,233,18,12,6,2,1
6,237,237,17,4,13,2,1
33,251,251,44,44,0,1,0
3,253,253,31,13,18,4,3
35,273,273,55,55,0,1,0
42,281,281,16,13,3,2,1
12,283,283,15,1,14,3,2
31,289,289,26,9,17,2,1
27,301,301,63,63,0,1,0
39,302,302,16,16,0,1,0
2,309,309,30,30,0,1,0
19,309,309,27,27,0,1,0
40,330,330,28,28,0,1,0
17,345,345,18,18,0,1,0
43,350,350,36,36,0,1,0
9,379,379,10,10,0,1,0
29,383,383,47,3,44,3,2
8,384,384,80,6,74,3,2
28,414,414,62,52,10,2,1
25,423,423,2,2,0,1,0
11,437,437,100,27,73,4,3
4,442,442,37,3,34,2,1
0,452,452,8,1,7,2,1
20,458,458,38,38,0,1,0

10,103,103,8,8,0,1,0
37,106,106,23,8,15,3,2
24,120,120,16,13,3,2,1
15,120,120,13,13,0,1,0
30,121,121,1,1,0,1,0
28,140,140,8,8,0,1,0
20,145,145,1,1,0,1,0
8,167,167,23,23,0,1,0
27,174,174,45,18,27,3,2
4,189,189,2,2,0,1,0
23,193,193,12,7,5,2,1
33,194,194,21,12,9,2,1
11,210,210,6,2,4,2,1
22,217,217,9,9,0,1,0
36,226,226,14,2,12,2,1
26,264,264,54,34,20,3,2
29,273,273,31,31,0,1,0
18,274,274,64,64,0,1,0
0,274,274,36,36,0,1,0
32,296,296,37,27,10,2,1
12,306,306,33,7,26,2,1
7,315,315,35,35,0,1,0
9,332,332,9,9,0,1,0
6,375,375,40,22,18,3,2
1,381,381,35,6,29,4,3
25,381,381,4,4,0,1,0
34,384,384,61,61,0,1,0
35,385,385,15,15,0,1,0
14,391,391,13,13,0,1,0
13,415,415,2,2,0,1,0
31,416,416,57,12,45,4,3
16,426,426,25,10,15,4,3
21,439,439,47,14,33,2,1
2,440,440,40,40,0,1,0
5,454,454,44,34,10,3,2
3,470,470,97,97,0,1,0
19,490,490,46,16,30,4,3
17,496,496,118,85,33,4,3

6,110,110,11,3,8,2,1
9,133,133,7,7,0,1,0
38,135,135,3,3,0,1,0
11,144,144,7,7,0,1,0
5,147,147,13,2,11,2,1
22,149,149,15,3,12,2,1
0,160,160,24,16,8,3,2
29,162,162,2,2,0,1,0
27,165,165,14,14,0,1,0
24,169,169,2,2,0,1,0
35,185,185,9,9,0,1,0
26,192,192,23,11,12,4,3
1,195,195,14,14,0,1,0
31,201,201,12,12,0,1,0
14,209,209,35,15,20,2,1
13,213,213,23,23,0,1,0
15,221,221,18,8,10,3,2
12,224,224,7,7,0,1,0
18,243,243,11,11,0,1,0
37,258,258,24,24,0,1,0
36,289,289,12,12,0,1,0
34,293,293,7,4,3,2,1
17,299,299,39,39,0,1,0
4,347,347,6,3,3,2,1
23,350,350,23,4,19,2,1
39,354,354,96,48,48,4,3
3,357,357,32,32,0,1,0
32,360,360,65,4,61,3,2
16,366,366,1,1,0,1,0
8,370,370,47,47,0,1,0
7,377,377,1,1,0,1,0
2,400,400,49,31,18,2,1
20,412,412,43,4,39,4,3
25,417,417,32,32,0,1,0
21,421,421,65,65,0,1,0
28,451,451,33,33,0,1,0
10,465,465,68,35,33,4,3
19,487,487,29,3,26,4,3
33,489,489,92,66,26,3,2
40,493,493,89,89,0,1,0
30,497,497,143,143,0,1,0

9,107,107,5,5,0,1,0
7,112,112,6,6,0,1,0
36,128,128,8,4,4,2,1
14,137,137,5,5,0,1,0
37,157,157,9,9,0,1,0
31,160,160,5,5,0,1,0
15,161,161,18,18,0,1,0
28,171,171,22,22,0,1,0
42,228,228,43,43,0,1,0
12,231,231,2,2,0,1,0
1,231,231,3,3,0,1,0
2,270,270,16,16,0,1,0
4,282,282,34,34,0,1,0
44,300,300,12,3,9,4,3
0,301,301,3,3,0,1,0
11,302,302,39,39,0,1,0
17,311,311,13,5,8,2,1
43,321,321,4,4,0,1,0
6,322,322,45,7,38,2,1
23,323,323,45,24,21,4,3
32,328,328,26,5,21,2,1
3,328,328,10,7,3,2,1
40,333,333,34,10,24,3,2
8,348,348,8,8,0,1,0
20,356,356,5,5,0,1,0
26,374,374,44,18,26,3,2
34,384,384,31,31,0,1,0
13,386,386,6,6,0,1,0
41,388,388,10,10,0,1,0
18,397,397,56,18,38,4,3
38,398,398,81,36,45,2,1
33,402,402,24,1,23,4,3
29,403,403,45,45,0,1,0
10,404,404,118,84,34,3,2
24,415,415,25,7,18,3,2
27,422,422,141,64,77,4,3
25,426,426,21,13,8,3,2
39,435,435,43,39,4,2,1
30,439,439,42,42,0,1,0
21,448,448,13,13,0,1,0
22,458,458,29,9,20,3,2
19,471,471,34,34,0,1,0
35,482,482,33,33,0,1,0
45,483,483,76,76,0,1,0
5,485,485,23,23,0,1,0
16,497,497,18,12,6,3,2

29,117,117,2,2,0,1,0
3,134,134,3,3,0,1,0
26,177,177,32,28,4,2,1
12,189,189,2,2,0,1,0
24,193,193,3,3,0,1,0
20,199,199,29,29,0,1,0
4,219,219,25,13,12,3,2
34,222,222,25,8,17,4,3
33,232,232,1,1,0,1,0
13,262,262,68,68,0,1,0
18,263,263,21,21,0,1,0
6,269,269,14,2,12,3,2
15,273,273,118,118,0,1,0
10,285,285,19,11,8,3,2
17,305,305,35,35,0,1,0
30,335,335,28,10,18,2,1
5,344,344,56,43,13,2,1
2,362,362,48,48,0,1,0
27,362,362,46,46,0,1,0
8,363,363,8,8,0,1,0
7,369,369,36,32,4,2,1
32,376,376,48,48,0,1,0
14,378,378,9,1,8,3,2
22,395,395,41,20,21,2,1
9,395,395,91,91,0,1,0
11,409,409,8,3,5,2,1
28,409,409,28,23,5,2,1
19,420,420,31,31,0,1,0
31,427,427,78,78,0,1,0
16,435,435,17,7,10,2,1
23,440,440,98,9,89,4,3
25,440,440,67,67,0,1,0
21,445,445,39,39,0,1,0
1,488,488,80,80,0,1,0
0,488,488,44,44,0,1,0

20,134,134,1,1,0,1,0
0,137,137,22,13,9,4,3
10,138,138,1,1,0,1,0
21,138,138,1,1,0,1,0
9,144,144,12,4,8,2,1
37,148,148,11,11,0,1,0
25,168,168,5,5,0,1,0
24,177,177,3,3,0,1,0
33,183,183,10,10,0,1,0
2,186,186,62,62,0,1,0
8,216,216,6,6,0,1,0
18,218,218,11,11,0,1,0
27,227,227,9,5,4,2,1
22,231,231,37,13,24,3,2
1,237,237,56,50,6,3,2
42,245,245,19,16,3,2,1
34,246,246,5,2,3,2,1
32,269,269,42,26,16,3,2
38,271,271,168,168,0,1,0
19,301,301,11,11,0,1,0
28,307,307,16,16,0,1,0
39,307,307,13,10,3,2,1
23,316,316,2,2,0,1,0
16,318,318,25,25,0,1,0
6,332,332,24,6,18,2,1
15,347,347,48,20,28,3,2
36,348,348,42,30,12,2,1
31,352,352,53,53,0,1,0
7,360,360,6,6,0,1,0
40,370,370,31,31,0,1,0
12,420,420,46,46,0,1,0
41,432,432,22,22,0,1,0
5,433,433,2,2,0,1,0
4,435,435,46,27,19,2,1
26,453,453,31,11,20,2,1
3,453,453,4,4,0,1,0
14,455,455,30,30,0,1,0
35,456,456,1,1,0,1,0
29,458,458,5,5,0,1,0
17,466,466,11,3,8,3,2
13,466,466,63,60,3,2,1
30,496,496,131,95,36,3,2
11,497,497,12,12,0,1,0

17,114,114,5,5,0,1,0
4,129,129,18,6,12,3,2
23,140,140,45,33,12,4,3
10,154,154,24,24,0,1,0
33,163,163,12,12,0,1,0
31,166,166,8,8,0,1,0
1,166,166,16,16,0,1,0
19,167,167,2,2,0,1,0
6,167,167,29,29,0,1,0
5,178,178,1,1,0,1,0
12,189,189,5,5,0,1,0
29,192,192,1,1,0,1,0
21,200,200,2,2,0,1,0
8,236,236,7,7,0,1,0
13,243,243,2,2,0,1,0
3,263,263,58,14,44,2,1
24,277,277,40,25,15,2,1
27,298,298,106,95,11,2,1
2,312,312,1,1,0,1,0
20,323,323,54,54,0,1,0
0,325,325,25,25,0,1,0
14,333,333,136,58,78,3,2
26,342,342,32,9,23,2,1
16,358,358,46,28,18,3,2
28,375,375,45,34,11,2,1
32,400,400,17,7,10,2,1
15,407,407,50,14,36,3,2
9,409,409,64,27,37,2,1
22,431,431,14,14,0,1,0
34,432,432,25,25,0,1,0
18,441,441,60,60,0,1,0
7,483,483,49,43,6,2,1
11,495,495,87,5,82,3,2
25,497,497,43,1,42,4,3
30,497,497,30,11,19,2,1

0,108,108,6,2,4,2,1
16,110,110,22,22,0,1,0
11,126,126,2,2,0,1,0
5,131,131,5,5,0,1,0
34,159,159,54,54,0,1,0
13,216,216,11,11,0,1,0
15,220,220,20,20,0,1,0
24,224,224,22,22,0,1,0
9,232,232,32,32,0,1,0
1,244,244,12,12,0,1,0
28,252,252,7,2,5,2,1
33,259,259,28,9,19,2,1
38,279,279,24,24,0,1,0
6,291,291,30,30,0,1,0
14,312,312,19,19,0,1,0
4,316,316,77,34,43,3,2
18,324,324,56,56,0,1,0
12,329,329,4,1,3,2,1
26,335,335,1,1,0,1,0
2,336,336,5,5,0,1,0
37,339,339,67,31,36,3,2
35,342,342,11,2,9,4,3
17,358,358,7,4,3,2,1
20,368,368,15,15,0,1,0
3,375,375,13,7,6,2,1
21,379,379,36,36,0,1,0
23,382,382,30,23,7,2,1
22,382,382,16,4,12,3,2
30,400,400,1,1,0,1,0
8,401,401,83,54,29,2,1
31,407,407,25,25,0,1,0
7,421,421,61,61,0,1,0
36,429,429,218,183,35,4,3
19,447,447,23,7,16,3,2
32,478,478,10,10,0,1,0
27,481,481,68,68,0,1,0
10,490,490,97,86,11,2,1
29,491,491,18,12,6,2,1
25,493,493,7,2,5,2,1

18,110,110,12,1,11,2,1
28,116,116,1,1,0,1,0
6,158,158,7,7,0,1,0
31,161,161,51,51,0,1,0
38,175,175,4,4,0,1,0
17,195,195,17,17,0,1,0
8,201,201,31,31,0,1,0
29,203,203,20,20,0,1,0
2,213,213,1,1,0,1,0
1,235,235,1,1,0,1,0
3,259,259,7,1,6,3,2
35,271,271,81,42,39,4,3
13,276,276,2,2,0,1,0
4,282,282,55,37,18,3,2
30,286,286,11,11,0,1,0
0,293,293,2,2,0,1,0
23,307,307,4,4,0,1,0
19,312,312,78,8,70,3,2
34,330,330,48,2,46,3,2
5,338,338,64,30,34,3,2
16,344,344,8,8,0,1,0
25,346,346,124,68,56,4,3
12,349,349,20,20,0,1,0
36,356,356,14,14,0,1,0
32,361,361,2,2,0,1,0
10,373,373,1,1,0,1,0
9,385,385,30,30,0,1,0
15,386,386,63,63,0,1,0
24,394,394,16,16,0,1,0
20,417,417,4,4,0,1,0
11,424,424,57,42,15,2,1
26,424,424,5,5,0,1,0
14,436,436,98,44,54,4,3
37,442,442,20,2,18,4,3
22,444,444,77,77,0,1,0
33,455,455,47,2,45,4,3
7,470,470,65,34,31,2,1
27,470,470,71,4,67,4,3
21,480,480,20,20,0,1,0

3,102,102,23,23,0,1,0
27,112,112,23,23,0,1,0
15,150,150,6,6,0,1,0
20,167,167,28,28,0,1,0
29,236,236,1,1,0,1,0
26,236,236,53,21,32,3,2
8,258,258,2,2,0,1,0
14,263,263,74,74,0,1,0
11,267,267,27,27,0,1,0
23,280,280,5,5,0,1,0
12,287,287,9,9,0,1,0
22,333,333,22,1,21,2,1
24,338,338,7,7,0,1,0
28,346,346,57,6,51,4,3
7,355,355,31,31,0,1,0
13,377,377,7,7,0,1,0
17,378,378,61,22,39,4,3
16,392,392,9,9,0,1,0
4,408,408,19,5,14,3,2
9,421,421,22,15,7,2,1
18,437,437,73,64,9,4,3
2,437,437,73,40,33,4,3
0,450,450,2,2,0,1,0
19,467,467,11,1,10,2,1
25,472,472,39,9,30,3,2
10,475,475,134,101,33,4,3
21,476,476,62,54,8,3,2
6,476,476,69,5,64,3,2
1,484,484,213,207,6,3,2
5,491,491,218,124,94,3,2

19,109,109,13,4,9,4,3
29,112,112,8,2,6,3,2
35,114,114,1,1,0,1,0
16,122,122,1,1,0,1,0
15,167,167,43,8,35,3,2
13,197,197,36,27,9,2,1
11,198,198,9,9,0,1,0
0,203,203,46,46,0,1,0
31,223,223,5,1,4,2,1
4,224,224,2,2,0,1,0
37,229,229,11,11,0,1,0
34,240,240,53,20,33,4,3
2,249,249,26,26,0,1,0
10,251,251,7,7,0,1,0
6,255,255,5,5,0,1,0
28,270,270,23,23,0,1,0
26,280,280,7,7,0,1,0
3,299,299,24,24,0,1,0
22,303,303,1,1,0,1,0
17,312,312,41,2,39,2,1
32,325,325,44,39,5,2,1
21,366,366,5,5,0,1,0
23,366,366,209,114,95,4,3
20,373,373,12,6,6,2,1
30,379,379,15,5,10,4,3
25,391,391,31,8,23,2,1
5,409,409,109,35,74,4,3
18,419,419,29,17,12,2,1
33,426,426,30,30,0,1,0
8,435,435,21,21,0,1,0
36,450,450,89,13,76,3,2
27,456,456,55,49,6,2,1
12,463,463,87,60,27,4,3
9,472,472,31,8,23,4,3
24,475,475,43,11,32,3,2
7,476,476,7,7,0,1,0
14,479,479,32,32,0,1,0
1,495,495,44,44,0,1,0

13,105,105,5,5,0,1,0
11,119,119,7,1,6,3,2
23,126,126,23,23,0,1,0
22,140,140,2,2,0,1,0
30,146,146,11,11,0,1,0
10,158,158,31,31,0,1,0
24,172,172,22,7,15,4,3
21,188,188,12,2,10,3,2
15,195,195,22,9,13,2,1
25,200,200,27,27,0,1,0
7,208,208,17,3,14,2,1
4,210,210,26,26,0,1,0
14,213,213,48,11,37,2,1
28,214,214,32,32,0,1,0
26,228,228,2,2,0,1,0
27,236,236,12,6,6,2,1
9,246,246,46,43,3,2,1
19,246,246,14,2,12,4,3
34,294,294,14,14,0,1,0
33,298,298,47,47,0,1,0
6,307,307,17,17,0,1,0
2,317,317,29,5,24,2,1
29,325,325,13,1,12,3,2
3,329,329,37,37,0,1,0
18,339,339,8,5,3,2,1
1,380,380,42,16,26,2,1
5,415,415,58,10,48,4,3
20,428,428,89,89,0,1,0
16,429,429,27,27,0,1,0
0,460,460,28,2,26,2,1
8,462,462,7,7,0,1,0
17,468,468,63,18,45,2,1
31,476,476,123,103,20,2,1
32,495,495,85,48,37,2,1
12,499,499,109,87,22,2,1
35,500,500,17,5,12,4,3

42,115,115,5,5,0,1,0
6,135,135,3,3,0,1,0
28,148,148,5,5,0,1,0
3,153,153,9,1,8,2,1
4,162,162,8,8,0,1,0
21,170,170,6,6,0,1,0
46,183,183,20,6,14,3,2
25,205,205,14,14,0,1,0
17,209,209,47,20,27,2,1
9,221,221,44,11,33,2,1
13,228,228,6,6,0,1,0
34,229,229,14,8,6,3,2
47,232,232,14,14,0,1,0
1,253,253,6,6,0,1,0
5,254,254,13,13,0,1,0
14,254,254,1,1,0,1,0
12,262,262,63,59,4,2,1
32,263,263,14,14,0,1,0
38,265,265,38,38,0,1,0
33,273,273,25,10,15,2,1
43,285,285,11,4,7,3,2
41,303,303,33,30,3,2,1
35,306,306,7,7,0,1,0
15,313,313,44,44,0,1,0
18,316,316,1,1,0,1,0
23,319,319,14,6,8,2,1
40,335,335,35,14,21,2,1
29,344,344,47,47,0,1,0
7,354,354,15,15,0,1,0
0,355,355,55,55,0,1,0
44,360,360,96,61,35,2,1
16,373,373,1,1,0,1,0
20,399,399,8,8,0,1,0
26,414,414,1,1,0,1,0
31,418,418,10,3,7,2,1
27,421,421,16,16,0,1,0
2,448,448,9,1,8,3,2
39,448,448,84,49,35,2,1
22,450,450,12,12,0,1,0
8,457,457,12,2,10,2,1
10,461,461,41,41,0,1,0
37,463,463,7,7,0,1,0
11,489,489,24,24,0,1,0
30,492,492,67,67,0,1,0
45,493,493,13,1,12,3,2
24,494,494,81,81,0,1,0
36,496,496,154,48,106,4,3
19,498,498,20,20,0,1,0

19,101,101,11,11,0,1,0
15,134,134,6,6,0,1,0
2,143,143,60,60,0,1,0
13,146,146,1,1,0,1,0
21,170,170,32,32,0,1,0
0,179,179,5,5,0,1,0
11,183,183,48,48,0,1,0
3,186,186,18,4,14,2,1
12,187,187,39,39,0,1,0
14,199,199,16,11,5,2,1
29,203,203,48,23,25,4,3
26,205,205,1,1,0,1,0
7,207,207,1,1,0,1,0
25,222,222,5,5,0,1,0
24,240,240,10,1,9,4,3
8,247,247,90,36,54,3,2
17,259,259,36,6,30,3,2
23,264,264,60,60,0,1,0
20,266,266,7,7,0,1,0
30,272,272,3,3,0,1,0
4,291,291,13,4,9,2,1
27,315,315,128,61,67,4,3
18,349,349,5,5,0,1,0
10,350,350,2,2,0,1,0
28,351,351,31,2,29,2,1
16,363,363,31,31,0,1,0
5,367,367,8,8,0,1,0
1,414,414,120,44,76,3,2
6,444,444,1,1,0,1,0
9,453,453,165,27,138,4,3
22,459,459,3,3,0,1,0

32,106,106,2,2,0,1,0
16,139,139,5,5,0,1,0
26,147,147,8,8,0,1,0
4,152,152,5,1,4,2,1
13,174,174,11,7,4,2,1
17,189,189,23,23,0,1,0
12,191,191,52,52,0,1,0
25,198,198,11,1,10,2,1
29,199,199,22,6,16,3,2
18,209,209,19,19,0,1,0
9,215,215,10,3,7,2,1
10,216,216,36,10,26,3,2
8,247,247,39,20,19,2,1
14,252,252,121,121,0,1,0
27,269,269,34,34,0,1,0
6,279,279,24,24,0,1,0
21,283,283,6,1,5,2,1
0,323,323,19,19,0,1,0
30,324,324,84,40,44,3,2
33,337,337,27,23,4,2,1
1,342,342,10,1,9,4,3
31,350,350,86,86,0,1,0
28,366,366,21,21,0,1,0
20,385,385,10,10,0,1,0
15,396,396,88,88,0,1,0
7,416,416,88,49,39,2,1
19,417,417,53,35,18,2,1
23,459,459,50,2,48,4,3
22,470,470,18,18,0,1,0
5,482,482,31,13,18,4,3
24,491,491,72,48,24,2,1
3,494,494,28,1,27,4,3
11,495,495,34,19,15,4,3
2,496,496,54,54,0,1,0

8,101,101,12,12,0,1,0
11,104,104,9,1,8,2,1
19,104,104,20,20,0,1,0
15,112,112,12,7,5,2,1
3,119,119,1,1,0,1,0
35,121,121,8,1,7,2,1
5,124,124,20,10,10,3,2
31,128,128,2,2,0,1,0
17,143,143,19,19,0,1,0
21,146,146,1,1,0,1,0
32,152,152,10,10,0,1,0
30,161,161,8,8,0,1,0
36,169,169,22,22,0,1,0
20,184,184,14,7,7,2,1
16,192,192,65,41,24,2,1
13,204,204,2,2,0,1,0
12,218,218,8,8,0,1,0
38,225,225,13,7,6,3,2
29,238,238,30,1,29,2,1
39,256,256,46,46,0,1,0
2,276,276,12,12,0,1,0
37,277,277,48,48,0,1,0
28,294,294,80,80,0,1,0
18,325,325,2,2,0,1,0
40,344,344,52,3,49,2,1
33,348,348,1,1,0,1,0
4,358,358,71,62,9,4,3
41,366,366,9,9,0,1,0
10,396,396,13,13,0,1,0
25,398,398,18,18,0,1,0
7,407,407,8,2,6,3,2
22,413,413,4,4,0,1,0
27,413,413,3,3,0,1,0
0,429,429,21,14,7,2,1
9,439,439,92,46,46,3,2
24,443,443,43,38,5,2,1
6,475,475,3,3,0,1,0
1,486,486,21,10,11,2,1
23,495,495,151,99,52,4,3
34,496,496,44,3,41,3,2
14,497,497,4,4,0,1,0
26,500,500,34,34,0,1,0

3,111,111,5,5,0,1,0
14,133,133,3,3,0,1,0
6,156,156,70,70,0,1,0
20,156,156,11,3,8,3,2
18,158,158,2,2,0,1,0
4,175,175,9,9,0,1,0
15,185,185,9,9,0,1,0
29,217,217,3,3,0,1,0
19,220,220,71,56,15,2,1
0,235,235,59,43,16,2,1
7,238,238,38,26,12,4,3
26,240,240,16,3,13,3,2
16,266,266,7,7,0,1,0
10,284,284,21,21,0,1,0
2,297,297,53,53,0,1,0
1,302,302,65,65,0,1,0
12,303,303,2,2,0,1,0
31,342,342,50,29,21,2,1
24,344,344,84,27,57,4,3
32,347,347,8,8,0,1,0
27,361,361,49,18,31,2,1
23,371,371,22,1,21,4,3
21,381,381,45,29,16,4,3
17,384,384,57,51,6,3,2
25,391,391,37,16,21,3,2
28,407,407,102,39,63,4,3
22,411,411,35,17,18,2,1
13,417,417,73,26,47,4,3
11,431,431,26,26,0,1,0
5,444,444,15,5,10,3,2
9,446,446,69,69,0,1,0
8,485,485,23,5,18,4,3
30,495,495,26,26,0,1,0

13,107,107,14,14,0,1,0
22,108,108,4,4,0,1,0
10,139,139,14,4,10,2,1
27,175,175,5,5,0,1,0
33,190,190,8,4,4,2,1
21,202,202,29,14,15,4,3
15,204,204,1,1,0,1,0
37,256,256,26,26,0,1,0
29,256,256,36,36,0,1,0
38,269,269,28,25,3,2,1
5,280,280,26,26,0,1,0
19,282,282,2,2,0,1,0
24,284,284,55,43,12,2,1
28,296,296,14,14,0,1,0
30,298,298,6,6,0,1,0
32,310,310,24,18,6,2,1
11,311,311,60,22,38,4,3
7,319,319,77,77,0,1,0
18,328,328,32,32,0,1,0
23,340,340,13,13,0,1,0
12,345,345,23,23,0,1,0
1,345,345,14,14,0,1,0
16,371,371,15,8,7,2,1
6,372,372,157,58,99,4,3
2,380,380,25,25,0,1,0
9,383,383,35,14,21,4,3
36,392,392,60,60,0,1,0
8,393,393,31,31,0,1,0
4,419,419,4,4,0,1,0
31,436,436,53,17,36,2,1
0,444,444,18,18,0,1,0
20,453,453,13,13,0,1,0
35,455,455,158,158,0,1,0
14,464,464,30,4,26,4,3
25,467,467,72,72,0,1,0
17,472,472,19,19,0,1,0
26,474,474,24,8,16,3,2
34,485,485,51,4,47,2,1
3,486,486,35,35,0,1,0

0,101,101,15,15,0,1,0
1,102,102,37,23,14,2,1
6,130,130,1,1,0,1,0
20,151,151,17,2,15,4,3
32,156,156,4,1,3,2,1
14,182,182,5,1,4,2,1
17,185,185,16,16,0,1,0
27,191,191,6,1,5,2,1
13,210,210,53,28,25,4,3
15,233,233,1,1,0,1,0
18,273,273,1,1,0,1,0
9,276,276,16,13,3,2,1
28,279,279,5,5,0,1,0
26,285,285,56,29,27,2,1
31,292,292,15,15,0,1,0
4,294,294,18,18,0,1,0
5,308,308,64,16,48,3,2
33,309,309,14,14,0,1,0
8,321,321,42,42,0,1,0
2,325,325,37,24,13,2,1
22,336,336,9,9,0,1,0
11,343,343,41,41,0,1,0
7,373,373,8,4,4,2,1
24,385,385,156,132,24,4,3
21,386,386,24,6,18,4,3
23,396,396,11,11,0,1,0
16,403,403,10,10,0,1,0
10,408,408,95,65,30,4,3
29,415,415,64,55,9,2,1
25,416,416,42,13,29,4,3
35,452,452,182,170,12,2,1
19,453,453,30,30,0,1,0
3,461,461,47,23,24,2,1
12,463,463,12,12,0,1,0
34,487,487,39,30,9,4,3
30,497,497,19,7,12,4,3

5,106,106,15,15,0,1,0
10,121,121,1,1,0,1,0
36,123,123,2,2,0,1,0
17,142,142,7,4,3,2,1
32,173,173,2,2,0,1,0
0,177,177,15,6,9,4,3
25,185,185,10,5,5,2,1
1,193,193,4,4,0,1,0
35,201,201,10,10,0,1,0
23,209,209,17,17,0,1,0
19,225,225,1,1,0,1,0
3,226,226,11,11,0,1,0
22,246,246,13,1,12,4,3
9,264,264,38,4,34,2,1
6,283,283,1,1,0,1,0
29,289,289,22,22,0,1,0
39,293,293,47,47,0,1,0
20,303,303,51,22,29,2,1
30,318,318,62,62,0,1,0
38,336,336,117,18,99,4,3
11,352,352,21,21,0,1,0
33,357,357,72,47,25,2,1
2,360,360,25,10,15,2,1
21,365,365,1,1,0,1,0
18,366,366,17,4,13,2,1
4,368,368,20,20,0,1,0
27,384,384,5,5,0,1,0
12,387,387,73,8,65,4,3
14,394,394,13,5,8,3,2
15,397,397,64,64,0,1,0
26,399,399,83,83,0,1,0
28,399,399,14,14,0,1,0
37,399,399,85,67,18,4,3
31,406,406,1,1,0,1,0
13,408,408,177,156,21,2,1
8,431,431,39,39,0,1,0
7,441,441,10,10,0,1,0
24,454,454,32,32,0,1,0
34,455,455,37,11,26,2,1
41,473,473,27,13,14,3,2
40,496,496,29,29,0,1,0
16,499,499,7,3,4,2,1

24,115,115,2,2,0,1,0
34,152,152,10,7,3,2,1
12,162,162,39,14,25,2,1
2,210,210,20,20,0,1,0
13,210,210,29,8,21,2,1
9,216,216,18,9,9,4,3
36,228,228,17,3,14,2,1
21,236,236,3,3,0,1,0
25,241,241,28,17,11,4,3
3,248,248,5,5,0,1,0
27,267,267,2,2,0,1,0
23,269,269,22,22,0,1,0
28,274,274,9,9,0,1,0
39,279,279,44,19,25,4,3
22,296,296,51,30,21,4,3
20,302,302,30,18,12,4,3
11,305,305,16,12,4,2,1
1,309,309,1,1,0,1,0
18,310,310,5,5,0,1,0
10,325,325,11,11,0,1,0
15,326,326,25,20,5,2,1
5,328,328,28,3,25,4,3
14,341,341,52,52,0,1,0
8,352,352,30,13,17,2,1
17,365,365,18,4,14,4,3
26,376,376,33,14,19,2,1
32,381,381,17,17,0,1,0
0,394,394,35,23,12,2,1
4,398,398,23,5,18,4,3
29,403,403,64,17,47,2,1
37,419,419,6,6,0,1,0
16,421,421,51,51,0,1,0
19,428,428,81,33,48,3,2
40,437,437,92,58,34,3,2
41,439,439,208,120,88,3,2
33,440,440,63,55,8,3,2
7,446,446,8,8,0,1,0
30,452,452,15,15,0,1,0
6,453,453,5,5,0,1,0
35,473,473,1,1,0,1,0
31,494,494,17,9,8,2,1
38,497,497,84,32,52,3,2

1,114,114,1,1,0,1,0
41,121,121,21,15,6,2,1
16,126,126,32,32,0,1,0
21,127,127,22,8,14,3,2
29,152,152,15,5,10,4,3
31,165,165,41,41,0,1,0
24,168,168,3,3,0,1,0
20,174,174,5,2,3,2,1
3,178,178,1,1,0,1,0
40,196,196,58,41,17,2,1
38,199,199,9,9,0,1,0
32,212,212,18,18,0,1,0
30,233,233,85,63,22,3,2
45,241,241,10,10,0,1,0
4,242,242,9,9,0,1,0
0,256,256,13,13,0,1,0
7,256,256,9,9,0,1,0
26,263,263,11,7,4,2,1
13,271,271,2,2,0,1,0
23,279,279,1,1,0,1,0
36,284,284,9,9,0,1,0
19,295,295,27,27,0,1,0
42,306,306,35,35,0,1,0
5,324,324,58,58,0,1,0
37,324,324,8,8,0,1,0
14,327,327,9,3,6,3,2
12,329,329,12,6,6,2,1
39,336,336,16,16,0,1,0
43,340,340,14,14,0,1,0
2,348,348,6,2,4,2,1
27,351,351,1,1,0,1,0
17,358,358,55,55,0,1,0
8,372,372,25,1,24,3,2
9,374,374,6,6,0,1,0
22,375,375,19,4,15,4,3
35,379,379,7,1,6,3,2
10,387,387,10,10,0,1,0
44,387,387,29,11,18,3,2
6,413,413,53,23,30,2,1
28,416,416,3,3,0,1,0
25,421,421,77,49,28,2,1
34,430,430,39,31,8,2,1
18,456,456,36,36,0,1,0
15,473,473,70,7,63,4,3
33,475,475,61,61,0,1,0
11,483,483,16,6,10,4,3

29,108,108,10,7,3,2,1
4,126,126,55,13,42,2,1
1,140,140,5,1,4,2,1
24,150,150,4,4,0,1,0
27,152,152,1,1,0,1,0
9,153,153,38,38,0,1,0
36,175,175,12,12,0,1,0
35,181,181,24,24,0,1,0
23,185,185,9,9,0,1,0
6,186,186,1,1,0,1,0
20,195,195,1,1,0,1,0
18,209,209,17,17,0,1,0
34,211,211,4,4,0,1,0
33,214,214,54,54,0,1,0
15,233,233,9,6,3,2,1
19,238,238,1,1,0,1,0
26,247,247,35,35,0,1,0
39,250,250,5,5,0,1,0
11,252,252,33,11,22,2,1
40,278,278,11,11,0,1,0
3,307,307,73,73,0,1,0
30,312,312,29,11,18,2,1
17,312,312,5,5,0,1,0
41,314,314,8,8,0,1,0
0,316,316,1,1,0,1,0
16,336,336,19,13,6,3,2
25,343,343,9,9,0,1,0
42,346,346,55,55,0,1,0
37,349,349,18,3,15,4,3
32,355,355,72,54,18,3,2
21,364,364,12,1,11,2,1
22,374,374,2,2,0,1,0
31,378,378,113,102,11,2,1
14,392,392,9,9,0,1,0
5,393,393,1,1,0,1,0
13,397,397,33,1,32,3,2
10,399,399,52,17,35,4,3
28,452,452,123,123,0,1,0
7,452,452,4,4,0,1,0
8,454,454,43,10,33,2,1
2,454,454,68,68,0,1,0
12,454,454,10,4,6,3,2
38,465,465,11,1,10,3,2

36,139,139,13,13,0,1,0
40,156,156,24,11,13,2,1
2,162,162,33,4,29,2,1
9,171,171,38,38,0,1,0
21,175,175,1,1,0,1,0
3,184,184,20,20,0,1,0
18,185,185,27,4,23,2,1
30,195,195,39,8,31,4,3
22,208,208,15,8,7,3,2
17,217,217,3,3,0,1,0
13,236,236,17,17,0,1,0
33,242,242,9,3,6,3,2
31,244,244,8,8,0,1,0
7,249,249,6,6,0,1,0
28,269,269,21,12,9,2,1
8,277,277,20,8,12,2,1
19,287,287,3,3,0,1,0
32,296,296,48,18,30,4,3
26,302,302,59,24,35,2,1
38,306,306,51,39,12,4,3
20,321,321,60,18,42,3,2
27,324,324,32,16,16,3,2
39,329,329,41,15,26,2,1
4,330,330,69,43,26,3,2
29,337,337,44,44,0,1,0
24,348,348,12,12,0,1,0
5,352,352,8,4,4,2,1
1,376,376,13,13,0,1,0
34,376,376,13,13,0,1,0
16,379,379,21,12,9,4,3
11,388,388,69,20,49,2,1
14,410,410,11,11,0,1,0
23,440,440,92,92,0,1,0
25,442,442,21,9,12,4,3
6,454,454,86,86,0,1,0
15,458,458,14,1,13,2,1
10,470,470,22,4,18,2,1
0,475,475,4,1,3,2,1
35,480,480,4,4,0,1,0
37,492,492,26,14,12,3,2
12,494,494,18,18,0,1,0

3,106,106,9,9,0,1,0
7,115,115,12,1,11,2,1
0,118,118,10,10,0,1,0
34,122,122,17,2,15,2,1
19,129,129,21,9,12,4,3
27,136,136,1,1,0,1,0
13,141,141,13,7,6,3,2
30,154,154,11,11,0,1,0
10,179,179,4,4,0,1,0
14,196,196,34,34,0,1,0
22,202,202,5,5,0,1,0
29,230,230,22,22,0,1,0
4,233,233,77,44,33,3,2
31,242,242,26,26,0,1,0
15,267,267,53,48,5,2,1
20,274,274,22,22,0,1,0
28,295,295,23,1,22,4,3
9,298,298,7,1,6,2,1
8,303,303,10,10,0,1,0
5,305,305,33,33,0,1,0
6,343,343,27,27,0,1,0
2,345,345,65,53,12,3,2
16,347,347,29,29,0,1,0
24,385,385,68,45,23,2,1
32,407,407,102,102,0,1,0
26,411,411,28,28,0,1,0
21,413,413,112,52,60,3,2
12,416,416,2,2,0,1,0
23,417,417,16,16,0,1,0
1,419,419,31,31,0,1,0
25,435,435,30,20,10,2,1
17,440,440,119,71,48,4,3
35,444,444,5,5,0,1,0
11,459,459,99,54,45,4,3
18,466,466,1,1,0,1,0
33,471,471,4,4,0,1,0

17,118,118,22,22,0,1,0
10,147,147,13,13,0,1,0
8,149,149,38,25,13,2,1
38,150,150,13,13,0,1,0
26,154,154,6,6,0,1,0
9,160,160,2,2,0,1,0
24,174,174,17,17,0,1,0
31,222,222,3,3,0,1,0
4,249,249,24,16,8,3,2
15,249,249,1,1,0,1,0
13,250,250,1,1,0,1,0
34,262,262,20,20,0,1,0
11,286,286,26,26,0,1,0
40,296,296,17,17,0,1,0
12,301,301,16,7,9,2,1
30,314,314,83,75,8,3,2
14,333,333,68,36,32,3,2
22,343,343,6,6,0,1,0
23,367,367,60,29,31,2,1
6,367,367,29,29,0,1,0
32,368,368,32,1,31,4,3
33,381,381,29,14,15,2,1
41,384,384,17,7,10,2,1
35,387,387,5,2,3,2,1
27,390,390,65,47,18,2,1
21,392,392,38,38,0,1,0
36,412,412,69,69,0,1,0
0,423,423,20,14,6,2,1
18,424,424,80,26,54,4,3
3,434,434,39,39,0,1,0
37,440,440,50,18,32,2,1
19,445,445,1,1,0,1,0
25,449,449,70,35,35,4,3
1,453,453,14,14,0,1,0
7,456,456,49,1,48,4,3
39,461,461,19,11,8,2,1
16,470,470,2,2,0,1,0
28,478,478,104,39,65,3,2
5,486,486,17,17,0,1,0
2,493,493,4,1,3,2,1
29,496,496,26,7,19,2,1
20,498,498,99,55,44,2,1

7,108,108,3,3,0,1,0
38,135,135,5,5,0,1,0
35,151,151,56,17,39,2,1
39,170,170,3,3,0,1,0
21,172,172,13,13,0,1,0
3,189,189,26,26,0,1,0
30,198,198,9,9,0,1,0
32,199,199,7,7,0,1,0
15,202,202,15,10,5,2,1
12,206,206,92,92,0,1,0
26,217,217,4,4,0,1,0
11,242,242,54,54,0,1,0
28,269,269,80,80,0,1,0
34,278,278,23,23,0,1,0
14,278,278,12,6,6,3,2
31,285,285,24,12,12,3,2
5,294,294,9,9,0,1,0
22,296,296,38,38,0,1,0
19,300,300,1,1,0,1,0
13,317,317,2,2,0,1,0
10,325,325,3,3,0,1,0
6,351,351,49,5,44,4,3
36,365,365,38,38,0,1,0
2,366,366,14,6,8,3,2
0,377,377,62,62,0,1,0
20,379,379,6,6,0,1,0
8,379,379,41,31,10,2,1
17,379,379,49,37,12,4,3
33,381,381,27,27,0,1,0
29,403,403,5,5,0,1,0
16,405,405,31,19,12,2,1
23,405,405,37,37,0,1,0
9,410,410,36,22,14,3,2
18,414,414,38,38,0,1,0
37,416,416,18,9,9,4,3
24,453,453,43,28,15,4,3
4,462,462,3,3,0,1,0
1,474,474,20,3,17,2,1
25,486,486,48,48,0,1,0
27,490,490,109,109,0,1,0

6,153,153,33,33,0,1,0
7,170,170,2,2,0,1,0
16,174,174,7,7,0,1,0
14,182,182,17,17,0,1,0
11,183,183,21,21,0,1,0
17,211,211,3,3,0,1,0
32,232,232,30,4,26,3,2
29,246,246,23,10,13,2,1
27,251,251,2,2,0,1,0
12,260,260,66,24,42,3,2
22,292,292,3,3,0,1,0
9,292,292,4,4,0,1,0
31,294,294,15,15,0,1,0
23,304,304,59,59,0,1,0
19,310,310,16,5,11,4,3
20,311,311,30,15,15,2,1
28,313,313,102,96,6,2,1
33,319,319,17,17,0,1,0
24,321,321,16,16,0,1,0
21,325,325,36,4,32,3,2
0,373,373,38,6,32,4,3
15,378,378,94,67,27,2,1
1,383,383,30,30,0,1,0
25,393,393,149,149,0,1,0
3,410,410,6,6,0,1,0
35,413,413,27,27,0,1,0
13,415,415,6,6,0,1,0
36,417,417,44,44,0,1,0
26,424,424,12,7,5,2,1
18,424,424,34,1,33,2,1
37,442,442,19,19,0,1,0
5,443,443,56,32,24,2,1
30,449,449,28,28,0,1,0
39,453,453,59,20,39,3,2
10,454,454,70,70,0,1,0
2,455,455,4,1,3,2,1
38,473,473,30,1,29,2,1
4,474,474,39,6,33,4,3
34,494,494,12,1,11,2,1
8,496,496,43,26,17,2,1

17,108,108,3,3,0,1,0
13,121,121,4,1,3,2,1
29,135,135,21,2,19,2,1
23,142,142,7,7,0,1,0
21,148,148,2,2,0,1,0
26,159,159,3,3,0,1,0
4,160,160,10,10,0,1,0
3,166,166,5,5,0,1,0
12,226,226,28,28,0,1,0
2,233,233,23,11,12,4,3
28,244,244,3,3,0,1,0
27,244,244,3,3,0,1,0
31,274,274,33,33,0,1,0
15,275,275,153,153,0,1,0
35,278,278,96,96,0,1,0
30,285,285,1,1,0,1,0
1,315,315,17,12,5,2,1
8,317,317,23,3,20,3,2
18,327,327,37,27,10,2,1
7,352,352,41,13,28,3,2
22,355,355,9,9,0,1,0
0,364,364,39,6,33,4,3
33,374,374,55,55,0,1,0
25,380,380,76,24,52,3,2
19,382,382,120,24,96,3,2
16,392,392,4,1,3,2,1
14,393,393,91,91,0,1,0
6,399,399,11,11,0,1,0
34,404,404,59,31,28,2,1
11,414,414,98,38,60,4,3
10,421,421,34,6,28,2,1
24,422,422,61,49,12,3,2
32,425,425,33,25,8,2,1
5,464,464,21,21,0,1,0
20,464,464,9,9,0,1,0
9,488,488,7,2,5,2,1

31,103,103,4,1,3,2,1
22,113,113,1,1,0,1,0
26,115,115,9,3,6,3,2
5,133,133,3,3,0,1,0
20,138,138,1,1,0,1,0
29,152,152,2,2,0,1,0
43,156,156,7,1,6,2,1
14,164,164,10,1,9,4,3
25,178,178,24,9,15,4,3
40,188,188,15,1,14,2,1
0,201,201,56,56,0,1,0
42,221,221,37,37,0,1,0
2,225,225,38,5,33,4,3
33,230,230,69,69,0,1,0
18,233,233,12,3,9,4,3
21,237,237,28,28,0,1,0
12,247,247,1,1,0,1,0
28,265,265,34,34,0,1,0
9,270,270,17,8,9,2,1
36,276,276,15,10,5,2,1
23,284,284,17,17,0,1,0
13,284,284,22,4,18,4,3
37,289,289,1,1,0,1,0
24,310,310,11,2,9,4,3
6,311,311,11,11,0,1,0
19,311,311,13,4,9,4,3
17,313,313,16,2,14,2,1
4,321,321,15,15,0,1,0
10,323,323,25,10,15,4,3
1,324,324,58,58,0,1,0
34,335,335,30,30,0,1,0
32,338,338,100,54,46,3,2
3,339,339,2,2,0,1,0
44,348,348,50,50,0,1,0
11,352,352,9,9,0,1,0
27,354,354,32,32,0,1,0
15,421,421,33,18,15,2,1
16,426,426,103,64,39,4,3
39,430,430,50,6,44,2,1
41,430,430,49,35,14,3,2
8,441,441,10,4,6,3,2
35,449,449,21,21,0,1,0
38,456,456,18,6,12,4,3
7,468,468,3,3,0,1,0
30,475,475,50,23,27,2,1

27,105,105,2,2,0,1,0
5,105,105,18,18,0,1,0
26,113,113,6,6,0,1,0
36,119,119,4,4,0,1,0
0,143,143,9,9,0,1,0
41,173,173,8,8,0,1,0
29,183,183,19,7,12,3,2
7,184,184,4,4,0,1,0
14,189,189,9,9,0,1,0
2,201,201,4,4,0,1,0
25,207,207,12,12,0,1,0
15,211,211,49,9,40,3,2
8,217,217,28,3,25,2,1
16,227,227,7,7,0,1,0
11,228,228,36,36,0,1,0
22,237,237,26,2,24,2,1
18,240,240,28,28,0,1,0
10,254,254,9,9,0,1,0
42,254,254,42,8,34,4,3
38,262,262,9,9,0,1,0
6,265,265,23,8,15,3,2
23,311,311,22,9,13,3,2
17,314,314,1,1,0,1,0
12,316,316,10,2,8,3,2
20,324,324,7,3,4,2,1
34,326,326,1,1,0,1,0
39,332,332,58,41,17,2,1
33,336,336,33,25,8,2,1
4,340,340,15,15,0,1,0
9,371,371,7,7,0,1,0
1,371,371,42,10,32,3,2
24,372,372,58,58,0,1,0
32,379,379,33,1,32,2,1
13,394,394,13,13,0,1,0
43,395,395,82,82,0,1,0
3,398,398,9,9,0,1,0
35,406,406,28,11,17,4,3
40,411,411,1,1,0,1,0
19,436,436,5,5,0,1,0
21,437,437,67,52,15,2,1
31,442,442,269,230,39,2,1
30,464,464,8,8,0,1,0
37,469,469,42,42,0,1,0
28,470,470,29,8,21,4,3

11,100,100,1,1,0,1,0
3,112,112,4,4,0,1,0
26,112,112,17,17,0,1,0
0,137,137,1,1,0,1,0
20,140,140,3,3,0,1,0
30,141,141,23,23,0,1,0
23,146,146,39,27,12,4,3
8,157,157,14,11,3,2,1
34,172,172,3,3,0,1,0
28,194,194,32,5,27,2,1
21,200,200,5,1,4,2,1
2,200,200,10,10,0,1,0
25,207,207,3,3,0,1,0
27,211,211,56,17,39,2,1
9,240,240,77,77,0,1,0
31,251,251,1,1,0,1,0
15,251,251,4,4,0,1,0
33,272,272,33,7,26,3,2
14,316,316,49,21,28,3,2
16,321,321,141,68,73,4,3
38,334,334,13,3,10,3,2
37,348,348,67,33,34,2,1
18,348,348,19,19,0,1,0
17,349,349,1,1,0,1,0
6,380,380,1,1,0,1,0
19,395,395,7,7,0,1,0
36,403,403,1,1,0,1,0
12,408,408,17,9,8,2,1
35,412,412,5,1,4,2,1
5,445,445,8,1,7,2,1
4,459,459,45,45,0,1,0
7,461,461,83,63,20,2,1
1,472,472,107,74,33,4,3
32,477,477,88,88,0,1,0
10,480,480,24,24,0,1,0
13,480,480,32,7,25,2,1
39,483,483,91,37,54,4,3
22,492,492,42,2,40,3,2
29,494,494,6,2,4,2,1
24,498,498,16,6,10,2,1

35,106,106,14,14,0,1,0
0,148,148,3,3,0,1,0
6,161,161,1,1,0,1,0
12,165,165,29,13,16,3,2
13,176,176,14,2,12,3,2
37,183,183,9,9,0,1,0
11,191,191,65,25,40,3,2
27,195,195,24,12,12,2,1
17,201,201,4,1,3,2,1
1,223,223,3,3,0,1,0
29,233,233,7,7,0,1,0
31,235,235,4,4,0,1,0
26,239,239,43,43,0,1,0
30,278,278,5,5,0,1,0
5,282,282,12,12,0,1,0
36,322,322,55,28,27,4,3
34,341,341,65,65,0,1,0
3,343,343,14,14,0,1,0
22,349,349,14,14,0,1,0
7,351,351,89,89,0,1,0
18,355,355,12,12,0,1,0
9,374,374,13,13,0,1,0
33,386,386,62,62,0,1,0
15,396,396,1,1,0,1,0
21,405,405,1,1,0,1,0
20,431,431,61,49,12,3,2
4,449,449,22,2,20,2,1
28,452,452,36,7,29,3,2
2,463,463,79,49,30,4,3
10,464,464,47,20,27,4,3
32,466,466,57,57,0,1,0
25,472,472,42,2,40,3,2
23,473,473,64,18,46,2,1
19,473,473,15,15,0,1,0
14,475,475,143,143,0,1,0
8,478,478,61,61,0,1,0
16,481,481,42,42,0,1,0
24,487,487,109,27,82,3,2

27,113,113,17,17,0,1,0
14,122,122,14,14,0,1,0
30,129,129,22,4,18,3,2
11,153,153,1,1,0,1,0
8,156,156,32,32,0,1,0
7,167,167,1,1,0,1,0
4,177,177,3,3,0,1,0
6,190,190,2,2,0,1,0
2,202,202,28,6,22,3,2
20,225,225,7,7,0,1,0
22,234,234,10,10,0,1,0
25,273,273,93,74,19,2,1
28,305,305,83,45,38,3,2
1,306,306,58,4,54,4,3
31,309,309,41,5,36,4,3
16,335,335,5,1,4,2,1
33,343,343,21,15,6,3,2
36,362,362,79,79,0,1,0
21,374,374,27,27,0,1,0
29,377,377,40,5,35,2,1
5,385,385,6,6,0,1,0
34,388,388,42,42,0,1,0
32,391,391,7,2,5,2,1
17,391,391,101,101,0,1,0
19,403,403,12,12,0,1,0
12,413,413,1,1,0,1,0
0,433,433,1,1,0,1,0
15,442,442,13,1,12,4,3
23,444,444,16,4,12,3,2
10,447,447,57,29,28,3,2
37,451,451,3,3,0,1,0
26,466,466,47,47,0,1,0
24,478,478,10,1,9,2,1
35,480,480,6,6,0,1,0
3,483,483,81,81,0,1,0
9,483,483,6,6,0,1,0
18,486,486,267,213,54,4,3
13,499,499,16,16,0,1,0

28,102,102,14,14,0,1,0
34,103,103,11,1,10,2,1
23,107,107,14,14,0,1,0
37,112,112,4,4,0,1,0
10,117,117,7,1,6,2,1
30,121,121,30,30,0,1,0
2,135,135,18,18,0,1,0
40,145,145,5,5,0,1,0
35,158,158,17,17,0,1,0
15,167,167,1,1,0,1,0
21,175,175,7,3,4,2,1
27,177,177,18,18,0,1,0
38,182,182,2,2,0,1,0
3,186,186,3,3,0,1,0
12,191,191,2,2,0,1,0
29,195,195,14,14,0,1,0
16,197,197,11,5,6,3,2
36,197,197,2,2,0,1,0
33,239,239,26,26,0,1,0
39,259,259,12,12,0,1,0
24,264,264,4,4,0,1,0
20,271,271,6,6,0,1,0
32,287,287,60,60,0,1,0
4,302,302,63,37,26,3,2
13,304,304,27,6,21,4,3
9,310,310,3,3,0,1,0
19,321,321,20,5,15,2,1
7,327,327,79,45,34,2,1
0,335,335,5,5,0,1,0
18,339,339,117,117,0,1,0
43,344,344,6,2,4,2,1
5,348,348,8,2,6,3,2
11,354,354,58,58,0,1,0
25,361,361,68,68,0,1,0
17,370,370,10,10,0,1,0
14,400,400,1,1,0,1,0
6,405,405,12,12,0,1,0
26,407,407,40,40,0,1,0
8,409,409,22,22,0,1,0
22,423,423,19,7,12,2,1
31,446,446,142,10,132,4,3
1,468,468,45,45,0,1,0
42,486,486,25,25,0,1,0
41,494,494,21,21,0,1,0

37,107,107,9,3,6,2,1
16,123,123,22,22,0,1,0
28,143,143,25,14,11,2,1
17,161,161,5,2,3,2,1
11,172,172,12,12,0,1,0
34,175,175,15,5,10,2,1
33,182,182,13,13,0,1,0
30,184,184,28,28,0,1,0
5,185,185,46,20,26,2,1
27,189,189,29,18,11,2,1
8,209,209,3,3,0,1,0
31,212,212,17,17,0,1,0
3,222,222,7,7,0,1,0
38,241,241,84,36,48,3,2
7,244,244,2,2,0,1,0
36,259,259,3,3,0,1,0
9,272,272,1,1,0,1,0
10,289,289,16,8,8,3,2
35,314,314,32,32,0,1,0
2,340,340,50,50,0,1,0
32,356,356,46,46,0,1,0
25,359,359,15,15,0,1,0
15,370,370,80,39,41,2,1
12,376,376,9,3,6,3,2
22,380,380,22,17,5,2,1
4,410,410,8,8,0,1,0
14,417,417,123,78,45,4,3
6,424,424,24,10,14,2,1
29,424,424,14,1,13,2,1
26,438,438,42,42,0,1,0
23,458,458,43,43,0,1,0
13,470,470,66,36,30,2,1
24,474,474,4,4,0,1,0
21,484,484,30,2,28,2,1
18,488,488,74,42,32,2,1
20,492,492,76,49,27,4,3
1,492,492,27,21,6,2,1
19,492,492,28,28,0,1,0
0,492,492,48,35,13,2,1

7,121,121,30,30,0,1,0
28,140,140,21,8,13,2,1
1,141,141,34,6,28,3,2
12,166,166,1,1,0,1,0
23,188,188,14,5,9,2,1
29,219,219,23,7,16,3,2
20,231,231,7,7,0,1,0
9,235,235,10,10,0,1,0
8,239,239,14,14,0,1,0
21,244,244,27,27,0,1,0
13,254,254,12,3,9,4,3
17,258,258,3,3,0,1,0
35,264,264,9,9,0,1,0
30,264,264,45,45,0,1,0
2,283,283,5,5,0,1,0
5,288,288,21,21,0,1,0
10,306,306,45,45,0,1,0
6,313,313,8,2,6,3,2
24,315,315,38,6,32,2,1
19,316,316,4,1,3,2,1
3,317,317,2,2,0,1,0
33,346,346,7,7,0,1,0
32,365,365,35,35,0,1,0
31,369,369,49,49,0,1,0
25,375,375,60,60,0,1,0
14,386,386,24,24,0,1,0
34,387,387,8,4,4,2,1
26,394,394,130,122,8,2,1
11,399,399,75,75,0,1,0
22,411,411,40,21,19,2,1
4,411,411,106,85,21,4,3
15,413,413,1,1,0,1,0
18,431,431,20,20,0,1,0
27,432,432,87,87,0,1,0
16,465,465,211,157,54,3,2
0,466,466,11,11,0,1,0

25,111,111,5,5,0,1,0
36,126,126,12,12,0,1,0
12,133,133,45,45,0,1,0
27,138,138,8,8,0,1,0
1,165,165,2,2,0,1,0
3,176,176,11,3,8,2,1
2,186,186,38,38,0,1,0
7,196,196,14,14,0,1,0
34,224,224,118,47,71,3,2
16,225,225,1,1,0,1,0
17,244,244,19,3,16,3,2
28,253,253,26,10,16,3,2
5,265,265,39,13,26,2,1
4,277,277,1,1,0,1,0
26,282,282,4,4,0,1,0
37,289,289,7,7,0,1,0
31,293,293,6,1,5,2,1
30,296,296,9,5,4,2,1
0,298,298,19,19,0,1,0
8,312,312,42,12,30,3,2
29,320,320,48,38,10,2,1
11,323,323,50,5,45,2,1
19,336,336,54,54,0,1,0
13,343,343,3,3,0,1,0
21,361,361,28,4,24,3,2
10,377,377,59,56,3,2,1
23,377,377,6,6,0,1,0
9,383,383,71,61,10,3,2
15,384,384,6,6,0,1,0
6,392,392,22,22,0,1,0
18,408,408,20,20,0,1,0
24,412,412,5,1,4,2,1
14,414,414,64,64,0,1,0
22,426,426,4,4,0,1,0
20,443,443,135,135,0,1,0
35,466,466,43,13,30,4,3
32,469,469,88,88,0,1,0
33,484,484,6,6,0,1,0

0,108,108,8,8,0,1,0
9,108,108,10,3,7,2,1
24,134,134,12,12,0,1,0
7,135,135,7,1,6,3,2
29,147,147,3,3,0,1,0
33,171,171,13,13,0,1,0
17,182,182,42,42,0,1,0
23,184,184,12,12,0,1,0
12,193,193,12,12,0,1,0
37,199,199,75,57,18,4,3
8,202,202,6,6,0,1,0
38,203,203,12,12,0,1,0
26,208,208,4,4,0,1,0
18,209,209,3,3,0,1,0
30,209,209,11,5,6,2,1
1,213,213,8,2,6,2,1
20,215,215,17,17,0,1,0
2,227,227,6,2,4,2,1
22,243,243,10,10,0,1,0
34,266,266,2,2,0,1,0
27,268,268,6,6,0,1,0
14,270,270,13,13,0,1,0
6,284,284,21,3,18,2,1
36,285,285,5,5,0,1,0
35,286,286,9,9,0,1,0
41,294,294,6,1,5,2,1
21,294,294,24,24,0,1,0
3,305,305,1,1,0,1,0
40,317,317,23,23,0,1,0
10,332,332,1,1,0,1,0
11,333,333,28,28,0,1,0
5,344,344,98,30,68,3,2
39,355,355,145,85,60,3,2
15,377,377,46,17,29,2,1
19,383,383,50,50,0,1,0
16,419,419,22,4,18,4,3
13,427,427,69,69,0,1,0
4,436,436,22,13,9,4,3
42,441,441,136,52,84,3,2
31,457,457,64,12,52,3,2
32,469,469,16,16,0,1,0
28,485,485,44,44,0,1,0
25,491,491,46,40,6,2,1

9,121,121,11,2,9,4,3
4,138,138,57,23,34,2,1
17,141,141,1,1,0,1,0
3,155,155,1,1,0,1,0
31,160,160,11,2,9,4,3
11,169,169,32,2,30,3,2
22,170,170,27,27,0,1,0
38,171,171,3,3,0,1,0
20,190,190,2,2,0,1,0
13,206,206,5,2,3,2,1
8,223,223,13,6,7,2,1
12,227,227,2,2,0,1,0
30,240,240,35,15,20,3,2
23,247,247,2,2,0,1,0
15,279,279,4,4,0,1,0
33,290,290,5,5,0,1,0
16,295,295,1,1,0,1,0
25,308,308,41,26,15,4,3
29,312,312,14,8,6,3,2
7,321,321,29,29,0,1,0
14,343,343,68,68,0,1,0
2,353,353,7,4,3,2,1
5,362,362,3,3,0,1,0
24,373,373,103,103,0,1,0
0,376,376,12,5,7,2,1
18,380,380,100,93,7,2,1
19,387,387,56,7,49,4,3
32,398,398,23,23,0,1,0
27,403,403,119,119,0,1,0
1,423,423,77,77,0,1,0
35,438,438,51,9,42,3,2
37,445,445,16,10,6,3,2
26,456,456,78,72,6,3,2
34,457,457,28,28,0,1,0
10,462,462,47,47,0,1,0
36,487,487,130,130,0,1,0
21,488,488,13,13,0,1,0
28,497,497,8,2,6,2,1
6,497,497,22,8,14,3,2

4,130,130,1,1,0,1,0
12,132,132,24,12,12,3,2
9,155,155,26,26,0,1,0
33,156,156,7,4,3,2,1
28,193,193,22,1,21,4,3
34,197,197,4,4,0,1,0
1,198,198,20,20,0,1,0
29,203,203,39,23,16,2,1
7,223,223,9,9,0,1,0
5,226,226,1,1,0,1,0
18,227,227,5,1,4,2,1
22,229,229,4,4,0,1,0
23,239,239,42,18,24,4,3
21,270,270,21,6,15,2,1
30,274,274,50,16,34,3,2
19,279,279,16,16,0,1,0
35,288,288,91,46,45,4,3
26,301,301,12,12,0,1,0
17,316,316,46,35,11,2,1
20,324,324,70,49,21,2,1
27,352,352,15,15,0,1,0
6,360,360,48,48,0,1,0
25,380,380,34,34,0,1,0
10,382,382,39,39,0,1,0
24,392,392,19,10,9,2,1
3,396,396,8,8,0,1,0
0,405,405,34,19,15,2,1
15,407,407,49,49,0,1,0
16,408,408,128,10,118,4,3
2,411,411,9,6,3,2,1
31,430,430,46,6,40,3,2
14,436,436,128,14,114,4,3
13,453,453,4,4,0,1,0
11,468,468,49,1,48,4,3
8,485,485,95,38,57,4,3
32,500,500,13,13,0,1,0

10,125,125,5,2,3,2,1
20,137,137,13,7,6,2,1
11,146,146,17,17,0,1,0
12,149,149,2,2,0,1,0
21,154,154,8,8,0,1,0
9,165,165,24,11,13,2,1
13,168,168,18,6,12,4,3
18,170,170,1,1,0,1,0
30,181,181,33,27,6,2,1
15,183,183,75,49,26,2,1
17,188,188,13,9,4,2,1
4,221,221,1,1,0,1,0
26,246,246,40,40,0,1,0
23,272,272,2,2,0,1,0
8,320,320,113,113,0,1,0
14,328,328,16,16,0,1,0
7,333,333,28,12,16,2,1
16,342,342,18,18,0,1,0
0,351,351,41,41,0,1,0
32,357,357,4,4,0,1,0
5,361,361,13,9,4,2,1
3,369,369,1,1,0,1,0
25,384,384,34,4,30,3,2
1,386,386,93,28,65,3,2
22,403,403,51,24,27,4,3
29,427,427,5,5,0,1,0
31,433,433,99,23,76,3,2
27,465,465,26,26,0,1,0
24,481,481,50,42,8,3,2
6,484,484,118,66,52,4,3
19,491,491,2,2,0,1,0
28,496,496,108,3,105,4,3
2,498,498,197,137,60,4,3

11,100,100,18,10,8,2,1
5,104,104,4,4,0,1,0
7,106,106,14,5,9,4,3
37,176,176,7,7,0,1,0
6,183,183,6,6,0,1,0
27,216,216,34,4,30,3,2
0,217,217,17,17,0,1,0
20,220,220,1,1,0,1,0
9,232,232,16,6,10,3,2
2,237,237,60,34,26,2,1
4,240,240,18,8,10,2,1
32,248,248,12,12,0,1,0
34,249,249,39,12,27,2,1
17,275,275,42,42,0,1,0
18,276,276,32,32,0,1,0
31,298,298,33,10,23,2,1
13,309,309,39,22,17,2,1
30,312,312,24,14,10,2,1
10,333,333,70,50,20,3,2
23,347,347,179,179,0,1,0
25,381,381,60,34,26,3,2
1,398,398,8,5,3,2,1
33,399,399,8,5,3,2,1
35,406,406,6,6,0,1,0
19,411,411,83,10,73,3,2
8,433,433,18,7,11,2,1
16,436,436,62,62,0,1,0
22,440,440,10,2,8,3,2
29,454,454,42,38,4,2,1
21,454,454,30,17,13,2,1
12,454,454,34,34,0,1,0
28,455,455,75,75,0,1,0
24,467,467,24,14,10,2,1
14,473,473,54,20,34,3,2
26,487,487,3,3,0,1,0
3,489,489,17,1,16,3,2
36,490,490,11,11,0,1,0
15,494,494,5,5,0,1,0

39,131,131,16,10,6,3,2
3,140,140,15,15,0,1,0
7,149,149,6,6,0,1,0
16,165,165,2,2,0,1,0
4,184,184,17,17,0,1,0
14,199,199,20,1,19,2,1
5,210,210,1,1,0,1,0
17,217,217,67,31,36,2,1
15,244,244,2,2,0,1,0
23,247,247,136,55,81,3,2
28,247,247,11,11,0,1,0
20,249,249,5,5,0,1,0
10,251,251,28,28,0,1,0
2,276,276,17,4,13,4,3
11,286,286,28,28,0,1,0
22,308,308,9,9,0,1,0
1,311,311,74,74,0,1,0
19,327,327,8,8,0,1,0
18,339,339,109,67,42,3,2
27,346,346,45,36,9,2,1
6,351,351,27,15,12,4,3
0,361,361,7,4,3,2,1
21,364,364,9,9,0,1,0
26,367,367,10,1,9,4,3
33,379,379,91,16,75,4,3
25,381,381,11,11,0,1,0
32,403,403,18,18,0,1,0
24,408,408,66,50,16,3,2
36,410,410,31,25,6,3,2
34,410,410,12,8,4,2,1
38,424,424,9,9,0,1,0
8,427,427,4,4,0,1,0
9,428,428,53,53,0,1,0
40,432,432,21,21,0,1,0
13,453,453,16,6,10,3,2
31,460,460,26,26,0,1,0
29,465,465,46,46,0,1,0
12,474,474,30,22,8,2,1
35,477,477,94,94,0,1,0
30,483,483,5,5,0,1,0
37,489,489,2,2,0,1,0

28,124,124,1,1,0,1,0
9,125,125,2,2,0,1,0
3,133,133,20,5,15,4,3
1,136,136,10,1,9,4,3
39,144,144,4,4,0,1,0
18,166,166,11,4,7,2,1
29,171,171,7,7,0,1,0
20,176,176,3,3,0,1,0
16,185,185,28,28,0,1,0
42,192,192,21,21,0,1,0
17,201,201,6,6,0,1,0
15,201,201,10,10,0,1,0
40,211,211,16,3,13,2,1
7,212,212,5,5,0,1,0
30,218,218,56,56,0,1,0
12,230,230,18,10,8,3,2
27,230,230,2,2,0,1,0
11,238,238,1,1,0,1,0
8,251,251,9,9,0,1,0
13,297,297,55,55,0,1,0
14,297,297,35,7,28,2,1
0,298,298,3,3,0,1,0
38,303,303,46,43,3,2,1
41,306,306,5,1,4,2,1
32,308,308,41,34,7,2,1
19,316,316,23,23,0,1,0
34,334,334,56,56,0,1,0
36,344,344,138,42,96,4,3
25,356,356,8,4,4,2,1
2,360,360,164,79,85,4,3
23,369,369,34,12,22,2,1
21,378,378,9,9,0,1,0
37,387,387,56,56,0,1,0
5,396,396,19,19,0,1,0
33,400,400,47,35,12,4,3
24,426,426,64,7,57,3,2
22,427,427,26,13,13,2,1
35,437,437,3,3,0,1,0
10,445,445,23,8,15,2,1
31,448,448,10,2,8,2,1
26,464,464,30,30,0,1,0
6,496,496,37,37,0,1,0
4,498,498,6,6,0,1,0

6,103,103,25,25,0,1,0
7,113,113,9,9,0,1,0
24,113,113,11,11,0,1,0
33,120,120,7,7,0,1,0
40,124,124,3,3,0,1,0
14,131,131,19,19,0,1,0
3,134,134,1,1,0,1,0
16,136,136,17,12,5,2,1
1,141,141,24,24,0,1,0
23,158,158,32,3,29,3,2
9,173,173,10,10,0,1,0
11,178,178,6,3,3,2,1
17,185,185,8,8,0,1,0
15,202,202,26,26,0,1,0
37,203,203,12,12,0,1,0
31,207,207,29,11,18,3,2
27,211,211,6,6,0,1,0
2,229,229,1,1,0,1,0
21,238,238,28,6,22,2,1
36,238,238,18,6,12,4,3
41,241,241,11,11,0,1,0
4,244,244,16,16,0,1,0
38,256,256,23,23,0,1,0
26,266,266,69,69,0,1,0
13,277,277,4,4,0,1,0
28,285,285,86,86,0,1,0
19,288,288,25,25,0,1,0
8,309,309,19,19,0,1,0
20,316,316,14,14,0,1,0
18,352,352,69,20,49,4,3
10,377,377,9,3,6,2,1
0,389,389,37,9,28,2,1
34,389,389,39,39,0,1,0
12,393,393,43,2,41,2,1
39,398,398,25,18,7,2,1
29,418,418,4,4,0,1,0
25,423,423,1,1,0,1,0
22,433,433,14,14,0,1,0
35,452,452,49,49,0,1,0
30,456,456,106,80,26,3,2
5,465,465,8,8,0,1,0
32,488,488,23,7,16,2,1

33,116,116,9,9,0,1,0
30,123,123,13,13,0,1,0
11,160,160,37,37,0,1,0
34,175,175,45,27,18,3,2
31,176,176,19,16,3,2,1
32,193,193,1,1,0,1,0
26,223,223,3,3,0,1,0
6,230,230,7,1,6,3,2
13,252,252,7,1,6,2,1
10,256,256,15,2,13,2,1
23,262,262,22,8,14,3,2
8,264,264,104,38,66,3,2
16,291,291,5,5,0,1,0
29,308,308,138,138,0,1,0
1,311,311,27,15,12,2,1
5,314,314,98,49,49,4,3
15,316,316,48,38,10,2,1
14,317,317,22,4,18,4,3
0,327,327,95,95,0,1,0
24,336,336,21,21,0,1,0
9,362,362,9,9,0,1,0
3,369,369,1,1,0,1,0
2,395,395,10,10,0,1,0
18,411,411,50,50,0,1,0
28,438,438,31,31,0,1,0
21,444,444,35,5,30,3,2
12,465,465,6,6,0,1,0
4,468,468,60,34,26,2,1
27,469,469,1,1,0,1,0
7,469,469,25,25,0,1,0
22,477,477,57,57,0,1,0
19,486,486,26,26,0,1,0
17,486,486,8,2,6,2,1
25,489,489,132,112,20,3,2
20,497,497,13,10,3,2,1

37,104,104,13,13,0,1,0
46,131,131,13,13,0,1,0
40,133,133,7,7,0,1,0
47,135,135,37,23,14,3,2
13,141,141,1,1,0,1,0
14,145,145,5,2,3,2,1
8,152,152,11,3,8,3,2
45,155,155,22,22,0,1,0
48,161,161,38,23,15,2,1
43,173,173,29,3,26,3,2
24,181,181,1,1,0,1,0
15,182,182,1,1,0,1,0
32,199,199,1,1,0,1,0
18,209,209,5,5,0,1,0
4,211,211,1,1,0,1,0
26,211,211,13,7,6,3,2
9,213,213,19,19,0,1,0
44,218,218,18,7,11,2,1
11,220,220,27,27,0,1,0
22,226,226,45,12,33,2,1
17,263,263,32,5,27,2,1
5,269,269,19,1,18,3,2
0,271,271,11,11,0,1,0
25,283,283,3,3,0,1,0
31,297,297,3,3,0,1,0
20,323,323,12,12,0,1,0
41,348,348,44,34,10,3,2
30,358,358,36,9,27,4,3
38,363,363,42,42,0,1,0
23,367,367,17,5,12,3,2
27,368,368,46,46,0,1,0
2,369,369,26,26,0,1,0
19,371,371,50,24,26,3,2
10,384,384,6,6,0,1,0
34,392,392,27,27,0,1,0
21,406,406,23,3,20,3,2
1,408,408,8,1,7,2,1
35,417,417,23,4,19,4,3
29,428,428,44,44,0,1,0
39,431,431,40,40,0,1,0
6,456,456,3,3,0,1,0
36,457,457,8,8,0,1,0
42,460,460,6,6,0,1,0
12,468,468,4,4,0,1,0
3,477,477,61,34,27,2,1
28,482,482,55,55,0,1,0
7,488,488,38,38,0,1,0
33,496,496,81,81,0,1,0
16,496,496,44,14,30,4,3

34,102,102,23,8,15,2,1
30,106,106,2,2,0,1,0
7,125,125,18,18,0,1,0
19,143,143,8,8,0,1,0
0,144,144,2,2,0,1,0
25,150,150,12,12,0,1,0
4,159,159,7,7,0,1,0
13,162,162,12,12,0,1,0
10,174,174,48,36,12,4,3
35,185,185,42,32,10,3,2
20,185,185,8,8,0,1,0
17,199,199,14,14,0,1,0
18,199,199,10,10,0,1,0
31,202,202,11,11,0,1,0
26,203,203,23,23,0,1,0
6,231,231,6,6,0,1,0
37,248,248,4,4,0,1,0
32,252,252,14,14,0,1,0
28,260,260,87,28,59,4,3
15,261,261,6,6,0,1,0
27,273,273,64,52,12,4,3
21,293,293,14,2,12,4,3
12,302,302,72,72,0,1,0
9,307,307,1,1,0,1,0
2,308,308,112,91,21,4,3
5,319,319,43,8,35,4,3
23,327,327,64,64,0,1,0
24,331,331,10,4,6,3,2
11,349,349,8,8,0,1,0
16,351,351,6,3,3,2,1
33,354,354,30,30,0,1,0
36,377,377,2,2,0,1,0
8,380,380,27,27,0,1,0
14,391,391,51,36,15,2,1
22,435,435,26,4,22,2,1
29,447,447,26,26,0,1,0
3,469,469,55,55,0,1,0
1,497,497,42,6,36,4,3

13,101,101,4,4,0,1,0
11,118,118,8,8,0,1,0
17,121,121,7,7,0,1,0
6,131,131,6,3,3,2,1
33,133,133,3,3,0,1,0
21,139,139,10,10,0,1,0
10,163,163,48,48,0,1,0
4,183,183,20,20,0,1,0
14,195,195,6,6,0,1,0
29,199,199,26,26,0,1,0
25,201,201,7,7,0,1,0
2,210,210,3,3,0,1,0
19,282,282,21,21,0,1,0
1,311,311,17,17,0,1,0
27,323,323,8,8,0,1,0
31,344,344,3,3,0,1,0
7,349,349,111,47,64,3,2
23,373,373,4,4,0,1,0
5,374,374,19,6,13,2,1
8,376,376,120,88,32,3,2
18,384,384,68,43,25,2,1
32,394,394,10,10,0,1,0
16,397,397,91,91,0,1,0
20,401,401,76,14,62,3,2
0,405,405,6,6,0,1,0
12,406,406,34,3,31,2,1
15,408,408,67,55,12,4,3
26,414,414,138,17,121,4,3
22,417,417,47,7,40,3,2
3,447,447,141,100,41,2,1
24,461,461,17,17,0,1,0
9,462,462,67,55,12,4,3
30,494,494,23,7,16,2,1
28,497,497,91,91,0,1,0

19,107,107,6,6,0,1,0
5,116,116,26,10,16,2,1
45,142,142,5,5,0,1,0
43,153,153,18,15,3,2,1
38,154,154,3,3,0,1,0
28,165,165,67,51,16,2,1
0,182,182,10,5,5,2,1
17,185,185,52,52,0,1,0
29,210,210,10,4,6,3,2
35,220,220,8,8,0,1,0
11,235,235,13,13,0,1,0
14,236,236,34,2,32,2,1
6,251,251,2,2,0,1,0
2,252,252,15,15,0,1,0
10,260,260,25,17,8,2,1
3,270,270,20,1,19,3,2
42,271,271,12,12,0,1,0
25,274,274,1,1,0,1,0
31,276,276,70,70,0,1,0
36,278,278,4,4,0,1,0
41,282,282,55,55,0,1,0
9,292,292,35,27,8,3,2
8,304,304,7,7,0,1,0
39,306,306,48,48,0,1,0
24,314,314,42,8,34,3,2
7,315,315,9,5,4,2,1
21,316,316,1,1,0,1,0
16,325,325,76,66,10,2,1
33,328,328,8,8,0,1,0
20,331,331,1,1,0,1,0
12,351,351,5,5,0,1,0
40,358,358,6,6,0,1,0
26,360,360,33,33,0,1,0
44,376,376,47,47,0,1,0
32,377,377,84,84,0,1,0
13,400,400,2,2,0,1,0
30,406,406,41,34,7,2,1
27,413,413,7,1,6,3,2
15,419,419,6,6,0,1,0
37,433,433,28,5,23,3,2
34,435,435,19,3,16,2,1
1,441,441,17,17,0,1,0
23,444,444,1,1,0,1,0
22,450,450,9,6,3,2,1
18,465,465,19,19,0,1,0
4,486,486,35,26,9,4,3

11,105,105,4,4,0,1,0
1,111,111,16,16,0,1,0
27,140,140,7,7,0,1,0
40,142,142,18,12,6,2,1
35,143,143,34,8,26,3,2
33,147,147,1,1,0,1,0
7,164,164,1,1,0,1,0
24,164,164,10,10,0,1,0
20,196,196,1,1,0,1,0
25,205,205,26,26,0,1,0
14,215,215,1,1,0,1,0
34,222,222,3,3,0,1,0
12,228,228,23,23,0,1,0
0,281,281,11,1,10,3,2
31,284,284,21,21,0,1,0
2,288,288,38,38,0,1,0
15,288,288,31,15,16,2,1
30,294,294,34,16,18,3,2
21,303,303,23,11,12,2,1
22,313,313,56,56,0,1,0
38,323,323,2,2,0,1,0
9,328,328,27,27,0,1,0
6,342,342,86,37,49,4,3
29,351,351,54,23,31,2,1
3,353,353,72,36,36,3,2
13,355,355,9,9,0,1,0
32,360,360,81,17,64,3,2
4,368,368,27,27,0,1,0
39,378,378,14,14,0,1,0
16,384,384,23,10,13,2,1
37,399,399,32,17,15,2,1
23,405,405,26,26,0,1,0
36,418,418,22,22,0,1,0
19,423,423,19,19,0,1,0
17,455,455,22,14,8,2,1
28,467,467,110,25,85,4,3
5,476,476,2,2,0,1,0
26,476,476,47,47,0,1,0
10,481,481,27,27,0,1,0
18,481,481,41,2,39,2,1
8,494,494,155,146,9,4,3

13,109,109,6,6,0,1,0
19,112,112,14,8,6,3,2
5,136,136,1,1,0,1,0
7,144,144,31,31,0,1,0
30,162,162,31,31,0,1,0
14,220,220,22,22,0,1,0
16,244,244,56,56,0,1,0
0,279,279,10,3,7,2,1
35,283,283,28,28,0,1,0
26,285,285,10,10,0,1,0
22,286,286,27,27,0,1,0
9,297,297,29,29,0,1,0
1,321,321,7,7,0,1,0
32,323,323,70,70,0,1,0
11,324,324,22,22,0,1,0
28,332,332,39,39,0,1,0
27,333,333,2,2,0,1,0
12,338,338,55,20,35,2,1
10,361,361,7,7,0,1,0
3,362,362,11,11,0,1,0
6,368,368,7,7,0,1,0
18,377,377,13,1,12,2,1
25,389,389,1,1,0,1,0
20,390,390,32,32,0,1,0
15,394,394,14,14,0,1,0
29,400,400,60,53,7,2,1
2,409,409,77,77,0,1,0
17,411,411,18,8,10,2,1
8,431,431,26,26,0,1,0
24,432,432,44,10,34,2,1
34,433,433,148,148,0,1,0
33,464,464,36,36,0,1,0
21,479,479,24,24,0,1,0
23,491,491,24,20,4,2,1
4,492,492,274,248,26,3,2
31,495,495,56,37,19,2,1

26,110,110,1,1,0,1,0
23,126,126,1,1,0,1,0
29,160,160,23,15,8,2,1
8,183,183,7,7,0,1,0
11,194,194,20,20,0,1,0
6,197,197,35,18,17,2,1
0,204,204,40,30,10,2,1
18,216,216,13,13,0,1,0
17,233,233,7,7,0,1,0
28,239,239,5,5,0,1,0
27,244,244,28,18,10,2,1
13,260,260,66,59,7,2,1
14,283,283,2,2,0,1,0
12,294,294,13,13,0,1,0
19,317,317,39,21,18,4,3
2,318,318,131,100,31,4,3
1,327,327,81,7,74,3,2
5,361,361,24,24,0,1,0
16,363,363,19,19,0,1,0
15,369,369,3,3,0,1,0
22,383,383,41,12,29,3,2
25,386,386,149,65,84,4,3
30,387,387,102,102,0,1,0
3,395,395,8,8,0,1,0
9,429,429,171,141,30,4,3
4,431,431,14,14,0,1,0
21,437,437,63,63,0,1,0
10,440,440,27,27,0,1,0
24,448,448,13,13,0,1,0
20,460,460,63,63,0,1,0
7,466,466,69,26,43,2,1

35,109,109,13,3,10,2,1
13,111,111,1,1,0,1,0
15,113,113,1,1,0,1,0
21,136,136,6,6,0,1,0
3,143,143,10,10,0,1,0
29,148,148,2,2,0,1,0
18,161,161,16,13,3,2,1
33,211,211,11,11,0,1,0
14,216,216,23,23,0,1,0
32,216,216,23,6,17,4,3
7,226,226,17,1,16,2,1
17,230,230,35,11,24,3,2
8,233,233,8,8,0,1,0
4,239,239,74,30,44,4,3
22,264,264,50,40,10,2,1
30,278,278,20,20,0,1,0
5,281,281,28,28,0,1,0
1,282,282,43,43,0,1,0
2,291,291,34,34,0,1,0
36,308,308,9,9,0,1,0
26,316,316,92,92,0,1,0
34,321,321,10,10,0,1,0
6,351,351,8,8,0,1,0
0,364,364,171,81,90,3,2
9,368,368,22,22,0,1,0
28,370,370,36,21,15,2,1
11,389,389,4,4,0,1,0
31,420,420,27,27,0,1,0
24,421,421,110,60,50,3,2
27,424,424,15,15,0,1,0
19,435,435,12,4,8,3,2
20,471,471,38,38,0,1,0
16,474,474,2,2,0,1,0
10,475,475,94,42,52,3,2
23,488,488,78,10,68,3,2
12,495,495,1,1,0,1,0
25,498,498,80,80,0,1,0

14,111,111,2,2,0,1,0
7,112,112,3,3,0,1,0
29,114,114,30,30,0,1,0
18,127,127,8,1,7,2,1
5,149,149,5,5,0,1,0
38,151,151,9,9,0,1,0
30,157,157,17,5,12,4,3
16,164,164,1,1,0,1,0
6,165,165,7,7,0,1,0
35,165,165,6,6,0,1,0
0,171,171,7,4,3,2,1
12,221,221,7,4,3,2,1
34,225,225,10,10,0,1,0
10,227,227,85,70,15,4,3
33,232,232,3,3,0,1,0
13,235,235,35,35,0,1,0
40,243,243,3,3,0,1,0
4,258,258,50,50,0,1,0
26,268,268,47,10,37,2,1
2,270,270,15,15,0,1,0
1,276,276,25,16,9,2,1
39,298,298,3,3,0,1,0
3,299,299,38,20,18,4,3
28,318,318,16,5,11,2,1
31,322,322,10,1,9,4,3
19,324,324,27,6,21,2,1
15,328,328,47,47,0,1,0
8,340,340,66,30,36,3,2
9,348,348,25,3,22,2,1
24,351,351,14,8,6,2,1
23,354,354,64,32,32,2,1
32,376,376,53,53,0,1,0
21,380,380,14,14,0,1,0
25,388,388,111,85,26,2,1
22,394,394,47,31,16,3,2
37,440,440,81,35,46,2,1
17,466,466,7,7,0,1,0
36,479,479,40,16,24,3,2
20,485,485,14,14,0,1,0
11,487,487,36,17,19,2,1
27,496,496,51,15,36,4,3

25,103,103,7,1,6,2,1
38,116,116,4,4,0,1,0
23,128,128,8,2,6,2,1
9,140,140,2,2,0,1,0
11,161,161,13,13,0,1,0
26,172,172,4,1,3,2,1
28,201,201,29,3,26,2,1
19,221,221,6,6,0,1,0
15,231,231,20,6,14,2,1
3,242,242,5,5,0,1,0
34,246,246,29,29,0,1,0
10,247,247,9,3,6,3,2
37,278,278,12,2,10,3,2
36,291,291,5,5,0,1,0
5,323,323,106,92,14,3,2
27,329,329,4,4,0,1,0
6,331,331,103,17,86,3,2
31,341,341,92,46,46,4,3
33,354,354,114,57,57,4,3
0,362,362,122,122,0,1,0
1,364,364,12,12,0,1,0
18,367,367,9,9,0,1,0
21,368,368,26,3,23,2,1
17,369,369,15,5,10,2,1
8,374,374,6,6,0,1,0
24,379,379,10,6,4,2,1
16,410,410,31,13,18,3,2
35,412,412,35,8,27,4,3
14,416,416,55,31,24,2,1
12,436,436,7,7,0,1,0
22,440,440,64,64,0,1,0
4,468,468,73,67,6,3,2
13,468,468,1,1,0,1,0
29,475,475,63,3,60,4,3
2,478,478,30,16,14,3,2
30,479,479,37,21,16,4,3
32,482,482,125,53,72,4,3
20,492,492,13,13,0,1,0
7,500,500,50,32,18,3,2

8,103,103,1,1,0,1,0
25,104,104,21,21,0,1,0
7,106,106,5,5,0,1,0
30,115,115,16,16,0,1,0
17,120,120,2,2,0,1,0
27,125,125,9,6,3,2,1
23,136,136,15,15,0,1,0
4,147,147,10,10,0,1,0
0,151,151,58,58,0,1,0
1,157,157,28,16,12,4,3
29,164,164,1,1,0,1,0
16,169,169,33,3,30,2,1
13,198,198,33,33,0,1,0
20,227,227,74,59,15,4,3
12,233,233,35,6,29,4,3
22,238,238,7,7,0,1,0
26,264,264,22,2,20,2,1
11,270,270,3,3,0,1,0
21,310,310,20,3,17,2,1
9,319,319,27,5,22,2,1
2,319,319,234,213,21,4,3
19,332,332,37,37,0,1,0
31,353,353,4,1,3,2,1
24,367,367,19,19,0,1,0
18,372,372,16,16,0,1,0
3,381,381,31,19,12,4,3
10,390,390,5,5,0,1,0
14,406,406,30,30,0,1,0
5,437,437,32,32,0,1,0
15,446,446,18,1,17,2,1
6,458,458,31,5,26,3,2
28,472,472,99,22,77,4,3

9,119,119,1,1,0,1,0
20,121,121,4,4,0,1,0
8,144,144,28,4,24,3,2
19,153,153,1,1,0,1,0
4,164,164,80,8,72,4,3
7,178,178,52,52,0,1,0
18,181,181,3,3,0,1,0
28,182,182,3,3,0,1,0
14,208,208,10,10,0,1,0
11,218,218,15,15,0,1,0
32,252,252,10,10,0,1,0
0,253,253,54,39,15,2,1
1,253,253,14,14,0,1,0
6,262,262,26,22,4,2,1
23,272,272,94,72,22,3,2
15,296,296,28,17,11,2,1
29,312,312,1,1,0,1,0
5,322,322,25,18,7,2,1
24,325,325,27,27,0,1,0
17,326,326,78,78,0,1,0
31,329,329,49,11,38,2,1
27,346,346,51,51,0,1,0
21,359,359,23,1,22,3,2
3,362,362,13,7,6,2,1
12,364,364,21,1,20,2,1
26,373,373,4,4,0,1,0
25,384,384,61,14,47,2,1
34,387,387,13,5,8,3,2
22,394,394,5,5,0,1,0
30,406,406,135,35,100,3,2
16,436,436,96,54,42,3,2
33,463,463,9,3,6,3,2
2,485,485,15,15,0,1,0
13,498,498,66,66,0,1,0
10,498,498,3,3,0,1,0

14,113,113,1,1,0,1,0
1,118,118,3,3,0,1,0
24,123,123,5,5,0,1,0
3,134,134,8,3,5,2,1
40,135,135,6,6,0,1,0
18,142,142,8,8,0,1,0
29,143,143,60,17,43,2,1
21,150,150,8,8,0,1,0
9,182,182,68,68,0,1,0
38,184,184,5,5,0,1,0
16,184,184,35,35,0,1,0
22,190,190,8,3,5,2,1
30,194,194,1,1,0,1,0
7,199,199,17,1,16,3,2
6,220,220,29,24,5,2,1
23,251,251,93,21,72,4,3
15,268,268,9,1,8,2,1
17,273,273,36,14,22,3,2
5,281,281,43,43,0,1,0
8,289,289,1,1,0,1,0
26,295,295,38,31,7,2,1
2,312,312,30,30,0,1,0
25,313,313,72,72,0,1,0
34,321,321,35,35,0,1,0
35,332,332,5,5,0,1,0
33,340,340,29,4,25,4,3
31,348,348,17,17,0,1,0
37,357,357,7,7,0,1,0
19,363,363,70,31,39,4,3
0,388,388,1,1,0,1,0
39,401,401,41,41,0,1,0
28,405,405,28,2,26,3,2
13,409,409,50,50,0,1,0
4,413,413,15,4,11,2,1
27,434,434,35,35,0,1,0
11,437,437,1,1,0,1,0
41,453,453,21,3,18,2,1
32,468,468,38,38,0,1,0
12,473,473,10,10,0,1,0
36,485,485,7,7,0,1,0
20,496,496,1,1,0,1,0
10,496,496,40,8,32,3,2

9,113,113,8,8,0,1,0
3,114,114,21,21,0,1,0
10,121,121,5,5,0,1,0
35,125,125,24,17,7,2,1
11,128,128,33,20,13,2,1
4,138,138,1,1,0,1,0
33,140,140,38,22,16,3,2
13,166,166,1,1,0,1,0
8,168,168,6,6,0,1,0
19,176,176,23,23,0,1,0
32,180,180,35,1,34,4,3
0,194,194,34,34,0,1,0
28,201,201,28,28,0,1,0
31,209,209,8,1,7,2,1
16,216,216,45,23,22,2,1
18,226,226,49,49,0,1,0
12,229,229,13,13,0,1,0
20,237,237,21,21,0,1,0
7,256,256,16,16,0,1,0
26,270,270,28,23,5,2,1
21,276,276,33,4,29,2,1
2,291,291,20,1,19,4,3
5,297,297,59,59,0,1,0
34,311,311,9,5,4,2,1
27,313,313,20,9,11,2,1
30,314,314,13,7,6,3,2
36,324,324,11,3,8,3,2
1,384,384,24,15,9,4,3
17,404,404,60,60,0,1,0
29,405,405,16,16,0,1,0
15,408,408,13,13,0,1,0
22,415,415,38,6,32,2,1
25,420,420,32,32,0,1,0
23,437,437,70,70,0,1,0
37,458,458,9,2,7,2,1
6,460,460,25,25,0,1,0
24,495,495,46,24,22,3,2
14,499,499,7,7,0,1,0

25,110,110,10,10,0,1,0
19,129,129,16,12,4,2,1
22,144,144,20,2,18,4,3
16,169,169,21,4,17,4,3
21,176,176,30,27,3,2,1
31,182,182,20,20,0,1,0
7,185,185,9,2,7,2,1
4,194,194,62,28,34,2,1
5,213,213,15,1,14,3,2
18,214,214,14,14,0,1,0
27,223,223,5,5,0,1,0
9,223,223,32,32,0,1,0
38,223,223,5,2,3,2,1
3,238,238,17,17,0,1,0
36,239,239,3,3,0,1,0
35,241,241,5,2,3,2,1
33,250,250,23,23,0,1,0
13,254,254,33,15,18,2,1
32,263,263,1,1,0,1,0
14,264,264,13,3,10,2,1
2,267,267,19,19,0,1,0
6,268,268,2,2,0,1,0
26,273,273,71,55,16,2,1
1,282,282,15,15,0,1,0
24,284,284,42,3,39,4,3
23,313,313,1,1,0,1,0
17,355,355,76,76,0,1,0
12,357,357,2,2,0,1,0
34,366,366,14,14,0,1,0
0,381,381,16,11,5,2,1
37,404,404,35,17,18,2,1
30,405,405,3,3,0,1,0
29,414,414,28,14,14,3,2
20,415,415,23,23,0,1,0
28,420,420,244,204,40,3,2
11,431,431,22,22,0,1,0
8,432,432,6,2,4,2,1
15,433,433,16,4,12,3,2
39,457,457,28,28,0,1,0
10,498,498,102,70,32,2,1

2,100,100,1,1,0,1,0
18,104,104,1,1,0,1,0
9,116,116,6,3,3,2,1
15,132,132,13,1,12,4,3
17,173,173,16,2,14,3,2
38,175,175,23,15,8,3,2
44,217,217,17,3,14,3,2
5,223,223,9,9,0,1,0
10,234,234,5,2,3,2,1
11,238,238,1,1,0,1,0
31,244,244,59,5,54,3,2
23,251,251,50,50,0,1,0
29,255,255,25,6,19,2,1
32,257,257,7,2,5,2,1
41,258,258,31,31,0,1,0
25,273,273,3,3,0,1,0
34,293,293,35,2,33,2,1
42,302,302,19,12,7,2,1
33,312,312,12,12,0,1,0
28,317,317,11,11,0,1,0
22,317,317,4,1,3,2,1
45,331,331,33,21,12,4,3
39,336,336,12,12,0,1,0
19,343,343,37,7,30,3,2
27,346,346,32,12,20,3,2
46,358,358,11,11,0,1,0
30,366,366,120,91,29,3,2
43,369,369,34,5,29,2,1
36,369,369,29,29,0,1,0
40,391,391,59,39,20,3,2
12,396,396,18,2,16,3,2
7,414,414,14,14,0,1,0
16,421,421,112,49,63,4,3
13,436,436,49,44,5,2,1
20,443,443,55,55,0,1,0
3,446,446,60,34,26,2,1
0,448,448,14,4,10,3,2
21,455,455,11,11,0,1,0
26,459,459,78,8,70,3,2
1,460,460,26,8,18,4,3
14,463,463,16,8,8,2,1
6,463,463,16,10,6,2,1
24,464,464,14,14,0,1,0
4,469,469,20,20,0,1,0
8,469,469,5,5,0,1,0
37,486,486,1,1,0,1,0
35,489,489,80,18,62,3,2

1,104,104,9,3,6,2,1
8,135,135,4,4,0,1,0
21,140,140,8,8,0,1,0
3,143,143,5,5,0,1,0
17,173,173,5,1,4,2,1
29,174,174,2,2,0,1,0
12,179,179,23,15,8,3,2
19,185,185,12,1,11,2,1
23,212,212,3,3,0,1,0
33,213,213,17,17,0,1,0
15,222,222,2,2,0,1,0
18,222,222,20,4,16,3,2
24,248,248,8,8,0,1,0
11,269,269,43,6,37,4,3
34,270,270,16,9,7,2,1
14,272,272,18,18,0,1,0
9,294,294,18,18,0,1,0
28,298,298,107,97,10,3,2
36,306,306,6,2,4,2,1
27,315,315,9,9,0,1,0
6,317,317,121,35,86,3,2
13,321,321,23,8,15,4,3
32,323,323,18,18,0,1,0
2,330,330,10,10,0,1,0
22,340,340,96,88,8,2,1
31,372,372,10,4,6,3,2
0,375,375,20,20,0,1,0
20,381,381,64,26,38,3,2
30,385,385,27,27,0,1,0
7,419,419,68,68,0,1,0
5,430,430,13,5,8,3,2
4,435,435,54,6,48,2,1
25,443,443,118,90,28,3,2
37,448,448,80,80,0,1,0
16,461,461,2,2,0,1,0
26,465,465,48,28,20,3,2
10,469,469,163,163,0,1,0
35,494,494,28,8,20,3,2

5,110,110,3,3,0,1,0
17,114,114,6,6,0,1,0
38,122,122,3,3,0,1,0
4,140,140,5,1,4,2,1
0,141,141,1,1,0,1,0
24,164,164,34,22,12,4,3
25,170,170,4,4,0,1,0
30,171,171,21,6,15,2,1
37,184,184,1,1,0,1,0
2,185,185,32,32,0,1,0
36,191,191,36,36,0,1,0
19,197,197,34,34,0,1,0
9,209,209,22,22,0,1,0
39,216,216,6,3,3,2,1
13,221,221,39,39,0,1,0
15,232,232,34,22,12,2,1
10,242,242,27,9,18,2,1
6,262,262,1,1,0,1,0
23,265,265,13,13,0,1,0
35,268,268,12,12,0,1,0
21,275,275,73,54,19,2,1
8,285,285,116,44,72,4,3
29,298,298,1,1,0,1,0
22,304,304,64,33,31,2,1
26,316,316,7,7,0,1,0
28,330,330,9,9,0,1,0
20,332,332,7,3,4,2,1
32,345,345,66,66,0,1,0
34,352,352,7,7,0,1,0
12,394,394,56,56,0,1,0
27,395,395,110,110,0,1,0
11,408,408,1,1,0,1,0
3,409,409,1,1,0,1,0
33,416,416,14,3,11,2,1
16,418,418,14,14,0,1,0
1,432,432,33,17,16,4,3
18,454,454,85,41,44,3,2
31,455,455,87,61,26,2,1
14,492,492,7,7,0,1,0
7,496,496,1,1,0,1,0

27,102,102,18,18,0,1,0
13,112,112,16,16,0,1,0
12,123,123,13,9,4,2,1
16,126,126,10,7,3,2,1
0,127,127,21,6,15,2,1
43,135,135,11,11,0,1,0
25,140,140,2,2,0,1,0
6,149,149,16,1,15,2,1
22,157,157,8,8,0,1,0
8,162,162,1,1,0,1,0
23,171,171,10,1,9,2,1
19,175,175,6,6,0,1,0
40,177,177,6,6,0,1,0
28,212,212,41,17,24,2,1
42,213,213,36,13,23,2,1
11,217,217,38,38,0,1,0
36,220,220,6,6,0,1,0
20,222,222,2,2,0,1,0
34,239,239,34,6,28,2,1
31,247,247,10,10,0,1,0
37,261,261,41,6,35,4,3
1,294,294,10,10,0,1,0
15,316,316,1,1,0,1,0
7,321,321,42,42,0,1,0
38,321,321,4,4,0,1,0
30,339,339,51,51,0,1,0
24,342,342,3,3,0,1,0
9,347,347,19,19,0,1,0
35,365,365,36,36,0,1,0
33,381,381,49,7,42,3,2
26,399,399,82,38,44,3,2
2,401,401,52,52,0,1,0
3,413,413,10,10,0,1,0
5,414,414,3,3,0,1,0
39,419,419,2,2,0,1,0
14,435,435,13,8,5,2,1
41,442,442,2,2,0,1,0
21,445,445,86,18,68,3,2
4,453,453,18,13,5,2,1
18,467,467,90,90,0,1,0
29,468,468,125,13,112,4,3
10,472,472,3,3,0,1,0
17,493,493,55,55,0,1,0
32,495,495,13,2,11,4,3

4,112,112,2,2,0,1,0
14,124,124,9,9,0,1,0
27,129,129,1,1,0,1,0
11,134,134,3,3,0,1,0
36,141,141,10,1,9,4,3
20,147,147,10,10,0,1,0
6,191,191,31,31,0,1,0
1,219,219,64,64,0,1,0
39,224,224,18,18,0,1,0
12,233,233,39,39,0,1,0
16,234,234,10,2,8,2,1
5,240,240,45,45,0,1,0
17,255,255,1,1,0,1,0
2,263,263,38,38,0,1,0
41,271,271,77,34,43,4,3
28,271,271,42,42,0,1,0
19,276,276,1,1,0,1,0
26,277,277,28,5,23,2,1
0,294,294,26,21,5,2,1
31,295,295,8,4,4,2,1
34,299,299,14,14,0,1,0
18,303,303,3,3,0,1,0
15,325,325,2,2,0,1,0
25,326,326,9,1,8,3,2
33,329,329,11,11,0,1,0
8,333,333,10,2,8,3,2
32,354,354,109,1,108,4,3
7,359,359,42,9,33,4,3
13,377,377,2,2,0,1,0
9,379,379,2,2,0,1,0
3,381,381,31,22,9,2,1
24,384,384,17,17,0,1,0
37,393,393,41,41,0,1,0
22,417,417,20,20,0,1,0
29,434,434,6,6,0,1,0
21,435,435,39,39,0,1,0
38,446,446,85,85,0,1,0
40,457,457,9,5,4,2,1
23,458,458,165,85,80,3,2
30,477,477,17,8,9,4,3
10,495,495,116,16,100,3,2
35,497,497,10,10,0,1,0

19,111,111,4,4,0,1,0
25,111,111,3,3,0,1,0
26,118,118,5,2,3,2,1
31,135,135,2,2,0,1,0
2,151,151,16,1,15,4,3
7,176,176,9,6,3,2,1
8,181,181,47,36,11,2,1
16,187,187,4,4,0,1,0
33,191,191,21,21,0,1,0
17,193,193,2,2,0,1,0
29,205,205,13,13,0,1,0
23,214,214,71,71,0,1,0
6,216,216,1,1,0,1,0
24,219,219,28,28,0,1,0
12,240,240,12,2,10,3,2
11,250,250,3,3,0,1,0
4,271,271,9,3,6,3,2
18,271,271,32,32,0,1,0
20,272,272,9,9,0,1,0
22,282,282,100,70,30,2,1
1,284,284,5,5,0,1,0
27,293,293,5,1,4,2,1
13,294,294,2,2,0,1,0
21,308,308,90,32,58,3,2
9,319,319,43,43,0,1,0
0,328,328,65,45,20,2,1
14,342,342,14,2,12,4,3
34,409,409,6,6,0,1,0
3,419,419,11,11,0,1,0
30,425,425,25,25,0,1,0
15,449,449,101,95,6,2,1
10,449,449,19,19,0,1,0
32,462,462,13,4,9,4,3
28,493,493,121,121,0,1,0
5,496,496,344,314,30,4,3

6,120,120,25,7,18,2,1
31,124,124,5,5,0,1,0
19,163,163,14,14,0,1,0
12,192,192,10,10,0,1,0
9,194,194,67,3,64,3,2
7,195,195,10,10,0,1,0
26,204,204,5,5,0,1,0
22,206,206,9,6,3,2,1
30,209,209,47,47,0,1,0
27,227,227,4,4,0,1,0
18,246,246,10,3,7,2,1
29,248,248,55,47,8,3,2
24,284,284,26,2,24,3,2
5,294,294,72,72,0,1,0
1,303,303,32,32,0,1,0
10,312,312,98,98,0,1,0
14,335,335,19,11,8,2,1
4,344,344,50,2,48,3,2
16,361,361,5,5,0,1,0
3,367,367,10,10,0,1,0
23,383,383,233,226,7,2,1
28,383,383,10,10,0,1,0
0,402,402,24,24,0,1,0
17,413,413,13,13,0,1,0
13,420,420,24,24,0,1,0
25,444,444,109,59,50,4,3
15,456,456,9,1,8,2,1
8,457,457,22,15,7,2,1
2,459,459,44,44,0,1,0
11,467,467,68,33,35,3,2
20,477,477,18,9,9,4,3
21,481,481,26,8,18,3,2
32,497,497,27,13,14,2,1

25,113,113,3,3,0,1,0
11,115,115,28,28,0,1,0
15,115,115,7,7,0,1,0
22,116,116,1,1,0,1,0
27,125,125,5,5,0,1,0
29,143,143,3,3,0,1,0
24,147,147,42,28,14,2,1
16,159,159,37,37,0,1,0
13,164,164,53,16,37,2,1
5,212,212,3,3,0,1,0
4,243,243,9,9,0,1,0
23,251,251,28,9,19,2,1
7,274,274,26,12,14,3,2
17,279,279,26,26,0,1,0
19,289,289,35,35,0,1,0
28,293,293,27,27,0,1,0
1,320,320,77,77,0,1,0
14,327,327,11,11,0,1,0
3,327,327,67,67,0,1,0
31,345,345,45,9,36,3,2
6,347,347,17,5,12,4,3
8,349,349,78,78,0,1,0
30,361,361,25,5,20,2,1
0,387,387,139,106,33,4,3
2,399,399,9,9,0,1,0
10,448,448,107,70,37,2,1
26,452,452,46,39,7,2,1
9,453,453,18,2,16,3,2
12,475,475,63,63,0,1,0
18,493,493,21,14,7,2,1
21,494,494,38,4,34,2,1
20,495,495,37,18,19,2,1

12,102,102,13,8,5,2,1
34,103,103,9,6,3,2,1
41,126,126,5,5,0,1,0
14,138,138,7,7,0,1,0
2,141,141,3,3,0,1,0
23,147,147,4,4,0,1,0
30,151,151,39,3,36,3,2
31,164,164,26,26,0,1,0
37,167,167,32,2,30,4,3
29,168,168,9,9,0,1,0
28,171,171,23,4,19,2,1
10,183,183,6,6,0,1,0
0,192,192,2,2,0,1,0
5,199,199,1,1,0,1,0
9,214,214,75,75,0,1,0
22,225,225,40,2,38,4,3
15,233,233,45,26,19,2,1
39,253,253,8,8,0,1,0
33,258,258,25,18,7,2,1
36,293,293,46,46,0,1,0
8,300,300,43,13,30,4,3
21,307,307,2,2,0,1,0
19,323,323,25,25,0,1,0
26,330,330,21,11,10,3,2
13,335,335,19,7,12,4,3
6,351,351,2,2,0,1,0
42,358,358,1,1,0,1,0
38,372,372,36,6,30,2,1
40,373,373,60,9,51,4,3
18,380,380,32,10,22,2,1
24,385,385,2,2,0,1,0
4,400,400,6,6,0,1,0
35,417,417,44,44,0,1,0
1,424,424,63,23,40,3,2
20,432,432,26,26,0,1,0
25,451,451,7,2,5,2,1
27,457,457,79,7,72,3,2
17,470,470,52,52,0,1,0
32,472,472,48,27,21,2,1
11,479,479,18,18,0,1,0
7,484,484,33,33,0,1,0
16,484,484,41,21,20,2,1
3,490,490,3,3,0,1,0

11,103,103,5,5,0,1,0
13,135,135,15,15,0,1,0
17,136,136,3,3,0,1,0
9,136,136,4,4,0,1,0
31,160,160,22,22,0,1,0
10,182,182,20,5,15,3,2
29,201,201,51,51,0,1,0
24,207,207,2,2,0,1,0
20,234,234,68,68,0,1,0
12,237,237,18,5,13,2,1
18,239,239,74,8,66,3,2
3,239,239,30,30,0,1,0
6,248,248,13,5,8,2,1
14,254,254,3,3,0,1,0
27,256,256,4,4,0,1,0
22,256,256,31,31,0,1,0
15,266,266,60,60,0,1,0
1,283,283,7,1,6,2,1
19,287,287,13,10,3,2,1
7,305,305,43,16,27,4,3
8,306,306,58,6,52,4,3
0,321,321,6,6,0,1,0
30,325,325,10,2,8,2,1
34,346,346,16,12,4,2,1
2,349,349,56,30,26,2,1
32,358,358,17,13,4,2,1
28,364,364,12,3,9,4,3
16,368,368,94,94,0,1,0
35,369,369,56,21,35,2,1
21,386,386,4,4,0,1,0
26,408,408,36,36,0,1,0
33,410,410,80,20,60,3,2
25,417,417,36,36,0,1,0
4,421,421,32,23,9,4,3
23,433,433,20,20,0,1,0
5,442,442,108,108,0,1,0

10,103,103,1,1,0,1,0
0,123,123,30,30,0,1,0
43,135,135,5,5,0,1,0
8,157,157,1,1,0,1,0
5,161,161,3,3,0,1,0
20,178,178,3,3,0,1,0
30,183,183,25,19,6,3,2
42,200,200,19,19,0,1,0
39,202,202,28,28,0,1,0
14,216,216,33,33,0,1,0
38,218,218,28,28,0,1,0
1,220,220,25,25,0,1,0
36,223,223,8,8,0,1,0
17,227,227,10,2,8,3,2
16,243,243,10,10,0,1,0
4,249,249,22,12,10,2,1
34,254,254,29,11,18,4,3
12,256,256,19,19,0,1,0
2,264,264,1,1,0,1,0
19,270,270,23,3,20,3,2
18,294,294,15,15,0,1,0
21,338,338,1,1,0,1,0
41,339,339,21,4,17,3,2
28,340,340,17,1,16,3,2
9,342,342,29,2,27,2,1
24,354,354,15,2,13,2,1
7,355,355,27,12,15,2,1
25,358,358,14,2,12,3,2
15,361,361,34,34,0,1,0
40,361,361,6,6,0,1,0
35,369,369,21,21,0,1,0
11,381,381,70,34,36,2,1
26,384,384,52,5,47,2,1
31,406,406,41,12,29,2,1
22,411,411,31,31,0,1,0
23,428,428,136,28,108,4,3
13,429,429,1,1,0,1,0
33,432,432,7,7,0,1,0
37,457,457,44,44,0,1,0
27,457,457,87,87,0,1,0
6,467,467,26,26,0,1,0
29,485,485,52,14,38,3,2
32,491,491,183,183,0,1,0
3,494,494,8,2,6,2,1

32,120,120,12,12,0,1,0
2,125,125,6,1,5,2,1
15,136,136,15,15,0,1,0
11,155,155,16,13,3,2,1
20,190,190,30,30,0,1,0
6,199,199,3,3,0,1,0
26,203,203,6,6,0,1,0
18,207,207,84,84,0,1,0
23,220,220,9,3,6,3,2
36,258,258,4,4,0,1,0
13,262,262,64,41,23,2,1
4,271,271,14,14,0,1,0
5,282,282,8,8,0,1,0
30,283,283,6,6,0,1,0
12,284,284,22,22,0,1,0
17,295,295,17,17,0,1,0
16,317,317,36,36,0,1,0
31,337,337,10,5,5,2,1
1,357,357,106,69,37,2,1
3,364,364,21,1,20,4,3
22,383,383,49,29,20,2,1
14,384,384,34,1,33,2,1
8,384,384,28,6,22,3,2
19,401,401,13,13,0,1,0
34,408,408,27,27,0,1,0
10,409,409,86,20,66,3,2
0,414,414,7,2,5,2,1
24,417,417,3,3,0,1,0
7,422,422,110,106,4,2,1
25,433,433,125,125,0,1,0
33,438,438,93,72,21,4,3
27,439,439,37,7,30,2,1
35,450,450,11,5,6,3,2
28,455,455,51,10,41,2,1
21,459,459,8,8,0,1,0
29,463,463,70,29,41,4,3
9,473,473,23,3,20,2,1

16,105,105,8,8,0,1,0
0,108,108,20,5,15,4,3
21,119,119,15,15,0,1,0
13,125,125,64,28,36,4,3
24,127,127,2,2,0,1,0
2,133,133,1,1,0,1,0
12,179,179,12,12,0,1,0
23,185,185,7,7,0,1,0
32,189,189,26,14,12,3,2
31,206,206,1,1,0,1,0
15,219,219,48,44,4,2,1
19,227,227,4,4,0,1,0
29,229,229,2,2,0,1,0
4,231,231,17,14,3,2,1
1,243,243,45,32,13,2,1
18,247,247,1,1,0,1,0
5,248,248,5,5,0,1,0
28,268,268,1,1,0,1,0
30,279,279,13,13,0,1,0
25,289,289,129,129,0,1,0
20,299,299,9,9,0,1,0
3,315,315,18,18,0,1,0
10,315,315,63,63,0,1,0
22,337,337,36,36,0,1,0
11,342,342,3,3,0,1,0
26,369,369,27,15,12,3,2
6,371,371,114,114,0,1,0
9,384,384,55,55,0,1,0
17,388,388,151,113,38,2,1
8,394,394,4,1,3,2,1
7,399,399,51,18,33,2,1
14,455,455,60,60,0,1,0
27,462,462,31,5,26,3,2

23,108,108,2,2,0,1,0
1,115,115,4,4,0,1,0
17,130,130,7,4,3,2,1
21,148,148,7,7,0,1,0
16,165,165,45,17,28,2,1
9,169,169,13,1,12,4,3
43,179,179,18,18,0,1,0
13,182,182,5,1,4,2,1
15,191,191,9,2,7,2,1
4,191,191,7,7,0,1,0
35,191,191,11,11,0,1,0
6,202,202,8,8,0,1,0
39,203,203,24,10,14,3,2
42,221,221,15,15,0,1,0
0,228,228,9,9,0,1,0
41,239,239,13,10,3,2,1
20,243,243,1,1,0,1,0
27,248,248,13,13,0,1,0
8,249,249,52,52,0,1,0
30,254,254,27,1,26,3,2
32,270,270,7,2,5,2,1
14,272,272,1,1,0,1,0
7,287,287,27,3,24,3,2
11,290,290,8,2,6,2,1
3,309,309,43,32,11,2,1
40,309,309,38,38,0,1,0
5,321,321,18,3,15,3,2
31,324,324,29,12,17,2,1
22,329,329,11,7,4,2,1
10,354,354,50,35,15,4,3
29,367,367,111,37,74,4,3
33,380,380,19,10,9,4,3
38,389,389,175,83,92,3,2
24,398,398,33,3,30,2,1
28,399,399,21,14,7,2,1
34,406,406,39,31,8,3,2
19,407,407,9,4,5,2,1
36,409,409,18,18,0,1,0
12,417,417,9,9,0,1,0
37,434,434,33,33,0,1,0
18,462,462,4,4,0,1,0
25,471,471,88,74,14,3,2
26,478,478,26,4,22,2,1
2,488,488,86,86,0,1,0
44,489,489,7,1,6,3,2

21,100,100,6,1,5,2,1
3,115,115,24,24,0,1,0
23,124,124,34,34,0,1,0
36,132,132,11,11,0,1,0
20,146,146,30,9,21,4,3
10,167,167,7,1,6,3,2
12,175,175,6,2,4,2,1
13,177,177,9,9,0,1,0
16,187,187,4,4,0,1,0
4,197,197,9,9,0,1,0
32,200,200,6,6,0,1,0
1,210,210,1,1,0,1,0
5,210,210,4,4,0,1,0
17,228,228,51,51,0,1,0
15,244,244,19,19,0,1,0
11,249,249,14,10,4,2,1
34,270,270,93,93,0,1,0
31,279,279,10,3,7,2,1
6,281,281,32,20,12,3,2
27,289,289,10,10,0,1,0
35,300,300,74,10,64,4,3
18,303,303,3,3,0,1,0
9,316,316,136,123,13,2,1
26,330,330,3,3,0,1,0
7,332,332,64,7,57,4,3
8,362,362,8,3,5,2,1
25,366,366,31,6,25,2,1
2,386,386,19,3,16,3,2
37,399,399,14,7,7,2,1
22,415,415,28,28,0,1,0
30,420,420,70,14,56,3,2
19,429,429,6,6,0,1,0
14,458,458,32,32,0,1,0
28,470,470,62,44,18,2,1
0,470,470,107,107,0,1,0
24,481,481,5,5,0,1,0
33,491,491,27,27,0,1,0
29,495,495,22,22,0,1,0

31,116,116,5,5,0,1,0
18,120,120,17,1,16,2,1
5,129,129,11,11,0,1,0
12,130,130,18,6,12,3,2
20,146,146,16,16,0,1,0
1,151,151,45,5,40,2,1
22,182,182,21,21,0,1,0
21,185,185,48,22,26,2,1
14,193,193,41,24,17,2,1
27,197,197,6,6,0,1,0
25,232,232,109,109,0,1,0
15,254,254,14,14,0,1,0
29,257,257,14,14,0,1,0
23,273,273,7,7,0,1,0
10,291,291,37,37,0,1,0
11,334,334,8,8,0,1,0
19,341,341,34,34,0,1,0
26,352,352,24,24,0,1,0
9,362,362,64,64,0,1,0
32,364,364,29,29,0,1,0
6,384,384,6,6,0,1,0
2,386,386,14,5,9,4,3
8,391,391,17,17,0,1,0
28,396,396,12,2,10,2,1
17,426,426,60,26,34,2,1
30,443,443,15,15,0,1,0
0,444,444,67,1,66,4,3
4,456,456,64,20,44,2,1
3,463,463,1,1,0,1,0
16,465,465,26,3,23,2,1
33,471,471,49,49,0,1,0
13,472,472,90,16,74,3,2
24,474,474,12,4,8,3,2
7,477,477,125,72,53,4,3

11,111,111,1,1,0,1,0
30,119,119,2,2,0,1,0
26,134,134,20,12,8,3,2
19,137,137,4,4,0,1,0
23,138,138,11,5,6,2,1
13,150,150,99,54,45,4,3
7,152,152,1,1,0,1,0
29,165,165,19,19,0,1,0
14,172,172,7,1,6,2,1
27,177,177,4,4,0,1,0
10,179,179,46,8,38,3,2
8,223,223,50,21,29,2,1
35,242,242,10,10,0,1,0
5,243,243,5,1,4,2,1
15,250,250,28,19,9,4,3
2,258,258,42,24,18,4,3
31,273,273,2,2,0,1,0
33,282,282,2,2,0,1,0
18,309,309,58,24,34,2,1
20,317,317,23,11,12,2,1
25,327,327,19,5,14,4,3
16,338,338,32,14,18,4,3
34,363,363,11,1,10,2,1
28,380,380,76,45,31,3,2
3,382,382,1,1,0,1,0
1,384,384,18,18,0,1,0
6,412,412,8,8,0,1,0
24,412,412,56,17,39,2,1
0,441,441,70,24,46,3,2
4,442,442,10,10,0,1,0
21,455,455,23,20,3,2,1
32,460,460,27,13,14,3,2
17,471,471,78,51,27,4,3
22,482,482,248,242,6,2,1
12,484,484,20,2,18,2,1
9,493,493,11,11,0,1,0

14,108,108,7,1,6,2,1
2,116,116,42,35,7,2,1
29,129,129,5,1,4,2,1
33,134,134,1,1,0,1,0
9,147,147,11,11,0,1,0
16,149,149,9,5,4,2,1
17,161,161,3,3,0,1,0
5,171,171,9,9,0,1,0
31,174,174,20,10,10,3,2
24,177,177,14,14,0,1,0
19,198,198,25,25,0,1,0
27,208,208,30,21,9,4,3
8,226,226,11,11,0,1,0
32,244,244,18,6,12,2,1
18,259,259,71,71,0,1,0
3,298,298,4,1,3,2,1
12,300,300,15,3,12,3,2
6,314,314,15,12,3,2,1
22,322,322,24,14,10,3,2
15,325,325,4,4,0,1,0
7,348,348,124,124,0,1,0
21,356,356,143,65,78,4,3
34,357,357,23,23,0,1,0
28,371,371,11,11,0,1,0
20,396,396,21,1,20,2,1
1,401,401,45,45,0,1,0
26,414,414,31,10,21,4,3
13,443,443,61,25,36,3,2
30,451,451,35,20,15,2,1
11,467,467,3,3,0,1,0
10,470,470,207,207,0,1,0
0,488,488,56,19,37,2,1
4,490,490,3,3,0,1,0
23,491,491,56,23,33,2,1
25,497,497,53,43,10,2,1

31,113,113,11,11,0,1,0
23,122,122,6,1,5,2,1
32,128,128,21,21,0,1,0
27,132,132,35,35,0,1,0
34,136,136,3,3,0,1,0
29,143,143,9,9,0,1,0
11,143,143,5,5,0,1,0
9,157,157,40,28,12,4,3
0,162,162,18,18,0,1,0
21,168,168,6,6,0,1,0
22,176,176,17,1,16,3,2
2,185,185,10,10,0,1,0
15,200,200,26,8,18,4,3
14,214,214,24,24,0,1,0
6,217,217,31,31,0,1,0
12,221,221,17,17,0,1,0
28,236,236,14,1,13,2,1
35,292,292,35,35,0,1,0
24,294,294,70,36,34,4,3
18,303,303,4,4,0,1,0
38,311,311,1,1,0,1,0
17,318,318,2,2,0,1,0
39,326,326,11,5,6,3,2
40,340,340,45,45,0,1,0
26,342,342,65,65,0,1,0
37,351,351,77,36,41,2,1
30,360,360,28,11,17,2,1
8,375,375,54,54,0,1,0
20,379,379,11,11,0,1,0
36,380,380,4,1,3,2,1
13,388,388,6,6,0,1,0
1,405,405,24,24,0,1,0
5,407,407,15,10,5,2,1
3,412,412,114,28,86,3,2
7,413,413,81,15,66,4,3
33,420,420,34,1,33,4,3
25,436,436,10,2,8,2,1
19,452,452,13,13,0,1,0
10,476,476,19,1,18,3,2
16,479,479,13,7,6,2,1
4,488,488,37,25,12,4,3

39,110,110,2,2,0,1,0
35,111,111,3,3,0,1,0
25,112,112,15,15,0,1,0
6,114,114,17,3,14,3,2
32,127,127,24,24,0,1,0
9,139,139,3,3,0,1,0
18,142,142,4,4,0,1,0
26,157,157,36,36,0,1,0
21,159,159,28,6,22,2,1
16,165,165,1,1,0,1,0
5,168,168,3,3,0,1,0
10,171,171,15,15,0,1,0
30,186,186,18,18,0,1,0
19,211,211,4,4,0,1,0
7,216,216,19,19,0,1,0
40,229,229,9,5,4,2,1
20,230,230,22,22,0,1,0
15,231,231,19,7,12,2,1
36,235,235,40,8,32,3,2
14,250,250,5,5,0,1,0
13,252,252,24,14,10,3,2
31,259,259,9,9,0,1,0
12,263,263,36,14,22,2,1
38,282,282,39,39,0,1,0
0,291,291,36,36,0,1,0
41,302,302,23,1,22,3,2
28,310,310,22,22,0,1,0
33,316,316,14,14,0,1,0
2,319,319,75,75,0,1,0
8,325,325,14,4,10,3,2
24,355,355,16,16,0,1,0
17,365,365,92,92,0,1,0
37,375,375,36,36,0,1,0
29,379,379,121,121,0,1,0
34,424,424,38,38,0,1,0
4,429,429,4,4,0,1,0
42,437,437,40,9,31,2,1
3,443,443,8,8,0,1,0
23,454,454,53,41,12,4,3
22,464,464,25,25,0,1,0
27,466,466,19,13,6,3,2
11,488,488,1,1,0,1,0
1,497,497,12,7,5,2,1

6,114,114,14,2,12,4,3
1,117,117,22,22,0,1,0
5,122,122,9,9,0,1,0
28,133,133,1,1,0,1,0
36,170,170,8,8,0,1,0
16,180,180,1,1,0,1,0
24,183,183,2,2,0,1,0
22,184,184,23,8,15,2,1
39,211,211,15,9,6,2,1
15,212,212,1,1,0,1,0
12,214,214,65,65,0,1,0
37,233,233,42,42,0,1,0
21,248,248,19,1,18,2,1
29,257,257,16,16,0,1,0
33,266,266,79,79,0,1,0
23,281,281,16,16,0,1,0
38,286,286,51,12,39,4,3
2,299,299,1,1,0,1,0
11,311,311,8,8,0,1,0
26,315,315,18,8,10,2,1
10,316,316,64,12,52,3,2
14,326,326,17,17,0,1,0
31,329,329,60,6,54,3,2
20,336,336,6,3,3,2,1
8,340,340,78,78,0,1,0
35,348,348,121,121,0,1,0
27,349,349,55,7,48,4,3
17,365,365,87,87,0,1,0
41,384,384,1,1,0,1,0
13,392,392,14,7,7,2,1
4,394,394,6,6,0,1,0
3,398,398,7,7,0,1,0
30,401,401,7,7,0,1,0
19,402,402,1,1,0,1,0
9,426,426,1,1,0,1,0
32,429,429,25,25,0,1,0
18,443,443,21,5,16,2,1
25,457,457,14,14,0,1,0
34,467,467,62,62,0,1,0
40,471,471,15,15,0,1,0
7,472,472,38,17,21,4,3
0,478,478,14,2,12,3,2

8,111,111,1,1,0,1,0
6,118,118,41,41,0,1,0
37,128,128,35,23,12,3,2
23,134,134,7,2,5,2,1
28,177,177,29,19,10,2,1
13,187,187,31,31,0,1,0
19,189,189,5,5,0,1,0
34,193,193,29,17,12,2,1
21,197,197,3,3,0,1,0
35,214,214,55,55,0,1,0
27,216,216,11,2,9,4,3
24,227,227,3,3,0,1,0
3,229,229,21,6,15,4,3
14,239,239,4,4,0,1,0
17,259,259,24,2,22,3,2
22,262,262,10,2,8,3,2
7,263,263,2,2,0,1,0
11,277,277,21,12,9,2,1
36,307,307,107,80,27,4,3
33,321,321,46,46,0,1,0
31,342,342,30,30,0,1,0
16,347,347,34,34,0,1,0
15,353,353,1,1,0,1,0
18,354,354,106,106,0,1,0
1,372,372,3,3,0,1,0
2,390,390,139,75,64,4,3
5,394,394,62,62,0,1,0
20,394,394,14,14,0,1,0
10,419,419,31,27,4,2,1
0,420,420,7,7,0,1,0
12,422,422,14,14,0,1,0
9,430,430,14,14,0,1,0
26,446,446,6,6,0,1,0
4,455,455,8,8,0,1,0
32,467,467,23,14,9,4,3
25,472,472,31,31,0,1,0
30,489,489,46,46,0,1,0
29,493,493,31,31,0,1,0

20,107,107,24,24,0,1,0
11,113,113,3,3,0,1,0
5,128,128,15,9,6,2,1
9,136,136,21,12,9,4,3
18,137,137,4,4,0,1,0
28,150,150,39,5,34,3,2
37,163,163,5,5,0,1,0
30,165,165,17,17,0,1,0
14,169,169,12,6,6,3,2
21,191,191,10,10,0,1,0
19,205,205,33,33,0,1,0
2,211,211,3,3,0,1,0
38,222,222,8,8,0,1,0
36,241,241,17,17,0,1,0
40,244,244,46,46,0,1,0
41,256,256,32,29,3,2,1
6,260,260,6,6,0,1,0
22,274,274,8,4,4,2,1
26,286,286,25,11,14,2,1
12,290,290,14,6,8,3,2
29,293,293,25,19,6,3,2
1,294,294,6,6,0,1,0
16,311,311,27,27,0,1,0
13,331,331,15,15,0,1,0
33,333,333,87,77,10,2,1
34,342,342,44,26,18,3,2
31,351,351,34,2,32,3,2
24,354,354,19,1,18,3,2
7,356,356,38,38,0,1,0
23,374,374,10,10,0,1,0
27,378,378,56,2,54,3,2
25,386,386,9,6,3,2,1
35,399,399,34,24,10,2,1
8,403,403,97,97,0,1,0
10,429,429,58,18,40,3,2
32,429,429,26,19,7,2,1
0,430,430,37,37,0,1,0
17,458,458,42,42,0,1,0
3,459,459,4,4,0,1,0
39,467,467,29,2,27,4,3
4,483,483,61,17,44,2,1
15,495,495,1,1,0,1,0

31,105,105,6,3,3,2,1
0,126,126,4,4,0,1,0
26,134,134,18,18,0,1,0
33,140,140,19,19,0,1,0
16,147,147,5,5,0,1,0
13,194,194,6,6,0,1,0
1,214,214,23,17,6,3,2
8,223,223,15,15,0,1,0
25,242,242,29,20,9,4,3
32,246,246,34,1,33,2,1
20,250,250,47,13,34,4,3
41,259,259,35,3,32,3,2
11,259,259,41,41,0,1,0
17,259,259,24,15,9,2,1
6,267,267,9,9,0,1,0
2,267,267,53,53,0,1,0
27,270,270,51,23,28,3,2
5,275,275,12,12,0,1,0
7,290,290,20,20,0,1,0
23,292,292,86,86,0,1,0
12,292,292,32,32,0,1,0
36,299,299,28,28,0,1,0
30,309,309,21,21,0,1,0
19,311,311,27,27,0,1,0
21,323,323,11,11,0,1,0
38,330,330,39,10,29,3,2
35,330,330,36,36,0,1,0
24,339,339,8,2,6,2,1
9,346,346,17,11,6,3,2
18,351,351,35,5,30,3,2
22,364,364,11,11,0,1,0
34,371,371,19,16,3,2,1
42,376,376,38,32,6,3,2
40,377,377,50,50,0,1,0
28,420,420,6,6,0,1,0
15,429,429,24,24,0,1,0
29,442,442,12,9,3,2,1
14,464,464,31,31,0,1,0
3,475,475,4,1,3,2,1
39,478,478,128,128,0,1,0
37,488,488,8,4,4,2,1
4,498,498,3,3,0,1,0
10,498,498,3,3,0,1,0

18,108,108,29,6,23,2,1
22,115,115,24,13,11,2,1
9,120,120,4,4,0,1,0
7,124,124,3,3,0,1,0
24,127,127,13,13,0,1,0
14,148,148,15,7,8,3,2
19,165,165,27,27,0,1,0
31,183,183,26,10,16,3,2
10,221,221,15,11,4,2,1
23,227,227,55,33,22,2,1
32,229,229,11,11,0,1,0
21,237,237,13,7,6,2,1
16,238,238,16,16,0,1,0
20,262,262,12,12,0,1,0
28,276,276,11,11,0,1,0
30,291,291,15,6,9,2,1
26,303,303,4,4,0,1,0
4,320,320,7,4,3,2,1
11,325,325,98,62,36,4,3
5,331,331,37,15,22,2,1
2,338,338,107,64,43,2,1
6,354,354,46,46,0,1,0
13,373,373,4,1,3,2,1
17,378,378,19,19,0,1,0
27,385,385,15,7,8,3,2
0,397,397,97,35,62,3,2
15,408,408,22,22,0,1,0
1,463,463,39,17,22,3,2
12,470,470,10,10,0,1,0
25,472,472,22,22,0,1,0
29,478,478,98,2,96,3,2
8,492,492,115,99,16,3,2
3,492,492,147,147,0,1,0

9,106,106,2,2,0,1,0
12,107,107,2,2,0,1,0
6,109,109,8,2,6,2,1
10,116,116,1,1,0,1,0
37,120,120,3,3,0,1,0
14,125,125,6,1,5,2,1
1,130,130,16,16,0,1,0
18,153,153,32,2,30,3,2
2,161,161,1,1,0,1,0
20,168,168,5,2,3,2,1
0,188,188,22,18,4,2,1
40,216,216,7,7,0,1,0
16,216,216,13,1,12,2,1
30,225,225,2,2,0,1,0
25,229,229,25,25,0,1,0
42,241,241,4,4,0,1,0
29,261,261,5,5,0,1,0
8,263,263,1,1,0,1,0
22,271,271,60,60,0,1,0
36,272,272,65,35,30,3,2
34,276,276,25,25,0,1,0
15,305,305,5,5,0,1,0
32,330,330,81,25,56,3,2
24,352,352,30,7,23,2,1
7,367,367,15,10,5,2,1
28,375,375,4,1,3,2,1
33,381,381,112,48,64,4,3
5,381,381,60,33,27,3,2
3,394,394,39,12,27,2,1
4,401,401,62,35,27,4,3
21,410,410,27,22,5,2,1
41,413,413,71,9,62,3,2
17,418,418,104,20,84,4,3
27,421,421,21,6,15,4,3
35,423,423,30,22,8,3,2
19,428,428,1,1,0,1,0
38,431,431,87,18,69,4,3
11,444,444,69,69,0,1,0
39,448,448,6,6,0,1,0
26,450,450,67,67,0,1,0
31,459,459,47,14,33,4,3
23,481,481,10,10,0,1,0
13,500,500,1,1,0,1,0

39,100,100,17,17,0,1,0
32,108,108,6,6,0,1,0
37,109,109,2,2,0,1,0
36,109,109,23,1,22,3,2
19,110,110,4,4,0,1,0
46,111,111,23,23,0,1,0
31,120,120,35,35,0,1,0
21,126,126,43,37,6,2,1
2,132,132,11,11,0,1,0
24,150,150,19,9,10,3,2
23,166,166,6,6,0,1,0
26,170,170,11,3,8,3,2
45,171,171,27,14,13,2,1
34,185,185,17,6,11,3,2
29,197,197,5,1,4,2,1
43,197,197,33,24,9,4,3
41,212,212,10,10,0,1,0
0,216,216,17,17,0,1,0
14,222,222,14,14,0,1,0
33,226,226,19,19,0,1,0
35,235,235,8,8,0,1,0
28,262,262,9,9,0,1,0
27,293,293,1,1,0,1,0
48,297,297,7,3,4,2,1
20,303,303,9,1,8,3,2
12,304,304,24,24,0,1,0
7,314,314,7,7,0,1,0
5,335,335,10,3,7,2,1
15,338,338,8,8,0,1,0
22,348,348,5,1,4,2,1
44,350,350,4,4,0,1,0
25,356,356,1,1,0,1,0
42,364,364,5,5,0,1,0
47,366,366,31,31,0,1,0
18,393,393,18,1,17,2,1
10,419,419,45,6,39,4,3
6,437,437,2,2,0,1,0
16,447,447,58,58,0,1,0
4,451,451,43,43,0,1,0
11,454,454,30,8,22,2,1
38,455,455,77,77,0,1,0
8,459,459,27,27,0,1,0
9,461,461,48,14,34,3,2
17,464,464,62,62,0,1,0
1,470,470,11,4,7,2,1
13,475,475,2,2,0,1,0
3,485,485,17,17,0,1,0
40,492,492,37,28,9,3,2
30,494,494,17,1,16,3,2

38,101,101,2,2,0,1,0
16,102,102,16,16,0,1,0
31,106,106,6,6,0,1,0
26,110,110,8,8,0,1,0
22,126,126,16,16,0,1,0
35,133,133,9,9,0,1,0
36,155,155,2,2,0,1,0
39,158,158,14,14,0,1,0
34,159,159,8,8,0,1,0
20,185,185,44,44,0,1,0
2,209,209,28,28,0,1,0
11,213,213,7,7,0,1,0
12,223,223,7,7,0,1,0
10,224,224,11,8,3,2,1
18,229,229,19,19,0,1,0
25,238,238,27,27,0,1,0
23,238,238,34,26,8,3,2
37,243,243,11,11,0,1,0
24,245,245,4,4,0,1,0
19,300,300,10,7,3,2,1
1,305,305,36,18,18,4,3
9,305,305,89,86,3,2,1
17,311,311,58,58,0,1,0
6,319,319,45,21,24,3,2
32,321,321,16,6,10,2,1
5,334,334,11,5,6,2,1
13,340,340,17,5,12,2,1
30,349,349,134,62,72,4,3
28,352,352,53,32,21,2,1
3,366,366,45,37,8,3,2
33,376,376,114,114,0,1,0
27,381,381,8,8,0,1,0
21,410,410,49,35,14,3,2
4,417,417,6,6,0,1,0
8,423,423,13,13,0,1,0
29,425,425,47,47,0,1,0
0,425,425,26,26,0,1,0
7,444,444,3,3,0,1,0
14,464,464,33,1,32,4,3
15,471,471,7,7,0,1,0

17,100,100,7,4,3,2,1
27,103,103,25,3,22,3,2
7,104,104,16,16,0,1,0
21,118,118,3,3,0,1,0
9,123,123,17,17,0,1,0
25,132,132,5,5,0,1,0
19,142,142,8,3,5,2,1
13,225,225,7,4,3,2,1
3,226,226,125,35,90,3,2
8,247,247,18,8,10,2,1
2,271,271,49,29,20,3,2
23,273,273,59,46,13,2,1
10,298,298,53,53,0,1,0
11,300,300,5,5,0,1,0
1,306,306,121,96,25,2,1
26,322,322,39,24,15,4,3
18,330,330,28,28,0,1,0
6,349,349,10,2,8,2,1
22,355,355,14,14,0,1,0
12,361,361,66,21,45,4,3
20,376,376,23,23,0,1,0
4,389,389,1,1,0,1,0
16,406,406,62,62,0,1,0
14,425,425,51,5,46,3,2
24,437,437,27,27,0,1,0
15,442,442,51,51,0,1,0
0,447,447,229,229,0,1,0
5,483,483,1,1,0,1,0

21,109,109,4,4,0,1,0
15,120,120,17,17,0,1,0
39,156,156,19,16,3,2,1
26,156,156,27,27,0,1,0
23,237,237,25,25,0,1,0
1,240,240,12,3,9,2,1
29,243,243,10,10,0,1,0
4,258,258,1,1,0,1,0
18,259,259,24,18,6,3,2
22,260,260,20,9,11,2,1
36,266,266,46,32,14,3,2
30,268,268,40,28,12,3,2
3,272,272,7,7,0,1,0
2,282,282,1,1,0,1,0
12,311,311,5,5,0,1,0
6,313,313,35,19,16,2,1
7,315,315,21,21,0,1,0
10,319,319,1,1,0,1,0
0,326,326,54,54,0,1,0
37,329,329,33,33,0,1,0
16,341,341,90,74,16,3,2
35,352,352,10,10,0,1,0
24,357,357,50,35,15,2,1
34,393,393,15,4,11,2,1
32,397,397,20,20,0,1,0
33,401,401,88,82,6,2,1
28,403,403,12,4,8,3,2
25,413,413,70,70,0,1,0
9,423,423,7,7,0,1,0
27,434,434,85,25,60,4,3
17,440,440,53,23,30,3,2
31,443,443,12,12,0,1,0
11,446,446,7,7,0,1,0
13,463,463,17,5,12,2,1
8,474,474,51,10,41,4,3
40,485,485,30,30,0,1,0
5,488,488,161,121,40,2,1
38,489,489,13,9,4,2,1
19,489,489,66,66,0,1,0
14,490,490,59,59,0,1,0
20,496,496,22,11,11,2,1

30,104,104,6,6,0,1,0
26,115,115,23,23,0,1,0
35,116,116,21,21,0,1,0
13,117,117,3,3,0,1,0
39,128,128,49,49,0,1,0
7,138,138,9,9,0,1,0
28,167,167,19,10,9,4,3
38,172,172,2,2,0,1,0
1,174,174,4,1,3,2,1
0,180,180,9,1,8,3,2
33,184,184,15,7,8,2,1
8,202,202,23,23,0,1,0
3,208,208,3,3,0,1,0
36,218,218,3,3,0,1,0
14,221,221,20,20,0,1,0
20,233,233,6,6,0,1,0
41,261,261,11,5,6,2,1
2,274,274,19,19,0,1,0
25,281,281,24,24,0,1,0
31,300,300,36,36,0,1,0
37,301,301,14,4,10,3,2
24,307,307,23,23,0,1,0
43,309,309,5,5,0,1,0
6,326,326,39,39,0,1,0
16,329,329,1,1,0,1,0
11,350,350,166,142,24,2,1
12,366,366,3,3,0,1,0
40,370,370,7,7,0,1,0
21,397,397,52,52,0,1,0
42,401,401,21,21,0,1,0
9,404,404,11,2,9,4,3
17,411,411,8,8,0,1,0
10,428,428,3,3,0,1,0
32,431,431,16,16,0,1,0
23,438,438,72,72,0,1,0
19,442,442,41,36,5,2,1
29,446,446,162,91,71,3,2
4,449,449,53,53,0,1,0
18,465,465,26,14,12,2,1
34,482,482,6,1,5,2,1
27,492,492,53,44,9,4,3
22,496,496,24,18,6,2,1
15,497,497,31,31,0,1,0
5,498,498,9,4,5,2,1

26,106,106,4,4,0,1,0
30,112,112,6,3,3,2,1
14,113,113,3,3,0,1,0
15,128,128,2,2,0,1,0
8,128,128,6,1,5,2,1
12,136,136,17,17,0,1,0
11,137,137,12,3,9,4,3
27,152,152,5,5,0,1,0
38,184,184,4,1,3,2,1
7,198,198,1,1,0,1,0
5,220,220,16,7,9,2,1
33,228,228,15,15,0,1,0
1,246,246,5,1,4,2,1
21,248,248,5,5,0,1,0
13,256,256,1,1,0,1,0
34,259,259,23,23,0,1,0
39,262,262,43,43,0,1,0
23,267,267,13,4,9,3,2
25,269,269,9,6,3,2,1
2,289,289,24,24,0,1,0
19,292,292,23,23,0,1,0
40,304,304,17,17,0,1,0
4,305,305,38,20,18,2,1
29,331,331,169,81,88,3,2
10,335,335,10,10,0,1,0
9,347,347,90,41,49,2,1
28,365,365,22,8,14,3,2
6,366,366,28,28,0,1,0
18,369,369,46,46,0,1,0
31,379,379,124,124,0,1,0
17,392,392,35,35,0,1,0
0,393,393,72,29,43,4,3
16,394,394,113,50,63,4,3
20,411,411,1,1,0,1,0
24,421,421,40,5,35,3,2
35,452,452,45,10,35,4,3
37,455,455,16,16,0,1,0
3,470,470,66,23,43,2,1
32,480,480,34,34,0,1,0
22,484,484,2,2,0,1,0
36,484,484,61,61,0,1,0

9,116,116,8,8,0,1,0
23,124,124,11,7,4,2,1
18,127,127,18,14,4,2,1
31,144,144,7,7,0,1,0
35,147,147,28,7,21,4,3
22,148,148,14,14,0,1,0
21,149,149,12,12,0,1,0
0,172,172,5,5,0,1,0
16,175,175,3,3,0,1,0
20,193,193,89,89,0,1,0
11,211,211,55,55,0,1,0
4,211,211,69,30,39,2,1
24,225,225,62,62,0,1,0
30,227,227,26,26,0,1,0
5,228,228,8,8,0,1,0
27,240,240,24,19,5,2,1
19,270,270,13,5,8,2,1
26,275,275,7,7,0,1,0
34,280,280,16,16,0,1,0
13,296,296,5,5,0,1,0
32,320,320,13,13,0,1,0
25,356,356,15,1,14,4,3
12,369,369,41,7,34,2,1
14,394,394,45,17,28,3,2
15,413,413,16,10,6,2,1
28,414,414,3,3,0,1,0
6,423,423,122,68,54,3,2
8,429,429,40,1,39,3,2
10,447,447,1,1,0,1,0
1,451,451,65,44,21,4,3
2,462,462,5,5,0,1,0
36,464,464,9,9,0,1,0
29,467,467,27,27,0,1,0
3,471,471,103,103,0,1,0
7,471,471,57,35,22,3,2
33,497,497,21,6,15,3,2
17,500,500,2,2,0,1,0

32,107,107,26,4,22,2,1
22,134,134,3,3,0,1,0
23,140,140,40,32,8,2,1
36,142,142,6,6,0,1,0
29,157,157,27,3,24,4,3
28,175,175,27,27,0,1,0
6,205,205,1,1,0,1,0
39,215,215,16,16,0,1,0
15,228,228,8,8,0,1,0
8,229,229,71,11,60,3,2
11,232,232,78,69,9,4,3
12,236,236,8,8,0,1,0
0,243,243,2,2,0,1,0
25,258,258,80,80,0,1,0
3,270,270,1,1,0,1,0
34,273,273,50,18,32,2,1
40,278,278,24,24,0,1,0
19,281,281,10,10,0,1,0
20,285,285,7,7,0,1,0
27,321,321,9,9,0,1,0
30,345,345,3,3,0,1,0
1,346,346,39,23,16,3,2
31,354,354,33,33,0,1,0
10,356,356,11,11,0,1,0
5,358,358,1,1,0,1,0
4,363,363,12,2,10,3,2
9,370,370,29,17,12,4,3
18,372,372,2,2,0,1,0
14,377,377,64,22,42,3,2
42,404,404,8,8,0,1,0
17,404,404,18,18,0,1,0
38,406,406,65,65,0,1,0
26,436,436,14,14,0,1,0
33,440,440,18,2,16,2,1
21,443,443,35,16,19,3,2
2,444,444,28,28,0,1,0
13,444,444,62,62,0,1,0
35,458,458,44,14,30,2,1
37,458,458,30,21,9,4,3
7,461,461,16,11,5,2,1
24,469,469,49,12,37,4,3
41,490,490,16,4,12,4,3
16,496,496,4,4,0,1,0

1,105,105,9,3,6,2,1
3,105,105,29,17,12,4,3
0,126,126,17,17,0,1,0
30,126,126,17,6,11,2,1
4,154,154,18,6,12,2,1
12,166,166,2,2,0,1,0
25,167,167,4,4,0,1,0
2,173,173,51,51,0,1,0
15,175,175,34,19,15,2,1
19,192,192,45,37,8,2,1
18,196,196,20,20,0,1,0
23,208,208,49,49,0,1,0
8,282,282,48,48,0,1,0
28,284,284,49,27,22,2,1
13,292,292,17,3,14,2,1
29,298,298,18,18,0,1,0
21,314,314,53,41,12,2,1
7,317,317,26,8,18,2,1
6,333,333,60,7,53,3,2
24,345,345,10,10,0,1,0
22,348,348,47,25,22,2,1
11,355,355,114,33,81,4,3
17,366,366,22,4,18,2,1
14,377,377,1,1,0,1,0
31,384,384,58,43,15,2,1
27,403,403,19,19,0,1,0
10,404,404,14,3,11,2,1
5,431,431,31,31,0,1,0
20,434,434,30,11,19,2,1
16,443,443,13,3,10,2,1
9,473,473,58,58,0,1,0
26,476,476,13,7,6,3,2

35,103,103,45,39,6,3,2
27,128,128,4,4,0,1,0
41,143,143,15,15,0,1,0
37,146,146,24,6,18,4,3
33,149,149,25,25,0,1,0
17,170,170,12,12,0,1,0
26,179,179,1,1,0,1,0
32,192,192,37,37,0,1,0
34,200,200,5,5,0,1,0
5,204,204,3,3,0,1,0
6,206,206,1,1,0,1,0
31,210,210,11,5,6,3,2
38,220,220,24,10,14,2,1
13,221,221,14,14,0,1,0
1,226,226,5,1,4,2,1
43,235,235,23,23,0,1,0
29,239,239,4,4,0,1,0
30,239,239,3,3,0,1,0
4,245,245,20,8,12,3,2
12,262,262,10,10,0,1,0
2,267,267,15,1,14,3,2
7,272,272,31,1,30,2,1
23,281,281,27,24,3,2,1
11,296,296,15,4,11,2,1
21,302,302,39,4,35,4,3
36,307,307,29,29,0,1,0
22,312,312,9,9,0,1,0
9,340,340,59,25,34,3,2
25,345,345,22,22,0,1,0
14,346,346,26,16,10,2,1
45,350,350,9,9,0,1,0
8,353,353,7,7,0,1,0
40,377,377,49,9,40,2,1
0,380,380,72,15,57,4,3
18,385,385,44,44,0,1,0
3,388,388,28,28,0,1,0
20,402,402,11,11,0,1,0
10,416,416,33,30,3,2,1
16,426,426,2,2,0,1,0
15,463,463,88,88,0,1,0
42,465,465,55,55,0,1,0
19,469,469,12,12,0,1,0
39,469,469,1,1,0,1,0
28,473,473,19,19,0,1,0
44,478,478,56,56,0,1,0
24,481,481,44,32,12,2,1

9,107,107,8,8,0,1,0
5,113,113,1,1,0,1,0
2,120,120,4,4,0,1,0
4,121,121,1,1,0,1,0
25,129,129,14,14,0,1,0
20,136,136,28,28,0,1,0
3,141,141,10,10,0,1,0
29,142,142,4,4,0,1,0
21,145,145,4,4,0,1,0
7,158,158,25,25,0,1,0
32,178,178,26,12,14,3,2
10,183,183,35,15,20,3,2
19,192,192,5,2,3,2,1
24,197,197,29,20,9,2,1
16,206,206,6,6,0,1,0
36,211,211,14,14,0,1,0
22,250,250,14,14,0,1,0
30,252,252,30,30,0,1,0
27,253,253,31,6,25,2,1
17,265,265,15,1,14,3,2
15,277,277,3,3,0,1,0
8,292,292,158,131,27,4,3
31,317,317,9,9,0,1,0
11,336,336,90,30,60,4,3
28,340,340,54,27,27,2,1
12,362,362,39,12,27,4,3
35,387,387,20,20,0,1,0
26,393,393,75,75,0,1,0
33,398,398,38,38,0,1,0
13,435,435,26,8,18,4,3
1,438,438,1,1,0,1,0
6,446,446,23,23,0,1,0
0,458,458,59,37,22,3,2
18,458,458,84,54,30,4,3
34,464,464,16,16,0,1,0
14,487,487,49,44,5,2,1
23,494,494,70,70,0,1,0

6,100,100,10,7,3,2,1
19,106,106,1,1,0,1,0
35,122,122,14,11,3,2,1
25,147,147,1,1,0,1,0
15,148,148,35,4,31,2,1
12,150,150,2,2,0,1,0
31,156,156,18,7,11,2,1
38,182,182,12,12,0,1,0
14,184,184,3,3,0,1,0
1,190,190,3,3,0,1,0
37,191,191,56,33,23,2,1
7,194,194,15,15,0,1,0
4,196,196,2,2,0,1,0
20,205,205,16,10,6,3,2
30,215,215,11,11,0,1,0
17,218,218,13,13,0,1,0
29,221,221,6,1,5,2,1
9,233,233,1,1,0,1,0
34,237,237,39,5,34,2,1
16,249,249,23,18,5,2,1
32,255,255,2,2,0,1,0
22,274,274,12,3,9,4,3
28,277,277,30,30,0,1,0
8,299,299,22,22,0,1,0
39,316,316,38,4,34,2,1
2,332,332,15,1,14,2,1
3,337,337,41,41,0,1,0
5,365,365,112,112,0,1,0
33,365,365,21,21,0,1,0
10,376,376,3,3,0,1,0
24,393,393,18,9,9,4,3
21,393,393,62,62,0,1,0
23,397,397,185,67,118,4,3
13,402,402,16,16,0,1,0
40,403,403,25,7,18,2,1
18,423,423,97,39,58,3,2
0,437,437,3,3,0,1,0
36,451,451,57,57,0,1,0
27,471,471,15,6,9,4,3
11,480,480,95,69,26,2,1
26,496,496,14,14,0,1,0

31,138,138,3,3,0,1,0
9,141,141,20,20,0,1,0
15,144,144,8,8,0,1,0
23,144,144,27,27,0,1,0
6,161,161,2,2,0,1,0
1,163,163,25,17,8,2,1
29,163,163,12,12,0,1,0
10,173,173,16,16,0,1,0
19,197,197,12,12,0,1,0
26,207,207,35,25,10,3,2
30,217,217,59,31,28,2,1
4,250,250,99,99,0,1,0
7,258,258,12,12,0,1,0
16,264,264,2,2,0,1,0
5,267,267,3,3,0,1,0
38,287,287,9,9,0,1,0
35,289,289,4,4,0,1,0
32,294,294,41,13,28,2,1
37,301,301,3,3,0,1,0
39,317,317,62,62,0,1,0
33,331,331,25,25,0,1,0
21,337,337,33,33,0,1,0
20,358,358,26,26,0,1,0
42,366,366,16,16,0,1,0
12,385,385,53,53,0,1,0
13,388,388,1,1,0,1,0
28,389,389,37,34,3,2,1
3,393,393,20,20,0,1,0
40,395,395,22,22,0,1,0
18,395,395,7,7,0,1,0
25,402,402,79,16,63,4,3
11,402,402,13,5,8,2,1
27,405,405,6,1,5,2,1
8,412,412,52,6,46,2,1
34,414,414,9,9,0,1,0
14,416,416,34,9,25,2,1
0,455,455,19,10,9,2,1
2,459,459,32,13,19,4,3
36,476,476,52,9,43,4,3
24,477,477,16,16,0,1,0
41,483,483,173,102,71,4,3
22,485,485,1,1,0,1,0
17,493,493,3,3,0,1,0

7,101,101,4,1,3,2,1
3,107,107,6,6,0,1,0
18,117,117,3,3,0,1,0
6,133,133,5,5,0,1,0
27,145,145,35,35,0,1,0
2,152,152,17,11,6,2,1
32,153,153,16,16,0,1,0
0,163,163,19,19,0,1,0
4,191,191,11,2,9,4,3
25,219,219,4,4,0,1,0
17,237,237,6,6,0,1,0
22,275,275,32,32,0,1,0
23,282,282,47,2,45,2,1
8,291,291,9,9,0,1,0
35,295,295,42,42,0,1,0
10,296,296,1,1,0,1,0
30,315,315,48,21,27,4,3
12,332,332,46,26,20,3,2
14,338,338,24,24,0,1,0
26,345,345,4,4,0,1,0
31,355,355,4,1,3,2,1
29,359,359,57,18,39,4,3
5,377,377,61,61,0,1,0
15,387,387,26,26,0,1,0
19,392,392,88,26,62,3,2
21,396,396,83,83,0,1,0
28,399,399,7,7,0,1,0
24,422,422,61,35,26,3,2
34,432,432,41,41,0,1,0
9,438,438,16,10,6,2,1
13,439,439,322,290,32,2,1
16,453,453,7,7,0,1,0
33,453,453,4,4,0,1,0
20,472,472,28,28,0,1,0
11,480,480,13,13,0,1,0
1,499,499,98,98,0,1,0

40,100,100,34,11,23,2,1
36,131,131,41,7,34,2,1
4,132,132,8,8,0,1,0
35,169,169,30,30,0,1,0
15,179,179,18,10,8,3,2
29,182,182,8,8,0,1,0
6,191,191,20,20,0,1,0
21,193,193,2,2,0,1,0
24,198,198,5,2,3,2,1
31,202,202,3,3,0,1,0
41,238,238,6,6,0,1,0
10,270,270,41,41,0,1,0
2,284,284,6,6,0,1,0
26,286,286,6,6,0,1,0
0,331,331,26,16,10,2,1
3,335,335,7,3,4,2,1
19,344,344,5,5,0,1,0
34,346,346,51,51,0,1,0
18,358,358,27,27,0,1,0
7,365,365,15,4,11,2,1
9,367,367,63,21,42,3,2
22,369,369,42,14,28,2,1
16,373,373,1,1,0,1,0
23,375,375,17,17,0,1,0
39,386,386,58,6,52,3,2
28,398,398,19,14,5,2,1
11,403,403,35,35,0,1,0
14,414,414,54,16,38,2,1
12,426,426,51,51,0,1,0
30,427,427,74,74,0,1,0
32,430,430,49,40,9,4,3
17,433,433,57,53,4,2,1
25,439,439,20,20,0,1,0
37,440,440,15,15,0,1,0
27,447,447,6,6,0,1,0
1,453,453,11,1,10,2,1
5,473,473,33,13,20,4,3
20,488,488,79,79,0,1,0
33,490,490,70,20,50,2,1
38,497,497,31,23,8,2,1
13,498,498,63,63,0,1,0
8,499,499,41,33,8,3,2

10,100,100,1,1,0,1,0
3,111,111,2,2,0,1,0
13,119,119,20,20,0,1,0
18,186,186,10,2,8,3,2
34,198,198,9,6,3,2,1
11,208,208,16,1,15,2,1
2,216,216,82,82,0,1,0
21,225,225,15,5,10,3,2
33,236,236,29,29,0,1,0
29,241,241,17,17,0,1,0
26,249,249,7,7,0,1,0
9,274,274,34,14,20,3,2
32,282,282,37,37,0,1,0
5,286,286,3,3,0,1,0
28,290,290,93,35,58,4,3
16,313,313,19,4,15,2,1
14,325,325,5,5,0,1,0
30,332,332,18,18,0,1,0
22,372,372,7,7,0,1,0
25,374,374,36,36,0,1,0
31,380,380,9,9,0,1,0
7,381,381,114,114,0,1,0
8,391,391,18,6,12,3,2
23,393,393,16,16,0,1,0
20,413,413,27,27,0,1,0
6,415,415,114,114,0,1,0
27,431,431,115,72,43,2,1
4,445,445,77,69,8,3,2
19,462,462,74,8,66,4,3
1,468,468,20,20,0,1,0
24,471,471,40,19,21,2,1
0,478,478,59,59,0,1,0
17,490,490,109,109,0,1,0
12,494,494,21,21,0,1,0
15,498,498,48,48,0,1,0

38,110,110,7,7,0,1,0
9,117,117,4,4,0,1,0
10,122,122,19,19,0,1,0
28,149,149,24,24,0,1,0
33,150,150,13,13,0,1,0
18,151,151,9,3,6,2,1
11,152,152,3,3,0,1,0
7,158,158,9,4,5,2,1
8,158,158,33,2,31,2,1
20,161,161,25,25,0,1,0
31,169,169,9,9,0,1,0
30,173,173,5,2,3,2,1
2,176,176,53,53,0,1,0
15,179,179,32,1,31,2,1
4,194,194,3,3,0,1,0
5,195,195,9,9,0,1,0
40,202,202,19,4,15,2,1
32,209,209,40,14,26,2,1
0,217,217,15,15,0,1,0
39,270,270,18,18,0,1,0
36,276,276,40,40,0,1,0
17,281,281,17,17,0,1,0
19,282,282,11,11,0,1,0
23,283,283,12,12,0,1,0
14,288,288,14,14,0,1,0
6,295,295,7,7,0,1,0
1,298,298,27,3,24,2,1
27,306,306,12,12,0,1,0
35,310,310,8,8,0,1,0
25,319,319,28,28,0,1,0
16,346,346,14,14,0,1,0
42,372,372,67,18,49,4,3
21,399,399,26,26,0,1,0
12,407,407,18,14,4,2,1
3,452,452,19,12,7,2,1
24,453,453,43,43,0,1,0
41,470,470,1,1,0,1,0
37,477,477,3,3,0,1,0
29,482,482,24,14,10,2,1
26,490,490,229,171,58,3,2
34,493,493,41,41,0,1,0
22,498,498,16,3,13,2,1
13,499,499,35,35,0,1,0

12,120,120,29,21,8,3,2
5,126,126,13,13,0,1,0
31,143,143,16,16,0,1,0
16,143,143,2,2,0,1,0
4,174,174,18,8,10,3,2
8,195,195,14,5,9,4,3
13,216,216,32,16,16,3,2
17,225,225,104,25,79,4,3
14,226,226,33,17,16,3,2
19,226,226,4,1,3,2,1
10,265,265,8,8,0,1,0
26,266,266,23,8,15,4,3
7,267,267,21,12,9,4,3
3,273,273,5,5,0,1,0
29,309,309,7,7,0,1,0
30,322,322,17,2,15,2,1
20,349,349,4,4,0,1,0
24,353,353,20,2,18,2,1
33,369,369,136,102,34,3,2
0,372,372,24,24,0,1,0
6,384,384,159,133,26,2,1
15,389,389,48,32,16,3,2
23,391,391,7,7,0,1,0
21,398,398,19,3,16,2,1
11,401,401,11,11,0,1,0
34,404,404,9,1,8,2,1
2,419,419,83,33,50,2,1
18,429,429,22,22,0,1,0
27,429,429,19,7,12,4,3
9,429,429,14,14,0,1,0
25,431,431,60,60,0,1,0
22,434,434,9,9,0,1,0
28,434,434,4,4,0,1,0
1,466,466,47,47,0,1,0
32,492,492,180,180,0,1,0

3,104,104,5,5,0,1,0
14,112,112,9,1,8,3,2
13,113,113,15,15,0,1,0
20,113,113,4,4,0,1,0
26,122,122,1,1,0,1,0
32,132,132,32,8,24,2,1
28,160,160,65,65,0,1,0
11,161,161,11,2,9,2,1
30,168,168,2,2,0,1,0
34,176,176,13,13,0,1,0
7,181,181,19,2,17,2,1
12,192,192,20,20,0,1,0
1,202,202,4,4,0,1,0
19,204,204,14,11,3,2,1
16,211,211,2,2,0,1,0
24,234,234,20,20,0,1,0
17,241,241,3,3,0,1,0
38,243,243,33,33,0,1,0
25,251,251,19,19,0,1,0
39,256,256,3,3,0,1,0
9,263,263,11,11,0,1,0
31,283,283,2,2,0,1,0
40,293,293,38,8,30,2,1
22,299,299,4,4,0,1,0
5,328,328,1,1,0,1,0
8,340,340,102,16,86,4,3
6,344,344,12,6,6,3,2
36,374,374,14,6,8,3,2
33,394,394,42,32,10,3,2
23,404,404,21,11,10,2,1
37,430,430,33,33,0,1,0
21,441,441,48,20,28,2,1
27,445,445,21,9,12,4,3
15,446,446,56,23,33,4,3
41,447,447,124,124,0,1,0
4,452,452,40,40,0,1,0
0,453,453,134,98,36,2,1
29,474,474,49,5,44,3,2
18,476,476,69,69,0,1,0
10,479,479,11,3,8,3,2
2,489,489,19,19,0,1,0
35,497,497,21,21,0,1,0

14,100,100,9,9,0,1,0
2,127,127,30,21,9,4,3
33,128,128,21,7,14,3,2
26,132,132,7,7,0,1,0
16,132,132,19,10,9,4,3
25,134,134,16,8,8,3,2
28,145,145,12,8,4,2,1
27,149,149,24,24,0,1,0
0,153,153,1,1,0,1,0
10,169,169,5,5,0,1,0
9,174,174,5,2,3,2,1
4,209,209,98,98,0,1,0
23,219,219,1,1,0,1,0
7,220,220,20,8,12,4,3
11,237,237,5,1,4,2,1
24,248,248,36,16,20,3,2
18,272,272,42,42,0,1,0
17,282,282,41,41,0,1,0
22,295,295,62,11,51,4,3
32,297,297,14,14,0,1,0
34,310,310,28,6,22,3,2
20,334,334,65,65,0,1,0
13,337,337,142,79,63,4,3
29,362,362,21,9,12,4,3
31,399,399,7,2,5,2,1
6,401,401,86,62,24,3,2
19,411,411,9,9,0,1,0
30,411,411,1,1,0,1,0
3,415,415,43,43,0,1,0
21,428,428,55,34,21,2,1
8,452,452,6,6,0,1,0
12,455,455,6,6,0,1,0
5,464,464,1,1,0,1,0
1,467,467,69,69,0,1,0
15,482,482,6,6,0,1,0

3,117,117,20,20,0,1,0
5,126,126,3,3,0,1,0
26,131,131,7,7,0,1,0
19,135,135,12,12,0,1,0
31,141,141,6,3,3,2,1
17,146,146,3,3,0,1,0
27,147,147,7,3,4,2,1
37,175,175,57,57,0,1,0
42,176,176,4,1,3,2,1
6,183,183,17,5,12,3,2
43,198,198,19,19,0,1,0
4,199,199,2,2,0,1,0
8,202,202,16,16,0,1,0
24,206,206,1,1,0,1,0
38,221,221,40,4,36,4,3
36,225,225,21,15,6,3,2
23,226,226,6,6,0,1,0
25,231,231,89,89,0,1,0
44,234,234,7,7,0,1,0
0,246,246,10,2,8,3,2
35,252,252,7,7,0,1,0
21,254,254,17,17,0,1,0
29,264,264,26,26,0,1,0
11,268,268,14,14,0,1,0
12,275,275,9,5,4,2,1
30,276,276,7,2,5,2,1
9,298,298,5,5,0,1,0
32,301,301,10,1,9,4,3
10,301,301,11,1,10,3,2
14,304,304,20,20,0,1,0
40,311,311,32,32,0,1,0
34,343,343,47,47,0,1,0
7,357,357,12,12,0,1,0
2,357,357,3,3,0,1,0
22,388,388,5,5,0,1,0
1,391,391,58,9,49,2,1
41,403,403,87,87,0,1,0
18,422,422,85,43,42,4,3
20,425,425,24,1,23,4,3
16,430,430,9,1,8,3,2
33,442,442,63,31,32,4,3
28,460,460,115,79,36,2,1
15,464,464,34,34,0,1,0
39,465,465,8,4,4,2,1
13,487,487,65,47,18,4,3

17,103,103,1,1,0,1,0
32,105,105,13,13,0,1,0
18,106,106,12,6,6,3,2
9,157,157,37,7,30,3,2
6,159,159,2,2,0,1,0
3,168,168,1,1,0,1,0
15,184,184,17,7,10,2,1
2,188,188,51,32,19,4,3
26,190,190,38,38,0,1,0
10,211,211,27,27,0,1,0
24,229,229,20,14,6,3,2
11,252,252,15,5,10,3,2
19,267,267,17,8,9,2,1
20,270,270,28,7,21,2,1
29,287,287,95,69,26,2,1
4,316,316,39,12,27,2,1
12,331,331,70,14,56,3,2
22,333,333,34,34,0,1,0
5,334,334,8,8,0,1,0
16,349,349,3,3,0,1,0
30,357,357,31,31,0,1,0
28,359,359,25,25,0,1,0
14,362,362,5,5,0,1,0
7,381,381,120,27,93,4,3
21,382,382,31,31,0,1,0
27,407,407,103,69,34,2,1
23,426,426,46,34,12,4,3
1,435,435,83,65,18,2,1
13,438,438,32,27,5,2,1
25,469,469,30,30,0,1,0
0,486,486,13,13,0,1,0
31,491,491,14,14,0,1,0
8,499,499,112,3,109,4,3

25,107,107,8,5,3,2,1
17,114,114,4,1,3,2,1
33,117,117,27,1,26,2,1
11,135,135,7,7,0,1,0
22,137,137,16,1,15,3,2
8,151,151,2,2,0,1,0
5,155,155,41,41,0,1,0
21,158,158,3,3,0,1,0
7,163,163,10,10,0,1,0
23,163,163,4,4,0,1,0
2,168,168,17,6,11,2,1
4,191,191,31,21,10,3,2
18,191,191,47,5,42,2,1
26,193,193,14,14,0,1,0
20,236,236,3,3,0,1,0
31,299,299,10,10,0,1,0
0,306,306,82,48,34,2,1
9,322,322,40,13,27,2,1
12,335,335,24,12,12,2,1
19,348,348,10,10,0,1,0
30,355,355,77,33,44,3,2
29,357,357,42,25,17,4,3
24,360,360,102,45,57,4,3
3,365,365,11,3,8,2,1
27,382,382,34,22,12,4,3
28,382,382,33,33,0,1,0
32,399,399,39,39,0,1,0
10,403,403,170,126,44,3,2
15,411,411,1,1,0,1,0
14,413,413,78,14,64,3,2
1,465,465,52,52,0,1,0
16,473,473,72,23,49,2,1
6,473,473,1,1,0,1,0
13,479,479,13,13,0,1,0

28,117,117,7,3,4,2,1
14,120,120,20,20,0,1,0
9,122,122,25,25,0,1,0
31,125,125,4,4,0,1,0
11,151,151,15,9,6,3,2
16,162,162,30,30,0,1,0
13,165,165,6,6,0,1,0
0,209,209,6,3,3,2,1
34,247,247,11,11,0,1,0
12,258,258,1,1,0,1,0
24,261,261,2,2,0,1,0
19,268,268,27,27,0,1,0
23,272,272,28,28,0,1,0
38,280,280,79,79,0,1,0
20,280,280,58,10,48,4,3
2,314,314,60,60,0,1,0
5,320,320,10,7,3,2,1
4,345,345,50,10,40,4,3
37,356,356,5,1,4,2,1
35,357,357,62,15,47,2,1
27,371,371,3,3,0,1,0
6,376,376,40,40,0,1,0
7,386,386,20,20,0,1,0
21,405,405,29,29,0,1,0
22,417,417,12,12,0,1,0
3,420,420,36,30,6,2,1
1,421,421,4,1,3,2,1
33,422,422,75,75,0,1,0
36,440,440,36,13,23,2,1
25,450,450,137,109,28,3,2
15,452,452,54,18,36,2,1
10,460,460,20,16,4,2,1
29,466,466,44,44,0,1,0
30,472,472,58,22,36,4,3
18,474,474,8,8,0,1,0
8,475,475,30,15,15,2,1
32,486,486,29,29,0,1,0
26,487,487,30,30,0,1,0
17,493,493,105,85,20,3,2

4,109,109,6,2,4,2,1
16,131,131,5,1,4,2,1
33,133,133,1,1,0,1,0
19,141,141,10,10,0,1,0
38,143,143,10,3,7,2,1
36,159,159,12,12,0,1,0
2,164,164,17,17,0,1,0
37,164,164,6,2,4,2,1
30,164,164,14,14,0,1,0
34,175,175,14,2,12,3,2
25,184,184,23,23,0,1,0
26,185,185,17,17,0,1,0
0,188,188,19,19,0,1,0
10,190,190,12,12,0,1,0
5,197,197,54,54,0,1,0
24,199,199,37,37,0,1,0
13,212,212,3,3,0,1,0
31,213,213,2,2,0,1,0
29,225,225,34,19,15,4,3
11,241,241,2,2,0,1,0
15,275,275,102,45,57,4,3
32,275,275,4,4,0,1,0
8,284,284,4,4,0,1,0
12,286,286,7,7,0,1,0
7,300,300,1,1,0,1,0
3,314,314,19,19,0,1,0
20,335,335,67,34,33,4,3
9,370,370,68,38,30,3,2
22,379,379,165,81,84,4,3
28,386,386,40,16,24,4,3
17,417,417,43,43,0,1,0
23,432,432,13,13,0,1,0
18,442,442,50,50,0,1,0
6,454,454,1,1,0,1,0
21,459,459,21,21,0,1,0
27,468,468,38,16,22,2,1
14,486,486,97,97,0,1,0
35,496,496,55,55,0,1,0
1,497,497,51,48,3,2,1

23,102,102,10,2,8,3,2
16,112,112,25,17,8,2,1
8,118,118,9,9,0,1,0
7,134,134,41,41,0,1,0
10,150,150,31,31,0,1,0
11,164,164,13,13,0,1,0
3,195,195,4,1,3,2,1
32,208,208,15,15,0,1,0
28,224,224,1,1,0,1,0
2,227,227,12,12,0,1,0
1,236,236,122,5,117,4,3
9,238,238,33,33,0,1,0
13,266,266,9,5,4,2,1
12,282,282,28,10,18,3,2
31,285,285,2,2,0,1,0
14,299,299,54,37,17,2,1
21,314,314,28,22,6,2,1
19,320,320,9,9,0,1,0
26,320,320,8,8,0,1,0
5,343,343,60,60,0,1,0
18,356,356,17,17,0,1,0
27,394,394,66,34,32,2,1
15,395,395,34,20,14,2,1
17,432,432,112,78,34,3,2
20,432,432,30,30,0,1,0
30,436,436,32,18,14,3,2
25,441,441,50,50,0,1,0
6,442,442,31,31,0,1,0
4,454,454,48,48,0,1,0
0,473,473,10,1,9,2,1
29,483,483,56,8,48,3,2
24,487,487,103,103,0,1,0
22,489,489,31,7,24,2,1

27,105,105,28,6,22,3,2
35,115,115,31,9,22,4,3
18,120,120,11,6,5,2,1
33,124,124,9,3,6,3,2
17,149,149,4,4,0,1,0
28,152,152,5,5,0,1,0
32,168,168,13,5,8,2,1
29,172,172,9,9,0,1,0
0,179,179,48,11,37,2,1
15,207,207,2,2,0,1,0
7,223,223,32,32,0,1,0
36,232,232,11,11,0,1,0
23,254,254,23,7,16,3,2
11,266,266,30,22,8,3,2
4,267,267,20,1,19,4,3
30,284,284,11,11,0,1,0
12,291,291,23,23,0,1,0
25,295,295,61,19,42,3,2
13,318,318,6,6,0,1,0
3,322,322,4,1,3,2,1
1,323,323,5,2,3,2,1
20,334,334,12,4,8,2,1
10,335,335,177,101,76,4,3
26,348,348,41,41,0,1,0
6,352,352,39,39,0,1,0
22,356,356,15,15,0,1,0
21,360,360,30,30,0,1,0
19,364,364,30,9,21,2,1
8,383,383,42,29,13,2,1
31,384,384,69,21,48,4,3
2,400,400,3,3,0,1,0
5,439,439,52,43,9,4,3
24,457,457,6,6,0,1,0
34,468,468,65,65,0,1,0
9,475,475,18,9,9,2,1
14,482,482,106,18,88,3,2
16,489,489,5,5,0,1,0

6,114,114,1,1,0,1,0
11,121,121,20,20,0,1,0
21,123,123,6,6,0,1,0
18,129,129,23,23,0,1,0
19,139,139,30,30,0,1,0
0,147,147,15,15,0,1,0
31,148,148,10,10,0,1,0
24,206,206,1,1,0,1,0
10,222,222,26,26,0,1,0
2,224,224,49,49,0,1,0
23,242,242,4,4,0,1,0
8,262,262,11,3,8,2,1
16,269,269,1,1,0,1,0
20,288,288,15,15,0,1,0
26,292,292,20,5,15,4,3
12,292,292,29,11,18,3,2
9,297,297,7,7,0,1,0
14,312,312,96,96,0,1,0
13,320,320,12,1,11,2,1
5,321,321,12,5,7,2,1
3,331,331,2,2,0,1,0
35,345,345,47,9,38,2,1
17,368,368,2,2,0,1,0
4,371,371,60,27,33,2,1
33,377,377,9,9,0,1,0
32,401,401,79,65,14,2,1
29,402,402,79,40,39,2,1
28,402,402,143,102,41,4,3
15,427,427,122,110,12,3,2
25,438,438,72,72,0,1,0
30,445,445,3,3,0,1,0
34,451,451,21,16,5,2,1
22,456,456,15,2,13,2,1
7,456,456,9,6,3,2,1
27,493,493,57,54,3,2,1
1,496,496,132,132,0,1,0

34,112,112,9,9,0,1,0
31,115,115,36,36,0,1,0
1,124,124,8,8,0,1,0
16,126,126,1,1,0,1,0
26,135,135,7,7,0,1,0
13,139,139,10,2,8,3,2
9,164,164,28,28,0,1,0
15,180,180,11,11,0,1,0
20,180,180,3,3,0,1,0
21,188,188,66,66,0,1,0
18,196,196,28,3,25,2,1
27,206,206,20,7,13,2,1
29,208,208,30,18,12,2,1
6,212,212,62,62,0,1,0
23,214,214,37,37,0,1,0
14,232,232,33,33,0,1,0
25,241,241,1,1,0,1,0
30,257,257,14,14,0,1,0
24,260,260,39,8,31,2,1
28,267,267,6,2,4,2,1
36,286,286,15,6,9,4,3
33,286,286,61,61,0,1,0
35,316,316,4,4,0,1,0
12,324,324,30,25,5,2,1
5,338,338,49,49,0,1,0
37,370,370,12,1,11,2,1
0,375,375,7,4,3,2,1
22,392,392,60,60,0,1,0
7,393,393,69,69,0,1,0
32,396,396,6,6,0,1,0
10,400,400,17,17,0,1,0
17,411,411,45,45,0,1,0
3,427,427,34,34,0,1,0
8,438,438,68,58,10,2,1
19,449,449,5,5,0,1,0
2,463,463,11,11,0,1,0
4,472,472,19,7,12,4,3
11,494,494,32,32,0,1,0

37,104,104,20,6,14,2,1
11,104,104,2,2,0,1,0
26,109,109,3,3,0,1,0
38,111,111,4,4,0,1,0
36,150,150,13,13,0,1,0
41,157,157,3,3,0,1,0
5,168,168,43,43,0,1,0
12,172,172,5,1,4,2,1
34,173,173,3,3,0,1,0
0,177,177,2,2,0,1,0
3,183,183,17,17,0,1,0
33,184,184,15,3,12,3,2
15,184,184,13,13,0,1,0
17,195,195,54,22,32,2,1
13,201,201,4,4,0,1,0
19,221,221,14,14,0,1,0
4,227,227,1,1,0,1,0
39,227,227,86,86,0,1,0
6,229,229,1,1,0,1,0
14,252,252,7,7,0,1,0
31,253,253,31,31,0,1,0
24,268,268,41,41,0,1,0
10,271,271,40,28,12,4,3
7,272,272,6,3,3,2,1
25,286,286,13,10,3,2,1
35,289,289,11,11,0,1,0
29,291,291,51,51,0,1,0
32,310,310,5,2,3,2,1
30,328,328,79,63,16,3,2
28,330,330,5,5,0,1,0
20,344,344,24,24,0,1,0
1,346,346,86,86,0,1,0
2,368,368,20,20,0,1,0
22,375,375,74,40,34,4,3
8,381,381,6,6,0,1,0
18,399,399,21,9,12,3,2
9,417,417,14,14,0,1,0
27,441,441,12,12,0,1,0
21,460,460,65,8,57,4,3
40,496,496,16,16,0,1,0
23,497,497,124,124,0,1,0
16,500,500,21,6,15,4,3

10,106,106,14,14,0,1,0
11,112,112,3,3,0,1,0
4,119,119,25,1,24,3,2
15,122,122,4,1,3,2,1
32,132,132,14,4,10,3,2
3,137,137,1,1,0,1,0
23,152,152,5,5,0,1,0
16,155,155,1,1,0,1,0
14,194,194,8,1,7,3,2
30,217,217,15,3,12,3,2
20,237,237,30,30,0,1,0
27,244,244,7,7,0,1,0
33,249,249,4,4,0,1,0
7,256,256,13,13,0,1,0
25,270,270,3,3,0,1,0
9,277,277,11,11,0,1,0
13,300,300,63,63,0,1,0
18,301,301,30,30,0,1,0
29,305,305,11,2,9,2,1
28,308,308,13,5,8,3,2
34,312,312,106,64,42,4,3
5,312,312,88,46,42,2,1
19,316,316,37,25,12,2,1
36,330,330,41,7,34,3,2
8,344,344,1,1,0,1,0
1,359,359,22,13,9,3,2
0,369,369,20,20,0,1,0
24,378,378,78,78,0,1,0
22,400,400,95,95,0,1,0
2,401,401,62,55,7,2,1
21,403,403,20,20,0,1,0
31,426,426,36,36,0,1,0
17,433,433,121,23,98,3,2
12,445,445,32,32,0,1,0
35,466,466,86,86,0,1,0
26,483,483,11,7,4,2,1
6,488,488,116,34,82,3,2

33,101,101,18,18,0,1,0
16,105,105,4,4,0,1,0
26,106,106,5,2,3,2,1
31,145,145,1,1,0,1,0
12,180,180,1,1,0,1,0
10,186,186,41,7,34,2,1
24,195,195,52,52,0,1,0
1,197,197,4,4,0,1,0
7,202,202,57,33,24,3,2
13,204,204,1,1,0,1,0
20,204,204,7,7,0,1,0
22,229,229,5,5,0,1,0
23,251,251,2,2,0,1,0
3,268,268,45,45,0,1,0
5,285,285,51,41,10,3,2
17,302,302,47,47,0,1,0
30,308,308,28,28,0,1,0
18,322,322,50,16,34,3,2
6,345,345,22,8,14,2,1
15,349,349,78,7,71,4,3
21,355,355,11,1,10,3,2
29,368,368,21,21,0,1,0
32,371,371,66,12,54,4,3
8,398,398,4,4,0,1,0
11,401,401,114,114,0,1,0
34,408,408,184,131,53,4,3
9,412,412,63,31,32,2,1
4,418,418,52,52,0,1,0
27,427,427,11,11,0,1,0
19,443,443,16,16,0,1,0
28,445,445,5,5,0,1,0
14,466,466,11,1,10,2,1
2,476,476,8,8,0,1,0
25,480,480,73,73,0,1,0
0,487,487,60,60,0,1,0

19,103,103,38,5,33,4,3
1,128,128,6,2,4,2,1
18,131,131,11,11,0,1,0
5,137,137,10,10,0,1,0
10,176,176,5,5,0,1,0
32,185,185,3,3,0,1,0
22,186,186,1,1,0,1,0
3,196,196,46,10,36,2,1
9,212,212,26,14,12,3,2
30,221,221,7,1,6,2,1
27,228,228,35,35,0,1,0
21,233,233,2,2,0,1,0
28,236,236,3,3,0,1,0
24,240,240,16,16,0,1,0
15,273,273,4,4,0,1,0
11,280,280,11,11,0,1,0
0,296,296,81,59,22,3,2
6,317,317,120,97,23,2,1
25,335,335,2,2,0,1,0
13,346,346,1,1,0,1,0
8,349,349,65,65,0,1,0
14,378,378,7,4,3,2,1
16,379,379,26,19,7,2,1
23,379,379,130,130,0,1,0
12,385,385,45,45,0,1,0
4,399,399,68,13,55,3,2
2,434,434,86,58,28,2,1
26,439,439,103,103,0,1,0
17,444,444,37,3,34,3,2
7,446,446,13,13,0,1,0
20,457,457,2,2,0,1,0
31,485,485,25,25,0,1,0
29,488,488,178,96,82,3,2

41,101,101,12,5,7,2,1
31,107,107,1,1,0,1,0
17,121,121,13,13,0,1,0
26,123,123,5,5,0,1,0
21,124,124,14,14,0,1,0
49,137,137,4,4,0,1,0
29,144,144,7,3,4,2,1
23,145,145,1,1,0,1,0
38,146,146,31,31,0,1,0
50,153,153,12,2,10,2,1
37,158,158,1,1,0,1,0
14,168,168,19,14,5,2,1
10,173,173,8,8,0,1,0
33,174,174,3,3,0,1,0
45,187,187,38,3,35,2,1
13,190,190,11,11,0,1,0
4,190,190,2,2,0,1,0
15,205,205,1,1,0,1,0
6,220,220,19,19,0,1,0
39,224,224,18,18,0,1,0
18,231,231,6,6,0,1,0
36,234,234,51,51,0,1,0
22,239,239,35,35,0,1,0
19,245,245,6,6,0,1,0
25,246,246,12,5,7,2,1
30,262,262,20,5,15,4,3
2,262,262,37,3,34,2,1
46,276,276,21,21,0,1,0
5,277,277,10,5,5,2,1
35,295,295,40,22,18,3,2
1,310,310,19,13,6,2,1
24,325,325,44,44,0,1,0
11,326,326,27,27,0,1,0
12,336,336,24,17,7,2,1
44,354,354,10,4,6,2,1
48,355,355,93,93,0,1,0
20,360,360,13,3,10,2,1
9,360,360,10,6,4,2,1
32,366,366,38,38,0,1,0
40,370,370,61,40,21,2,1
16,404,404,7,7,0,1,0
7,407,407,23,13,10,2,1
28,412,412,26,26,0,1,0
27,414,414,5,5,0,1,0
34,414,414,51,51,0,1,0
8,454,454,46,12,34,2,1
47,484,484,26,26,0,1,0
3,488,488,10,1,9,4,3
43,490,490,10,10,0,1,0
42,494,494,5,5,0,1,0
0,498,498,35,35,0,1,0

23,108,108,1,1,0,1,0
24,116,116,2,2,0,1,0
6,117,117,23,14,9,2,1
13,126,126,5,1,4,2,1
18,142,142,18,18,0,1,0
39,146,146,1,1,0,1,0
32,148,148,8,8,0,1,0
20,149,149,1,1,0,1,0
25,149,149,21,21,0,1,0
45,167,167,1,1,0,1,0
11,173,173,4,4,0,1,0
2,178,178,2,2,0,1,0
16,192,192,3,3,0,1,0
21,193,193,1,1,0,1,0
0,201,201,4,4,0,1,0
12,205,205,8,8,0,1,0
28,208,208,12,12,0,1,0
22,223,223,36,3,33,4,3
31,226,226,23,23,0,1,0
10,229,229,56,48,8,3,2
38,240,240,9,9,0,1,0
9,241,241,11,11,0,1,0
27,244,244,8,3,5,2,1
46,246,246,35,20,15,2,1
26,271,271,47,4,43,2,1
42,273,273,11,11,0,1,0
34,291,291,45,11,34,2,1
36,293,293,51,51,0,1,0
8,303,303,13,13,0,1,0
17,309,309,5,5,0,1,0
37,312,312,7,2,5,2,1
15,313,313,62,62,0,1,0
33,324,324,21,21,0,1,0
44,339,339,29,7,22,2,1
43,341,341,18,6,12,4,3
4,347,347,2,2,0,1,0
35,350,350,41,4,37,4,3
14,361,361,1,1,0,1,0
7,377,377,13,7,6,2,1
40,378,378,12,7,5,2,1
30,389,389,11,2,9,4,3
29,415,415,33,33,0,1,0
1,429,429,48,21,27,2,1
3,439,439,1,1,0,1,0
41,440,440,31,31,0,1,0
5,452,452,9,9,0,1,0
19,490,490,50,6,44,3,2
47,491,491,327,210,117,4,3

23,106,106,4,4,0,1,0
10,122,122,14,14,0,1,0
16,159,159,8,8,0,1,0
24,192,192,50,23,27,2,1
29,198,198,26,2,24,4,3
5,205,205,1,1,0,1,0
26,250,250,6,6,0,1,0
27,256,256,3,3,0,1,0
15,305,305,16,16,0,1,0
32,307,307,113,113,0,1,0
30,307,307,11,11,0,1,0
13,330,330,78,22,56,4,3
8,332,332,87,55,32,3,2
0,333,333,1,1,0,1,0
3,335,335,64,64,0,1,0
28,349,349,30,24,6,3,2
22,351,351,42,23,19,2,1
4,355,355,62,62,0,1,0
1,358,358,45,24,21,4,3
20,363,363,27,27,0,1,0
31,379,379,15,15,0,1,0
2,379,379,3,3,0,1,0
9,396,396,100,7,93,4,3
21,399,399,10,1,9,2,1
25,399,399,74,74,0,1,0
7,426,426,42,42,0,1,0
14,438,438,23,5,18,4,3
17,448,448,22,22,0,1,0
12,451,451,2,2,0,1,0
18,470,470,39,26,13,3,2
19,472,472,114,82,32,3,2
11,495,495,194,194,0,1,0
6,497,497,16,16,0,1,0

21,102,102,5,5,0,1,0
5,105,105,2,2,0,1,0
8,107,107,11,2,9,2,1
9,120,120,5,5,0,1,0
20,123,123,4,4,0,1,0
32,126,126,11,11,0,1,0
18,138,138,8,5,3,2,1
16,148,148,13,13,0,1,0
22,154,154,20,7,13,2,1
30,160,160,7,3,4,2,1
1,173,173,48,48,0,1,0
12,183,183,5,5,0,1,0
13,200,200,9,9,0,1,0
3,219,219,54,24,30,3,2
31,235,235,45,45,0,1,0
11,247,247,1,1,0,1,0
19,255,255,2,2,0,1,0
27,268,268,73,73,0,1,0
26,294,294,37,27,10,3,2
0,298,298,7,1,6,3,2
4,310,310,30,30,0,1,0
15,334,334,30,30,0,1,0
6,335,335,47,47,0,1,0
24,356,356,70,38,32,4,3
7,358,358,35,35,0,1,0
14,370,370,157,40,117,4,3
10,396,396,4,4,0,1,0
28,414,414,5,5,0,1,0
2,428,428,330,330,0,1,0
17,436,436,6,6,0,1,0
29,440,440,12,12,0,1,0
25,454,454,20,2,18,3,2
23,457,457,24,15,9,4,3

2,102,102,8,8,0,1,0
20,127,127,4,4,0,1,0
30,130,130,6,6,0,1,0
10,131,131,1,1,0,1,0
17,150,150,30,10,20,3,2
23,164,164,40,21,19,2,1
15,178,178,21,21,0,1,0
22,203,203,11,4,7,2,1
26,216,216,6,6,0,1,0
28,231,231,11,3,8,2,1
16,233,233,80,55,25,4,3
13,241,241,13,13,0,1,0
18,249,249,13,13,0,1,0
7,260,260,83,83,0,1,0
21,282,282,15,15,0,1,0
1,283,283,43,9,34,3,2
9,307,307,7,7,0,1,0
25,313,313,15,15,0,1,0
0,331,331,9,9,0,1,0
19,348,348,46,11,35,3,2
5,366,366,161,161,0,1,0
8,369,369,42,9,33,4,3
12,394,394,59,59,0,1,0
27,395,395,7,7,0,1,0
11,396,396,138,138,0,1,0
24,422,422,23,23,0,1,0
29,428,428,90,66,24,4,3
3,441,441,113,32,81,4,3
4,449,449,2,2,0,1,0
14,465,465,31,2,29,2,1
6,494,494,65,50,15,4,3

31,111,111,35,35,0,1,0
13,115,115,18,11,7,2,1
28,129,129,14,3,11,2,1
25,136,136,3,3,0,1,0
14,158,158,5,5,0,1,0
32,160,160,15,15,0,1,0
2,169,169,14,14,0,1,0
7,181,181,1,1,0,1,0
23,194,194,46,46,0,1,0
8,199,199,42,42,0,1,0
35,209,209,7,7,0,1,0
19,234,234,9,9,0,1,0
1,235,235,59,10,49,2,1
21,239,239,34,34,0,1,0
27,249,249,67,34,33,4,3
5,258,258,9,9,0,1,0
36,287,287,41,41,0,1,0
33,288,288,21,6,15,4,3
6,293,293,17,10,7,2,1
30,294,294,14,14,0,1,0
26,315,315,5,2,3,2,1
16,347,347,18,10,8,2,1
0,372,372,8,2,6,3,2
37,380,380,4,1,3,2,1
10,387,387,24,4,20,2,1
20,392,392,11,11,0,1,0
4,403,403,55,11,44,4,3
11,446,446,1,1,0,1,0
38,447,447,21,21,0,1,0
12,464,464,20,3,17,2,1
9,465,465,10,5,5,2,1
3,468,468,89,32,57,4,3
24,470,470,8,2,6,2,1
22,485,485,68,68,0,1,0
18,487,487,104,104,0,1,0
17,488,488,38,21,17,2,1
29,490,490,13,13,0,1,0
15,491,491,103,1,102,4,3
34,495,495,84,45,39,2,1

16,111,111,7,7,0,1,0
28,114,114,26,11,15,4,3
25,142,142,2,2,0,1,0
20,142,142,2,2,0,1,0
18,144,144,69,3,66,4,3
12,157,157,2,2,0,1,0
10,163,163,80,40,40,2,1
15,173,173,5,1,4,2,1
2,175,175,8,2,6,2,1
6,179,179,55,18,37,2,1
30,193,193,21,9,12,3,2
14,208,208,20,2,18,3,2
27,226,226,38,38,0,1,0
22,242,242,10,1,9,2,1
24,273,273,23,15,8,3,2
17,275,275,37,37,0,1,0
29,294,294,4,4,0,1,0
11,336,336,8,8,0,1,0
3,350,350,53,53,0,1,0
9,366,366,3,3,0,1,0
21,368,368,37,37,0,1,0
0,368,368,26,26,0,1,0
1,377,377,81,49,32,3,2
23,383,383,22,10,12,2,1
4,399,399,40,11,29,2,1
8,412,412,15,15,0,1,0
26,415,415,43,43,0,1,0
7,442,442,166,121,45,2,1
13,450,450,75,33,42,3,2
5,450,450,34,16,18,4,3
19,494,494,15,15,0,1,0

17,101,101,14,14,0,1,0
5,117,117,12,4,8,2,1
22,142,142,11,7,4,2,1
26,146,146,40,40,0,1,0
13,148,148,77,17,60,3,2
31,159,159,1,1,0,1,0
1,159,159,2,2,0,1,0
23,175,175,9,9,0,1,0
27,178,178,22,22,0,1,0
9,190,190,16,11,5,2,1
2,198,198,95,3,92,3,2
25,199,199,15,15,0,1,0
21,200,200,18,18,0,1,0
4,206,206,1,1,0,1,0
0,210,210,4,4,0,1,0
7,211,211,49,7,42,4,3
33,213,213,22,7,15,4,3
15,240,240,7,7,0,1,0
18,244,244,7,7,0,1,0
12,282,282,34,34,0,1,0
3,287,287,23,23,0,1,0
8,296,296,45,4,41,2,1
16,297,297,32,2,30,3,2
29,298,298,14,14,0,1,0
24,311,311,15,15,0,1,0
11,346,346,13,13,0,1,0
20,356,356,43,43,0,1,0
28,369,369,9,9,0,1,0
19,410,410,14,5,9,4,3
6,413,413,2,2,0,1,0
10,414,414,17,12,5,2,1
14,416,416,4,4,0,1,0
30,468,468,119,91,28,3,2
32,493,493,151,37,114,4,3

8,120,120,5,5,0,1,0
26,135,135,11,1,10,3,2
18,137,137,15,5,10,3,2
15,140,140,16,3,13,4,3
30,143,143,48,48,0,1,0
33,144,144,10,3,7,2,1
24,154,154,9,1,8,3,2
31,156,156,7,4,3,2,1
29,169,169,18,18,0,1,0
17,204,204,37,37,0,1,0
12,214,214,11,11,0,1,0
21,221,221,8,8,0,1,0
27,237,237,2,2,0,1,0
25,239,239,17,17,0,1,0
16,246,246,37,8,29,2,1
14,260,260,32,32,0,1,0
23,283,283,17,17,0,1,0
13,284,284,1,1,0,1,0
7,303,303,28,17,11,2,1
2,305,305,2,2,0,1,0
5,307,307,75,48,27,4,3
1,346,346,90,6,84,3,2
28,358,358,32,32,0,1,0
22,365,365,2,2,0,1,0
11,366,366,6,6,0,1,0
9,369,369,29,20,9,4,3
32,392,392,36,36,0,1,0
20,409,409,32,32,0,1,0
3,411,411,26,5,21,4,3
0,420,420,151,133,18,2,1
19,428,428,106,31,75,4,3
10,481,481,201,185,16,2,1
4,493,493,63,23,40,3,2
6,497,497,8,3,5,2,1

39,102,102,1,1,0,1,0
11,109,109,5,5,0,1,0
22,114,114,4,4,0,1,0
35,116,116,5,5,0,1,0
8,120,120,4,1,3,2,1
26,130,130,8,8,0,1,0
27,157,157,3,3,0,1,0
6,169,169,5,5,0,1,0
7,194,194,21,21,0,1,0
23,207,207,48,44,4,2,1
14,230,230,10,10,0,1,0
31,236,236,9,9,0,1,0
17,245,245,1,1,0,1,0
20,257,257,3,3,0,1,0
3,276,276,27,27,0,1,0
4,276,276,13,13,0,1,0
37,283,283,15,15,0,1,0
19,294,294,101,17,84,4,3
24,295,295,56,56,0,1,0
25,302,302,130,130,0,1,0
33,306,306,3,3,0,1,0
9,309,309,30,30,0,1,0
0,328,328,32,22,10,2,1
15,329,329,3,3,0,1,0
1,334,334,27,8,19,2,1
36,334,334,35,15,20,2,1
38,341,341,3,3,0,1,0
21,346,346,56,37,19,4,3
30,352,352,34,8,26,3,2
12,373,373,109,43,66,4,3
34,379,379,25,4,21,4,3
29,402,402,20,20,0,1,0
28,420,420,142,114,28,4,3
2,433,433,27,15,12,4,3
18,447,447,9,9,0,1,0
13,471,471,1,1,0,1,0
32,473,473,2,2,0,1,0
16,480,480,78,78,0,1,0
10,486,486,62,62,0,1,0
5,499,499,92,92,0,1,0

31,107,107,13,5,8,3,2
9,111,111,1,1,0,1,0
32,117,117,13,13,0,1,0
15,119,119,11,1,10,3,2
8,124,124,15,15,0,1,0
10,170,170,13,1,12,3,2
1,179,179,13,13,0,1,0
14,181,181,7,3,4,2,1
35,218,218,45,45,0,1,0
24,230,230,20,20,0,1,0
30,230,230,9,3,6,3,2
0,232,232,22,22,0,1,0
12,233,233,4,4,0,1,0
13,256,256,18,18,0,1,0
5,256,256,65,17,48,4,3
3,264,264,2,2,0,1,0
4,291,291,6,6,0,1,0
26,303,303,6,3,3,2,1
7,310,310,44,2,42,3,2
18,348,348,26,20,6,2,1
23,368,368,10,4,6,2,1
20,373,373,14,14,0,1,0
16,382,382,31,12,19,2,1
22,387,387,13,13,0,1,0
19,411,411,155,97,58,3,2
11,411,411,104,76,28,3,2
28,442,442,99,59,40,3,2
21,446,446,23,12,11,2,1
27,457,457,39,39,0,1,0
25,466,466,69,15,54,3,2
34,472,472,4,4,0,1,0
33,475,475,86,65,21,3,2
17,477,477,15,15,0,1,0
29,489,489,33,27,6,3,2
2,490,490,97,82,15,4,3
6,492,492,173,154,19,2,1

15,100,100,14,14,0,1,0
35,102,102,2,2,0,1,0
30,112,112,10,1,9,2,1
8,125,125,4,4,0,1,0
2,137,137,22,7,15,4,3
29,143,143,12,12,0,1,0
6,163,163,3,3,0,1,0
7,179,179,13,2,11,4,3
33,182,182,9,4,5,2,1
14,188,188,5,5,0,1,0
25,199,199,12,2,10,3,2
21,206,206,22,10,12,4,3
10,207,207,83,83,0,1,0
26,212,212,12,1,11,3,2
4,214,214,9,3,6,3,2
19,230,230,44,1,43,4,3
17,247,247,14,2,12,4,3
32,266,266,55,30,25,2,1
16,268,268,3,3,0,1,0
24,275,275,14,11,3,2,1
18,290,290,43,9,34,2,1
1,314,314,12,12,0,1,0
23,315,315,16,16,0,1,0
13,316,316,9,6,3,2,1
34,319,319,124,69,55,3,2
36,348,348,47,42,5,2,1
11,355,355,9,9,0,1,0
22,363,363,47,6,41,2,1
5,366,366,18,14,4,2,1
0,374,374,12,12,0,1,0
27,399,399,28,28,0,1,0
3,407,407,2,2,0,1,0
12,408,408,43,43,0,1,0
20,419,419,88,24,64,3,2
37,433,433,15,3,12,2,1
38,440,440,42,42,0,1,0
9,450,450,48,13,35,4,3
39,460,460,78,78,0,1,0
28,468,468,5,1,4,2,1
31,477,477,60,15,45,4,3

37,100,100,7,7,0,1,0
4,101,101,17,7,10,3,2
29,107,107,1,1,0,1,0
8,108,108,12,12,0,1,0
2,112,112,30,30,0,1,0
11,118,118,4,4,0,1,0
33,122,122,19,8,11,2,1
25,127,127,13,13,0,1,0
38,132,132,29,29,0,1,0
13,137,137,3,3,0,1,0
36,140,140,4,4,0,1,0
1,146,146,29,23,6,3,2
7,149,149,5,5,0,1,0
6,155,155,26,26,0,1,0
32,167,167,11,11,0,1,0
28,184,184,19,1,18,2,1
42,204,204,13,13,0,1,0
23,204,204,17,1,16,3,2
3,237,237,1,1,0,1,0
16,239,239,41,5,36,2,1
27,241,241,12,6,6,3,2
5,261,261,12,12,0,1,0
9,273,273,21,21,0,1,0
34,273,273,8,2,6,3,2
24,281,281,11,8,3,2,1
12,282,282,15,12,3,2,1
31,310,310,24,24,0,1,0
0,311,311,1,1,0,1,0
19,315,315,10,1,9,4,3
15,333,333,2,2,0,1,0
18,373,373,5,5,0,1,0
40,374,374,119,119,0,1,0
14,376,376,21,6,15,2,1
20,381,381,25,19,6,3,2
17,388,388,5,5,0,1,0
26,394,394,10,2,8,2,1
22,450,450,67,67,0,1,0
30,453,453,17,13,4,2,1
35,457,457,12,12,0,1,0
41,475,475,200,89,111,4,3
21,484,484,58,8,50,2,1
39,490,490,46,5,41,2,1
10,491,491,4,4,0,1,0

7,105,105,8,8,0,1,0
12,117,117,16,16,0,1,0
29,123,123,8,3,5,2,1
37,132,132,1,1,0,1,0
26,150,150,28,3,25,2,1
9,159,159,31,4,27,4,3
17,167,167,26,26,0,1,0
32,170,170,55,25,30,2,1
27,173,173,2,2,0,1,0
3,217,217,31,11,20,3,2
1,243,243,20,20,0,1,0
21,261,261,22,22,0,1,0
16,263,263,73,53,20,3,2
18,271,271,25,25,0,1,0
20,273,273,41,23,18,2,1
28,281,281,56,14,42,4,3
25,282,282,23,20,3,2,1
36,284,284,6,6,0,1,0
5,291,291,7,7,0,1,0
2,294,294,1,1,0,1,0
8,298,298,15,15,0,1,0
23,307,307,37,11,26,3,2
4,322,322,23,13,10,2,1
10,371,371,18,18,0,1,0
6,384,384,30,30,0,1,0
13,385,385,67,55,12,4,3
14,396,396,17,1,16,3,2
35,403,403,46,46,0,1,0
33,420,420,142,119,23,4,3
19,421,421,20,14,6,3,2
24,449,449,5,2,3,2,1
38,453,453,6,6,0,1,0
0,462,462,15,15,0,1,0
11,465,465,6,6,0,1,0
34,470,470,59,59,0,1,0
31,476,476,9,9,0,1,0
15,494,494,77,11,66,4,3
30,496,496,12,12,0,1,0
22,499,499,19,19,0,1,0

29,114,114,62,62,0,1,0
13,121,121,6,6,0,1,0
35,124,124,23,23,0,1,0
8,125,125,1,1,0,1,0
25,132,132,1,1,0,1,0
21,141,141,13,13,0,1,0
27,154,154,1,1,0,1,0
0,158,158,41,38,3,2,1
9,160,160,32,32,0,1,0
37,165,165,19,8,11,2,1
28,173,173,6,6,0,1,0
32,198,198,23,5,18,4,3
17,198,198,7,7,0,1,0
30,208,208,1,1,0,1,0
11,222,222,2,2,0,1,0
7,224,224,13,13,0,1,0
20,224,224,45,45,0,1,0
19,246,246,1,1,0,1,0
18,262,262,1,1,0,1,0
23,277,277,31,16,15,2,1
2,277,277,19,19,0,1,0
38,296,296,7,7,0,1,0
4,313,313,101,74,27,4,3
33,324,324,56,24,32,3,2
10,339,339,15,15,0,1,0
26,347,347,15,15,0,1,0
14,349,349,26,26,0,1,0
36,352,352,20,20,0,1,0
3,358,358,34,34,0,1,0
5,370,370,44,44,0,1,0
34,387,387,65,65,0,1,0
39,394,394,18,18,0,1,0
24,410,410,21,21,0,1,0
12,410,410,15,4,11,2,1
15,440,440,99,72,27,4,3
31,449,449,24,5,19,2,1
1,450,450,2,2,0,1,0
6,485,485,17,11,6,2,1
16,498,498,24,24,0,1,0
22,499,499,62,13,49,2,1

20,109,109,2,2,0,1,0
22,112,112,22,6,16,3,2
15,118,118,6,1,5,2,1
4,136,136,1,1,0,1,0
13,140,140,8,4,4,2,1
34,143,143,4,4,0,1,0
32,151,151,15,5,10,2,1
25,167,167,42,42,0,1,0
7,192,192,54,54,0,1,0
17,193,193,23,15,8,2,1
26,194,194,33,33,0,1,0
28,202,202,3,3,0,1,0
37,213,213,33,5,28,2,1
18,216,216,11,11,0,1,0
23,227,227,11,5,6,3,2
38,246,246,8,8,0,1,0
21,254,254,15,7,8,3,2
9,316,316,1,1,0,1,0
36,318,318,61,61,0,1,0
2,321,321,6,2,4,2,1
10,324,324,38,4,34,2,1
11,336,336,133,45,88,3,2
12,341,341,17,17,0,1,0
8,343,343,71,71,0,1,0
24,346,346,7,2,5,2,1
6,359,359,33,33,0,1,0
1,362,362,27,27,0,1,0
29,372,372,33,33,0,1,0
3,396,396,27,1,26,2,1
14,400,400,3,3,0,1,0
33,418,418,102,66,36,4,3
19,423,423,91,91,0,1,0
30,442,442,19,19,0,1,0
16,452,452,25,25,0,1,0
35,452,452,31,4,27,4,3
0,478,478,10,2,8,3,2
5,488,488,4,4,0,1,0
27,491,491,33,24,9,4,3
31,497,497,74,29,45,4,3

6,110,110,9,2,7,2,1
5,113,113,5,5,0,1,0
13,128,128,16,4,12,2,1
0,134,134,75,45,30,2,1
1,146,146,5,5,0,1,0
14,166,166,1,1,0,1,0
31,181,181,15,15,0,1,0
30,184,184,27,27,0,1,0
20,190,190,5,2,3,2,1
2,196,196,24,24,0,1,0
24,246,246,29,17,12,3,2
27,263,263,7,7,0,1,0
9,266,266,4,4,0,1,0
3,273,273,11,5,6,2,1
19,278,278,36,36,0,1,0
15,281,281,24,6,18,3,2
32,285,285,12,12,0,1,0
23,294,294,38,38,0,1,0
17,297,297,15,15,0,1,0
11,324,324,32,3,29,4,3
25,335,335,19,19,0,1,0
8,348,348,133,51,82,3,2
22,350,350,49,49,0,1,0
26,363,363,2,2,0,1,0
33,370,370,27,27,0,1,0
12,371,371,19,3,16,3,2
4,372,372,19,19,0,1,0
7,416,416,4,4,0,1,0
34,436,436,24,24,0,1,0
16,453,453,11,11,0,1,0
10,459,459,90,52,38,2,1
28,468,468,159,159,0,1,0
21,478,478,113,64,49,4,3
18,489,489,102,102,0,1,0
29,498,498,21,3,18,2,1

24,110,110,3,3,0,1,0
9,113,113,4,4,0,1,0
0,151,151,17,4,13,2,1
31,184,184,55,12,43,2,1
8,186,186,5,2,3,2,1
28,225,225,6,6,0,1,0
21,227,227,15,3,12,4,3
11,249,249,26,26,0,1,0
7,279,279,47,47,0,1,0
14,287,287,24,18,6,2,1
22,318,318,118,118,0,1,0
30,326,326,61,35,26,3,2
16,345,345,4,1,3,2,1
27,363,363,7,1,6,3,2
10,371,371,4,4,0,1,0
23,389,389,13,13,0,1,0
6,395,395,17,5,12,4,3
2,409,409,19,19,0,1,0
29,413,413,95,11,84,3,2
4,432,432,79,13,66,3,2
17,445,445,12,12,0,1,0
13,447,447,22,22,0,1,0
18,448,448,7,7,0,1,0
25,448,448,12,12,0,1,0
15,452,452,71,71,0,1,0
5,460,460,256,184,72,3,2
19,470,470,79,40,39,4,3
26,474,474,49,49,0,1,0
1,475,475,222,132,90,4,3
3,477,477,7,1,6,2,1
20,482,482,15,15,0,1,0
12,500,500,66,66,0,1,0

26,115,115,4,1,3,2,1
23,123,123,20,20,0,1,0
12,151,151,4,4,0,1,0
33,183,183,35,35,0,1,0
4,194,194,37,37,0,1,0
17,196,196,48,48,0,1,0
3,203,203,7,7,0,1,0
5,218,218,6,6,0,1,0
10,221,221,46,12,34,2,1
22,243,243,3,3,0,1,0
29,249,249,12,12,0,1,0
30,250,250,19,19,0,1,0
21,252,252,32,32,0,1,0
25,255,255,16,16,0,1,0
13,257,257,20,20,0,1,0
7,258,258,17,17,0,1,0
28,269,269,21,21,0,1,0
31,285,285,47,47,0,1,0
0,306,306,37,37,0,1,0
1,354,354,51,21,30,3,2
27,362,362,1,1,0,1,0
14,364,364,49,39,10,2,1
11,383,383,59,26,33,4,3
9,397,397,79,15,64,3,2
16,398,398,10,2,8,2,1
8,423,423,5,1,4,2,1
24,428,428,41,41,0,1,0
32,439,439,22,22,0,1,0
6,448,448,56,56,0,1,0
15,470,470,47,33,14,3,2
2,478,478,182,182,0,1,0
18,480,480,75,66,9,4,3
20,495,495,100,52,48,2,1
19,499,499,48,4,44,4,3

19,113,113,18,1,17,2,1
31,127,127,9,4,5,2,1
8,135,135,19,19,0,1,0
2,140,140,2,2,0,1,0
11,161,161,4,4,0,1,0
22,170,170,15,7,8,3,2
7,181,181,30,20,10,2,1
3,185,185,33,33,0,1,0
9,190,190,16,2,14,4,3
21,193,193,29,20,9,4,3
12,194,194,17,17,0,1,0
23,203,203,5,5,0,1,0
5,224,224,32,32,0,1,0
25,227,227,12,1,11,2,1
15,246,246,4,4,0,1,0
24,283,283,18,18,0,1,0
13,291,291,7,7,0,1,0
4,313,313,40,40,0,1,0
20,331,331,45,45,0,1,0
16,337,337,49,49,0,1,0
1,372,372,46,26,20,3,2
28,379,379,15,9,6,2,1
30,387,387,13,2,11,2,1
26,391,391,56,56,0,1,0
18,399,399,59,59,0,1,0
27,409,409,62,19,43,2,1
6,419,419,99,75,24,4,3
29,436,436,80,80,0,1,0
10,462,462,20,20,0,1,0
0,464,464,248,179,69,3,2
17,468,468,4,4,0,1,0
14,468,468,137,113,24,4,3

12,102,102,21,21,0,1,0
18,116,116,64,64,0,1,0
17,125,125,25,25,0,1,0
25,139,139,2,2,0,1,0
13,171,171,24,24,0,1,0
10,175,175,55,22,33,4,3
15,180,180,24,24,0,1,0
32,215,215,2,2,0,1,0
30,239,239,7,3,4,2,1
20,245,245,22,22,0,1,0
8,266,266,52,4,48,3,2
11,266,266,18,18,0,1,0
2,275,275,24,24,0,1,0
29,279,279,14,14,0,1,0
33,289,289,4,4,0,1,0
4,300,300,17,1,16,3,2
0,311,311,40,35,5,2,1
21,312,312,33,33,0,1,0
28,329,329,2,2,0,1,0
6,360,360,31,25,6,2,1
14,366,366,40,2,38,3,2
31,368,368,70,24,46,2,1
19,377,377,41,41,0,1,0
5,395,395,19,19,0,1,0
16,403,403,15,6,9,4,3
27,431,431,3,3,0,1,0
3,434,434,101,57,44,4,3
22,461,461,52,20,32,2,1
24,465,465,68,48,20,3,2
9,465,465,26,10,16,4,3
23,470,470,55,5,50,3,2
1,486,486,54,42,12,4,3
7,491,491,30,30,0,1,0
26,498,498,9,9,0,1,0

20,101,101,3,3,0,1,0
14,107,107,12,12,0,1,0
35,120,120,30,30,0,1,0
7,124,124,13,10,3,2,1
6,132,132,40,40,0,1,0
18,135,135,31,19,12,3,2
9,148,148,19,12,7,2,1
34,153,153,1,1,0,1,0
24,168,168,5,1,4,2,1
5,181,181,5,5,0,1,0
12,196,196,1,1,0,1,0
27,200,200,43,43,0,1,0
26,225,225,9,4,5,2,1
19,236,236,14,1,13,4,3
10,238,238,7,1,6,2,1
13,239,239,38,28,10,3,2
28,243,243,44,14,30,4,3
15,252,252,20,2,18,2,1
29,254,254,1,1,0,1,0
16,270,270,11,11,0,1,0
25,282,282,5,2,3,2,1
17,305,305,12,12,0,1,0
23,324,324,8,2,6,2,1
8,325,325,18,3,15,2,1
22,339,339,2,2,0,1,0
2,356,356,19,1,18,4,3
31,366,366,19,9,10,3,2
1,380,380,29,29,0,1,0
32,386,386,141,39,102,4,3
11,397,397,104,81,23,2,1
4,407,407,48,48,0,1,0
30,413,413,80,42,38,3,2
21,418,418,35,35,0,1,0
0,419,419,4,4,0,1,0
3,445,445,132,132,0,1,0
36,457,457,11,2,9,2,1
33,479,479,60,52,8,2,1

34,105,105,2,2,0,1,0
36,110,110,2,2,0,1,0
7,129,129,3,3,0,1,0
20,147,147,7,1,6,3,2
6,147,147,8,2,6,3,2
25,150,150,12,1,11,2,1
12,153,153,15,15,0,1,0
4,170,170,5,1,4,2,1
38,176,176,7,7,0,1,0
9,203,203,8,8,0,1,0
31,219,219,5,5,0,1,0
19,224,224,11,11,0,1,0
32,233,233,12,12,0,1,0
30,235,235,14,14,0,1,0
35,236,236,12,2,10,2,1
37,245,245,11,3,8,3,2
0,253,253,26,20,6,2,1
14,253,253,28,7,21,4,3
3,257,257,55,55,0,1,0
15,259,259,67,67,0,1,0
11,273,273,1,1,0,1,0
29,274,274,53,53,0,1,0
33,288,288,26,26,0,1,0
17,291,291,35,35,0,1,0
18,297,297,47,2,45,2,1
27,306,306,60,60,0,1,0
24,307,307,88,16,72,4,3
41,327,327,42,17,25,2,1
22,380,380,9,9,0,1,0
23,383,383,12,12,0,1,0
10,392,392,6,6,0,1,0
40,400,400,44,44,0,1,0
42,402,402,131,66,65,3,2
16,411,411,39,39,0,1,0
28,416,416,55,17,38,3,2
2,437,437,74,74,0,1,0
26,457,457,11,11,0,1,0
13,464,464,24,24,0,1,0
8,470,470,74,11,63,4,3
21,472,472,20,20,0,1,0
5,474,474,2,2,0,1,0
1,486,486,1,1,0,1,0
39,490,490,34,34,0,1,0

12,104,104,7,7,0,1,0
22,109,109,20,3,17,2,1
4,112,112,3,3,0,1,0
20,112,112,12,12,0,1,0
2,129,129,14,14,0,1,0
33,129,129,19,19,0,1,0
16,131,131,10,1,9,2,1
35,141,141,21,8,13,3,2
25,148,148,8,3,5,2,1
5,162,162,2,2,0,1,0
38,199,199,8,8,0,1,0
28,211,211,54,18,36,3,2
27,223,223,2,2,0,1,0
23,224,224,21,11,10,3,2
9,233,233,15,15,0,1,0
10,236,236,4,4,0,1,0
1,241,241,7,4,3,2,1
15,246,246,12,12,0,1,0
19,248,248,38,38,0,1,0
8,255,255,14,6,8,2,1
34,259,259,64,11,53,4,3
30,280,280,6,6,0,1,0
13,286,286,42,23,19,2,1
11,289,289,25,1,24,3,2
32,290,290,8,4,4,2,1
36,293,293,56,56,0,1,0
3,303,303,22,18,4,2,1
39,329,329,52,11,41,2,1
6,329,329,1,1,0,1,0
18,335,335,31,6,25,2,1
37,341,341,23,23,0,1,0
7,347,347,56,56,0,1,0
29,351,351,32,21,11,2,1
24,413,413,5,5,0,1,0
31,414,414,35,1,34,3,2
17,438,438,72,42,30,2,1
26,457,457,51,51,0,1,0
14,464,464,124,41,83,4,3
0,466,466,67,67,0,1,0
21,479,479,2,2,0,1,0

16,105,105,1,1,0,1,0
11,113,113,9,2,7,2,1
30,125,125,38,23,15,4,3
33,128,128,17,6,11,2,1
21,129,129,5,5,0,1,0
38,159,159,9,1,8,3,2
41,165,165,20,20,0,1,0
22,167,167,5,5,0,1,0
28,175,175,19,19,0,1,0
40,181,181,9,9,0,1,0
1,191,191,25,25,0,1,0
39,192,192,32,7,25,2,1
35,192,192,22,8,14,3,2
19,198,198,19,10,9,4,3
15,229,229,40,40,0,1,0
37,235,235,30,21,9,4,3
0,260,260,39,39,0,1,0
34,274,274,4,4,0,1,0
8,284,284,12,12,0,1,0
2,291,291,1,1,0,1,0
14,299,299,11,1,10,3,2
12,302,302,27,8,19,2,1
13,326,326,16,1,15,4,3
4,332,332,23,23,0,1,0
18,349,349,16,6,10,2,1
9,354,354,39,39,0,1,0
31,354,354,5,5,0,1,0
26,365,365,2,2,0,1,0
23,371,371,34,34,0,1,0
29,380,380,40,29,11,2,1
42,385,385,24,6,18,2,1
20,385,385,3,3,0,1,0
32,389,389,105,82,23,4,3
36,404,404,20,12,8,2,1
10,406,406,67,10,57,4,3
27,423,423,43,11,32,2,1
17,442,442,46,3,43,2,1
3,448,448,5,5,0,1,0
6,462,462,72,18,54,4,3
5,474,474,96,72,24,2,1
7,474,474,3,3,0,1,0
24,497,497,53,53,0,1,0
25,498,498,17,17,0,1,0

5,110,110,4,4,0,1,0
40,114,114,1,1,0,1,0
16,128,128,1,1,0,1,0
29,134,134,15,15,0,1,0
12,150,150,15,15,0,1,0
1,162,162,14,2,12,4,3
31,165,165,5,1,4,2,1
33,174,174,52,16,36,2,1
14,175,175,7,7,0,1,0
2,181,181,4,4,0,1,0
27,191,191,21,7,14,3,2
35,195,195,7,7,0,1,0
42,201,201,3,3,0,1,0
6,203,203,15,2,13,2,1
10,208,208,29,20,9,4,3
19,217,217,6,2,4,2,1
17,222,222,14,14,0,1,0
24,246,246,1,1,0,1,0
9,255,255,30,30,0,1,0
7,261,261,48,48,0,1,0
36,278,278,15,11,4,2,1
37,286,286,111,71,40,4,3
3,286,286,7,7,0,1,0
38,304,304,19,19,0,1,0
25,318,318,22,22,0,1,0
20,321,321,38,38,0,1,0
15,348,348,15,15,0,1,0
18,362,362,16,1,15,2,1
11,379,379,79,27,52,3,2
4,398,398,2,2,0,1,0
39,398,398,41,29,12,4,3
23,399,399,21,9,12,4,3
34,400,400,5,2,3,2,1
26,407,407,46,9,37,2,1
21,409,409,18,10,8,2,1
8,419,419,16,16,0,1,0
0,437,437,103,103,0,1,0
13,447,447,4,4,0,1,0
22,448,448,81,69,12,4,3
28,451,451,7,1,6,2,1
32,464,464,148,148,0,1,0
30,482,482,54,4,50,2,1
41,499,499,33,13,20,3,2

2,101,101,18,6,12,4,3
32,128,128,14,14,0,1,0
36,166,166,9,9,0,1,0
33,180,180,27,27,0,1,0
19,194,194,47,47,0,1,0
35,201,201,16,4,12,4,3
12,204,204,47,47,0,1,0
1,215,215,8,8,0,1,0
16,222,222,10,10,0,1,0
7,233,233,1,1,0,1,0
23,237,237,21,21,0,1,0
4,265,265,4,4,0,1,0
28,271,271,21,21,0,1,0
21,276,276,55,1,54,3,2
10,291,291,12,3,9,4,3
14,300,300,8,8,0,1,0
18,302,302,14,14,0,1,0
11,304,304,25,25,0,1,0
24,328,328,24,6,18,2,1
9,333,333,29,4,25,2,1
22,334,334,12,7,5,2,1
25,346,346,2,2,0,1,0
29,352,352,1,1,0,1,0
15,372,372,125,17,108,4,3
20,373,373,73,73,0,1,0
27,388,388,53,36,17,2,1
31,389,389,46,46,0,1,0
3,391,391,76,51,25,2,1
34,402,402,71,71,0,1,0
38,420,420,104,54,50,2,1
30,434,434,40,40,0,1,0
0,445,445,71,16,55,3,2
5,466,466,2,2,0,1,0
37,473,473,4,4,0,1,0
17,485,485,4,4,0,1,0
13,485,485,18,8,10,2,1
6,488,488,3,3,0,1,0
26,491,491,39,39,0,1,0
8,497,497,60,6,54,3,2

22,158,158,33,33,0,1,0
17,159,159,6,3,3,2,1
44,160,160,5,5,0,1,0
13,165,165,1,1,0,1,0
35,175,175,17,17,0,1,0
15,181,181,4,4,0,1,0
45,203,203,106,83,23,2,1
18,203,203,1,1,0,1,0
19,209,209,64,17,47,2,1
3,214,214,13,9,4,2,1
29,216,216,14,4,10,3,2
21,231,231,15,15,0,1,0
37,235,235,25,11,14,3,2
8,235,235,25,2,23,2,1
43,236,236,12,3,9,4,3
33,238,238,12,12,0,1,0
16,244,244,3,3,0,1,0
28,259,259,15,7,8,3,2
4,273,273,71,71,0,1,0
34,277,277,8,8,0,1,0
36,278,278,48,48,0,1,0
14,281,281,2,2,0,1,0
42,283,283,6,6,0,1,0
6,289,289,25,11,14,3,2
40,301,301,23,23,0,1,0
41,309,309,1,1,0,1,0
38,317,317,56,56,0,1,0
5,321,321,19,3,16,2,1
2,343,343,3,3,0,1,0
30,359,359,76,76,0,1,0
9,369,369,2,2,0,1,0
46,378,378,2,2,0,1,0
32,396,396,2,2,0,1,0
26,405,405,17,10,7,2,1
7,441,441,5,5,0,1,0
12,448,448,17,1,16,3,2
20,455,455,9,9,0,1,0
25,468,468,36,10,26,2,1
11,476,476,14,14,0,1,0
27,481,481,4,4,0,1,0
10,482,482,35,35,0,1,0
24,483,483,146,101,45,4,3
1,487,487,7,2,5,2,1
31,494,494,110,97,13,2,1
39,497,497,17,17,0,1,0
0,499,499,11,3,8,2,1
23,499,499,3,3,0,1,0

25,100,100,18,18,0,1,0
27,100,100,2,2,0,1,0
18,114,114,5,5,0,1,0
10,127,127,1,1,0,1,0
1,129,129,12,8,4,2,1
8,140,140,100,100,0,1,0
16,167,167,22,10,12,3,2
9,171,171,13,13,0,1,0
6,173,173,5,5,0,1,0
2,219,219,25,25,0,1,0
0,227,227,21,9,12,2,1
7,233,233,94,70,24,4,3
23,252,252,16,16,0,1,0
3,257,257,3,3,0,1,0
13,262,262,30,4,26,4,3
26,273,273,71,56,15,2,1
20,285,285,27,27,0,1,0
12,306,306,9,6,3,2,1
21,325,325,18,18,0,1,0
24,327,327,28,28,0,1,0
30,331,331,73,73,0,1,0
28,333,333,16,16,0,1,0
31,344,344,7,1,6,2,1
5,356,356,3,3,0,1,0
32,366,366,53,53,0,1,0
14,389,389,30,30,0,1,0
29,403,403,17,17,0,1,0
15,423,423,11,11,0,1,0
19,432,432,101,15,86,3,2
11,449,449,1,1,0,1,0
17,455,455,44,9,35,2,1
4,464,464,95,59,36,4,3
22,466,466,45,45,0,1,0

5,107,107,12,12,0,1,0
12,107,107,2,2,0,1,0
28,132,132,5,2,3,2,1
3,143,143,2,2,0,1,0
16,166,166,35,35,0,1,0
41,169,169,6,1,5,2,1
10,177,177,5,5,0,1,0
35,181,181,28,4,24,4,3
22,193,193,16,16,0,1,0
29,203,203,86,17,69,3,2
7,211,211,11,11,0,1,0
32,219,219,7,7,0,1,0
36,221,221,27,5,22,3,2
31,229,229,23,5,18,2,1
18,250,250,40,40,0,1,0
4,256,256,15,15,0,1,0
39,267,267,7,7,0,1,0
11,285,285,49,31,18,2,1
26,286,286,55,13,42,4,3
30,299,299,6,2,4,2,1
6,299,299,3,3,0,1,0
37,302,302,26,19,7,2,1
13,303,303,59,12,47,3,2
14,323,323,1,1,0,1,0
42,325,325,17,17,0,1,0
44,335,335,13,9,4,2,1
15,335,335,58,42,16,3,2
38,354,354,36,32,4,2,1
0,380,380,10,10,0,1,0
27,389,389,2,2,0,1,0
25,389,389,9,9,0,1,0
19,390,390,23,14,9,2,1
1,391,391,8,4,4,2,1
34,392,392,38,31,7,2,1
21,396,396,56,56,0,1,0
43,397,397,2,2,0,1,0
20,398,398,16,16,0,1,0
40,404,404,28,17,11,2,1
2,417,417,4,4,0,1,0
17,420,420,7,7,0,1,0
24,422,422,23,13,10,2,1
23,423,423,10,10,0,1,0
33,448,448,150,114,36,4,3
8,475,475,33,7,26,2,1
9,493,493,62,62,0,1,0

32,110,110,4,4,0,1,0
35,119,119,28,28,0,1,0
40,124,124,13,13,0,1,0
19,139,139,1,1,0,1,0
3,151,151,2,2,0,1,0
22,151,151,19,19,0,1,0
0,153,153,7,1,6,2,1
4,159,159,22,7,15,2,1
34,161,161,23,23,0,1,0
28,178,178,5,5,0,1,0
25,196,196,8,1,7,2,1
6,222,222,15,15,0,1,0
37,244,244,11,11,0,1,0
15,254,254,19,19,0,1,0
16,257,257,17,17,0,1,0
42,274,274,27,6,21,3,2
8,275,275,26,26,0,1,0
14,277,277,76,16,60,4,3
38,279,279,2,2,0,1,0
26,288,288,61,14,47,2,1
9,290,290,105,64,41,3,2
5,307,307,18,18,0,1,0
24,307,307,6,1,5,2,1
23,312,312,35,10,25,2,1
7,315,315,10,10,0,1,0
27,337,337,50,11,39,2,1
17,343,343,1,1,0,1,0
41,363,363,4,4,0,1,0
1,366,366,23,8,15,2,1
30,368,368,18,18,0,1,0
21,402,402,8,3,5,2,1
2,405,405,9,3,6,3,2
29,410,410,150,150,0,1,0
39,435,435,57,23,34,4,3
31,437,437,62,25,37,3,2
20,443,443,28,28,0,1,0
12,447,447,1,1,0,1,0
10,448,448,11,4,7,2,1
33,450,450,15,1,14,2,1
11,451,451,52,52,0,1,0
36,456,456,41,26,15,4,3
18,473,473,29,29,0,1,0
13,483,483,26,26,0,1,0

5,104,104,3,3,0,1,0
36,108,108,29,15,14,3,2
10,124,124,11,11,0,1,0
4,165,165,2,2,0,1,0
19,165,165,20,20,0,1,0
20,167,167,6,6,0,1,0
32,178,178,28,28,0,1,0
6,194,194,23,7,16,3,2
15,214,214,11,1,10,2,1
31,238,238,1,1,0,1,0
34,243,243,2,2,0,1,0
14,255,255,43,43,0,1,0
2,263,263,13,7,6,3,2
17,264,264,2,2,0,1,0
11,276,276,14,14,0,1,0
27,278,278,3,3,0,1,0
29,282,282,16,5,11,2,1
40,309,309,9,9,0,1,0
22,329,329,85,85,0,1,0
37,335,335,53,23,30,2,1
38,342,342,90,70,20,2,1
30,347,347,22,3,19,2,1
33,351,351,32,32,0,1,0
1,361,361,16,16,0,1,0
9,371,371,5,1,4,2,1
21,379,379,23,23,0,1,0
23,388,388,74,50,24,4,3
28,388,388,7,1,6,3,2
35,402,402,102,25,77,4,3
26,423,423,13,13,0,1,0
39,424,424,25,25,0,1,0
25,426,426,15,3,12,4,3
13,432,432,35,3,32,3,2
3,441,441,151,151,0,1,0
24,452,452,70,70,0,1,0
0,452,452,33,21,12,2,1
41,484,484,38,12,26,3,2
16,486,486,12,12,0,1,0
7,493,493,12,3,9,4,3
12,497,497,24,24,0,1,0
18,498,498,33,33,0,1,0
8,500,500,66,38,28,3,2

0,102,102,13,1,12,2,1
43,113,113,4,4,0,1,0
37,117,117,34,34,0,1,0
18,123,123,5,1,4,2,1
15,140,140,5,5,0,1,0
25,142,142,2,2,0,1,0
5,151,151,11,11,0,1,0
33,174,174,9,4,5,2,1
6,180,180,12,12,0,1,0
4,192,192,7,7,0,1,0
11,193,193,2,2,0,1,0
13,197,197,17,8,9,2,1
10,202,202,3,3,0,1,0
8,208,208,8,8,0,1,0
35,210,210,26,26,0,1,0
14,210,210,15,2,13,2,1
40,243,243,13,2,11,2,1
22,250,250,23,23,0,1,0
9,253,253,45,2,43,2,1
28,257,257,30,11,19,2,1
27,261,261,23,6,17,2,1
36,265,265,4,4,0,1,0
30,290,290,46,46,0,1,0
34,335,335,39,35,4,2,1
42,349,349,66,66,0,1,0
16,351,351,1,1,0,1,0
32,355,355,78,12,66,3,2
41,366,366,40,36,4,2,1
31,370,370,13,9,4,2,1
38,380,380,25,25,0,1,0
24,382,382,91,91,0,1,0
7,393,393,6,6,0,1,0
1,408,408,11,11,0,1,0
20,410,410,12,12,0,1,0
12,413,413,35,28,7,2,1
26,421,421,4,4,0,1,0
19,455,455,63,63,0,1,0
2,458,458,1,1,0,1,0
23,462,462,3,3,0,1,0
3,485,485,65,4,61,4,3
29,491,491,10,7,3,2,1
44,492,492,59,59,0,1,0
21,493,493,64,64,0,1,0
17,495,495,104,80,24,3,2
39,500,500,56,56,0,1,0

38,104,104,16,16,0,1,0
1,135,135,1,1,0,1,0
36,136,136,6,6,0,1,0
9,169,169,14,14,0,1,0
34,199,199,51,7,44,3,2
11,239,239,13,5,8,2,1
19,249,249,8,8,0,1,0
22,254,254,74,57,17,2,1
10,256,256,5,5,0,1,0
30,258,258,1,1,0,1,0
27,260,260,9,6,3,2,1
26,275,275,13,13,0,1,0
2,277,277,9,9,0,1,0
24,290,290,6,6,0,1,0
29,295,295,3,3,0,1,0
17,297,297,38,38,0,1,0
37,310,310,4,4,0,1,0
16,311,311,27,27,0,1,0
14,312,312,12,7,5,2,1
28,325,325,11,11,0,1,0
21,330,330,5,5,0,1,0
3,348,348,118,65,53,4,3
0,365,365,1,1,0,1,0
13,369,369,28,28,0,1,0
7,383,383,24,24,0,1,0
8,392,392,53,19,34,4,3
25,392,392,112,80,32,3,2
18,394,394,1,1,0,1,0
12,397,397,28,28,0,1,0
6,398,398,105,25,80,3,2
35,402,402,74,8,66,4,3
31,404,404,47,44,3,2,1
4,415,415,25,10,15,4,3
23,456,456,120,111,9,4,3
39,457,457,10,2,8,2,1
32,463,463,14,9,5,2,1
5,465,465,124,124,0,1,0
20,489,489,3,3,0,1,0
15,490,490,65,23,42,4,3
33,500,500,54,41,13,2,1

30,112,112,10,10,0,1,0
25,117,117,25,25,0,1,0
11,131,131,24,24,0,1,0
31,131,131,12,12,0,1,0
4,141,141,14,14,0,1,0
34,146,146,4,4,0,1,0
9,150,150,30,15,15,2,1
21,151,151,8,1,7,2,1
29,173,173,35,35,0,1,0
8,194,194,3,3,0,1,0
14,196,196,16,16,0,1,0
33,214,214,18,15,3,2,1
18,218,218,59,26,33,2,1
17,236,236,40,40,0,1,0
19,238,238,1,1,0,1,0
2,263,263,19,19,0,1,0
5,267,267,12,12,0,1,0
28,292,292,15,15,0,1,0
6,297,297,67,55,12,4,3
23,316,316,10,10,0,1,0
13,318,318,30,18,12,2,1
1,323,323,36,11,25,2,1
24,337,337,22,4,18,2,1
3,340,340,114,3,111,4,3
7,359,359,23,3,20,3,2
12,360,360,5,5,0,1,0
32,362,362,46,31,15,2,1
22,431,431,51,51,0,1,0
0,438,438,140,140,0,1,0
26,441,441,12,12,0,1,0
16,474,474,26,16,10,2,1
15,479,479,8,3,5,2,1
27,480,480,68,55,13,2,1
20,492,492,68,68,0,1,0
10,497,497,12,12,0,1,0

26,106,106,7,7,0,1,0
5,109,109,15,15,0,1,0
1,141,141,25,25,0,1,0
6,167,167,1,1,0,1,0
10,191,191,20,4,16,3,2
18,193,193,25,25,0,1,0
30,194,194,10,1,9,4,3
29,203,203,15,1,14,2,1
3,207,207,55,55,0,1,0
33,217,217,15,15,0,1,0
11,219,219,1,1,0,1,0
31,219,219,28,28,0,1,0
4,255,255,58,58,0,1,0
17,261,261,13,13,0,1,0
19,265,265,8,8,0,1,0
8,272,272,24,8,16,3,2
0,279,279,37,13,24,2,1
9,282,282,78,78,0,1,0
20,282,282,47,25,22,2,1
15,284,284,7,7,0,1,0
24,287,287,4,4,0,1,0
25,307,307,58,58,0,1,0
22,310,310,29,29,0,1,0
2,311,311,13,13,0,1,0
16,324,324,33,33,0,1,0
23,340,340,17,17,0,1,0
21,344,344,63,6,57,4,3
32,355,355,97,1,96,4,3
13,364,364,8,8,0,1,0
27,371,371,13,13,0,1,0
14,379,379,61,39,22,3,2
12,390,390,56,56,0,1,0
34,421,421,94,19,75,4,3
7,423,423,37,37,0,1,0
28,489,489,3,3,0,1,0

5,103,103,10,10,0,1,0
1,112,112,1,1,0,1,0
39,115,115,3,3,0,1,0
6,124,124,19,4,15,4,3
24,132,132,50,10,40,3,2
20,146,146,2,2,0,1,0
14,185,185,11,3,8,2,1
16,198,198,10,10,0,1,0
36,203,203,16,13,3,2,1
10,203,203,11,11,0,1,0
32,210,210,13,13,0,1,0
28,227,227,21,21,0,1,0
0,229,229,8,2,6,2,1
41,237,237,1,1,0,1,0
31,241,241,15,10,5,2,1
35,241,241,2,2,0,1,0
34,248,248,53,53,0,1,0
11,254,254,19,19,0,1,0
12,255,255,18,8,10,3,2
27,270,270,5,1,4,2,1
37,288,288,31,31,0,1,0
3,296,296,35,15,20,3,2
15,303,303,50,50,0,1,0
13,303,303,19,7,12,4,3
26,304,304,24,8,16,2,1
30,315,315,38,6,32,2,1
8,342,342,19,7,12,3,2
22,361,361,24,24,0,1,0
2,380,380,14,14,0,1,0
33,393,393,12,2,10,2,1
21,397,397,38,28,10,2,1
25,399,399,84,69,15,4,3
40,407,407,80,45,35,2,1
23,408,408,3,3,0,1,0
38,414,414,11,8,3,2,1
19,430,430,45,45,0,1,0
4,431,431,3,3,0,1,0
7,432,432,60,21,39,3,2
17,450,450,15,15,0,1,0
43,454,454,167,131,36,4,3
42,456,456,63,53,10,3,2
29,469,469,42,20,22,3,2
18,480,480,1,1,0,1,0
9,494,494,5,5,0,1,0

36,110,110,19,19,0,1,0
35,124,124,3,3,0,1,0
0,144,144,1,1,0,1,0
2,158,158,73,59,14,2,1
18,169,169,33,33,0,1,0
22,176,176,34,4,30,2,1
7,180,180,1,1,0,1,0
3,185,185,1,1,0,1,0
16,186,186,12,6,6,2,1
28,188,188,1,1,0,1,0
30,197,197,34,34,0,1,0
39,199,199,40,22,18,3,2
12,209,209,11,11,0,1,0
37,210,210,2,2,0,1,0
8,216,216,69,69,0,1,0
33,220,220,66,9,57,3,2
9,221,221,9,1,8,3,2
5,231,231,11,11,0,1,0
13,239,239,22,4,18,3,2
15,239,239,8,2,6,2,1
20,247,247,6,6,0,1,0
38,280,280,8,1,7,2,1
31,301,301,2,2,0,1,0
29,322,322,12,4,8,2,1
34,332,332,23,23,0,1,0
17,333,333,1,1,0,1,0
10,344,344,30,4,26,4,3
25,363,363,84,64,20,2,1
1,369,369,5,5,0,1,0
24,382,382,9,6,3,2,1
11,383,383,1,1,0,1,0
21,388,388,5,5,0,1,0
6,396,396,82,78,4,2,1
26,409,409,62,12,50,2,1
40,430,430,44,11,33,2,1
32,431,431,12,1,11,4,3
19,439,439,35,2,33,4,3
14,454,454,2,2,0,1,0
23,458,458,59,59,0,1,0
4,459,459,65,37,28,3,2
27,498,498,24,3,21,4,3

42,103,103,6,3,3,2,1
25,129,129,2,2,0,1,0
31,129,129,13,13,0,1,0
22,132,132,7,2,5,2,1
8,150,150,1,1,0,1,0
24,159,159,4,4,0,1,0
13,180,180,19,5,14,2,1
26,182,182,42,35,7,2,1
27,196,196,48,13,35,4,3
21,198,198,12,3,9,4,3
43,201,201,22,22,0,1,0
16,208,208,4,4,0,1,0
5,222,222,18,11,7,3,2
35,224,224,56,56,0,1,0
38,225,225,9,1,8,2,1
6,239,239,16,12,4,2,1
14,256,256,14,6,8,2,1
7,268,268,15,5,10,2,1
15,271,271,13,7,6,3,2
2,275,275,9,2,7,2,1
1,291,291,27,1,26,3,2
37,293,293,4,4,0,1,0
30,296,296,3,3,0,1,0
36,297,297,3,3,0,1,0
4,300,300,10,10,0,1,0
29,301,301,36,11,25,2,1
17,305,305,6,1,5,2,1
23,324,324,3,3,0,1,0
34,327,327,48,3,45,4,3
9,327,327,3,3,0,1,0
19,348,348,61,53,8,2,1
33,352,352,49,25,24,3,2
0,360,360,62,18,44,2,1
11,361,361,23,23,0,1,0
44,365,365,72,72,0,1,0
28,370,370,32,2,30,4,3
39,373,373,23,23,0,1,0
10,379,379,2,2,0,1,0
32,386,386,20,20,0,1,0
40,416,416,24,1,23,4,3
18,418,418,66,18,48,3,2
12,444,444,115,64,51,3,2
41,457,457,4,4,0,1,0
3,467,467,7,7,0,1,0
20,471,471,127,94,33,2,1

15,106,106,21,21,0,1,0
3,127,127,30,12,18,2,1
23,130,130,12,8,4,2,1
4,136,136,1,1,0,1,0
17,159,159,27,8,19,4,3
10,164,164,61,46,15,4,3
21,190,190,35,28,7,2,1
13,190,190,1,1,0,1,0
27,210,210,3,3,0,1,0
29,213,213,20,20,0,1,0
8,215,215,44,44,0,1,0
14,229,229,56,32,24,2,1
32,262,262,20,20,0,1,0
0,267,267,37,37,0,1,0
6,270,270,7,7,0,1,0
5,309,309,12,12,0,1,0
33,321,321,11,11,0,1,0
18,337,337,56,56,0,1,0
2,337,337,35,14,21,4,3
25,352,352,21,13,8,2,1
12,352,352,13,13,0,1,0
20,377,377,44,44,0,1,0
11,397,397,19,7,12,2,1
26,408,408,24,12,12,4,3
9,414,414,62,62,0,1,0
1,429,429,39,30,9,2,1
22,435,435,4,4,0,1,0
24,439,439,37,4,33,4,3
28,441,441,5,5,0,1,0
7,462,462,92,62,30,3,2
30,483,483,33,5,28,3,2
16,489,489,191,191,0,1,0
31,493,493,1,1,0,1,0
19,494,494,54,4,50,3,2

39,119,119,13,1,12,4,3
27,123,123,12,5,7,2,1
24,129,129,10,1,9,4,3
17,150,150,20,20,0,1,0
30,158,158,39,26,13,2,1
28,186,186,32,20,12,3,2
3,195,195,12,12,0,1,0
10,214,214,20,20,0,1,0
16,218,218,1,1,0,1,0
22,226,226,49,49,0,1,0
9,234,234,9,9,0,1,0
40,238,238,18,6,12,4,3
32,244,244,17,6,11,2,1
21,253,253,34,34,0,1,0
13,280,280,31,31,0,1,0
31,287,287,15,1,14,3,2
15,288,288,12,12,0,1,0
18,295,295,21,21,0,1,0
25,295,295,35,35,0,1,0
4,306,306,105,60,45,4,3
2,310,310,18,18,0,1,0
36,318,318,6,6,0,1,0
1,326,326,19,12,7,2,1
37,335,335,5,1,4,2,1
12,337,337,79,74,5,2,1
0,346,346,2,2,0,1,0
26,356,356,24,24,0,1,0
19,363,363,26,12,14,2,1
35,365,365,8,8,0,1,0
20,368,368,21,21,0,1,0
11,388,388,15,3,12,4,3
5,433,433,1,1,0,1,0
6,437,437,54,54,0,1,0
14,443,443,7,2,5,2,1
7,448,448,22,19,3,2,1
34,456,456,42,3,39,2,1
33,469,469,89,70,19,3,2
23,491,491,30,30,0,1,0
8,491,491,76,76,0,1,0
38,491,491,97,49,48,4,3
29,500,500,20,20,0,1,0

1,104,104,13,4,9,2,1
12,108,108,25,25,0,1,0
2,121,121,1,1,0,1,0
36,122,122,12,5,7,2,1
42,124,124,9,9,0,1,0
21,135,135,13,3,10,2,1
14,145,145,5,5,0,1,0
17,147,147,10,1,9,2,1
41,160,160,23,9,14,3,2
19,172,172,1,1,0,1,0
34,172,172,13,13,0,1,0
27,177,177,45,25,20,3,2
7,178,178,10,10,0,1,0
32,211,211,12,12,0,1,0
10,218,218,5,1,4,2,1
25,234,234,7,3,4,2,1
13,250,250,4,4,0,1,0
23,269,269,51,51,0,1,0
9,280,280,5,5,0,1,0
40,280,280,17,8,9,4,3
4,294,294,38,38,0,1,0
31,301,301,30,27,3,2,1
33,305,305,7,7,0,1,0
22,305,305,58,4,54,4,3
15,312,312,69,69,0,1,0
6,321,321,5,1,4,2,1
38,336,336,22,22,0,1,0
26,346,346,41,41,0,1,0
20,349,349,62,26,36,2,1
29,360,360,53,21,32,2,1
5,362,362,32,15,17,2,1
8,365,365,11,11,0,1,0
18,393,393,18,18,0,1,0
3,402,402,6,6,0,1,0
16,403,403,38,12,26,3,2
35,421,421,40,8,32,2,1
39,425,425,40,2,38,2,1
11,431,431,9,9,0,1,0
24,436,436,30,30,0,1,0
30,439,439,90,20,70,4,3
28,455,455,84,84,0,1,0
0,464,464,1,1,0,1,0
37,498,498,24,3,21,2,1

30,118,118,14,14,0,1,0
15,119,119,40,40,0,1,0
36,128,128,4,1,3,2,1
33,134,134,1,1,0,1,0
28,157,157,1,1,0,1,0
29,166,166,51,12,39,2,1
7,194,194,4,4,0,1,0
14,195,195,22,22,0,1,0
31,226,226,29,29,0,1,0
23,227,227,25,8,17,2,1
12,229,229,39,27,12,4,3
21,239,239,25,8,17,3,2
19,245,245,6,6,0,1,0
1,263,263,42,42,0,1,0
5,263,263,17,8,9,4,3
25,267,267,31,14,17,2,1
32,269,269,7,7,0,1,0
3,274,274,8,8,0,1,0
24,288,288,33,3,30,2,1
6,303,303,17,2,15,4,3
13,312,312,19,11,8,3,2
37,334,334,73,73,0,1,0
4,336,336,10,10,0,1,0
17,348,348,67,67,0,1,0
9,357,357,60,60,0,1,0
16,367,367,3,3,0,1,0
34,368,368,3,3,0,1,0
10,377,377,49,28,21,2,1
2,392,392,1,1,0,1,0
27,404,404,2,2,0,1,0
22,409,409,58,58,0,1,0
20,443,443,46,22,24,3,2
8,445,445,23,15,8,2,1
26,462,462,11,8,3,2,1
11,462,462,1,1,0,1,0
35,463,463,158,40,118,4,3
18,477,477,22,22,0,1,0
0,493,493,128,42,86,3,2

36,105,105,22,6,16,3,2
26,107,107,8,4,4,2,1
13,110,110,10,10,0,1,0
34,124,124,2,2,0,1,0
7,129,129,4,4,0,1,0
1,142,142,7,7,0,1,0
18,160,160,2,2,0,1,0
6,164,164,19,13,6,2,1
33,168,168,43,31,12,2,1
10,182,182,3,3,0,1,0
20,183,183,3,3,0,1,0
5,192,192,2,2,0,1,0
38,197,197,8,8,0,1,0
12,212,212,21,5,16,2,1
39,224,224,4,1,3,2,1
35,233,233,12,9,3,2,1
25,241,241,80,80,0,1,0
37,266,266,23,23,0,1,0
8,274,274,10,10,0,1,0
17,277,277,195,82,113,4,3
30,279,279,30,19,11,2,1
19,304,304,4,4,0,1,0
15,326,326,5,5,0,1,0
29,335,335,12,12,0,1,0
27,344,344,55,39,16,3,2
9,346,346,48,48,0,1,0
4,395,395,29,29,0,1,0
11,426,426,3,3,0,1,0
14,429,429,2,2,0,1,0
40,430,430,87,87,0,1,0
16,443,443,87,9,78,3,2
3,446,446,50,2,48,3,2
24,450,450,15,8,7,2,1
2,454,454,9,9,0,1,0
32,457,457,1,1,0,1,0
23,467,467,41,41,0,1,0
31,479,479,16,16,0,1,0
22,480,480,4,4,0,1,0
21,481,481,54,19,35,2,1
0,481,481,12,1,11,2,1
28,486,486,86,8,78,4,3

18,108,108,14,14,0,1,0
7,118,118,6,6,0,1,0
25,121,121,4,1,3,2,1
4,159,159,5,5,0,1,0
2,171,171,68,23,45,4,3
34,173,173,11,11,0,1,0
14,176,176,30,8,22,3,2
12,183,183,34,34,0,1,0
10,206,206,4,4,0,1,0
8,228,228,8,8,0,1,0
16,240,240,27,27,0,1,0
32,241,241,21,12,9,2,1
29,254,254,83,83,0,1,0
31,265,265,27,5,22,3,2
22,275,275,14,7,7,2,1
17,278,278,20,20,0,1,0
9,297,297,1,1,0,1,0
11,300,300,15,15,0,1,0
37,307,307,1,1,0,1,0
35,322,322,10,2,8,3,2
36,328,328,19,3,16,2,1
20,348,348,102,62,40,2,1
33,349,349,65,7,58,3,2
30,357,357,2,2,0,1,0
3,361,361,18,4,14,2,1
6,370,370,14,1,13,2,1
19,381,381,1,1,0,1,0
28,387,387,66,66,0,1,0
5,387,387,45,45,0,1,0
24,388,388,79,64,15,4,3
26,389,389,65,65,0,1,0
0,397,397,85,76,9,4,3
15,400,400,62,62,0,1,0
27,444,444,9,3,6,3,2
23,444,444,18,18,0,1,0
21,461,461,42,42,0,1,0
13,468,468,25,25,0,1,0
1,490,490,10,10,0,1,0

19,105,105,5,5,0,1,0
11,112,112,17,17,0,1,0
20,115,115,1,1,0,1,0
40,117,117,37,32,5,2,1
32,119,119,1,1,0,1,0
34,151,151,1,1,0,1,0
10,152,152,8,1,7,2,1
23,170,170,2,2,0,1,0
35,182,182,50,2,48,2,1
12,193,193,21,21,0,1,0
0,205,205,6,6,0,1,0
37,210,210,32,32,0,1,0
4,216,216,23,14,9,4,3
5,225,225,12,12,0,1,0
36,238,238,6,6,0,1,0
15,243,243,27,27,0,1,0
27,246,246,5,5,0,1,0
21,253,253,3,3,0,1,0
25,254,254,12,5,7,2,1
9,264,264,3,3,0,1,0
13,277,277,29,25,4,2,1
31,295,295,9,9,0,1,0
24,297,297,12,2,10,3,2
14,304,304,2,2,0,1,0
33,314,314,80,37,43,3,2
2,331,331,52,52,0,1,0
22,332,332,48,22,26,2,1
8,357,357,46,37,9,4,3
17,376,376,193,193,0,1,0
30,383,383,77,8,69,4,3
18,384,384,1,1,0,1,0
7,415,415,28,5,23,3,2
39,425,425,17,7,10,2,1
3,433,433,24,24,0,1,0
26,441,441,23,17,6,2,1
29,446,446,60,25,35,2,1
1,452,452,9,9,0,1,0
28,459,459,20,20,0,1,0
38,478,478,64,55,9,2,1
6,490,490,70,25,45,2,1
16,492,492,5,5,0,1,0

31,115,115,33,15,18,4,3
33,135,135,36,36,0,1,0
17,142,142,1,1,0,1,0
34,153,153,3,3,0,1,0
10,163,163,33,6,27,2,1
32,169,169,19,9,10,2,1
39,185,185,9,9,0,1,0
16,186,186,23,2,21,4,3
14,200,200,37,17,20,2,1
20,210,210,21,21,0,1,0
23,222,222,2,2,0,1,0
1,229,229,21,9,12,4,3
25,245,245,2,2,0,1,0
3,246,246,1,1,0,1,0
6,250,250,24,24,0,1,0
29,261,261,25,25,0,1,0
28,262,262,27,27,0,1,0
9,265,265,24,24,0,1,0
0,268,268,27,27,0,1,0
26,285,285,72,10,62,3,2
22,290,290,5,5,0,1,0
41,292,292,17,10,7,2,1
38,307,307,22,22,0,1,0
36,322,322,10,10,0,1,0
18,324,324,10,10,0,1,0
40,330,330,25,25,0,1,0
30,346,346,18,18,0,1,0
12,356,356,22,22,0,1,0
19,359,359,60,4,56,3,2
4,370,370,30,30,0,1,0
37,376,376,22,22,0,1,0
11,381,381,31,31,0,1,0
7,408,408,54,8,46,2,1
24,409,409,23,13,10,3,2
15,411,411,36,15,21,4,3
21,423,423,24,12,12,3,2
13,444,444,14,8,6,3,2
43,447,447,13,13,0,1,0
27,469,469,51,12,39,4,3
8,474,474,10,7,3,2,1
5,491,491,16,16,0,1,0
42,495,495,111,111,0,1,0
35,498,498,17,10,7,2,1
2,500,500,17,17,0,1,0

39,101,101,37,23,14,3,2
17,124,124,1,1,0,1,0
23,128,128,2,2,0,1,0
31,147,147,14,5,9,4,3
0,156,156,4,4,0,1,0
15,162,162,9,9,0,1,0
5,195,195,1,1,0,1,0
8,204,204,43,6,37,2,1
13,212,212,11,11,0,1,0
34,212,212,15,4,11,2,1
28,212,212,36,8,28,3,2
9,215,215,32,32,0,1,0
36,229,229,12,12,0,1,0
3,233,233,8,3,5,2,1
7,252,252,6,6,0,1,0
1,264,264,3,3,0,1,0
12,265,265,79,7,72,4,3
26,267,267,34,34,0,1,0
30,270,270,39,17,22,3,2
19,283,283,1,1,0,1,0
27,290,290,28,7,21,2,1
2,314,314,94,52,42,3,2
11,324,324,9,9,0,1,0
18,329,329,16,6,10,3,2
24,329,329,11,11,0,1,0
35,349,349,27,27,0,1,0
6,354,354,68,68,0,1,0
14,356,356,64,46,18,3,2
22,360,360,15,6,9,2,1
10,369,369,40,40,0,1,0
33,392,392,1,1,0,1,0
29,416,416,67,67,0,1,0
25,418,418,53,43,10,2,1
38,419,419,80,30,50,4,3
21,422,422,42,6,36,3,2
32,426,426,6,6,0,1,0
37,429,429,22,5,17,2,1
16,438,438,9,4,5,2,1
20,461,461,12,12,0,1,0
4,498,498,61,61,0,1,0

0,108,108,9,9,0,1,0
14,111,111,2,2,0,1,0
4,124,124,5,2,3,2,1
15,137,137,20,11,9,4,3
19,141,141,5,1,4,2,1
10,144,144,5,5,0,1,0
23,167,167,62,62,0,1,0
27,182,182,5,5,0,1,0
34,198,198,5,5,0,1,0
32,200,200,3,3,0,1,0
26,203,203,17,17,0,1,0
2,203,203,23,17,6,3,2
35,203,203,17,17,0,1,0
28,204,204,11,3,8,3,2
1,221,221,14,14,0,1,0
36,224,224,2,2,0,1,0
6,231,231,56,56,0,1,0
29,234,234,1,1,0,1,0
13,239,239,5,5,0,1,0
40,270,270,19,19,0,1,0
24,275,275,30,30,0,1,0
7,279,279,48,48,0,1,0
18,292,292,56,56,0,1,0
20,297,297,4,4,0,1,0
3,310,310,33,33,0,1,0
8,358,358,30,12,18,2,1
21,374,374,31,8,23,2,1
11,384,384,17,3,14,2,1
5,390,390,7,4,3,2,1
16,398,398,24,15,9,4,3
37,399,399,81,50,31,3,2
9,422,422,24,8,16,2,1
22,429,429,35,7,28,3,2
31,430,430,33,21,12,4,3
25,438,438,53,53,0,1,0
17,451,451,45,45,0,1,0
39,462,462,33,33,0,1,0
12,475,475,83,83,0,1,0
30,480,480,20,14,6,3,2
38,487,487,86,32,54,3,2
33,494,494,154,154,0,1,0

11,100,100,10,10,0,1,0
18,103,103,1,1,0,1,0
25,104,104,7,7,0,1,0
27,109,109,2,2,0,1,0
21,146,146,8,5,3,2,1
15,160,160,17,17,0,1,0
0,161,161,1,1,0,1,0
33,162,162,4,1,3,2,1
2,177,177,80,58,22,2,1
19,207,207,8,8,0,1,0
26,213,213,8,8,0,1,0
14,214,214,3,3,0,1,0
29,218,218,45,45,0,1,0
24,223,223,49,49,0,1,0
22,230,230,21,3,18,3,2
7,235,235,33,33,0,1,0
28,262,262,33,4,29,2,1
35,291,291,21,12,9,4,3
13,313,313,5,2,3,2,1
3,317,317,20,20,0,1,0
31,336,336,36,36,0,1,0
34,350,350,93,66,27,2,1
6,357,357,35,24,11,2,1
1,365,365,5,5,0,1,0
20,367,367,11,11,0,1,0
12,394,394,37,19,18,4,3
4,398,398,108,108,0,1,0
23,408,408,180,47,133,4,3
16,410,410,8,3,5,2,1
10,410,410,126,57,69,4,3
30,414,414,16,1,15,2,1
5,428,428,25,22,3,2,1
32,441,441,32,18,14,3,2
17,445,445,9,9,0,1,0
9,483,483,19,7,12,3,2
8,485,485,49,49,0,1,0

22,113,113,37,37,0,1,0
16,138,138,6,3,3,2,1
38,141,141,11,3,8,3,2
11,149,149,41,3,38,4,3
17,161,161,1,1,0,1,0
13,163,163,1,1,0,1,0
9,185,185,16,13,3,2,1
36,185,185,14,6,8,3,2
34,201,201,35,23,12,3,2
20,235,235,2,2,0,1,0
3,235,235,29,29,0,1,0
4,237,237,1,1,0,1,0
15,238,238,5,5,0,1,0
1,239,239,9,6,3,2,1
8,240,240,95,95,0,1,0
0,246,246,9,9,0,1,0
12,255,255,31,11,20,2,1
19,271,271,22,2,20,3,2
26,279,279,27,27,0,1,0
32,279,279,11,11,0,1,0
30,286,286,12,12,0,1,0
25,308,308,39,39,0,1,0
24,311,311,15,7,8,3,2
5,319,319,23,23,0,1,0
29,350,350,49,38,11,2,1
21,353,353,16,16,0,1,0
35,354,354,30,30,0,1,0
27,367,367,53,53,0,1,0
18,375,375,58,28,30,2,1
33,383,383,88,36,52,3,2
14,422,422,24,24,0,1,0
31,428,428,32,32,0,1,0
7,430,430,22,13,9,4,3
37,437,437,26,14,12,3,2
2,439,439,38,38,0,1,0
28,445,445,47,47,0,1,0
23,460,460,17,1,16,4,3
10,476,476,111,9,102,4,3
6,477,477,4,4,0,1,0

40,104,104,28,28,0,1,0
21,107,107,5,5,0,1,0
8,110,110,7,3,4,2,1
36,114,114,3,3,0,1,0
26,119,119,8,8,0,1,0
18,122,122,19,19,0,1,0
41,133,133,15,1,14,3,2
6,163,163,21,21,0,1,0
11,179,179,9,9,0,1,0
28,205,205,7,7,0,1,0
27,206,206,50,26,24,3,2
30,206,206,7,1,6,3,2
23,206,206,7,7,0,1,0
19,212,212,9,9,0,1,0
39,217,217,9,9,0,1,0
42,220,220,4,4,0,1,0
7,246,246,50,14,36,3,2
5,249,249,35,10,25,2,1
4,250,250,34,16,18,3,2
32,265,265,36,5,31,4,3
24,267,267,44,14,30,4,3
0,284,284,1,1,0,1,0
22,288,288,5,5,0,1,0
9,306,306,46,46,0,1,0
29,319,319,5,5,0,1,0
3,323,323,35,35,0,1,0
34,343,343,58,22,36,4,3
20,343,343,4,4,0,1,0
14,351,351,15,15,0,1,0
16,375,375,44,5,39,2,1
12,377,377,21,1,20,2,1
35,382,382,12,12,0,1,0
2,396,396,23,18,5,2,1
13,408,408,60,21,39,2,1
38,422,422,50,50,0,1,0
1,425,425,2,2,0,1,0
37,436,436,89,67,22,3,2
25,443,443,94,94,0,1,0
31,460,460,6,6,0,1,0
33,470,470,14,14,0,1,0
17,475,475,1,1,0,1,0
15,478,478,61,61,0,1,0
10,487,487,27,27,0,1,0

29,111,111,8,8,0,1,0
18,117,117,21,21,0,1,0
31,144,144,1,1,0,1,0
16,160,160,2,2,0,1,0
36,161,161,54,30,24,2,1
1,165,165,3,3,0,1,0
14,172,172,2,2,0,1,0
37,179,179,27,27,0,1,0
7,186,186,4,4,0,1,0
2,205,205,4,1,3,2,1
15,205,205,15,7,8,2,1
20,210,210,19,19,0,1,0
12,227,227,22,22,0,1,0
6,239,239,10,7,3,2,1
24,250,250,25,15,10,2,1
11,284,284,95,15,80,3,2
10,297,297,53,20,33,2,1
23,315,315,77,77,0,1,0
25,319,319,10,10,0,1,0
40,324,324,19,9,10,2,1
13,335,335,37,37,0,1,0
32,335,335,59,51,8,2,1
30,343,343,7,7,0,1,0
9,349,349,1,1,0,1,0
21,352,352,21,11,10,3,2
8,358,358,5,2,3,2,1
5,361,361,1,1,0,1,0
34,372,372,5,5,0,1,0
3,383,383,85,79,6,3,2
17,386,386,56,32,24,2,1
39,388,388,32,32,0,1,0
27,390,390,100,40,60,4,3
0,391,391,29,2,27,4,3
38,402,402,41,23,18,2,1
33,408,408,36,36,0,1,0
35,415,415,31,22,9,4,3
28,436,436,14,14,0,1,0
22,478,478,14,14,0,1,0
4,478,478,74,26,48,4,3
26,478,478,29,20,9,2,1
19,488,488,18,5,13,4,3

2,105,105,39,18,21,4,3
14,107,107,1,1,0,1,0
17,114,114,10,10,0,1,0
6,127,127,8,3,5,2,1
34,127,127,11,11,0,1,0
1,139,139,5,5,0,1,0
28,146,146,7,3,4,2,1
36,148,148,4,4,0,1,0
23,159,159,4,1,3,2,1
20,160,160,4,4,0,1,0
35,170,170,35,17,18,2,1
32,171,171,21,17,4,2,1
10,177,177,15,7,8,2,1
19,206,206,12,5,7,2,1
22,206,206,38,38,0,1,0
4,208,208,18,18,0,1,0
15,212,212,16,1,15,4,3
27,216,216,5,5,0,1,0
11,221,221,101,101,0,1,0
7,257,257,1,1,0,1,0
12,289,289,10,10,0,1,0
37,297,297,43,43,0,1,0
9,309,309,5,5,0,1,0
8,333,333,31,19,12,4,3
21,340,340,28,14,14,3,2
24,380,380,93,35,58,4,3
5,381,381,19,19,0,1,0
29,392,392,47,47,0,1,0
25,393,393,17,3,14,3,2
33,403,403,2,2,0,1,0
26,404,404,71,71,0,1,0
0,442,442,95,95,0,1,0
13,449,449,63,36,27,4,3
30,451,451,113,8,105,4,3
18,457,457,5,5,0,1,0
31,472,472,30,1,29,2,1
16,484,484,25,25,0,1,0
3,494,494,7,7,0,1,0

23,127,127,23,6,17,2,1
21,149,149,11,1,10,2,1
34,156,156,1,1,0,1,0
37,164,164,15,9,6,3,2
36,169,169,3,3,0,1,0
38,172,172,17,17,0,1,0
12,196,196,39,39,0,1,0
1,223,223,16,13,3,2,1
6,227,227,39,29,10,2,1
0,241,241,10,2,8,2,1
5,243,243,7,7,0,1,0
20,248,248,100,41,59,4,3
18,263,263,23,5,18,4,3
25,264,264,23,1,22,4,3
22,265,265,20,15,5,2,1
30,267,267,22,22,0,1,0
4,274,274,22,8,14,3,2
15,276,276,1,1,0,1,0
14,286,286,8,8,0,1,0
11,307,307,22,22,0,1,0
27,308,308,45,45,0,1,0
2,310,310,35,35,0,1,0
9,358,358,41,41,0,1,0
19,360,360,11,11,0,1,0
32,375,375,14,14,0,1,0
28,382,382,13,13,0,1,0
31,383,383,2,2,0,1,0
16,390,390,58,44,14,3,2
3,396,396,9,9,0,1,0
24,401,401,25,8,17,4,3
7,412,412,9,9,0,1,0
35,421,421,26,23,3,2,1
17,425,425,18,7,11,2,1
13,445,445,54,54,0,1,0
8,451,451,40,40,0,1,0
33,462,462,60,60,0,1,0
10,480,480,199,100,99,4,3
26,495,495,55,55,0,1,0
29,496,496,115,73,42,2,1

3,104,104,1,1,0,1,0
13,111,111,5,5,0,1,0
46,122,122,13,1,12,3,2
22,131,131,22,17,5,2,1
20,137,137,2,2,0,1,0
15,148,148,10,7,3,2,1
11,162,162,3,3,0,1,0
43,167,167,49,42,7,2,1
38,173,173,27,15,12,4,3
40,174,174,10,10,0,1,0
14,178,178,6,6,0,1,0
30,187,187,2,2,0,1,0
16,188,188,1,1,0,1,0
35,196,196,4,4,0,1,0
18,196,196,2,2,0,1,0
10,198,198,1,1,0,1,0
1,202,202,20,3,17,4,3
6,202,202,1,1,0,1,0
8,211,211,33,27,6,3,2
34,224,224,5,5,0,1,0
5,231,231,1,1,0,1,0
47,250,250,6,6,0,1,0
25,254,254,11,11,0,1,0
50,255,255,49,29,20,3,2
48,266,266,68,39,29,2,1
12,269,269,1,1,0,1,0
37,277,277,49,49,0,1,0
45,297,297,16,16,0,1,0
42,316,316,64,13,51,4,3
27,328,328,17,17,0,1,0
29,332,332,2,2,0,1,0
19,336,336,145,39,106,4,3
51,350,350,22,22,0,1,0
41,371,371,6,6,0,1,0
26,375,375,48,22,26,3,2
36,376,376,15,7,8,3,2
32,377,377,26,17,9,2,1
44,385,385,25,19,6,2,1
4,388,388,25,15,10,2,1
39,389,389,1,1,0,1,0
28,397,397,38,38,0,1,0
49,408,408,39,27,12,4,3
9,418,418,29,29,0,1,0
23,421,421,23,23,0,1,0
33,423,423,37,37,0,1,0
24,428,428,8,8,0,1,0
31,430,430,2,2,0,1,0
21,445,445,28,28,0,1,0
7,449,449,22,17,5,2,1
0,450,450,17,17,0,1,0
2,472,472,20,9,11,2,1
17,496,496,8,8,0,1,0

5,107,107,1,1,0,1,0
26,115,115,32,19,13,2,1
1,122,122,27,27,0,1,0
38,150,150,3,3,0,1,0
21,188,188,20,20,0,1,0
30,194,194,17,2,15,4,3
15,197,197,7,7,0,1,0
12,205,205,49,24,25,2,1
9,208,208,5,2,3,2,1
18,212,212,15,15,0,1,0
35,215,215,17,4,13,2,1
25,220,220,44,44,0,1,0
0,232,232,45,45,0,1,0
24,234,234,11,3,8,3,2
23,262,262,3,3,0,1,0
22,267,267,53,53,0,1,0
11,275,275,17,7,10,3,2
17,300,300,82,82,0,1,0
29,302,302,45,45,0,1,0
13,304,304,1,1,0,1,0
4,308,308,8,8,0,1,0
20,319,319,6,6,0,1,0
37,324,324,36,27,9,2,1
31,329,329,4,1,3,2,1
8,330,330,13,5,8,2,1
6,335,335,56,2,54,3,2
3,341,341,38,38,0,1,0
14,359,359,14,14,0,1,0
36,379,379,13,13,0,1,0
19,403,403,3,3,0,1,0
34,415,415,51,19,32,2,1
32,415,415,15,6,9,4,3
39,440,440,103,95,8,2,1
28,442,442,17,8,9,4,3
33,446,446,33,1,32,3,2
27,459,459,46,46,0,1,0
7,464,464,34,14,20,3,2
2,474,474,65,65,0,1,0
16,475,475,16,16,0,1,0
10,490,490,56,56,0,1,0

19,111,111,13,13,0,1,0
30,113,113,5,5,0,1,0
25,113,113,16,12,4,2,1
40,119,119,3,3,0,1,0
27,132,132,1,1,0,1,0
22,134,134,3,3,0,1,0
12,149,149,17,17,0,1,0
42,150,150,38,38,0,1,0
11,150,150,4,4,0,1,0
1,174,174,10,10,0,1,0
28,175,175,9,3,6,3,2
37,180,180,27,27,0,1,0
29,190,190,7,7,0,1,0
14,201,201,14,2,12,2,1
26,222,222,43,43,0,1,0
18,229,229,38,2,36,2,1
15,233,233,16,1,15,2,1
16,237,237,15,5,10,3,2
21,250,250,88,52,36,2,1
20,264,264,42,42,0,1,0
31,268,268,4,4,0,1,0
17,275,275,14,14,0,1,0
35,275,275,18,6,12,2,1
36,285,285,76,76,0,1,0
9,292,292,14,2,12,2,1
5,300,300,21,3,18,4,3
38,318,318,29,13,16,3,2
7,325,325,21,21,0,1,0
3,344,344,17,8,9,4,3
41,347,347,9,9,0,1,0
13,352,352,17,3,14,3,2
6,369,369,30,30,0,1,0
39,382,382,6,3,3,2,1
23,386,386,23,23,0,1,0
34,386,386,53,47,6,3,2
0,396,396,56,56,0,1,0
2,410,410,12,12,0,1,0
24,411,411,8,8,0,1,0
8,427,427,2,2,0,1,0
33,432,432,114,12,102,4,3
10,460,460,6,6,0,1,0
4,480,480,12,12,0,1,0
32,481,481,72,38,34,3,2

20,111,111,2,2,0,1,0
35,120,120,23,23,0,1,0
5,124,124,8,8,0,1,0
39,154,154,17,9,8,3,2
34,164,164,9,9,0,1,0
1,173,173,35,35,0,1,0
19,200,200,3,3,0,1,0
22,202,202,15,15,0,1,0
28,203,203,17,17,0,1,0
40,206,206,3,3,0,1,0
36,220,220,5,5,0,1,0
15,231,231,14,3,11,2,1
24,243,243,20,20,0,1,0
29,254,254,40,40,0,1,0
33,273,273,48,48,0,1,0
37,295,295,58,34,24,2,1
27,295,295,57,37,20,3,2
23,312,312,14,14,0,1,0
18,321,321,11,11,0,1,0
10,323,323,115,50,65,4,3
13,325,325,4,4,0,1,0
12,328,328,18,11,7,2,1
26,343,343,32,20,12,2,1
7,353,353,23,23,0,1,0
0,367,367,9,9,0,1,0
2,369,369,3,3,0,1,0
16,376,376,35,9,26,2,1
4,400,400,108,42,66,4,3
11,417,417,54,54,0,1,0
32,420,420,13,13,0,1,0
8,431,431,4,4,0,1,0
3,435,435,18,10,8,2,1
6,437,437,14,8,6,3,2
31,438,438,44,44,0,1,0
17,443,443,4,4,0,1,0
14,443,443,56,56,0,1,0
21,446,446,103,4,99,4,3
9,453,453,20,20,0,1,0
25,459,459,67,5,62,3,2
38,484,484,14,8,6,2,1
30,495,495,68,68,0,1,0

11,129,129,14,2,12,4,3
20,143,143,1,1,0,1,0
26,150,150,35,35,0,1,0
21,158,158,2,2,0,1,0
27,172,172,32,14,18,2,1
36,191,191,48,48,0,1,0
10,194,194,2,2,0,1,0
13,194,194,38,38,0,1,0
12,201,201,17,9,8,3,2
35,203,203,7,7,0,1,0
30,206,206,20,3,17,2,1
31,224,224,6,1,5,2,1
40,229,229,36,36,0,1,0
5,229,229,43,43,0,1,0
32,234,234,7,7,0,1,0
16,236,236,3,3,0,1,0
9,239,239,4,4,0,1,0
39,243,243,15,15,0,1,0
8,278,278,52,1,51,4,3
1,283,283,5,5,0,1,0
42,292,292,38,38,0,1,0
33,299,299,47,47,0,1,0
3,300,300,113,113,0,1,0
19,301,301,12,8,4,2,1
38,303,303,12,4,8,3,2
29,303,303,123,109,14,2,1
0,305,305,42,42,0,1,0
6,313,313,2,2,0,1,0
24,329,329,2,2,0,1,0
7,342,342,30,14,16,3,2
4,354,354,34,17,17,3,2
37,381,381,1,1,0,1,0
15,391,391,1,1,0,1,0
14,400,400,14,14,0,1,0
28,423,423,14,14,0,1,0
25,425,425,9,9,0,1,0
41,432,432,5,5,0,1,0
17,436,436,47,47,0,1,0
34,439,439,21,7,14,2,1
22,444,444,26,11,15,4,3
23,446,446,14,14,0,1,0
2,480,480,13,13,0,1,0
18,486,486,26,26,0,1,0

3,146,146,12,12,0,1,0
6,153,153,1,1,0,1,0
20,170,170,38,38,0,1,0
1,196,196,16,2,14,2,1
16,207,207,13,13,0,1,0
35,213,213,14,4,10,3,2
2,220,220,10,10,0,1,0
8,233,233,17,8,9,4,3
29,238,238,7,7,0,1,0
0,240,240,29,29,0,1,0
9,246,246,16,4,12,2,1
36,262,262,2,2,0,1,0
22,285,285,7,7,0,1,0
17,287,287,16,10,6,2,1
34,287,287,72,26,46,2,1
5,292,292,1,1,0,1,0
7,301,301,14,14,0,1,0
18,320,320,117,55,62,4,3
19,355,355,39,17,22,2,1
4,363,363,1,1,0,1,0
33,370,370,17,8,9,2,1
13,379,379,16,16,0,1,0
30,387,387,46,39,7,2,1
12,392,392,30,30,0,1,0
11,395,395,3,3,0,1,0
31,407,407,18,15,3,2,1
21,412,412,44,44,0,1,0
23,412,412,42,5,37,4,3
14,412,412,96,72,24,3,2
15,416,416,119,14,105,4,3
24,418,418,7,7,0,1,0
25,432,432,21,3,18,4,3
28,438,438,21,1,20,3,2
38,449,449,65,42,23,2,1
26,451,451,8,3,5,2,1
10,463,463,62,32,30,4,3
27,467,467,195,99,96,4,3
32,477,477,18,9,9,4,3
37,498,498,87,23,64,4,3

19,115,115,21,13,8,2,1
16,121,121,2,2,0,1,0
28,125,125,10,10,0,1,0
34,147,147,20,20,0,1,0
7,174,174,9,9,0,1,0
5,181,181,27,27,0,1,0
12,206,206,109,46,63,4,3
8,212,212,18,12,6,2,1
11,260,260,32,7,25,3,2
10,266,266,15,15,0,1,0
27,271,271,11,11,0,1,0
15,273,273,4,4,0,1,0
1,277,277,23,10,13,2,1
25,277,277,107,98,9,4,3
31,288,288,4,4,0,1,0
23,297,297,8,8,0,1,0
30,312,312,1,1,0,1,0
2,320,320,13,13,0,1,0
26,329,329,56,56,0,1,0
9,329,329,1,1,0,1,0
3,333,333,31,31,0,1,0
4,352,352,44,44,0,1,0
29,356,356,37,8,29,2,1
0,367,367,31,31,0,1,0
13,377,377,14,8,6,3,2
17,394,394,28,10,18,4,3
39,407,407,38,38,0,1,0
37,425,425,2,2,0,1,0
14,429,429,38,29,9,4,3
35,436,436,51,1,50,2,1
24,441,441,9,9,0,1,0
20,441,441,3,3,0,1,0
22,452,452,50,50,0,1,0
36,452,452,34,34,0,1,0
21,458,458,65,2,63,4,3
18,460,460,1,1,0,1,0
6,462,462,27,9,18,2,1
33,471,471,19,19,0,1,0
32,483,483,120,63,57,4,3
38,499,499,61,41,20,4,3

29,118,118,18,18,0,1,0
8,135,135,14,14,0,1,0
0,139,139,9,9,0,1,0
36,165,165,3,3,0,1,0
6,170,170,9,3,6,2,1
35,192,192,26,26,0,1,0
4,196,196,61,61,0,1,0
2,216,216,9,9,0,1,0
16,219,219,36,9,27,4,3
12,221,221,17,11,6,2,1
21,258,258,34,24,10,3,2
9,259,259,19,6,13,2,1
32,268,268,20,20,0,1,0
24,274,274,6,6,0,1,0
25,289,289,6,6,0,1,0
23,300,300,32,24,8,2,1
19,313,313,15,15,0,1,0
30,329,329,57,42,15,4,3
17,335,335,63,63,0,1,0
28,358,358,12,1,11,2,1
34,359,359,65,65,0,1,0
7,360,360,20,7,13,2,1
10,368,368,36,20,16,3,2
31,371,371,5,5,0,1,0
14,382,382,40,40,0,1,0
3,399,399,11,3,8,2,1
15,401,401,41,16,25,2,1
1,406,406,107,7,100,4,3
11,420,420,15,15,0,1,0
20,421,421,25,25,0,1,0
5,439,439,9,9,0,1,0
27,444,444,37,18,19,3,2
13,460,460,54,54,0,1,0
18,476,476,109,64,45,4,3
22,488,488,14,5,9,2,1
26,489,489,83,48,35,4,3
33,496,496,124,81,43,2,1

35,107,107,1,1,0,1,0
28,109,109,6,6,0,1,0
33,122,122,5,5,0,1,0
36,124,124,14,14,0,1,0
9,136,136,18,18,0,1,0
20,139,139,4,4,0,1,0
18,143,143,1,1,0,1,0
15,152,152,13,5,8,2,1
25,154,154,24,18,6,2,1
2,175,175,13,2,11,2,1
7,191,191,28,28,0,1,0
22,194,194,19,19,0,1,0
10,213,213,25,6,19,2,1
8,244,244,6,6,0,1,0
38,253,253,7,4,3,2,1
26,280,280,6,3,3,2,1
12,283,283,56,56,0,1,0
32,289,289,61,61,0,1,0
23,290,290,29,29,0,1,0
14,294,294,18,9,9,2,1
34,344,344,73,13,60,3,2
1,346,346,8,8,0,1,0
16,350,350,5,5,0,1,0
19,358,358,1,1,0,1,0
11,366,366,9,5,4,2,1
6,369,369,160,160,0,1,0
3,378,378,3,3,0,1,0
21,386,386,35,20,15,4,3
24,391,391,7,7,0,1,0
31,391,391,165,165,0,1,0
39,394,394,20,20,0,1,0
13,394,394,3,3,0,1,0
40,401,401,11,11,0,1,0
30,402,402,19,19,0,1,0
4,403,403,36,36,0,1,0
27,409,409,33,27,6,3,2
37,425,425,13,2,11,2,1
29,458,458,96,28,68,4,3
0,460,460,12,6,6,3,2
5,462,462,56,47,9,4,3
17,463,463,86,86,0,1,0

1,100,100,4,4,0,1,0
2,101,101,7,7,0,1,0
21,104,104,5,5,0,1,0
12,112,112,4,4,0,1,0
30,131,131,8,8,0,1,0
28,150,150,17,10,7,2,1
29,150,150,66,36,30,2,1
22,169,169,15,15,0,1,0
10,170,170,2,2,0,1,0
6,179,179,26,26,0,1,0
7,192,192,6,6,0,1,0
14,198,198,66,27,39,2,1
11,206,206,17,17,0,1,0
5,213,213,12,4,8,2,1
19,225,225,2,2,0,1,0
8,240,240,1,1,0,1,0
23,260,260,3,3,0,1,0
26,270,270,26,26,0,1,0
18,274,274,33,13,20,2,1
37,284,284,17,10,7,2,1
0,293,293,9,9,0,1,0
9,294,294,7,1,6,2,1
25,296,296,4,1,3,2,1
16,318,318,7,2,5,2,1
35,323,323,31,22,9,2,1
17,339,339,63,63,0,1,0
39,357,357,10,5,5,2,1
32,358,358,8,8,0,1,0
36,372,372,77,43,34,2,1
3,396,396,14,14,0,1,0
33,404,404,7,7,0,1,0
31,418,418,127,127,0,1,0
41,418,418,5,5,0,1,0
38,431,431,85,85,0,1,0
40,438,438,52,22,30,4,3
27,441,441,11,11,0,1,0
13,453,453,23,5,18,4,3
4,464,464,44,44,0,1,0
24,486,486,10,3,7,2,1
20,487,487,135,135,0,1,0
15,495,495,54,42,12,3,2
34,499,499,47,47,0,1,0

10,102,102,1,1,0,1,0
14,111,111,18,3,15,2,1
24,136,136,21,21,0,1,0
12,152,152,4,4,0,1,0
31,173,173,21,3,18,3,2
8,175,175,2,2,0,1,0
34,176,176,3,3,0,1,0
6,177,177,3,3,0,1,0
5,180,180,1,1,0,1,0
32,182,182,15,15,0,1,0
25,183,183,39,39,0,1,0
33,190,190,12,7,5,2,1
1,206,206,3,3,0,1,0
21,209,209,1,1,0,1,0
26,220,220,12,3,9,4,3
15,239,239,7,7,0,1,0
37,248,248,9,9,0,1,0
7,260,260,21,1,20,3,2
16,272,272,19,1,18,3,2
22,285,285,40,10,30,3,2
3,286,286,18,8,10,2,1
39,288,288,19,19,0,1,0
36,300,300,2,2,0,1,0
0,307,307,130,43,87,4,3
19,312,312,36,36,0,1,0
35,313,313,41,41,0,1,0
17,324,324,3,3,0,1,0
18,345,345,27,27,0,1,0
20,345,345,44,44,0,1,0
4,357,357,46,30,16,2,1
13,397,397,138,93,45,4,3
9,405,405,17,17,0,1,0
23,406,406,40,10,30,3,2
28,412,412,105,36,69,4,3
27,420,420,81,81,0,1,0
11,428,428,12,12,0,1,0
38,438,438,65,65,0,1,0
29,447,447,58,58,0,1,0
2,464,464,52,16,36,4,3
30,479,479,8,8,0,1,0

7,101,101,2,2,0,1,0
1,105,105,18,9,9,2,1
21,116,116,2,2,0,1,0
33,124,124,13,13,0,1,0
16,127,127,6,6,0,1,0
8,128,128,1,1,0,1,0
18,135,135,64,64,0,1,0
14,138,138,23,6,17,2,1
42,142,142,3,3,0,1,0
35,145,145,20,11,9,4,3
2,146,146,2,2,0,1,0
43,166,166,6,6,0,1,0
24,167,167,8,1,7,2,1
12,186,186,2,2,0,1,0
37,188,188,4,4,0,1,0
15,209,209,3,3,0,1,0
34,216,216,48,21,27,4,3
17,221,221,12,12,0,1,0
3,226,226,22,1,21,4,3
6,237,237,13,1,12,3,2
30,243,243,28,2,26,3,2
26,281,281,17,2,15,3,2
5,286,286,56,56,0,1,0
32,316,316,61,61,0,1,0
11,320,320,9,3,6,2,1
36,325,325,41,9,32,3,2
23,346,346,32,32,0,1,0
4,367,367,8,8,0,1,0
19,371,371,10,2,8,3,2
40,397,397,148,129,19,2,1
27,400,400,4,4,0,1,0
0,407,407,24,3,21,4,3
28,420,420,140,98,42,4,3
31,423,423,16,5,11,2,1
39,428,428,3,3,0,1,0
20,443,443,9,3,6,3,2
38,445,445,17,17,0,1,0
13,454,454,54,54,0,1,0
41,455,455,18,18,0,1,0
29,465,465,9,9,0,1,0
10,468,468,12,12,0,1,0
9,471,471,30,20,10,2,1
22,474,474,26,5,21,4,3
25,490,490,21,21,0,1,0

8,109,109,16,16,0,1,0
17,114,114,24,1,23,4,3
23,122,122,6,6,0,1,0
9,125,125,7,7,0,1,0
35,134,134,41,41,0,1,0
14,139,139,14,14,0,1,0
38,153,153,25,25,0,1,0
29,177,177,10,4,6,3,2
21,180,180,17,12,5,2,1
16,186,186,4,1,3,2,1
36,186,186,11,11,0,1,0
15,192,192,12,3,9,2,1
22,194,194,7,1,6,3,2
34,196,196,7,1,6,3,2
6,205,205,19,19,0,1,0
7,211,211,19,19,0,1,0
13,217,217,1,1,0,1,0
24,231,231,6,6,0,1,0
33,235,235,9,3,6,2,1
2,246,246,1,1,0,1,0
27,263,263,103,103,0,1,0
20,267,267,18,18,0,1,0
37,293,293,20,20,0,1,0
32,293,293,24,24,0,1,0
19,299,299,54,4,50,3,2
31,299,299,15,15,0,1,0
26,313,313,54,54,0,1,0
4,320,320,27,27,0,1,0
10,330,330,2,2,0,1,0
12,362,362,21,21,0,1,0
1,407,407,26,26,0,1,0
0,426,426,86,36,50,3,2
18,430,430,132,132,0,1,0
30,434,434,38,38,0,1,0
3,441,441,1,1,0,1,0
25,470,470,69,53,16,3,2
5,481,481,8,5,3,2,1
11,489,489,94,55,39,4,3
28,493,493,2,2,0,1,0

10,105,105,1,1,0,1,0
15,110,110,41,17,24,3,2
17,119,119,14,2,12,3,2
27,146,146,8,8,0,1,0
37,150,150,3,3,0,1,0
6,157,157,6,3,3,2,1
24,171,171,4,4,0,1,0
13,173,173,29,5,24,3,2
41,174,174,58,42,16,2,1
35,178,178,13,7,6,2,1
3,183,183,6,6,0,1,0
4,188,188,1,1,0,1,0
12,237,237,12,12,0,1,0
33,238,238,58,38,20,2,1
11,244,244,1,1,0,1,0
19,252,252,11,11,0,1,0
8,256,256,5,5,0,1,0
39,261,261,19,1,18,4,3
32,302,302,3,3,0,1,0
26,311,311,7,7,0,1,0
2,332,332,32,32,0,1,0
29,343,343,32,16,16,3,2
31,343,343,32,32,0,1,0
20,345,345,7,7,0,1,0
40,349,349,17,17,0,1,0
7,353,353,35,35,0,1,0
0,356,356,20,8,12,2,1
34,367,367,22,22,0,1,0
5,368,368,1,1,0,1,0
23,386,386,19,7,12,3,2
14,392,392,3,3,0,1,0
22,404,404,42,42,0,1,0
9,405,405,33,33,0,1,0
18,405,405,50,40,10,3,2
21,416,416,20,20,0,1,0
25,418,418,116,116,0,1,0
42,424,424,9,9,0,1,0
36,449,449,15,6,9,2,1
1,468,468,87,39,48,4,3
16,469,469,78,28,50,3,2
30,474,474,100,58,42,4,3
38,483,483,69,48,21,2,1
28,499,499,47,47,0,1,0

39,103,103,4,4,0,1,0
5,105,105,8,2,6,2,1
41,126,126,9,9,0,1,0
28,126,126,6,2,4,2,1
17,151,151,1,1,0,1,0
31,162,162,16,16,0,1,0
29,165,165,5,5,0,1,0
7,182,182,29,5,24,3,2
24,187,187,23,9,14,2,1
45,190,190,23,4,19,4,3
43,193,193,37,26,11,2,1
44,194,194,42,31,11,2,1
25,198,198,15,15,0,1,0
21,201,201,53,26,27,2,1
6,208,208,44,44,0,1,0
8,212,212,11,11,0,1,0
35,214,214,6,3,3,2,1
36,228,228,98,32,66,3,2
42,238,238,24,4,20,2,1
19,249,249,16,7,9,2,1
3,251,251,1,1,0,1,0
40,280,280,31,3,28,2,1
23,295,295,5,1,4,2,1
2,296,296,1,1,0,1,0
1,297,297,3,3,0,1,0
20,303,303,25,25,0,1,0
37,311,311,3,3,0,1,0
11,339,339,3,3,0,1,0
30,340,340,33,6,27,2,1
12,345,345,12,2,10,2,1
14,368,368,15,3,12,2,1
32,373,373,2,2,0,1,0
16,377,377,37,4,33,2,1
10,382,382,13,13,0,1,0
27,392,392,28,13,15,2,1
13,399,399,50,22,28,2,1
34,412,412,66,66,0,1,0
0,413,413,39,5,34,2,1
46,425,425,43,43,0,1,0
15,439,439,23,5,18,3,2
38,449,449,11,11,0,1,0
9,450,450,37,37,0,1,0
22,453,453,13,1,12,2,1
33,455,455,29,29,0,1,0
18,464,464,10,10,0,1,0
26,470,470,23,23,0,1,0
4,479,479,5,5,0,1,0

21,103,103,14,2,12,3,2
18,116,116,13,3,10,3,2
9,117,117,9,5,4,2,1
20,118,118,25,25,0,1,0
22,125,125,5,1,4,2,1
12,133,133,5,5,0,1,0
11,143,143,13,13,0,1,0
35,143,143,4,4,0,1,0
0,146,146,11,11,0,1,0
13,147,147,21,21,0,1,0
8,154,154,5,5,0,1,0
23,196,196,4,4,0,1,0
34,203,203,8,8,0,1,0
26,207,207,9,4,5,2,1
36,231,231,56,56,0,1,0
27,232,232,51,51,0,1,0
25,247,247,56,56,0,1,0
17,251,251,3,3,0,1,0
6,251,251,22,2,20,3,2
7,263,263,10,10,0,1,0
2,263,263,10,10,0,1,0
38,279,279,42,42,0,1,0
5,282,282,18,1,17,2,1
37,299,299,4,4,0,1,0
33,327,327,19,11,8,2,1
15,344,344,57,57,0,1,0
32,363,363,5,5,0,1,0
4,370,370,31,31,0,1,0
3,385,385,93,12,81,4,3
30,397,397,19,19,0,1,0
24,398,398,14,8,6,2,1
16,410,410,6,6,0,1,0
31,415,415,51,51,0,1,0
28,415,415,110,110,0,1,0
19,417,417,77,17,60,4,3
1,444,444,26,26,0,1,0
14,446,446,51,51,0,1,0
10,472,472,109,71,38,3,2
29,496,496,13,13,0,1,0

8,103,103,7,7,0,1,0
9,103,103,2,2,0,1,0
17,105,105,9,9,0,1,0
5,109,109,23,23,0,1,0
10,109,109,17,17,0,1,0
14,112,112,27,27,0,1,0
20,131,131,22,2,20,2,1
31,134,134,2,2,0,1,0
28,155,155,15,12,3,2,1
30,171,171,28,16,12,4,3
29,174,174,4,4,0,1,0
24,186,186,17,7,10,2,1
22,198,198,2,2,0,1,0
23,203,203,27,27,0,1,0
13,212,212,18,7,11,2,1
4,224,224,26,26,0,1,0
34,236,236,37,37,0,1,0
21,244,244,70,52,18,2,1
25,252,252,22,22,0,1,0
2,255,255,9,9,0,1,0
7,275,275,71,71,0,1,0
35,327,327,66,2,64,3,2
36,328,328,5,1,4,2,1
16,346,346,3,3,0,1,0
11,374,374,34,8,26,3,2
19,376,376,81,72,9,4,3
18,390,390,21,21,0,1,0
3,395,395,59,59,0,1,0
32,416,416,26,2,24,4,3
26,424,424,23,16,7,2,1
12,443,443,45,14,31,2,1
33,454,454,50,18,32,4,3
15,456,456,8,4,4,2,1
37,472,472,16,16,0,1,0
6,487,487,49,10,39,4,3
1,488,488,1,1,0,1,0
0,494,494,50,20,30,3,2
27,496,496,10,10,0,1,0

5,111,111,16,16,0,1,0
27,121,121,15,8,7,2,1
19,121,121,12,5,7,2,1
1,149,149,6,1,5,2,1
32,164,164,3,3,0,1,0
23,173,173,19,19,0,1,0
20,174,174,15,15,0,1,0
34,183,183,8,2,6,2,1
11,185,185,31,31,0,1,0
16,213,213,9,9,0,1,0
28,222,222,14,14,0,1,0
10,226,226,31,22,9,4,3
9,243,243,6,6,0,1,0
12,249,249,56,35,21,4,3
2,249,249,26,16,10,4,3
24,258,258,41,20,21,4,3
0,274,274,44,44,0,1,0
21,274,274,14,14,0,1,0
14,277,277,28,13,15,4,3
26,279,279,12,12,0,1,0
3,280,280,50,50,0,1,0
15,301,301,34,21,13,2,1
22,315,315,9,9,0,1,0
29,357,357,56,56,0,1,0
17,361,361,32,32,0,1,0
8,371,371,27,27,0,1,0
18,378,378,28,11,17,2,1
6,383,383,55,55,0,1,0
7,404,404,13,9,4,2,1
4,422,422,72,45,27,4,3
13,436,436,20,20,0,1,0
33,438,438,37,16,21,4,3
35,445,445,6,6,0,1,0
30,478,478,49,37,12,3,2
31,488,488,155,41,114,4,3
25,493,493,137,128,9,4,3

0,118,118,10,7,3,2,1
3,121,121,14,8,6,2,1
4,170,170,22,22,0,1,0
36,172,172,12,1,11,2,1
1,178,178,10,2,8,3,2
37,184,184,6,6,0,1,0
33,186,186,44,6,38,3,2
25,187,187,23,17,6,2,1
14,206,206,11,11,0,1,0
30,235,235,63,63,0,1,0
35,258,258,9,9,0,1,0
24,263,263,7,7,0,1,0
32,264,264,23,11,12,3,2
12,273,273,16,16,0,1,0
20,295,295,18,18,0,1,0
16,305,305,63,54,9,4,3
28,315,315,69,69,0,1,0
13,329,329,18,9,9,2,1
26,338,338,65,65,0,1,0
2,354,354,101,101,0,1,0
27,354,354,1,1,0,1,0
10,354,354,115,115,0,1,0
23,360,360,16,16,0,1,0
18,375,375,1,1,0,1,0
29,398,398,14,2,12,3,2
21,400,400,94,94,0,1,0
8,401,401,24,9,15,2,1
19,409,409,11,11,0,1,0
22,410,410,62,10,52,4,3
15,412,412,17,17,0,1,0
34,429,429,29,29,0,1,0
31,437,437,7,2,5,2,1
7,438,438,13,5,8,3,2
9,464,464,4,1,3,2,1
6,464,464,27,3,24,4,3
5,467,467,17,7,10,3,2
17,470,470,32,22,10,2,1
11,488,488,111,111,0,1,0

38,100,100,2,2,0,1,0
12,112,112,1,1,0,1,0
25,124,124,1,1,0,1,0
17,127,127,22,7,15,4,3
13,129,129,1,1,0,1,0
31,129,129,1,1,0,1,0
9,134,134,32,7,25,2,1
16,137,137,24,24,0,1,0
11,148,148,14,14,0,1,0
5,149,149,9,9,0,1,0
19,158,158,13,13,0,1,0
21,160,160,5,2,3,2,1
36,177,177,22,1,21,4,3
18,191,191,57,57,0,1,0
20,200,200,31,11,20,2,1
32,210,210,18,2,16,3,2
33,234,234,4,4,0,1,0
4,245,245,74,74,0,1,0
29,279,279,46,25,21,4,3
15,292,292,8,8,0,1,0
27,297,297,28,11,17,4,3
35,303,303,103,53,50,2,1
37,306,306,24,4,20,2,1
14,325,325,16,16,0,1,0
0,331,331,24,24,0,1,0
34,334,334,28,28,0,1,0
8,347,347,9,9,0,1,0
24,349,349,82,82,0,1,0
7,368,368,5,2,3,2,1
23,369,369,18,12,6,3,2
1,374,374,8,2,6,2,1
3,394,394,32,32,0,1,0
30,412,412,40,26,14,3,2
2,442,442,5,5,0,1,0
26,457,457,71,71,0,1,0
28,460,460,22,3,19,2,1
22,462,462,74,74,0,1,0
10,474,474,7,3,4,2,1
6,477,477,68,43,25,2,1

12,105,105,1,1,0,1,0
10,105,105,6,6,0,1,0
26,131,131,8,8,0,1,0
24,136,136,24,3,21,4,3
13,138,138,13,13,0,1,0
29,147,147,2,2,0,1,0
9,161,161,42,12,30,3,2
11,162,162,9,2,7,2,1
35,167,167,14,14,0,1,0
17,207,207,11,4,7,2,1
25,229,229,48,39,9,4,3
23,235,235,32,12,20,3,2
34,240,240,20,6,14,3,2
15,258,258,13,5,8,3,2
14,258,258,81,66,15,2,1
38,267,267,9,1,8,3,2
22,286,286,5,5,0,1,0
1,300,300,25,25,0,1,0
19,308,308,4,4,0,1,0
0,312,312,1,1,0,1,0
16,320,320,47,28,19,2,1
27,340,340,28,3,25,2,1
18,341,341,2,2,0,1,0
4,347,347,22,17,5,2,1
6,366,366,72,12,60,4,3
28,366,366,29,29,0,1,0
5,369,369,23,5,18,2,1
33,388,388,45,14,31,3,2
30,402,402,15,11,4,2,1
2,405,405,1,1,0,1,0
32,408,408,167,167,0,1,0
3,408,408,11,3,8,3,2
37,410,410,69,57,12,2,1
20,417,417,12,12,0,1,0
36,420,420,5,5,0,1,0
31,433,433,21,21,0,1,0
8,443,443,156,91,65,4,3
21,460,460,65,65,0,1,0
7,499,499,25,1,24,4,3

29,104,104,7,4,3,2,1
17,114,114,3,3,0,1,0
25,145,145,8,8,0,1,0
28,161,161,23,20,3,2,1
21,162,162,6,6,0,1,0
18,163,163,23,23,0,1,0
36,173,173,1,1,0,1,0
27,175,175,9,9,0,1,0
30,188,188,9,6,3,2,1
24,196,196,45,45,0,1,0
15,196,196,2,2,0,1,0
37,212,212,62,21,41,2,1
39,222,222,4,4,0,1,0
4,223,223,71,71,0,1,0
32,229,229,1,1,0,1,0
5,238,238,1,1,0,1,0
3,252,252,17,8,9,4,3
9,252,252,2,2,0,1,0
8,273,273,1,1,0,1,0
19,295,295,14,14,0,1,0
35,305,305,19,19,0,1,0
23,316,316,49,49,0,1,0
11,351,351,3,3,0,1,0
26,352,352,28,6,22,3,2
13,353,353,42,42,0,1,0
12,371,371,23,23,0,1,0
10,386,386,6,3,3,2,1
2,387,387,51,25,26,2,1
40,391,391,4,4,0,1,0
1,413,413,59,15,44,2,1
34,421,421,68,68,0,1,0
33,426,426,25,25,0,1,0
16,437,437,34,34,0,1,0
0,438,438,46,46,0,1,0
31,460,460,89,64,25,2,1
22,461,461,95,58,37,4,3
14,477,477,8,8,0,1,0
20,478,478,212,153,59,4,3
38,485,485,49,3,46,2,1
6,488,488,28,28,0,1,0
7,488,488,28,3,25,2,1

19,104,104,11,11,0,1,0
31,109,109,4,1,3,2,1
21,123,123,18,18,0,1,0
27,135,135,27,10,17,2,1
38,142,142,4,1,3,2,1
30,146,146,26,26,0,1,0
26,147,147,5,5,0,1,0
28,148,148,24,9,15,4,3
32,154,154,9,9,0,1,0
23,159,159,47,9,38,2,1
16,182,182,11,11,0,1,0
18,184,184,19,7,12,3,2
4,190,190,17,17,0,1,0
24,197,197,25,25,0,1,0
29,205,205,5,5,0,1,0
1,216,216,3,3,0,1,0
10,224,224,2,2,0,1,0
6,247,247,32,6,26,3,2
17,268,268,23,2,21,2,1
22,279,279,56,56,0,1,0
11,283,283,18,14,4,2,1
25,317,317,45,45,0,1,0
2,318,318,12,12,0,1,0
8,322,322,21,1,20,2,1
20,329,329,3,3,0,1,0
37,335,335,15,1,14,3,2
3,369,369,2,2,0,1,0
14,373,373,65,26,39,4,3
12,378,378,19,19,0,1,0
33,381,381,44,44,0,1,0
15,394,394,26,18,8,3,2
34,411,411,36,20,16,3,2
0,427,427,45,45,0,1,0
13,436,436,132,56,76,3,2
36,436,436,2,2,0,1,0
7,450,450,19,15,4,2,1
5,473,473,139,68,71,4,3
9,488,488,51,51,0,1,0
35,496,496,18,9,9,4,3

15,152,152,14,6,8,3,2
4,172,172,20,6,14,2,1
32,187,187,4,1,3,2,1
20,204,204,11,5,6,3,2
18,208,208,2,2,0,1,0
14,213,213,28,28,0,1,0
24,223,223,30,25,5,2,1
30,227,227,7,3,4,2,1
27,233,233,2,2,0,1,0
0,242,242,33,33,0,1,0
6,249,249,39,14,25,2,1
11,256,256,1,1,0,1,0
25,261,261,88,10,78,4,3
28,262,262,12,12,0,1,0
16,262,262,38,35,3,2,1
8,274,274,3,3,0,1,0
1,295,295,10,10,0,1,0
26,315,315,36,15,21,2,1
3,316,316,2,2,0,1,0
13,338,338,125,27,98,3,2
23,347,347,9,4,5,2,1
29,360,360,22,22,0,1,0
33,376,376,87,65,22,3,2
22,386,386,67,57,10,3,2
17,389,389,19,19,0,1,0
10,404,404,102,102,0,1,0
12,413,413,11,1,10,2,1
21,423,423,102,16,86,4,3
19,426,426,21,21,0,1,0
7,436,436,78,78,0,1,0
2,442,442,94,32,62,3,2
31,462,462,42,17,25,4,3
5,482,482,79,79,0,1,0
34,482,482,55,55,0,1,0
9,485,485,6,6,0,1,0

29,152,152,28,22,6,2,1
25,169,169,4,4,0,1,0
14,191,191,1,1,0,1,0
17,202,202,1,1,0,1,0
7,206,206,1,1,0,1,0
13,207,207,8,1,7,2,1
0,207,207,8,4,4,2,1
3,212,212,5,5,0,1,0
4,215,215,6,6,0,1,0
19,224,224,15,15,0,1,0
33,236,236,78,78,0,1,0
1,237,237,21,21,0,1,0
5,244,244,12,1,11,2,1
11,245,245,9,9,0,1,0
10,249,249,36,30,6,2,1
20,269,269,46,46,0,1,0
8,275,275,84,84,0,1,0
28,283,283,30,24,6,3,2
6,294,294,19,5,14,2,1
26,305,305,41,27,14,2,1
31,325,325,19,9,10,2,1
32,333,333,87,87,0,1,0
24,352,352,4,4,0,1,0
35,359,359,60,60,0,1,0
9,386,386,33,33,0,1,0
22,390,390,13,13,0,1,0
16,432,432,222,179,43,4,3
23,436,436,9,1,8,2,1
21,442,442,85,76,9,4,3
30,443,443,24,19,5,2,1
34,447,447,14,7,7,2,1
15,459,459,88,88,0,1,0
2,474,474,26,26,0,1,0
37,474,474,46,11,35,2,1
36,484,484,24,9,15,2,1
27,485,485,3,3,0,1,0
38,490,490,2,2,0,1,0
12,492,492,14,4,10,3,2
18,494,494,63,23,40,2,1

20,100,100,5,5,0,1,0
1,105,105,1,1,0,1,0
9,112,112,4,1,3,2,1
21,114,114,5,5,0,1,0
35,123,123,14,14,0,1,0
14,130,130,5,5,0,1,0
6,131,131,15,3,12,3,2
16,140,140,53,42,11,2,1
27,144,144,6,6,0,1,0
0,147,147,29,29,0,1,0
38,151,151,5,5,0,1,0
10,164,164,2,2,0,1,0
29,184,184,4,4,0,1,0
24,211,211,6,6,0,1,0
36,217,217,26,26,0,1,0
11,220,220,24,24,0,1,0
30,223,223,3,3,0,1,0
7,230,230,13,13,0,1,0
15,264,264,8,8,0,1,0
33,264,264,104,53,51,4,3
3,273,273,69,26,43,4,3
4,285,285,10,2,8,2,1
12,290,290,22,3,19,2,1
17,302,302,16,16,0,1,0
28,307,307,14,14,0,1,0
5,316,316,13,8,5,2,1
26,318,318,38,38,0,1,0
18,325,325,61,19,42,3,2
22,330,330,35,11,24,4,3
34,346,346,5,5,0,1,0
13,363,363,41,41,0,1,0
37,419,419,93,63,30,2,1
8,427,427,3,3,0,1,0
19,448,448,38,38,0,1,0
31,448,448,19,6,13,2,1
25,460,460,88,37,51,4,3
32,460,460,113,64,49,4,3
2,470,470,32,23,9,4,3
23,484,484,42,18,24,4,3

6,103,103,8,2,6,3,2
19,115,115,8,3,5,2,1
21,120,120,4,1,3,2,1
17,125,125,19,19,0,1,0
3,133,133,27,3,24,4,3
14,147,147,1,1,0,1,0
29,169,169,38,16,22,3,2
8,178,178,10,10,0,1,0
43,195,195,8,8,0,1,0
26,195,195,3,3,0,1,0
16,200,200,1,1,0,1,0
25,204,204,25,12,13,2,1
42,207,207,26,18,8,2,1
7,226,226,11,11,0,1,0
33,227,227,19,9,10,3,2
24,243,243,43,43,0,1,0
9,246,246,8,8,0,1,0
11,253,253,4,4,0,1,0
4,253,253,7,7,0,1,0
40,261,261,25,25,0,1,0
31,268,268,18,1,17,4,3
18,268,268,15,15,0,1,0
20,270,270,18,2,16,2,1
39,271,271,18,18,0,1,0
22,289,289,53,53,0,1,0
37,310,310,53,53,0,1,0
28,319,319,12,12,0,1,0
2,328,328,35,26,9,4,3
35,331,331,53,53,0,1,0
23,337,337,5,5,0,1,0
44,340,340,36,36,0,1,0
27,355,355,19,19,0,1,0
41,364,364,119,51,68,3,2
10,370,370,3,3,0,1,0
12,373,373,10,10,0,1,0
32,396,396,78,78,0,1,0
5,396,396,42,17,25,2,1
34,407,407,14,3,11,4,3
15,429,429,22,22,0,1,0
38,438,438,2,2,0,1,0
30,447,447,46,46,0,1,0
13,453,453,84,38,46,3,2
0,471,471,9,5,4,2,1
1,489,489,25,25,0,1,0
36,495,495,5,2,3,2,1

16,107,107,27,17,10,3,2
31,112,112,45,45,0,1,0
6,120,120,3,3,0,1,0
25,128,128,7,7,0,1,0
27,145,145,6,6,0,1,0
34,158,158,28,28,0,1,0
0,161,161,1,1,0,1,0
40,169,169,8,8,0,1,0
18,179,179,4,1,3,2,1
12,190,190,4,4,0,1,0
36,211,211,8,1,7,3,2
39,229,229,1,1,0,1,0
9,232,232,14,14,0,1,0
37,236,236,28,28,0,1,0
21,252,252,46,46,0,1,0
29,254,254,1,1,0,1,0
38,280,280,45,9,36,4,3
3,285,285,11,4,7,2,1
26,286,286,83,56,27,4,3
35,288,288,47,7,40,3,2
13,296,296,13,1,12,2,1
1,297,297,8,8,0,1,0
33,299,299,22,13,9,2,1
28,304,304,13,7,6,3,2
5,316,316,83,41,42,2,1
22,330,330,11,11,0,1,0
17,337,337,34,34,0,1,0
10,345,345,36,36,0,1,0
4,346,346,7,2,5,2,1
24,360,360,2,2,0,1,0
32,368,368,43,1,42,2,1
15,376,376,10,10,0,1,0
8,382,382,7,1,6,2,1
23,396,396,21,21,0,1,0
7,404,404,46,46,0,1,0
14,410,410,51,43,8,2,1
11,415,415,43,43,0,1,0
19,429,429,89,62,27,2,1
20,445,445,55,55,0,1,0
2,450,450,7,7,0,1,0
30,477,477,57,39,18,4,3

20,113,113,15,15,0,1,0
0,122,122,44,44,0,1,0
29,124,124,17,5,12,2,1
23,162,162,3,3,0,1,0
6,166,166,1,1,0,1,0
15,169,169,28,12,16,3,2
3,174,174,2,2,0,1,0
31,174,174,35,14,21,2,1
24,178,178,9,9,0,1,0
21,179,179,16,16,0,1,0
16,181,181,5,5,0,1,0
5,210,210,17,13,4,2,1
11,223,223,32,32,0,1,0
8,248,248,22,10,12,4,3
28,249,249,23,23,0,1,0
36,252,252,15,15,0,1,0
2,274,274,3,3,0,1,0
12,276,276,1,1,0,1,0
30,277,277,1,1,0,1,0
27,283,283,19,10,9,4,3
9,290,290,51,43,8,3,2
1,299,299,47,7,40,2,1
18,309,309,56,44,12,4,3
4,320,320,16,16,0,1,0
13,347,347,41,29,12,4,3
22,356,356,29,29,0,1,0
37,361,361,37,37,0,1,0
25,361,361,51,31,20,2,1
10,370,370,10,3,7,2,1
17,382,382,85,85,0,1,0
14,388,388,4,4,0,1,0
19,391,391,72,26,46,3,2
34,393,393,17,17,0,1,0
35,416,416,35,11,24,3,2
33,434,434,1,1,0,1,0
7,438,438,27,27,0,1,0
32,439,439,145,145,0,1,0
26,466,466,51,51,0,1,0

23,145,145,6,6,0,1,0
4,147,147,2,2,0,1,0
10,183,183,8,2,6,2,1
0,185,185,7,2,5,2,1
29,191,191,65,65,0,1,0
1,205,205,34,34,0,1,0
18,205,205,7,3,4,2,1
22,212,212,52,52,0,1,0
28,226,226,24,16,8,3,2
20,228,228,21,21,0,1,0
13,273,273,1,1,0,1,0
24,290,290,29,19,10,2,1
31,293,293,4,1,3,2,1
17,303,303,48,22,26,2,1
5,306,306,15,15,0,1,0
19,314,314,14,14,0,1,0
6,333,333,189,171,18,4,3
9,334,334,49,49,0,1,0
25,343,343,38,12,26,3,2
34,347,347,22,22,0,1,0
27,348,348,5,5,0,1,0
3,371,371,13,13,0,1,0
16,374,374,7,7,0,1,0
11,394,394,178,118,60,4,3
14,406,406,21,21,0,1,0
8,408,408,2,2,0,1,0
7,409,409,14,14,0,1,0
33,414,414,37,37,0,1,0
32,419,419,75,35,40,2,1
26,430,430,113,113,0,1,0
2,431,431,12,2,10,2,1
12,456,456,25,15,10,2,1
21,484,484,3,3,0,1,0
30,487,487,8,8,0,1,0
15,493,493,105,55,50,2,1

20,116,116,1,1,0,1,0
21,121,121,7,7,0,1,0
4,124,124,6,1,5,2,1
11,129,129,7,4,3,2,1
12,142,142,6,6,0,1,0
29,154,154,29,29,0,1,0
24,161,161,9,9,0,1,0
8,163,163,4,4,0,1,0
17,191,191,15,3,12,3,2
32,196,196,6,6,0,1,0
1,209,209,15,15,0,1,0
27,233,233,1,1,0,1,0
33,240,240,14,8,6,3,2
7,244,244,72,22,50,2,1
6,258,258,27,2,25,2,1
2,258,258,37,3,34,2,1
23,266,266,85,23,62,3,2
26,271,271,56,36,20,4,3
18,272,272,27,12,15,2,1
31,278,278,31,31,0,1,0
19,284,284,13,13,0,1,0
25,294,294,57,57,0,1,0
0,332,332,32,21,11,2,1
28,336,336,14,11,3,2,1
5,360,360,95,2,93,4,3
34,372,372,38,38,0,1,0
3,373,373,42,42,0,1,0
10,380,380,26,26,0,1,0
9,394,394,113,84,29,2,1
15,437,437,28,28,0,1,0
35,440,440,41,41,0,1,0
22,463,463,25,1,24,3,2
13,466,466,43,6,37,2,1
14,468,468,47,13,34,3,2
30,491,491,95,50,45,4,3
16,499,499,16,7,9,4,3

13,102,102,5,5,0,1,0
14,103,103,5,5,0,1,0
28,103,103,4,4,0,1,0
4,105,105,10,10,0,1,0
30,114,114,3,3,0,1,0
9,119,119,1,1,0,1,0
10,128,128,15,15,0,1,0
31,136,136,2,2,0,1,0
36,152,152,29,13,16,3,2
19,156,156,7,7,0,1,0
1,157,157,7,1,6,3,2
3,161,161,1,1,0,1,0
5,189,189,6,3,3,2,1
12,194,194,1,1,0,1,0
0,210,210,3,3,0,1,0
37,211,211,29,29,0,1,0
21,212,212,64,64,0,1,0
40,228,228,9,9,0,1,0
8,232,232,25,4,21,4,3
17,246,246,29,5,24,3,2
2,249,249,7,7,0,1,0
42,250,250,30,14,16,3,2
7,252,252,16,16,0,1,0
27,256,256,4,4,0,1,0
23,266,266,36,18,18,3,2
15,273,273,23,23,0,1,0
29,275,275,94,46,48,2,1
32,280,280,31,31,0,1,0
38,296,296,18,4,14,3,2
43,312,312,9,3,6,2,1
24,314,314,3,3,0,1,0
20,327,327,33,33,0,1,0
26,334,334,10,3,7,2,1
11,348,348,6,6,0,1,0
18,350,350,38,24,14,2,1
25,363,363,41,7,34,3,2
45,367,367,15,15,0,1,0
39,371,371,121,90,31,2,1
35,386,386,8,1,7,3,2
34,394,394,47,47,0,1,0
16,411,411,27,13,14,3,2
6,432,432,48,36,12,4,3
33,475,475,4,4,0,1,0
41,490,490,39,2,37,2,1
22,500,500,21,21,0,1,0
44,500,500,108,47,61,4,3

0,126,126,8,8,0,1,0
11,133,133,16,16,0,1,0
22,133,133,52,8,44,2,1
1,144,144,13,13,0,1,0
36,159,159,8,5,3,2,1
39,167,167,45,2,43,2,1
35,175,175,26,26,0,1,0
12,177,177,4,1,3,2,1
27,182,182,17,17,0,1,0
40,194,194,5,5,0,1,0
33,208,208,37,7,30,3,2
18,219,219,30,30,0,1,0
34,241,241,21,9,12,2,1
9,242,242,47,10,37,3,2
2,249,249,3,3,0,1,0
30,253,253,63,63,0,1,0
24,254,254,2,2,0,1,0
6,266,266,16,10,6,3,2
10,270,270,36,2,34,3,2
16,274,274,1,1,0,1,0
7,286,286,1,1,0,1,0
31,294,294,39,39,0,1,0
26,297,297,36,28,8,3,2
38,299,299,4,4,0,1,0
32,307,307,22,2,20,2,1
3,307,307,68,68,0,1,0
41,325,325,49,49,0,1,0
17,367,367,12,12,0,1,0
29,372,372,23,23,0,1,0
5,376,376,2,2,0,1,0
14,396,396,40,15,25,2,1
4,399,399,7,7,0,1,0
21,426,426,9,9,0,1,0
37,427,427,31,31,0,1,0
20,451,451,22,3,19,2,1
8,472,472,59,59,0,1,0
23,473,473,10,10,0,1,0
13,473,473,1,1,0,1,0
15,473,473,34,13,21,2,1
19,483,483,12,12,0,1,0
25,490,490,80,52,28,2,1
28,495,495,10,6,4,2,1

31,101,101,4,1,3,2,1
16,104,104,4,1,3,2,1
0,126,126,11,11,0,1,0
4,130,130,3,3,0,1,0
32,152,152,8,8,0,1,0
15,157,157,8,3,5,2,1
34,204,204,16,16,0,1,0
14,217,217,11,11,0,1,0
30,218,218,29,11,18,3,2
8,224,224,64,64,0,1,0
27,253,253,22,10,12,2,1
28,254,254,6,6,0,1,0
9,257,257,5,5,0,1,0
2,259,259,32,25,7,2,1
5,265,265,40,40,0,1,0
19,272,272,129,29,100,4,3
13,290,290,90,72,18,4,3
26,304,304,33,33,0,1,0
21,322,322,47,16,31,2,1
20,323,323,62,14,48,2,1
7,333,333,8,8,0,1,0
11,361,361,24,24,0,1,0
23,373,373,16,10,6,3,2
25,382,382,13,7,6,3,2
12,382,382,28,28,0,1,0
33,386,386,15,9,6,2,1
24,387,387,22,10,12,3,2
17,399,399,57,21,36,3,2
10,415,415,139,139,0,1,0
29,432,432,48,34,14,3,2
1,435,435,111,87,24,2,1
18,457,457,29,11,18,4,3
6,486,486,19,19,0,1,0
3,490,490,5,5,0,1,0
22,494,494,41,41,0,1,0

16,102,102,16,2,14,4,3
35,105,105,16,12,4,2,1
1,114,114,19,19,0,1,0
38,120,120,3,3,0,1,0
7,126,126,13,13,0,1,0
14,146,146,4,4,0,1,0
2,146,146,20,20,0,1,0
11,164,164,21,9,12,4,3
23,176,176,14,14,0,1,0
25,204,204,4,4,0,1,0
9,231,231,17,17,0,1,0
24,243,243,6,6,0,1,0
17,274,274,54,16,38,3,2
22,276,276,41,41,0,1,0
20,280,280,3,3,0,1,0
21,283,283,10,4,6,2,1
37,298,298,2,2,0,1,0
4,304,304,15,3,12,2,1
26,323,323,42,42,0,1,0
31,326,326,76,53,23,2,1
12,337,337,63,9,54,4,3
27,355,355,123,123,0,1,0
36,358,358,4,4,0,1,0
28,376,376,3,3,0,1,0
8,377,377,15,15,0,1,0
30,382,382,120,111,9,4,3
5,388,388,6,1,5,2,1
10,390,390,1,1,0,1,0
15,396,396,3,3,0,1,0
18,411,411,36,36,0,1,0
13,415,415,41,32,9,2,1
29,421,421,12,12,0,1,0
34,421,421,109,109,0,1,0
33,432,432,34,24,10,2,1
3,459,459,60,38,22,2,1
6,462,462,40,40,0,1,0
0,467,467,51,7,44,4,3
32,495,495,10,10,0,1,0
19,496,496,48,24,24,4,3

31,112,112,21,21,0,1,0
19,121,121,17,5,12,4,3
0,122,122,8,8,0,1,0
33,140,140,2,2,0,1,0
5,143,143,28,5,23,2,1
21,180,180,23,20,3,2,1
24,189,189,12,3,9,2,1
2,193,193,14,14,0,1,0
17,202,202,2,2,0,1,0
18,219,219,6,1,5,2,1
13,230,230,30,30,0,1,0
23,232,232,12,2,10,3,2
22,238,238,31,31,0,1,0
3,283,283,18,18,0,1,0
27,295,295,4,4,0,1,0
14,304,304,16,16,0,1,0
30,330,330,66,66,0,1,0
9,347,347,42,4,38,3,2
1,349,349,9,9,0,1,0
8,353,353,61,61,0,1,0
25,359,359,28,28,0,1,0
10,362,362,44,15,29,2,1
20,368,368,11,1,10,3,2
32,369,369,20,10,10,2,1
15,372,372,3,3,0,1,0
28,372,372,6,6,0,1,0
16,409,409,40,40,0,1,0
11,421,421,17,7,10,2,1
34,435,435,92,44,48,3,2
4,437,437,132,84,48,3,2
35,441,441,40,1,39,4,3
6,442,442,151,151,0,1,0
36,451,451,34,34,0,1,0
26,453,453,72,17,55,4,3
12,456,456,35,23,12,3,2
7,477,477,2,2,0,1,0
29,486,486,130,130,0,1,0

28,102,102,8,3,5,2,1
6,103,103,3,3,0,1,0
23,117,117,1,1,0,1,0
7,118,118,1,1,0,1,0
8,130,130,14,14,0,1,0
25,132,132,9,9,0,1,0
9,134,134,1,1,0,1,0
37,161,161,26,22,4,2,1
13,205,205,54,29,25,4,3
11,210,210,22,10,12,3,2
26,218,218,15,15,0,1,0
5,221,221,2,2,0,1,0
3,226,226,17,9,8,3,2
34,228,228,26,13,13,2,1
19,234,234,75,38,37,2,1
40,242,242,3,3,0,1,0
17,245,245,10,10,0,1,0
29,271,271,8,8,0,1,0
1,274,274,37,19,18,4,3
38,280,280,40,33,7,2,1
33,286,286,15,15,0,1,0
4,297,297,41,41,0,1,0
24,300,300,43,31,12,3,2
21,301,301,19,19,0,1,0
2,317,317,1,1,0,1,0
22,338,338,18,3,15,4,3
27,343,343,4,4,0,1,0
12,349,349,9,1,8,2,1
15,352,352,17,17,0,1,0
35,367,367,9,9,0,1,0
36,389,389,132,98,34,2,1
32,391,391,112,57,55,4,3
30,395,395,39,27,12,4,3
18,419,419,28,28,0,1,0
20,419,419,70,4,66,3,2
0,420,420,24,4,20,2,1
16,436,436,5,5,0,1,0
31,451,451,87,84,3,2,1
14,451,451,17,13,4,2,1
10,476,476,87,7,80,3,2
39,481,481,24,24,0,1,0

26,131,131,9,1,8,2,1
28,131,131,18,18,0,1,0
32,143,143,2,2,0,1,0
21,158,158,10,5,5,2,1
6,159,159,13,13,0,1,0
22,168,168,12,12,0,1,0
19,185,185,40,40,0,1,0
29,192,192,68,58,10,2,1
20,229,229,17,3,14,3,2
31,230,230,30,26,4,2,1
24,230,230,27,27,0,1,0
0,236,236,44,22,22,3,2
27,246,246,1,1,0,1,0
34,256,256,3,3,0,1,0
1,267,267,4,1,3,2,1
2,302,302,11,11,0,1,0
15,315,315,6,6,0,1,0
17,318,318,13,13,0,1,0
12,322,322,23,3,20,3,2
11,325,325,120,81,39,4,3
14,329,329,103,73,30,4,3
3,340,340,28,28,0,1,0
7,366,366,31,21,10,2,1
13,373,373,1,1,0,1,0
30,376,376,29,20,9,4,3
10,390,390,129,99,30,3,2
25,390,390,42,42,0,1,0
23,423,423,8,8,0,1,0
16,425,425,37,37,0,1,0
5,433,433,22,3,19,2,1
8,443,443,82,31,51,4,3
4,444,444,13,13,0,1,0
9,452,452,19,19,0,1,0
18,462,462,38,38,0,1,0
33,488,488,133,17,116,4,3

11,102,102,13,13,0,1,0
41,106,106,29,29,0,1,0
19,107,107,4,4,0,1,0
30,108,108,10,10,0,1,0
32,124,124,15,6,9,2,1
42,128,128,8,8,0,1,0
39,138,138,10,10,0,1,0
4,147,147,29,4,25,4,3
29,179,179,34,34,0,1,0
16,197,197,4,1,3,2,1
18,202,202,56,46,10,2,1
33,208,208,1,1,0,1,0
31,209,209,13,13,0,1,0
17,214,214,7,7,0,1,0
12,217,217,2,2,0,1,0
15,224,224,1,1,0,1,0
5,246,246,8,8,0,1,0
26,262,262,24,13,11,2,1
23,267,267,47,5,42,2,1
7,270,270,11,11,0,1,0
10,281,281,83,77,6,3,2
9,297,297,5,5,0,1,0
37,300,300,5,5,0,1,0
25,310,310,22,6,16,3,2
14,336,336,46,46,0,1,0
2,343,343,14,11,3,2,1
22,370,370,43,43,0,1,0
27,373,373,72,24,48,3,2
20,376,376,5,5,0,1,0
36,376,376,21,2,19,2,1
24,378,378,14,9,5,2,1
40,381,381,22,22,0,1,0
38,412,412,8,8,0,1,0
35,417,417,49,49,0,1,0
13,420,420,26,13,13,4,3
34,422,422,108,88,20,3,2
0,427,427,1,1,0,1,0
6,427,427,29,29,0,1,0
3,440,440,52,21,31,2,1
8,473,473,13,13,0,1,0
21,492,492,23,23,0,1,0
28,497,497,73,73,0,1,0
1,497,497,1,1,0,1,0

28,101,101,3,3,0,1,0
15,103,103,18,18,0,1,0
32,116,116,19,19,0,1,0
21,123,123,7,2,5,2,1
9,142,142,2,2,0,1,0
3,146,146,23,4,19,3,2
2,148,148,14,9,5,2,1
19,160,160,15,15,0,1,0
33,175,175,2,2,0,1,0
26,186,186,52,52,0,1,0
36,208,208,79,6,73,4,3
6,239,239,27,10,17,2,1
0,257,257,17,14,3,2,1
22,267,267,45,45,0,1,0
10,272,272,1,1,0,1,0
11,275,275,82,82,0,1,0
1,277,277,9,9,0,1,0
14,311,311,1,1,0,1,0
31,313,313,37,37,0,1,0
13,345,345,3,3,0,1,0
23,349,349,24,24,0,1,0
16,350,350,39,31,8,3,2
7,356,356,112,97,15,4,3
24,366,366,93,71,22,3,2
34,370,370,26,26,0,1,0
30,372,372,27,27,0,1,0
29,389,389,27,27,0,1,0
27,413,413,2,2,0,1,0
20,432,432,25,25,0,1,0
35,433,433,4,1,3,2,1
4,441,441,68,46,22,2,1
25,457,457,12,6,6,3,2
8,465,465,2,2,0,1,0
12,467,467,21,21,0,1,0
17,471,471,97,43,54,3,2
5,485,485,48,24,24,4,3
18,490,490,2,2,0,1,0

33,148,148,14,2,12,4,3
31,149,149,7,7,0,1,0
32,154,154,4,4,0,1,0
4,162,162,5,1,4,2,1
13,167,167,13,13,0,1,0
40,183,183,26,21,5,2,1
30,206,206,26,26,0,1,0
10,207,207,14,14,0,1,0
28,214,214,7,7,0,1,0
43,223,223,24,24,0,1,0
5,223,223,13,1,12,3,2
34,231,231,49,3,46,3,2
3,238,238,23,5,18,3,2
0,241,241,3,3,0,1,0
46,250,250,20,12,8,3,2
44,256,256,23,15,8,3,2
26,261,261,9,9,0,1,0
45,266,266,43,16,27,4,3
27,269,269,1,1,0,1,0
41,272,272,49,49,0,1,0
9,277,277,1,1,0,1,0
25,278,278,51,39,12,4,3
37,287,287,15,15,0,1,0
36,292,292,17,11,6,3,2
22,294,294,33,25,8,3,2
39,325,325,34,26,8,2,1
23,326,326,37,9,28,2,1
11,333,333,24,24,0,1,0
12,340,340,17,17,0,1,0
2,368,368,11,11,0,1,0
38,371,371,81,6,75,4,3
8,372,372,3,3,0,1,0
16,373,373,61,3,58,3,2
21,394,394,42,42,0,1,0
15,394,394,1,1,0,1,0
18,401,401,1,1,0,1,0
19,414,414,68,68,0,1,0
47,417,417,24,9,15,2,1
7,420,420,64,34,30,4,3
20,429,429,23,23,0,1,0
24,445,445,1,1,0,1,0
35,448,448,32,26,6,2,1
42,451,451,37,37,0,1,0
14,453,453,22,16,6,3,2
6,457,457,90,51,39,2,1
17,465,465,9,9,0,1,0
1,498,498,2,2,0,1,0
29,500,500,12,12,0,1,0

15,102,102,2,2,0,1,0
11,123,123,3,3,0,1,0
10,140,140,6,1,5,2,1
21,162,162,9,9,0,1,0
17,174,174,32,2,30,3,2
37,174,174,26,14,12,3,2
30,175,175,6,2,4,2,1
34,191,191,5,5,0,1,0
23,208,208,1,1,0,1,0
27,217,217,16,16,0,1,0
26,231,231,4,4,0,1,0
0,243,243,5,5,0,1,0
1,249,249,39,39,0,1,0
39,257,257,35,35,0,1,0
38,267,267,38,2,36,4,3
8,277,277,7,7,0,1,0
19,280,280,34,4,30,3,2
28,282,282,14,5,9,4,3
32,287,287,53,27,26,3,2
6,290,290,16,2,14,3,2
29,290,290,2,2,0,1,0
3,292,292,45,45,0,1,0
20,311,311,30,16,14,3,2
9,318,318,11,11,0,1,0
22,321,321,10,6,4,2,1
24,321,321,5,5,0,1,0
41,329,329,104,14,90,3,2
18,331,331,2,2,0,1,0
33,334,334,19,19,0,1,0
35,341,341,62,41,21,2,1
4,361,361,1,1,0,1,0
31,370,370,50,30,20,3,2
16,372,372,11,8,3,2,1
7,391,391,54,54,0,1,0
40,396,396,28,19,9,4,3
25,397,397,21,3,18,4,3
2,415,415,84,72,12,4,3
36,426,426,120,30,90,4,3
5,428,428,44,44,0,1,0
14,450,450,95,26,69,4,3
12,462,462,32,26,6,3,2
13,476,476,56,56,0,1,0

36,101,101,19,9,10,3,2
34,118,118,7,7,0,1,0
22,118,118,11,6,5,2,1
14,120,120,6,6,0,1,0
17,124,124,3,3,0,1,0
9,133,133,3,3,0,1,0
33,133,133,34,9,25,2,1
38,146,146,10,10,0,1,0
32,154,154,5,1,4,2,1
11,155,155,7,7,0,1,0
39,164,164,41,41,0,1,0
35,175,175,23,23,0,1,0
4,176,176,2,2,0,1,0
10,204,204,18,14,4,2,1
8,209,209,34,34,0,1,0
0,219,219,3,3,0,1,0
26,223,223,50,1,49,2,1
25,226,226,15,15,0,1,0
19,228,228,23,7,16,3,2
24,231,231,16,16,0,1,0
30,252,252,16,16,0,1,0
28,267,267,3,3,0,1,0
31,275,275,13,13,0,1,0
1,276,276,46,38,8,2,1
18,283,283,10,2,8,2,1
3,287,287,8,4,4,2,1
7,312,312,8,8,0,1,0
27,314,314,90,42,48,4,3
20,319,319,11,4,7,2,1
37,381,381,27,1,26,2,1
21,388,388,7,7,0,1,0
15,399,399,108,77,31,3,2
12,423,423,20,4,16,2,1
16,431,431,9,9,0,1,0
13,445,445,117,82,35,2,1
23,451,451,11,11,0,1,0
29,463,463,1,1,0,1,0
5,470,470,35,21,14,2,1
6,471,471,27,27,0,1,0
40,496,496,2,2,0,1,0
2,500,500,170,140,30,3,2

14,101,101,4,4,0,1,0
30,106,106,23,23,0,1,0
31,108,108,5,5,0,1,0
4,138,138,17,17,0,1,0
35,158,158,17,9,8,2,1
15,165,165,5,5,0,1,0
26,170,170,12,12,0,1,0
13,177,177,84,12,72,3,2
5,182,182,1,1,0,1,0
17,184,184,6,6,0,1,0
24,195,195,12,5,7,2,1
11,206,206,8,8,0,1,0
36,216,216,34,7,27,4,3
8,241,241,1,1,0,1,0
12,249,249,5,5,0,1,0
10,252,252,17,5,12,3,2
16,252,252,3,3,0,1,0
33,261,261,32,19,13,2,1
32,261,261,63,54,9,4,3
25,272,272,2,2,0,1,0
38,274,274,24,3,21,4,3
23,277,277,17,17,0,1,0
0,291,291,6,6,0,1,0
34,309,309,33,33,0,1,0
37,322,322,21,21,0,1,0
20,340,340,29,29,0,1,0
29,364,364,99,99,0,1,0
1,380,380,73,73,0,1,0
21,384,384,17,8,9,4,3
18,388,388,94,63,31,2,1
7,401,401,143,113,30,2,1
6,418,418,11,6,5,2,1
28,421,421,53,27,26,2,1
22,429,429,12,4,8,3,2
27,436,436,14,7,7,2,1
19,471,471,10,1,9,4,3
9,476,476,32,7,25,3,2
3,479,479,30,30,0,1,0
2,498,498,32,19,13,2,1

3,101,101,3,3,0,1,0
11,101,101,5,2,3,2,1
12,111,111,2,2,0,1,0
13,128,128,34,34,0,1,0
21,133,133,36,36,0,1,0
2,137,137,14,14,0,1,0
30,149,149,2,2,0,1,0
28,162,162,15,15,0,1,0
16,190,190,7,7,0,1,0
7,208,208,6,2,4,2,1
31,219,219,31,19,12,3,2
10,221,221,5,5,0,1,0
9,223,223,25,8,17,3,2
33,252,252,15,3,12,2,1
32,252,252,15,15,0,1,0
23,252,252,18,18,0,1,0
24,263,263,14,14,0,1,0
1,265,265,115,15,100,3,2
26,268,268,3,3,0,1,0
22,271,271,20,20,0,1,0
4,305,305,7,1,6,2,1
15,357,357,19,3,16,4,3
18,372,372,68,68,0,1,0
6,373,373,127,94,33,4,3
17,377,377,28,28,0,1,0
29,389,389,15,3,12,2,1
27,425,425,139,64,75,4,3
0,427,427,27,2,25,2,1
5,440,440,106,62,44,2,1
25,455,455,2,2,0,1,0
19,457,457,44,44,0,1,0
8,463,463,7,7,0,1,0
14,478,478,74,74,0,1,0
20,487,487,135,95,40,3,2

24,104,104,7,4,3,2,1
4,117,117,14,14,0,1,0
15,121,121,3,3,0,1,0
27,129,129,2,2,0,1,0
12,139,139,23,1,22,2,1
22,150,150,8,4,4,2,1
18,161,161,2,2,0,1,0
14,210,210,3,3,0,1,0
3,216,216,2,2,0,1,0
28,216,216,8,5,3,2,1
0,218,218,13,13,0,1,0
8,235,235,33,11,22,2,1
21,242,242,43,3,40,2,1
32,260,260,13,13,0,1,0
20,266,266,28,28,0,1,0
31,269,269,20,10,10,2,1
26,291,291,31,15,16,3,2
19,294,294,30,10,20,2,1
9,327,327,145,12,133,4,3
1,328,328,133,123,10,2,1
5,356,356,7,1,6,3,2
10,366,366,104,16,88,3,2
7,376,376,18,18,0,1,0
16,378,378,5,5,0,1,0
29,391,391,22,4,18,3,2
13,402,402,25,11,14,2,1
17,414,414,109,25,84,4,3
23,420,420,1,1,0,1,0
25,426,426,185,53,132,4,3
11,450,450,3,3,0,1,0
30,457,457,152,99,53,3,2
2,489,489,55,37,18,4,3
6,497,497,12,12,0,1,0

26,123,123,6,6,0,1,0
3,125,125,1,1,0,1,0
4,138,138,3,3,0,1,0
6,152,152,55,17,38,3,2
34,160,160,1,1,0,1,0
25,170,170,16,16,0,1,0
2,176,176,18,9,9,2,1
15,205,205,33,14,19,2,1
27,211,211,22,22,0,1,0
36,211,211,30,3,27,4,3
21,216,216,23,8,15,4,3
19,227,227,17,17,0,1,0
29,231,231,7,7,0,1,0
33,244,244,19,6,13,2,1
0,246,246,19,19,0,1,0
9,263,263,3,3,0,1,0
1,264,264,7,4,3,2,1
12,265,265,7,7,0,1,0
31,271,271,10,10,0,1,0
16,272,272,28,28,0,1,0
7,275,275,27,1,26,2,1
35,286,286,8,8,0,1,0
32,318,318,19,4,15,4,3
20,325,325,85,7,78,4,3
30,338,338,39,22,17,4,3
11,347,347,26,4,22,2,1
17,360,360,1,1,0,1,0
24,378,378,3,3,0,1,0
28,380,380,80,68,12,3,2
13,381,381,31,31,0,1,0
40,390,390,113,50,63,4,3
39,393,393,62,29,33,4,3
8,394,394,50,45,5,2,1
18,395,395,1,1,0,1,0
41,417,417,5,5,0,1,0
14,435,435,5,5,0,1,0
22,443,443,39,28,11,2,1
38,457,457,30,10,20,3,2
5,457,457,23,23,0,1,0
37,459,459,179,171,8,2,1
10,463,463,10,1,9,4,3
23,471,471,26,5,21,3,2

12,141,141,1,1,0,1,0
27,145,145,3,3,0,1,0
11,154,154,14,14,0,1,0
16,158,158,13,5,8,2,1
4,173,173,29,18,11,2,1
10,174,174,7,7,0,1,0
20,180,180,42,42,0,1,0
21,191,191,5,1,4,2,1
25,211,211,22,22,0,1,0
0,226,226,14,9,5,2,1
2,231,231,8,8,0,1,0
7,243,243,2,2,0,1,0
14,249,249,14,14,0,1,0
31,255,255,48,48,0,1,0
5,268,268,2,2,0,1,0
39,279,279,41,41,0,1,0
34,290,290,18,15,3,2,1
9,305,305,28,28,0,1,0
3,328,328,2,2,0,1,0
36,335,335,66,24,42,2,1
6,336,336,39,25,14,2,1
30,340,340,37,25,12,2,1
8,344,344,32,4,28,3,2
28,347,347,8,8,0,1,0
17,364,364,23,16,7,3,2
13,365,365,109,109,0,1,0
1,370,370,4,4,0,1,0
41,397,397,9,9,0,1,0
19,401,401,19,13,6,2,1
37,402,402,35,35,0,1,0
35,403,403,70,70,0,1,0
29,404,404,45,45,0,1,0
32,415,415,19,10,9,4,3
23,416,416,42,35,7,2,1
38,420,420,19,19,0,1,0
15,425,425,61,16,45,2,1
40,437,437,26,5,21,2,1
18,460,460,88,2,86,4,3
33,466,466,13,13,0,1,0
22,469,469,11,5,6,3,2
26,471,471,100,100,0,1,0
24,492,492,93,14,79,4,3

0,102,102,10,10,0,1,0
30,108,108,6,6,0,1,0
24,130,130,25,7,18,3,2
14,135,135,20,14,6,2,1
13,149,149,9,9,0,1,0
20,157,157,16,16,0,1,0
4,161,161,56,21,35,2,1
23,176,176,54,42,12,3,2
11,179,179,64,64,0,1,0
27,201,201,25,20,5,2,1
22,234,234,4,4,0,1,0
17,237,237,2,2,0,1,0
25,252,252,1,1,0,1,0
21,282,282,3,3,0,1,0
5,284,284,18,18,0,1,0
9,315,315,22,22,0,1,0
8,319,319,94,94,0,1,0
32,321,321,10,10,0,1,0
2,333,333,1,1,0,1,0
16,355,355,65,65,0,1,0
15,358,358,1,1,0,1,0
12,358,358,14,8,6,2,1
26,374,374,30,19,11,2,1
3,374,374,38,5,33,4,3
28,389,389,32,3,29,2,1
7,395,395,15,15,0,1,0
1,396,396,54,54,0,1,0
6,408,408,54,1,53,3,2
10,438,438,70,48,22,3,2
18,443,443,2,2,0,1,0
31,448,448,169,169,0,1,0
29,484,484,27,7,20,2,1
19,490,490,75,37,38,3,2

17,103,103,18,15,3,2,1
1,106,106,10,10,0,1,0
16,114,114,4,4,0,1,0
38,135,135,8,8,0,1,0
18,147,147,6,6,0,1,0
35,152,152,21,8,13,2,1
33,159,159,23,23,0,1,0
3,165,165,71,33,38,2,1
24,180,180,5,5,0,1,0
11,182,182,18,1,17,3,2
26,185,185,61,35,26,3,2
22,196,196,2,2,0,1,0
28,201,201,14,14,0,1,0
23,205,205,2,2,0,1,0
20,213,213,1,1,0,1,0
5,221,221,1,1,0,1,0
40,227,227,15,6,9,2,1
4,271,271,48,48,0,1,0
2,293,293,1,1,0,1,0
39,294,294,27,12,15,2,1
25,297,297,19,7,12,3,2
19,316,316,82,73,9,4,3
31,321,321,6,6,0,1,0
9,328,328,1,1,0,1,0
30,329,329,49,9,40,2,1
12,330,330,8,8,0,1,0
32,348,348,95,52,43,3,2
36,352,352,4,4,0,1,0
14,356,356,42,42,0,1,0
37,361,361,118,41,77,4,3
0,386,386,11,2,9,2,1
6,399,399,9,9,0,1,0
10,407,407,7,7,0,1,0
13,409,409,13,13,0,1,0
34,431,431,24,24,0,1,0
7,436,436,68,23,45,4,3
8,438,438,26,1,25,2,1
21,444,444,16,11,5,2,1
29,457,457,38,38,0,1,0
41,463,463,7,7,0,1,0
27,491,491,6,6,0,1,0
15,495,495,35,17,18,4,3

39,100,100,10,10,0,1,0
29,141,141,8,8,0,1,0
34,148,148,21,6,15,3,2
30,154,154,3,3,0,1,0
14,174,174,18,4,14,2,1
36,191,191,13,13,0,1,0
18,197,197,18,18,0,1,0
9,197,197,20,20,0,1,0
10,215,215,59,11,48,4,3
19,219,219,7,4,3,2,1
27,225,225,77,56,21,4,3
23,251,251,11,11,0,1,0
7,252,252,1,1,0,1,0
37,261,261,47,47,0,1,0
16,264,264,1,1,0,1,0
6,264,264,20,20,0,1,0
20,274,274,7,7,0,1,0
21,284,284,41,17,24,4,3
26,285,285,23,18,5,2,1
35,299,299,39,39,0,1,0
4,315,315,26,2,24,2,1
31,315,315,25,17,8,3,2
1,320,320,74,74,0,1,0
17,354,354,18,18,0,1,0
24,391,391,13,13,0,1,0
33,397,397,27,27,0,1,0
32,404,404,17,17,0,1,0
22,416,416,27,27,0,1,0
5,418,418,4,4,0,1,0
12,426,426,19,19,0,1,0
3,427,427,135,135,0,1,0
38,434,434,57,14,43,4,3
8,438,438,7,7,0,1,0
0,444,444,39,27,12,4,3
25,447,447,29,10,19,4,3
11,448,448,24,16,8,2,1
2,457,457,9,9,0,1,0
13,461,461,4,4,0,1,0
28,463,463,65,41,24,2,1
15,497,497,133,79,54,4,3

37,111,111,8,3,5,2,1
17,115,115,20,14,6,3,2
29,121,121,10,7,3,2,1
9,121,121,21,2,19,2,1
23,125,125,14,14,0,1,0
34,133,133,8,8,0,1,0
6,135,135,14,5,9,2,1
24,140,140,12,12,0,1,0
25,144,144,9,2,7,2,1
0,166,166,8,5,3,2,1
30,167,167,21,21,0,1,0
14,169,169,69,45,24,4,3
19,174,174,80,80,0,1,0
4,194,194,1,1,0,1,0
3,202,202,41,41,0,1,0
18,206,206,2,2,0,1,0
11,210,210,3,3,0,1,0
28,221,221,14,14,0,1,0
26,244,244,21,21,0,1,0
5,246,246,81,81,0,1,0
8,260,260,14,2,12,4,3
36,269,269,16,1,15,4,3
22,280,280,61,33,28,3,2
2,280,280,19,4,15,4,3
7,292,292,10,10,0,1,0
27,297,297,6,6,0,1,0
13,320,320,18,18,0,1,0
20,357,357,104,104,0,1,0
10,362,362,19,4,15,4,3
21,385,385,46,46,0,1,0
31,389,389,7,7,0,1,0
15,421,421,1,1,0,1,0
32,437,437,2,2,0,1,0
1,456,456,23,23,0,1,0
12,474,474,9,6,3,2,1
16,474,474,45,45,0,1,0
35,488,488,5,2,3,2,1
33,500,500,6,3,3,2,1

34,101,101,2,2,0,1,0
11,106,106,7,7,0,1,0
42,113,113,10,10,0,1,0
6,116,116,14,14,0,1,0
28,123,123,11,5,6,2,1
24,130,130,37,6,31,3,2
2,148,148,6,6,0,1,0
14,158,158,7,7,0,1,0
40,176,176,3,3,0,1,0
9,182,182,16,16,0,1,0
4,185,185,20,20,0,1,0
41,191,191,5,5,0,1,0
23,199,199,5,5,0,1,0
22,201,201,4,4,0,1,0
12,209,209,11,8,3,2,1
18,220,220,9,9,0,1,0
37,230,230,6,3,3,2,1
5,257,257,1,1,0,1,0
30,289,289,35,35,0,1,0
36,296,296,14,6,8,2,1
35,298,298,25,3,22,3,2
39,303,303,31,31,0,1,0
33,318,318,18,18,0,1,0
15,328,328,15,15,0,1,0
25,330,330,17,2,15,2,1
21,353,353,61,61,0,1,0
3,362,362,56,8,48,2,1
1,373,373,66,16,50,2,1
7,375,375,17,17,0,1,0
20,383,383,46,16,30,2,1
27,385,385,148,148,0,1,0
10,386,386,10,10,0,1,0
16,403,403,12,4,8,3,2
26,412,412,35,6,29,2,1
31,429,429,3,3,0,1,0
17,435,435,11,11,0,1,0
8,448,448,88,88,0,1,0
0,465,465,8,8,0,1,0
38,466,466,164,164,0,1,0
13,466,466,85,11,74,3,2
29,483,483,16,16,0,1,0
32,486,486,25,25,0,1,0
19,490,490,50,45,5,2,1

9,111,111,41,15,26,3,2
8,116,116,22,8,14,2,1
20,134,134,19,19,0,1,0
12,135,135,2,2,0,1,0
14,137,137,27,27,0,1,0
37,140,140,28,7,21,4,3
28,153,153,4,4,0,1,0
3,158,158,16,4,12,2,1
11,179,179,29,29,0,1,0
26,182,182,69,9,60,4,3
33,183,183,5,5,0,1,0
31,184,184,22,8,14,3,2
17,193,193,10,10,0,1,0
2,202,202,4,4,0,1,0
32,208,208,13,3,10,3,2
6,221,221,9,9,0,1,0
24,232,232,15,7,8,2,1
15,244,244,16,4,12,3,2
35,250,250,32,5,27,4,3
19,280,280,22,13,9,4,3
38,311,311,30,17,13,2,1
29,326,326,1,1,0,1,0
21,339,339,16,1,15,4,3
0,361,361,3,3,0,1,0
25,367,367,12,12,0,1,0
5,389,389,22,22,0,1,0
4,398,398,24,3,21,2,1
18,402,402,100,73,27,2,1
16,409,409,1,1,0,1,0
10,417,417,24,6,18,3,2
30,429,429,90,90,0,1,0
13,435,435,21,5,16,2,1
36,436,436,62,24,38,4,3
22,451,451,22,18,4,2,1
23,454,454,32,17,15,4,3
27,459,459,39,39,0,1,0
7,476,476,23,23,0,1,0
1,487,487,39,39,0,1,0
34,494,494,28,28,0,1,0

19,126,126,52,52,0,1,0
22,167,167,10,10,0,1,0
32,173,173,13,13,0,1,0
9,181,181,13,13,0,1,0
20,201,201,13,13,0,1,0
18,203,203,13,13,0,1,0
30,212,212,10,7,3,2,1
24,214,214,38,38,0,1,0
23,233,233,7,7,0,1,0
25,240,240,8,8,0,1,0
1,241,241,51,51,0,1,0
13,246,246,66,41,25,4,3
17,248,248,5,5,0,1,0
3,265,265,121,102,19,2,1
14,265,265,40,20,20,2,1
15,275,275,39,39,0,1,0
33,326,326,48,48,0,1,0
0,349,349,29,29,0,1,0
16,361,361,16,10,6,2,1
5,369,369,31,12,19,2,1
7,380,380,105,55,50,3,2
12,382,382,5,2,3,2,1
31,382,382,66,66,0,1,0
8,385,385,1,1,0,1,0
28,397,397,3,3,0,1,0
6,401,401,6,3,3,2,1
27,401,401,61,61,0,1,0
26,421,421,110,79,31,2,1
4,426,426,28,9,19,2,1
21,433,433,7,3,4,2,1
11,476,476,2,2,0,1,0
29,488,488,6,6,0,1,0
10,491,491,29,24,5,2,1
2,499,499,70,1,69,4,3

0,104,104,7,7,0,1,0
18,114,114,3,3,0,1,0
10,116,116,1,1,0,1,0
26,119,119,18,18,0,1,0
39,122,122,9,1,8,3,2
28,140,140,13,13,0,1,0
5,150,150,28,16,12,2,1
24,173,173,1,1,0,1,0
19,187,187,4,4,0,1,0
4,188,188,24,9,15,4,3
31,204,204,25,19,6,3,2
25,210,210,12,12,0,1,0
23,223,223,18,18,0,1,0
1,230,230,25,25,0,1,0
20,239,239,53,53,0,1,0
3,245,245,4,4,0,1,0
33,245,245,21,3,18,4,3
30,249,249,25,25,0,1,0
8,259,259,44,14,30,2,1
32,267,267,76,76,0,1,0
29,275,275,19,19,0,1,0
15,315,315,1,1,0,1,0
17,321,321,32,4,28,3,2
7,334,334,38,1,37,2,1
9,338,338,4,4,0,1,0
38,348,348,20,13,7,2,1
37,356,356,28,2,26,4,3
22,368,368,68,38,30,2,1
35,383,383,38,11,27,2,1
34,390,390,22,22,0,1,0
11,426,426,12,5,7,2,1
42,433,433,80,45,35,2,1
6,447,447,31,31,0,1,0
13,458,458,8,8,0,1,0
12,458,458,22,10,12,3,2
36,460,460,10,10,0,1,0
2,466,466,71,71,0,1,0
40,467,467,134,42,92,4,3
41,483,483,4,4,0,1,0
16,486,486,15,2,13,4,3
21,492,492,12,12,0,1,0
14,497,497,42,42,0,1,0
27,499,499,49,37,12,3,2

41,120,120,9,9,0,1,0
19,123,123,1,1,0,1,0
39,133,133,17,17,0,1,0
37,133,133,47,6,41,3,2
1,135,135,22,22,0,1,0
21,154,154,15,6,9,2,1
12,157,157,14,14,0,1,0
8,166,166,26,10,16,2,1
7,177,177,1,1,0,1,0
22,181,181,47,47,0,1,0
11,181,181,14,14,0,1,0
24,207,207,72,12,60,3,2
33,223,223,19,8,11,3,2
20,229,229,13,3,10,2,1
4,254,254,15,5,10,3,2
9,267,267,10,10,0,1,0
42,287,287,9,9,0,1,0
29,292,292,1,1,0,1,0
35,294,294,5,5,0,1,0
5,295,295,62,62,0,1,0
31,301,301,49,25,24,2,1
13,320,320,1,1,0,1,0
32,340,340,7,7,0,1,0
25,341,341,73,7,66,4,3
38,343,343,38,29,9,2,1
34,404,404,24,7,17,3,2
30,417,417,34,34,0,1,0
10,418,418,36,30,6,2,1
26,419,419,3,3,0,1,0
2,426,426,37,23,14,2,1
17,430,430,11,8,3,2,1
27,432,432,44,29,15,4,3
18,438,438,15,15,0,1,0
15,446,446,31,31,0,1,0
36,453,453,12,6,6,2,1
28,456,456,31,31,0,1,0
40,460,460,16,16,0,1,0
6,461,461,23,23,0,1,0
3,464,464,33,33,0,1,0
0,488,488,14,5,9,2,1
23,488,488,26,2,24,4,3
14,494,494,28,20,8,3,2
16,495,495,57,57,0,1,0

9,109,109,1,1,0,1,0
35,112,112,3,3,0,1,0
29,113,113,42,42,0,1,0
25,115,115,14,5,9,2,1
8,121,121,8,8,0,1,0
39,135,135,7,7,0,1,0
16,136,136,1,1,0,1,0
3,139,139,19,19,0,1,0
4,139,139,14,14,0,1,0
42,141,141,9,9,0,1,0
7,144,144,1,1,0,1,0
10,151,151,28,16,12,4,3
23,152,152,19,19,0,1,0
24,164,164,12,3,9,2,1
11,174,174,40,40,0,1,0
34,180,180,41,41,0,1,0
41,187,187,4,4,0,1,0
13,188,188,21,5,16,2,1
0,199,199,9,9,0,1,0
14,201,201,4,1,3,2,1
38,201,201,33,33,0,1,0
32,211,211,1,1,0,1,0
6,248,248,17,1,16,3,2
15,252,252,13,13,0,1,0
26,271,271,27,21,6,2,1
2,272,272,18,5,13,2,1
1,272,272,13,13,0,1,0
33,295,295,21,18,3,2,1
12,348,348,50,20,30,3,2
17,349,349,19,11,8,3,2
31,355,355,40,30,10,2,1
20,374,374,38,38,0,1,0
40,383,383,25,4,21,4,3
37,385,385,2,2,0,1,0
43,404,404,39,39,0,1,0
30,410,410,26,26,0,1,0
19,424,424,1,1,0,1,0
27,431,431,67,16,51,4,3
21,434,434,27,11,16,3,2
36,436,436,13,7,6,3,2
5,456,456,29,29,0,1,0
28,461,461,88,55,33,4,3
18,461,461,33,2,31,4,3
22,474,474,24,10,14,2,1

4,120,120,4,1,3,2,1
31,121,121,16,5,11,2,1
16,128,128,2,2,0,1,0
1,133,133,2,2,0,1,0
11,143,143,12,12,0,1,0
6,146,146,32,14,18,4,3
26,170,170,9,9,0,1,0
35,171,171,46,46,0,1,0
33,175,175,5,1,4,2,1
23,205,205,5,5,0,1,0
12,215,215,58,11,47,2,1
7,215,215,5,5,0,1,0
15,224,224,6,3,3,2,1
14,228,228,10,10,0,1,0
3,231,231,55,55,0,1,0
38,260,260,25,4,21,4,3
34,263,263,57,18,39,2,1
22,268,268,20,11,9,4,3
36,269,269,7,7,0,1,0
9,277,277,25,25,0,1,0
30,304,304,14,14,0,1,0
41,329,329,45,3,42,2,1
25,337,337,14,14,0,1,0
28,339,339,56,51,5,2,1
21,346,346,10,7,3,2,1
19,348,348,9,9,0,1,0
10,352,352,39,5,34,2,1
13,377,377,7,2,5,2,1
29,391,391,62,62,0,1,0
24,399,399,23,5,18,3,2
20,400,400,47,20,27,4,3
2,404,404,13,1,12,4,3
39,408,408,52,10,42,3,2
37,442,442,8,8,0,1,0
32,456,456,58,58,0,1,0
40,463,463,19,19,0,1,0
18,468,468,23,23,0,1,0
17,469,469,28,12,16,3,2
8,473,473,18,3,15,4,3
0,479,479,66,66,0,1,0
27,482,482,81,57,24,3,2
5,490,490,73,73,0,1,0

32,108,108,69,69,0,1,0
7,130,130,2,2,0,1,0
21,134,134,4,4,0,1,0
17,146,146,17,17,0,1,0
1,156,156,29,29,0,1,0
27,181,181,27,9,18,3,2
8,185,185,6,6,0,1,0
37,213,213,38,22,16,2,1
25,219,219,17,17,0,1,0
23,220,220,7,7,0,1,0
33,223,223,40,8,32,2,1
14,224,224,18,9,9,2,1
20,292,292,3,3,0,1,0
4,295,295,48,4,44,4,3
0,297,297,76,4,72,4,3
35,301,301,3,3,0,1,0
31,302,302,21,2,19,2,1
24,307,307,13,1,12,4,3
9,308,308,2,2,0,1,0
34,316,316,58,50,8,3,2
3,320,320,31,31,0,1,0
15,322,322,16,16,0,1,0
19,322,322,13,5,8,2,1
28,326,326,18,8,10,2,1
5,339,339,18,10,8,3,2
11,357,357,5,5,0,1,0
16,367,367,19,12,7,2,1
36,370,370,19,1,18,3,2
10,385,385,81,71,10,2,1
22,391,391,10,2,8,3,2
2,391,391,64,44,20,4,3
12,392,392,29,5,24,3,2
26,401,401,7,4,3,2,1
6,425,425,31,24,7,2,1
30,430,430,38,26,12,2,1
29,431,431,27,27,0,1,0
13,440,440,74,74,0,1,0
18,466,466,42,42,0,1,0

4,109,109,1,1,0,1,0
7,118,118,17,17,0,1,0
37,125,125,9,6,3,2,1
14,146,146,7,3,4,2,1
42,146,146,6,6,0,1,0
22,147,147,3,3,0,1,0
40,171,171,19,8,11,2,1
1,187,187,1,1,0,1,0
45,188,188,24,18,6,3,2
6,191,191,6,6,0,1,0
2,194,194,1,1,0,1,0
46,204,204,31,18,13,2,1
12,214,214,54,40,14,2,1
44,226,226,34,10,24,4,3
25,227,227,47,47,0,1,0
5,229,229,7,7,0,1,0
19,232,232,8,3,5,2,1
35,237,237,100,100,0,1,0
32,237,237,9,3,6,3,2
13,243,243,66,66,0,1,0
9,260,260,6,6,0,1,0
10,283,283,6,6,0,1,0
20,288,288,9,9,0,1,0
26,317,317,30,8,22,3,2
3,323,323,11,11,0,1,0
27,327,327,6,6,0,1,0
30,338,338,19,19,0,1,0
33,374,374,5,2,3,2,1
39,377,377,41,23,18,4,3
34,388,388,10,1,9,2,1
11,393,393,47,18,29,2,1
43,394,394,15,15,0,1,0
15,401,401,83,83,0,1,0
36,404,404,26,26,0,1,0
17,409,409,5,5,0,1,0
38,419,419,66,43,23,2,1
18,436,436,9,2,7,2,1
16,439,439,49,49,0,1,0
23,442,442,13,13,0,1,0
21,445,445,15,6,9,4,3
8,449,449,11,11,0,1,0
29,464,464,46,46,0,1,0
24,475,475,9,9,0,1,0
0,480,480,20,20,0,1,0
31,489,489,8,1,7,2,1
28,494,494,26,8,18,4,3
41,497,497,92,92,0,1,0

11,104,104,3,3,0,1,0
23,108,108,40,40,0,1,0
26,110,110,11,11,0,1,0
0,115,115,1,1,0,1,0
19,121,121,7,7,0,1,0
24,123,123,1,1,0,1,0
4,125,125,2,2,0,1,0
29,126,126,2,2,0,1,0
18,129,129,16,2,14,3,2
14,139,139,20,20,0,1,0
22,155,155,11,3,8,2,1
37,168,168,19,19,0,1,0
10,169,169,19,5,14,2,1
34,175,175,4,4,0,1,0
38,217,217,19,19,0,1,0
7,225,225,48,30,18,3,2
25,241,241,36,36,0,1,0
30,255,255,69,45,24,3,2
1,261,261,8,8,0,1,0
16,269,269,6,6,0,1,0
20,272,272,2,2,0,1,0
33,279,279,5,5,0,1,0
15,291,291,19,14,5,2,1
9,303,303,31,10,21,4,3
32,310,310,1,1,0,1,0
27,322,322,1,1,0,1,0
35,323,323,4,4,0,1,0
40,341,341,3,3,0,1,0
36,347,347,71,71,0,1,0
2,347,347,11,1,10,2,1
12,372,372,34,4,30,4,3
39,394,394,86,86,0,1,0
31,399,399,48,17,31,2,1
3,402,402,33,8,25,2,1
21,406,406,25,25,0,1,0
5,415,415,170,132,38,3,2
17,465,465,46,46,0,1,0
8,479,479,63,63,0,1,0
6,481,481,2,2,0,1,0
13,482,482,28,28,0,1,0
28,500,500,76,14,62,4,3

24,103,103,3,3,0,1,0
16,105,105,4,4,0,1,0
43,108,108,7,7,0,1,0
30,113,113,3,3,0,1,0
9,117,117,3,3,0,1,0
5,120,120,40,40,0,1,0
26,130,130,10,10,0,1,0
42,133,133,22,22,0,1,0
14,136,136,12,12,0,1,0
41,148,148,3,3,0,1,0
31,183,183,12,12,0,1,0
10,187,187,15,15,0,1,0
19,209,209,31,31,0,1,0
39,239,239,16,16,0,1,0
29,242,242,19,19,0,1,0
28,252,252,5,5,0,1,0
18,279,279,7,3,4,2,1
21,283,283,13,7,6,3,2
6,297,297,59,15,44,2,1
34,308,308,9,9,0,1,0
35,311,311,44,25,19,2,1
1,312,312,71,26,45,3,2
2,313,313,4,4,0,1,0
12,326,326,32,32,0,1,0
37,327,327,18,6,12,4,3
38,328,328,77,47,30,4,3
32,334,334,70,70,0,1,0
17,348,348,2,2,0,1,0
7,375,375,33,33,0,1,0
23,376,376,7,7,0,1,0
33,390,390,26,26,0,1,0
22,397,397,78,78,0,1,0
3,412,412,1,1,0,1,0
36,419,419,9,9,0,1,0
20,426,426,16,16,0,1,0
11,427,427,6,6,0,1,0
25,428,428,92,68,24,3,2
4,437,437,22,22,0,1,0
8,443,443,3,3,0,1,0
0,449,449,14,7,7,2,1
15,452,452,40,40,0,1,0
13,459,459,6,6,0,1,0
27,493,493,190,190,0,1,0
40,499,499,3,3,0,1,0

2,105,105,4,4,0,1,0
33,106,106,11,11,0,1,0
13,112,112,8,8,0,1,0
14,143,143,7,7,0,1,0
15,143,143,15,15,0,1,0
19,148,148,19,19,0,1,0
6,176,176,119,119,0,1,0
28,198,198,43,31,12,2,1
18,201,201,29,29,0,1,0
3,222,222,39,39,0,1,0
29,254,254,15,1,14,3,2
20,254,254,30,30,0,1,0
17,274,274,1,1,0,1,0
1,275,275,4,4,0,1,0
0,276,276,11,11,0,1,0
21,291,291,5,5,0,1,0
9,295,295,8,8,0,1,0
32,298,298,18,5,13,3,2
11,320,320,17,17,0,1,0
22,323,323,69,64,5,2,1
30,328,328,15,15,0,1,0
24,341,341,4,4,0,1,0
8,347,347,88,11,77,3,2
7,365,365,17,9,8,2,1
10,368,368,8,8,0,1,0
16,371,371,120,120,0,1,0
5,393,393,16,6,10,3,2
12,398,398,21,8,13,2,1
4,415,415,142,88,54,4,3
25,417,417,6,6,0,1,0
26,417,417,38,38,0,1,0
31,429,429,76,76,0,1,0
23,440,440,8,8,0,1,0
27,464,464,38,38,0,1,0

9,104,104,20,12,8,3,2
28,128,128,16,7,9,4,3
36,132,132,5,5,0,1,0
43,135,135,4,4,0,1,0
23,160,160,7,3,4,2,1
37,162,162,13,8,5,2,1
31,162,162,29,29,0,1,0
25,169,169,57,39,18,2,1
12,179,179,2,2,0,1,0
18,202,202,23,6,17,2,1
11,207,207,20,20,0,1,0
33,225,225,3,3,0,1,0
40,251,251,3,3,0,1,0
17,252,252,6,1,5,2,1
1,265,265,52,52,0,1,0
16,277,277,6,6,0,1,0
24,281,281,10,10,0,1,0
20,293,293,15,7,8,2,1
42,294,294,5,5,0,1,0
29,305,305,1,1,0,1,0
0,308,308,2,2,0,1,0
22,326,326,30,30,0,1,0
5,333,333,53,53,0,1,0
32,347,347,18,15,3,2,1
6,349,349,2,2,0,1,0
7,358,358,38,38,0,1,0
14,361,361,16,1,15,3,2
10,370,370,59,37,22,3,2
3,370,370,10,6,4,2,1
41,382,382,157,49,108,4,3
26,388,388,10,10,0,1,0
21,394,394,4,1,3,2,1
2,404,404,10,1,9,2,1
15,411,411,20,20,0,1,0
35,420,420,5,2,3,2,1
34,427,427,115,83,32,2,1
8,429,429,4,4,0,1,0
38,461,461,25,25,0,1,0
39,461,461,19,15,4,2,1
27,463,463,89,45,44,2,1
19,463,463,46,46,0,1,0
4,463,463,44,44,0,1,0
30,472,472,19,7,12,4,3
13,473,473,107,76,31,2,1

37,121,121,11,2,9,2,1
31,126,126,44,44,0,1,0
13,148,148,30,9,21,4,3
33,158,158,12,12,0,1,0
6,171,171,9,9,0,1,0
26,176,176,27,18,9,4,3
15,184,184,1,1,0,1,0
2,199,199,32,4,28,2,1
16,204,204,40,40,0,1,0
35,214,214,34,19,15,4,3
34,218,218,24,14,10,2,1
11,219,219,27,9,18,2,1
0,242,242,16,16,0,1,0
22,251,251,55,24,31,2,1
38,254,254,26,6,20,3,2
21,256,256,33,5,28,2,1
29,266,266,2,2,0,1,0
19,274,274,10,10,0,1,0
12,274,274,65,47,18,3,2
20,298,298,18,18,0,1,0
5,300,300,1,1,0,1,0
25,309,309,12,8,4,2,1
30,324,324,73,57,16,2,1
1,333,333,9,9,0,1,0
4,339,339,48,48,0,1,0
32,346,346,18,10,8,2,1
14,346,346,54,30,24,4,3
18,361,361,47,11,36,3,2
28,398,398,18,1,17,4,3
23,402,402,15,15,0,1,0
3,406,406,16,16,0,1,0
17,409,409,1,1,0,1,0
7,419,419,73,73,0,1,0
8,431,431,19,19,0,1,0
24,447,447,18,11,7,2,1
36,461,461,9,2,7,2,1
10,464,464,38,2,36,4,3
27,471,471,10,3,7,2,1
9,493,493,11,11,0,1,0

43,106,106,12,12,0,1,0
5,106,106,3,3,0,1,0
29,113,113,4,4,0,1,0
33,122,122,3,3,0,1,0
41,123,123,6,6,0,1,0
11,129,129,8,4,4,2,1
10,132,132,30,9,21,2,1
42,146,146,3,3,0,1,0
1,171,171,21,21,0,1,0
24,172,172,18,18,0,1,0
18,186,186,4,4,0,1,0
21,186,186,18,18,0,1,0
23,188,188,1,1,0,1,0
25,208,208,50,11,39,4,3
2,216,216,22,10,12,4,3
40,218,218,102,55,47,2,1
7,237,237,12,8,4,2,1
12,243,243,4,4,0,1,0
14,254,254,42,33,9,4,3
17,254,254,1,1,0,1,0
22,259,259,22,12,10,2,1
0,271,271,29,29,0,1,0
39,275,275,4,1,3,2,1
3,294,294,15,15,0,1,0
20,312,312,33,33,0,1,0
6,327,327,13,1,12,4,3
36,333,333,6,6,0,1,0
28,334,334,34,34,0,1,0
26,342,342,44,44,0,1,0
31,371,371,15,15,0,1,0
35,373,373,5,1,4,2,1
19,390,390,8,8,0,1,0
34,391,391,57,57,0,1,0
8,393,393,43,43,0,1,0
38,398,398,7,4,3,2,1
13,417,417,29,29,0,1,0
32,422,422,23,23,0,1,0
4,425,425,46,46,0,1,0
9,434,434,12,12,0,1,0
30,460,460,19,19,0,1,0
27,467,467,107,2,105,4,3
15,475,475,16,4,12,3,2
16,483,483,68,48,20,2,1
37,489,489,88,44,44,3,2

5,106,106,1,1,0,1,0
10,109,109,14,2,12,4,3
32,114,114,15,1,14,3,2
19,118,118,12,3,9,4,3
33,121,121,12,1,11,2,1
36,126,126,5,5,0,1,0
34,142,142,2,2,0,1,0
18,143,143,5,2,3,2,1
30,144,144,13,13,0,1,0
24,161,161,26,23,3,2,1
11,163,163,20,20,0,1,0
25,175,175,4,4,0,1,0
29,178,178,14,14,0,1,0
0,213,213,1,1,0,1,0
14,223,223,9,5,4,2,1
21,227,227,53,53,0,1,0
16,233,233,13,13,0,1,0
9,236,236,5,5,0,1,0
26,239,239,18,15,3,2,1
22,247,247,9,9,0,1,0
39,271,271,36,36,0,1,0
28,289,289,22,22,0,1,0
12,314,314,67,67,0,1,0
23,316,316,1,1,0,1,0
15,344,344,3,3,0,1,0
8,348,348,5,5,0,1,0
2,348,348,128,42,86,4,3
13,349,349,68,68,0,1,0
35,350,350,50,50,0,1,0
7,355,355,3,3,0,1,0
6,387,387,9,2,7,2,1
31,389,389,67,32,35,4,3
37,393,393,91,91,0,1,0
3,415,415,25,25,0,1,0
17,418,418,59,7,52,3,2
38,430,430,25,25,0,1,0
20,436,436,59,59,0,1,0
1,458,458,78,24,54,4,3
4,493,493,22,22,0,1,0
27,499,499,68,47,21,4,3

12,120,120,16,16,0,1,0
29,136,136,16,16,0,1,0
38,137,137,6,6,0,1,0
14,142,142,4,4,0,1,0
5,160,160,1,1,0,1,0
23,163,163,9,9,0,1,0
21,184,184,33,5,28,2,1
33,202,202,34,16,18,3,2
25,213,213,3,3,0,1,0
30,221,221,25,25,0,1,0
11,225,225,25,18,7,2,1
6,228,228,37,5,32,3,2
2,239,239,7,2,5,2,1
13,246,246,20,20,0,1,0
32,259,259,13,5,8,2,1
22,289,289,19,19,0,1,0
24,289,289,155,44,111,4,3
8,304,304,3,3,0,1,0
4,306,306,127,127,0,1,0
20,312,312,17,17,0,1,0
1,321,321,7,7,0,1,0
36,324,324,24,8,16,2,1
34,326,326,17,5,12,3,2
28,327,327,14,3,11,2,1
3,333,333,50,50,0,1,0
18,334,334,11,6,5,2,1
15,364,364,2,2,0,1,0
9,397,397,2,2,0,1,0
35,406,406,34,34,0,1,0
10,409,409,130,130,0,1,0
16,414,414,16,9,7,2,1
19,421,421,77,59,18,4,3
7,439,439,23,10,13,2,1
17,445,445,46,46,0,1,0
26,453,453,75,32,43,2,1
37,457,457,10,1,9,4,3
31,468,468,16,4,12,2,1
0,480,480,7,7,0,1,0
27,495,495,35,35,0,1,0

14,132,132,18,18,0,1,0
27,135,135,14,5,9,4,3
2,150,150,39,30,9,2,1
37,163,163,2,2,0,1,0
4,176,176,3,3,0,1,0
35,192,192,29,4,25,2,1
9,196,196,12,4,8,2,1
21,229,229,6,6,0,1,0
32,231,231,13,3,10,3,2
18,235,235,1,1,0,1,0
23,257,257,10,10,0,1,0
31,262,262,19,19,0,1,0
17,275,275,3,3,0,1,0
30,280,280,7,1,6,2,1
26,285,285,7,7,0,1,0
10,291,291,19,12,7,2,1
36,307,307,66,30,36,2,1
24,311,311,28,1,27,3,2
12,313,313,29,1,28,2,1
25,330,330,34,34,0,1,0
16,333,333,124,67,57,4,3
1,337,337,90,48,42,3,2
29,350,350,77,77,0,1,0
7,352,352,3,3,0,1,0
33,383,383,1,1,0,1,0
11,387,387,76,46,30,4,3
6,400,400,17,17,0,1,0
19,407,407,4,4,0,1,0
22,423,423,133,129,4,2,1
28,434,434,149,93,56,3,2
20,450,450,12,12,0,1,0
8,454,454,14,8,6,3,2
13,465,465,72,38,34,2,1
34,472,472,46,46,0,1,0
0,475,475,56,9,47,2,1
3,487,487,5,5,0,1,0
5,495,495,25,25,0,1,0
15,496,496,1,1,0,1,0

29,102,102,20,20,0,1,0
2,114,114,4,4,0,1,0
16,136,136,9,9,0,1,0
19,155,155,4,1,3,2,1
17,164,164,11,4,7,2,1
32,168,168,26,15,11,2,1
33,184,184,8,8,0,1,0
40,203,203,26,26,0,1,0
36,206,206,18,2,16,2,1
41,232,232,2,2,0,1,0
44,235,235,12,12,0,1,0
14,249,249,2,2,0,1,0
20,255,255,63,63,0,1,0
0,267,267,3,3,0,1,0
43,275,275,5,5,0,1,0
39,290,290,14,9,5,2,1
9,309,309,30,30,0,1,0
25,311,311,7,1,6,3,2
1,319,319,26,8,18,2,1
4,327,327,8,8,0,1,0
37,329,329,71,71,0,1,0
34,331,331,58,32,26,4,3
18,338,338,32,1,31,2,1
27,339,339,3,3,0,1,0
8,349,349,35,8,27,2,1
15,351,351,15,15,0,1,0
5,358,358,32,3,29,4,3
22,361,361,20,2,18,2,1
7,368,368,49,49,0,1,0
24,378,378,6,6,0,1,0
30,380,380,39,39,0,1,0
10,380,380,69,45,24,4,3
21,387,387,16,16,0,1,0
26,395,395,35,25,10,2,1
13,397,397,35,35,0,1,0
3,404,404,32,32,0,1,0
28,416,416,81,81,0,1,0
35,444,444,94,63,31,2,1
11,454,454,21,5,16,3,2
38,460,460,20,8,12,2,1
23,472,472,56,56,0,1,0
6,482,482,50,50,0,1,0
12,490,490,13,13,0,1,0
42,493,493,44,44,0,1,0
31,495,495,34,34,0,1,0

0,105,105,2,2,0,1,0
16,118,118,3,3,0,1,0
5,154,154,24,9,15,4,3
25,164,164,10,4,6,3,2
36,165,165,29,29,0,1,0
35,181,181,16,11,5,2,1
38,186,186,15,3,12,4,3
18,188,188,1,1,0,1,0
15,194,194,10,3,7,2,1
14,195,195,3,3,0,1,0
17,205,205,5,5,0,1,0
27,219,219,55,55,0,1,0
9,225,225,18,4,14,3,2
6,226,226,23,11,12,2,1
21,231,231,39,39,0,1,0
22,234,234,6,6,0,1,0
30,236,236,70,70,0,1,0
11,251,251,93,67,26,2,1
4,260,260,27,27,0,1,0
3,277,277,5,2,3,2,1
12,289,289,86,12,74,3,2
20,291,291,71,62,9,4,3
31,312,312,18,18,0,1,0
29,318,318,8,8,0,1,0
1,326,326,60,60,0,1,0
7,334,334,31,13,18,2,1
32,338,338,56,56,0,1,0
8,343,343,1,1,0,1,0
34,346,346,25,25,0,1,0
37,381,381,9,3,6,2,1
2,394,394,21,21,0,1,0
23,408,408,9,9,0,1,0
19,409,409,19,19,0,1,0
28,419,419,5,2,3,2,1
13,438,438,24,20,4,2,1
24,445,445,21,21,0,1,0
33,454,454,20,20,0,1,0
10,456,456,90,30,60,4,3
26,499,499,34,25,9,4,3

1,130,130,11,2,9,4,3
22,133,133,9,3,6,3,2
2,141,141,5,1,4,2,1
0,160,160,1,1,0,1,0
26,160,160,3,3,0,1,0
14,181,181,23,8,15,4,3
27,182,182,11,11,0,1,0
18,204,204,11,11,0,1,0
9,227,227,37,11,26,2,1
29,234,234,61,43,18,4,3
37,237,237,32,21,11,2,1
28,239,239,15,5,10,2,1
19,244,244,9,9,0,1,0
8,256,256,10,10,0,1,0
34,260,260,49,49,0,1,0
30,262,262,31,31,0,1,0
38,275,275,31,20,11,4,3
3,275,275,1,1,0,1,0
13,279,279,7,7,0,1,0
23,288,288,2,2,0,1,0
12,340,340,152,128,24,4,3
16,360,360,30,30,0,1,0
5,367,367,38,38,0,1,0
24,375,375,27,27,0,1,0
11,378,378,35,29,6,2,1
21,388,388,11,11,0,1,0
32,394,394,45,12,33,2,1
31,398,398,11,11,0,1,0
25,402,402,3,3,0,1,0
4,421,421,46,46,0,1,0
6,422,422,6,6,0,1,0
20,427,427,10,7,3,2,1
35,428,428,162,58,104,4,3
17,445,445,75,21,54,4,3
33,447,447,11,11,0,1,0
10,457,457,17,4,13,2,1
36,472,472,106,12,94,3,2
7,473,473,58,21,37,2,1
15,487,487,72,63,9,2,1

38,113,113,8,8,0,1,0
3,114,114,3,3,0,1,0
28,115,115,5,1,4,2,1
27,128,128,4,1,3,2,1
0,129,129,7,7,0,1,0
32,133,133,10,10,0,1,0
40,137,137,28,28,0,1,0
4,156,156,1,1,0,1,0
15,170,170,18,18,0,1,0
37,192,192,22,14,8,2,1
20,199,199,1,1,0,1,0
31,202,202,1,1,0,1,0
12,208,208,7,7,0,1,0
36,210,210,24,12,12,3,2
17,211,211,6,2,4,2,1
16,213,213,18,18,0,1,0
6,222,222,12,9,3,2,1
29,227,227,23,23,0,1,0
30,229,229,29,29,0,1,0
41,239,239,1,1,0,1,0
1,247,247,8,8,0,1,0
25,248,248,2,2,0,1,0
22,261,261,2,2,0,1,0
7,264,264,1,1,0,1,0
39,270,270,23,23,0,1,0
23,275,275,11,11,0,1,0
5,287,287,200,113,87,4,3
9,300,300,2,2,0,1,0
19,308,308,28,28,0,1,0
21,310,310,27,27,0,1,0
18,345,345,58,31,27,4,3
13,367,367,14,14,0,1,0
24,376,376,77,77,0,1,0
8,377,377,71,71,0,1,0
34,405,405,198,198,0,1,0
35,407,407,20,6,14,2,1
14,417,417,3,3,0,1,0
2,423,423,45,13,32,3,2
26,484,484,76,34,42,3,2
33,486,486,13,4,9,2,1
11,486,486,10,10,0,1,0
10,500,500,25,17,8,2,1

3,121,121,9,4,5,2,1
30,138,138,3,3,0,1,0
7,157,157,43,43,0,1,0
17,169,169,19,19,0,1,0
20,172,172,1,1,0,1,0
13,176,176,1,1,0,1,0
27,186,186,37,37,0,1,0
33,187,187,40,40,0,1,0
25,189,189,9,9,0,1,0
5,200,200,1,1,0,1,0
39,227,227,36,36,0,1,0
15,228,228,3,3,0,1,0
43,235,235,3,3,0,1,0
18,261,261,1,1,0,1,0
6,267,267,33,33,0,1,0
10,270,270,54,54,0,1,0
22,280,280,57,57,0,1,0
31,296,296,17,5,12,3,2
28,308,308,8,8,0,1,0
35,311,311,33,33,0,1,0
29,321,321,3,3,0,1,0
12,335,335,12,12,0,1,0
2,340,340,64,50,14,3,2
34,343,343,27,27,0,1,0
42,348,348,113,26,87,4,3
23,354,354,43,43,0,1,0
14,359,359,7,7,0,1,0
19,371,371,5,5,0,1,0
0,379,379,13,13,0,1,0
9,379,379,6,6,0,1,0
11,382,382,55,46,9,2,1
32,401,401,25,25,0,1,0
40,406,406,17,17,0,1,0
37,416,416,14,14,0,1,0
38,416,416,13,13,0,1,0
4,416,416,26,14,12,2,1
41,417,417,17,5,12,3,2
8,422,422,6,6,0,1,0
16,449,449,45,45,0,1,0
1,457,457,5,5,0,1,0
21,462,462,15,15,0,1,0
26,466,466,17,17,0,1,0
36,469,469,78,63,15,4,3
44,479,479,149,149,0,1,0
24,491,491,20,20,0,1,0

19,100,100,6,6,0,1,0
38,122,122,5,1,4,2,1
1,130,130,19,12,7,2,1
13,136,136,4,4,0,1,0
30,149,149,40,40,0,1,0
6,180,180,29,29,0,1,0
27,182,182,9,5,4,2,1
23,186,186,66,31,35,2,1
36,189,189,31,31,0,1,0
40,192,192,7,7,0,1,0
12,200,200,17,17,0,1,0
20,201,201,1,1,0,1,0
17,201,201,2,2,0,1,0
3,218,218,6,6,0,1,0
16,238,238,5,5,0,1,0
37,257,257,9,9,0,1,0
41,270,270,2,2,0,1,0
0,290,290,5,5,0,1,0
4,294,294,22,2,20,3,2
18,298,298,28,28,0,1,0
33,302,302,3,3,0,1,0
22,303,303,1,1,0,1,0
2,344,344,58,17,41,2,1
7,382,382,66,23,43,4,3
31,387,387,25,13,12,4,3
10,388,388,68,68,0,1,0
24,391,391,12,5,7,2,1
34,405,405,77,60,17,2,1
39,419,419,31,31,0,1,0
9,419,419,118,103,15,4,3
21,438,438,39,39,0,1,0
15,440,440,48,48,0,1,0
5,441,441,24,3,21,4,3
35,451,451,6,1,5,2,1
14,461,461,30,22,8,3,2
32,465,465,48,48,0,1,0
8,477,477,5,5,0,1,0
25,478,478,86,86,0,1,0
26,483,483,49,49,0,1,0
28,490,490,84,84,0,1,0
11,497,497,21,1,20,3,2
29,500,500,25,25,0,1,0

2,122,122,42,34,8,3,2
38,139,139,9,9,0,1,0
35,159,159,14,14,0,1,0
41,160,160,18,4,14,2,1
5,164,164,11,11,0,1,0
0,177,177,1,1,0,1,0
18,184,184,10,6,4,2,1
4,186,186,4,4,0,1,0
19,193,193,32,32,0,1,0
6,194,194,24,9,15,4,3
33,198,198,23,23,0,1,0
10,206,206,1,1,0,1,0
13,211,211,28,8,20,2,1
31,216,216,65,19,46,3,2
26,225,225,3,3,0,1,0
28,233,233,49,4,45,2,1
7,234,234,19,4,15,2,1
39,244,244,15,15,0,1,0
17,257,257,2,2,0,1,0
14,267,267,13,4,9,2,1
37,302,302,2,2,0,1,0
15,306,306,33,5,28,3,2
30,318,318,11,11,0,1,0
22,330,330,16,8,8,3,2
36,335,335,2,2,0,1,0
21,342,342,53,43,10,3,2
23,345,345,135,123,12,4,3
11,356,356,7,7,0,1,0
16,359,359,32,32,0,1,0
24,370,370,50,50,0,1,0
1,373,373,53,35,18,4,3
12,373,373,18,6,12,4,3
32,374,374,21,21,0,1,0
9,387,387,7,1,6,2,1
3,395,395,25,25,0,1,0
29,407,407,12,12,0,1,0
8,419,419,59,59,0,1,0
20,431,431,5,5,0,1,0
25,434,434,12,8,4,2,1
34,447,447,58,28,30,4,3
27,448,448,27,27,0,1,0
40,462,462,46,1,45,2,1

35,106,106,21,15,6,2,1
1,131,131,6,6,0,1,0
8,132,132,3,3,0,1,0
28,139,139,2,2,0,1,0
25,160,160,15,5,10,2,1
19,191,191,5,5,0,1,0
27,199,199,11,11,0,1,0
2,207,207,21,5,16,3,2
24,209,209,47,1,46,4,3
29,209,209,5,5,0,1,0
10,219,219,89,89,0,1,0
16,222,222,6,1,5,2,1
9,225,225,16,16,0,1,0
4,231,231,38,38,0,1,0
26,231,231,8,1,7,2,1
7,232,232,19,4,15,4,3
3,245,245,5,1,4,2,1
34,247,247,27,27,0,1,0
31,248,248,84,32,52,3,2
6,285,285,35,35,0,1,0
12,288,288,51,51,0,1,0
38,292,292,8,8,0,1,0
20,310,310,58,58,0,1,0
18,315,315,66,66,0,1,0
0,317,317,3,3,0,1,0
17,322,322,16,16,0,1,0
14,336,336,28,25,3,2,1
23,362,362,2,2,0,1,0
37,364,364,31,17,14,2,1
21,392,392,4,4,0,1,0
32,398,398,53,24,29,2,1
13,416,416,9,1,8,2,1
22,424,424,79,79,0,1,0
30,433,433,50,41,9,4,3
11,436,436,1,1,0,1,0
5,437,437,94,85,9,2,1
15,451,451,20,1,19,2,1
33,473,473,9,5,4,2,1
36,481,481,37,37,0,1,0

14,102,102,6,6,0,1,0
9,110,110,29,17,12,3,2
32,115,115,9,9,0,1,0
36,130,130,26,17,9,4,3
11,154,154,16,16,0,1,0
2,161,161,11,11,0,1,0
18,170,170,3,3,0,1,0
38,177,177,51,25,26,3,2
33,191,191,2,2,0,1,0
3,194,194,3,3,0,1,0
17,198,198,7,4,3,2,1
21,201,201,3,3,0,1,0
8,215,215,16,16,0,1,0
0,223,223,13,7,6,2,1
28,239,239,12,12,0,1,0
25,252,252,6,6,0,1,0
7,257,257,2,2,0,1,0
30,258,258,21,21,0,1,0
37,259,259,49,49,0,1,0
10,285,285,9,9,0,1,0
15,297,297,18,10,8,2,1
23,303,303,2,2,0,1,0
12,305,305,9,9,0,1,0
1,315,315,4,1,3,2,1
29,323,323,29,17,12,4,3
4,328,328,10,10,0,1,0
34,332,332,102,102,0,1,0
27,343,343,1,1,0,1,0
31,356,356,14,2,12,4,3
20,367,367,11,11,0,1,0
19,394,394,110,10,100,3,2
26,401,401,45,24,21,4,3
22,404,404,20,1,19,2,1
6,436,436,31,8,23,2,1
5,446,446,122,122,0,1,0
39,471,471,43,1,42,3,2
24,473,473,37,37,0,1,0
35,476,476,113,101,12,2,1
13,489,489,136,136,0,1,0
16,491,491,49,2,47,4,3

37,104,104,5,5,0,1,0
40,120,120,90,40,50,3,2
0,137,137,20,20,0,1,0
8,168,168,11,5,6,2,1
5,174,174,31,10,21,4,3
26,177,177,34,34,0,1,0
39,200,200,16,16,0,1,0
42,210,210,16,16,0,1,0
17,216,216,16,1,15,2,1
11,232,232,1,1,0,1,0
19,241,241,6,6,0,1,0
35,247,247,19,19,0,1,0
4,254,254,42,42,0,1,0
24,258,258,8,8,0,1,0
41,266,266,8,8,0,1,0
20,268,268,4,4,0,1,0
13,275,275,11,11,0,1,0
36,280,280,22,14,8,3,2
30,282,282,7,3,4,2,1
3,284,284,21,12,9,2,1
28,290,290,19,19,0,1,0
23,291,291,57,17,40,3,2
33,292,292,3,3,0,1,0
14,300,300,4,4,0,1,0
31,306,306,11,11,0,1,0
2,325,325,28,28,0,1,0
34,328,328,18,7,11,2,1
10,334,334,55,55,0,1,0
12,345,345,1,1,0,1,0
7,359,359,68,68,0,1,0
9,375,375,4,1,3,2,1
32,377,377,82,10,72,4,3
25,398,398,29,29,0,1,0
21,412,412,7,7,0,1,0
18,414,414,21,17,4,2,1
27,429,429,1,1,0,1,0
29,433,433,32,20,12,3,2
38,460,460,14,14,0,1,0
6,465,465,55,55,0,1,0
16,467,467,27,24,3,2,1
22,470,470,30,27,3,2,1
1,475,475,50,6,44,3,2
15,476,476,18,18,0,1,0

1,101,101,2,2,0,1,0
31,114,114,35,35,0,1,0
12,115,115,25,25,0,1,0
6,118,118,34,7,27,4,3
27,132,132,2,2,0,1,0
18,133,133,8,2,6,2,1
7,141,141,1,1,0,1,0
32,154,154,4,4,0,1,0
2,155,155,22,22,0,1,0
33,188,188,40,18,22,2,1
35,208,208,14,5,9,4,3
5,209,209,5,5,0,1,0
30,217,217,2,2,0,1,0
34,226,226,4,4,0,1,0
28,233,233,16,16,0,1,0
24,240,240,11,11,0,1,0
16,263,263,29,29,0,1,0
36,268,268,46,46,0,1,0
8,276,276,65,26,39,2,1
9,320,320,31,11,20,2,1
13,333,333,2,2,0,1,0
15,338,338,13,13,0,1,0
10,367,367,69,27,42,2,1
20,382,382,29,29,0,1,0
14,392,392,13,13,0,1,0
22,394,394,23,23,0,1,0
4,396,396,2,2,0,1,0
17,399,399,21,6,15,4,3
3,426,426,33,17,16,3,2
26,430,430,8,8,0,1,0
23,442,442,118,78,40,2,1
11,453,453,142,85,57,3,2
29,464,464,28,6,22,2,1
21,468,468,15,15,0,1,0
0,471,471,22,22,0,1,0
19,483,483,138,111,27,4,3
25,495,495,72,72,0,1,0

9,100,100,3,3,0,1,0
40,137,137,6,6,0,1,0
12,144,144,2,2,0,1,0
28,144,144,29,23,6,2,1
32,157,157,2,2,0,1,0
33,161,161,5,5,0,1,0
16,166,166,13,3,10,2,1
14,172,172,11,11,0,1,0
21,192,192,1,1,0,1,0
25,195,195,38,38,0,1,0
17,217,217,7,7,0,1,0
37,222,222,34,2,32,3,2
42,229,229,11,11,0,1,0
35,237,237,2,2,0,1,0
39,240,240,72,58,14,3,2
31,259,259,67,18,49,2,1
10,259,259,55,55,0,1,0
6,259,259,1,1,0,1,0
18,266,266,3,3,0,1,0
29,274,274,22,22,0,1,0
19,276,276,38,28,10,3,2
24,302,302,10,1,9,2,1
43,306,306,24,24,0,1,0
0,312,312,5,5,0,1,0
41,314,314,84,84,0,1,0
26,317,317,12,12,0,1,0
1,320,320,17,12,5,2,1
44,322,322,1,1,0,1,0
8,335,335,7,7,0,1,0
5,337,337,75,75,0,1,0
2,340,340,45,34,11,2,1
13,348,348,4,4,0,1,0
4,354,354,35,35,0,1,0
36,359,359,50,9,41,2,1
20,380,380,8,8,0,1,0
22,385,385,91,42,49,2,1
7,403,403,17,2,15,3,2
23,413,413,35,4,31,2,1
30,442,442,20,1,19,2,1
38,445,445,1,1,0,1,0
34,447,447,37,37,0,1,0
15,461,461,30,30,0,1,0
11,462,462,1,1,0,1,0
27,491,491,70,70,0,1,0
3,499,499,39,39,0,1,0

27,101,101,19,19,0,1,0
0,109,109,23,23,0,1,0
9,150,150,6,6,0,1,0
4,153,153,20,8,12,3,2
11,171,171,2,2,0,1,0
36,179,179,4,4,0,1,0
23,183,183,37,37,0,1,0
1,193,193,1,1,0,1,0
8,198,198,13,13,0,1,0
22,198,198,4,1,3,2,1
34,212,212,8,8,0,1,0
37,212,212,4,4,0,1,0
10,221,221,1,1,0,1,0
6,223,223,5,5,0,1,0
16,230,230,19,19,0,1,0
5,233,233,47,47,0,1,0
28,251,251,8,8,0,1,0
2,275,275,15,3,12,2,1
15,326,326,90,41,49,2,1
33,343,343,124,124,0,1,0
3,350,350,50,29,21,4,3
17,350,350,6,6,0,1,0
25,394,394,37,37,0,1,0
29,410,410,89,52,37,4,3
20,412,412,27,22,5,2,1
35,423,423,14,14,0,1,0
31,431,431,32,32,0,1,0
7,434,434,11,7,4,2,1
14,436,436,29,29,0,1,0
21,437,437,17,17,0,1,0
13,468,468,166,140,26,2,1
19,472,472,31,5,26,3,2
32,479,479,21,21,0,1,0
30,480,480,136,136,0,1,0
26,482,482,45,10,35,2,1
24,490,490,20,11,9,4,3
18,492,492,37,7,30,3,2
12,492,492,56,17,39,2,1

3,109,109,1,1,0,1,0
12,111,111,5,5,0,1,0
20,123,123,1,1,0,1,0
38,124,124,24,24,0,1,0
11,128,128,29,17,12,2,1
17,129,129,12,12,0,1,0
28,130,130,3,3,0,1,0
30,130,130,18,3,15,2,1
6,135,135,1,1,0,1,0
34,146,146,12,12,0,1,0
41,149,149,55,5,50,3,2
19,160,160,6,6,0,1,0
0,176,176,13,13,0,1,0
36,177,177,23,23,0,1,0
22,178,178,11,11,0,1,0
1,191,191,7,4,3,2,1
23,198,198,26,5,21,4,3
15,210,210,16,13,3,2,1
24,253,253,7,7,0,1,0
45,284,284,23,23,0,1,0
2,285,285,24,17,7,2,1
26,287,287,8,8,0,1,0
18,289,289,63,20,43,2,1
10,303,303,10,10,0,1,0
31,320,320,70,37,33,2,1
39,320,320,10,2,8,2,1
16,325,325,6,6,0,1,0
44,336,336,2,2,0,1,0
40,350,350,15,4,11,3,2
35,367,367,2,2,0,1,0
27,369,369,43,37,6,2,1
42,376,376,5,5,0,1,0
9,377,377,36,36,0,1,0
21,402,402,40,29,11,2,1
43,406,406,44,15,29,2,1
5,409,409,4,4,0,1,0
13,424,424,15,15,0,1,0
14,428,428,2,2,0,1,0
29,453,453,52,23,29,2,1
32,461,461,130,103,27,4,3
25,470,470,21,21,0,1,0
7,478,478,5,5,0,1,0
8,481,481,52,18,34,2,1
37,484,484,8,8,0,1,0
33,489,489,7,1,6,3,2
46,493,493,34,34,0,1,0
4,495,495,80,80,0,1,0

14,122,122,11,7,4,2,1
36,123,123,6,3,3,2,1
27,129,129,32,14,18,3,2
2,132,132,4,4,0,1,0
33,133,133,4,4,0,1,0
21,141,141,30,30,0,1,0
25,141,141,15,7,8,3,2
37,149,149,11,11,0,1,0
13,159,159,2,2,0,1,0
5,164,164,27,9,18,4,3
18,168,168,4,4,0,1,0
0,182,182,4,4,0,1,0
11,201,201,43,22,21,3,2
28,202,202,13,13,0,1,0
7,210,210,3,3,0,1,0
29,211,211,22,22,0,1,0
6,228,228,1,1,0,1,0
22,230,230,20,17,3,2,1
31,234,234,23,23,0,1,0
20,243,243,22,22,0,1,0
9,255,255,18,18,0,1,0
24,256,256,1,1,0,1,0
12,257,257,22,1,21,4,3
19,283,283,22,7,15,4,3
38,285,285,68,60,8,3,2
8,294,294,5,5,0,1,0
10,301,301,7,4,3,2,1
34,305,305,5,5,0,1,0
39,321,321,2,2,0,1,0
30,321,321,132,132,0,1,0
40,322,322,10,10,0,1,0
15,331,331,10,10,0,1,0
32,359,359,75,5,70,3,2
1,382,382,4,4,0,1,0
16,399,399,5,2,3,2,1
23,424,424,24,24,0,1,0
4,424,424,159,159,0,1,0
41,425,425,8,8,0,1,0
17,427,427,48,48,0,1,0
3,449,449,55,55,0,1,0
26,496,496,18,6,12,4,3
35,500,500,68,68,0,1,0

10,101,101,19,1,18,4,3
24,103,103,3,3,0,1,0
19,113,113,30,30,0,1,0
9,117,117,18,6,12,2,1
5,134,134,20,20,0,1,0
20,148,148,7,7,0,1,0
6,148,148,14,6,8,2,1
16,151,151,23,1,22,2,1
0,171,171,24,19,5,2,1
23,173,173,2,2,0,1,0
30,178,178,43,43,0,1,0
33,187,187,14,4,10,2,1
21,191,191,11,11,0,1,0
2,192,192,13,2,11,3,2
15,222,222,1,1,0,1,0
11,243,243,4,4,0,1,0
34,247,247,49,49,0,1,0
4,267,267,41,9,32,2,1
32,293,293,3,3,0,1,0
26,308,308,24,24,0,1,0
3,331,331,20,12,8,2,1
14,335,335,2,2,0,1,0
37,340,340,25,3,22,3,2
18,347,347,2,2,0,1,0
22,357,357,14,8,6,3,2
25,365,365,163,163,0,1,0
27,370,370,33,33,0,1,0
8,398,398,48,29,19,4,3
1,415,415,16,16,0,1,0
36,421,421,2,2,0,1,0
31,426,426,52,52,0,1,0
13,429,429,7,7,0,1,0
12,436,436,94,24,70,3,2
35,436,436,11,11,0,1,0
17,477,477,6,1,5,2,1
28,485,485,20,20,0,1,0
29,488,488,42,12,30,3,2
7,489,489,149,149,0,1,0

31,117,117,10,10,0,1,0
26,122,122,20,20,0,1,0
29,122,122,11,7,4,2,1
9,124,124,9,2,7,2,1
28,131,131,2,2,0,1,0
41,138,138,10,1,9,4,3
14,148,148,19,13,6,3,2
40,155,155,28,28,0,1,0
33,160,160,19,19,0,1,0
4,167,167,9,3,6,3,2
1,183,183,2,2,0,1,0
30,186,186,1,1,0,1,0
0,189,189,25,25,0,1,0
10,193,193,12,12,0,1,0
42,196,196,16,10,6,2,1
20,211,211,1,1,0,1,0
34,217,217,39,9,30,4,3
35,227,227,18,11,7,2,1
38,230,230,61,40,21,4,3
43,241,241,10,1,9,4,3
6,244,244,5,5,0,1,0
25,262,262,3,3,0,1,0
18,262,262,55,36,19,3,2
5,262,262,16,8,8,2,1
3,264,264,62,62,0,1,0
15,266,266,20,17,3,2,1
19,277,277,11,11,0,1,0
21,282,282,29,29,0,1,0
22,283,283,29,17,12,4,3
13,291,291,17,7,10,3,2
11,294,294,45,45,0,1,0
8,308,308,1,1,0,1,0
24,323,323,2,2,0,1,0
36,338,338,41,41,0,1,0
16,341,341,10,6,4,2,1
27,343,343,36,36,0,1,0
39,370,370,46,42,4,2,1
32,387,387,79,79,0,1,0
17,411,411,62,62,0,1,0
2,416,416,3,3,0,1,0
23,421,421,35,24,11,2,1
37,436,436,2,2,0,1,0
7,461,461,13,5,8,3,2
12,480,480,34,26,8,2,1

13,102,102,7,7,0,1,0
1,119,119,5,5,0,1,0
11,129,129,3,3,0,1,0
18,131,131,11,5,6,3,2
14,131,131,2,2,0,1,0
15,136,136,36,36,0,1,0
36,142,142,10,1,9,4,3
25,142,142,17,11,6,2,1
24,152,152,28,1,27,2,1
0,154,154,3,3,0,1,0
22,169,169,2,2,0,1,0
34,173,173,11,11,0,1,0
9,174,174,4,4,0,1,0
4,197,197,3,3,0,1,0
6,208,208,75,42,33,2,1
19,226,226,5,1,4,2,1
27,227,227,31,7,24,3,2
16,235,235,9,9,0,1,0
17,243,243,41,11,30,4,3
29,265,265,18,2,16,3,2
2,294,294,1,1,0,1,0
38,315,315,4,1,3,2,1
12,320,320,5,5,0,1,0
20,325,325,4,4,0,1,0
10,327,327,34,1,33,2,1
23,352,352,2,2,0,1,0
8,369,369,46,36,10,3,2
28,377,377,62,10,52,4,3
37,390,390,15,15,0,1,0
7,392,392,5,5,0,1,0
31,402,402,21,21,0,1,0
32,443,443,50,29,21,4,3
21,444,444,114,114,0,1,0
26,451,451,73,33,40,3,2
39,454,454,47,16,31,2,1
33,456,456,188,188,0,1,0
3,471,471,15,15,0,1,0
35,474,474,34,2,32,3,2
5,478,478,93,40,53,3,2
40,496,496,56,17,39,4,3
30,499,499,16,11,5,2,1

23,108,108,7,1,6,2,1
12,112,112,12,12,0,1,0
5,112,112,41,41,0,1,0
33,128,128,6,1,5,2,1
27,131,131,6,6,0,1,0
15,147,147,5,5,0,1,0
14,174,174,3,3,0,1,0
7,175,175,2,2,0,1,0
13,190,190,12,12,0,1,0
8,207,207,43,25,18,4,3
19,225,225,25,25,0,1,0
24,226,226,44,2,42,3,2
20,236,236,63,41,22,3,2
21,247,247,37,13,24,3,2
4,250,250,56,56,0,1,0
10,256,256,27,27,0,1,0
17,256,256,9,6,3,2,1
2,259,259,2,2,0,1,0
22,288,288,51,51,0,1,0
1,293,293,2,2,0,1,0
25,303,303,4,4,0,1,0
11,310,310,51,1,50,3,2
29,334,334,80,80,0,1,0
31,340,340,47,24,23,4,3
32,350,350,16,16,0,1,0
6,351,351,58,9,49,3,2
9,366,366,5,5,0,1,0
16,408,408,52,52,0,1,0
26,423,423,2,2,0,1,0
18,425,425,60,60,0,1,0
3,478,478,141,44,97,4,3
0,480,480,71,71,0,1,0
30,487,487,24,15,9,2,1
28,488,488,31,17,14,2,1

2,107,107,1,1,0,1,0
38,111,111,20,11,9,4,3
21,123,123,24,3,21,2,1
4,127,127,7,7,0,1,0
18,156,156,19,19,0,1,0
25,159,159,6,6,0,1,0
16,164,164,1,1,0,1,0
8,165,165,9,9,0,1,0
32,184,184,26,26,0,1,0
14,188,188,20,20,0,1,0
31,194,194,2,2,0,1,0
26,195,195,6,6,0,1,0
33,212,212,4,4,0,1,0
41,227,227,15,5,10,2,1
22,237,237,8,8,0,1,0
20,245,245,38,8,30,3,2
36,249,249,11,2,9,2,1
34,249,249,6,6,0,1,0
24,259,259,52,7,45,3,2
40,268,268,1,1,0,1,0
0,273,273,10,4,6,3,2
6,280,280,13,1,12,2,1
10,295,295,13,7,6,2,1
37,295,295,10,7,3,2,1
35,303,303,52,52,0,1,0
5,330,330,56,48,8,3,2
28,342,342,108,61,47,4,3
12,342,342,6,6,0,1,0
3,383,383,30,30,0,1,0
7,390,390,16,16,0,1,0
19,401,401,89,60,29,2,1
17,403,403,19,19,0,1,0
13,404,404,50,50,0,1,0
11,411,411,46,27,19,2,1
29,422,422,67,37,30,2,1
23,425,425,19,19,0,1,0
27,445,445,79,33,46,2,1
9,449,449,8,8,0,1,0
1,474,474,49,33,16,3,2
15,477,477,51,2,49,3,2
30,478,478,86,86,0,1,0
39,492,492,48,2,46,2,1

24,100,100,17,11,6,2,1
10,107,107,4,1,3,2,1
29,128,128,8,8,0,1,0
12,144,144,8,8,0,1,0
0,148,148,56,56,0,1,0
14,160,160,7,7,0,1,0
8,162,162,11,11,0,1,0
23,162,162,8,2,6,3,2
22,177,177,24,24,0,1,0
30,179,179,15,12,3,2,1
15,181,181,13,13,0,1,0
1,197,197,38,38,0,1,0
25,202,202,97,69,28,2,1
5,233,233,18,11,7,2,1
13,258,258,2,2,0,1,0
31,266,266,7,7,0,1,0
9,272,272,25,5,20,3,2
3,284,284,59,1,58,3,2
17,292,292,24,24,0,1,0
11,298,298,59,59,0,1,0
19,344,344,12,12,0,1,0
18,357,357,7,7,0,1,0
28,379,379,59,53,6,3,2
2,383,383,111,41,70,4,3
7,399,399,90,42,48,2,1
4,405,405,27,17,10,3,2
27,410,410,28,2,26,3,2
6,412,412,6,1,5,2,1
16,418,418,18,18,0,1,0
21,420,420,46,16,30,3,2
20,431,431,116,65,51,4,3
26,459,459,12,12,0,1,0

40,100,100,12,12,0,1,0
9,112,112,1,1,0,1,0
4,113,113,13,13,0,1,0
21,125,125,11,11,0,1,0
31,133,133,5,5,0,1,0
35,158,158,12,3,9,2,1
19,164,164,5,2,3,2,1
3,164,164,4,4,0,1,0
10,171,171,11,11,0,1,0
14,172,172,5,5,0,1,0
5,203,203,32,4,28,3,2
13,230,230,23,3,20,3,2
27,238,238,17,11,6,3,2
26,253,253,13,13,0,1,0
20,258,258,38,38,0,1,0
36,261,261,64,64,0,1,0
18,307,307,14,14,0,1,0
41,317,317,32,32,0,1,0
22,319,319,33,3,30,2,1
42,322,322,12,12,0,1,0
33,324,324,14,11,3,2,1
16,351,351,20,20,0,1,0
2,355,355,50,50,0,1,0
30,368,368,12,12,0,1,0
11,372,372,54,9,45,2,1
23,381,381,15,15,0,1,0
34,381,381,45,45,0,1,0
0,398,398,56,26,30,3,2
1,403,403,4,1,3,2,1
37,405,405,140,140,0,1,0
12,418,418,60,60,0,1,0
15,424,424,35,19,16,2,1
25,426,426,3,3,0,1,0
6,434,434,8,2,6,3,2
8,448,448,39,2,37,3,2
28,460,460,40,4,36,4,3
32,465,465,51,51,0,1,0
24,469,469,17,17,0,1,0
38,481,481,40,40,0,1,0
39,483,483,9,9,0,1,0
17,488,488,29,29,0,1,0
7,497,497,31,31,0,1,0
29,499,499,153,127,26,2,1

17,101,101,1,1,0,1,0
9,101,101,7,7,0,1,0
41,107,107,6,2,4,2,1
6,126,126,4,4,0,1,0
31,133,133,5,1,4,2,1
26,147,147,16,16,0,1,0
40,150,150,4,4,0,1,0
14,160,160,15,15,0,1,0
20,173,173,2,2,0,1,0
39,205,205,3,3,0,1,0
18,221,221,9,9,0,1,0
21,224,224,14,1,13,2,1
5,226,226,3,3,0,1,0
7,230,230,42,6,36,4,3
1,237,237,16,16,0,1,0
22,241,241,5,5,0,1,0
37,258,258,70,60,10,3,2
12,259,259,6,3,3,2,1
23,260,260,10,10,0,1,0
11,270,270,15,5,10,3,2
30,276,276,34,27,7,2,1
25,279,279,18,18,0,1,0
3,305,305,44,6,38,2,1
28,306,306,25,25,0,1,0
0,330,330,6,6,0,1,0
27,333,333,14,14,0,1,0
10,336,336,97,97,0,1,0
32,350,350,140,41,99,4,3
34,375,375,15,15,0,1,0
19,382,382,19,19,0,1,0
35,393,393,33,33,0,1,0
24,402,402,23,7,16,3,2
36,419,419,45,34,11,2,1
4,431,431,1,1,0,1,0
33,461,461,5,5,0,1,0
2,461,461,19,19,0,1,0
15,468,468,13,13,0,1,0
16,472,472,158,158,0,1,0
13,484,484,23,17,6,2,1
29,493,493,19,13,6,2,1
38,495,495,163,163,0,1,0
8,496,496,132,132,0,1,0

26,130,130,10,10,0,1,0
22,131,131,22,14,8,2,1
3,160,160,21,21,0,1,0
2,176,176,26,26,0,1,0
28,186,186,2,2,0,1,0
23,191,191,10,10,0,1,0
15,194,194,21,15,6,2,1
11,196,196,5,1,4,2,1
14,210,210,5,5,0,1,0
12,222,222,8,3,5,2,1
25,223,223,28,28,0,1,0
0,243,243,35,11,24,3,2
21,266,266,29,11,18,4,3
18,284,284,64,64,0,1,0
24,308,308,25,9,16,2,1
10,355,355,61,19,42,2,1
1,356,356,18,6,12,2,1
27,371,371,3,3,0,1,0
6,379,379,33,33,0,1,0
34,379,379,56,8,48,4,3
9,382,382,17,17,0,1,0
33,394,394,2,2,0,1,0
8,399,399,102,27,75,4,3
19,414,414,66,66,0,1,0
32,417,417,34,34,0,1,0
13,420,420,53,53,0,1,0
31,431,431,14,14,0,1,0
7,438,438,146,132,14,3,2
4,476,476,63,13,50,2,1
30,481,481,56,8,48,2,1
29,484,484,48,48,0,1,0
16,486,486,27,15,12,4,3
5,490,490,42,42,0,1,0
17,496,496,146,59,87,4,3
20,497,497,41,41,0,1,0

20,102,102,2,2,0,1,0
21,112,112,8,8,0,1,0
3,117,117,1,1,0,1,0
10,159,159,37,37,0,1,0
11,164,164,11,11,0,1,0
34,166,166,22,22,0,1,0
18,178,178,1,1,0,1,0
8,194,194,8,5,3,2,1
4,212,212,18,3,15,2,1
35,213,213,97,37,60,4,3
27,230,230,14,5,9,2,1
31,232,232,13,13,0,1,0
6,237,237,17,7,10,2,1
26,266,266,9,9,0,1,0
24,281,281,74,38,36,4,3
13,287,287,36,36,0,1,0
15,299,299,57,57,0,1,0
32,303,303,7,7,0,1,0
29,312,312,48,35,13,2,1
25,347,347,32,4,28,3,2
16,355,355,5,5,0,1,0
14,382,382,76,16,60,3,2
12,385,385,5,1,4,2,1
5,397,397,52,13,39,4,3
2,397,397,113,74,39,2,1
7,422,422,1,1,0,1,0
33,430,430,5,1,4,2,1
28,457,457,61,24,37,4,3
23,472,472,22,22,0,1,0
19,473,473,34,8,26,4,3
22,484,484,82,44,38,2,1
0,487,487,64,28,36,4,3
9,489,489,7,7,0,1,0
17,496,496,32,7,25,2,1
30,496,496,33,33,0,1,0
1,500,500,144,58,86,4,3

2,108,108,9,5,4,2,1
18,117,117,2,2,0,1,0
17,118,118,12,9,3,2,1
25,125,125,36,25,11,2,1
13,131,131,1,1,0,1,0
5,134,134,6,2,4,2,1
29,156,156,45,45,0,1,0
16,158,158,3,3,0,1,0
23,187,187,7,4,3,2,1
11,195,195,9,1,8,3,2
4,196,196,16,16,0,1,0
10,204,204,34,3,31,4,3
7,246,246,37,37,0,1,0
9,249,249,23,14,9,2,1
6,265,265,73,53,20,3,2
14,302,302,49,49,0,1,0
3,316,316,93,15,78,4,3
31,317,317,8,2,6,2,1
1,323,323,28,5,23,2,1
22,324,324,5,5,0,1,0
0,346,346,138,43,95,4,3
20,352,352,70,70,0,1,0
24,355,355,14,1,13,2,1
26,368,368,44,44,0,1,0
27,421,421,6,6,0,1,0
19,424,424,75,44,31,2,1
28,425,425,97,13,84,4,3
15,433,433,18,6,12,4,3
30,438,438,35,3,32,3,2
21,461,461,33,10,23,2,1
12,468,468,13,13,0,1,0
8,471,471,72,48,24,3,2

0,113,113,1,1,0,1,0
11,126,126,6,6,0,1,0
14,126,126,7,7,0,1,0
10,162,162,11,2,9,4,3
17,165,165,5,5,0,1,0
7,183,183,66,16,50,3,2
22,186,186,7,7,0,1,0
6,188,188,13,3,10,2,1
28,213,213,84,80,4,2,1
26,219,219,1,1,0,1,0
30,254,254,29,29,0,1,0
27,262,262,7,7,0,1,0
1,284,284,48,41,7,2,1
31,295,295,49,49,0,1,0
18,302,302,31,31,0,1,0
19,303,303,13,13,0,1,0
20,320,320,64,64,0,1,0
24,327,327,15,15,0,1,0
13,345,345,4,4,0,1,0
3,347,347,52,52,0,1,0
8,354,354,142,142,0,1,0
2,358,358,30,1,29,4,3
23,371,371,98,3,95,3,2
5,389,389,4,4,0,1,0
9,409,409,13,2,11,3,2
25,414,414,24,24,0,1,0
12,423,423,50,41,9,2,1
16,438,438,12,12,0,1,0
21,445,445,73,7,66,3,2
32,446,446,30,30,0,1,0
29,454,454,5,5,0,1,0
15,455,455,60,15,45,3,2
4,480,480,179,113,66,4,3

5,114,114,1,1,0,1,0
15,117,117,5,5,0,1,0
7,128,128,3,3,0,1,0
30,138,138,26,16,10,2,1
8,148,148,12,1,11,2,1
6,179,179,23,6,17,2,1
35,183,183,9,9,0,1,0
11,201,201,11,3,8,3,2
33,201,201,41,41,0,1,0
20,212,212,35,35,0,1,0
25,233,233,6,6,0,1,0
1,242,242,47,47,0,1,0
18,260,260,8,8,0,1,0
14,269,269,112,10,102,4,3
28,283,283,2,2,0,1,0
2,303,303,72,22,50,2,1
19,312,312,41,20,21,4,3
0,314,314,66,66,0,1,0
24,336,336,3,3,0,1,0
23,344,344,29,25,4,2,1
10,345,345,7,7,0,1,0
27,374,374,31,31,0,1,0
13,387,387,15,7,8,3,2
16,398,398,20,20,0,1,0
32,404,404,83,83,0,1,0
31,408,408,110,55,55,4,3
34,410,410,80,80,0,1,0
4,436,436,13,13,0,1,0
22,448,448,2,2,0,1,0
17,450,450,26,26,0,1,0
12,455,455,55,55,0,1,0
9,462,462,105,29,76,3,2
26,471,471,26,5,21,4,3
21,480,480,30,30,0,1,0
29,485,485,52,52,0,1,0
3,488,488,8,8,0,1,0

6,106,106,22,22,0,1,0
26,114,114,10,10,0,1,0
12,116,116,12,12,0,1,0
16,120,120,5,1,4,2,1
13,121,121,1,1,0,1,0
36,137,137,34,34,0,1,0
35,139,139,1,1,0,1,0
4,169,169,3,3,0,1,0
8,176,176,36,28,8,2,1
23,190,190,4,4,0,1,0
14,201,201,4,4,0,1,0
18,206,206,9,9,0,1,0
10,217,217,3,3,0,1,0
20,233,233,33,11,22,3,2
0,242,242,8,8,0,1,0
39,244,244,10,3,7,3,2
28,245,245,1,1,0,1,0
9,246,246,11,11,0,1,0
34,259,259,5,1,4,2,1
37,267,267,6,6,0,1,0
33,280,280,5,5,0,1,0
19,283,283,1,1,0,1,0
21,297,297,3,3,0,1,0
29,331,331,88,88,0,1,0
5,344,344,30,30,0,1,0
38,368,368,11,1,10,3,2
41,372,372,32,11,21,4,3
25,377,377,41,29,12,4,3
1,385,385,41,33,8,3,2
15,412,412,25,3,22,3,2
17,415,415,61,18,43,2,1
22,415,415,14,14,0,1,0
3,422,422,196,138,58,4,3
7,428,428,1,1,0,1,0
30,435,435,7,2,5,2,1
32,436,436,154,154,0,1,0
24,439,439,24,24,0,1,0
40,453,453,84,84,0,1,0
2,460,460,5,1,4,2,1
31,471,471,147,135,12,4,3
27,479,479,27,3,24,3,2
11,498,498,47,4,43,2,1

24,109,109,2,2,0,1,0
12,120,120,4,4,0,1,0
9,143,143,26,12,14,2,1
26,146,146,40,40,0,1,0
18,152,152,31,31,0,1,0
30,152,152,17,14,3,2,1
37,155,155,4,4,0,1,0
3,180,180,30,9,21,2,1
15,194,194,59,23,36,3,2
13,204,204,38,8,30,3,2
34,219,219,12,12,0,1,0
11,222,222,9,9,0,1,0
10,243,243,25,25,0,1,0
33,247,247,18,1,17,2,1
23,262,262,12,9,3,2,1
0,270,270,9,9,0,1,0
5,271,271,10,10,0,1,0
17,272,272,48,48,0,1,0
6,274,274,28,10,18,4,3
2,287,287,6,1,5,2,1
25,289,289,54,54,0,1,0
29,303,303,2,2,0,1,0
22,315,315,23,23,0,1,0
36,316,316,52,52,0,1,0
28,322,322,6,6,0,1,0
14,322,322,3,3,0,1,0
27,337,337,67,43,24,2,1
1,346,346,67,44,23,2,1
35,347,347,50,23,27,4,3
4,349,349,2,2,0,1,0
21,375,375,25,25,0,1,0
31,381,381,11,11,0,1,0
7,416,416,20,20,0,1,0
16,431,431,10,1,9,4,3
20,436,436,30,6,24,3,2
32,439,439,110,70,40,2,1
8,450,450,15,1,14,3,2
19,452,452,58,58,0,1,0

18,100,100,10,4,6,2,1
16,109,109,1,1,0,1,0
3,110,110,45,33,12,2,1
28,112,112,12,12,0,1,0
4,113,113,2,2,0,1,0
13,119,119,18,18,0,1,0
23,131,131,13,6,7,2,1
31,154,154,8,4,4,2,1
5,156,156,25,25,0,1,0
9,168,168,10,10,0,1,0
0,175,175,8,8,0,1,0
2,180,180,18,18,0,1,0
26,183,183,17,17,0,1,0
11,188,188,33,7,26,4,3
24,208,208,3,3,0,1,0
12,222,222,101,101,0,1,0
8,258,258,9,9,0,1,0
21,263,263,5,5,0,1,0
25,267,267,71,56,15,4,3
10,273,273,10,10,0,1,0
29,294,294,127,127,0,1,0
6,307,307,9,1,8,2,1
30,332,332,57,19,38,2,1
20,356,356,105,105,0,1,0
22,365,365,19,6,13,2,1
17,368,368,31,9,22,2,1
32,369,369,5,5,0,1,0
14,389,389,24,14,10,3,2
1,394,394,1,1,0,1,0
19,417,417,4,4,0,1,0
27,431,431,22,2,20,2,1
33,433,433,11,11,0,1,0
15,464,464,25,1,24,4,3
7,490,490,79,28,51,4,3

22,104,104,4,4,0,1,0
30,106,106,15,8,7,2,1
7,111,111,1,1,0,1,0
21,112,112,14,14,0,1,0
26,123,123,19,1,18,2,1
6,128,128,33,20,13,2,1
28,162,162,28,19,9,4,3
16,185,185,4,4,0,1,0
3,213,213,44,31,13,2,1
27,213,213,5,5,0,1,0
14,226,226,5,5,0,1,0
18,234,234,14,2,12,2,1
15,251,251,6,6,0,1,0
8,277,277,3,3,0,1,0
2,311,311,35,35,0,1,0
25,318,318,18,4,14,3,2
11,326,326,35,6,29,2,1
5,327,327,1,1,0,1,0
29,339,339,34,16,18,4,3
10,346,346,41,41,0,1,0
9,358,358,58,58,0,1,0
32,361,361,168,92,76,3,2
1,367,367,19,19,0,1,0
24,374,374,16,9,7,2,1
12,380,380,5,5,0,1,0
17,394,394,34,9,25,2,1
4,399,399,226,143,83,4,3
0,400,400,18,8,10,4,3
31,432,432,54,54,0,1,0
20,453,453,37,9,28,4,3
23,454,454,76,76,0,1,0
19,490,490,14,14,0,1,0
13,496,496,118,49,69,4,3

13,105,105,12,12,0,1,0
39,120,120,28,28,0,1,0
24,127,127,12,12,0,1,0
5,130,130,13,1,12,3,2
26,132,132,14,2,12,4,3
28,133,133,7,7,0,1,0
14,157,157,11,11,0,1,0
1,196,196,1,1,0,1,0
15,205,205,20,17,3,2,1
32,211,211,28,14,14,3,2
25,223,223,5,2,3,2,1
0,226,226,29,6,23,2,1
22,230,230,1,1,0,1,0
16,241,241,27,27,0,1,0
34,262,262,40,40,0,1,0
12,274,274,75,42,33,4,3
6,282,282,14,14,0,1,0
21,290,290,60,60,0,1,0
37,291,291,8,8,0,1,0
18,297,297,65,9,56,3,2
36,321,321,51,51,0,1,0
2,327,327,48,27,21,4,3
27,328,328,12,12,0,1,0
38,329,329,38,24,14,3,2
17,346,346,9,9,0,1,0
4,346,346,1,1,0,1,0
11,356,356,13,4,9,2,1
29,367,367,33,9,24,3,2
9,371,371,67,53,14,3,2
31,371,371,25,18,7,2,1
23,375,375,37,37,0,1,0
30,381,381,89,89,0,1,0
3,420,420,3,3,0,1,0
7,425,425,13,13,0,1,0
20,439,439,1,1,0,1,0
10,459,459,14,8,6,3,2
40,467,467,30,30,0,1,0
35,473,473,5,5,0,1,0
33,473,473,110,56,54,4,3
19,477,477,5,2,3,2,1
8,500,500,25,7,18,4,3

5,106,106,1,1,0,1,0
38,127,127,13,1,12,2,1
40,130,130,1,1,0,1,0
29,134,134,34,23,11,2,1
41,140,140,11,11,0,1,0
31,140,140,9,9,0,1,0
27,146,146,5,5,0,1,0
4,151,151,13,5,8,3,2
18,168,168,50,50,0,1,0
1,171,171,14,1,13,3,2
19,176,176,18,18,0,1,0
30,181,181,17,2,15,4,3
14,210,210,2,2,0,1,0
28,210,210,17,17,0,1,0
42,215,215,9,9,0,1,0
2,232,232,32,32,0,1,0
35,247,247,25,7,18,2,1
11,259,259,9,9,0,1,0
20,263,263,38,20,18,2,1
12,265,265,22,4,18,3,2
6,269,269,62,29,33,4,3
34,283,283,56,56,0,1,0
37,291,291,102,68,34,2,1
21,317,317,15,15,0,1,0
7,317,317,17,8,9,4,3
36,319,319,2,2,0,1,0
17,320,320,24,15,9,2,1
33,321,321,7,7,0,1,0
25,322,322,8,8,0,1,0
8,325,325,25,1,24,4,3
9,326,326,23,9,14,3,2
23,328,328,2,2,0,1,0
32,347,347,59,59,0,1,0
10,350,350,12,12,0,1,0
22,394,394,14,14,0,1,0
39,442,442,59,59,0,1,0
3,442,442,20,11,9,2,1
15,453,453,4,4,0,1,0
26,454,454,26,26,0,1,0
13,465,465,97,97,0,1,0
16,477,477,4,4,0,1,0
0,484,484,7,7,0,1,0
24,492,492,64,50,14,2,1

14,118,118,14,5,9,4,3
5,128,128,16,8,8,2,1
17,132,132,6,6,0,1,0
1,141,141,22,1,21,2,1
12,143,143,28,7,21,2,1
3,146,146,2,2,0,1,0
11,165,165,2,2,0,1,0
19,211,211,2,2,0,1,0
21,211,211,11,11,0,1,0
7,215,215,50,16,34,4,3
26,223,223,15,3,12,4,3
24,242,242,25,15,10,2,1
9,254,254,15,15,0,1,0
31,256,256,120,120,0,1,0
15,280,280,10,2,8,2,1
27,288,288,32,2,30,4,3
8,311,311,46,34,12,4,3
30,327,327,106,106,0,1,0
23,333,333,9,9,0,1,0
34,337,337,65,50,15,4,3
2,340,340,1,1,0,1,0
4,344,344,8,8,0,1,0
35,357,357,16,16,0,1,0
13,389,389,4,4,0,1,0
32,427,427,1,1,0,1,0
25,430,430,3,3,0,1,0
20,442,442,49,49,0,1,0
6,450,450,26,26,0,1,0
18,454,454,41,15,26,3,2
10,473,473,306,306,0,1,0
16,474,474,7,2,5,2,1
0,477,477,23,23,0,1,0
29,482,482,21,5,16,2,1
33,484,484,2,2,0,1,0
22,486,486,65,23,42,2,1
28,499,499,47,47,0,1,0

16,150,150,8,8,0,1,0
30,155,155,13,8,5,2,1
29,181,181,12,4,8,2,1
19,187,187,10,3,7,2,1
35,197,197,28,28,0,1,0
21,210,210,18,18,0,1,0
13,214,214,21,21,0,1,0
0,225,225,3,3,0,1,0
34,242,242,34,34,0,1,0
24,244,244,13,13,0,1,0
20,246,246,16,16,0,1,0
14,255,255,3,3,0,1,0
8,270,270,34,7,27,4,3
5,277,277,1,1,0,1,0
27,278,278,17,5,12,2,1
1,286,286,41,18,23,2,1
7,290,290,48,48,0,1,0
25,293,293,12,12,0,1,0
9,305,305,13,2,11,3,2
2,308,308,32,32,0,1,0
23,320,320,40,40,0,1,0
26,322,322,7,1,6,3,2
31,342,342,34,4,30,4,3
32,347,347,45,15,30,4,3
15,354,354,63,63,0,1,0
17,356,356,6,6,0,1,0
10,374,374,23,7,16,2,1
33,424,424,223,223,0,1,0
22,431,431,43,23,20,2,1
18,435,435,7,7,0,1,0
6,439,439,187,187,0,1,0
11,442,442,74,74,0,1,0
28,449,449,50,26,24,3,2
12,486,486,56,56,0,1,0
4,493,493,62,22,40,3,2
3,496,496,33,10,23,2,1

6,110,110,5,5,0,1,0
31,110,110,10,10,0,1,0
15,128,128,36,36,0,1,0
7,129,129,1,1,0,1,0
32,137,137,4,4,0,1,0
4,151,151,2,2,0,1,0
16,190,190,4,4,0,1,0
8,225,225,59,59,0,1,0
28,243,243,5,5,0,1,0
12,251,251,13,13,0,1,0
24,261,261,32,8,24,4,3
22,276,276,45,45,0,1,0
14,285,285,94,59,35,4,3
26,330,330,25,1,24,3,2
9,351,351,17,9,8,3,2
0,367,367,87,87,0,1,0
11,373,373,9,3,6,2,1
33,379,379,6,6,0,1,0
25,387,387,68,68,0,1,0
35,389,389,53,53,0,1,0
13,402,402,29,29,0,1,0
10,405,405,8,8,0,1,0
21,408,408,19,4,15,4,3
27,411,411,13,13,0,1,0
20,419,419,71,29,42,3,2
1,427,427,14,14,0,1,0
29,454,454,21,11,10,2,1
30,458,458,32,32,0,1,0
36,460,460,99,73,26,2,1
19,462,462,4,4,0,1,0
18,463,463,36,36,0,1,0
17,465,465,76,16,60,4,3
2,478,478,109,109,0,1,0
5,479,479,29,2,27,4,3
34,490,490,71,71,0,1,0
3,495,495,1,1,0,1,0
23,498,498,141,3,138,4,3

34,113,113,11,11,0,1,0
0,149,149,1,1,0,1,0
6,150,150,7,4,3,2,1
18,155,155,12,3,9,2,1
24,162,162,2,2,0,1,0
10,176,176,12,12,0,1,0
27,180,180,15,12,3,2,1
33,194,194,1,1,0,1,0
32,204,204,16,7,9,2,1
12,225,225,86,86,0,1,0
23,227,227,6,3,3,2,1
31,239,239,10,10,0,1,0
9,243,243,12,2,10,2,1
4,247,247,20,15,5,2,1
16,263,263,49,49,0,1,0
22,263,263,64,22,42,4,3
17,266,266,17,3,14,2,1
1,286,286,16,16,0,1,0
3,297,297,37,5,32,3,2
2,299,299,9,9,0,1,0
19,301,301,14,11,3,2,1
8,318,318,13,5,8,2,1
7,337,337,59,56,3,2,1
25,348,348,159,54,105,4,3
20,359,359,10,10,0,1,0
21,366,366,3,3,0,1,0
15,373,373,91,49,42,3,2
26,376,376,27,27,0,1,0
30,400,400,6,6,0,1,0
35,401,401,39,39,0,1,0
28,404,404,153,153,0,1,0
29,410,410,39,12,27,4,3
13,412,412,51,51,0,1,0
11,452,452,83,83,0,1,0
5,469,469,21,21,0,1,0
14,495,495,30,30,0,1,0

17,105,105,10,10,0,1,0
20,107,107,8,8,0,1,0
12,121,121,2,2,0,1,0
19,134,134,9,9,0,1,0
3,141,141,17,17,0,1,0
7,168,168,38,38,0,1,0
26,171,171,43,43,0,1,0
10,173,173,71,29,42,4,3
21,177,177,72,16,56,4,3
11,206,206,5,1,4,2,1
1,221,221,7,3,4,2,1
25,227,227,10,10,0,1,0
18,235,235,7,7,0,1,0
0,237,237,27,7,20,3,2
36,243,243,6,6,0,1,0
16,251,251,21,12,9,4,3
27,256,256,37,3,34,2,1
15,272,272,84,39,45,2,1
34,284,284,12,12,0,1,0
32,305,305,5,5,0,1,0
24,313,313,5,5,0,1,0
30,332,332,4,4,0,1,0
6,355,355,58,36,22,2,1
31,358,358,13,3,10,3,2
4,374,374,38,7,31,2,1
2,380,380,6,6,0,1,0
8,402,402,4,4,0,1,0
22,406,406,8,8,0,1,0
5,410,410,8,8,0,1,0
14,428,428,21,21,0,1,0
13,443,443,10,2,8,2,1
35,450,450,128,59,69,4,3
29,452,452,66,54,12,4,3
28,460,460,25,7,18,2,1
9,469,469,41,15,26,3,2
33,480,480,25,25,0,1,0
23,485,485,106,57,49,2,1

11,102,102,1,1,0,1,0
12,112,112,7,7,0,1,0
1,117,117,44,44,0,1,0
29,124,124,9,9,0,1,0
15,134,134,3,3,0,1,0
17,137,137,4,4,0,1,0
13,154,154,24,16,8,2,1
34,156,156,12,4,8,2,1
9,181,181,17,17,0,1,0
25,186,186,32,32,0,1,0
18,205,205,16,16,0,1,0
20,243,243,4,4,0,1,0
32,246,246,71,71,0,1,0
35,248,248,40,24,16,3,2
8,249,249,15,2,13,2,1
33,252,252,7,7,0,1,0
2,259,259,16,16,0,1,0
30,262,262,8,1,7,2,1
4,264,264,25,25,0,1,0
5,277,277,67,59,8,2,1
36,283,283,1,1,0,1,0
23,294,294,90,42,48,3,2
10,304,304,6,6,0,1,0
3,306,306,86,54,32,3,2
14,308,308,44,32,12,2,1
21,312,312,29,29,0,1,0
6,320,320,16,16,0,1,0
22,334,334,12,12,0,1,0
0,346,346,7,7,0,1,0
27,349,349,15,15,0,1,0
38,376,376,24,8,16,3,2
28,391,391,42,2,40,3,2
16,401,401,16,16,0,1,0
7,421,421,14,14,0,1,0
26,442,442,21,5,16,2,1
19,462,462,13,9,4,2,1
37,466,466,19,19,0,1,0
31,479,479,99,99,0,1,0
24,491,491,69,69,0,1,0

22,105,105,25,25,0,1,0
1,149,149,20,8,12,2,1
29,151,151,11,2,9,4,3
0,162,162,21,13,8,2,1
34,169,169,1,1,0,1,0
13,179,179,21,21,0,1,0
35,185,185,34,22,12,2,1
9,188,188,18,10,8,2,1
5,194,194,11,11,0,1,0
40,209,209,2,2,0,1,0
19,210,210,28,28,0,1,0
11,221,221,21,5,16,3,2
18,225,225,20,20,0,1,0
41,249,249,11,11,0,1,0
27,257,257,85,85,0,1,0
20,262,262,7,2,5,2,1
4,272,272,30,30,0,1,0
12,273,273,10,10,0,1,0
2,285,285,14,14,0,1,0
26,286,286,82,46,36,4,3
14,294,294,20,1,19,3,2
6,295,295,32,18,14,2,1
39,295,295,16,6,10,3,2
25,346,346,1,1,0,1,0
30,356,356,20,2,18,2,1
32,365,365,18,18,0,1,0
17,370,370,12,3,9,2,1
33,371,371,127,73,54,3,2
37,373,373,119,119,0,1,0
42,384,384,10,5,5,2,1
7,399,399,9,9,0,1,0
43,403,403,1,1,0,1,0
28,405,405,8,8,0,1,0
15,409,409,42,33,9,4,3
21,418,418,1,1,0,1,0
23,422,422,35,35,0,1,0
38,435,435,2,2,0,1,0
10,457,457,11,3,8,3,2
36,461,461,23,2,21,4,3
3,464,464,36,16,20,3,2
24,467,467,9,9,0,1,0
8,474,474,21,8,13,2,1
16,491,491,2,2,0,1,0
31,494,494,35,22,13,2,1

4,102,102,3,3,0,1,0
1,108,108,6,6,0,1,0
9,114,114,15,8,7,2,1
15,114,114,3,3,0,1,0
21,124,124,4,4,0,1,0
28,129,129,33,3,30,3,2
20,133,133,2,2,0,1,0
23,139,139,11,11,0,1,0
13,140,140,22,8,14,2,1
5,147,147,49,4,45,4,3
30,149,149,34,34,0,1,0
8,215,215,16,16,0,1,0
31,220,220,7,3,4,2,1
0,237,237,9,9,0,1,0
34,237,237,15,3,12,2,1
14,249,249,23,7,16,2,1
11,266,266,53,53,0,1,0
33,270,270,42,31,11,2,1
32,273,273,1,1,0,1,0
26,285,285,66,66,0,1,0
2,287,287,7,1,6,3,2
18,300,300,30,30,0,1,0
6,306,306,17,17,0,1,0
17,321,321,5,1,4,2,1
19,342,342,125,90,35,3,2
7,356,356,67,67,0,1,0
3,359,359,1,1,0,1,0
25,379,379,23,5,18,4,3
16,387,387,154,124,30,4,3
27,388,388,31,31,0,1,0
35,406,406,26,26,0,1,0
12,407,407,23,23,0,1,0
10,427,427,17,7,10,2,1
29,433,433,27,20,7,2,1
22,453,453,12,12,0,1,0
24,495,495,35,21,14,3,2

17,115,115,1,1,0,1,0
12,115,115,4,4,0,1,0
22,122,122,23,23,0,1,0
34,129,129,6,6,0,1,0
33,137,137,13,5,8,3,2
30,144,144,17,17,0,1,0
15,145,145,8,8,0,1,0
37,148,148,1,1,0,1,0
21,151,151,7,7,0,1,0
18,155,155,1,1,0,1,0
9,156,156,4,4,0,1,0
19,162,162,6,6,0,1,0
6,171,171,26,26,0,1,0
29,172,172,28,10,18,3,2
8,187,187,27,27,0,1,0
13,187,187,11,11,0,1,0
3,223,223,4,1,3,2,1
36,223,223,8,3,5,2,1
1,248,248,49,49,0,1,0
32,251,251,26,2,24,2,1
35,252,252,63,42,21,2,1
26,254,254,28,28,0,1,0
4,255,255,82,20,62,4,3
10,265,265,1,1,0,1,0
7,271,271,12,2,10,3,2
0,283,283,48,34,14,3,2
23,286,286,25,22,3,2,1
20,315,315,12,12,0,1,0
5,320,320,85,80,5,2,1
11,349,349,48,25,23,2,1
24,349,349,50,25,25,2,1
2,374,374,49,7,42,4,3
27,388,388,42,42,0,1,0
25,422,422,12,12,0,1,0
16,424,424,3,3,0,1,0
31,436,436,104,53,51,4,3
28,445,445,46,34,12,4,3
14,448,448,53,53,0,1,0

26,119,119,1,1,0,1,0
30,125,125,5,1,4,2,1
28,142,142,32,18,14,2,1
12,144,144,4,4,0,1,0
5,145,145,13,13,0,1,0
14,149,149,12,4,8,2,1
22,165,165,40,40,0,1,0
32,177,177,35,35,0,1,0
27,178,178,11,8,3,2,1
25,192,192,31,31,0,1,0
36,197,197,5,5,0,1,0
3,201,201,14,14,0,1,0
0,206,206,22,22,0,1,0
34,224,224,17,17,0,1,0
17,233,233,5,2,3,2,1
31,241,241,8,8,0,1,0
19,248,248,1,1,0,1,0
8,254,254,15,15,0,1,0
23,271,271,22,16,6,3,2
15,283,283,44,44,0,1,0
2,292,292,2,2,0,1,0
21,296,296,26,26,0,1,0
33,302,302,20,20,0,1,0
1,304,304,13,13,0,1,0
38,312,312,71,71,0,1,0
6,327,327,91,35,56,4,3
24,333,333,36,36,0,1,0
29,341,341,24,24,0,1,0
20,364,364,41,41,0,1,0
37,370,370,52,40,12,2,1
9,384,384,57,21,36,4,3
10,389,389,1,1,0,1,0
16,423,423,17,7,10,3,2
11,436,436,100,44,56,3,2
18,452,452,108,99,9,4,3
7,466,466,1,1,0,1,0
13,480,480,1,1,0,1,0
35,490,490,7,2,5,2,1
4,497,497,91,83,8,2,1
39,498,498,37,10,27,2,1

10,101,101,2,2,0,1,0
5,109,109,59,59,0,1,0
0,117,117,1,1,0,1,0
8,140,140,4,1,3,2,1
3,163,163,6,1,5,2,1
6,164,164,7,7,0,1,0
33,183,183,12,2,10,3,2
26,184,184,25,25,0,1,0
32,195,195,25,17,8,2,1
24,195,195,12,2,10,2,1
29,218,218,58,10,48,4,3
19,218,218,5,5,0,1,0
9,234,234,29,9,20,2,1
21,238,238,9,5,4,2,1
36,242,242,18,18,0,1,0
35,258,258,3,3,0,1,0
18,274,274,90,43,47,2,1
22,308,308,6,2,4,2,1
1,314,314,47,2,45,4,3
17,337,337,31,2,29,2,1
12,347,347,3,3,0,1,0
11,358,358,7,7,0,1,0
28,369,369,7,7,0,1,0
34,376,376,14,2,12,4,3
27,398,398,78,78,0,1,0
4,399,399,31,3,28,2,1
23,400,400,17,5,12,2,1
25,429,429,41,41,0,1,0
30,439,439,54,21,33,2,1
7,450,450,50,50,0,1,0
20,456,456,44,8,36,4,3
14,458,458,1,1,0,1,0
16,459,459,1,1,0,1,0
13,461,461,151,151,0,1,0
2,466,466,97,79,18,3,2
31,469,469,78,78,0,1,0
15,470,470,48,48,0,1,0

2,112,112,6,2,4,2,1
27,122,122,23,7,16,2,1
1,126,126,5,5,0,1,0
14,128,128,1,1,0,1,0
29,136,136,15,15,0,1,0
9,137,137,41,20,21,4,3
5,142,142,11,7,4,2,1
7,185,185,2,2,0,1,0
21,188,188,39,39,0,1,0
25,191,191,23,1,22,3,2
38,193,193,16,16,0,1,0
35,206,206,14,2,12,3,2
0,219,219,5,5,0,1,0
13,235,235,34,28,6,2,1
4,239,239,29,20,9,2,1
11,252,252,17,10,7,2,1
8,274,274,3,3,0,1,0
24,278,278,9,9,0,1,0
6,286,286,10,7,3,2,1
30,300,300,24,12,12,4,3
37,311,311,78,44,34,4,3
16,319,319,22,16,6,3,2
17,334,334,74,56,18,2,1
31,348,348,17,5,12,2,1
28,349,349,18,10,8,3,2
33,357,357,71,44,27,4,3
26,358,358,22,4,18,4,3
32,364,364,24,18,6,3,2
19,364,364,60,60,0,1,0
15,365,365,1,1,0,1,0
12,388,388,104,104,0,1,0
36,403,403,82,55,27,4,3
23,408,408,10,2,8,2,1
22,411,411,7,7,0,1,0
34,434,434,48,48,0,1,0
3,439,439,10,6,4,2,1
20,443,443,5,5,0,1,0
18,451,451,50,30,20,2,1
10,487,487,74,35,39,4,3

23,102,102,1,1,0,1,0
20,112,112,20,13,7,2,1
16,126,126,26,26,0,1,0
17,146,146,21,9,12,3,2
19,166,166,47,47,0,1,0
27,189,189,13,13,0,1,0
22,189,189,43,43,0,1,0
3,202,202,80,45,35,4,3
18,221,221,11,11,0,1,0
7,244,244,24,24,0,1,0
21,251,251,4,4,0,1,0
26,255,255,19,2,17,4,3
9,274,274,15,15,0,1,0
25,284,284,28,28,0,1,0
31,304,304,19,14,5,2,1
12,306,306,86,26,60,4,3
13,332,332,55,55,0,1,0
14,337,337,17,9,8,2,1
28,339,339,37,37,0,1,0
8,356,356,10,10,0,1,0
5,361,361,22,22,0,1,0
11,378,378,47,47,0,1,0
0,384,384,33,14,19,2,1
29,402,402,98,98,0,1,0
24,415,415,10,10,0,1,0
2,426,426,55,18,37,2,1
32,439,439,35,35,0,1,0
30,444,444,2,2,0,1,0
6,458,458,21,5,16,3,2
1,459,459,131,95,36,3,2
10,488,488,46,46,0,1,0
4,491,491,25,13,12,4,3
15,494,494,11,11,0,1,0

0,117,117,1,1,0,1,0
15,142,142,8,4,4,2,1
25,152,152,9,9,0,1,0
13,153,153,1,1,0,1,0
14,153,153,65,65,0,1,0
12,161,161,12,8,4,2,1
30,164,164,30,2,28,2,1
32,174,174,4,4,0,1,0
9,179,179,10,10,0,1,0
28,180,180,21,21,0,1,0
10,182,182,5,5,0,1,0
3,205,205,9,9,0,1,0
19,215,215,17,17,0,1,0
24,287,287,35,6,29,2,1
33,291,291,5,5,0,1,0
21,304,304,20,8,12,3,2
23,309,309,13,13,0,1,0
5,311,311,44,39,5,2,1
11,313,313,73,1,72,3,2
22,341,341,7,4,3,2,1
20,349,349,98,74,24,2,1
8,351,351,68,47,21,4,3
31,358,358,3,3,0,1,0
26,378,378,240,240,0,1,0
34,387,387,5,5,0,1,0
1,389,389,37,12,25,2,1
4,408,408,27,9,18,4,3
17,424,424,19,7,12,2,1
2,443,443,15,15,0,1,0
7,451,451,186,186,0,1,0
18,459,459,9,3,6,2,1
29,468,468,10,7,3,2,1
16,469,469,1,1,0,1,0
27,482,482,87,87,0,1,0
6,495,495,14,14,0,1,0

3,102,102,10,10,0,1,0
12,137,137,15,15,0,1,0
29,143,143,3,3,0,1,0
27,145,145,1,1,0,1,0
23,156,156,32,23,9,2,1
17,158,158,14,14,0,1,0
8,159,159,3,3,0,1,0
7,160,160,10,10,0,1,0
37,160,160,25,25,0,1,0
38,171,171,5,5,0,1,0
14,175,175,3,3,0,1,0
28,189,189,11,7,4,2,1
24,215,215,8,8,0,1,0
19,230,230,29,14,15,4,3
13,230,230,14,6,8,3,2
30,233,233,62,62,0,1,0
33,239,239,10,5,5,2,1
39,250,250,71,29,42,4,3
20,282,282,63,18,45,4,3
4,286,286,25,4,21,4,3
32,305,305,8,1,7,3,2
6,321,321,16,7,9,2,1
36,325,325,1,1,0,1,0
31,330,330,137,137,0,1,0
5,342,342,2,2,0,1,0
22,352,352,32,23,9,4,3
21,361,361,6,6,0,1,0
11,367,367,23,23,0,1,0
34,374,374,19,19,0,1,0
35,376,376,7,7,0,1,0
2,378,378,23,23,0,1,0
10,383,383,48,34,14,2,1
9,392,392,102,102,0,1,0
0,403,403,54,31,23,2,1
25,419,419,17,6,11,2,1
18,423,423,29,6,23,2,1
15,423,423,39,39,0,1,0
26,481,481,82,82,0,1,0
16,492,492,9,9,0,1,0
1,497,497,65,38,27,3,2

12,112,112,9,9,0,1,0
10,113,113,32,32,0,1,0
7,115,115,1,1,0,1,0
37,118,118,36,36,0,1,0
30,138,138,4,4,0,1,0
32,157,157,19,7,12,4,3
17,170,170,28,15,13,2,1
21,182,182,11,7,4,2,1
8,194,194,10,10,0,1,0
38,223,223,19,7,12,4,3
5,229,229,37,37,0,1,0
0,242,242,1,1,0,1,0
25,245,245,21,15,6,3,2
4,246,246,10,2,8,2,1
23,251,251,3,3,0,1,0
2,261,261,16,7,9,4,3
29,278,278,1,1,0,1,0
26,278,278,13,2,11,2,1
28,296,296,108,100,8,3,2
18,316,316,21,21,0,1,0
9,352,352,1,1,0,1,0
36,355,355,21,5,16,2,1
1,357,357,79,69,10,3,2
20,365,365,21,21,0,1,0
34,366,366,34,34,0,1,0
3,373,373,9,9,0,1,0
15,377,377,37,22,15,4,3
35,379,379,57,57,0,1,0
22,380,380,7,7,0,1,0
31,382,382,65,58,7,2,1
6,425,425,80,4,76,3,2
27,435,435,70,70,0,1,0
13,452,452,9,9,0,1,0
16,453,453,34,34,0,1,0
19,463,463,7,7,0,1,0
11,463,463,85,58,27,4,3
39,471,471,32,17,15,4,3
14,481,481,45,45,0,1,0
33,492,492,14,2,12,3,2
24,496,496,32,26,6,2,1

13,120,120,13,8,5,2,1
27,128,128,4,4,0,1,0
16,148,148,1,1,0,1,0
40,151,151,4,4,0,1,0
32,153,153,18,18,0,1,0
39,157,157,14,8,6,2,1
14,158,158,27,8,19,2,1
3,159,159,3,3,0,1,0
33,160,160,10,6,4,2,1
17,165,165,3,3,0,1,0
9,169,169,34,22,12,4,3
5,173,173,13,13,0,1,0
4,182,182,5,5,0,1,0
21,184,184,4,4,0,1,0
0,198,198,6,6,0,1,0
8,231,231,1,1,0,1,0
19,241,241,14,14,0,1,0
22,241,241,2,2,0,1,0
30,259,259,32,32,0,1,0
20,291,291,2,2,0,1,0
38,298,298,28,28,0,1,0
18,310,310,35,8,27,4,3
7,327,327,106,88,18,3,2
11,342,342,132,57,75,4,3
29,343,343,17,1,16,3,2
31,363,363,146,41,105,4,3
15,365,365,29,29,0,1,0
6,381,381,50,50,0,1,0
37,382,382,8,8,0,1,0
24,383,383,12,12,0,1,0
23,384,384,6,6,0,1,0
25,419,419,19,19,0,1,0
1,424,424,12,4,8,3,2
36,425,425,5,5,0,1,0
26,429,429,83,83,0,1,0
12,431,431,17,17,0,1,0
2,433,433,2,2,0,1,0
10,441,441,21,12,9,2,1
34,448,448,202,202,0,1,0
35,468,468,32,1,31,2,1
28,489,489,44,12,32,2,1

10,159,159,14,4,10,2,1
16,169,169,12,4,8,2,1
14,178,178,35,4,31,2,1
19,187,187,8,8,0,1,0
21,192,192,27,4,23,2,1
7,194,194,1,1,0,1,0
20,197,197,36,3,33,2,1
4,216,216,43,43,0,1,0
11,222,222,5,5,0,1,0
34,243,243,19,16,3,2,1
17,256,256,48,44,4,2,1
22,260,260,16,4,12,4,3
35,264,264,9,9,0,1,0
5,267,267,17,6,11,2,1
0,278,278,45,45,0,1,0
33,284,284,1,1,0,1,0
13,288,288,38,38,0,1,0
30,302,302,46,46,0,1,0
24,304,304,1,1,0,1,0
18,320,320,31,7,24,2,1
1,324,324,34,34,0,1,0
26,330,330,6,6,0,1,0
15,358,358,1,1,0,1,0
2,363,363,14,14,0,1,0
28,389,389,17,3,14,3,2
23,400,400,103,103,0,1,0
31,410,410,90,68,22,2,1
9,411,411,39,33,6,3,2
29,422,422,87,52,35,2,1
6,425,425,139,91,48,4,3
8,428,428,55,4,51,4,3
32,430,430,116,60,56,4,3
27,433,433,8,8,0,1,0
25,434,434,12,2,10,3,2
36,439,439,33,33,0,1,0
12,453,453,28,2,26,2,1
3,494,494,8,5,3,2,1

3,103,103,3,3,0,1,0
0,117,117,1,1,0,1,0
30,117,117,5,5,0,1,0
21,119,119,9,9,0,1,0
29,130,130,5,5,0,1,0
6,163,163,4,1,3,2,1
18,170,170,32,32,0,1,0
28,177,177,35,35,0,1,0
25,184,184,3,3,0,1,0
27,193,193,24,24,0,1,0
42,222,222,58,58,0,1,0
5,225,225,17,17,0,1,0
37,234,234,46,33,13,4,3
11,249,249,17,13,4,2,1
13,253,253,30,6,24,2,1
34,259,259,48,48,0,1,0
39,270,270,36,31,5,2,1
9,297,297,12,4,8,2,1
36,312,312,8,8,0,1,0
32,337,337,1,1,0,1,0
33,339,339,6,6,0,1,0
20,348,348,13,2,11,2,1
10,348,348,30,26,4,2,1
44,348,348,43,19,24,3,2
2,367,367,26,26,0,1,0
16,386,386,93,15,78,3,2
22,387,387,25,25,0,1,0
31,387,387,59,29,30,2,1
17,388,388,52,22,30,2,1
4,394,394,1,1,0,1,0
19,400,400,6,6,0,1,0
15,416,416,31,5,26,3,2
40,425,425,57,57,0,1,0
14,431,431,8,8,0,1,0
24,439,439,6,6,0,1,0
7,441,441,116,53,63,4,3
8,459,459,18,18,0,1,0
43,460,460,30,30,0,1,0
26,466,466,88,82,6,2,1
1,467,467,54,54,0,1,0
35,468,468,3,3,0,1,0
23,478,478,8,1,7,2,1
38,480,480,4,4,0,1,0
12,482,482,32,10,22,3,2
41,495,495,11,11,0,1,0

31,116,116,3,3,0,1,0
10,127,127,77,77,0,1,0
22,128,128,47,7,40,3,2
28,168,168,14,2,12,2,1
5,171,171,39,25,14,3,2
20,184,184,4,1,3,2,1
15,184,184,16,4,12,3,2
1,192,192,46,46,0,1,0
25,203,203,37,37,0,1,0
4,220,220,23,23,0,1,0
8,287,287,19,19,0,1,0
24,310,310,5,5,0,1,0
3,330,330,17,17,0,1,0
19,331,331,21,21,0,1,0
9,332,332,19,4,15,4,3
18,342,342,68,2,66,3,2
16,366,366,3,3,0,1,0
0,366,366,5,5,0,1,0
27,388,388,48,40,8,2,1
30,415,415,50,50,0,1,0
2,421,421,14,5,9,4,3
11,426,426,64,64,0,1,0
6,433,433,9,5,4,2,1
26,436,436,13,1,12,2,1
14,436,436,38,38,0,1,0
23,460,460,17,17,0,1,0
13,463,463,116,33,83,4,3
17,475,475,33,30,3,2,1
7,483,483,109,79,30,2,1
29,486,486,26,26,0,1,0
21,494,494,59,59,0,1,0
12,500,500,52,52,0,1,0

4,121,121,13,7,6,2,1
1,139,139,16,16,0,1,0
13,150,150,5,1,4,2,1
6,164,164,9,9,0,1,0
21,164,164,26,26,0,1,0
2,175,175,26,26,0,1,0
14,188,188,12,12,0,1,0
31,188,188,50,50,0,1,0
36,188,188,5,5,0,1,0
10,200,200,14,9,5,2,1
29,222,222,7,1,6,2,1
18,228,228,1,1,0,1,0
38,240,240,18,18,0,1,0
9,262,262,21,1,20,2,1
3,268,268,54,54,0,1,0
25,268,268,5,5,0,1,0
26,270,270,9,9,0,1,0
34,281,281,4,4,0,1,0
33,303,303,69,45,24,4,3
23,303,303,42,42,0,1,0
7,314,314,25,16,9,2,1
24,317,317,18,18,0,1,0
20,320,320,9,9,0,1,0
5,327,327,4,4,0,1,0
22,333,333,55,55,0,1,0
32,343,343,16,1,15,4,3
17,351,351,73,37,36,2,1
19,361,361,7,7,0,1,0
16,379,379,24,15,9,4,3
28,418,418,59,59,0,1,0
30,434,434,11,11,0,1,0
11,440,440,27,27,0,1,0
0,442,442,7,7,0,1,0
27,452,452,64,31,33,2,1
39,458,458,24,24,0,1,0
35,461,461,26,26,0,1,0
8,464,464,73,73,0,1,0
15,470,470,25,7,18,2,1
12,474,474,154,69,85,4,3
37,497,497,130,60,70,3,2

9,137,137,2,2,0,1,0
8,150,150,34,34,0,1,0
3,157,157,36,36,0,1,0
5,162,162,9,1,8,2,1
6,163,163,76,63,13,2,1
23,170,170,13,13,0,1,0
25,185,185,46,43,3,2,1
7,194,194,73,31,42,4,3
20,198,198,9,9,0,1,0
33,200,200,6,6,0,1,0
19,236,236,2,2,0,1,0
4,246,246,12,9,3,2,1
26,317,317,9,9,0,1,0
2,319,319,7,4,3,2,1
11,333,333,21,21,0,1,0
12,335,335,32,24,8,3,2
16,343,343,53,46,7,2,1
13,375,375,29,29,0,1,0
24,377,377,14,14,0,1,0
17,380,380,11,5,6,2,1
0,384,384,20,20,0,1,0
30,388,388,121,76,45,4,3
21,393,393,63,3,60,3,2
14,394,394,18,2,16,3,2
28,396,396,115,29,86,3,2
10,420,420,42,31,11,2,1
32,455,455,53,9,44,3,2
27,458,458,28,10,18,2,1
15,459,459,24,24,0,1,0
18,462,462,21,21,0,1,0
1,462,462,13,13,0,1,0
31,475,475,43,11,32,3,2
29,484,484,19,2,17,2,1
22,488,488,50,40,10,3,2

32,104,104,1,1,0,1,0
6,108,108,1,1,0,1,0
14,111,111,1,1,0,1,0
20,126,126,22,22,0,1,0
3,127,127,6,6,0,1,0
10,135,135,14,14,0,1,0
36,139,139,36,18,18,2,1
9,141,141,8,8,0,1,0
25,176,176,23,14,9,2,1
13,201,201,17,17,0,1,0
35,202,202,2,2,0,1,0
24,215,215,8,8,0,1,0
19,241,241,1,1,0,1,0
29,245,245,2,2,0,1,0
30,270,270,18,18,0,1,0
16,274,274,50,2,48,4,3
4,277,277,30,17,13,2,1
7,280,280,40,40,0,1,0
2,288,288,20,6,14,2,1
23,295,295,45,45,0,1,0
31,296,296,12,2,10,2,1
0,303,303,1,1,0,1,0
8,303,303,54,54,0,1,0
21,317,317,21,21,0,1,0
17,319,319,1,1,0,1,0
22,329,329,17,17,0,1,0
12,355,355,43,43,0,1,0
26,357,357,81,54,27,4,3
28,359,359,19,1,18,3,2
34,385,385,33,2,31,2,1
1,394,394,54,24,30,3,2
11,395,395,115,115,0,1,0
37,399,399,112,82,30,3,2
38,423,423,83,83,0,1,0
33,434,434,30,2,28,3,2
5,447,447,79,34,45,3,2
15,448,448,29,29,0,1,0
27,451,451,9,9,0,1,0
18,499,499,55,55,0,1,0

18,110,110,6,6,0,1,0
19,111,111,17,5,12,2,1
14,121,121,8,2,6,2,1
13,131,131,17,12,5,2,1
29,138,138,9,9,0,1,0
27,142,142,5,5,0,1,0
2,151,151,16,16,0,1,0
8,157,157,18,13,5,2,1
11,168,168,1,1,0,1,0
28,178,178,12,12,0,1,0
3,184,184,15,15,0,1,0
4,193,193,18,18,0,1,0
24,209,209,58,10,48,2,1
17,223,223,44,44,0,1,0
20,229,229,2,2,0,1,0
23,232,232,25,21,4,2,1
10,243,243,131,101,30,4,3
26,257,257,67,67,0,1,0
25,257,257,14,14,0,1,0
7,276,276,2,2,0,1,0
30,277,277,27,3,24,2,1
12,306,306,85,85,0,1,0
9,321,321,18,9,9,2,1
0,337,337,28,28,0,1,0
31,344,344,21,21,0,1,0
32,389,389,74,74,0,1,0
22,421,421,41,11,30,3,2
5,421,421,4,4,0,1,0
16,442,442,21,21,0,1,0
1,456,456,9,9,0,1,0
21,458,458,11,11,0,1,0
6,467,467,177,87,90,4,3
15,500,500,41,23,18,4,3

21,107,107,14,2,12,2,1
31,114,114,6,6,0,1,0
2,115,115,21,21,0,1,0
17,121,121,1,1,0,1,0
40,143,143,10,10,0,1,0
42,145,145,5,5,0,1,0
22,172,172,15,15,0,1,0
6,180,180,28,28,0,1,0
12,190,190,12,5,7,2,1
41,192,192,4,4,0,1,0
23,196,196,24,24,0,1,0
14,204,204,2,2,0,1,0
24,207,207,2,2,0,1,0
35,251,251,6,6,0,1,0
25,258,258,3,3,0,1,0
36,261,261,64,42,22,2,1
38,267,267,21,21,0,1,0
10,282,282,27,7,20,4,3
39,285,285,2,2,0,1,0
5,291,291,17,17,0,1,0
9,296,296,1,1,0,1,0
16,309,309,3,3,0,1,0
3,320,320,72,33,39,2,1
11,325,325,14,14,0,1,0
28,333,333,30,14,16,3,2
15,334,334,33,12,21,4,3
44,337,337,2,2,0,1,0
1,374,374,1,1,0,1,0
19,379,379,6,3,3,2,1
26,383,383,32,14,18,3,2
33,388,388,4,4,0,1,0
43,396,396,232,232,0,1,0
18,402,402,69,1,68,4,3
29,403,403,7,7,0,1,0
34,411,411,121,43,78,4,3
7,416,416,12,12,0,1,0
37,417,417,9,9,0,1,0
20,417,417,22,16,6,3,2
27,419,419,67,64,3,2,1
0,420,420,77,77,0,1,0
30,427,427,11,3,8,2,1
8,461,461,54,54,0,1,0
13,465,465,5,5,0,1,0
32,482,482,51,51,0,1,0
4,484,484,2,2,0,1,0

26,120,120,7,7,0,1,0
30,140,140,9,9,0,1,0
0,143,143,12,12,0,1,0
5,148,148,9,5,4,2,1
11,156,156,3,3,0,1,0
39,168,168,8,8,0,1,0
35,172,172,48,48,0,1,0
36,173,173,9,1,8,3,2
25,183,183,7,2,5,2,1
14,198,198,1,1,0,1,0
19,204,204,5,1,4,2,1
40,211,211,17,4,13,2,1
17,216,216,6,6,0,1,0
27,217,217,53,53,0,1,0
16,220,220,25,3,22,3,2
37,225,225,18,10,8,2,1
24,236,236,22,10,12,2,1
29,242,242,70,70,0,1,0
13,260,260,4,4,0,1,0
34,268,268,1,1,0,1,0
2,274,274,9,9,0,1,0
22,279,279,21,13,8,3,2
6,310,310,41,41,0,1,0
38,324,324,46,46,0,1,0
15,334,334,22,8,14,3,2
4,339,339,11,11,0,1,0
32,347,347,50,36,14,3,2
18,357,357,101,101,0,1,0
28,381,381,25,17,8,2,1
31,389,389,51,51,0,1,0
12,399,399,8,2,6,2,1
8,404,404,16,10,6,2,1
21,412,412,32,32,0,1,0
1,423,423,26,10,16,3,2
7,424,424,64,19,45,2,1
9,431,431,28,12,16,2,1
23,437,437,20,20,0,1,0
20,458,458,117,108,9,4,3
10,464,464,102,102,0,1,0
33,474,474,2,2,0,1,0
3,483,483,55,55,0,1,0

43,101,101,6,6,0,1,0
36,118,118,28,28,0,1,0
22,119,119,20,2,18,3,2
44,132,132,15,3,12,3,2
11,142,142,1,1,0,1,0
40,145,145,32,32,0,1,0
25,147,147,5,5,0,1,0
0,148,148,1,1,0,1,0
17,161,161,8,8,0,1,0
31,171,171,2,2,0,1,0
1,176,176,3,3,0,1,0
19,193,193,35,9,26,4,3
2,206,206,13,13,0,1,0
5,209,209,5,5,0,1,0
9,212,212,22,22,0,1,0
35,220,220,29,21,8,3,2
23,232,232,10,10,0,1,0
21,232,232,7,4,3,2,1
15,246,246,3,3,0,1,0
29,298,298,21,9,12,4,3
38,305,305,4,4,0,1,0
10,314,314,93,8,85,4,3
3,329,329,52,30,22,3,2
34,346,346,1,1,0,1,0
18,351,351,31,8,23,2,1
16,356,356,48,30,18,2,1
7,366,366,3,3,0,1,0
14,371,371,29,19,10,3,2
4,380,380,9,3,6,2,1
26,384,384,9,9,0,1,0
33,396,396,23,1,22,2,1
24,399,399,29,29,0,1,0
41,412,412,41,5,36,2,1
32,424,424,52,25,27,4,3
37,427,427,169,93,76,4,3
8,429,429,1,1,0,1,0
6,443,443,103,17,86,4,3
42,446,446,60,60,0,1,0
13,451,451,10,10,0,1,0
12,455,455,2,2,0,1,0
39,456,456,22,10,12,3,2
27,461,461,8,2,6,3,2
28,483,483,40,40,0,1,0
30,490,490,47,16,31,2,1
20,496,496,19,19,0,1,0

37,119,119,11,8,3,2,1
19,143,143,1,1,0,1,0
4,144,144,19,19,0,1,0
11,147,147,24,9,15,4,3
35,152,152,10,2,8,3,2
13,173,173,30,3,27,4,3
0,189,189,1,1,0,1,0
2,198,198,7,4,3,2,1
25,199,199,12,3,9,4,3
20,207,207,11,2,9,4,3
22,212,212,10,10,0,1,0
26,214,214,7,7,0,1,0
10,218,218,38,15,23,2,1
28,221,221,3,3,0,1,0
1,222,222,1,1,0,1,0
27,224,224,8,2,6,3,2
12,225,225,23,23,0,1,0
9,239,239,31,1,30,4,3
33,243,243,4,4,0,1,0
8,254,254,54,12,42,4,3
7,265,265,1,1,0,1,0
21,268,268,22,22,0,1,0
16,269,269,89,63,26,2,1
15,292,292,1,1,0,1,0
6,303,303,40,14,26,3,2
30,306,306,28,20,8,3,2
29,327,327,47,26,21,2,1
24,364,364,3,3,0,1,0
34,368,368,177,125,52,3,2
5,384,384,21,21,0,1,0
17,390,390,6,6,0,1,0
36,398,398,19,11,8,2,1
38,410,410,118,40,78,3,2
18,416,416,59,19,40,4,3
23,418,418,131,70,61,4,3
3,443,443,36,27,9,2,1
31,469,469,28,28,0,1,0
32,495,495,5,2,3,2,1
14,496,496,2,2,0,1,0

28,134,134,12,12,0,1,0
29,139,139,6,6,0,1,0
33,140,140,2,2,0,1,0
12,145,145,29,29,0,1,0
9,147,147,3,3,0,1,0
10,148,148,1,1,0,1,0
8,169,169,6,6,0,1,0
25,179,179,9,2,7,2,1
22,196,196,1,1,0,1,0
6,200,200,3,3,0,1,0
3,210,210,38,38,0,1,0
18,236,236,5,5,0,1,0
2,243,243,34,34,0,1,0
26,248,248,23,23,0,1,0
30,254,254,4,4,0,1,0
19,259,259,22,2,20,2,1
38,292,292,72,26,46,3,2
35,298,298,4,1,3,2,1
20,320,320,10,2,8,3,2
1,327,327,10,6,4,2,1
42,344,344,23,10,13,2,1
16,357,357,31,31,0,1,0
39,358,358,38,17,21,4,3
14,359,359,3,3,0,1,0
24,364,364,20,11,9,2,1
36,377,377,27,27,0,1,0
40,389,389,12,12,0,1,0
0,395,395,7,3,4,2,1
11,397,397,33,33,0,1,0
31,400,400,13,10,3,2,1
7,402,402,14,14,0,1,0
34,405,405,148,100,48,4,3
27,419,419,22,8,14,2,1
15,419,419,69,33,36,2,1
37,425,425,139,139,0,1,0
4,433,433,77,31,46,2,1
41,436,436,1,1,0,1,0
13,444,444,20,20,0,1,0
17,464,464,70,1,69,4,3
5,483,483,29,5,24,2,1
32,484,484,127,99,28,2,1
21,486,486,113,67,46,4,3
23,490,490,33,11,22,3,2

5,119,119,10,10,0,1,0
0,121,121,1,1,0,1,0
15,169,169,33,4,29,4,3
13,185,185,23,23,0,1,0
21,209,209,20,20,0,1,0
7,211,211,28,13,15,4,3
28,230,230,88,88,0,1,0
4,231,231,28,28,0,1,0
17,235,235,14,14,0,1,0
8,259,259,6,6,0,1,0
25,263,263,16,16,0,1,0
34,292,292,18,4,14,2,1
3,298,298,2,2,0,1,0
12,313,313,38,16,22,3,2
32,315,315,69,69,0,1,0
2,322,322,29,19,10,2,1
6,335,335,13,3,10,3,2
27,344,344,36,10,26,2,1
14,344,344,1,1,0,1,0
22,362,362,6,6,0,1,0
35,367,367,10,10,0,1,0
9,369,369,124,124,0,1,0
18,380,380,15,15,0,1,0
16,380,380,91,10,81,3,2
30,385,385,5,5,0,1,0
1,385,385,45,45,0,1,0
23,403,403,17,8,9,2,1
26,416,416,83,83,0,1,0
24,419,419,39,15,24,3,2
11,445,445,89,39,50,2,1
10,457,457,27,16,11,2,1
31,460,460,7,7,0,1,0
29,467,467,14,14,0,1,0
33,479,479,24,24,0,1,0
20,486,486,149,87,62,4,3
19,500,500,56,56,0,1,0

10,135,135,1,1,0,1,0
13,177,177,89,44,45,3,2
2,183,183,12,2,10,2,1
27,197,197,6,6,0,1,0
12,201,201,24,24,0,1,0
14,202,202,13,13,0,1,0
26,224,224,3,3,0,1,0
23,245,245,11,11,0,1,0
28,246,246,22,2,20,3,2
15,249,249,13,5,8,2,1
6,260,260,136,52,84,4,3
5,270,270,26,13,13,2,1
0,274,274,97,97,0,1,0
3,285,285,86,14,72,4,3
7,285,285,1,1,0,1,0
17,298,298,32,32,0,1,0
24,305,305,56,56,0,1,0
25,321,321,59,59,0,1,0
16,330,330,25,17,8,2,1
19,340,340,25,25,0,1,0
21,352,352,56,56,0,1,0
4,365,365,31,31,0,1,0
11,370,370,4,1,3,2,1
18,373,373,17,4,13,2,1
9,382,382,86,86,0,1,0
1,404,404,82,27,55,3,2
8,444,444,20,14,6,2,1
20,473,473,32,26,6,3,2
22,493,493,55,51,4,2,1

2,101,101,1,1,0,1,0
16,117,117,22,4,18,4,3
19,133,133,10,10,0,1,0
10,134,134,4,4,0,1,0
31,134,134,39,20,19,2,1
7,137,137,8,8,0,1,0
26,148,148,2,2,0,1,0
13,154,154,7,4,3,2,1
36,165,165,15,1,14,2,1
20,175,175,23,11,12,3,2
18,200,200,20,20,0,1,0
0,205,205,9,2,7,3,2
24,217,217,13,13,0,1,0
6,218,218,16,16,0,1,0
32,232,232,9,9,0,1,0
33,248,248,24,2,22,3,2
30,248,248,83,29,54,3,2
12,262,262,95,95,0,1,0
11,285,285,5,5,0,1,0
28,294,294,24,24,0,1,0
9,303,303,115,25,90,3,2
17,320,320,3,3,0,1,0
15,323,323,72,31,41,2,1
29,372,372,12,7,5,2,1
25,376,376,13,5,8,2,1
5,378,378,27,9,18,4,3
22,395,395,26,26,0,1,0
14,397,397,5,5,0,1,0
23,405,405,82,58,24,2,1
1,406,406,27,19,8,2,1
21,414,414,92,39,53,4,3
3,442,442,25,7,18,4,3
27,458,458,14,4,10,3,2
34,466,466,12,2,10,3,2
8,474,474,22,2,20,2,1
35,486,486,8,1,7,2,1
4,500,500,104,100,4,2,1

37,104,104,10,10,0,1,0
14,118,118,14,14,0,1,0
42,146,146,4,1,3,2,1
38,146,146,19,10,9,2,1
0,175,175,4,4,0,1,0
25,182,182,6,2,4,2,1
19,189,189,14,14,0,1,0
35,192,192,45,13,32,4,3
18,205,205,4,4,0,1,0
15,213,213,14,14,0,1,0
21,230,230,8,8,0,1,0
43,231,231,6,2,4,2,1
40,242,242,12,12,0,1,0
2,242,242,16,16,0,1,0
26,257,257,63,63,0,1,0
39,293,293,27,27,0,1,0
11,298,298,2,2,0,1,0
12,319,319,25,3,22,2,1
30,322,322,55,8,47,2,1
7,331,331,32,24,8,3,2
10,333,333,2,2,0,1,0
4,365,365,65,18,47,4,3
29,368,368,26,2,24,2,1
5,384,384,10,10,0,1,0
28,393,393,28,11,17,2,1
9,394,394,44,44,0,1,0
27,404,404,36,6,30,2,1
24,416,416,3,3,0,1,0
3,426,426,39,39,0,1,0
20,427,427,28,28,0,1,0
6,427,427,1,1,0,1,0
22,432,432,17,17,0,1,0
23,433,433,123,52,71,4,3
31,435,435,75,26,49,2,1
41,453,453,50,50,0,1,0
8,463,463,22,13,9,4,3
13,463,463,13,2,11,2,1
36,464,464,5,5,0,1,0
1,464,464,146,146,0,1,0
32,469,469,4,4,0,1,0
17,477,477,8,8,0,1,0
44,484,484,51,18,33,2,1
34,494,494,27,27,0,1,0
16,494,494,32,32,0,1,0
33,496,496,85,36,49,4,3

16,104,104,30,4,26,4,3
19,111,111,5,5,0,1,0
7,133,133,16,6,10,3,2
24,153,153,37,37,0,1,0
25,170,170,30,6,24,3,2
3,200,200,1,1,0,1,0
6,207,207,4,4,0,1,0
0,219,219,6,2,4,2,1
35,241,241,50,50,0,1,0
26,244,244,28,10,18,4,3
8,252,252,15,9,6,3,2
10,260,260,1,1,0,1,0
2,263,263,80,54,26,2,1
18,266,266,7,4,3,2,1
22,275,275,12,12,0,1,0
33,276,276,9,3,6,2,1
32,282,282,31,23,8,2,1
13,308,308,56,35,21,2,1
12,333,333,27,22,5,2,1
23,347,347,7,1,6,2,1
29,351,351,72,23,49,3,2
1,353,353,48,48,0,1,0
4,366,366,75,70,5,2,1
15,397,397,33,5,28,3,2
20,401,401,24,24,0,1,0
34,401,401,92,92,0,1,0
11,402,402,47,47,0,1,0
14,414,414,90,90,0,1,0
28,419,419,57,33,24,4,3
27,424,424,28,6,22,2,1
17,429,429,23,2,21,4,3
31,445,445,16,16,0,1,0
9,449,449,5,5,0,1,0
5,488,488,23,15,8,2,1
21,491,491,17,11,6,3,2
30,500,500,43,43,0,1,0

25,103,103,7,7,0,1,0
7,123,123,22,22,0,1,0
14,129,129,6,1,5,2,1
30,134,134,5,1,4,2,1
24,142,142,23,16,7,2,1
31,163,163,4,4,0,1,0
19,177,177,3,3,0,1,0
28,197,197,17,17,0,1,0
16,216,216,48,24,24,2,1
36,263,263,11,8,3,2,1
23,267,267,27,27,0,1,0
10,274,274,14,6,8,3,2
27,280,280,10,4,6,3,2
21,281,281,36,11,25,4,3
15,295,295,8,2,6,2,1
29,326,326,16,8,8,2,1
20,329,329,10,10,0,1,0
1,339,339,22,22,0,1,0
38,355,355,150,139,11,2,1
13,356,356,3,3,0,1,0
32,378,378,15,15,0,1,0
5,382,382,34,34,0,1,0
9,389,389,110,110,0,1,0
3,399,399,50,15,35,2,1
35,402,402,89,63,26,2,1
22,404,404,2,2,0,1,0
33,405,405,71,17,54,3,2
8,405,405,81,61,20,3,2
37,424,424,38,17,21,2,1
34,426,426,16,4,12,4,3
17,444,444,15,4,11,2,1
26,445,445,67,67,0,1,0
39,449,449,28,6,22,3,2
18,450,450,31,9,22,3,2
11,462,462,1,1,0,1,0
2,463,463,16,16,0,1,0
6,469,469,23,23,0,1,0
12,477,477,52,28,24,3,2
0,497,497,63,55,8,2,1
4,500,500,67,41,26,3,2

3,104,104,1,1,0,1,0
30,123,123,9,9,0,1,0
26,145,145,8,8,0,1,0
29,152,152,19,13,6,2,1
4,153,153,12,12,0,1,0
36,158,158,2,2,0,1,0
14,191,191,1,1,0,1,0
15,196,196,79,70,9,4,3
9,212,212,7,1,6,3,2
35,213,213,91,67,24,4,3
42,225,225,14,14,0,1,0
34,225,225,3,3,0,1,0
20,235,235,25,6,19,3,2
28,235,235,6,6,0,1,0
19,246,246,3,3,0,1,0
41,248,248,4,4,0,1,0
7,251,251,38,38,0,1,0
24,253,253,5,5,0,1,0
43,258,258,7,7,0,1,0
2,266,266,3,3,0,1,0
31,267,267,47,47,0,1,0
8,269,269,36,36,0,1,0
10,275,275,14,4,10,3,2
22,298,298,39,17,22,2,1
1,321,321,1,1,0,1,0
27,324,324,84,55,29,4,3
11,326,326,3,3,0,1,0
25,342,342,23,18,5,2,1
40,353,353,43,19,24,2,1
39,378,378,19,3,16,3,2
23,401,401,39,12,27,2,1
38,404,404,12,2,10,3,2
17,410,410,2,2,0,1,0
0,413,413,13,13,0,1,0
32,419,419,133,45,88,4,3
37,428,428,29,29,0,1,0
18,429,429,5,5,0,1,0
13,449,449,16,16,0,1,0
33,455,455,7,1,6,3,2
16,463,463,148,133,15,2,1
6,473,473,9,9,0,1,0
12,478,478,33,25,8,3,2
5,483,483,72,25,47,2,1
21,487,487,3,3,0,1,0

35,103,103,14,2,12,2,1
4,121,121,8,8,0,1,0
2,121,121,15,15,0,1,0
39,122,122,9,3,6,2,1
30,130,130,3,3,0,1,0
11,148,148,1,1,0,1,0
22,156,156,8,8,0,1,0
23,169,169,24,16,8,3,2
17,170,170,5,5,0,1,0
29,171,171,44,44,0,1,0
38,172,172,9,9,0,1,0
14,175,175,16,3,13,3,2
34,183,183,2,2,0,1,0
26,193,193,22,22,0,1,0
7,195,195,26,26,0,1,0
20,220,220,52,8,44,3,2
15,226,226,33,14,19,2,1
10,230,230,3,3,0,1,0
21,258,258,11,11,0,1,0
32,281,281,71,71,0,1,0
28,283,283,15,15,0,1,0
12,299,299,13,1,12,4,3
33,317,317,1,1,0,1,0
25,326,326,16,16,0,1,0
5,340,340,64,7,57,4,3
19,349,349,36,36,0,1,0
6,354,354,46,46,0,1,0
40,361,361,74,41,33,2,1
41,375,375,25,5,20,3,2
9,381,381,47,47,0,1,0
0,384,384,8,8,0,1,0
1,389,389,14,6,8,3,2
36,403,403,64,64,0,1,0
8,424,424,55,25,30,3,2
18,428,428,26,10,16,3,2
27,433,433,24,5,19,2,1
37,455,455,98,71,27,4,3
31,456,456,18,2,16,2,1
13,461,461,7,7,0,1,0
16,464,464,11,11,0,1,0
24,495,495,18,4,14,2,1
3,500,500,45,45,0,1,0

22,102,102,22,6,16,3,2
11,105,105,3,3,0,1,0
31,108,108,6,1,5,2,1
2,110,110,6,6,0,1,0
14,116,116,1,1,0,1,0
34,119,119,3,3,0,1,0
19,126,126,1,1,0,1,0
1,134,134,11,7,4,2,1
21,138,138,12,4,8,2,1
36,142,142,7,7,0,1,0
17,149,149,13,13,0,1,0
33,155,155,19,6,13,2,1
35,166,166,12,4,8,2,1
0,169,169,1,1,0,1,0
26,184,184,6,6,0,1,0
28,194,194,20,5,15,4,3
3,196,196,37,6,31,2,1
23,205,205,60,60,0,1,0
38,212,212,17,7,10,2,1
4,220,220,56,56,0,1,0
18,220,220,37,13,24,2,1
37,229,229,25,25,0,1,0
16,231,231,6,1,5,2,1
39,240,240,56,23,33,4,3
5,246,246,27,4,23,2,1
29,253,253,1,1,0,1,0
7,257,257,1,1,0,1,0
13,258,258,23,11,12,2,1
20,262,262,43,18,25,3,2
30,272,272,13,5,8,2,1
8,309,309,16,16,0,1,0
32,323,323,26,5,21,2,1
10,363,363,4,4,0,1,0
27,368,368,73,73,0,1,0
12,401,401,8,8,0,1,0
6,424,424,215,203,12,4,3
9,432,432,14,14,0,1,0
24,458,458,20,4,16,2,1
15,484,484,1,1,0,1,0
25,498,498,47,47,0,1,0

14,100,100,29,29,0,1,0
23,150,150,8,8,0,1,0
17,151,151,10,10,0,1,0
32,153,153,19,19,0,1,0
18,168,168,1,1,0,1,0
16,171,171,10,10,0,1,0
3,179,179,2,2,0,1,0
12,216,216,19,5,14,2,1
11,252,252,71,14,57,4,3
22,261,261,47,47,0,1,0
26,263,263,9,9,0,1,0
5,263,263,40,40,0,1,0
15,271,271,40,10,30,2,1
24,294,294,1,1,0,1,0
21,336,336,31,2,29,2,1
29,338,338,122,122,0,1,0
10,350,350,13,2,11,3,2
6,353,353,27,18,9,2,1
9,355,355,10,6,4,2,1
30,359,359,26,4,22,3,2
33,378,378,44,24,20,3,2
19,379,379,53,33,20,2,1
4,387,387,23,5,18,3,2
2,396,396,3,3,0,1,0
20,397,397,70,57,13,2,1
25,405,405,8,8,0,1,0
28,416,416,91,49,42,3,2
31,441,441,15,9,6,2,1
8,442,442,17,3,14,2,1
7,446,446,173,88,85,4,3
0,474,474,17,17,0,1,0
13,477,477,116,103,13,2,1
1,485,485,9,9,0,1,0
27,488,488,76,40,36,4,3
34,493,493,9,9,0,1,0

3,102,102,12,2,10,3,2
19,119,119,10,10,0,1,0
4,123,123,7,1,6,2,1
13,125,125,10,10,0,1,0
29,127,127,1,1,0,1,0
24,138,138,8,8,0,1,0
12,138,138,25,21,4,2,1
14,141,141,10,5,5,2,1
23,147,147,12,9,3,2,1
28,155,155,7,1,6,2,1
9,165,165,10,10,0,1,0
0,175,175,16,8,8,2,1
21,194,194,42,12,30,4,3
17,199,199,3,3,0,1,0
18,205,205,41,41,0,1,0
31,220,220,3,3,0,1,0
35,221,221,36,36,0,1,0
36,233,233,73,60,13,2,1
30,259,259,15,3,12,3,2
33,287,287,45,9,36,4,3
11,297,297,12,12,0,1,0
27,300,300,28,14,14,2,1
37,306,306,7,7,0,1,0
16,321,321,111,44,67,3,2
1,325,325,5,1,4,2,1
2,327,327,31,17,14,2,1
22,336,336,32,2,30,4,3
7,353,353,25,17,8,2,1
34,364,364,10,10,0,1,0
10,399,399,21,21,0,1,0
5,429,429,40,40,0,1,0
25,437,437,148,90,58,4,3
26,438,438,47,33,14,2,1
8,445,445,42,9,33,2,1
6,450,450,73,9,64,4,3
20,455,455,27,1,26,3,2
15,471,471,27,27,0,1,0
32,471,471,1,1,0,1,0

10,103,103,5,5,0,1,0
17,106,106,13,1,12,4,3
26,106,106,13,13,0,1,0
6,125,125,24,24,0,1,0
18,142,142,3,3,0,1,0
9,145,145,8,1,7,2,1
28,155,155,23,10,13,2,1
12,159,159,9,4,5,2,1
22,169,169,8,8,0,1,0
13,174,174,23,9,14,3,2
31,179,179,3,3,0,1,0
4,226,226,2,2,0,1,0
25,231,231,35,6,29,2,1
23,252,252,9,9,0,1,0
3,260,260,38,15,23,4,3
14,261,261,12,12,0,1,0
20,270,270,1,1,0,1,0
35,271,271,53,53,0,1,0
11,280,280,96,70,26,4,3
0,286,286,15,7,8,2,1
2,309,309,4,1,3,2,1
15,330,330,7,7,0,1,0
1,334,334,21,7,14,3,2
5,338,338,30,13,17,2,1
33,360,360,27,27,0,1,0
27,364,364,14,9,5,2,1
21,367,367,12,3,9,2,1
8,369,369,1,1,0,1,0
37,373,373,183,90,93,4,3
30,375,375,87,87,0,1,0
19,380,380,6,6,0,1,0
38,386,386,45,45,0,1,0
36,419,419,30,30,0,1,0
29,427,427,19,3,16,3,2
34,434,434,2,2,0,1,0
32,453,453,11,5,6,2,1
24,461,461,36,12,24,3,2
16,471,471,34,34,0,1,0
7,472,472,189,189,0,1,0

9,101,101,8,8,0,1,0
21,106,106,34,34,0,1,0
35,133,133,2,2,0,1,0
18,137,137,13,8,5,2,1
30,163,163,6,6,0,1,0
24,190,190,21,21,0,1,0
13,191,191,1,1,0,1,0
3,195,195,7,7,0,1,0
8,212,212,12,1,11,3,2
7,241,241,59,59,0,1,0
32,246,246,37,37,0,1,0
27,251,251,2,2,0,1,0
28,261,261,8,3,5,2,1
19,265,265,13,13,0,1,0
22,267,267,8,8,0,1,0
10,269,269,26,26,0,1,0
39,278,278,5,5,0,1,0
15,287,287,11,11,0,1,0
33,292,292,29,29,0,1,0
36,296,296,9,3,6,2,1
2,300,300,27,27,0,1,0
17,304,304,33,33,0,1,0
14,310,310,34,34,0,1,0
4,338,338,22,22,0,1,0
38,339,339,67,67,0,1,0
5,344,344,12,12,0,1,0
11,346,346,25,25,0,1,0
29,350,350,102,102,0,1,0
34,362,362,85,10,75,4,3
37,391,391,88,54,34,2,1
31,392,392,7,1,6,2,1
1,398,398,2,2,0,1,0
20,402,402,44,12,32,2,1
23,431,431,35,35,0,1,0
12,465,465,186,130,56,3,2
26,474,474,17,9,8,2,1
25,479,479,2,2,0,1,0
6,492,492,78,78,0,1,0
0,493,493,9,3,6,2,1
16,497,497,14,11,3,2,1

2,113,113,1,1,0,1,0
13,118,118,5,2,3,2,1
39,121,121,4,1,3,2,1
18,123,123,8,8,0,1,0
9,131,131,3,3,0,1,0
8,134,134,15,9,6,3,2
5,164,164,4,4,0,1,0
6,168,168,3,3,0,1,0
26,210,210,26,26,0,1,0
22,210,210,26,8,18,3,2
41,214,214,13,5,8,2,1
42,218,218,74,44,30,4,3
34,222,222,32,17,15,4,3
11,224,224,20,6,14,2,1
38,233,233,10,10,0,1,0
0,241,241,1,1,0,1,0
4,244,244,105,6,99,4,3
7,273,273,39,15,24,3,2
20,285,285,15,15,0,1,0
36,285,285,28,10,18,2,1
28,291,291,3,3,0,1,0
32,298,298,25,9,16,2,1
24,306,306,25,25,0,1,0
43,311,311,36,2,34,2,1
33,318,318,31,31,0,1,0
29,321,321,28,8,20,2,1
19,323,323,33,20,13,2,1
12,329,329,20,12,8,2,1
15,337,337,2,2,0,1,0
40,342,342,59,33,26,3,2
10,346,346,66,66,0,1,0
1,352,352,16,16,0,1,0
37,360,360,26,16,10,3,2
31,360,360,37,37,0,1,0
27,379,379,42,38,4,2,1
14,411,411,11,3,8,3,2
21,428,428,6,6,0,1,0
35,440,440,19,7,12,4,3
30,468,468,21,13,8,3,2
23,471,471,1,1,0,1,0
16,472,472,31,31,0,1,0
3,474,474,47,13,34,3,2
17,475,475,33,19,14,2,1
25,488,488,72,72,0,1,0

18,123,123,4,4,0,1,0
8,126,126,11,11,0,1,0
2,148,148,6,6,0,1,0
10,169,169,1,1,0,1,0
32,178,178,15,15,0,1,0
15,179,179,8,5,3,2,1
27,185,185,5,5,0,1,0
16,195,195,35,6,29,3,2
21,202,202,16,16,0,1,0
22,216,216,5,5,0,1,0
5,221,221,16,16,0,1,0
25,224,224,7,7,0,1,0
24,230,230,50,50,0,1,0
4,232,232,55,55,0,1,0
36,232,232,29,29,0,1,0
30,237,237,2,2,0,1,0
26,244,244,1,1,0,1,0
12,244,244,4,1,3,2,1
0,290,290,6,6,0,1,0
23,308,308,18,18,0,1,0
19,315,315,43,27,16,2,1
1,331,331,47,47,0,1,0
6,332,332,65,53,12,4,3
7,342,342,21,21,0,1,0
3,351,351,4,4,0,1,0
33,371,371,62,2,60,3,2
37,377,377,19,16,3,2,1
20,381,381,37,11,26,4,3
38,393,393,135,51,84,4,3
29,394,394,83,59,24,3,2
34,417,417,41,41,0,1,0
35,419,419,92,10,82,4,3
13,449,449,23,23,0,1,0
17,460,460,112,112,0,1,0
11,462,462,71,43,28,4,3
9,466,466,14,1,13,2,1
14,480,480,66,19,47,4,3
31,492,492,22,6,16,2,1
28,494,494,23,23,0,1,0

37,112,112,4,4,0,1,0
0,122,122,4,4,0,1,0
25,122,122,3,3,0,1,0
6,135,135,24,13,11,2,1
35,146,146,19,19,0,1,0
18,147,147,8,5,3,2,1
29,153,153,44,35,9,2,1
10,171,171,26,26,0,1,0
19,172,172,33,33,0,1,0
4,174,174,32,12,20,2,1
38,175,175,51,39,12,4,3
2,184,184,1,1,0,1,0
31,186,186,28,28,0,1,0
33,187,187,36,11,25,2,1
28,210,210,7,7,0,1,0
7,214,214,60,60,0,1,0
13,237,237,23,23,0,1,0
21,251,251,33,9,24,2,1
32,259,259,18,18,0,1,0
30,260,260,1,1,0,1,0
17,270,270,8,8,0,1,0
34,277,277,11,1,10,2,1
23,279,279,37,32,5,2,1
12,307,307,7,7,0,1,0
15,321,321,6,3,3,2,1
3,337,337,1,1,0,1,0
20,369,369,24,24,0,1,0
11,400,400,26,10,16,3,2
1,402,402,7,1,6,3,2
27,407,407,19,3,16,3,2
24,410,410,16,16,0,1,0
36,412,412,35,15,20,3,2
26,417,417,79,79,0,1,0
5,435,435,59,59,0,1,0
22,436,436,1,1,0,1,0
9,450,450,87,2,85,4,3
8,451,451,73,73,0,1,0
14,454,454,32,14,18,2,1
16,460,460,4,4,0,1,0

35,120,120,1,1,0,1,0
18,132,132,10,4,6,3,2
2,135,135,9,1,8,3,2
12,137,137,1,1,0,1,0
5,150,150,9,9,0,1,0
17,154,154,2,2,0,1,0
6,155,155,51,51,0,1,0
23,157,157,31,31,0,1,0
20,168,168,21,17,4,2,1
15,186,186,29,29,0,1,0
34,200,200,31,15,16,3,2
41,202,202,58,58,0,1,0
31,202,202,13,13,0,1,0
13,206,206,1,1,0,1,0
40,212,212,65,65,0,1,0
1,213,213,11,11,0,1,0
30,234,234,24,24,0,1,0
33,236,236,86,86,0,1,0
9,240,240,43,43,0,1,0
26,268,268,32,32,0,1,0
24,290,290,9,9,0,1,0
28,301,301,19,1,18,4,3
38,303,303,14,6,8,2,1
25,308,308,3,3,0,1,0
10,317,317,1,1,0,1,0
8,325,325,20,20,0,1,0
4,349,349,7,7,0,1,0
3,351,351,21,21,0,1,0
39,360,360,17,8,9,3,2
11,374,374,4,4,0,1,0
27,376,376,9,2,7,2,1
14,401,401,59,53,6,3,2
21,405,405,30,30,0,1,0
37,425,425,17,17,0,1,0
19,438,438,13,13,0,1,0
29,445,445,70,70,0,1,0
32,447,447,22,3,19,2,1
36,452,452,2,2,0,1,0
22,454,454,5,5,0,1,0
42,477,477,28,22,6,3,2
7,492,492,69,69,0,1,0
16,493,493,9,2,7,2,1
0,498,498,30,30,0,1,0

38,141,141,4,4,0,1,0
21,148,148,3,3,0,1,0
37,158,158,28,12,16,2,1
12,166,166,1,1,0,1,0
23,167,167,12,4,8,3,2
7,169,169,3,3,0,1,0
18,178,178,2,2,0,1,0
20,181,181,7,2,5,2,1
16,186,186,3,3,0,1,0
34,188,188,1,1,0,1,0
28,211,211,5,5,0,1,0
22,214,214,23,7,16,2,1
35,239,239,16,16,0,1,0
14,248,248,15,3,12,2,1
15,249,249,57,57,0,1,0
33,257,257,8,4,4,2,1
3,264,264,10,10,0,1,0
19,276,276,83,73,10,2,1
24,281,281,12,12,0,1,0
13,284,284,70,52,18,2,1
29,288,288,51,24,27,2,1
5,293,293,40,20,20,3,2
1,314,314,36,36,0,1,0
9,319,319,10,10,0,1,0
6,340,340,97,58,39,4,3
11,343,343,3,3,0,1,0
4,351,351,12,6,6,3,2
10,369,369,27,15,12,2,1
39,371,371,52,52,0,1,0
25,375,375,24,24,0,1,0
26,379,379,67,67,0,1,0
36,384,384,68,2,66,3,2
2,390,390,17,17,0,1,0
31,410,410,109,47,62,3,2
32,421,421,48,3,45,4,3
0,430,430,12,12,0,1,0
8,434,434,45,18,27,4,3
17,446,446,36,36,0,1,0
30,454,454,101,87,14,3,2
27,499,499,14,11,3,2,1

3,109,109,27,3,24,2,1
9,114,114,10,10,0,1,0
26,138,138,19,19,0,1,0
8,145,145,72,72,0,1,0
31,164,164,2,2,0,1,0
6,166,166,4,4,0,1,0
0,175,175,25,25,0,1,0
24,177,177,4,4,0,1,0
7,190,190,46,40,6,2,1
22,200,200,29,29,0,1,0
28,203,203,43,40,3,2,1
30,214,214,34,34,0,1,0
1,234,234,17,17,0,1,0
32,242,242,26,26,0,1,0
10,244,244,6,6,0,1,0
20,276,276,4,1,3,2,1
19,297,297,26,14,12,3,2
27,315,315,54,2,52,3,2
18,317,317,8,4,4,2,1
17,317,317,47,47,0,1,0
11,337,337,20,14,6,2,1
15,341,341,57,57,0,1,0
4,348,348,39,39,0,1,0
33,348,348,14,1,13,3,2
23,354,354,32,13,19,2,1
25,365,365,35,35,0,1,0
12,401,401,3,3,0,1,0
16,406,406,83,39,44,3,2
13,433,433,43,34,9,2,1
34,444,444,36,10,26,3,2
21,451,451,75,75,0,1,0
5,458,458,19,3,16,3,2
2,473,473,32,9,23,2,1
29,486,486,10,10,0,1,0
14,495,495,5,5,0,1,0

20,105,105,1,1,0,1,0
6,115,115,12,12,0,1,0
17,118,118,9,9,0,1,0
33,123,123,28,28,0,1,0
18,132,132,20,20,0,1,0
34,167,167,37,28,9,2,1
29,180,180,18,12,6,3,2
11,212,212,40,14,26,2,1
14,224,224,20,9,11,2,1
30,237,237,31,15,16,3,2
15,238,238,22,22,0,1,0
8,239,239,6,6,0,1,0
9,251,251,35,14,21,4,3
22,263,263,11,11,0,1,0
23,270,270,58,39,19,2,1
21,296,296,27,11,16,2,1
31,304,304,29,29,0,1,0
32,347,347,17,3,14,2,1
12,347,347,50,16,34,2,1
4,351,351,25,25,0,1,0
28,358,358,9,9,0,1,0
2,376,376,1,1,0,1,0
27,381,381,1,1,0,1,0
35,385,385,35,13,22,2,1
19,391,391,11,3,8,3,2
1,404,404,96,96,0,1,0
16,412,412,18,18,0,1,0
0,418,418,12,12,0,1,0
36,420,420,89,47,42,3,2
26,422,422,57,57,0,1,0
3,426,426,111,39,72,4,3
7,431,431,8,8,0,1,0
24,436,436,21,15,6,2,1
13,453,453,30,16,14,2,1
10,460,460,33,33,0,1,0
25,467,467,27,5,22,3,2
5,492,492,119,119,0,1,0

12,100,100,1,1,0,1,0
24,101,101,2,2,0,1,0
8,109,109,3,3,0,1,0
18,123,123,8,3,5,2,1
16,136,136,17,17,0,1,0
20,137,137,10,10,0,1,0
27,142,142,2,2,0,1,0
34,145,145,4,4,0,1,0
22,154,154,1,1,0,1,0
17,154,154,31,3,28,3,2
32,184,184,11,5,6,2,1
14,185,185,14,14,0,1,0
25,186,186,6,3,3,2,1
19,215,215,41,32,9,2,1
1,240,240,120,2,118,4,3
26,242,242,9,9,0,1,0
5,243,243,27,27,0,1,0
31,262,262,22,13,9,4,3
6,278,278,15,12,3,2,1
29,305,305,105,15,90,4,3
11,327,327,42,27,15,4,3
0,338,338,8,8,0,1,0
4,366,366,30,6,24,3,2
35,367,367,6,6,0,1,0
9,370,370,34,18,16,2,1
23,371,371,22,6,16,3,2
2,380,380,13,10,3,2,1
15,390,390,93,63,30,3,2
7,399,399,19,10,9,4,3
13,410,410,12,12,0,1,0
33,439,439,17,4,13,2,1
21,454,454,166,61,105,4,3
3,456,456,43,21,22,4,3
28,466,466,128,66,62,3,2
30,476,476,14,14,0,1,0
10,487,487,114,60,54,4,3

36,132,132,6,6,0,1,0
15,168,168,16,16,0,1,0
2,170,170,10,4,6,3,2
24,172,172,90,90,0,1,0
22,187,187,46,9,37,3,2
18,196,196,19,9,10,3,2
38,217,217,2,2,0,1,0
20,232,232,1,1,0,1,0
28,234,234,13,13,0,1,0
4,238,238,12,5,7,2,1
37,259,259,6,6,0,1,0
19,260,260,4,4,0,1,0
12,270,270,38,38,0,1,0
8,273,273,40,40,0,1,0
31,278,278,12,12,0,1,0
26,282,282,17,17,0,1,0
27,290,290,17,3,14,2,1
23,292,292,19,10,9,4,3
16,295,295,1,1,0,1,0
35,308,308,37,17,20,2,1
17,316,316,40,16,24,4,3
30,324,324,22,22,0,1,0
11,324,324,24,24,0,1,0
21,324,324,12,12,0,1,0
25,325,325,30,30,0,1,0
1,347,347,19,6,13,2,1
33,353,353,13,10,3,2,1
6,360,360,29,29,0,1,0
7,384,384,6,6,0,1,0
10,385,385,20,5,15,4,3
9,385,385,74,36,38,3,2
39,387,387,3,3,0,1,0
14,395,395,35,35,0,1,0
29,401,401,47,3,44,2,1
3,434,434,23,11,12,4,3
32,451,451,134,111,23,2,1
34,456,456,15,15,0,1,0
0,460,460,65,17,48,2,1
5,467,467,36,4,32,3,2
13,470,470,157,51,106,4,3

26,108,108,31,31,0,1,0
22,130,130,1,1,0,1,0
8,131,131,2,2,0,1,0
9,137,137,14,14,0,1,0
16,139,139,30,9,21,2,1
28,176,176,1,1,0,1,0
36,189,189,7,7,0,1,0
18,204,204,10,5,5,2,1
32,208,208,21,9,12,2,1
21,211,211,35,2,33,4,3
6,211,211,22,22,0,1,0
20,222,222,1,1,0,1,0
10,230,230,1,1,0,1,0
14,232,232,56,10,46,3,2
17,233,233,50,9,41,2,1
19,247,247,16,5,11,2,1
33,254,254,117,117,0,1,0
35,261,261,5,5,0,1,0
27,279,279,17,17,0,1,0
30,286,286,64,19,45,4,3
25,310,310,8,8,0,1,0
5,328,328,52,52,0,1,0
34,336,336,28,10,18,4,3
13,340,340,54,19,35,2,1
4,375,375,3,3,0,1,0
24,378,378,5,1,4,2,1
31,384,384,88,88,0,1,0
1,395,395,35,17,18,3,2
29,404,404,30,30,0,1,0
0,407,407,21,21,0,1,0
2,416,416,48,11,37,4,3
23,420,420,12,12,0,1,0
11,423,423,28,7,21,3,2
3,458,458,88,88,0,1,0
7,490,490,56,25,31,3,2
12,495,495,24,14,10,2,1
15,499,499,2,2,0,1,0

9,115,115,20,20,0,1,0
3,128,128,22,22,0,1,0
32,131,131,12,12,0,1,0
35,143,143,4,1,3,2,1
27,146,146,2,2,0,1,0
10,150,150,25,25,0,1,0
23,155,155,2,2,0,1,0
5,171,171,11,11,0,1,0
29,180,180,1,1,0,1,0
11,189,189,31,31,0,1,0
15,194,194,1,1,0,1,0
37,200,200,11,11,0,1,0
36,221,221,32,7,25,3,2
22,231,231,4,4,0,1,0
25,254,254,47,47,0,1,0
8,256,256,2,2,0,1,0
33,263,263,7,3,4,2,1
20,264,264,3,3,0,1,0
2,272,272,20,2,18,3,2
13,274,274,5,5,0,1,0
31,282,282,27,4,23,2,1
34,297,297,52,52,0,1,0
16,312,312,8,8,0,1,0
1,319,319,46,28,18,3,2
28,339,339,7,7,0,1,0
14,346,346,31,12,19,2,1
38,356,356,46,19,27,2,1
30,377,377,31,28,3,2,1
26,412,412,14,14,0,1,0
7,435,435,62,62,0,1,0
19,445,445,44,18,26,2,1
6,452,452,60,51,9,4,3
17,454,454,13,13,0,1,0
39,467,467,216,192,24,4,3
21,471,471,25,3,22,3,2
24,481,481,143,98,45,3,2
18,484,484,33,25,8,2,1
0,488,488,1,1,0,1,0
4,489,489,3,3,0,1,0
12,499,499,152,72,80,3,2

24,111,111,8,8,0,1,0
0,151,151,7,7,0,1,0
11,211,211,3,3,0,1,0
30,213,213,25,15,10,3,2
22,219,219,18,18,0,1,0
9,234,234,47,40,7,2,1
31,239,239,36,36,0,1,0
12,241,241,5,5,0,1,0
13,258,258,13,13,0,1,0
34,267,267,32,32,0,1,0
17,272,272,4,4,0,1,0
23,288,288,5,5,0,1,0
10,297,297,41,41,0,1,0
2,311,311,76,26,50,2,1
3,321,321,46,46,0,1,0
29,326,326,3,3,0,1,0
19,326,326,49,33,16,2,1
14,333,333,57,27,30,4,3
1,369,369,63,31,32,3,2
16,370,370,24,9,15,2,1
25,370,370,21,21,0,1,0
6,381,381,51,51,0,1,0
15,387,387,19,19,0,1,0
4,411,411,106,85,21,4,3
33,411,411,52,52,0,1,0
26,425,425,133,91,42,4,3
32,441,441,34,20,14,3,2
7,456,456,103,79,24,4,3
5,460,460,8,8,0,1,0
20,466,466,28,7,21,4,3
8,468,468,8,1,7,2,1
21,474,474,2,2,0,1,0
27,475,475,111,97,14,2,1
18,476,476,9,9,0,1,0
28,486,486,117,39,78,3,2

6,101,101,3,3,0,1,0
10,103,103,9,9,0,1,0
9,113,113,2,2,0,1,0
15,129,129,28,28,0,1,0
19,132,132,4,4,0,1,0
23,142,142,2,2,0,1,0
11,155,155,10,10,0,1,0
13,188,188,18,18,0,1,0
33,191,191,20,20,0,1,0
27,194,194,9,3,6,3,2
21,196,196,21,21,0,1,0
24,200,200,34,24,10,2,1
22,200,200,2,2,0,1,0
25,208,208,2,2,0,1,0
28,228,228,56,9,47,2,1
26,239,239,6,1,5,2,1
5,250,250,7,7,0,1,0
16,283,283,9,9,0,1,0
12,288,288,14,14,0,1,0
39,303,303,33,9,24,3,2
20,305,305,35,7,28,2,1
3,322,322,35,35,0,1,0
1,340,340,31,15,16,2,1
14,341,341,14,14,0,1,0
34,360,360,71,59,12,2,1
36,361,361,38,26,12,2,1
30,362,362,28,16,12,2,1
35,382,382,1,1,0,1,0
8,388,388,11,11,0,1,0
31,390,390,49,49,0,1,0
17,400,400,24,24,0,1,0
38,402,402,30,30,0,1,0
7,403,403,3,3,0,1,0
37,403,403,107,65,42,3,2
2,404,404,63,63,0,1,0
32,435,435,23,23,0,1,0
4,453,453,150,41,109,4,3
29,470,470,88,16,72,3,2
18,497,497,144,116,28,3,2
0,498,498,12,6,6,2,1

32,139,139,15,15,0,1,0
26,147,147,7,7,0,1,0
3,147,147,4,4,0,1,0
22,157,157,6,6,0,1,0
23,158,158,13,13,0,1,0
30,159,159,24,18,6,2,1
10,170,170,16,16,0,1,0
18,174,174,12,3,9,2,1
33,194,194,24,24,0,1,0
19,201,201,15,5,10,2,1
13,204,204,2,2,0,1,0
2,206,206,2,2,0,1,0
34,222,222,3,3,0,1,0
27,228,228,35,35,0,1,0
37,230,230,2,2,0,1,0
36,235,235,12,12,0,1,0
15,253,253,15,1,14,3,2
14,265,265,16,16,0,1,0
25,299,299,44,30,14,2,1
7,304,304,60,10,50,3,2
16,314,314,45,1,44,4,3
24,320,320,79,15,64,4,3
12,321,321,19,7,12,3,2
31,321,321,49,18,31,2,1
8,341,341,18,18,0,1,0
0,362,362,8,2,6,3,2
21,363,363,48,40,8,2,1
20,366,366,61,3,58,3,2
35,381,381,76,40,36,2,1
1,416,416,155,85,70,4,3
4,418,418,19,11,8,2,1
5,428,428,38,38,0,1,0
6,429,429,83,63,20,2,1
28,460,460,11,11,0,1,0
11,461,461,26,18,8,2,1
29,488,488,10,1,9,2,1
17,492,492,81,81,0,1,0
9,496,496,87,27,60,4,3

4,127,127,3,3,0,1,0
37,159,159,2,2,0,1,0
5,171,171,33,33,0,1,0
12,183,183,16,16,0,1,0
0,188,188,20,1,19,4,3
16,199,199,36,30,6,2,1
9,199,199,11,11,0,1,0
15,204,204,9,1,8,3,2
23,212,212,2,2,0,1,0
34,217,217,15,12,3,2,1
38,233,233,49,4,45,2,1
6,235,235,23,23,0,1,0
3,235,235,26,4,22,2,1
11,255,255,4,4,0,1,0
31,263,263,13,4,9,2,1
18,278,278,1,1,0,1,0
36,278,278,28,28,0,1,0
42,287,287,35,2,33,4,3
29,292,292,23,23,0,1,0
27,299,299,16,11,5,2,1
22,307,307,48,7,41,2,1
24,316,316,17,17,0,1,0
25,335,335,50,15,35,2,1
14,348,348,25,25,0,1,0
26,351,351,37,5,32,3,2
32,351,351,39,39,0,1,0
33,364,364,8,8,0,1,0
2,379,379,35,35,0,1,0
39,381,381,19,1,18,4,3
20,381,381,3,3,0,1,0
30,385,385,180,136,44,3,2
1,386,386,17,17,0,1,0
13,387,387,41,17,24,2,1
35,389,389,12,12,0,1,0
21,391,391,12,2,10,2,1
41,422,422,40,40,0,1,0
7,422,422,14,9,5,2,1
19,428,428,73,35,38,3,2
40,428,428,8,8,0,1,0
10,438,438,87,87,0,1,0
28,446,446,56,56,0,1,0
8,449,449,15,15,0,1,0
17,487,487,15,3,12,4,3

7,112,112,6,6,0,1,0
39,123,123,10,10,0,1,0
26,139,139,35,3,32,4,3
36,141,141,3,3,0,1,0
40,149,149,32,32,0,1,0
41,161,161,3,3,0,1,0
22,175,175,34,34,0,1,0
12,179,179,8,8,0,1,0
10,183,183,24,24,0,1,0
5,188,188,5,2,3,2,1
37,194,194,10,1,9,4,3
8,202,202,11,11,0,1,0
25,226,226,11,1,10,2,1
11,235,235,14,14,0,1,0
3,242,242,23,23,0,1,0
28,254,254,47,47,0,1,0
6,256,256,6,2,4,2,1
1,285,285,4,4,0,1,0
27,289,289,12,7,5,2,1
13,290,290,47,11,36,4,3
23,318,318,9,9,0,1,0
35,321,321,11,11,0,1,0
30,328,328,45,45,0,1,0
18,344,344,3,3,0,1,0
0,352,352,7,7,0,1,0
17,355,355,16,16,0,1,0
16,363,363,36,14,22,2,1
31,371,371,6,6,0,1,0
2,380,380,1,1,0,1,0
24,395,395,56,4,52,4,3
4,398,398,21,5,16,3,2
9,411,411,59,23,36,3,2
15,436,436,70,49,21,2,1
29,444,444,147,147,0,1,0
34,446,446,41,11,30,4,3
21,461,461,48,2,46,4,3
38,473,473,4,4,0,1,0
33,474,474,50,14,36,4,3
32,481,481,63,63,0,1,0
20,482,482,38,38,0,1,0
14,489,489,64,64,0,1,0
19,494,494,99,99,0,1,0

40,107,107,13,1,12,4,3
38,108,108,9,1,8,3,2
20,112,112,1,1,0,1,0
29,153,153,3,3,0,1,0
5,160,160,13,13,0,1,0
37,163,163,4,1,3,2,1
9,170,170,7,7,0,1,0
13,170,170,1,1,0,1,0
23,177,177,2,2,0,1,0
3,178,178,4,4,0,1,0
7,178,178,15,5,10,2,1
22,187,187,14,5,9,2,1
32,191,191,18,5,13,2,1
16,209,209,13,4,9,2,1
6,209,209,13,13,0,1,0
17,210,210,57,57,0,1,0
35,220,220,39,39,0,1,0
33,243,243,49,6,43,2,1
24,244,244,53,4,49,2,1
0,259,259,57,21,36,4,3
27,271,271,11,8,3,2,1
36,280,280,13,5,8,2,1
18,296,296,46,34,12,3,2
42,307,307,35,27,8,2,1
2,312,312,29,29,0,1,0
4,324,324,37,1,36,4,3
31,334,334,11,3,8,2,1
12,353,353,26,26,0,1,0
1,353,353,9,9,0,1,0
8,355,355,20,11,9,4,3
10,373,373,4,4,0,1,0
21,383,383,10,10,0,1,0
39,420,420,164,57,107,4,3
25,424,424,31,3,28,3,2
19,426,426,69,69,0,1,0
34,429,429,58,29,29,2,1
14,434,434,39,39,0,1,0
15,446,446,43,1,42,2,1
26,451,451,4,4,0,1,0
28,475,475,3,3,0,1,0
41,492,492,46,46,0,1,0
30,493,493,33,33,0,1,0
11,499,499,28,28,0,1,0

12,101,101,8,8,0,1,0
7,114,114,34,34,0,1,0
10,117,117,14,6,8,3,2
8,146,146,15,5,10,3,2
11,153,153,3,3,0,1,0
19,155,155,1,1,0,1,0
1,181,181,20,8,12,2,1
20,194,194,29,29,0,1,0
15,201,201,30,18,12,4,3
13,226,226,4,4,0,1,0
28,246,246,55,43,12,4,3
25,246,246,25,4,21,4,3
27,250,250,11,11,0,1,0
29,302,302,22,7,15,4,3
17,311,311,46,21,25,2,1
9,339,339,121,97,24,4,3
4,359,359,1,1,0,1,0
16,367,367,28,28,0,1,0
23,371,371,27,27,0,1,0
26,377,377,46,13,33,3,2
3,380,380,78,78,0,1,0
21,409,409,46,14,32,2,1
0,414,414,53,53,0,1,0
5,434,434,73,73,0,1,0
22,441,441,28,28,0,1,0
14,445,445,167,134,33,4,3
2,463,463,64,64,0,1,0
24,467,467,15,15,0,1,0
6,468,468,129,112,17,2,1
18,500,500,38,38,0,1,0

14,117,117,6,6,0,1,0
27,140,140,16,1,15,4,3
12,150,150,37,37,0,1,0
3,163,163,8,8,0,1,0
25,218,218,9,9,0,1,0
8,233,233,52,12,40,2,1
34,240,240,11,11,0,1,0
41,244,244,81,42,39,4,3
22,248,248,15,2,13,4,3
9,252,252,7,7,0,1,0
5,277,277,4,4,0,1,0
35,286,286,93,55,38,3,2
23,290,290,31,31,0,1,0
4,305,305,27,27,0,1,0
17,309,309,8,8,0,1,0
30,315,315,2,2,0,1,0
21,317,317,11,11,0,1,0
32,323,323,18,10,8,2,1
31,325,325,9,9,0,1,0
38,341,341,46,9,37,2,1
6,343,343,15,8,7,2,1
11,365,365,2,2,0,1,0
37,370,370,55,55,0,1,0
13,373,373,30,27,3,2,1
7,374,374,32,32,0,1,0
18,377,377,27,27,0,1,0
40,377,377,17,17,0,1,0
33,394,394,103,40,63,4,3
2,397,397,45,45,0,1,0
24,398,398,11,1,10,3,2
26,432,432,28,9,19,2,1
29,444,444,47,47,0,1,0
10,452,452,63,15,48,2,1
39,455,455,1,1,0,1,0
15,458,458,36,36,0,1,0
19,461,461,27,27,0,1,0
1,469,469,62,19,43,4,3
28,473,473,34,34,0,1,0
20,484,484,59,59,0,1,0
16,487,487,38,29,9,4,3
36,493,493,9,9,0,1,0
0,494,494,35,11,24,3,2

18,118,118,34,34,0,1,0
2,118,118,8,8,0,1,0
28,125,125,4,4,0,1,0
9,141,141,1,1,0,1,0
37,159,159,1,1,0,1,0
26,182,182,9,3,6,3,2
17,189,189,69,29,40,2,1
24,191,191,42,14,28,2,1
7,192,192,11,8,3,2,1
13,196,196,4,4,0,1,0
20,205,205,9,9,0,1,0
15,218,218,4,4,0,1,0
8,242,242,100,70,30,4,3
27,243,243,29,29,0,1,0
31,258,258,7,7,0,1,0
3,266,266,19,3,16,3,2
22,278,278,11,5,6,3,2
25,279,279,8,8,0,1,0
14,279,279,11,11,0,1,0
0,280,280,3,3,0,1,0
33,290,290,9,9,0,1,0
5,297,297,20,2,18,2,1
32,328,328,3,3,0,1,0
16,335,335,3,3,0,1,0
23,338,338,130,66,64,3,2
34,341,341,2,2,0,1,0
6,351,351,6,6,0,1,0
19,355,355,173,124,49,2,1
10,359,359,41,21,20,2,1
29,394,394,31,6,25,2,1
36,407,407,7,1,6,3,2
4,420,420,51,27,24,2,1
35,447,447,56,25,31,2,1
11,459,459,35,5,30,2,1
12,466,466,10,10,0,1,0
21,473,473,107,55,52,4,3
1,478,478,58,58,0,1,0
30,481,481,3,3,0,1,0

7,107,107,4,4,0,1,0
31,110,110,1,1,0,1,0
16,112,112,4,1,3,2,1
27,122,122,11,11,0,1,0
1,138,138,1,1,0,1,0
8,141,141,15,15,0,1,0
6,153,153,16,4,12,3,2
35,153,153,17,3,14,3,2
36,158,158,2,2,0,1,0
32,168,168,61,19,42,2,1
21,175,175,6,1,5,2,1
19,181,181,18,8,10,3,2
13,188,188,15,6,9,4,3
22,191,191,16,16,0,1,0
40,203,203,15,15,0,1,0
26,205,205,13,5,8,2,1
24,222,222,1,1,0,1,0
28,224,224,5,5,0,1,0
9,229,229,30,18,12,3,2
2,230,230,4,4,0,1,0
30,233,233,1,1,0,1,0
41,235,235,12,12,0,1,0
42,258,258,22,22,0,1,0
43,275,275,49,44,5,2,1
38,275,275,101,79,22,3,2
23,280,280,1,1,0,1,0
25,280,280,49,5,44,2,1
14,340,340,58,19,39,4,3
11,354,354,5,5,0,1,0
17,363,363,58,18,40,2,1
4,375,375,42,24,18,3,2
34,378,378,5,1,4,2,1
5,380,380,20,20,0,1,0
15,386,386,94,43,51,4,3
33,401,401,39,25,14,2,1
10,405,405,10,2,8,3,2
12,418,418,21,21,0,1,0
18,425,425,94,9,85,4,3
3,464,464,1,1,0,1,0
0,466,466,48,42,6,3,2
39,471,471,52,36,16,3,2
20,471,471,1,1,0,1,0
37,492,492,38,38,0,1,0
29,493,493,21,3,18,2,1

7,111,111,16,1,15,2,1
13,123,123,9,9,0,1,0
11,129,129,20,20,0,1,0
39,134,134,15,15,0,1,0
34,140,140,8,3,5,2,1
27,159,159,33,5,28,3,2
21,159,159,17,17,0,1,0
2,170,170,41,15,26,3,2
35,175,175,6,6,0,1,0
32,175,175,1,1,0,1,0
4,181,181,3,3,0,1,0
5,194,194,14,8,6,2,1
1,197,197,17,17,0,1,0
8,198,198,7,1,6,2,1
15,200,200,22,10,12,4,3
37,226,226,43,43,0,1,0
38,227,227,16,7,9,4,3
17,228,228,14,6,8,3,2
14,238,238,15,15,0,1,0
3,252,252,17,6,11,2,1
18,267,267,4,4,0,1,0
6,270,270,78,18,60,4,3
36,316,316,16,7,9,4,3
26,322,322,65,47,18,4,3
22,337,337,29,20,9,4,3
9,344,344,15,15,0,1,0
25,350,350,15,4,11,2,1
23,379,379,101,101,0,1,0
30,379,379,31,31,0,1,0
33,383,383,69,27,42,4,3
24,385,385,1,1,0,1,0
16,409,409,5,5,0,1,0
19,413,413,19,19,0,1,0
10,413,413,39,39,0,1,0
28,432,432,22,12,10,2,1
12,444,444,39,6,33,4,3
20,449,449,24,24,0,1,0
31,455,455,12,12,0,1,0
0,459,459,14,14,0,1,0
29,465,465,61,52,9,4,3
40,493,493,70,70,0,1,0

42,102,102,13,13,0,1,0
36,134,134,5,5,0,1,0
13,142,142,28,28,0,1,0
17,147,147,5,1,4,2,1
25,151,151,20,20,0,1,0
6,175,175,1,1,0,1,0
18,176,176,24,12,12,3,2
14,178,178,31,5,26,2,1
24,181,181,44,17,27,2,1
1,188,188,14,14,0,1,0
2,206,206,7,7,0,1,0
35,221,221,14,3,11,4,3
12,238,238,7,4,3,2,1
38,250,250,18,18,0,1,0
21,251,251,62,10,52,3,2
28,252,252,23,11,12,4,3
27,262,262,16,7,9,4,3
23,263,263,11,11,0,1,0
10,263,263,47,39,8,3,2
8,285,285,11,11,0,1,0
7,299,299,31,5,26,3,2
29,301,301,8,2,6,3,2
5,302,302,48,42,6,2,1
9,320,320,12,1,11,2,1
41,330,330,11,1,10,2,1
19,344,344,9,1,8,3,2
40,355,355,49,49,0,1,0
0,361,361,10,10,0,1,0
31,363,363,13,13,0,1,0
11,372,372,1,1,0,1,0
33,373,373,147,54,93,4,3
37,398,398,23,23,0,1,0
26,401,401,52,2,50,3,2
4,434,434,36,36,0,1,0
16,446,446,35,35,0,1,0
3,453,453,42,38,4,2,1
39,460,460,11,11,0,1,0
34,463,463,1,1,0,1,0
32,478,478,73,73,0,1,0
22,480,480,24,24,0,1,0
30,490,490,54,7,47,2,1
20,494,494,8,8,0,1,0
15,498,498,16,16,0,1,0

37,110,110,23,14,9,4,3
36,128,128,10,10,0,1,0
5,137,137,14,14,0,1,0
16,150,150,7,4,3,2,1
44,157,157,19,6,13,4,3
18,160,160,23,23,0,1,0
26,168,168,15,5,10,2,1
11,200,200,11,11,0,1,0
4,201,201,16,16,0,1,0
1,205,205,1,1,0,1,0
25,215,215,20,20,0,1,0
35,219,219,13,13,0,1,0
39,235,235,28,6,22,2,1
28,236,236,21,11,10,2,1
23,237,237,4,4,0,1,0
20,320,320,67,35,32,3,2
22,321,321,13,13,0,1,0
14,323,323,28,6,22,3,2
33,328,328,2,2,0,1,0
41,336,336,36,36,0,1,0
8,337,337,34,6,28,2,1
31,340,340,29,10,19,4,3
15,341,341,27,27,0,1,0
2,343,343,10,10,0,1,0
19,350,350,1,1,0,1,0
3,370,370,59,59,0,1,0
6,375,375,14,14,0,1,0
40,403,403,67,67,0,1,0
43,414,414,36,36,0,1,0
12,424,424,12,12,0,1,0
34,424,424,143,95,48,2,1
42,427,427,27,27,0,1,0
7,428,428,20,8,12,4,3
13,430,430,14,2,12,2,1
9,433,433,38,38,0,1,0
29,449,449,15,15,0,1,0
38,450,450,75,60,15,4,3
27,455,455,7,7,0,1,0
10,459,459,1,1,0,1,0
30,461,461,8,8,0,1,0
21,466,466,60,28,32,3,2
0,469,469,20,20,0,1,0
24,487,487,114,114,0,1,0
17,493,493,6,1,5,2,1
32,500,500,45,35,10,3,2

4,104,104,3,3,0,1,0
0,114,114,22,18,4,2,1
29,115,115,13,3,10,2,1
8,125,125,7,3,4,2,1
12,155,155,11,7,4,2,1
22,156,156,27,27,0,1,0
31,159,159,25,9,16,2,1
26,162,162,1,1,0,1,0
13,191,191,21,21,0,1,0
15,220,220,7,7,0,1,0
27,224,224,6,6,0,1,0
11,234,234,28,12,16,2,1
30,246,246,26,26,0,1,0
32,250,250,7,3,4,2,1
7,261,261,5,5,0,1,0
20,272,272,41,5,36,4,3
18,274,274,68,30,38,3,2
5,276,276,64,30,34,3,2
10,295,295,128,128,0,1,0
9,302,302,37,3,34,3,2
19,306,306,26,26,0,1,0
6,310,310,89,89,0,1,0
23,319,319,62,20,42,3,2
1,359,359,10,2,8,2,1
21,382,382,50,50,0,1,0
17,402,402,27,27,0,1,0
16,406,406,33,18,15,3,2
24,421,421,16,16,0,1,0
14,446,446,67,33,34,4,3
28,448,448,18,18,0,1,0
25,449,449,53,53,0,1,0
2,474,474,69,1,68,4,3
3,481,481,26,13,13,4,3

10,119,119,4,1,3,2,1
22,125,125,17,5,12,3,2
23,131,131,2,2,0,1,0
15,139,139,9,9,0,1,0
12,148,148,1,1,0,1,0
35,148,148,3,3,0,1,0
33,148,148,5,5,0,1,0
41,168,168,2,2,0,1,0
29,216,216,37,25,12,4,3
30,219,219,6,6,0,1,0
34,225,225,34,4,30,2,1
37,228,228,46,46,0,1,0
17,242,242,9,1,8,3,2
13,257,257,9,9,0,1,0
18,266,266,35,12,23,2,1
25,280,280,35,35,0,1,0
28,283,283,17,17,0,1,0
20,294,294,3,3,0,1,0
9,299,299,43,43,0,1,0
4,310,310,1,1,0,1,0
6,316,316,1,1,0,1,0
39,328,328,67,67,0,1,0
26,334,334,2,2,0,1,0
3,336,336,25,25,0,1,0
38,339,339,2,2,0,1,0
11,342,342,5,2,3,2,1
24,344,344,113,113,0,1,0
8,359,359,7,7,0,1,0
36,360,360,1,1,0,1,0
5,361,361,1,1,0,1,0
14,382,382,23,19,4,2,1
19,401,401,2,2,0,1,0
31,406,406,24,20,4,2,1
40,410,410,101,101,0,1,0
0,412,412,20,8,12,2,1
16,421,421,225,135,90,4,3
21,426,426,135,135,0,1,0
32,432,432,9,9,0,1,0
1,449,449,57,26,31,4,3
2,468,468,16,16,0,1,0
7,468,468,28,28,0,1,0
27,491,491,121,121,0,1,0

34,101,101,18,1,17,2,1
38,101,101,5,5,0,1,0
40,102,102,12,9,3,2,1
23,123,123,6,6,0,1,0
46,123,123,4,4,0,1,0
5,137,137,11,1,10,2,1
36,154,154,37,20,17,2,1
12,161,161,5,5,0,1,0
30,165,165,12,12,0,1,0
15,175,175,4,1,3,2,1
39,176,176,2,2,0,1,0
16,181,181,12,3,9,2,1
6,206,206,11,6,5,2,1
22,213,213,8,8,0,1,0
14,221,221,6,6,0,1,0
27,256,256,20,14,6,2,1
26,267,267,63,23,40,3,2
25,279,279,19,19,0,1,0
4,286,286,23,23,0,1,0
24,292,292,36,36,0,1,0
3,293,293,39,39,0,1,0
43,303,303,11,8,3,2,1
13,313,313,23,23,0,1,0
35,319,319,28,7,21,2,1
11,328,328,28,16,12,3,2
0,341,341,54,14,40,3,2
18,346,346,5,5,0,1,0
41,349,349,16,16,0,1,0
2,355,355,8,8,0,1,0
19,359,359,17,11,6,3,2
44,360,360,19,5,14,2,1
45,361,361,142,52,90,4,3
1,361,361,2,2,0,1,0
29,366,366,85,64,21,3,2
8,373,373,7,7,0,1,0
21,381,381,10,10,0,1,0
20,419,419,8,3,5,2,1
9,426,426,22,1,21,3,2
42,437,437,44,44,0,1,0
32,464,464,21,21,0,1,0
10,466,466,59,59,0,1,0
33,469,469,17,17,0,1,0
28,469,469,26,26,0,1,0
17,470,470,66,15,51,4,3
31,476,476,37,26,11,2,1
37,485,485,36,36,0,1,0
7,497,497,13,7,6,2,1

31,103,103,8,8,0,1,0
2,104,104,1,1,0,1,0
7,140,140,2,2,0,1,0
15,144,144,4,4,0,1,0
25,147,147,10,10,0,1,0
6,156,156,20,20,0,1,0
29,158,158,29,9,20,2,1
0,171,171,7,7,0,1,0
11,182,182,2,2,0,1,0
22,184,184,25,16,9,2,1
21,202,202,30,6,24,4,3
17,240,240,53,9,44,3,2
10,262,262,84,44,40,2,1
1,302,302,27,27,0,1,0
3,328,328,5,5,0,1,0
13,341,341,24,24,0,1,0
5,349,349,276,216,60,4,3
26,355,355,1,1,0,1,0
4,366,366,4,4,0,1,0
12,366,366,48,30,18,3,2
23,371,371,5,5,0,1,0
28,388,388,49,11,38,3,2
27,403,403,156,147,9,2,1
32,426,426,99,87,12,4,3
14,431,431,4,1,3,2,1
8,443,443,64,64,0,1,0
24,445,445,11,11,0,1,0
30,452,452,7,1,6,3,2
18,458,458,91,91,0,1,0
19,463,463,24,2,22,4,3
20,467,467,3,3,0,1,0
16,474,474,3,3,0,1,0
9,479,479,60,17,43,2,1

35,110,110,34,25,9,2,1
18,132,132,2,2,0,1,0
10,143,143,7,7,0,1,0
36,157,157,52,52,0,1,0
38,161,161,4,4,0,1,0
39,191,191,4,4,0,1,0
28,198,198,9,9,0,1,0
32,204,204,36,36,0,1,0
5,206,206,30,30,0,1,0
16,206,206,27,27,0,1,0
27,207,207,2,2,0,1,0
26,218,218,44,44,0,1,0
1,219,219,5,5,0,1,0
23,220,220,11,4,7,2,1
24,220,220,26,26,0,1,0
30,225,225,31,31,0,1,0
3,227,227,5,5,0,1,0
25,235,235,18,2,16,2,1
42,239,239,4,4,0,1,0
2,241,241,3,3,0,1,0
12,243,243,59,15,44,3,2
6,243,243,17,5,12,2,1
20,247,247,74,50,24,4,3
0,256,256,38,38,0,1,0
19,257,257,51,3,48,2,1
11,258,258,22,6,16,3,2
14,262,262,18,18,0,1,0
17,281,281,13,13,0,1,0
8,324,324,8,8,0,1,0
41,331,331,21,21,0,1,0
21,332,332,11,11,0,1,0
29,335,335,26,19,7,2,1
33,350,350,5,5,0,1,0
22,358,358,16,2,14,2,1
40,382,382,22,4,18,4,3
9,385,385,9,9,0,1,0
15,393,393,22,22,0,1,0
7,427,427,10,10,0,1,0
13,430,430,35,9,26,3,2
37,435,435,44,11,33,2,1
4,458,458,3,3,0,1,0
31,489,489,35,31,4,2,1
34,496,496,43,29,14,3,2

18,102,102,1,1,0,1,0
40,117,117,2,2,0,1,0
28,119,119,20,20,0,1,0
5,123,123,18,18,0,1,0
22,131,131,5,5,0,1,0
10,136,136,4,4,0,1,0
30,137,137,51,51,0,1,0
39,139,139,5,5,0,1,0
11,151,151,34,4,30,4,3
6,161,161,19,5,14,2,1
8,170,170,23,23,0,1,0
15,176,176,2,2,0,1,0
1,185,185,6,3,3,2,1
27,201,201,3,3,0,1,0
36,242,242,17,10,7,2,1
26,249,249,42,42,0,1,0
17,274,274,41,17,24,4,3
37,300,300,43,43,0,1,0
14,313,313,8,3,5,2,1
31,323,323,95,44,51,4,3
12,332,332,17,17,0,1,0
34,362,362,15,15,0,1,0
25,394,394,24,8,16,2,1
32,399,399,36,36,0,1,0
7,408,408,45,45,0,1,0
19,409,409,41,11,30,3,2
2,415,415,120,120,0,1,0
29,421,421,15,6,9,3,2
13,433,433,26,8,18,2,1
16,438,438,22,22,0,1,0
24,444,444,10,2,8,3,2
9,447,447,36,18,18,3,2
20,458,458,27,13,14,3,2
21,462,462,54,54,0,1,0
3,462,462,18,10,8,2,1
23,469,469,20,20,0,1,0
0,479,479,1,1,0,1,0
38,479,479,63,15,48,2,1
35,490,490,62,62,0,1,0
33,497,497,29,7,22,2,1
4,500,500,30,30,0,1,0

10,111,111,1,1,0,1,0
15,116,116,35,7,28,3,2
5,117,117,3,3,0,1,0
26,132,132,26,26,0,1,0
27,138,138,5,5,0,1,0
21,150,150,6,2,4,2,1
30,163,163,5,5,0,1,0
16,179,179,3,3,0,1,0
20,185,185,20,20,0,1,0
8,193,193,42,6,36,3,2
18,201,201,5,5,0,1,0
7,217,217,65,3,62,3,2
0,220,220,3,3,0,1,0
6,239,239,49,26,23,4,3
4,263,263,50,50,0,1,0
23,269,269,10,10,0,1,0
12,284,284,33,3,30,3,2
17,286,286,62,8,54,4,3
13,311,311,99,99,0,1,0
11,332,332,21,5,16,2,1
9,356,356,85,85,0,1,0
25,359,359,43,43,0,1,0
1,370,370,2,2,0,1,0
29,384,384,1,1,0,1,0
3,409,409,160,34,126,4,3
24,447,447,21,6,15,2,1
22,448,448,49,49,0,1,0
2,460,460,112,85,27,2,1
19,473,473,43,29,14,2,1
14,476,476,20,20,0,1,0
28,479,479,46,13,33,4,3

34,105,105,27,20,7,2,1
10,119,119,7,1,6,2,1
13,119,119,14,14,0,1,0
0,137,137,1,1,0,1,0
39,143,143,21,8,13,2,1
20,148,148,12,12,0,1,0
15,149,149,14,5,9,2,1
22,155,155,3,3,0,1,0
26,157,157,60,39,21,4,3
31,159,159,6,6,0,1,0
36,162,162,27,27,0,1,0
33,188,188,5,5,0,1,0
21,195,195,29,4,25,2,1
28,200,200,27,13,14,2,1
35,211,211,5,5,0,1,0
17,214,214,30,30,0,1,0
19,251,251,6,2,4,2,1
29,264,264,15,15,0,1,0
9,268,268,19,15,4,2,1
12,282,282,23,23,0,1,0
1,287,287,4,4,0,1,0
11,287,287,68,18,50,3,2
23,295,295,7,7,0,1,0
5,300,300,1,1,0,1,0
24,315,315,34,20,14,3,2
16,330,330,28,16,12,3,2
3,331,331,24,24,0,1,0
32,349,349,21,12,9,4,3
18,364,364,84,47,37,2,1
7,364,364,37,7,30,4,3
40,379,379,8,8,0,1,0
30,382,382,19,7,12,2,1
2,387,387,4,4,0,1,0
14,409,409,13,10,3,2,1
27,419,419,43,43,0,1,0
37,439,439,31,31,0,1,0
6,447,447,19,19,0,1,0
25,448,448,65,50,15,4,3
4,465,465,79,34,45,2,1
38,475,475,49,49,0,1,0
8,483,483,38,14,24,4,3

4,100,100,1,1,0,1,0
3,106,106,24,24,0,1,0
38,112,112,7,2,5,2,1
1,116,116,8,4,4,2,1
14,131,131,18,5,13,2,1
43,136,136,29,29,0,1,0
9,149,149,5,5,0,1,0
15,157,157,14,6,8,2,1
0,172,172,3,3,0,1,0
22,175,175,1,1,0,1,0
37,192,192,20,8,12,4,3
32,197,197,16,16,0,1,0
41,203,203,19,19,0,1,0
6,226,226,6,6,0,1,0
18,228,228,12,1,11,2,1
2,233,233,1,1,0,1,0
5,238,238,11,11,0,1,0
29,240,240,9,9,0,1,0
8,258,258,2,2,0,1,0
17,261,261,11,7,4,2,1
20,268,268,7,7,0,1,0
28,284,284,23,11,12,2,1
30,293,293,45,45,0,1,0
13,295,295,51,51,0,1,0
19,298,298,1,1,0,1,0
23,302,302,122,122,0,1,0
39,318,318,32,23,9,2,1
11,319,319,32,32,0,1,0
21,320,320,43,25,18,4,3
40,329,329,101,49,52,3,2
26,352,352,1,1,0,1,0
12,365,365,30,30,0,1,0
36,377,377,31,19,12,2,1
7,385,385,23,8,15,2,1
34,395,395,31,28,3,2,1
31,451,451,30,9,21,2,1
42,455,455,44,32,12,3,2
33,459,459,31,1,30,4,3
35,472,472,44,44,0,1,0
24,473,473,45,15,30,3,2
10,473,473,2,2,0,1,0
25,476,476,89,68,21,4,3
27,488,488,12,9,3,2,1
16,490,490,25,17,8,2,1

21,126,126,11,1,10,3,2
29,158,158,32,16,16,3,2
24,159,159,17,17,0,1,0
30,164,164,17,3,14,2,1
16,170,170,33,33,0,1,0
27,172,172,42,42,0,1,0
6,173,173,4,4,0,1,0
41,177,177,17,17,0,1,0
25,178,178,7,1,6,2,1
14,179,179,1,1,0,1,0
26,185,185,3,3,0,1,0
9,188,188,23,23,0,1,0
0,194,194,40,40,0,1,0
1,195,195,4,4,0,1,0
12,200,200,21,5,16,3,2
2,218,218,6,6,0,1,0
39,218,218,65,11,54,3,2
8,232,232,29,29,0,1,0
18,260,260,56,56,0,1,0
36,276,276,15,15,0,1,0
35,276,276,24,10,14,2,1
20,281,281,3,3,0,1,0
32,298,298,22,7,15,4,3
4,319,319,2,2,0,1,0
28,320,320,13,1,12,3,2
37,324,324,10,10,0,1,0
19,341,341,11,11,0,1,0
23,346,346,24,24,0,1,0
31,368,368,8,8,0,1,0
5,393,393,18,18,0,1,0
11,394,394,46,46,0,1,0
38,402,402,107,87,20,3,2
3,407,407,21,13,8,2,1
17,419,419,95,3,92,3,2
33,422,422,52,43,9,2,1
40,444,444,26,26,0,1,0
7,456,456,48,1,47,2,1
34,467,467,2,2,0,1,0
22,470,470,17,17,0,1,0
13,489,489,1,1,0,1,0
10,490,490,54,38,16,3,2
15,500,500,13,13,0,1,0

3,100,100,16,7,9,2,1
19,104,104,8,5,3,2,1
20,107,107,4,4,0,1,0
8,113,113,50,19,31,2,1
21,113,113,13,4,9,4,3
14,124,124,21,6,15,4,3
23,130,130,4,4,0,1,0
12,146,146,16,16,0,1,0
27,150,150,29,11,18,4,3
33,157,157,3,3,0,1,0
16,171,171,4,4,0,1,0
4,195,195,21,8,13,2,1
29,209,209,29,29,0,1,0
17,223,223,35,20,15,2,1
13,224,224,29,1,28,2,1
24,228,228,14,14,0,1,0
5,245,245,4,4,0,1,0
11,255,255,17,6,11,2,1
30,258,258,17,7,10,3,2
32,261,261,10,2,8,3,2
2,274,274,7,7,0,1,0
22,336,336,37,6,31,2,1
31,341,341,137,28,109,4,3
26,345,345,46,4,42,3,2
7,364,364,27,4,23,2,1
6,365,365,26,11,15,2,1
9,370,370,76,76,0,1,0
10,378,378,62,62,0,1,0
28,396,396,17,17,0,1,0
15,409,409,30,6,24,3,2
18,447,447,9,9,0,1,0
0,457,457,57,36,21,4,3
1,458,458,18,18,0,1,0
25,500,500,99,58,41,2,1

24,103,103,1,1,0,1,0
36,131,131,6,6,0,1,0
8,131,131,52,52,0,1,0
11,133,133,2,2,0,1,0
21,167,167,87,19,68,3,2
30,173,173,2,2,0,1,0
3,179,179,7,7,0,1,0
32,183,183,18,10,8,3,2
12,184,184,4,4,0,1,0
1,239,239,7,7,0,1,0
33,241,241,5,5,0,1,0
7,255,255,6,6,0,1,0
25,255,255,3,3,0,1,0
0,257,257,8,8,0,1,0
37,268,268,20,20,0,1,0
10,285,285,45,45,0,1,0
17,293,293,4,4,0,1,0
6,298,298,42,2,40,3,2
38,307,307,23,1,22,2,1
18,313,313,20,20,0,1,0
29,322,322,7,3,4,2,1
4,336,336,83,46,37,4,3
27,337,337,13,5,8,2,1
2,355,355,50,50,0,1,0
39,368,368,38,38,0,1,0
23,371,371,61,48,13,2,1
20,373,373,96,96,0,1,0
26,383,383,33,33,0,1,0
31,399,399,24,24,0,1,0
14,406,406,46,46,0,1,0
35,427,427,39,26,13,3,2
5,435,435,30,30,0,1,0
15,441,441,6,6,0,1,0
9,450,450,5,5,0,1,0
22,456,456,88,46,42,3,2
16,477,477,9,2,7,2,1
13,479,479,14,14,0,1,0
34,480,480,71,24,47,2,1
19,481,481,32,12,20,4,3
28,499,499,78,78,0,1,0

12,102,102,1,1,0,1,0
7,115,115,6,6,0,1,0
33,122,122,12,12,0,1,0
17,130,130,3,3,0,1,0
27,131,131,5,1,4,2,1
9,135,135,6,6,0,1,0
32,140,140,27,18,9,4,3
13,145,145,12,2,10,2,1
30,183,183,15,15,0,1,0
6,185,185,17,17,0,1,0
5,190,190,1,1,0,1,0
1,212,212,1,1,0,1,0
26,216,216,13,3,10,4,3
15,244,244,30,30,0,1,0
28,252,252,9,2,7,2,1
4,257,257,22,22,0,1,0
8,259,259,73,73,0,1,0
34,260,260,19,7,12,3,2
2,276,276,58,13,45,4,3
36,288,288,20,20,0,1,0
31,309,309,3,3,0,1,0
24,320,320,9,9,0,1,0
29,359,359,5,5,0,1,0
11,370,370,55,10,45,4,3
10,381,381,12,4,8,2,1
18,386,386,18,14,4,2,1
25,386,386,93,87,6,2,1
35,401,401,48,31,17,2,1
23,411,411,34,34,0,1,0
16,416,416,19,7,12,3,2
19,418,418,108,65,43,2,1
21,432,432,15,3,12,2,1
14,462,462,20,3,17,2,1
22,467,467,8,8,0,1,0
0,467,467,127,127,0,1,0
3,472,472,19,4,15,4,3
37,476,476,93,77,16,2,1
20,491,491,222,183,39,4,3
38,500,500,46,46,0,1,0

2,101,101,7,7,0,1,0
25,106,106,1,1,0,1,0
27,114,114,4,4,0,1,0
28,115,115,12,4,8,3,2
32,124,124,20,20,0,1,0
18,146,146,10,10,0,1,0
14,147,147,28,3,25,2,1
12,153,153,21,6,15,2,1
7,154,154,6,6,0,1,0
34,169,169,48,32,16,3,2
15,170,170,8,8,0,1,0
6,176,176,12,12,0,1,0
26,216,216,1,1,0,1,0
31,223,223,37,37,0,1,0
17,223,223,57,57,0,1,0
5,224,224,9,9,0,1,0
29,228,228,65,65,0,1,0
11,253,253,13,13,0,1,0
3,256,256,28,28,0,1,0
16,260,260,48,38,10,2,1
8,263,263,23,3,20,3,2
33,275,275,17,6,11,2,1
13,332,332,3,3,0,1,0
30,357,357,52,52,0,1,0
24,357,357,58,58,0,1,0
20,358,358,26,2,24,2,1
0,403,403,36,28,8,3,2
1,410,410,77,77,0,1,0
9,426,426,63,63,0,1,0
4,431,431,19,19,0,1,0
38,433,433,9,9,0,1,0
36,447,447,8,2,6,2,1
21,452,452,49,25,24,2,1
35,452,452,12,12,0,1,0
37,465,465,58,58,0,1,0
23,488,488,21,5,16,3,2
10,493,493,22,22,0,1,0
22,494,494,55,48,7,2,1
19,498,498,15,15,0,1,0

23,120,120,3,3,0,1,0
34,121,121,11,1,10,3,2
29,132,132,1,1,0,1,0
9,141,141,16,16,0,1,0
22,148,148,12,12,0,1,0
12,154,154,2,2,0,1,0
15,155,155,24,24,0,1,0
6,164,164,12,12,0,1,0
27,171,171,10,10,0,1,0
17,178,178,18,4,14,2,1
30,178,178,67,17,50,3,2
31,186,186,1,1,0,1,0
11,187,187,5,5,0,1,0
1,194,194,107,98,9,4,3
19,201,201,7,7,0,1,0
0,209,209,3,3,0,1,0
37,223,223,12,5,7,2,1
3,228,228,2,2,0,1,0
33,257,257,2,2,0,1,0
10,291,291,17,17,0,1,0
18,292,292,47,23,24,3,2
25,301,301,22,22,0,1,0
24,327,327,24,24,0,1,0
28,350,350,8,8,0,1,0
26,354,354,31,25,6,2,1
4,354,354,6,6,0,1,0
32,365,365,19,19,0,1,0
21,366,366,41,15,26,3,2
14,374,374,14,14,0,1,0
2,388,388,76,14,62,4,3
5,389,389,41,41,0,1,0
7,394,394,57,24,33,4,3
16,400,400,19,19,0,1,0
20,411,411,12,12,0,1,0
8,426,426,22,2,20,2,1
36,436,436,297,273,24,2,1
35,457,457,31,7,24,3,2
13,472,472,12,12,0,1,0

5,104,104,3,3,0,1,0
31,106,106,10,10,0,1,0
0,108,108,11,11,0,1,0
14,109,109,42,42,0,1,0
7,113,113,4,4,0,1,0
26,135,135,1,1,0,1,0
11,184,184,23,23,0,1,0
8,214,214,38,38,0,1,0
30,218,218,1,1,0,1,0
22,239,239,95,20,75,4,3
9,251,251,20,8,12,4,3
13,264,264,48,7,41,4,3
16,313,313,27,27,0,1,0
3,329,329,93,53,40,2,1
6,355,355,17,17,0,1,0
1,366,366,14,14,0,1,0
10,367,367,187,187,0,1,0
4,381,381,29,29,0,1,0
2,397,397,29,15,14,2,1
28,405,405,24,24,0,1,0
24,405,405,36,7,29,2,1
23,406,406,29,29,0,1,0
29,408,408,1,1,0,1,0
12,414,414,60,60,0,1,0
21,423,423,14,14,0,1,0
19,428,428,32,32,0,1,0
15,430,430,116,86,30,2,1
18,454,454,7,7,0,1,0
20,471,471,5,5,0,1,0
17,479,479,46,46,0,1,0
27,494,494,59,54,5,2,1
32,496,496,31,31,0,1,0
25,497,497,27,5,22,3,2

26,128,128,1,1,0,1,0
22,130,130,20,20,0,1,0
16,134,134,4,4,0,1,0
13,145,145,16,16,0,1,0
35,158,158,1,1,0,1,0
32,162,162,6,6,0,1,0
15,169,169,27,3,24,2,1
29,170,170,18,18,0,1,0
10,187,187,3,3,0,1,0
20,189,189,2,2,0,1,0
7,221,221,41,20,21,4,3
17,223,223,4,4,0,1,0
4,231,231,26,26,0,1,0
19,234,234,20,20,0,1,0
3,245,245,54,54,0,1,0
21,269,269,19,15,4,2,1
23,274,274,6,6,0,1,0
5,284,284,30,30,0,1,0
30,290,290,110,9,101,4,3
1,290,290,12,12,0,1,0
33,300,300,48,19,29,2,1
8,359,359,20,2,18,4,3
6,363,363,99,20,79,3,2
18,384,384,27,4,23,2,1
34,414,414,84,41,43,2,1
9,415,415,39,8,31,2,1
0,420,420,9,3,6,3,2
2,424,424,28,28,0,1,0
14,439,439,126,107,19,2,1
11,442,442,10,2,8,3,2
31,469,469,74,20,54,4,3
12,472,472,47,47,0,1,0
27,473,473,31,7,24,3,2
25,482,482,80,50,30,2,1
24,490,490,95,73,22,3,2
28,497,497,12,1,11,2,1

5,108,108,13,13,0,1,0
29,158,158,1,1,0,1,0
25,161,161,3,3,0,1,0
3,185,185,27,10,17,2,1
20,197,197,7,4,3,2,1
1,210,210,2,2,0,1,0
27,217,217,34,3,31,3,2
14,225,225,6,6,0,1,0
23,241,241,19,19,0,1,0
21,264,264,107,107,0,1,0
10,272,272,133,101,32,2,1
0,278,278,26,4,22,2,1
6,279,279,33,9,24,2,1
16,286,286,12,3,9,2,1
11,290,290,18,18,0,1,0
18,293,293,10,4,6,2,1
30,315,315,2,2,0,1,0
8,318,318,16,6,10,2,1
13,319,319,52,52,0,1,0
9,337,337,1,1,0,1,0
31,374,374,6,6,0,1,0
17,391,391,39,39,0,1,0
12,402,402,105,6,99,4,3
19,404,404,52,31,21,4,3
15,406,406,1,1,0,1,0
22,420,420,42,42,0,1,0
28,422,422,179,107,72,4,3
26,428,428,28,19,9,2,1
2,468,468,22,22,0,1,0
4,472,472,1,1,0,1,0
32,474,474,31,22,9,2,1
24,481,481,106,62,44,2,1
7,498,498,167,146,21,4,3

35,170,170,71,54,17,4,3
31,171,171,3,3,0,1,0
24,215,215,28,4,24,2,1
23,228,228,15,15,0,1,0
30,232,232,11,2,9,4,3
20,235,235,19,19,0,1,0
16,243,243,21,16,5,2,1
22,246,246,61,23,38,3,2
13,250,250,28,28,0,1,0
17,258,258,30,18,12,4,3
26,263,263,41,41,0,1,0
28,264,264,45,45,0,1,0
9,273,273,56,19,37,4,3
10,280,280,1,1,0,1,0
12,287,287,25,13,12,2,1
3,290,290,5,5,0,1,0
19,296,296,7,7,0,1,0
14,314,314,30,30,0,1,0
0,317,317,9,9,0,1,0
29,322,322,67,9,58,4,3
8,322,322,21,21,0,1,0
18,323,323,5,5,0,1,0
25,327,327,8,8,0,1,0
1,339,339,105,105,0,1,0
5,347,347,36,36,0,1,0
34,354,354,13,13,0,1,0
11,405,405,99,99,0,1,0
4,418,418,65,65,0,1,0
7,434,434,93,46,47,2,1
27,439,439,6,6,0,1,0
33,446,446,17,9,8,3,2
32,451,451,16,16,0,1,0
6,465,465,60,16,44,2,1
2,471,471,16,16,0,1,0
15,486,486,6,6,0,1,0
21,494,494,45,24,21,2,1

22,105,105,3,3,0,1,0
19,107,107,11,4,7,2,1
8,127,127,22,8,14,2,1
11,136,136,35,29,6,2,1
0,149,149,6,6,0,1,0
24,162,162,4,4,0,1,0
32,163,163,32,32,0,1,0
1,164,164,42,21,21,4,3
20,176,176,15,15,0,1,0
2,178,178,5,5,0,1,0
3,247,247,25,8,17,2,1
7,265,265,38,14,24,3,2
28,290,290,16,16,0,1,0
14,290,290,16,16,0,1,0
12,304,304,2,2,0,1,0
17,311,311,7,7,0,1,0
33,315,315,54,54,0,1,0
35,319,319,13,1,12,3,2
29,334,334,41,41,0,1,0
13,336,336,17,17,0,1,0
18,339,339,109,45,64,3,2
37,347,347,55,17,38,2,1
9,362,362,19,19,0,1,0
23,363,363,23,14,9,4,3
26,370,370,29,29,0,1,0
15,386,386,64,36,28,2,1
27,388,388,54,54,0,1,0
10,397,397,19,19,0,1,0
21,417,417,88,88,0,1,0
5,432,432,65,35,30,3,2
4,435,435,8,8,0,1,0
6,435,435,1,1,0,1,0
30,449,449,76,70,6,2,1
36,450,450,14,4,10,2,1
34,463,463,97,69,28,2,1
31,464,464,7,7,0,1,0
25,475,475,14,2,12,4,3
16,495,495,4,1,3,2,1

25,108,108,1,1,0,1,0
13,123,123,33,33,0,1,0
11,123,123,14,14,0,1,0
8,130,130,4,1,3,2,1
20,134,134,1,1,0,1,0
14,142,142,1,1,0,1,0
17,154,154,4,4,0,1,0
28,166,166,2,2,0,1,0
21,167,167,2,2,0,1,0
6,173,173,6,6,0,1,0
39,204,204,24,16,8,3,2
26,212,212,3,3,0,1,0
12,212,212,25,25,0,1,0
16,219,219,9,2,7,2,1
23,241,241,6,6,0,1,0
35,247,247,103,103,0,1,0
7,250,250,60,52,8,2,1
15,251,251,1,1,0,1,0
24,262,262,5,5,0,1,0
0,269,269,74,43,31,2,1
1,285,285,2,2,0,1,0
3,293,293,47,32,15,2,1
32,294,294,152,50,102,4,3
37,296,296,18,18,0,1,0
38,303,303,5,5,0,1,0
9,317,317,47,2,45,2,1
5,323,323,1,1,0,1,0
18,329,329,28,19,9,4,3
2,342,342,3,3,0,1,0
29,343,343,28,28,0,1,0
36,349,349,45,45,0,1,0
27,356,356,1,1,0,1,0
4,356,356,48,48,0,1,0
40,363,363,57,57,0,1,0
31,373,373,1,1,0,1,0
34,378,378,75,35,40,3,2
22,392,392,12,12,0,1,0
10,399,399,53,1,52,3,2
19,412,412,5,5,0,1,0
33,417,417,22,22,0,1,0
30,459,459,14,5,9,2,1
41,479,479,37,37,0,1,0

14,107,107,6,1,5,2,1
25,117,117,23,23,0,1,0
17,137,137,1,1,0,1,0
4,151,151,4,4,0,1,0
5,153,153,6,1,5,2,1
38,157,157,7,3,4,2,1
26,208,208,44,28,16,2,1
3,210,210,32,10,22,2,1
31,220,220,8,8,0,1,0
8,236,236,8,3,5,2,1
10,236,236,10,6,4,2,1
41,238,238,39,29,10,2,1
37,243,243,21,9,12,4,3
30,244,244,20,2,18,3,2
32,250,250,18,18,0,1,0
12,255,255,23,23,0,1,0
24,270,270,42,42,0,1,0
34,280,280,27,12,15,2,1
27,289,289,1,1,0,1,0
0,293,293,6,1,5,2,1
9,330,330,59,59,0,1,0
29,332,332,44,38,6,2,1
1,350,350,28,22,6,3,2
42,364,364,8,2,6,2,1
33,372,372,28,28,0,1,0
2,375,375,24,6,18,2,1
16,381,381,14,7,7,2,1
36,389,389,98,98,0,1,0
7,393,393,46,46,0,1,0
20,398,398,43,43,0,1,0
39,409,409,29,17,12,4,3
28,421,421,59,59,0,1,0
21,427,427,22,22,0,1,0
11,439,439,1,1,0,1,0
18,440,440,67,47,20,3,2
15,447,447,16,16,0,1,0
6,448,448,64,64,0,1,0
35,457,457,41,41,0,1,0
13,459,459,63,63,0,1,0
23,460,460,20,20,0,1,0
40,462,462,5,1,4,2,1
19,471,471,87,87,0,1,0
22,499,499,49,49,0,1,0

12,105,105,13,3,10,3,2
26,105,105,9,2,7,2,1
7,106,106,17,17,0,1,0
33,115,115,7,3,4,2,1
8,117,117,5,5,0,1,0
31,124,124,12,12,0,1,0
30,142,142,36,3,33,4,3
19,146,146,1,1,0,1,0
36,163,163,8,8,0,1,0
24,164,164,2,2,0,1,0
6,171,171,9,1,8,2,1
14,175,175,20,20,0,1,0
25,197,197,31,7,24,3,2
10,198,198,11,11,0,1,0
13,206,206,4,1,3,2,1
22,206,206,29,24,5,2,1
17,216,216,14,14,0,1,0
1,228,228,46,46,0,1,0
32,229,229,2,2,0,1,0
4,230,230,5,5,0,1,0
3,285,285,4,4,0,1,0
5,289,289,64,35,29,4,3
11,296,296,1,1,0,1,0
38,303,303,9,4,5,2,1
15,310,310,64,34,30,2,1
37,310,310,2,2,0,1,0
20,315,315,7,7,0,1,0
0,321,321,8,4,4,2,1
9,333,333,19,19,0,1,0
28,335,335,22,13,9,2,1
21,337,337,32,32,0,1,0
39,370,370,111,54,57,4,3
27,382,382,23,14,9,2,1
29,389,389,79,79,0,1,0
16,392,392,64,40,24,4,3
18,423,423,35,35,0,1,0
40,432,432,69,32,37,2,1
23,436,436,57,21,36,3,2
34,454,454,47,9,38,2,1
35,460,460,15,15,0,1,0
2,467,467,69,47,22,3,2

39,103,103,20,5,15,2,1
5,113,113,11,6,5,2,1
14,161,161,13,1,12,3,2
25,178,178,66,66,0,1,0
19,185,185,20,15,5,2,1
20,186,186,29,11,18,4,3
12,189,189,22,5,17,2,1
40,190,190,27,27,0,1,0
31,192,192,9,2,7,3,2
17,204,204,39,39,0,1,0
1,215,215,2,2,0,1,0
18,215,215,12,12,0,1,0
42,218,218,24,9,15,4,3
35,229,229,10,7,3,2,1
41,235,235,20,20,0,1,0
8,265,265,29,29,0,1,0
28,293,293,20,20,0,1,0
2,300,300,8,8,0,1,0
21,313,313,22,13,9,4,3
15,331,331,23,23,0,1,0
33,356,356,18,12,6,2,1
6,357,357,51,3,48,3,2
29,358,358,68,46,22,3,2
32,359,359,36,24,12,3,2
37,368,368,9,4,5,2,1
34,378,378,5,5,0,1,0
24,382,382,41,41,0,1,0
13,393,393,19,19,0,1,0
10,401,401,40,40,0,1,0
27,407,407,4,4,0,1,0
3,408,408,64,64,0,1,0
0,412,412,11,11,0,1,0
4,415,415,21,7,14,2,1
9,416,416,23,6,17,2,1
26,420,420,72,67,5,2,1
38,422,422,9,9,0,1,0
23,426,426,24,24,0,1,0
16,430,430,21,4,17,2,1
22,437,437,16,6,10,3,2
30,454,454,43,43,0,1,0
7,454,454,7,7,0,1,0
36,464,464,42,22,20,2,1
11,472,472,34,34,0,1,0

2,137,137,7,2,5,2,1
14,141,141,5,2,3,2,1
25,150,150,20,4,16,3,2
17,188,188,9,9,0,1,0
12,197,197,36,36,0,1,0
19,200,200,8,3,5,2,1
9,208,208,32,19,13,2,1
32,212,212,23,23,0,1,0
4,213,213,43,43,0,1,0
15,234,234,5,5,0,1,0
20,252,252,2,2,0,1,0
27,255,255,62,62,0,1,0
29,270,270,34,34,0,1,0
3,272,272,54,54,0,1,0
6,277,277,2,2,0,1,0
10,284,284,44,34,10,2,1
18,284,284,27,15,12,2,1
22,315,315,45,19,26,2,1
16,348,348,110,32,78,3,2
11,354,354,73,3,70,3,2
5,360,360,20,20,0,1,0
7,362,362,34,26,8,2,1
26,374,374,96,70,26,4,3
24,431,431,15,6,9,4,3
23,448,448,3,3,0,1,0
31,449,449,15,3,12,3,2
21,464,464,71,57,14,3,2
28,470,470,53,43,10,2,1
30,476,476,10,10,0,1,0
0,481,481,130,80,50,3,2
33,490,490,17,5,12,4,3
8,490,490,5,5,0,1,0
13,490,490,23,23,0,1,0
1,495,495,116,58,58,3,2

35,102,102,4,4,0,1,0
24,103,103,5,5,0,1,0
17,106,106,2,2,0,1,0
21,112,112,7,1,6,2,1
6,113,113,5,2,3,2,1
29,122,122,12,12,0,1,0
38,133,133,20,14,6,3,2
25,157,157,6,6,0,1,0
37,163,163,6,6,0,1,0
0,169,169,1,1,0,1,0
2,192,192,17,17,0,1,0
10,194,194,3,3,0,1,0
4,197,197,11,5,6,3,2
14,198,198,84,36,48,4,3
16,206,206,37,37,0,1,0
34,210,210,8,5,3,2,1
1,223,223,24,16,8,2,1
18,243,243,12,12,0,1,0
27,244,244,7,7,0,1,0
9,249,249,14,14,0,1,0
8,253,253,12,12,0,1,0
31,309,309,28,4,24,3,2
30,322,322,16,5,11,3,2
28,323,323,9,9,0,1,0
26,330,330,42,4,38,3,2
33,359,359,55,13,42,3,2
20,377,377,13,13,0,1,0
36,400,400,207,198,9,2,1
3,425,425,39,33,6,3,2
39,426,426,71,71,0,1,0
13,438,438,29,13,16,2,1
32,439,439,94,94,0,1,0
11,440,440,1,1,0,1,0
23,462,462,2,2,0,1,0
22,462,462,27,9,18,4,3
12,466,466,112,62,50,3,2
15,481,481,19,19,0,1,0
5,483,483,119,77,42,3,2
7,488,488,27,27,0,1,0
19,491,491,15,7,8,3,2

30,102,102,3,3,0,1,0
6,105,105,6,6,0,1,0
7,107,107,5,5,0,1,0
33,121,121,5,5,0,1,0
3,124,124,8,8,0,1,0
14,134,134,14,14,0,1,0
11,153,153,3,3,0,1,0
40,161,161,11,11,0,1,0
0,171,171,7,3,4,2,1
8,173,173,18,5,13,2,1
2,178,178,1,1,0,1,0
23,179,179,3,3,0,1,0
43,197,197,18,14,4,2,1
36,197,197,11,4,7,2,1
24,199,199,1,1,0,1,0
25,205,205,2,2,0,1,0
29,220,220,55,55,0,1,0
38,222,222,1,1,0,1,0
37,228,228,60,60,0,1,0
15,239,239,1,1,0,1,0
32,244,244,4,4,0,1,0
45,264,264,12,12,0,1,0
39,267,267,5,5,0,1,0
20,268,268,17,17,0,1,0
21,273,273,86,2,84,4,3
12,290,290,10,5,5,2,1
34,322,322,33,25,8,2,1
18,328,328,103,103,0,1,0
5,330,330,7,2,5,2,1
26,333,333,48,48,0,1,0
13,345,345,6,3,3,2,1
16,362,362,12,12,0,1,0
28,369,369,170,132,38,4,3
41,372,372,65,7,58,3,2
4,387,387,10,10,0,1,0
9,387,387,10,10,0,1,0
44,388,388,24,5,19,4,3
46,390,390,55,55,0,1,0
22,402,402,12,6,6,2,1
1,409,409,27,27,0,1,0
31,420,420,32,5,27,4,3
17,434,434,26,16,10,3,2
35,436,436,10,10,0,1,0
42,445,445,3,3,0,1,0
19,447,447,50,14,36,3,2
10,467,467,40,16,24,2,1
27,492,492,37,7,30,4,3

13,104,104,46,6,40,2,1
14,117,117,12,2,10,2,1
26,119,119,7,3,4,2,1
1,131,131,28,28,0,1,0
22,147,147,19,19,0,1,0
10,165,165,6,3,3,2,1
30,173,173,19,19,0,1,0
3,195,195,32,16,16,3,2
11,199,199,13,1,12,4,3
8,207,207,1,1,0,1,0
0,211,211,4,4,0,1,0
6,227,227,4,4,0,1,0
27,256,256,21,21,0,1,0
2,276,276,17,17,0,1,0
15,280,280,4,4,0,1,0
20,282,282,7,7,0,1,0
31,298,298,11,11,0,1,0
7,299,299,70,10,60,4,3
35,302,302,4,4,0,1,0
17,309,309,4,4,0,1,0
16,316,316,17,10,7,2,1
25,326,326,22,22,0,1,0
18,343,343,41,3,38,4,3
33,346,346,39,39,0,1,0
23,350,350,113,73,40,4,3
37,402,402,74,74,0,1,0
9,407,407,61,61,0,1,0
19,415,415,10,10,0,1,0
34,423,423,106,7,99,4,3
24,425,425,43,35,8,3,2
38,439,439,1,1,0,1,0
36,445,445,46,46,0,1,0
12,449,449,1,1,0,1,0
28,464,464,13,6,7,2,1
32,467,467,93,84,9,4,3
21,477,477,3,3,0,1,0
29,480,480,47,3,44,2,1
5,481,481,77,46,31,2,1
4,481,481,1,1,0,1,0

0,106,106,5,2,3,2,1
6,136,136,23,15,8,3,2
8,143,143,7,7,0,1,0
3,161,161,14,14,0,1,0
14,161,161,8,8,0,1,0
16,181,181,30,30,0,1,0
20,185,185,46,46,0,1,0
1,188,188,103,103,0,1,0
29,200,200,10,10,0,1,0
30,209,209,5,5,0,1,0
19,235,235,6,6,0,1,0
10,241,241,83,76,7,2,1
5,251,251,3,3,0,1,0
7,261,261,11,11,0,1,0
4,317,317,36,36,0,1,0
11,331,331,19,19,0,1,0
21,345,345,95,95,0,1,0
27,357,357,14,14,0,1,0
13,366,366,25,3,22,2,1
25,373,373,105,105,0,1,0
28,377,377,9,9,0,1,0
31,383,383,38,38,0,1,0
9,385,385,17,2,15,2,1
18,402,402,63,63,0,1,0
12,402,402,71,53,18,3,2
2,414,414,87,87,0,1,0
24,425,425,61,61,0,1,0
23,430,430,23,23,0,1,0
26,434,434,49,49,0,1,0
22,455,455,38,38,0,1,0
17,460,460,9,5,4,2,1
15,488,488,8,8,0,1,0

9,105,105,11,5,6,2,1
25,125,125,16,12,4,2,1
20,141,141,1,1,0,1,0
12,165,165,21,1,20,2,1
0,182,182,22,22,0,1,0
15,184,184,2,2,0,1,0
11,196,196,19,19,0,1,0
16,198,198,19,3,16,3,2
19,220,220,36,36,0,1,0
33,223,223,30,18,12,4,3
32,236,236,26,14,12,2,1
26,248,248,40,25,15,3,2
2,251,251,77,5,72,4,3
31,262,262,13,5,8,2,1
5,264,264,27,27,0,1,0
18,279,279,15,2,13,2,1
30,309,309,13,13,0,1,0
13,325,325,43,43,0,1,0
23,327,327,79,79,0,1,0
6,332,332,14,3,11,2,1
8,342,342,80,23,57,4,3
14,344,344,36,36,0,1,0
21,360,360,90,74,16,3,2
17,370,370,37,37,0,1,0
22,409,409,27,27,0,1,0
3,421,421,48,48,0,1,0
24,429,429,1,1,0,1,0
4,437,437,124,124,0,1,0
29,460,460,101,101,0,1,0
7,473,473,32,8,24,2,1
27,474,474,33,22,11,2,1
10,489,489,1,1,0,1,0
28,494,494,13,4,9,2,1
1,495,495,30,30,0,1,0

9,122,122,4,4,0,1,0
6,130,130,9,9,0,1,0
7,137,137,15,15,0,1,0
3,141,141,23,8,15,2,1
22,153,153,2,2,0,1,0
20,165,165,48,18,30,4,3
24,176,176,32,4,28,2,1
12,184,184,34,12,22,2,1
28,203,203,21,21,0,1,0
13,218,218,22,22,0,1,0
8,228,228,14,14,0,1,0
1,228,228,28,28,0,1,0
16,234,234,35,35,0,1,0
26,252,252,19,7,12,3,2
0,271,271,106,72,34,2,1
4,278,278,88,21,67,4,3
15,298,298,13,13,0,1,0
27,302,302,1,1,0,1,0
30,315,315,35,35,0,1,0
2,348,348,5,5,0,1,0
14,349,349,5,1,4,2,1
23,353,353,6,2,4,2,1
11,365,365,16,16,0,1,0
19,367,367,28,20,8,3,2
10,379,379,33,18,15,4,3
25,381,381,45,45,0,1,0
21,396,396,22,22,0,1,0
17,403,403,6,3,3,2,1
5,440,440,215,215,0,1,0
29,480,480,17,17,0,1,0
18,498,498,175,137,38,2,1

16,112,112,8,8,0,1,0
22,120,120,1,1,0,1,0
40,134,134,18,12,6,3,2
36,134,134,32,12,20,4,3
27,148,148,41,29,12,4,3
9,149,149,3,3,0,1,0
25,161,161,11,11,0,1,0
39,176,176,22,15,7,2,1
12,177,177,28,28,0,1,0
4,182,182,1,1,0,1,0
31,195,195,5,5,0,1,0
37,212,212,18,18,0,1,0
21,218,218,8,8,0,1,0
32,219,219,1,1,0,1,0
6,226,226,13,4,9,2,1
5,239,239,4,4,0,1,0
18,247,247,20,6,14,3,2
35,257,257,13,13,0,1,0
44,269,269,12,12,0,1,0
11,278,278,25,17,8,2,1
0,278,278,6,6,0,1,0
42,282,282,19,19,0,1,0
17,287,287,1,1,0,1,0
33,292,292,57,57,0,1,0
38,293,293,19,3,16,3,2
8,298,298,62,23,39,4,3
43,319,319,48,15,33,2,1
2,326,326,26,6,20,3,2
20,330,330,47,47,0,1,0
15,338,338,5,2,3,2,1
24,339,339,4,4,0,1,0
41,351,351,30,8,22,3,2
23,353,353,9,3,6,3,2
19,362,362,62,21,41,2,1
7,366,366,5,2,3,2,1
28,390,390,49,49,0,1,0
1,411,411,31,4,27,4,3
34,425,425,6,1,5,2,1
3,428,428,36,2,34,4,3
14,465,465,114,98,16,3,2
10,469,469,1,1,0,1,0
30,471,471,26,5,21,4,3
26,471,471,21,21,0,1,0
29,474,474,72,72,0,1,0
13,481,481,91,67,24,3,2

0,130,130,3,3,0,1,0
23,133,133,11,4,7,2,1
32,135,135,11,11,0,1,0
34,155,155,17,9,8,3,2
18,157,157,1,1,0,1,0
4,159,159,50,2,48,2,1
2,162,162,24,1,23,4,3
7,167,167,20,20,0,1,0
31,175,175,12,12,0,1,0
14,186,186,2,2,0,1,0
19,202,202,19,19,0,1,0
27,216,216,1,1,0,1,0
30,237,237,55,27,28,2,1
12,248,248,43,43,0,1,0
16,251,251,8,2,6,3,2
29,286,286,55,55,0,1,0
21,292,292,11,11,0,1,0
3,297,297,54,54,0,1,0
37,305,305,19,19,0,1,0
13,310,310,21,6,15,4,3
6,314,314,1,1,0,1,0
26,328,328,36,4,32,3,2
28,339,339,5,5,0,1,0
8,342,342,22,22,0,1,0
9,347,347,3,3,0,1,0
33,361,361,23,23,0,1,0
15,366,366,66,32,34,3,2
17,386,386,108,69,39,4,3
5,386,386,50,23,27,2,1
1,407,407,1,1,0,1,0
36,409,409,78,57,21,4,3
10,417,417,42,25,17,3,2
22,448,448,8,5,3,2,1
25,455,455,94,45,49,4,3
35,471,471,37,37,0,1,0
20,480,480,77,70,7,2,1
11,481,481,26,26,0,1,0
24,500,500,62,17,45,4,3

32,114,114,8,8,0,1,0
31,126,126,31,31,0,1,0
19,132,132,3,3,0,1,0
3,144,144,36,36,0,1,0
0,165,165,12,12,0,1,0
18,189,189,22,22,0,1,0
13,195,195,12,12,0,1,0
6,209,209,13,13,0,1,0
28,241,241,2,2,0,1,0
5,243,243,1,1,0,1,0
8,259,259,4,4,0,1,0
20,274,274,44,44,0,1,0
26,291,291,81,21,60,3,2
23,296,296,29,2,27,4,3
12,297,297,82,54,28,3,2
21,309,309,23,23,0,1,0
33,315,315,21,21,0,1,0
15,317,317,44,44,0,1,0
27,334,334,14,14,0,1,0
34,337,337,16,16,0,1,0
24,352,352,24,15,9,4,3
11,357,357,11,2,9,4,3
29,361,361,50,32,18,4,3
2,415,415,31,9,22,3,2
1,423,423,81,42,39,2,1
14,424,424,170,170,0,1,0
16,443,443,8,8,0,1,0
22,443,443,1,1,0,1,0
4,447,447,6,6,0,1,0
7,467,467,5,5,0,1,0
25,468,468,144,99,45,2,1
17,471,471,26,20,6,3,2
30,472,472,56,26,30,2,1
10,477,477,1,1,0,1,0
9,484,484,143,37,106,4,3

23,109,109,4,4,0,1,0
36,122,122,3,3,0,1,0
6,124,124,2,2,0,1,0
8,169,169,57,7,50,3,2
17,195,195,15,15,0,1,0
20,196,196,20,20,0,1,0
37,207,207,54,54,0,1,0
32,210,210,8,8,0,1,0
34,218,218,14,14,0,1,0
12,234,234,11,11,0,1,0
18,248,248,52,52,0,1,0
4,263,263,33,24,9,2,1
10,271,271,18,9,9,2,1
21,280,280,25,25,0,1,0
28,285,285,11,2,9,4,3
11,294,294,36,27,9,4,3
24,295,295,22,9,13,2,1
7,315,315,57,24,33,3,2
25,344,344,16,3,13,2,1
0,347,347,38,3,35,4,3
14,353,353,1,1,0,1,0
35,357,357,10,2,8,2,1
13,368,368,12,12,0,1,0
15,369,369,14,14,0,1,0
31,369,369,52,2,50,2,1
27,381,381,13,13,0,1,0
1,384,384,25,22,3,2,1
19,402,402,72,72,0,1,0
9,404,404,2,2,0,1,0
29,412,412,31,9,22,3,2
22,423,423,71,39,32,2,1
3,425,425,38,22,16,4,3
16,439,439,103,82,21,4,3
2,448,448,55,20,35,2,1
33,451,451,100,80,20,2,1
30,452,452,39,39,0,1,0
5,486,486,10,10,0,1,0
26,488,488,108,96,12,3,2

28,102,102,3,3,0,1,0
40,116,116,4,4,0,1,0
11,134,134,2,2,0,1,0
12,145,145,36,6,30,4,3
7,149,149,1,1,0,1,0
29,171,171,21,21,0,1,0
26,173,173,6,2,4,2,1
20,193,193,4,4,0,1,0
19,196,196,4,4,0,1,0
36,201,201,30,30,0,1,0
23,226,226,10,6,4,2,1
6,229,229,2,2,0,1,0
35,231,231,41,41,0,1,0
39,234,234,3,3,0,1,0
10,235,235,3,3,0,1,0
42,257,257,2,2,0,1,0
25,265,265,51,16,35,4,3
3,273,273,27,27,0,1,0
13,273,273,75,75,0,1,0
2,276,276,60,45,15,4,3
18,291,291,13,13,0,1,0
21,297,297,21,3,18,3,2
32,300,300,12,12,0,1,0
15,300,300,36,12,24,4,3
9,302,302,11,2,9,4,3
16,303,303,8,8,0,1,0
4,318,318,21,21,0,1,0
1,320,320,9,9,0,1,0
8,324,324,69,25,44,3,2
38,330,330,89,89,0,1,0
24,332,332,136,136,0,1,0
30,341,341,57,57,0,1,0
5,360,360,3,3,0,1,0
37,369,369,3,3,0,1,0
0,374,374,4,4,0,1,0
31,387,387,55,28,27,4,3
41,416,416,32,32,0,1,0
34,425,425,2,2,0,1,0
17,445,445,15,6,9,4,3
27,464,464,2,2,0,1,0
33,472,472,24,24,0,1,0
22,474,474,31,16,15,4,3
14,492,492,104,24,80,4,3

21,106,106,9,9,0,1,0
32,134,134,25,25,0,1,0
13,158,158,8,2,6,2,1
2,159,159,12,2,10,3,2
22,159,159,17,17,0,1,0
1,166,166,1,1,0,1,0
4,166,166,43,43,0,1,0
7,173,173,20,20,0,1,0
14,191,191,20,16,4,2,1
33,206,206,14,8,6,3,2
3,215,215,53,10,43,2,1
24,231,231,31,31,0,1,0
19,275,275,7,7,0,1,0
31,290,290,30,30,0,1,0
10,316,316,40,40,0,1,0
11,324,324,117,117,0,1,0
12,332,332,73,1,72,3,2
8,350,350,30,22,8,2,1
27,353,353,102,54,48,4,3
17,366,366,5,5,0,1,0
0,372,372,1,1,0,1,0
23,390,390,71,25,46,2,1
30,401,401,38,11,27,4,3
20,403,403,81,81,0,1,0
28,416,416,18,18,0,1,0
18,424,424,34,34,0,1,0
9,427,427,72,58,14,2,1
5,432,432,30,14,16,3,2
16,436,436,6,3,3,2,1
6,439,439,4,4,0,1,0
15,479,479,12,6,6,2,1
29,484,484,30,12,18,4,3
26,490,490,53,53,0,1,0
25,497,497,57,57,0,1,0

18,101,101,5,5,0,1,0
5,101,101,9,9,0,1,0
31,105,105,45,36,9,2,1
13,105,105,4,4,0,1,0
32,118,118,4,4,0,1,0
28,122,122,2,2,0,1,0
19,127,127,13,13,0,1,0
27,129,129,7,7,0,1,0
30,129,129,24,16,8,3,2
37,137,137,11,1,10,3,2
26,156,156,17,14,3,2,1
33,168,168,35,35,0,1,0
38,172,172,14,8,6,3,2
16,174,174,14,14,0,1,0
9,199,199,21,21,0,1,0
23,205,205,30,30,0,1,0
36,217,217,4,4,0,1,0
14,229,229,2,2,0,1,0
39,231,231,1,1,0,1,0
35,239,239,1,1,0,1,0
12,240,240,55,55,0,1,0
17,249,249,6,6,0,1,0
29,258,258,68,59,9,4,3
1,260,260,6,6,0,1,0
11,264,264,12,1,11,2,1
22,282,282,6,6,0,1,0
24,288,288,17,17,0,1,0
34,341,341,15,4,11,2,1
15,342,342,23,2,21,4,3
6,362,362,46,30,16,3,2
20,394,394,45,45,0,1,0
0,397,397,1,1,0,1,0
2,420,420,32,5,27,4,3
10,424,424,60,50,10,3,2
3,426,426,74,66,8,3,2
8,456,456,105,105,0,1,0
21,458,458,77,3,74,3,2
4,463,463,39,12,27,2,1
7,471,471,42,42,0,1,0
25,478,478,6,6,0,1,0

1,112,112,35,35,0,1,0
17,112,112,7,7,0,1,0
30,114,114,4,4,0,1,0
31,118,118,11,8,3,2,1
19,124,124,7,7,0,1,0
16,136,136,9,9,0,1,0
9,160,160,64,64,0,1,0
21,167,167,3,3,0,1,0
4,174,174,1,1,0,1,0
11,174,174,10,3,7,2,1
32,183,183,2,2,0,1,0
40,202,202,28,12,16,4,3
29,208,208,1,1,0,1,0
25,214,214,32,32,0,1,0
38,217,217,17,17,0,1,0
33,223,223,35,20,15,4,3
27,228,228,36,36,0,1,0
7,270,270,8,8,0,1,0
39,272,272,3,3,0,1,0
23,288,288,14,14,0,1,0
2,290,290,4,1,3,2,1
6,296,296,20,3,17,2,1
28,297,297,67,22,45,4,3
0,304,304,3,3,0,1,0
18,306,306,7,1,6,3,2
37,312,312,107,15,92,4,3
42,338,338,28,28,0,1,0
8,351,351,19,5,14,3,2
22,360,360,6,6,0,1,0
3,370,370,28,14,14,3,2
36,382,382,8,8,0,1,0
24,383,383,51,10,41,4,3
13,393,393,80,80,0,1,0
41,408,408,78,78,0,1,0
34,410,410,10,2,8,2,1
14,413,413,1,1,0,1,0
10,423,423,46,46,0,1,0
35,454,454,37,22,15,4,3
5,458,458,69,7,62,3,2
15,461,461,21,21,0,1,0
12,475,475,14,14,0,1,0
26,484,484,6,6,0,1,0
20,497,497,22,9,13,2,1

17,108,108,1,1,0,1,0
24,109,109,1,1,0,1,0
8,114,114,1,1,0,1,0
18,122,122,1,1,0,1,0
46,129,129,11,11,0,1,0
5,130,130,17,17,0,1,0
33,142,142,6,6,0,1,0
6,145,145,2,2,0,1,0
47,159,159,5,5,0,1,0
13,167,167,27,27,0,1,0
35,193,193,8,8,0,1,0
44,198,198,9,9,0,1,0
28,199,199,13,3,10,3,2
9,213,213,5,5,0,1,0
40,227,227,20,4,16,2,1
38,231,231,32,32,0,1,0
4,233,233,20,20,0,1,0
27,242,242,10,10,0,1,0
14,248,248,35,23,12,2,1
21,254,254,7,7,0,1,0
29,283,283,20,5,15,4,3
20,285,285,12,12,0,1,0
42,285,285,19,19,0,1,0
2,286,286,1,1,0,1,0
10,312,312,42,11,31,2,1
43,313,313,4,1,3,2,1
3,317,317,3,3,0,1,0
1,318,318,1,1,0,1,0
7,322,322,40,10,30,3,2
15,324,324,34,14,20,3,2
37,338,338,6,6,0,1,0
32,339,339,120,74,46,3,2
36,353,353,25,25,0,1,0
22,356,356,25,25,0,1,0
45,365,365,34,34,0,1,0
41,381,381,223,184,39,2,1
0,381,381,1,1,0,1,0
25,391,391,63,63,0,1,0
34,392,392,30,3,27,2,1
11,419,419,9,9,0,1,0
23,429,429,120,21,99,4,3
39,442,442,2,2,0,1,0
30,459,459,11,1,10,3,2
19,463,463,46,46,0,1,0
12,466,466,25,25,0,1,0
26,474,474,15,1,14,3,2
16,489,489,16,1,15,4,3
31,497,497,46,46,0,1,0

5,100,100,10,1,9,2,1
2,119,119,16,16,0,1,0
34,127,127,16,16,0,1,0
6,146,146,6,6,0,1,0
9,147,147,1,1,0,1,0
10,148,148,11,11,0,1,0
28,156,156,19,5,14,2,1
33,169,169,14,14,0,1,0
1,181,181,71,71,0,1,0
30,187,187,44,44,0,1,0
18,192,192,39,6,33,4,3
13,195,195,17,2,15,4,3
29,198,198,8,2,6,2,1
26,207,207,21,9,12,2,1
25,219,219,2,2,0,1,0
8,237,237,15,3,12,2,1
15,244,244,15,15,0,1,0
27,271,271,17,6,11,2,1
14,272,272,2,2,0,1,0
0,290,290,45,45,0,1,0
19,320,320,12,12,0,1,0
32,333,333,5,5,0,1,0
12,356,356,43,43,0,1,0
22,366,366,11,11,0,1,0
3,369,369,11,4,7,2,1
36,376,376,21,12,9,4,3
31,395,395,39,31,8,2,1
17,410,410,59,36,23,2,1
20,438,438,12,3,9,4,3
7,447,447,35,35,0,1,0
21,449,449,212,212,0,1,0
11,469,469,1,1,0,1,0
23,471,471,9,9,0,1,0
16,474,474,106,106,0,1,0
35,476,476,89,50,39,4,3
4,477,477,86,10,76,3,2
24,485,485,3,3,0,1,0

27,101,101,4,4,0,1,0
33,105,105,8,8,0,1,0
30,105,105,17,11,6,2,1
7,113,113,4,4,0,1,0
28,115,115,11,5,6,2,1
13,118,118,14,14,0,1,0
21,130,130,27,18,9,4,3
6,147,147,11,6,5,2,1
14,154,154,18,18,0,1,0
10,160,160,8,8,0,1,0
8,166,166,34,34,0,1,0
34,196,196,26,2,24,4,3
12,203,203,5,5,0,1,0
29,208,208,10,10,0,1,0
11,213,213,10,10,0,1,0
0,239,239,14,14,0,1,0
24,243,243,20,6,14,2,1
31,246,246,2,2,0,1,0
5,262,262,10,10,0,1,0
26,277,277,1,1,0,1,0
32,290,290,65,15,50,2,1
9,297,297,2,2,0,1,0
18,298,298,40,18,22,3,2
1,319,319,146,76,70,4,3
17,320,320,27,3,24,4,3
4,326,326,78,50,28,2,1
22,329,329,55,55,0,1,0
25,365,365,91,74,17,4,3
23,401,401,14,14,0,1,0
19,403,403,22,22,0,1,0
3,435,435,46,46,0,1,0
15,447,447,129,87,42,4,3
16,478,478,62,62,0,1,0
2,482,482,16,6,10,2,1
20,483,483,11,11,0,1,0

19,118,118,4,4,0,1,0
27,118,118,6,2,4,2,1
21,126,126,11,11,0,1,0
32,145,145,20,1,19,4,3
5,193,193,37,17,20,3,2
9,198,198,11,11,0,1,0
2,204,204,35,7,28,3,2
23,214,214,22,13,9,4,3
6,222,222,31,15,16,2,1
17,233,233,4,4,0,1,0
34,235,235,52,30,22,3,2
1,238,238,6,6,0,1,0
37,244,244,63,63,0,1,0
15,256,256,14,14,0,1,0
14,266,266,1,1,0,1,0
26,266,266,12,12,0,1,0
24,272,272,32,32,0,1,0
36,275,275,40,23,17,2,1
13,294,294,53,29,24,4,3
16,304,304,36,2,34,2,1
12,316,316,52,15,37,2,1
30,318,318,34,34,0,1,0
33,333,333,21,5,16,3,2
3,342,342,53,53,0,1,0
18,344,344,17,17,0,1,0
29,357,357,27,27,0,1,0
0,372,372,15,9,6,3,2
7,403,403,25,25,0,1,0
20,415,415,15,6,9,4,3
25,418,418,35,2,33,4,3
10,437,437,73,23,50,2,1
35,451,451,44,26,18,4,3
22,452,452,20,4,16,3,2
8,454,454,59,53,6,3,2
28,475,475,31,31,0,1,0
11,478,478,54,48,6,2,1
4,492,492,30,30,0,1,0
31,495,495,83,83,0,1,0

5,108,108,2,2,0,1,0
0,136,136,30,30,0,1,0
2,157,157,10,10,0,1,0
14,157,157,11,7,4,2,1
30,163,163,7,1,6,3,2
23,182,182,1,1,0,1,0
34,191,191,29,29,0,1,0
32,191,191,30,30,0,1,0
22,211,211,23,23,0,1,0
1,254,254,6,2,4,2,1
31,255,255,33,24,9,4,3
27,260,260,25,8,17,2,1
11,262,262,22,1,21,4,3
13,262,262,6,6,0,1,0
37,263,263,67,61,6,3,2
19,286,286,32,32,0,1,0
12,293,293,43,9,34,3,2
36,300,300,64,41,23,2,1
26,324,324,18,18,0,1,0
24,349,349,5,2,3,2,1
16,359,359,7,7,0,1,0
29,373,373,17,12,5,2,1
8,394,394,5,5,0,1,0
15,395,395,91,61,30,4,3
10,399,399,43,43,0,1,0
3,399,399,52,16,36,3,2
4,406,406,60,60,0,1,0
6,408,408,60,35,25,4,3
17,420,420,43,27,16,3,2
33,431,431,88,88,0,1,0
35,436,436,39,39,0,1,0
25,437,437,6,6,0,1,0
20,443,443,32,2,30,4,3
7,449,449,49,49,0,1,0
28,455,455,37,2,35,2,1
18,461,461,49,49,0,1,0
21,462,462,43,38,5,2,1
9,475,475,65,65,0,1,0

24,118,118,19,3,16,3,2
27,121,121,8,8,0,1,0
13,174,174,17,5,12,4,3
19,174,174,21,21,0,1,0
23,186,186,4,4,0,1,0
16,194,194,47,47,0,1,0
11,220,220,18,5,13,4,3
4,237,237,12,12,0,1,0
21,267,267,8,8,0,1,0
31,272,272,24,16,8,3,2
2,283,283,93,57,36,3,2
26,285,285,23,2,21,4,3
7,286,286,131,131,0,1,0
28,298,298,69,10,59,4,3
14,320,320,5,5,0,1,0
0,325,325,128,128,0,1,0
22,326,326,38,38,0,1,0
8,329,329,1,1,0,1,0
12,333,333,54,27,27,4,3
5,349,349,72,10,62,4,3
25,353,353,16,8,8,3,2
29,380,380,21,21,0,1,0
6,380,380,5,5,0,1,0
1,383,383,13,13,0,1,0
20,389,389,8,2,6,3,2
3,431,431,3,3,0,1,0
32,433,433,134,134,0,1,0
15,438,438,22,22,0,1,0
18,449,449,25,25,0,1,0
30,458,458,83,39,44,3,2
17,467,467,24,24,0,1,0
10,495,495,32,32,0,1,0
9,500,500,1,1,0,1,0

2,114,114,8,8,0,1,0
30,126,126,10,10,0,1,0
25,145,145,17,17,0,1,0
22,155,155,20,2,18,2,1
15,169,169,55,10,45,4,3
21,170,170,14,14,0,1,0
1,174,174,51,27,24,3,2
13,186,186,2,2,0,1,0
18,197,197,1,1,0,1,0
8,205,205,12,12,0,1,0
32,206,206,3,3,0,1,0
11,230,230,26,26,0,1,0
28,237,237,49,49,0,1,0
3,262,262,50,31,19,4,3
34,265,265,10,10,0,1,0
29,266,266,15,15,0,1,0
20,322,322,12,12,0,1,0
33,323,323,35,35,0,1,0
9,327,327,48,37,11,2,1
36,331,331,75,75,0,1,0
4,340,340,37,3,34,3,2
27,342,342,58,58,0,1,0
14,350,350,81,31,50,2,1
16,360,360,24,3,21,4,3
17,366,366,29,1,28,2,1
35,371,371,116,116,0,1,0
5,385,385,19,7,12,4,3
7,387,387,15,15,0,1,0
24,393,393,38,22,16,3,2
19,397,397,1,1,0,1,0
6,408,408,9,9,0,1,0
23,409,409,38,38,0,1,0
31,436,436,62,14,48,2,1
12,441,441,19,19,0,1,0
0,450,450,15,15,0,1,0
26,490,490,12,3,9,2,1
10,492,492,10,10,0,1,0

10,114,114,6,6,0,1,0
12,120,120,3,3,0,1,0
0,130,130,2,2,0,1,0
24,133,133,6,6,0,1,0
28,138,138,11,2,9,2,1
25,139,139,1,1,0,1,0
19,142,142,60,15,45,4,3
3,148,148,1,1,0,1,0
5,159,159,32,10,22,3,2
14,160,160,46,5,41,3,2
7,169,169,13,13,0,1,0
22,184,184,18,18,0,1,0
29,208,208,11,3,8,3,2
20,232,232,23,23,0,1,0
18,235,235,8,2,6,3,2
32,318,318,30,16,14,3,2
21,318,318,18,18,0,1,0
11,327,327,57,9,48,4,3
9,331,331,77,66,11,2,1
8,332,332,3,3,0,1,0
4,344,344,66,66,0,1,0
6,347,347,43,43,0,1,0
1,363,363,17,5,12,3,2
33,367,367,11,11,0,1,0
26,371,371,28,28,0,1,0
30,371,371,67,35,32,2,1
15,383,383,56,56,0,1,0
13,385,385,142,68,74,4,3
27,403,403,102,102,0,1,0
16,415,415,1,1,0,1,0
31,434,434,11,11,0,1,0
17,438,438,96,65,31,2,1
2,493,493,45,3,42,2,1
23,498,498,4,1,3,2,1

8,107,107,12,12,0,1,0
30,108,108,7,4,3,2,1
2,110,110,1,1,0,1,0
40,111,111,16,12,4,2,1
41,119,119,34,34,0,1,0
9,135,135,17,1,16,3,2
0,136,136,14,14,0,1,0
6,156,156,4,4,0,1,0
20,184,184,32,32,0,1,0
25,187,187,11,7,4,2,1
24,193,193,25,25,0,1,0
21,199,199,13,13,0,1,0
15,202,202,2,2,0,1,0
23,207,207,10,4,6,3,2
26,227,227,57,57,0,1,0
34,233,233,10,2,8,3,2
22,247,247,8,3,5,2,1
27,250,250,17,9,8,3,2
36,250,250,45,21,24,4,3
38,258,258,18,9,9,2,1
12,258,258,8,1,7,3,2
28,271,271,22,10,12,3,2
4,276,276,16,6,10,3,2
13,282,282,45,45,0,1,0
11,283,283,53,34,19,2,1
33,285,285,15,7,8,2,1
16,292,292,16,8,8,3,2
1,298,298,15,9,6,3,2
29,315,315,3,3,0,1,0
31,319,319,29,29,0,1,0
37,333,333,18,18,0,1,0
5,350,350,15,5,10,2,1
39,350,350,27,27,0,1,0
3,350,350,23,8,15,2,1
14,389,389,52,40,12,2,1
10,408,408,12,12,0,1,0
32,413,413,16,16,0,1,0
7,425,425,129,30,99,4,3
18,432,432,17,17,0,1,0
19,437,437,17,17,0,1,0
17,448,448,1,1,0,1,0
42,466,466,42,42,0,1,0
35,492,492,74,50,24,4,3

15,104,104,14,14,0,1,0
22,116,116,15,3,12,2,1
25,121,121,14,14,0,1,0
12,137,137,5,5,0,1,0
26,141,141,61,8,53,3,2
20,148,148,12,2,10,2,1
30,182,182,14,14,0,1,0
31,221,221,30,30,0,1,0
33,223,223,22,18,4,2,1
14,251,251,8,8,0,1,0
19,253,253,25,15,10,2,1
0,257,257,24,12,12,4,3
32,260,260,16,16,0,1,0
10,265,265,14,4,10,2,1
16,274,274,37,37,0,1,0
7,276,276,79,79,0,1,0
5,288,288,4,1,3,2,1
8,302,302,31,13,18,2,1
24,309,309,5,5,0,1,0
21,309,309,4,4,0,1,0
6,330,330,81,58,23,4,3
18,353,353,21,21,0,1,0
23,367,367,8,2,6,2,1
4,371,371,2,2,0,1,0
2,381,381,41,8,33,2,1
27,383,383,20,10,10,2,1
17,401,401,82,72,10,3,2
13,416,416,118,118,0,1,0
34,416,416,55,38,17,4,3
29,428,428,6,6,0,1,0
9,441,441,54,2,52,4,3
11,454,454,11,11,0,1,0
3,460,460,56,26,30,4,3
35,461,461,70,46,24,4,3
1,466,466,48,48,0,1,0
28,477,477,23,23,0,1,0

28,100,100,11,11,0,1,0
16,101,101,4,4,0,1,0
34,105,105,3,3,0,1,0
26,112,112,12,12,0,1,0
19,118,118,17,5,12,2,1
39,127,127,5,2,3,2,1
1,130,130,10,10,0,1,0
18,164,164,28,1,27,4,3
33,169,169,7,7,0,1,0
8,172,172,1,1,0,1,0
4,175,175,8,8,0,1,0
25,209,209,16,16,0,1,0
13,225,225,2,2,0,1,0
15,241,241,1,1,0,1,0
17,263,263,104,44,60,3,2
12,267,267,103,40,63,3,2
23,267,267,100,100,0,1,0
31,274,274,32,32,0,1,0
21,290,290,13,1,12,3,2
10,299,299,8,2,6,2,1
37,304,304,6,6,0,1,0
0,309,309,8,8,0,1,0
24,318,318,13,13,0,1,0
2,345,345,4,4,0,1,0
11,348,348,2,2,0,1,0
7,355,355,52,1,51,4,3
5,360,360,42,30,12,2,1
40,383,383,41,41,0,1,0
9,396,396,32,6,26,3,2
35,411,411,61,31,30,2,1
14,428,428,20,4,16,3,2
38,441,441,11,11,0,1,0
22,455,455,174,68,106,4,3
27,457,457,6,6,0,1,0
32,458,458,31,12,19,4,3
36,458,458,25,3,22,3,2
20,467,467,10,10,0,1,0
6,481,481,28,28,0,1,0
30,484,484,29,18,11,2,1
3,484,484,19,19,0,1,0
29,497,497,59,59,0,1,0

27,100,100,5,5,0,1,0
14,107,107,24,12,12,3,2
7,121,121,3,3,0,1,0
10,129,129,2,2,0,1,0
15,147,147,36,36,0,1,0
20,148,148,23,23,0,1,0
25,155,155,3,3,0,1,0
35,158,158,14,14,0,1,0
2,179,179,25,25,0,1,0
38,180,180,20,13,7,2,1
31,181,181,65,65,0,1,0
37,185,185,5,5,0,1,0
18,188,188,3,3,0,1,0
36,191,191,6,3,3,2,1
24,200,200,24,12,12,4,3
32,210,210,24,9,15,4,3
34,217,217,26,6,20,2,1
5,217,217,1,1,0,1,0
13,241,241,8,8,0,1,0
11,287,287,2,2,0,1,0
26,295,295,8,3,5,2,1
33,315,315,56,52,4,2,1
9,320,320,62,62,0,1,0
19,333,333,48,22,26,2,1
1,334,334,31,31,0,1,0
0,340,340,34,26,8,2,1
21,349,349,112,44,68,4,3
17,350,350,27,27,0,1,0
22,352,352,29,29,0,1,0
12,355,355,17,17,0,1,0
23,375,375,20,20,0,1,0
29,375,375,31,31,0,1,0
30,393,393,9,5,4,2,1
4,411,411,11,3,8,3,2
28,421,421,44,44,0,1,0
3,443,443,2,2,0,1,0
39,458,458,10,10,0,1,0
16,458,458,1,1,0,1,0
8,462,462,2,2,0,1,0
6,500,500,171,105,66,4,3

38,111,111,5,2,3,2,1
20,113,113,3,3,0,1,0
36,116,116,15,15,0,1,0
27,125,125,13,13,0,1,0
30,143,143,10,10,0,1,0
40,164,164,74,20,54,3,2
3,179,179,17,14,3,2,1
37,194,194,15,15,0,1,0
39,194,194,6,6,0,1,0
16,196,196,31,31,0,1,0
26,201,201,21,3,18,3,2
18,201,201,2,2,0,1,0
21,213,213,6,1,5,2,1
35,216,216,5,5,0,1,0
6,218,218,14,14,0,1,0
15,229,229,31,15,16,3,2
1,237,237,7,7,0,1,0
8,246,246,18,13,5,2,1
0,254,254,13,13,0,1,0
10,259,259,1,1,0,1,0
24,261,261,2,2,0,1,0
23,270,270,58,50,8,2,1
29,281,281,28,28,0,1,0
22,297,297,24,24,0,1,0
45,298,298,9,9,0,1,0
33,299,299,51,51,0,1,0
12,306,306,13,13,0,1,0
28,322,322,12,12,0,1,0
4,323,323,18,18,0,1,0
2,375,375,15,15,0,1,0
13,390,390,12,12,0,1,0
9,393,393,19,10,9,4,3
32,404,404,17,17,0,1,0
31,407,407,99,24,75,4,3
14,407,407,23,20,3,2,1
43,436,436,38,38,0,1,0
42,447,447,9,9,0,1,0
34,454,454,12,2,10,2,1
44,462,462,110,19,91,4,3
25,465,465,25,25,0,1,0
11,467,467,44,44,0,1,0
7,472,472,97,29,68,3,2
41,474,474,5,5,0,1,0
17,482,482,8,8,0,1,0
19,487,487,72,6,66,3,2
5,499,499,13,13,0,1,0

5,107,107,25,25,0,1,0
35,113,113,8,8,0,1,0
39,118,118,9,3,6,3,2
23,125,125,11,1,10,3,2
26,137,137,19,2,17,2,1
21,138,138,1,1,0,1,0
9,146,146,3,3,0,1,0
3,173,173,1,1,0,1,0
37,195,195,10,2,8,3,2
11,195,195,5,5,0,1,0
34,199,199,9,9,0,1,0
30,231,231,24,6,18,3,2
14,231,231,17,17,0,1,0
33,253,253,108,105,3,2,1
36,260,260,39,39,0,1,0
20,269,269,34,16,18,2,1
24,272,272,28,28,0,1,0
38,288,288,20,20,0,1,0
0,291,291,160,150,10,2,1
2,291,291,31,31,0,1,0
10,308,308,3,3,0,1,0
6,310,310,7,7,0,1,0
19,311,311,4,4,0,1,0
31,319,319,13,13,0,1,0
27,322,322,28,28,0,1,0
8,329,329,33,3,30,4,3
12,341,341,48,9,39,4,3
28,341,341,42,42,0,1,0
15,390,390,19,19,0,1,0
40,398,398,61,6,55,4,3
7,400,400,12,12,0,1,0
16,400,400,11,1,10,3,2
4,410,410,21,21,0,1,0
32,411,411,29,29,0,1,0
1,425,425,14,14,0,1,0
29,438,438,33,21,12,2,1
25,453,453,32,20,12,2,1
17,461,461,11,1,10,3,2
13,476,476,53,36,17,2,1
18,480,480,69,69,0,1,0
22,490,490,1,1,0,1,0

2,100,100,14,14,0,1,0
17,130,130,4,4,0,1,0
7,132,132,5,2,3,2,1
11,137,137,16,11,5,2,1
3,159,159,22,2,20,2,1
21,161,161,43,10,33,2,1
27,165,165,8,8,0,1,0
22,170,170,10,10,0,1,0
4,185,185,1,1,0,1,0
30,185,185,1,1,0,1,0
9,213,213,16,16,0,1,0
6,219,219,4,4,0,1,0
8,230,230,41,34,7,2,1
12,231,231,2,2,0,1,0
1,272,272,141,124,17,3,2
10,296,296,36,21,15,4,3
0,303,303,70,70,0,1,0
32,307,307,20,16,4,2,1
26,340,340,13,2,11,3,2
16,356,356,38,5,33,2,1
15,359,359,8,8,0,1,0
28,367,367,68,16,52,3,2
31,367,367,19,7,12,4,3
29,372,372,99,99,0,1,0
25,393,393,28,22,6,3,2
23,395,395,2,2,0,1,0
13,405,405,13,9,4,2,1
19,411,411,56,56,0,1,0
24,428,428,93,77,16,2,1
20,441,441,61,61,0,1,0
14,443,443,82,12,70,3,2
5,467,467,131,89,42,4,3
18,475,475,18,18,0,1,0

15,120,120,16,16,0,1,0
23,127,127,3,3,0,1,0
3,138,138,8,8,0,1,0
35,175,175,17,5,12,4,3
19,181,181,39,39,0,1,0
0,187,187,2,2,0,1,0
26,191,191,3,3,0,1,0
29,195,195,16,16,0,1,0
1,204,204,2,2,0,1,0
16,206,206,1,1,0,1,0
33,209,209,1,1,0,1,0
24,215,215,25,2,23,2,1
34,218,218,2,2,0,1,0
38,218,218,1,1,0,1,0
14,218,218,33,3,30,3,2
37,221,221,14,14,0,1,0
13,227,227,14,14,0,1,0
12,229,229,1,1,0,1,0
4,259,259,15,2,13,3,2
11,277,277,43,43,0,1,0
18,283,283,1,1,0,1,0
17,323,323,43,34,9,4,3
5,327,327,92,23,69,4,3
32,358,358,11,11,0,1,0
36,358,358,42,42,0,1,0
25,364,364,118,65,53,4,3
2,388,388,60,60,0,1,0
6,390,390,45,45,0,1,0
9,391,391,14,14,0,1,0
27,416,416,65,51,14,3,2
7,424,424,22,10,12,3,2
10,430,430,9,9,0,1,0
22,447,447,166,155,11,2,1
31,449,449,99,78,21,2,1
21,450,450,2,2,0,1,0
30,457,457,38,38,0,1,0
39,460,460,86,34,52,4,3
20,470,470,91,91,0,1,0
8,472,472,23,13,10,2,1
28,482,482,9,9,0,1,0

21,111,111,5,5,0,1,0
0,141,141,2,2,0,1,0
28,141,141,1,1,0,1,0
35,152,152,1,1,0,1,0
36,158,158,21,3,18,3,2
19,168,168,14,14,0,1,0
26,177,177,24,7,17,2,1
18,178,178,82,38,44,3,2
5,188,188,39,39,0,1,0
23,225,225,2,2,0,1,0
3,227,227,20,8,12,4,3
6,251,251,24,24,0,1,0
25,252,252,5,2,3,2,1
14,261,261,21,11,10,3,2
16,266,266,30,21,9,2,1
11,274,274,56,11,45,4,3
13,274,274,34,4,30,4,3
15,276,276,3,3,0,1,0
1,317,317,8,8,0,1,0
20,319,319,12,12,0,1,0
17,333,333,42,15,27,2,1
33,347,347,4,4,0,1,0
34,353,353,12,12,0,1,0
30,361,361,39,26,13,2,1
8,367,367,3,3,0,1,0
27,382,382,61,56,5,2,1
9,402,402,12,5,7,2,1
4,413,413,45,45,0,1,0
24,447,447,29,2,27,4,3
31,462,462,204,150,54,3,2
22,468,468,44,23,21,4,3
32,468,468,7,7,0,1,0
37,470,470,202,133,69,4,3
12,473,473,16,7,9,4,3
7,490,490,4,1,3,2,1
2,494,494,61,26,35,2,1
10,498,498,19,19,0,1,0
29,499,499,51,29,22,3,2

10,123,123,37,19,18,4,3
26,142,142,34,34,0,1,0
24,152,152,9,6,3,2,1
8,177,177,31,22,9,2,1
27,188,188,1,1,0,1,0
12,203,203,7,7,0,1,0
4,211,211,2,2,0,1,0
21,217,217,28,28,0,1,0
19,225,225,10,10,0,1,0
3,230,230,36,16,20,2,1
7,232,232,6,6,0,1,0
16,242,242,13,1,12,3,2
28,255,255,72,72,0,1,0
5,274,274,145,136,9,2,1
9,287,287,7,7,0,1,0
18,313,313,43,43,0,1,0
30,343,343,31,31,0,1,0
29,353,353,1,1,0,1,0
11,360,360,2,2,0,1,0
23,363,363,71,44,27,3,2
2,364,364,42,2,40,2,1
22,381,381,65,2,63,4,3
17,385,385,17,17,0,1,0
0,418,418,108,108,0,1,0
6,422,422,126,42,84,4,3
1,429,429,1,1,0,1,0
15,438,438,20,9,11,2,1
25,441,441,61,43,18,4,3
13,468,468,28,28,0,1,0
14,476,476,70,56,14,3,2
20,479,479,23,8,15,2,1

5,109,109,1,1,0,1,0
27,119,119,8,8,0,1,0
4,121,121,62,62,0,1,0
2,138,138,21,16,5,2,1
23,141,141,4,4,0,1,0
17,143,143,15,15,0,1,0
24,148,148,9,9,0,1,0
6,167,167,7,4,3,2,1
7,173,173,8,8,0,1,0
0,190,190,26,5,21,2,1
3,191,191,16,11,5,2,1
30,198,198,85,42,43,2,1
13,213,213,37,3,34,3,2
18,221,221,8,3,5,2,1
14,267,267,23,23,0,1,0
10,299,299,3,3,0,1,0
22,312,312,25,25,0,1,0
1,313,313,46,8,38,3,2
12,319,319,32,2,30,3,2
28,333,333,21,21,0,1,0
26,341,341,21,7,14,2,1
11,345,345,166,136,30,2,1
31,359,359,16,16,0,1,0
25,364,364,56,8,48,3,2
21,375,375,43,6,37,2,1
20,390,390,39,39,0,1,0
8,410,410,38,14,24,2,1
9,426,426,38,38,0,1,0
15,461,461,100,59,41,3,2
29,464,464,7,7,0,1,0
16,480,480,44,30,14,4,3
19,485,485,7,7,0,1,0

16,148,148,1,1,0,1,0
33,158,158,22,22,0,1,0
12,163,163,16,4,12,2,1
15,163,163,77,77,0,1,0
14,167,167,42,36,6,3,2
35,196,196,2,2,0,1,0
11,216,216,28,28,0,1,0
24,216,216,10,10,0,1,0
13,219,219,59,33,26,3,2
32,221,221,19,9,10,3,2
29,246,246,11,11,0,1,0
19,256,256,47,47,0,1,0
26,263,263,37,37,0,1,0
30,267,267,27,9,18,2,1
23,278,278,29,29,0,1,0
0,288,288,1,1,0,1,0
21,289,289,14,10,4,2,1
3,300,300,6,6,0,1,0
7,313,313,26,26,0,1,0
31,320,320,3,3,0,1,0
5,322,322,7,7,0,1,0
2,335,335,70,70,0,1,0
22,365,365,99,9,90,3,2
20,376,376,63,63,0,1,0
18,377,377,10,10,0,1,0
10,378,378,3,3,0,1,0
17,380,380,6,6,0,1,0
8,397,397,44,20,24,4,3
28,402,402,43,43,0,1,0
34,403,403,42,15,27,4,3
6,411,411,5,1,4,2,1
27,455,455,68,24,44,2,1
4,456,456,6,6,0,1,0
9,458,458,18,12,6,3,2
25,460,460,81,81,0,1,0
1,463,463,72,51,21,4,3

10,108,108,13,13,0,1,0
33,115,115,4,4,0,1,0
32,115,115,3,3,0,1,0
3,124,124,8,8,0,1,0
14,126,126,1,1,0,1,0
23,161,161,30,13,17,2,1
27,189,189,57,57,0,1,0
25,209,209,15,2,13,2,1
35,222,222,39,39,0,1,0
4,226,226,5,5,0,1,0
28,249,249,27,12,15,4,3
29,260,260,2,2,0,1,0
7,265,265,9,2,7,2,1
19,271,271,49,49,0,1,0
26,272,272,12,12,0,1,0
5,278,278,27,27,0,1,0
20,281,281,15,5,10,3,2
15,285,285,15,15,0,1,0
12,289,289,60,18,42,2,1
22,305,305,11,6,5,2,1
34,309,309,3,3,0,1,0
18,318,318,13,13,0,1,0
8,336,336,34,14,20,2,1
2,349,349,19,13,6,2,1
36,353,353,102,102,0,1,0
0,362,362,20,4,16,3,2
1,372,372,195,118,77,3,2
9,379,379,31,4,27,4,3
6,384,384,23,23,0,1,0
17,386,386,45,12,33,4,3
24,399,399,76,4,72,4,3
13,414,414,16,16,0,1,0
21,426,426,71,26,45,3,2
16,443,443,32,32,0,1,0
11,449,449,67,63,4,2,1
30,455,455,17,17,0,1,0
37,458,458,3,3,0,1,0
31,482,482,5,5,0,1,0

17,102,102,9,9,0,1,0
4,113,113,16,7,9,2,1
18,139,139,20,20,0,1,0
19,164,164,36,36,0,1,0
12,164,164,7,7,0,1,0
37,170,170,21,11,10,3,2
29,186,186,10,10,0,1,0
33,193,193,5,5,0,1,0
1,198,198,17,17,0,1,0
22,209,209,28,28,0,1,0
27,229,229,8,8,0,1,0
7,237,237,4,4,0,1,0
11,245,245,20,2,18,4,3
8,253,253,18,18,0,1,0
25,259,259,56,6,50,2,1
30,269,269,35,22,13,2,1
15,271,271,10,4,6,3,2
9,299,299,10,6,4,2,1
23,300,300,80,11,69,4,3
38,326,326,21,21,0,1,0
21,345,345,21,5,16,2,1
6,345,345,29,23,6,2,1
28,362,362,27,27,0,1,0
2,377,377,62,33,29,2,1
26,378,378,22,22,0,1,0
13,383,383,28,28,0,1,0
24,385,385,39,13,26,3,2
36,387,387,91,42,49,2,1
10,391,391,4,4,0,1,0
0,394,394,110,42,68,4,3
39,405,405,21,21,0,1,0
34,408,408,22,22,0,1,0
35,410,410,5,1,4,2,1
16,412,412,40,16,24,2,1
20,420,420,8,8,0,1,0
3,456,456,16,1,15,4,3
31,459,459,78,17,61,4,3
32,466,466,29,13,16,4,3
14,484,484,52,22,30,2,1
5,494,494,35,10,25,2,1

7,112,112,52,18,34,4,3
11,142,142,1,1,0,1,0
13,152,152,12,12,0,1,0
25,156,156,5,1,4,2,1
16,166,166,28,28,0,1,0
29,167,167,30,30,0,1,0
10,172,172,12,12,0,1,0
8,173,173,34,13,21,2,1
20,180,180,16,16,0,1,0
30,181,181,1,1,0,1,0
9,203,203,9,9,0,1,0
26,206,206,55,39,16,3,2
5,215,215,11,11,0,1,0
21,239,239,78,78,0,1,0
23,242,242,22,8,14,2,1
24,252,252,22,19,3,2,1
3,256,256,52,52,0,1,0
33,272,272,2,2,0,1,0
12,281,281,17,7,10,2,1
1,295,295,5,2,3,2,1
4,330,330,12,12,0,1,0
2,330,330,19,19,0,1,0
18,354,354,8,8,0,1,0
32,361,361,29,19,10,3,2
17,371,371,65,65,0,1,0
22,376,376,10,10,0,1,0
6,390,390,38,38,0,1,0
15,428,428,6,6,0,1,0
31,441,441,37,37,0,1,0
0,453,453,195,195,0,1,0
14,457,457,40,10,30,4,3
19,458,458,47,2,45,4,3
27,480,480,18,18,0,1,0
28,489,489,65,65,0,1,0

29,121,121,6,6,0,1,0
6,124,124,4,4,0,1,0
24,133,133,8,8,0,1,0
28,139,139,21,9,12,4,3
11,160,160,10,2,8,2,1
18,167,167,44,44,0,1,0
0,170,170,35,35,0,1,0
3,184,184,11,5,6,3,2
34,187,187,10,10,0,1,0
10,192,192,58,58,0,1,0
22,213,213,3,3,0,1,0
5,216,216,42,42,0,1,0
8,219,219,18,18,0,1,0
15,228,228,3,3,0,1,0
9,229,229,20,1,19,2,1
21,235,235,42,1,41,2,1
17,238,238,24,12,12,4,3
1,241,241,8,8,0,1,0
19,251,251,54,8,46,3,2
23,256,256,1,1,0,1,0
13,277,277,14,5,9,2,1
14,289,289,6,6,0,1,0
33,302,302,10,2,8,2,1
36,306,306,62,5,57,4,3
27,321,321,104,34,70,4,3
26,329,329,56,56,0,1,0
16,344,344,21,4,17,2,1
7,350,350,5,5,0,1,0
30,353,353,27,12,15,2,1
4,360,360,2,2,0,1,0
2,379,379,54,54,0,1,0
32,385,385,31,31,0,1,0
35,397,397,34,12,22,3,2
12,410,410,69,54,15,2,1
31,420,420,25,25,0,1,0
37,446,446,16,16,0,1,0
20,451,451,1,1,0,1,0
25,464,464,62,29,33,4,3

36,130,130,6,6,0,1,0
8,130,130,32,32,0,1,0
19,137,137,6,1,5,2,1
12,148,148,62,6,56,3,2
16,157,157,1,1,0,1,0
23,160,160,19,19,0,1,0
13,166,166,10,4,6,3,2
0,166,166,5,5,0,1,0
17,190,190,13,5,8,3,2
35,192,192,9,9,0,1,0
1,202,202,7,7,0,1,0
10,203,203,14,14,0,1,0
32,213,213,43,43,0,1,0
21,217,217,27,17,10,2,1
9,231,231,24,6,18,4,3
3,242,242,33,33,0,1,0
29,252,252,9,1,8,2,1
2,261,261,47,47,0,1,0
5,263,263,16,16,0,1,0
26,265,265,26,26,0,1,0
33,281,281,79,55,24,3,2
11,282,282,8,8,0,1,0
27,301,301,73,63,10,2,1
24,315,315,26,9,17,2,1
28,330,330,14,2,12,2,1
4,341,341,33,11,22,2,1
15,368,368,2,2,0,1,0
34,387,387,11,5,6,2,1
31,392,392,52,8,44,2,1
7,406,406,115,45,70,3,2
14,423,423,13,13,0,1,0
25,424,424,10,10,0,1,0
30,446,446,49,11,38,3,2
22,452,452,45,45,0,1,0
6,495,495,22,16,6,3,2
18,498,498,6,3,3,2,1
20,500,500,86,86,0,1,0

14,102,102,1,1,0,1,0
24,134,134,5,1,4,2,1
27,138,138,4,4,0,1,0
30,165,165,37,37,0,1,0
4,173,173,49,16,33,4,3
31,183,183,39,39,0,1,0
5,188,188,75,21,54,4,3
25,188,188,37,23,14,2,1
11,196,196,18,18,0,1,0
3,205,205,68,68,0,1,0
32,212,212,11,11,0,1,0
12,215,215,14,14,0,1,0
28,232,232,6,6,0,1,0
22,236,236,64,60,4,2,1
13,269,269,24,24,0,1,0
23,281,281,1,1,0,1,0
6,297,297,13,9,4,2,1
17,346,346,75,27,48,2,1
7,377,377,61,11,50,3,2
9,397,397,7,7,0,1,0
20,409,409,14,14,0,1,0
16,411,411,67,3,64,3,2
1,413,413,21,1,20,3,2
29,423,423,49,8,41,3,2
15,432,432,68,38,30,3,2
19,452,452,14,4,10,3,2
26,460,460,36,4,32,3,2
0,469,469,80,80,0,1,0
21,473,473,37,15,22,3,2
10,479,479,19,3,16,2,1
18,487,487,3,3,0,1,0
8,489,489,36,36,0,1,0
2,491,491,42,21,21,4,3

33,107,107,2,2,0,1,0
10,109,109,47,23,24,3,2
25,122,122,2,2,0,1,0
8,122,122,17,2,15,4,3
34,129,129,7,1,6,3,2
28,147,147,30,30,0,1,0
36,148,148,1,1,0,1,0
23,157,157,20,15,5,2,1
15,177,177,23,15,8,3,2
32,178,178,15,15,0,1,0
14,182,182,4,4,0,1,0
2,197,197,10,10,0,1,0
26,198,198,25,10,15,4,3
19,208,208,49,27,22,3,2
18,219,219,16,6,10,2,1
4,223,223,1,1,0,1,0
5,223,223,4,1,3,2,1
20,244,244,46,46,0,1,0
16,251,251,65,35,30,4,3
27,305,305,5,5,0,1,0
13,311,311,58,58,0,1,0
22,318,318,8,8,0,1,0
3,339,339,5,5,0,1,0
11,345,345,14,14,0,1,0
1,346,346,14,2,12,4,3
6,352,352,1,1,0,1,0
24,355,355,69,41,28,3,2
9,382,382,23,23,0,1,0
0,392,392,62,35,27,2,1
30,395,395,42,33,9,4,3
12,396,396,126,75,51,4,3
17,413,413,8,5,3,2,1
29,457,457,32,32,0,1,0
31,462,462,104,104,0,1,0
7,490,490,3,3,0,1,0
21,491,491,20,5,15,4,3
35,494,494,62,62,0,1,0

42,105,105,23,7,16,2,1
4,116,116,6,6,0,1,0
10,124,124,1,1,0,1,0
34,136,136,4,4,0,1,0
30,141,141,12,3,9,2,1
23,147,147,2,2,0,1,0
11,149,149,3,3,0,1,0
21,158,158,26,26,0,1,0
1,166,166,6,3,3,2,1
16,179,179,17,5,12,3,2
0,190,190,9,9,0,1,0
44,204,204,5,5,0,1,0
22,224,224,7,7,0,1,0
6,227,227,6,6,0,1,0
24,242,242,1,1,0,1,0
7,243,243,49,7,42,4,3
17,245,245,4,4,0,1,0
33,249,249,3,3,0,1,0
25,254,254,14,14,0,1,0
18,254,254,2,2,0,1,0
40,260,260,34,7,27,4,3
41,262,262,15,7,8,3,2
43,266,266,19,19,0,1,0
31,271,271,40,40,0,1,0
28,287,287,33,33,0,1,0
5,300,300,21,14,7,2,1
35,304,304,18,18,0,1,0
32,316,316,84,61,23,2,1
27,317,317,46,11,35,3,2
45,364,364,97,54,43,4,3
38,381,381,59,24,35,2,1
14,387,387,4,4,0,1,0
15,389,389,32,32,0,1,0
12,390,390,25,5,20,2,1
3,403,403,9,9,0,1,0
13,414,414,30,30,0,1,0
29,415,415,8,8,0,1,0
36,416,416,1,1,0,1,0
8,416,416,16,16,0,1,0
2,422,422,111,111,0,1,0
37,429,429,18,18,0,1,0
39,433,433,41,35,6,2,1
26,438,438,38,24,14,3,2
19,453,453,4,1,3,2,1
20,456,456,60,5,55,3,2
9,466,466,127,120,7,2,1

7,105,105,2,2,0,1,0
15,130,130,5,5,0,1,0
25,134,134,15,1,14,3,2
22,145,145,14,5,9,2,1
2,166,166,1,1,0,1,0
24,176,176,33,3,30,2,1
3,177,177,95,56,39,4,3
19,196,196,17,17,0,1,0
5,208,208,1,1,0,1,0
28,211,211,29,7,22,2,1
23,226,226,13,13,0,1,0
8,243,243,13,13,0,1,0
0,248,248,25,18,7,2,1
30,254,254,7,7,0,1,0
1,260,260,90,90,0,1,0
27,263,263,78,78,0,1,0
9,266,266,32,32,0,1,0
18,267,267,43,37,6,2,1
11,288,288,120,80,40,2,1
4,293,293,12,12,0,1,0
31,316,316,27,27,0,1,0
14,344,344,31,16,15,4,3
6,348,348,69,51,18,3,2
12,368,368,11,11,0,1,0
29,377,377,21,21,0,1,0
20,397,397,14,2,12,4,3
26,411,411,124,124,0,1,0
10,439,439,12,12,0,1,0
17,443,443,2,2,0,1,0
13,458,458,38,2,36,3,2
21,480,480,37,37,0,1,0
16,492,492,5,2,3,2,1

17,103,103,1,1,0,1,0
41,108,108,2,2,0,1,0
7,128,128,3,3,0,1,0
20,147,147,30,30,0,1,0
35,160,160,2,2,0,1,0
30,173,173,11,2,9,2,1
11,183,183,20,1,19,2,1
28,184,184,35,35,0,1,0
40,201,201,1,1,0,1,0
38,201,201,41,41,0,1,0
26,205,205,7,7,0,1,0
18,214,214,15,15,0,1,0
32,219,219,2,2,0,1,0
10,226,226,6,3,3,2,1
39,245,245,45,45,0,1,0
13,263,263,21,11,10,3,2
36,263,263,130,34,96,4,3
5,276,276,14,14,0,1,0
14,280,280,17,17,0,1,0
16,284,284,17,17,0,1,0
21,291,291,27,5,22,3,2
2,294,294,1,1,0,1,0
4,297,297,84,77,7,2,1
6,308,308,27,27,0,1,0
37,310,310,18,8,10,3,2
3,317,317,23,23,0,1,0
15,330,330,63,39,24,2,1
9,332,332,1,1,0,1,0
1,336,336,1,1,0,1,0
22,337,337,17,17,0,1,0
19,341,341,1,1,0,1,0
8,350,350,89,19,70,3,2
29,356,356,14,1,13,2,1
23,371,371,26,20,6,3,2
24,377,377,105,57,48,3,2
25,403,403,15,15,0,1,0
12,421,421,36,29,7,2,1
27,432,432,32,5,27,2,1
33,446,446,16,1,15,4,3
0,455,455,36,36,0,1,0
31,471,471,35,8,27,4,3
34,500,500,28,28,0,1,0

27,107,107,17,4,13,2,1
39,116,116,6,6,0,1,0
43,123,123,2,2,0,1,0
19,133,133,24,24,0,1,0
16,142,142,4,4,0,1,0
28,146,146,15,6,9,4,3
15,158,158,1,1,0,1,0
6,170,170,1,1,0,1,0
34,179,179,6,6,0,1,0
26,185,185,27,18,9,4,3
37,186,186,5,5,0,1,0
33,190,190,27,11,16,3,2
8,196,196,5,1,4,2,1
23,209,209,71,71,0,1,0
42,235,235,26,26,0,1,0
5,236,236,1,1,0,1,0
41,243,243,9,3,6,3,2
17,258,258,10,1,9,2,1
7,272,272,10,10,0,1,0
10,273,273,2,2,0,1,0
29,286,286,38,3,35,2,1
45,304,304,58,32,26,3,2
21,308,308,26,8,18,3,2
38,316,316,62,62,0,1,0
20,317,317,12,2,10,2,1
2,321,321,31,23,8,3,2
30,378,378,8,8,0,1,0
1,395,395,46,46,0,1,0
44,406,406,37,13,24,3,2
22,409,409,4,1,3,2,1
0,420,420,26,26,0,1,0
40,427,427,144,72,72,3,2
24,446,446,6,6,0,1,0
12,470,470,44,11,33,4,3
14,471,471,47,47,0,1,0
4,475,475,12,12,0,1,0
9,476,476,18,2,16,2,1
18,477,477,61,24,37,2,1
3,482,482,4,4,0,1,0
11,483,483,1,1,0,1,0
35,484,484,36,26,10,2,1
32,484,484,43,43,0,1,0
36,485,485,39,39,0,1,0
31,487,487,25,25,0,1,0
25,496,496,75,75,0,1,0
13,497,497,57,48,9,4,3

1,107,107,4,4,0,1,0
16,109,109,3,3,0,1,0
30,109,109,21,21,0,1,0
14,119,119,15,10,5,2,1
9,120,120,26,2,24,4,3
12,127,127,1,1,0,1,0
2,132,132,1,1,0,1,0
5,134,134,3,3,0,1,0
10,137,137,3,3,0,1,0
44,141,141,22,10,12,3,2
17,144,144,11,5,6,3,2
19,152,152,3,3,0,1,0
40,152,152,20,2,18,3,2
3,153,153,15,15,0,1,0
22,169,169,11,8,3,2,1
25,176,176,6,6,0,1,0
28,181,181,26,26,0,1,0
21,188,188,32,32,0,1,0
13,231,231,17,5,12,2,1
38,232,232,50,2,48,4,3
31,232,232,5,5,0,1,0
6,238,238,32,11,21,4,3
11,239,239,39,28,11,4,3
8,239,239,11,2,9,2,1
4,255,255,26,4,22,3,2
39,262,262,5,5,0,1,0
36,262,262,45,45,0,1,0
23,288,288,21,21,0,1,0
29,343,343,51,9,42,3,2
35,354,354,28,28,0,1,0
33,355,355,27,27,0,1,0
43,371,371,11,11,0,1,0
15,379,379,38,3,35,2,1
7,380,380,44,44,0,1,0
18,382,382,16,16,0,1,0
32,383,383,26,20,6,2,1
37,386,386,48,9,39,4,3
26,394,394,10,4,6,3,2
0,408,408,10,5,5,2,1
34,410,410,59,22,37,2,1
24,415,415,16,1,15,2,1
42,462,462,23,17,6,3,2
41,469,469,46,5,41,2,1
27,471,471,23,1,22,3,2
20,489,489,28,8,20,3,2

0,130,130,43,43,0,1,0
2,131,131,15,15,0,1,0
25,145,145,5,2,3,2,1
7,154,154,11,11,0,1,0
9,164,164,1,1,0,1,0
16,176,176,9,9,0,1,0
4,183,183,54,6,48,4,3
17,184,184,7,1,6,3,2
15,198,198,11,7,4,2,1
20,203,203,20,20,0,1,0
1,204,204,3,3,0,1,0
24,207,207,24,18,6,3,2
22,215,215,28,28,0,1,0
33,232,232,21,21,0,1,0
18,236,236,23,7,16,2,1
27,240,240,85,21,64,3,2
28,245,245,52,52,0,1,0
10,285,285,29,4,25,2,1
8,293,293,4,1,3,2,1
19,331,331,33,7,26,2,1
32,336,336,16,1,15,4,3
26,340,340,75,66,9,4,3
30,358,358,39,39,0,1,0
5,361,361,124,124,0,1,0
11,363,363,16,16,0,1,0
31,368,368,4,1,3,2,1
29,374,374,18,18,0,1,0
23,375,375,6,6,0,1,0
21,375,375,42,26,16,3,2
13,401,401,21,21,0,1,0
12,408,408,7,7,0,1,0
3,453,453,56,18,38,2,1
6,467,467,3,3,0,1,0
14,476,476,174,174,0,1,0

29,117,117,13,13,0,1,0
23,126,126,7,3,4,2,1
21,131,131,6,6,0,1,0
10,144,144,12,12,0,1,0
3,146,146,21,9,12,2,1
8,152,152,4,4,0,1,0
27,160,160,20,20,0,1,0
28,180,180,20,20,0,1,0
39,196,196,6,6,0,1,0
38,209,209,17,17,0,1,0
33,216,216,171,171,0,1,0
20,219,219,2,2,0,1,0
30,228,228,1,1,0,1,0
24,275,275,22,22,0,1,0
9,277,277,12,12,0,1,0
12,280,280,11,11,0,1,0
35,287,287,14,14,0,1,0
37,315,315,2,2,0,1,0
2,320,320,4,4,0,1,0
16,336,336,105,49,56,3,2
7,344,344,28,28,0,1,0
18,345,345,7,7,0,1,0
22,350,350,66,66,0,1,0
15,353,353,21,21,0,1,0
5,374,374,64,64,0,1,0
31,375,375,44,23,21,4,3
0,381,381,3,3,0,1,0
26,384,384,10,7,3,2,1
25,392,392,9,9,0,1,0
19,394,394,62,62,0,1,0
36,397,397,2,2,0,1,0
6,415,415,31,31,0,1,0
11,420,420,18,12,6,2,1
32,434,434,18,18,0,1,0
1,436,436,1,1,0,1,0
13,451,451,33,1,32,4,3
4,464,464,5,1,4,2,1
17,465,465,7,7,0,1,0
14,477,477,247,180,67,4,3
34,488,488,25,25,0,1,0

31,100,100,19,19,0,1,0
30,108,108,8,8,0,1,0
27,115,115,41,41,0,1,0
20,118,118,4,4,0,1,0
34,120,120,14,14,0,1,0
36,131,131,32,32,0,1,0
21,166,166,15,11,4,2,1
3,168,168,18,18,0,1,0
16,170,170,28,6,22,3,2
19,181,181,1,1,0,1,0
17,186,186,24,24,0,1,0
11,187,187,4,4,0,1,0
4,191,191,8,1,7,2,1
26,191,191,5,1,4,2,1
40,216,216,11,11,0,1,0
5,218,218,21,4,17,2,1
33,225,225,18,18,0,1,0
37,260,260,16,16,0,1,0
44,284,284,22,22,0,1,0
32,296,296,28,1,27,2,1
9,297,297,16,1,15,4,3
43,309,309,29,29,0,1,0
14,312,312,27,14,13,2,1
23,320,320,24,9,15,2,1
35,321,321,25,7,18,4,3
28,327,327,26,5,21,4,3
39,356,356,6,1,5,2,1
0,364,364,1,1,0,1,0
15,371,371,79,9,70,4,3
29,373,373,16,16,0,1,0
41,375,375,11,11,0,1,0
18,375,375,49,49,0,1,0
22,376,376,2,2,0,1,0
24,388,388,1,1,0,1,0
2,393,393,3,3,0,1,0
12,397,397,18,18,0,1,0
42,418,418,72,48,24,4,3
25,419,419,3,3,0,1,0
38,438,438,27,14,13,2,1
7,448,448,132,122,10,3,2
13,465,465,12,1,11,2,1
10,472,472,28,28,0,1,0
8,482,482,33,27,6,3,2
6,493,493,15,12,3,2,1
1,496,496,51,45,6,2,1

0,102,102,2,2,0,1,0
33,102,102,26,4,22,3,2
7,110,110,9,9,0,1,0
39,129,129,1,1,0,1,0
5,140,140,36,28,8,2,1
6,157,157,8,8,0,1,0
22,159,159,6,2,4,2,1
37,170,170,6,6,0,1,0
24,177,177,32,32,0,1,0
21,180,180,8,8,0,1,0
8,203,203,15,3,12,2,1
40,218,218,45,45,0,1,0
14,218,218,3,3,0,1,0
31,234,234,10,2,8,2,1
28,237,237,8,4,4,2,1
17,242,242,13,13,0,1,0
12,246,246,18,18,0,1,0
18,258,258,8,4,4,2,1
23,260,260,7,3,4,2,1
3,262,262,58,36,22,4,3
9,267,267,9,9,0,1,0
38,283,283,5,5,0,1,0
41,325,325,10,4,6,2,1
32,332,332,6,6,0,1,0
35,335,335,1,1,0,1,0
29,338,338,1,1,0,1,0
25,339,339,84,42,42,4,3
4,362,362,22,4,18,2,1
10,368,368,3,3,0,1,0
1,379,379,38,6,32,3,2
16,386,386,36,15,21,4,3
27,391,391,136,60,76,4,3
11,399,399,22,22,0,1,0
15,408,408,62,62,0,1,0
30,410,410,75,75,0,1,0
36,430,430,51,3,48,2,1
20,436,436,11,11,0,1,0
19,457,457,4,1,3,2,1
34,464,464,73,73,0,1,0
13,466,466,145,65,80,3,2
2,484,484,48,48,0,1,0
26,494,494,15,7,8,3,2

9,123,123,6,6,0,1,0
1,140,140,1,1,0,1,0
16,141,141,1,1,0,1,0
20,144,144,2,2,0,1,0
19,156,156,14,9,5,2,1
31,157,157,11,5,6,2,1
33,158,158,29,29,0,1,0
5,164,164,6,3,3,2,1
35,185,185,13,13,0,1,0
8,197,197,28,28,0,1,0
7,207,207,8,8,0,1,0
24,236,236,26,26,0,1,0
22,237,237,13,5,8,3,2
34,258,258,8,8,0,1,0
6,259,259,19,19,0,1,0
15,261,261,116,35,81,4,3
3,305,305,64,64,0,1,0
12,309,309,21,4,17,3,2
13,311,311,173,95,78,4,3
26,371,371,84,71,13,2,1
21,382,382,41,41,0,1,0
4,384,384,28,22,6,3,2
10,395,395,1,1,0,1,0
32,413,413,5,5,0,1,0
23,414,414,28,28,0,1,0
30,425,425,26,1,25,2,1
29,427,427,49,36,13,2,1
14,428,428,39,15,24,2,1
2,436,436,1,1,0,1,0
17,437,437,3,3,0,1,0
36,449,449,16,16,0,1,0
27,479,479,114,114,0,1,0
11,481,481,20,2,18,3,2
28,483,483,4,4,0,1,0
25,491,491,69,69,0,1,0
18,496,496,151,151,0,1,0
0,496,496,26,26,0,1,0

29,100,100,3,3,0,1,0
1,118,118,10,10,0,1,0
22,142,142,23,23,0,1,0
18,146,146,8,8,0,1,0
25,150,150,14,14,0,1,0
40,152,152,9,9,0,1,0
21,157,157,19,19,0,1,0
3,164,164,2,2,0,1,0
26,184,184,65,65,0,1,0
8,195,195,8,8,0,1,0
13,195,195,39,39,0,1,0
10,200,200,5,5,0,1,0
17,206,206,12,3,9,2,1
32,214,214,35,35,0,1,0
24,227,227,9,3,6,2,1
7,232,232,6,3,3,2,1
16,234,234,33,9,24,3,2
36,235,235,6,3,3,2,1
33,240,240,23,23,0,1,0
28,273,273,12,12,0,1,0
39,275,275,76,18,58,3,2
4,299,299,4,4,0,1,0
42,325,325,29,29,0,1,0
23,341,341,44,44,0,1,0
34,341,341,7,7,0,1,0
12,349,349,17,1,16,2,1
2,349,349,40,14,26,2,1
15,359,359,7,7,0,1,0
0,362,362,36,21,15,2,1
11,366,366,20,11,9,4,3
6,367,367,30,30,0,1,0
5,382,382,13,3,10,3,2
37,390,390,27,27,0,1,0
31,395,395,44,44,0,1,0
30,411,411,32,32,0,1,0
41,419,419,4,1,3,2,1
35,422,422,21,4,17,2,1
27,428,428,38,38,0,1,0
19,457,457,35,20,15,4,3
14,458,458,122,122,0,1,0
20,459,459,11,11,0,1,0
38,477,477,118,58,60,3,2
9,492,492,7,3,4,2,1

36,136,136,4,1,3,2,1
29,158,158,2,2,0,1,0
10,169,169,32,17,15,2,1
2,196,196,1,1,0,1,0
26,211,211,8,8,0,1,0
32,223,223,11,11,0,1,0
20,225,225,35,1,34,3,2
13,227,227,5,5,0,1,0
34,234,234,13,13,0,1,0
22,238,238,85,85,0,1,0
5,239,239,2,2,0,1,0
3,241,241,36,36,0,1,0
19,271,271,57,57,0,1,0
27,273,273,18,18,0,1,0
12,287,287,1,1,0,1,0
18,311,311,37,37,0,1,0
33,321,321,28,28,0,1,0
17,324,324,43,2,41,2,1
14,327,327,1,1,0,1,0
1,354,354,62,32,30,4,3
15,357,357,1,1,0,1,0
35,358,358,47,47,0,1,0
31,380,380,49,49,0,1,0
28,381,381,1,1,0,1,0
7,384,384,16,16,0,1,0
6,390,390,163,147,16,2,1
11,394,394,36,36,0,1,0
23,401,401,11,11,0,1,0
16,405,405,20,20,0,1,0
37,415,415,44,14,30,2,1
9,419,419,98,98,0,1,0
8,422,422,61,35,26,3,2
21,423,423,15,6,9,2,1
4,428,428,4,4,0,1,0
25,439,439,1,1,0,1,0
24,451,451,93,19,74,3,2
30,473,473,111,56,55,4,3
0,480,480,49,49,0,1,0

30,113,113,29,2,27,4,3
15,118,118,9,9,0,1,0
17,129,129,18,18,0,1,0
11,137,137,13,13,0,1,0
20,158,158,33,18,15,4,3
0,176,176,2,2,0,1,0
36,181,181,13,13,0,1,0
9,182,182,1,1,0,1,0
23,184,184,19,5,14,2,1
37,195,195,18,8,10,3,2
32,208,208,33,25,8,3,2
2,228,228,15,15,0,1,0
18,235,235,20,5,15,4,3
28,241,241,14,2,12,4,3
27,252,252,10,10,0,1,0
16,283,283,24,24,0,1,0
34,284,284,9,3,6,2,1
26,287,287,4,4,0,1,0
22,310,310,64,64,0,1,0
21,316,316,13,5,8,2,1
8,323,323,13,9,4,2,1
24,339,339,1,1,0,1,0
35,340,340,85,82,3,2,1
1,366,366,18,6,12,4,3
14,371,371,89,89,0,1,0
4,377,377,86,53,33,4,3
5,393,393,93,93,0,1,0
31,409,409,41,41,0,1,0
12,419,419,18,18,0,1,0
25,423,423,37,37,0,1,0
10,423,423,60,7,53,4,3
7,433,433,40,40,0,1,0
33,437,437,35,19,16,3,2
6,439,439,8,8,0,1,0
13,442,442,43,43,0,1,0
19,443,443,49,7,42,4,3
29,459,459,12,12,0,1,0
3,492,492,74,74,0,1,0

25,100,100,45,1,44,2,1
29,130,130,5,5,0,1,0
11,172,172,24,24,0,1,0
13,175,175,1,1,0,1,0
36,175,175,6,3,3,2,1
27,176,176,25,25,0,1,0
19,191,191,5,2,3,2,1
5,193,193,8,8,0,1,0
3,198,198,22,17,5,2,1
6,203,203,10,10,0,1,0
21,227,227,4,1,3,2,1
26,254,254,2,2,0,1,0
18,303,303,19,19,0,1,0
34,315,315,11,11,0,1,0
2,322,322,25,17,8,3,2
20,324,324,33,33,0,1,0
22,345,345,39,31,8,3,2
24,347,347,83,83,0,1,0
17,348,348,3,3,0,1,0
30,352,352,3,3,0,1,0
10,353,353,78,2,76,3,2
0,368,368,80,26,54,4,3
33,375,375,4,4,0,1,0
31,393,393,55,55,0,1,0
1,398,398,2,2,0,1,0
32,409,409,26,26,0,1,0
15,417,417,37,37,0,1,0
28,425,425,67,17,50,2,1
4,426,426,18,5,13,2,1
16,441,441,109,67,42,4,3
7,445,445,46,46,0,1,0
12,453,453,34,27,7,2,1
23,457,457,33,27,6,2,1
8,457,457,24,24,0,1,0
35,481,481,104,28,76,3,2
14,495,495,160,160,0,1,0
9,496,496,46,32,14,3,2

0,116,116,2,2,0,1,0
9,128,128,4,4,0,1,0
21,133,133,14,14,0,1,0
14,143,143,2,2,0,1,0
1,148,148,25,2,23,2,1
3,152,152,22,22,0,1,0
37,156,156,1,1,0,1,0
16,162,162,10,10,0,1,0
15,168,168,5,5,0,1,0
11,182,182,4,4,0,1,0
13,185,185,9,9,0,1,0
25,194,194,38,38,0,1,0
2,196,196,4,4,0,1,0
8,200,200,28,28,0,1,0
4,202,202,3,3,0,1,0
30,217,217,47,38,9,4,3
5,226,226,4,1,3,2,1
18,234,234,59,59,0,1,0
27,244,244,7,1,6,2,1
32,254,254,21,21,0,1,0
31,258,258,8,1,7,2,1
22,275,275,11,5,6,2,1
35,307,307,17,11,6,2,1
24,313,313,12,12,0,1,0
38,316,316,79,25,54,3,2
17,317,317,29,29,0,1,0
26,318,318,57,25,32,2,1
36,344,344,35,25,10,2,1
12,368,368,20,20,0,1,0
10,376,376,45,45,0,1,0
19,404,404,166,85,81,4,3
28,420,420,9,1,8,2,1
7,427,427,50,50,0,1,0
29,458,458,19,19,0,1,0
23,462,462,115,69,46,4,3
20,472,472,76,76,0,1,0
33,473,473,14,2,12,4,3
6,494,494,61,61,0,1,0
34,499,499,44,44,0,1,0

33,148,148,25,25,0,1,0
17,153,153,3,3,0,1,0
31,158,158,26,3,23,4,3
22,159,159,12,4,8,2,1
11,175,175,7,4,3,2,1
2,190,190,5,5,0,1,0
6,194,194,38,38,0,1,0
34,207,207,79,79,0,1,0
19,253,253,1,1,0,1,0
37,270,270,9,9,0,1,0
36,273,273,20,20,0,1,0
1,281,281,62,4,58,3,2
30,284,284,13,13,0,1,0
38,288,288,37,6,31,2,1
23,289,289,1,1,0,1,0
12,290,290,43,1,42,2,1
35,296,296,56,56,0,1,0
26,314,314,21,12,9,2,1
14,320,320,3,3,0,1,0
15,325,325,50,26,24,2,1
32,334,334,58,58,0,1,0
18,336,336,11,5,6,2,1
10,342,342,80,11,69,4,3
21,345,345,25,5,20,2,1
24,354,354,48,43,5,2,1
8,360,360,3,3,0,1,0
3,369,369,5,5,0,1,0
16,376,376,15,15,0,1,0
20,382,382,17,17,0,1,0
25,392,392,50,38,12,3,2
4,422,422,32,21,11,3,2
29,425,425,3,3,0,1,0
28,427,427,6,3,3,2,1
7,442,442,16,8,8,2,1
5,463,463,24,24,0,1,0
13,463,463,72,48,24,2,1
27,479,479,17,17,0,1,0
9,482,482,27,27,0,1,0
0,485,485,185,111,74,4,3

9,106,106,3,3,0,1,0
19,111,111,10,10,0,1,0
26,115,115,1,1,0,1,0
17,142,142,5,5,0,1,0
3,150,150,16,7,9,2,1
31,172,172,28,2,26,3,2
37,193,193,5,5,0,1,0
0,216,216,20,5,15,4,3
46,218,218,19,19,0,1,0
27,219,219,18,18,0,1,0
44,222,222,2,2,0,1,0
22,230,230,22,22,0,1,0
21,238,238,20,12,8,3,2
7,259,259,5,2,3,2,1
29,263,263,39,39,0,1,0
30,279,279,24,24,0,1,0
38,283,283,36,36,0,1,0
18,284,284,17,8,9,4,3
45,284,284,15,12,3,2,1
35,289,289,40,5,35,2,1
11,295,295,7,3,4,2,1
1,300,300,30,30,0,1,0
16,326,326,45,9,36,2,1
6,340,340,38,8,30,4,3
13,346,346,3,3,0,1,0
43,351,351,2,2,0,1,0
28,360,360,142,121,21,3,2
12,370,370,14,14,0,1,0
23,371,371,34,21,13,2,1
5,379,379,21,6,15,2,1
33,380,380,14,6,8,2,1
20,386,386,47,26,21,2,1
40,395,395,11,11,0,1,0
24,404,404,35,35,0,1,0
36,408,408,40,21,19,2,1
41,415,415,75,75,0,1,0
32,423,423,78,74,4,2,1
8,439,439,16,16,0,1,0
34,445,445,14,14,0,1,0
14,449,449,18,3,15,4,3
4,459,459,27,20,7,2,1
2,463,463,9,9,0,1,0
10,464,464,23,23,0,1,0
42,469,469,29,7,22,3,2
15,477,477,54,24,30,3,2
25,482,482,51,43,8,2,1
39,483,483,39,29,10,2,1

35,108,108,9,9,0,1,0
38,108,108,1,1,0,1,0
8,109,109,1,1,0,1,0
10,111,111,14,4,10,2,1
0,114,114,29,23,6,2,1
26,123,123,5,2,3,2,1
45,128,128,14,14,0,1,0
19,137,137,15,15,0,1,0
6,143,143,5,5,0,1,0
42,159,159,17,6,11,2,1
2,164,164,11,11,0,1,0
12,175,175,16,7,9,4,3
29,175,175,39,21,18,3,2
34,180,180,13,3,10,2,1
41,199,199,21,21,0,1,0
5,205,205,23,18,5,2,1
39,205,205,52,7,45,2,1
4,214,214,9,1,8,2,1
23,228,228,7,7,0,1,0
32,244,244,10,7,3,2,1
20,271,271,7,7,0,1,0
40,274,274,1,1,0,1,0
24,283,283,34,34,0,1,0
1,297,297,9,1,8,2,1
11,298,298,5,5,0,1,0
21,309,309,14,2,12,2,1
15,316,316,14,5,9,4,3
31,328,328,16,16,0,1,0
17,330,330,6,6,0,1,0
30,337,337,31,31,0,1,0
7,345,345,29,29,0,1,0
36,358,358,21,6,15,4,3
33,363,363,7,7,0,1,0
22,378,378,23,23,0,1,0
37,379,379,9,9,0,1,0
43,393,393,164,164,0,1,0
18,401,401,12,5,7,2,1
3,412,412,21,21,0,1,0
44,417,417,38,24,14,2,1
13,427,427,4,4,0,1,0
9,433,433,47,47,0,1,0
16,440,440,5,2,3,2,1
27,473,473,29,21,8,3,2
14,478,478,73,73,0,1,0
25,486,486,88,82,6,2,1
28,496,496,57,57,0,1,0

44,111,111,1,1,0,1,0
34,119,119,23,23,0,1,0
27,127,127,14,14,0,1,0
12,127,127,1,1,0,1,0
7,128,128,8,8,0,1,0
30,137,137,7,7,0,1,0
4,153,153,10,10,0,1,0
19,171,171,14,2,12,3,2
2,173,173,29,21,8,3,2
33,174,174,4,1,3,2,1
3,188,188,44,44,0,1,0
32,210,210,12,4,8,2,1
26,210,210,1,1,0,1,0
8,225,225,1,1,0,1,0
14,238,238,6,6,0,1,0
40,242,242,1,1,0,1,0
9,253,253,13,1,12,2,1
24,253,253,5,5,0,1,0
5,254,254,1,1,0,1,0
36,263,263,15,11,4,2,1
38,265,265,26,18,8,2,1
43,268,268,61,29,32,3,2
16,299,299,9,9,0,1,0
1,299,299,3,3,0,1,0
20,318,318,66,18,48,2,1
10,320,320,12,1,11,2,1
28,323,323,20,7,13,2,1
6,328,328,1,1,0,1,0
29,334,334,69,69,0,1,0
25,352,352,11,11,0,1,0
21,354,354,57,57,0,1,0
0,360,360,44,44,0,1,0
42,379,379,11,6,5,2,1
18,381,381,12,7,5,2,1
22,393,393,118,44,74,3,2
41,393,393,47,47,0,1,0
46,411,411,21,21,0,1,0
11,411,411,24,24,0,1,0
39,414,414,101,63,38,4,3
37,419,419,12,12,0,1,0
45,433,433,78,7,71,3,2
15,434,434,1,1,0,1,0
31,437,437,95,95,0,1,0
17,438,438,14,3,11,2,1
23,441,441,10,4,6,3,2
35,483,483,40,40,0,1,0
13,495,495,8,2,6,2,1

5,100,100,22,22,0,1,0
21,106,106,30,30,0,1,0
2,109,109,5,1,4,2,1
7,123,123,23,12,11,3,2
19,127,127,1,1,0,1,0
9,132,132,47,32,15,2,1
18,147,147,13,13,0,1,0
17,153,153,11,11,0,1,0
0,154,154,20,20,0,1,0
6,167,167,11,2,9,2,1
27,171,171,4,4,0,1,0
15,205,205,35,7,28,2,1
29,233,233,13,13,0,1,0
8,237,237,2,2,0,1,0
3,270,270,53,53,0,1,0
1,282,282,112,112,0,1,0
10,283,283,1,1,0,1,0
26,294,294,18,18,0,1,0
20,299,299,12,5,7,2,1
16,308,308,42,16,26,2,1
4,363,363,106,84,22,3,2
14,363,363,35,35,0,1,0
13,381,381,6,6,0,1,0
25,388,388,74,56,18,2,1
23,414,414,112,112,0,1,0
28,421,421,61,61,0,1,0
12,447,447,2,2,0,1,0
24,458,458,25,25,0,1,0
11,483,483,36,36,0,1,0
22,486,486,68,68,0,1,0

2,118,118,29,29,0,1,0
9,130,130,12,12,0,1,0
12,134,134,16,16,0,1,0
22,150,150,47,47,0,1,0
24,158,158,7,1,6,2,1
13,161,161,89,51,38,2,1
1,197,197,7,7,0,1,0
23,197,197,3,3,0,1,0
8,203,203,10,10,0,1,0
21,217,217,4,4,0,1,0
27,222,222,15,10,5,2,1
0,224,224,1,1,0,1,0
28,226,226,16,16,0,1,0
31,241,241,91,27,64,3,2
34,248,248,27,27,0,1,0
35,257,257,79,4,75,4,3
19,281,281,7,7,0,1,0
6,288,288,38,19,19,2,1
29,293,293,2,2,0,1,0
33,298,298,56,56,0,1,0
3,316,316,16,6,10,3,2
32,325,325,1,1,0,1,0
17,326,326,13,13,0,1,0
11,337,337,40,40,0,1,0
26,352,352,27,1,26,2,1
20,368,368,16,16,0,1,0
14,382,382,15,15,0,1,0
18,406,406,29,4,25,2,1
15,411,411,8,2,6,3,2
25,414,414,4,4,0,1,0
4,429,429,11,11,0,1,0
7,454,454,12,12,0,1,0
16,454,454,1,1,0,1,0
30,460,460,66,33,33,2,1
5,470,470,80,80,0,1,0
10,498,498,108,99,9,4,3

4,111,111,18,18,0,1,0
22,119,119,5,5,0,1,0
11,123,123,18,18,0,1,0
29,124,124,12,12,0,1,0
21,125,125,4,4,0,1,0
35,127,127,8,8,0,1,0
10,139,139,23,23,0,1,0
15,141,141,29,29,0,1,0
13,165,165,13,4,9,3,2
5,167,167,32,12,20,4,3
14,187,187,2,2,0,1,0
23,195,195,1,1,0,1,0
27,200,200,26,5,21,2,1
32,203,203,20,20,0,1,0
34,221,221,65,38,27,4,3
39,223,223,31,28,3,2,1
3,240,240,12,12,0,1,0
40,250,250,30,30,0,1,0
12,251,251,2,2,0,1,0
1,257,257,32,32,0,1,0
18,277,277,13,1,12,3,2
8,277,277,14,14,0,1,0
25,297,297,22,10,12,4,3
17,328,328,7,7,0,1,0
6,332,332,84,84,0,1,0
38,338,338,8,8,0,1,0
36,354,354,10,10,0,1,0
16,358,358,5,2,3,2,1
33,386,386,31,31,0,1,0
0,390,390,40,40,0,1,0
24,397,397,44,44,0,1,0
30,399,399,10,10,0,1,0
7,408,408,13,13,0,1,0
19,424,424,40,40,0,1,0
20,424,424,20,20,0,1,0
37,436,436,28,28,0,1,0
9,437,437,8,1,7,2,1
26,444,444,56,25,31,4,3
31,444,444,67,31,36,2,1
2,488,488,25,2,23,4,3
28,489,489,126,30,96,4,3

22,104,104,4,4,0,1,0
13,110,110,1,1,0,1,0
27,113,113,20,20,0,1,0
24,114,114,1,1,0,1,0
31,130,130,12,4,8,2,1
26,148,148,30,16,14,3,2
25,173,173,11,11,0,1,0
28,177,177,2,2,0,1,0
23,188,188,5,5,0,1,0
33,192,192,1,1,0,1,0
7,201,201,5,2,3,2,1
37,226,226,52,43,9,4,3
18,230,230,19,19,0,1,0
29,237,237,4,1,3,2,1
4,250,250,1,1,0,1,0
38,266,266,28,28,0,1,0
43,269,269,33,33,0,1,0
30,276,276,30,30,0,1,0
44,286,286,1,1,0,1,0
20,286,286,51,7,44,3,2
21,290,290,22,8,14,3,2
41,292,292,40,31,9,2,1
35,296,296,71,71,0,1,0
9,319,319,24,6,18,4,3
10,325,325,71,71,0,1,0
11,341,341,21,9,12,2,1
19,341,341,16,16,0,1,0
17,342,342,109,77,32,2,1
8,349,349,23,3,20,2,1
32,352,352,10,1,9,4,3
15,358,358,1,1,0,1,0
16,372,372,37,11,26,2,1
5,396,396,20,14,6,2,1
1,404,404,10,10,0,1,0
40,408,408,29,2,27,4,3
12,411,411,7,7,0,1,0
34,441,441,1,1,0,1,0
36,442,442,6,1,5,2,1
0,450,450,1,1,0,1,0
3,470,470,45,45,0,1,0
14,471,471,103,103,0,1,0
39,478,478,41,41,0,1,0
42,490,490,140,73,67,3,2
2,495,495,23,23,0,1,0
6,496,496,22,22,0,1,0

16,111,111,8,8,0,1,0
2,114,114,6,6,0,1,0
13,129,129,21,7,14,3,2
14,143,143,2,2,0,1,0
23,151,151,15,5,10,3,2
26,156,156,23,9,14,4,3
19,162,162,19,19,0,1,0
10,168,168,4,4,0,1,0
35,196,196,53,35,18,4,3
21,203,203,29,4,25,3,2
33,220,220,32,24,8,3,2
38,228,228,2,2,0,1,0
25,228,228,1,1,0,1,0
3,241,241,37,7,30,2,1
5,261,261,11,11,0,1,0
12,262,262,18,10,8,2,1
37,275,275,4,4,0,1,0
17,301,301,1,1,0,1,0
15,307,307,147,93,54,4,3
20,307,307,65,47,18,2,1
0,312,312,10,10,0,1,0
9,328,328,57,4,53,4,3
4,353,353,8,5,3,2,1
11,355,355,17,5,12,3,2
6,361,361,42,24,18,4,3
30,365,365,14,14,0,1,0
1,369,369,46,38,8,2,1
22,372,372,15,5,10,2,1
32,382,382,58,40,18,2,1
27,382,382,6,6,0,1,0
24,387,387,27,6,21,2,1
36,395,395,65,65,0,1,0
28,401,401,116,116,0,1,0
7,404,404,2,2,0,1,0
8,442,442,49,15,34,3,2
29,443,443,6,2,4,2,1
31,479,479,16,16,0,1,0
18,487,487,38,30,8,3,2
34,499,499,33,19,14,3,2

35,106,106,15,10,5,2,1
0,107,107,20,20,0,1,0
18,130,130,10,3,7,2,1
1,135,135,12,8,4,2,1
28,136,136,27,13,14,3,2
13,148,148,36,36,0,1,0
14,161,161,30,15,15,2,1
24,169,169,1,1,0,1,0
20,192,192,16,16,0,1,0
9,206,206,24,24,0,1,0
16,215,215,32,32,0,1,0
32,218,218,15,15,0,1,0
11,220,220,10,10,0,1,0
25,224,224,1,1,0,1,0
10,231,231,27,3,24,3,2
34,233,233,19,19,0,1,0
31,236,236,23,13,10,3,2
27,236,236,31,22,9,4,3
12,247,247,13,13,0,1,0
33,251,251,11,11,0,1,0
2,300,300,15,15,0,1,0
17,303,303,6,6,0,1,0
5,324,324,21,2,19,2,1
8,328,328,5,5,0,1,0
29,356,356,26,26,0,1,0
6,358,358,159,159,0,1,0
7,362,362,4,4,0,1,0
21,369,369,88,1,87,4,3
3,371,371,10,10,0,1,0
4,379,379,14,14,0,1,0
19,383,383,123,78,45,4,3
23,393,393,1,1,0,1,0
22,442,442,4,4,0,1,0
15,456,456,31,15,16,2,1
26,460,460,13,13,0,1,0
30,471,471,146,146,0,1,0

28,113,113,19,10,9,4,3
5,114,114,3,3,0,1,0
25,145,145,1,1,0,1,0
7,147,147,56,14,42,3,2
31,151,151,6,2,4,2,1
8,156,156,1,1,0,1,0
1,182,182,6,6,0,1,0
0,184,184,4,4,0,1,0
15,186,186,5,1,4,2,1
30,186,186,19,19,0,1,0
42,198,198,12,12,0,1,0
21,233,233,20,14,6,3,2
6,236,236,18,18,0,1,0
32,245,245,26,15,11,2,1
33,253,253,1,1,0,1,0
18,258,258,24,17,7,2,1
35,266,266,56,56,0,1,0
12,274,274,14,4,10,3,2
26,289,289,35,35,0,1,0
3,290,290,1,1,0,1,0
9,298,298,17,2,15,2,1
11,304,304,54,16,38,3,2
24,307,307,30,4,26,2,1
19,316,316,55,55,0,1,0
14,318,318,38,3,35,2,1
23,346,346,51,51,0,1,0
22,352,352,18,15,3,2,1
20,373,373,1,1,0,1,0
13,379,379,7,7,0,1,0
4,381,381,1,1,0,1,0
38,411,411,3,3,0,1,0
40,416,416,11,11,0,1,0
36,416,416,41,1,40,3,2
29,421,421,68,10,58,3,2
10,425,425,30,30,0,1,0
27,434,434,25,25,0,1,0
37,439,439,202,174,28,3,2
2,457,457,6,6,0,1,0
16,460,460,18,18,0,1,0
39,461,461,8,8,0,1,0
17,477,477,107,107,0,1,0
41,483,483,68,56,12,2,1
34,488,488,24,10,14,2,1

9,108,108,6,6,0,1,0
30,111,111,6,3,3,2,1
6,112,112,13,13,0,1,0
33,113,113,27,18,9,2,1
19,115,115,1,1,0,1,0
0,126,126,3,3,0,1,0
5,137,137,21,21,0,1,0
37,142,142,8,4,4,2,1
2,153,153,4,4,0,1,0
4,155,155,10,10,0,1,0
1,155,155,18,3,15,2,1
16,159,159,12,12,0,1,0
12,165,165,6,2,4,2,1
3,171,171,21,15,6,2,1
34,200,200,9,9,0,1,0
17,201,201,4,4,0,1,0
13,203,203,18,7,11,2,1
22,204,204,48,48,0,1,0
23,211,211,11,11,0,1,0
28,218,218,34,18,16,2,1
21,222,222,41,41,0,1,0
27,237,237,19,7,12,2,1
14,257,257,6,6,0,1,0
26,282,282,27,27,0,1,0
29,283,283,10,3,7,2,1
10,331,331,28,28,0,1,0
18,352,352,54,22,32,2,1
31,406,406,115,58,57,4,3
24,416,416,11,1,10,3,2
25,419,419,5,5,0,1,0
36,429,429,31,3,28,4,3
20,454,454,54,48,6,3,2
8,458,458,174,174,0,1,0
15,459,459,82,19,63,4,3
35,468,468,9,9,0,1,0
32,484,484,81,71,10,3,2
7,496,496,1,1,0,1,0
11,500,500,90,90,0,1,0

14,104,104,4,4,0,1,0
15,111,111,2,2,0,1,0
41,127,127,20,20,0,1,0
22,135,135,1,1,0,1,0
45,137,137,18,7,11,2,1
5,142,142,10,10,0,1,0
23,165,165,5,1,4,2,1
10,169,169,26,4,22,2,1
44,176,176,4,4,0,1,0
37,195,195,16,16,0,1,0
19,204,204,23,11,12,3,2
34,210,210,36,36,0,1,0
29,214,214,65,16,49,4,3
18,223,223,11,11,0,1,0
43,228,228,17,6,11,2,1
12,231,231,28,19,9,4,3
32,243,243,4,4,0,1,0
11,245,245,43,43,0,1,0
7,304,304,13,13,0,1,0
40,315,315,21,21,0,1,0
46,324,324,32,8,24,3,2
24,330,330,17,3,14,3,2
0,332,332,32,32,0,1,0
39,335,335,14,6,8,3,2
42,340,340,52,36,16,2,1
21,346,346,28,28,0,1,0
2,363,363,2,2,0,1,0
27,374,374,4,1,3,2,1
13,379,379,2,2,0,1,0
25,386,386,7,1,6,3,2
4,389,389,88,88,0,1,0
28,389,389,117,87,30,2,1
6,396,396,81,81,0,1,0
30,405,405,24,7,17,2,1
16,411,411,51,51,0,1,0
1,412,412,30,14,16,2,1
33,426,426,2,2,0,1,0
31,429,429,31,12,19,2,1
36,434,434,18,2,16,4,3
3,448,448,6,6,0,1,0
35,481,481,7,7,0,1,0
20,481,481,12,2,10,3,2
8,486,486,6,6,0,1,0
17,493,493,39,39,0,1,0
38,494,494,62,6,56,3,2
26,496,496,1,1,0,1,0
9,499,499,27,15,12,2,1

7,102,102,4,4,0,1,0
11,111,111,7,7,0,1,0
5,129,129,12,8,4,2,1
36,133,133,3,3,0,1,0
4,135,135,59,59,0,1,0
29,171,171,10,10,0,1,0
22,172,172,1,1,0,1,0
8,173,173,6,6,0,1,0
24,175,175,1,1,0,1,0
19,182,182,2,2,0,1,0
25,187,187,6,3,3,2,1
16,193,193,8,3,5,2,1
0,211,211,5,5,0,1,0
31,217,217,6,6,0,1,0
13,259,259,37,12,25,2,1
15,261,261,18,10,8,2,1
20,263,263,6,6,0,1,0
28,267,267,44,4,40,2,1
23,281,281,27,14,13,2,1
37,281,281,53,34,19,4,3
18,294,294,23,23,0,1,0
12,301,301,3,3,0,1,0
35,305,305,12,3,9,4,3
33,313,313,20,20,0,1,0
3,318,318,1,1,0,1,0
9,323,323,40,10,30,3,2
26,359,359,144,144,0,1,0
10,361,361,78,78,0,1,0
1,375,375,3,3,0,1,0
21,386,386,206,137,69,4,3
34,400,400,6,6,0,1,0
2,424,424,102,70,32,3,2
14,442,442,47,47,0,1,0
27,447,447,11,11,0,1,0
17,452,452,51,17,34,2,1
38,466,466,10,2,8,2,1
30,478,478,25,25,0,1,0
6,484,484,24,15,9,4,3
32,488,488,75,55,20,3,2

29,102,102,2,2,0,1,0
28,115,115,15,10,5,2,1
0,133,133,32,32,0,1,0
3,166,166,8,3,5,2,1
6,166,166,1,1,0,1,0
23,174,174,62,48,14,3,2
39,178,178,14,14,0,1,0
11,178,178,10,10,0,1,0
31,201,201,49,49,0,1,0
5,203,203,3,3,0,1,0
37,215,215,5,5,0,1,0
20,239,239,26,26,0,1,0
15,253,253,25,25,0,1,0
19,258,258,24,24,0,1,0
25,265,265,24,18,6,2,1
32,279,279,3,3,0,1,0
14,284,284,57,12,45,2,1
2,291,291,10,4,6,3,2
7,304,304,3,3,0,1,0
10,305,305,29,29,0,1,0
9,308,308,36,10,26,4,3
21,310,310,28,28,0,1,0
36,313,313,64,50,14,3,2
34,313,313,12,12,0,1,0
26,322,322,8,8,0,1,0
1,332,332,2,2,0,1,0
12,343,343,20,10,10,3,2
8,364,364,15,15,0,1,0
17,373,373,45,45,0,1,0
24,392,392,6,6,0,1,0
4,394,394,103,103,0,1,0
13,402,402,79,71,8,2,1
38,402,402,31,31,0,1,0
22,414,414,15,15,0,1,0
18,425,425,1,1,0,1,0
35,434,434,78,78,0,1,0
30,450,450,6,6,0,1,0
27,451,451,100,56,44,2,1
16,486,486,44,6,38,3,2
33,498,498,45,34,11,4,3

9,109,109,7,7,0,1,0
38,112,112,17,5,12,2,1
12,146,146,1,1,0,1,0
11,157,157,36,36,0,1,0
29,168,168,51,51,0,1,0
45,169,169,3,3,0,1,0
15,172,172,3,3,0,1,0
31,173,173,12,12,0,1,0
43,180,180,19,11,8,2,1
40,185,185,18,18,0,1,0
18,193,193,69,63,6,2,1
1,200,200,1,1,0,1,0
10,201,201,8,8,0,1,0
44,215,215,14,14,0,1,0
32,217,217,54,54,0,1,0
13,234,234,13,13,0,1,0
26,236,236,14,14,0,1,0
21,240,240,2,2,0,1,0
4,250,250,16,16,0,1,0
33,255,255,18,4,14,2,1
0,262,262,4,4,0,1,0
5,268,268,10,1,9,2,1
17,269,269,1,1,0,1,0
34,271,271,5,1,4,2,1
16,274,274,3,3,0,1,0
8,291,291,38,38,0,1,0
39,314,314,42,32,10,2,1
30,317,317,45,22,23,2,1
36,319,319,51,51,0,1,0
6,323,323,46,37,9,4,3
2,328,328,70,62,8,2,1
7,331,331,2,2,0,1,0
27,335,335,47,39,8,2,1
3,336,336,27,2,25,2,1
37,344,344,47,47,0,1,0
41,352,352,7,4,3,2,1
35,380,380,14,14,0,1,0
25,381,381,9,9,0,1,0
42,390,390,3,3,0,1,0
28,433,433,5,5,0,1,0
24,443,443,2,2,0,1,0
23,449,449,8,8,0,1,0
22,450,450,11,11,0,1,0
19,481,481,38,7,31,2,1
14,483,483,36,36,0,1,0
20,495,495,64,25,39,4,3

28,109,109,2,2,0,1,0
16,120,120,17,9,8,3,2
0,123,123,18,18,0,1,0
37,125,125,95,95,0,1,0
20,180,180,6,6,0,1,0
35,183,183,14,14,0,1,0
27,191,191,22,10,12,4,3
23,192,192,1,1,0,1,0
8,192,192,1,1,0,1,0
3,200,200,8,8,0,1,0
11,212,212,17,17,0,1,0
31,213,213,28,28,0,1,0
12,223,223,60,2,58,3,2
10,224,224,4,4,0,1,0
6,235,235,53,53,0,1,0
17,237,237,71,29,42,3,2
14,247,247,1,1,0,1,0
18,270,270,4,4,0,1,0
38,277,277,1,1,0,1,0
34,289,289,17,13,4,2,1
24,327,327,55,20,35,2,1
29,339,339,53,53,0,1,0
32,358,358,54,54,0,1,0
4,371,371,23,3,20,2,1
13,379,379,22,13,9,4,3
7,386,386,71,3,68,3,2
2,394,394,13,5,8,2,1
1,411,411,48,48,0,1,0
22,416,416,24,24,0,1,0
25,442,442,31,1,30,4,3
19,445,445,33,19,14,2,1
5,447,447,13,5,8,2,1
33,454,454,30,30,0,1,0
26,459,459,36,36,0,1,0
21,467,467,1,1,0,1,0
15,467,467,6,1,5,2,1
30,472,472,6,6,0,1,0
9,475,475,26,26,0,1,0
36,485,485,1,1,0,1,0
39,493,493,4,4,0,1,0

10,121,121,5,2,3,2,1
33,122,122,1,1,0,1,0
22,127,127,4,4,0,1,0
3,128,128,3,3,0,1,0
26,129,129,10,2,8,3,2
29,132,132,21,21,0,1,0
25,138,138,3,3,0,1,0
9,142,142,8,8,0,1,0
37,156,156,46,2,44,3,2
32,165,165,4,4,0,1,0
20,201,201,34,22,12,4,3
4,204,204,7,7,0,1,0
40,210,210,24,16,8,2,1
16,216,216,13,13,0,1,0
6,223,223,22,22,0,1,0
13,226,226,1,1,0,1,0
14,232,232,4,4,0,1,0
7,271,271,7,7,0,1,0
23,272,272,33,11,22,2,1
30,274,274,48,48,0,1,0
28,276,276,1,1,0,1,0
39,291,291,27,15,12,2,1
35,317,317,6,6,0,1,0
15,328,328,74,33,41,3,2
36,329,329,35,16,19,2,1
41,336,336,59,59,0,1,0
1,338,338,115,68,47,2,1
31,355,355,55,55,0,1,0
2,357,357,13,13,0,1,0
18,357,357,7,7,0,1,0
5,365,365,45,45,0,1,0
19,388,388,3,3,0,1,0
27,390,390,17,17,0,1,0
0,417,417,81,34,47,4,3
17,425,425,18,18,0,1,0
12,445,445,30,30,0,1,0
24,457,457,44,23,21,2,1
21,457,457,38,38,0,1,0
11,464,464,88,34,54,4,3
38,487,487,40,10,30,4,3
8,490,490,4,4,0,1,0
34,490,490,82,58,24,3,2

6,101,101,8,8,0,1,0
31,128,128,3,3,0,1,0
27,133,133,33,16,17,2,1
1,149,149,45,45,0,1,0
12,150,150,1,1,0,1,0
10,166,166,45,45,0,1,0
13,168,168,1,1,0,1,0
20,190,190,8,8,0,1,0
18,193,193,10,10,0,1,0
32,194,194,1,1,0,1,0
9,206,206,11,3,8,3,2
23,211,211,35,6,29,4,3
21,246,246,3,3,0,1,0
15,254,254,8,8,0,1,0
17,260,260,65,65,0,1,0
0,262,262,9,3,6,3,2
29,263,263,21,21,0,1,0
24,263,263,13,13,0,1,0
14,290,290,78,78,0,1,0
7,294,294,31,23,8,2,1
22,298,298,10,10,0,1,0
16,300,300,9,5,4,2,1
8,340,340,132,113,19,2,1
11,377,377,57,36,21,4,3
28,377,377,116,116,0,1,0
30,380,380,71,44,27,4,3
4,385,385,4,4,0,1,0
25,388,388,11,11,0,1,0
26,389,389,19,19,0,1,0
3,456,456,1,1,0,1,0
19,456,456,36,6,30,4,3
2,457,457,192,183,9,2,1
5,494,494,35,35,0,1,0

32,105,105,19,19,0,1,0
29,110,110,3,3,0,1,0
11,140,140,32,32,0,1,0
1,151,151,38,38,0,1,0
23,159,159,2,2,0,1,0
24,164,164,16,2,14,2,1
9,172,172,9,9,0,1,0
22,176,176,11,5,6,2,1
7,179,179,39,25,14,3,2
25,188,188,34,12,22,2,1
2,204,204,2,2,0,1,0
3,234,234,1,1,0,1,0
20,235,235,69,69,0,1,0
15,239,239,35,5,30,2,1
14,256,256,19,19,0,1,0
35,258,258,1,1,0,1,0
26,266,266,82,82,0,1,0
19,276,276,24,24,0,1,0
28,282,282,1,1,0,1,0
21,290,290,22,22,0,1,0
5,311,311,89,67,22,3,2
33,319,319,93,23,70,3,2
13,321,321,80,59,21,4,3
12,358,358,16,10,6,3,2
34,372,372,8,8,0,1,0
30,374,374,69,69,0,1,0
18,381,381,13,7,6,2,1
31,388,388,6,6,0,1,0
8,391,391,6,1,5,2,1
17,420,420,1,1,0,1,0
4,430,430,29,29,0,1,0
6,444,444,50,50,0,1,0
10,461,461,6,2,4,2,1
27,464,464,26,26,0,1,0
0,467,467,6,2,4,2,1
16,478,478,55,5,50,3,2

16,109,109,33,17,16,2,1
25,110,110,6,6,0,1,0
12,112,112,9,1,8,2,1
19,129,129,19,5,14,4,3
28,141,141,3,3,0,1,0
8,142,142,1,1,0,1,0
35,158,158,5,5,0,1,0
6,165,165,7,7,0,1,0
30,166,166,3,3,0,1,0
21,178,178,5,5,0,1,0
23,183,183,7,7,0,1,0
9,183,183,28,28,0,1,0
27,194,194,1,1,0,1,0
22,195,195,20,20,0,1,0
37,200,200,3,3,0,1,0
0,213,213,6,6,0,1,0
20,217,217,13,8,5,2,1
26,218,218,21,21,0,1,0
10,219,219,34,34,0,1,0
2,238,238,9,3,6,3,2
4,240,240,32,32,0,1,0
34,243,243,51,32,19,2,1
13,255,255,48,48,0,1,0
3,263,263,34,7,27,2,1
33,267,267,45,17,28,2,1
31,293,293,65,65,0,1,0
36,297,297,19,19,0,1,0
29,337,337,48,39,9,4,3
15,376,376,19,11,8,2,1
24,388,388,20,4,16,3,2
7,398,398,1,1,0,1,0
40,407,407,1,1,0,1,0
1,409,409,2,2,0,1,0
5,415,415,61,28,33,2,1
17,416,416,31,2,29,2,1
39,425,425,48,21,27,4,3
11,432,432,46,46,0,1,0
32,452,452,182,86,96,4,3
38,458,458,78,71,7,2,1
14,467,467,10,10,0,1,0
18,470,470,2,2,0,1,0

26,116,116,1,1,0,1,0
46,122,122,33,33,0,1,0
38,128,128,1,1,0,1,0
17,138,138,6,6,0,1,0
4,142,142,2,2,0,1,0
40,142,142,1,1,0,1,0
18,152,152,3,3,0,1,0
27,162,162,16,16,0,1,0
0,168,168,23,23,0,1,0
9,173,173,1,1,0,1,0
22,192,192,15,9,6,2,1
13,192,192,2,2,0,1,0
10,198,198,2,2,0,1,0
8,206,206,41,13,28,3,2
5,221,221,14,14,0,1,0
19,224,224,11,1,10,3,2
14,226,226,3,3,0,1,0
20,254,254,1,1,0,1,0
44,257,257,6,6,0,1,0
3,283,283,41,41,0,1,0
2,285,285,62,47,15,4,3
45,285,285,19,19,0,1,0
15,295,295,20,4,16,3,2
37,307,307,111,51,60,3,2
33,313,313,72,72,0,1,0
29,334,334,20,8,12,3,2
21,343,343,22,22,0,1,0
11,355,355,12,12,0,1,0
41,357,357,52,40,12,4,3
36,366,366,22,22,0,1,0
43,392,392,50,50,0,1,0
24,403,403,1,1,0,1,0
39,413,413,48,5,43,3,2
35,422,422,4,1,3,2,1
42,427,427,85,85,0,1,0
32,429,429,10,6,4,2,1
31,439,439,11,2,9,3,2
25,447,447,19,19,0,1,0
12,467,467,37,37,0,1,0
7,469,469,131,91,40,4,3
23,474,474,29,1,28,3,2
28,479,479,45,16,29,2,1
6,481,481,14,6,8,3,2
34,483,483,45,36,9,4,3
30,489,489,7,7,0,1,0
1,497,497,44,30,14,3,2
16,499,499,19,19,0,1,0

15,104,104,27,27,0,1,0
30,112,112,2,2,0,1,0
11,130,130,14,14,0,1,0
2,140,140,3,3,0,1,0
13,140,140,4,1,3,2,1
29,142,142,59,41,18,2,1
20,147,147,11,11,0,1,0
25,151,151,13,13,0,1,0
7,160,160,13,13,0,1,0
23,181,181,37,31,6,2,1
26,185,185,13,5,8,3,2
0,196,196,18,18,0,1,0
33,199,199,1,1,0,1,0
18,203,203,5,5,0,1,0
1,206,206,22,22,0,1,0
19,215,215,19,19,0,1,0
22,240,240,30,9,21,2,1
5,258,258,47,1,46,3,2
21,281,281,17,1,16,2,1
14,289,289,36,12,24,4,3
12,294,294,19,7,12,3,2
17,309,309,12,12,0,1,0
32,315,315,62,19,43,2,1
34,329,329,22,22,0,1,0
9,332,332,25,6,19,2,1
4,385,385,26,4,22,2,1
3,397,397,16,10,6,2,1
24,402,402,16,6,10,2,1
10,409,409,35,25,10,3,2
28,410,410,92,44,48,2,1
8,422,422,138,68,70,4,3
27,428,428,2,2,0,1,0
35,448,448,65,21,44,4,3
31,459,459,21,2,19,2,1
16,464,464,63,63,0,1,0
6,480,480,48,6,42,3,2

2,110,110,6,1,5,2,1
0,130,130,39,39,0,1,0
27,142,142,24,24,0,1,0
22,144,144,7,7,0,1,0
28,151,151,3,3,0,1,0
30,166,166,30,9,21,2,1
23,168,168,29,6,23,2,1
8,203,203,13,13,0,1,0
17,214,214,2,2,0,1,0
31,227,227,22,22,0,1,0
12,240,240,8,8,0,1,0
6,248,248,43,21,22,3,2
18,259,259,2,2,0,1,0
32,268,268,15,15,0,1,0
1,273,273,85,57,28,2,1
7,281,281,18,18,0,1,0
3,284,284,14,9,5,2,1
29,327,327,14,14,0,1,0
11,338,338,14,14,0,1,0
20,345,345,40,40,0,1,0
5,346,346,73,73,0,1,0
16,358,358,27,18,9,4,3
4,382,382,75,57,18,2,1
25,388,388,29,29,0,1,0
9,396,396,104,84,20,2,1
10,402,402,25,25,0,1,0
19,407,407,120,32,88,3,2
14,436,436,17,17,0,1,0
24,457,457,109,42,67,4,3
21,472,472,3,3,0,1,0
15,485,485,76,7,69,4,3
26,487,487,61,28,33,4,3
13,487,487,38,38,0,1,0

30,117,117,16,16,0,1,0
4,130,130,4,4,0,1,0
16,143,143,27,15,12,2,1
14,159,159,2,2,0,1,0
9,187,187,48,48,0,1,0
24,188,188,20,11,9,3,2
7,204,204,41,25,16,3,2
17,205,205,38,38,0,1,0
2,224,224,9,9,0,1,0
26,225,225,13,13,0,1,0
25,236,236,34,34,0,1,0
19,244,244,4,4,0,1,0
21,268,268,50,35,15,2,1
36,276,276,8,8,0,1,0
18,276,276,8,4,4,2,1
32,279,279,27,27,0,1,0
15,284,284,31,31,0,1,0
22,290,290,2,2,0,1,0
13,296,296,6,6,0,1,0
20,302,302,41,41,0,1,0
23,327,327,14,14,0,1,0
12,328,328,37,11,26,3,2
0,335,335,44,44,0,1,0
11,347,347,51,51,0,1,0
6,357,357,11,6,5,2,1
33,358,358,59,8,51,4,3
31,361,361,20,3,17,2,1
27,373,373,52,19,33,2,1
34,392,392,118,84,34,2,1
37,396,396,9,9,0,1,0
1,402,402,62,11,51,3,2
10,421,421,30,1,29,2,1
5,423,423,22,12,10,2,1
29,452,452,31,31,0,1,0
35,457,457,1,1,0,1,0
8,460,460,22,11,11,3,2
28,492,492,104,104,0,1,0
3,499,499,41,22,19,2,1

22,100,100,5,5,0,1,0
32,100,100,2,2,0,1,0
34,106,106,23,23,0,1,0
37,131,131,8,8,0,1,0
27,131,131,27,27,0,1,0
36,132,132,48,48,0,1,0
28,160,160,1,1,0,1,0
39,167,167,41,6,35,2,1
10,171,171,14,14,0,1,0
15,172,172,13,9,4,2,1
35,184,184,8,8,0,1,0
33,189,189,19,19,0,1,0
30,195,195,8,8,0,1,0
7,207,207,21,21,0,1,0
19,215,215,16,11,5,2,1
16,220,220,6,6,0,1,0
24,232,232,6,2,4,2,1
14,233,233,7,1,6,2,1
29,246,246,19,8,11,2,1
38,263,263,37,7,30,4,3
4,269,269,13,13,0,1,0
11,284,284,49,21,28,2,1
20,288,288,6,1,5,2,1
2,308,308,19,3,16,4,3
13,327,327,14,1,13,3,2
31,343,343,4,4,0,1,0
0,367,367,89,56,33,4,3
18,375,375,31,25,6,3,2
25,387,387,48,48,0,1,0
23,390,390,8,4,4,2,1
17,411,411,9,9,0,1,0
5,414,414,9,9,0,1,0
12,420,420,9,9,0,1,0
6,430,430,37,21,16,3,2
21,435,435,20,20,0,1,0
3,454,454,67,67,0,1,0
8,470,470,222,222,0,1,0
26,483,483,76,37,39,4,3
1,483,483,28,28,0,1,0
9,489,489,6,6,0,1,0

5,105,105,16,16,0,1,0
1,106,106,1,1,0,1,0
15,144,144,3,3,0,1,0
14,167,167,2,2,0,1,0
13,169,169,33,33,0,1,0
8,188,188,1,1,0,1,0
30,218,218,35,1,34,4,3
31,241,241,12,7,5,2,1
20,252,252,56,56,0,1,0
24,264,264,33,33,0,1,0
18,266,266,3,3,0,1,0
19,267,267,58,26,32,3,2
16,289,289,4,4,0,1,0
25,294,294,13,9,4,2,1
29,295,295,33,14,19,2,1
9,302,302,36,36,0,1,0
6,307,307,36,26,10,3,2
21,335,335,29,29,0,1,0
27,338,338,9,5,4,2,1
26,338,338,100,8,92,3,2
17,338,338,5,5,0,1,0
0,343,343,52,24,28,3,2
23,345,345,100,100,0,1,0
32,349,349,21,21,0,1,0
3,354,354,97,69,28,2,1
7,356,356,14,14,0,1,0
10,399,399,20,20,0,1,0
28,414,414,60,60,0,1,0
12,459,459,153,119,34,3,2
33,476,476,9,6,3,2,1
22,490,490,8,8,0,1,0
4,494,494,93,93,0,1,0
11,498,498,57,57,0,1,0
2,500,500,70,70,0,1,0

14,102,102,1,1,0,1,0
29,107,107,19,15,4,2,1
36,119,119,7,4,3,2,1
11,135,135,6,6,0,1,0
10,155,155,30,30,0,1,0
7,168,168,49,49,0,1,0
6,171,171,5,1,4,2,1
12,187,187,1,1,0,1,0
31,190,190,10,10,0,1,0
38,193,193,3,3,0,1,0
15,194,194,19,2,17,2,1
32,207,207,1,1,0,1,0
26,207,207,33,33,0,1,0
4,227,227,10,10,0,1,0
22,230,230,63,63,0,1,0
30,250,250,26,26,0,1,0
21,262,262,90,12,78,4,3
13,267,267,4,4,0,1,0
23,267,267,10,10,0,1,0
25,283,283,7,7,0,1,0
34,298,298,27,12,15,3,2
18,319,319,44,2,42,4,3
35,335,335,13,2,11,2,1
8,343,343,76,7,69,4,3
17,343,343,22,22,0,1,0
3,346,346,4,1,3,2,1
28,351,351,43,23,20,3,2
1,359,359,20,20,0,1,0
2,365,365,1,1,0,1,0
33,365,365,59,26,33,4,3
19,385,385,23,6,17,2,1
24,399,399,8,8,0,1,0
0,404,404,192,180,12,3,2
27,423,423,39,12,27,2,1
37,434,434,30,12,18,2,1
9,472,472,29,20,9,2,1
5,487,487,1,1,0,1,0
20,488,488,49,49,0,1,0
16,490,490,38,22,16,2,1

20,100,100,5,5,0,1,0
14,107,107,4,4,0,1,0
24,119,119,14,14,0,1,0
19,121,121,9,9,0,1,0
3,130,130,42,42,0,1,0
4,150,150,13,13,0,1,0
41,162,162,36,21,15,4,3
23,169,169,25,3,22,3,2
21,200,200,5,5,0,1,0
36,205,205,2,2,0,1,0
16,211,211,5,5,0,1,0
30,214,214,33,7,26,3,2
1,249,249,7,7,0,1,0
35,263,263,9,3,6,2,1
22,288,288,14,14,0,1,0
15,300,300,33,33,0,1,0
6,310,310,8,5,3,2,1
12,312,312,4,4,0,1,0
7,313,313,21,5,16,2,1
40,327,327,7,7,0,1,0
0,337,337,32,32,0,1,0
9,347,347,57,57,0,1,0
25,351,351,44,29,15,4,3
10,358,358,1,1,0,1,0
27,359,359,28,15,13,2,1
39,362,362,55,43,12,4,3
29,363,363,10,1,9,4,3
17,374,374,5,5,0,1,0
11,376,376,28,28,0,1,0
26,380,380,57,45,12,2,1
18,385,385,101,87,14,3,2
8,388,388,60,15,45,4,3
34,394,394,12,12,0,1,0
13,397,397,14,5,9,2,1
37,401,401,21,10,11,2,1
28,413,413,25,25,0,1,0
31,421,421,4,4,0,1,0
33,437,437,27,27,0,1,0
32,439,439,206,206,0,1,0
5,442,442,82,3,79,3,2
2,454,454,1,1,0,1,0
38,455,455,7,1,6,3,2

29,107,107,12,12,0,1,0
17,108,108,6,6,0,1,0
8,120,120,12,2,10,3,2
32,123,123,20,20,0,1,0
6,161,161,105,1,104,4,3
13,183,183,49,49,0,1,0
2,194,194,10,10,0,1,0
9,196,196,1,1,0,1,0
27,204,204,38,38,0,1,0
19,211,211,11,1,10,3,2
23,224,224,12,12,0,1,0
25,232,232,31,6,25,2,1
31,236,236,10,4,6,3,2
7,248,248,16,16,0,1,0
22,248,248,59,59,0,1,0
20,248,248,48,48,0,1,0
11,255,255,47,32,15,4,3
28,273,273,9,9,0,1,0
30,280,280,15,15,0,1,0
16,285,285,25,1,24,2,1
33,286,286,19,19,0,1,0
26,287,287,27,27,0,1,0
14,309,309,57,57,0,1,0
4,361,361,8,8,0,1,0
15,363,363,62,62,0,1,0
12,377,377,3,3,0,1,0
10,378,378,31,31,0,1,0
18,386,386,18,18,0,1,0
5,394,394,11,1,10,3,2
21,396,396,30,30,0,1,0
1,404,404,7,7,0,1,0
0,413,413,19,9,10,3,2
24,428,428,37,37,0,1,0
3,500,500,94,88,6,3,2

4,104,104,12,12,0,1,0
0,111,111,31,7,24,2,1
19,116,116,2,2,0,1,0
1,136,136,3,3,0,1,0
31,136,136,3,3,0,1,0
25,137,137,7,7,0,1,0
32,172,172,30,30,0,1,0
33,178,178,52,26,26,3,2
18,183,183,23,4,19,2,1
7,209,209,18,18,0,1,0
23,230,230,12,7,5,2,1
9,256,256,42,29,13,2,1
29,258,258,20,20,0,1,0
16,279,279,32,32,0,1,0
10,282,282,43,28,15,4,3
14,283,283,1,1,0,1,0
2,296,296,70,70,0,1,0
8,299,299,10,4,6,2,1
11,323,323,66,66,0,1,0
22,327,327,5,5,0,1,0
5,330,330,2,2,0,1,0
30,334,334,12,2,10,2,1
26,352,352,8,8,0,1,0
12,359,359,130,85,45,4,3
20,375,375,49,19,30,3,2
15,389,389,44,44,0,1,0
17,425,425,22,22,0,1,0
13,428,428,39,39,0,1,0
27,437,437,98,98,0,1,0
6,437,437,43,13,30,3,2
3,443,443,20,13,7,2,1
28,450,450,75,37,38,2,1
21,471,471,71,7,64,4,3
24,477,477,52,4,48,3,2

22,101,101,3,3,0,1,0
18,114,114,15,15,0,1,0
24,116,116,12,12,0,1,0
34,126,126,1,1,0,1,0
31,131,131,30,30,0,1,0
30,131,131,3,3,0,1,0
3,132,132,2,2,0,1,0
2,135,135,31,17,14,3,2
32,136,136,4,4,0,1,0
14,184,184,3,3,0,1,0
5,192,192,31,7,24,3,2
23,198,198,33,10,23,2,1
4,218,218,10,10,0,1,0
33,224,224,1,1,0,1,0
28,224,224,12,7,5,2,1
8,233,233,42,42,0,1,0
19,272,272,18,2,16,3,2
29,297,297,36,8,28,3,2
27,327,327,12,12,0,1,0
13,330,330,5,5,0,1,0
6,330,330,27,27,0,1,0
7,356,356,17,17,0,1,0
17,358,358,49,34,15,4,3
9,375,375,2,2,0,1,0
11,376,376,55,35,20,3,2
15,383,383,83,58,25,3,2
26,385,385,33,21,12,3,2
1,386,386,39,39,0,1,0
21,392,392,23,23,0,1,0
20,393,393,110,56,54,3,2
12,438,438,47,47,0,1,0
0,475,475,213,213,0,1,0
16,482,482,152,94,58,4,3
10,484,484,40,40,0,1,0
25,491,491,37,37,0,1,0

29,109,109,13,13,0,1,0
27,114,114,12,9,3,2,1
21,116,116,2,2,0,1,0
0,131,131,2,2,0,1,0
16,146,146,1,1,0,1,0
1,166,166,1,1,0,1,0
10,177,177,20,14,6,2,1
38,183,183,15,15,0,1,0
19,197,197,29,29,0,1,0
37,215,215,3,3,0,1,0
28,232,232,11,5,6,3,2
35,245,245,76,31,45,2,1
15,245,245,10,1,9,3,2
18,246,246,16,4,12,2,1
20,275,275,49,1,48,4,3
2,292,292,18,9,9,2,1
32,297,297,11,5,6,3,2
23,300,300,25,25,0,1,0
22,301,301,17,17,0,1,0
3,307,307,21,21,0,1,0
13,307,307,21,6,15,2,1
5,311,311,29,29,0,1,0
4,313,313,51,6,45,4,3
9,327,327,8,2,6,2,1
24,343,343,37,19,18,3,2
41,346,346,44,32,12,3,2
14,357,357,1,1,0,1,0
34,368,368,19,19,0,1,0
8,391,391,30,17,13,2,1
25,391,391,28,6,22,3,2
31,392,392,88,78,10,3,2
11,396,396,26,5,21,2,1
42,397,397,16,4,12,2,1
7,398,398,123,75,48,3,2
17,403,403,25,4,21,4,3
30,420,420,21,21,0,1,0
6,427,427,23,23,0,1,0
12,435,435,53,36,17,2,1
26,450,450,134,90,44,2,1
36,455,455,55,55,0,1,0
39,460,460,7,7,0,1,0
40,473,473,55,32,23,4,3
33,500,500,2,2,0,1,0

30,107,107,10,2,8,2,1
16,114,114,5,5,0,1,0
31,133,133,3,3,0,1,0
6,140,140,13,5,8,2,1
29,144,144,11,4,7,2,1
28,155,155,14,7,7,2,1
38,164,164,1,1,0,1,0
15,166,166,1,1,0,1,0
7,178,178,54,54,0,1,0
11,184,184,18,18,0,1,0
5,203,203,58,58,0,1,0
17,207,207,16,16,0,1,0
22,224,224,5,2,3,2,1
25,227,227,74,74,0,1,0
24,231,231,14,8,6,2,1
4,232,232,11,8,3,2,1
27,242,242,35,1,34,2,1
35,265,265,16,16,0,1,0
19,276,276,22,2,20,2,1
34,290,290,4,4,0,1,0
9,304,304,25,6,19,2,1
32,306,306,56,56,0,1,0
10,350,350,21,7,14,2,1
20,361,361,88,88,0,1,0
18,376,376,8,8,0,1,0
8,385,385,28,28,0,1,0
3,396,396,53,53,0,1,0
36,397,397,71,42,29,2,1
37,404,404,20,20,0,1,0
13,419,419,54,16,38,2,1
0,430,430,1,1,0,1,0
12,433,433,81,37,44,3,2
23,449,449,98,87,11,2,1
14,458,458,1,1,0,1,0
2,460,460,5,2,3,2,1
33,468,468,25,11,14,2,1
26,481,481,23,17,6,2,1
1,483,483,80,33,47,2,1
21,497,497,28,21,7,2,1

41,102,102,13,1,12,3,2
38,103,103,16,16,0,1,0
11,109,109,1,1,0,1,0
16,134,134,5,5,0,1,0
39,149,149,2,2,0,1,0
4,165,165,34,8,26,3,2
40,167,167,5,5,0,1,0
18,178,178,4,4,0,1,0
26,189,189,48,36,12,4,3
8,192,192,21,3,18,4,3
3,200,200,43,19,24,3,2
43,208,208,21,21,0,1,0
13,223,223,54,3,51,4,3
28,227,227,19,19,0,1,0
23,231,231,9,2,7,2,1
10,232,232,25,7,18,2,1
6,239,239,11,7,4,2,1
35,242,242,18,11,7,2,1
33,257,257,1,1,0,1,0
2,270,270,25,25,0,1,0
0,272,272,4,4,0,1,0
9,274,274,4,4,0,1,0
29,301,301,55,31,24,4,3
21,310,310,9,9,0,1,0
15,316,316,78,28,50,4,3
20,329,329,14,5,9,4,3
24,340,340,18,8,10,3,2
32,340,340,53,8,45,4,3
19,341,341,21,12,9,4,3
36,356,356,30,30,0,1,0
25,367,367,26,26,0,1,0
31,367,367,8,8,0,1,0
34,380,380,70,14,56,4,3
12,386,386,2,2,0,1,0
30,389,389,17,17,0,1,0
27,407,407,6,6,0,1,0
14,436,436,32,15,17,2,1
1,461,461,13,8,5,2,1
42,462,462,59,59,0,1,0
7,463,463,1,1,0,1,0
5,468,468,3,3,0,1,0
37,478,478,105,16,89,4,3
17,489,489,20,14,6,2,1
22,498,498,78,54,24,4,3

28,109,109,17,3,14,2,1
1,113,113,1,1,0,1,0
8,133,133,5,1,4,2,1
18,134,134,4,1,3,2,1
17,135,135,1,1,0,1,0
26,160,160,9,9,0,1,0
36,162,162,8,8,0,1,0
38,169,169,14,14,0,1,0
16,172,172,21,21,0,1,0
34,178,178,54,36,18,2,1
11,202,202,13,13,0,1,0
5,203,203,1,1,0,1,0
12,205,205,13,13,0,1,0
44,219,219,40,12,28,2,1
4,227,227,17,17,0,1,0
30,242,242,7,7,0,1,0
32,263,263,32,32,0,1,0
23,274,274,57,57,0,1,0
22,278,278,18,18,0,1,0
19,280,280,16,16,0,1,0
33,281,281,4,4,0,1,0
14,290,290,6,6,0,1,0
27,310,310,54,6,48,3,2
45,311,311,23,20,3,2,1
10,316,316,4,4,0,1,0
13,352,352,106,94,12,3,2
37,353,353,2,2,0,1,0
15,357,357,1,1,0,1,0
31,380,380,15,8,7,2,1
43,392,392,8,5,3,2,1
2,394,394,1,1,0,1,0
24,397,397,1,1,0,1,0
25,397,397,8,8,0,1,0
35,404,404,95,95,0,1,0
41,404,404,4,4,0,1,0
39,406,406,115,17,98,4,3
0,424,424,23,9,14,2,1
3,433,433,178,121,57,4,3
40,437,437,16,16,0,1,0
9,459,459,28,14,14,3,2
29,461,461,23,1,22,4,3
6,464,464,39,29,10,3,2
21,466,466,25,6,19,2,1
20,483,483,22,4,18,3,2
42,494,494,33,9,24,3,2
7,495,495,17,17,0,1,0

27,112,112,8,5,3,2,1
1,136,136,28,28,0,1,0
20,139,139,2,2,0,1,0
33,148,148,12,12,0,1,0
7,154,154,4,4,0,1,0
21,154,154,17,7,10,2,1
24,169,169,14,14,0,1,0
19,180,180,16,1,15,2,1
8,180,180,20,6,14,2,1
32,185,185,54,30,24,2,1
15,186,186,1,1,0,1,0
6,199,199,6,3,3,2,1
18,238,238,53,35,18,3,2
0,240,240,6,2,4,2,1
11,245,245,75,55,20,2,1
29,272,272,101,87,14,3,2
31,273,273,2,2,0,1,0
10,283,283,73,73,0,1,0
4,289,289,38,38,0,1,0
16,303,303,26,1,25,2,1
12,322,322,60,10,50,2,1
30,330,330,66,66,0,1,0
22,339,339,25,25,0,1,0
9,344,344,77,77,0,1,0
13,355,355,10,4,6,3,2
25,359,359,1,1,0,1,0
2,382,382,9,9,0,1,0
23,384,384,19,19,0,1,0
3,396,396,8,8,0,1,0
14,409,409,101,65,36,4,3
26,413,413,35,8,27,4,3
34,418,418,19,19,0,1,0
28,422,422,16,16,0,1,0
17,449,449,7,7,0,1,0
5,493,493,36,36,0,1,0

14,108,108,1,1,0,1,0
31,113,113,5,5,0,1,0
23,116,116,13,7,6,2,1
16,122,122,1,1,0,1,0
11,132,132,6,2,4,2,1
25,135,135,12,12,0,1,0
6,145,145,10,10,0,1,0
3,153,153,4,4,0,1,0
12,169,169,12,12,0,1,0
15,181,181,5,1,4,2,1
33,182,182,1,1,0,1,0
5,185,185,27,15,12,4,3
9,194,194,1,1,0,1,0
28,197,197,45,24,21,4,3
7,223,223,13,13,0,1,0
8,241,241,7,2,5,2,1
34,244,244,1,1,0,1,0
24,256,256,18,11,7,2,1
36,276,276,125,125,0,1,0
41,284,284,27,12,15,4,3
32,298,298,27,27,0,1,0
18,310,310,37,17,20,3,2
35,314,314,11,1,10,3,2
40,328,328,22,22,0,1,0
37,331,331,28,17,11,2,1
10,341,341,58,58,0,1,0
13,351,351,118,80,38,3,2
42,395,395,5,5,0,1,0
22,413,413,7,4,3,2,1
19,416,416,43,43,0,1,0
2,417,417,29,11,18,4,3
38,419,419,7,7,0,1,0
17,431,431,12,12,0,1,0
1,434,434,1,1,0,1,0
29,448,448,73,73,0,1,0
30,448,448,48,24,24,4,3
26,452,452,27,17,10,3,2
21,453,453,66,66,0,1,0
39,461,461,43,43,0,1,0
27,464,464,101,101,0,1,0
0,468,468,12,12,0,1,0
4,474,474,69,69,0,1,0
20,491,491,67,67,0,1,0

18,104,104,1,1,0,1,0
14,113,113,1,1,0,1,0
19,118,118,8,1,7,2,1
11,121,121,23,15,8,3,2
22,125,125,9,1,8,2,1
8,126,126,5,5,0,1,0
16,138,138,15,15,0,1,0
40,139,139,2,2,0,1,0
31,140,140,37,25,12,4,3
37,141,141,5,5,0,1,0
28,144,144,3,3,0,1,0
23,145,145,3,3,0,1,0
9,146,146,7,7,0,1,0
20,164,164,40,10,30,2,1
0,177,177,33,13,20,2,1
15,181,181,5,5,0,1,0
3,188,188,58,7,51,4,3
35,193,193,19,6,13,4,3
21,195,195,3,3,0,1,0
24,204,204,52,22,30,2,1
33,243,243,51,5,46,4,3
41,247,247,5,5,0,1,0
6,254,254,3,3,0,1,0
30,261,261,1,1,0,1,0
26,267,267,33,6,27,4,3
1,272,272,3,3,0,1,0
25,278,278,2,2,0,1,0
7,278,278,23,23,0,1,0
17,283,283,22,22,0,1,0
13,284,284,5,5,0,1,0
12,306,306,21,1,20,2,1
39,319,319,73,55,18,3,2
27,319,319,6,2,4,2,1
32,326,326,43,12,31,2,1
29,369,369,4,4,0,1,0
5,393,393,41,29,12,4,3
10,394,394,4,1,3,2,1
36,400,400,41,17,24,2,1
4,412,412,58,58,0,1,0
34,414,414,142,113,29,2,1
2,478,478,26,26,0,1,0
38,482,482,16,16,0,1,0

14,143,143,25,25,0,1,0
27,149,149,3,3,0,1,0
24,154,154,43,37,6,2,1
9,160,160,5,5,0,1,0
20,171,171,32,32,0,1,0
2,171,171,13,13,0,1,0
34,192,192,3,3,0,1,0
16,200,200,12,12,0,1,0
32,200,200,50,50,0,1,0
30,202,202,19,19,0,1,0
35,210,210,5,5,0,1,0
26,223,223,5,5,0,1,0
5,240,240,48,48,0,1,0
39,241,241,24,7,17,2,1
13,247,247,8,8,0,1,0
23,257,257,34,34,0,1,0
0,262,262,6,6,0,1,0
38,263,263,38,38,0,1,0
11,271,271,6,6,0,1,0
10,281,281,18,10,8,3,2
19,288,288,3,3,0,1,0
28,289,289,4,4,0,1,0
8,290,290,2,2,0,1,0
21,295,295,12,12,0,1,0
36,299,299,29,5,24,3,2
41,319,319,9,9,0,1,0
25,327,327,23,9,14,2,1
15,343,343,9,9,0,1,0
33,359,359,96,96,0,1,0
29,361,361,19,13,6,3,2
7,367,367,158,138,20,2,1
12,378,378,45,45,0,1,0
17,386,386,59,59,0,1,0
31,393,393,3,3,0,1,0
18,394,394,17,5,12,2,1
3,411,411,7,7,0,1,0
4,434,434,10,10,0,1,0
1,451,451,1,1,0,1,0
22,471,471,54,54,0,1,0
6,471,471,21,2,19,4,3
37,484,484,125,116,9,2,1
40,492,492,27,2,25,2,1

3,121,121,21,2,19,2,1
8,127,127,13,4,9,3,2
9,145,145,7,1,6,3,2
21,180,180,4,4,0,1,0
17,185,185,17,2,15,4,3
19,191,191,39,35,4,2,1
20,195,195,12,4,8,2,1
31,206,206,25,3,22,4,3
34,210,210,50,50,0,1,0
14,226,226,23,23,0,1,0
27,227,227,1,1,0,1,0
6,251,251,36,15,21,4,3
29,253,253,6,6,0,1,0
25,254,254,8,8,0,1,0
30,266,266,11,8,3,2,1
12,270,270,61,37,24,3,2
10,282,282,69,69,0,1,0
18,288,288,16,12,4,2,1
13,297,297,20,20,0,1,0
11,324,324,14,6,8,2,1
15,333,333,32,32,0,1,0
16,340,340,108,79,29,2,1
5,353,353,4,4,0,1,0
33,353,353,65,38,27,4,3
0,362,362,23,23,0,1,0
23,384,384,89,72,17,2,1
22,388,388,12,2,10,2,1
7,396,396,85,13,72,4,3
32,399,399,34,34,0,1,0
4,434,434,55,9,46,2,1
26,447,447,34,7,27,4,3
1,454,454,24,6,18,3,2
28,467,467,9,3,6,2,1
24,491,491,48,48,0,1,0
2,500,500,93,45,48,2,1

39,140,140,12,3,9,4,3
8,146,146,2,2,0,1,0
28,149,149,5,5,0,1,0
20,158,158,23,23,0,1,0
1,166,166,5,5,0,1,0
24,173,173,3,3,0,1,0
35,180,180,15,15,0,1,0
13,192,192,7,7,0,1,0
0,204,204,29,29,0,1,0
21,211,211,59,33,26,2,1
14,216,216,9,9,0,1,0
9,217,217,24,24,0,1,0
37,227,227,103,23,80,3,2
10,232,232,15,15,0,1,0
2,232,232,34,34,0,1,0
38,277,277,3,3,0,1,0
19,281,281,1,1,0,1,0
26,288,288,5,5,0,1,0
5,293,293,4,4,0,1,0
29,295,295,5,1,4,2,1
31,296,296,19,19,0,1,0
40,304,304,11,2,9,2,1
34,324,324,65,1,64,4,3
6,333,333,53,53,0,1,0
12,339,339,7,7,0,1,0
33,343,343,38,6,32,3,2
17,348,348,40,40,0,1,0
18,355,355,3,3,0,1,0
22,365,365,116,5,111,4,3
27,366,366,41,41,0,1,0
25,367,367,76,2,74,4,3
30,391,391,22,22,0,1,0
23,443,443,27,1,26,4,3
11,444,444,35,35,0,1,0
32,446,446,17,14,3,2,1
3,465,465,102,28,74,4,3
36,476,476,5,5,0,1,0
4,477,477,50,50,0,1,0
16,481,481,8,8,0,1,0
15,482,482,41,6,35,4,3
7,490,490,33,17,16,3,2

26,107,107,13,13,0,1,0
29,112,112,13,3,10,2,1
33,114,114,22,22,0,1,0
12,124,124,4,1,3,2,1
19,158,158,10,10,0,1,0
6,164,164,1,1,0,1,0
9,173,173,24,19,5,2,1
16,182,182,26,26,0,1,0
23,202,202,6,6,0,1,0
22,217,217,15,5,10,2,1
5,225,225,18,18,0,1,0
25,235,235,61,25,36,3,2
4,238,238,1,1,0,1,0
15,239,239,4,4,0,1,0
10,256,256,95,65,30,2,1
11,266,266,65,3,62,3,2
27,267,267,10,10,0,1,0
31,270,270,20,8,12,3,2
28,291,291,32,32,0,1,0
24,293,293,6,6,0,1,0
20,298,298,32,6,26,2,1
8,305,305,31,26,5,2,1
2,328,328,142,142,0,1,0
7,339,339,3,3,0,1,0
21,353,353,16,16,0,1,0
18,356,356,55,55,0,1,0
1,372,372,25,4,21,2,1
0,382,382,112,103,9,2,1
14,383,383,6,6,0,1,0
17,398,398,123,99,24,3,2
32,413,413,11,11,0,1,0
13,416,416,20,20,0,1,0
3,443,443,25,5,20,4,3
30,455,455,24,24,0,1,0

34,105,105,6,6,0,1,0
39,106,106,3,3,0,1,0
7,119,119,12,12,0,1,0
22,131,131,22,22,0,1,0
15,132,132,3,3,0,1,0
5,143,143,7,4,3,2,1
29,150,150,3,3,0,1,0
23,158,158,8,8,0,1,0
0,158,158,35,35,0,1,0
6,161,161,1,1,0,1,0
17,162,162,24,24,0,1,0
1,170,170,20,2,18,2,1
12,175,175,10,10,0,1,0
31,181,181,10,4,6,2,1
25,184,184,10,10,0,1,0
30,201,201,12,12,0,1,0
14,215,215,1,1,0,1,0
26,226,226,20,10,10,2,1
32,230,230,82,82,0,1,0
9,245,245,93,27,66,4,3
38,264,264,41,41,0,1,0
8,300,300,1,1,0,1,0
3,307,307,1,1,0,1,0
33,316,316,42,9,33,2,1
35,318,318,98,17,81,4,3
21,320,320,72,72,0,1,0
36,322,322,51,51,0,1,0
27,327,327,18,6,12,2,1
10,349,349,6,3,3,2,1
2,358,358,5,1,4,2,1
24,362,362,24,3,21,4,3
19,366,366,12,3,9,2,1
20,395,395,8,8,0,1,0
4,412,412,37,19,18,4,3
16,425,425,44,26,18,4,3
28,437,437,25,11,14,3,2
11,437,437,2,2,0,1,0
13,454,454,58,23,35,2,1
37,454,454,23,23,0,1,0
18,457,457,70,2,68,3,2
40,483,483,10,10,0,1,0

10,110,110,5,5,0,1,0
31,137,137,4,4,0,1,0
11,143,143,2,2,0,1,0
13,168,168,5,5,0,1,0
18,170,170,14,14,0,1,0
32,187,187,22,22,0,1,0
20,199,199,23,9,14,3,2
3,202,202,39,33,6,2,1
9,213,213,80,18,62,3,2
26,222,222,3,3,0,1,0
8,244,244,2,2,0,1,0
34,250,250,44,44,0,1,0
4,256,256,26,20,6,2,1
17,265,265,39,39,0,1,0
15,266,266,18,1,17,2,1
24,275,275,15,5,10,2,1
30,279,279,78,30,48,4,3
16,281,281,17,17,0,1,0
1,286,286,81,57,24,2,1
12,300,300,27,11,16,4,3
0,352,352,84,57,27,4,3
29,356,356,8,8,0,1,0
22,365,365,21,21,0,1,0
25,366,366,15,8,7,2,1
27,386,386,9,9,0,1,0
21,388,388,45,33,12,3,2
28,402,402,16,16,0,1,0
19,407,407,110,41,69,4,3
23,415,415,18,18,0,1,0
5,416,416,53,53,0,1,0
6,431,431,52,11,41,2,1
7,443,443,7,7,0,1,0
2,446,446,39,39,0,1,0
33,476,476,44,44,0,1,0
14,495,495,22,6,16,2,1
35,495,495,106,67,39,4,3

2,103,103,2,2,0,1,0
6,130,130,23,15,8,2,1
36,143,143,12,12,0,1,0
30,147,147,1,1,0,1,0
20,149,149,1,1,0,1,0
8,208,208,28,16,12,2,1
7,220,220,6,6,0,1,0
4,223,223,14,14,0,1,0
34,224,224,71,61,10,3,2
5,229,229,14,8,6,3,2
13,232,232,30,16,14,3,2
28,256,256,25,5,20,2,1
0,262,262,8,8,0,1,0
23,270,270,3,3,0,1,0
11,275,275,28,6,22,3,2
19,280,280,36,36,0,1,0
21,289,289,36,31,5,2,1
17,293,293,114,114,0,1,0
10,321,321,15,4,11,2,1
9,355,355,13,13,0,1,0
3,358,358,11,7,4,2,1
35,365,365,82,33,49,4,3
15,381,381,102,102,0,1,0
25,394,394,72,3,69,4,3
27,398,398,24,24,0,1,0
24,399,399,79,79,0,1,0
31,406,406,5,5,0,1,0
18,432,432,26,14,12,3,2
32,433,433,56,20,36,4,3
33,441,441,9,9,0,1,0
16,441,441,84,81,3,2,1
14,444,444,59,59,0,1,0
12,462,462,5,5,0,1,0
1,467,467,25,11,14,2,1
26,472,472,18,11,7,2,1
29,476,476,41,41,0,1,0
22,498,498,72,64,8,2,1

5,112,112,6,6,0,1,0
33,127,127,3,3,0,1,0
13,136,136,3,3,0,1,0
21,144,144,12,12,0,1,0
15,159,159,13,13,0,1,0
1,172,172,7,3,4,2,1
12,176,176,53,17,36,3,2
29,186,186,31,1,30,3,2
40,193,193,3,3,0,1,0
32,196,196,33,33,0,1,0
16,204,204,23,23,0,1,0
10,225,225,46,13,33,2,1
28,242,242,6,6,0,1,0
7,254,254,3,3,0,1,0
9,258,258,14,2,12,2,1
38,260,260,22,4,18,2,1
0,280,280,7,7,0,1,0
35,293,293,19,19,0,1,0
19,297,297,40,23,17,2,1
24,306,306,52,11,41,2,1
4,324,324,2,2,0,1,0
37,331,331,25,25,0,1,0
2,354,354,12,12,0,1,0
30,354,354,83,58,25,2,1
31,355,355,35,35,0,1,0
22,356,356,35,3,32,3,2
34,366,366,18,5,13,2,1
11,366,366,2,2,0,1,0
6,373,373,18,6,12,4,3
25,373,373,33,33,0,1,0
39,381,381,53,43,10,2,1
36,397,397,20,20,0,1,0
18,401,401,95,72,23,2,1
17,401,401,13,13,0,1,0
27,409,409,139,63,76,4,3
3,443,443,116,47,69,4,3
8,444,444,19,19,0,1,0
26,454,454,8,4,4,2,1
20,474,474,41,12,29,2,1
23,481,481,14,14,0,1,0
14,490,490,10,10,0,1,0

20,101,101,5,5,0,1,0
26,102,102,4,4,0,1,0
46,109,109,9,3,6,2,1
32,110,110,17,2,15,2,1
38,115,115,1,1,0,1,0
14,134,134,4,4,0,1,0
36,142,142,1,1,0,1,0
35,152,152,15,15,0,1,0
23,158,158,5,5,0,1,0
47,195,195,16,8,8,2,1
44,199,199,2,2,0,1,0
17,206,206,1,1,0,1,0
1,219,219,2,2,0,1,0
19,221,221,1,1,0,1,0
42,229,229,18,4,14,2,1
12,232,232,8,8,0,1,0
34,251,251,2,2,0,1,0
0,256,256,11,1,10,2,1
40,263,263,2,2,0,1,0
18,267,267,8,4,4,2,1
8,275,275,12,12,0,1,0
15,276,276,17,4,13,2,1
10,282,282,25,25,0,1,0
43,291,291,31,7,24,3,2
24,311,311,18,18,0,1,0
45,311,311,66,44,22,3,2
37,330,330,18,12,6,2,1
27,334,334,29,12,17,2,1
25,337,337,29,18,11,2,1
41,347,347,145,40,105,4,3
28,351,351,9,9,0,1,0
13,358,358,22,22,0,1,0
21,363,363,6,6,0,1,0
2,369,369,45,19,26,2,1
7,372,372,1,1,0,1,0
33,374,374,18,18,0,1,0
4,376,376,36,12,24,2,1
16,380,380,53,11,42,3,2
22,385,385,22,7,15,2,1
9,388,388,70,19,51,4,3
6,415,415,133,133,0,1,0
11,444,444,3,3,0,1,0
5,449,449,69,69,0,1,0
3,451,451,8,8,0,1,0
39,458,458,26,11,15,2,1
29,468,468,123,114,9,2,1
30,484,484,22,22,0,1,0
31,485,485,98,32,66,3,2

23,111,111,4,4,0,1,0
22,118,118,7,7,0,1,0
9,122,122,6,3,3,2,1
29,125,125,3,3,0,1,0
6,160,160,16,16,0,1,0
42,171,171,23,9,14,3,2
0,184,184,2,2,0,1,0
47,189,189,23,23,0,1,0
7,191,191,17,17,0,1,0
19,191,191,2,2,0,1,0
38,191,191,6,6,0,1,0
32,193,193,14,14,0,1,0
3,205,205,3,3,0,1,0
21,212,212,2,2,0,1,0
11,213,213,32,32,0,1,0
39,214,214,29,29,0,1,0
26,223,223,4,1,3,2,1
2,228,228,1,1,0,1,0
25,232,232,12,12,0,1,0
46,243,243,3,3,0,1,0
34,244,244,9,3,6,3,2
27,244,244,31,4,27,3,2
36,249,249,3,3,0,1,0
30,276,276,139,139,0,1,0
43,281,281,79,43,36,3,2
5,287,287,10,1,9,4,3
31,289,289,4,4,0,1,0
28,317,317,17,10,7,2,1
35,338,338,31,31,0,1,0
8,346,346,26,8,18,2,1
1,349,349,106,88,18,2,1
40,355,355,17,17,0,1,0
41,376,376,37,37,0,1,0
15,379,379,13,8,5,2,1
37,387,387,30,30,0,1,0
16,387,387,60,12,48,2,1
24,395,395,3,3,0,1,0
33,399,399,45,45,0,1,0
44,409,409,41,41,0,1,0
13,417,417,1,1,0,1,0
10,423,423,32,18,14,3,2
12,432,432,63,16,47,4,3
20,437,437,21,6,15,2,1
45,447,447,15,15,0,1,0
18,471,471,13,13,0,1,0
17,479,479,26,26,0,1,0
14,481,481,27,1,26,2,1
4,498,498,49,49,0,1,0

0,105,105,8,8,0,1,0
7,124,124,2,2,0,1,0
8,142,142,1,1,0,1,0
17,143,143,12,12,0,1,0
21,148,148,28,28,0,1,0
16,149,149,1,1,0,1,0
33,175,175,3,3,0,1,0
9,187,187,10,3,7,2,1
27,202,202,43,43,0,1,0
22,209,209,27,27,0,1,0
34,217,217,3,3,0,1,0
32,224,224,9,3,6,2,1
2,246,246,22,22,0,1,0
6,256,256,8,1,7,2,1
1,258,258,67,67,0,1,0
13,267,267,53,53,0,1,0
3,279,279,5,5,0,1,0
35,296,296,36,6,30,3,2
25,309,309,16,16,0,1,0
20,328,328,19,8,11,2,1
15,330,330,77,10,67,4,3
28,332,332,38,7,31,2,1
10,361,361,127,127,0,1,0
24,375,375,3,3,0,1,0
23,390,390,50,32,18,3,2
19,398,398,27,22,5,2,1
14,422,422,21,21,0,1,0
5,428,428,31,31,0,1,0
12,438,438,20,20,0,1,0
18,443,443,118,118,0,1,0
29,450,450,88,88,0,1,0
26,450,450,37,15,22,3,2
11,465,465,68,68,0,1,0
4,468,468,76,36,40,2,1
31,481,481,57,6,51,4,3
30,483,483,55,46,9,4,3
36,498,498,1,1,0,1,0

32,107,107,3,3,0,1,0
21,110,110,5,2,3,2,1
3,119,119,3,3,0,1,0
0,135,135,19,4,15,3,2
24,147,147,9,9,0,1,0
18,149,149,47,14,33,4,3
2,152,152,3,3,0,1,0
35,157,157,3,3,0,1,0
6,168,168,1,1,0,1,0
14,168,168,33,33,0,1,0
11,170,170,38,38,0,1,0
28,175,175,5,5,0,1,0
19,179,179,15,15,0,1,0
33,185,185,10,2,8,2,1
20,258,258,17,2,15,2,1
23,270,270,4,4,0,1,0
30,321,321,12,3,9,2,1
25,339,339,16,16,0,1,0
10,344,344,4,1,3,2,1
13,348,348,9,9,0,1,0
17,380,380,46,34,12,2,1
8,389,389,83,9,74,3,2
27,394,394,25,25,0,1,0
1,399,399,32,8,24,2,1
34,413,413,142,61,81,4,3
29,418,418,17,2,15,2,1
15,418,418,42,42,0,1,0
16,421,421,29,14,15,4,3
4,432,432,14,14,0,1,0
7,438,438,34,16,18,2,1
12,441,441,14,4,10,2,1
5,457,457,107,62,45,2,1
9,461,461,191,191,0,1,0
26,461,461,9,9,0,1,0
22,463,463,98,49,49,4,3
31,482,482,163,163,0,1,0

11,103,103,18,4,14,2,1
3,111,111,44,38,6,2,1
13,122,122,8,2,6,2,1
1,131,131,5,5,0,1,0
22,147,147,24,4,20,3,2
5,167,167,21,11,10,2,1
16,169,169,4,4,0,1,0
27,176,176,12,12,0,1,0
10,195,195,40,40,0,1,0
21,204,204,4,4,0,1,0
25,206,206,12,7,5,2,1
18,236,236,13,13,0,1,0
6,240,240,26,18,8,3,2
35,265,265,16,16,0,1,0
12,273,273,8,2,6,3,2
33,274,274,53,53,0,1,0
15,283,283,8,8,0,1,0
32,295,295,2,2,0,1,0
14,314,314,2,2,0,1,0
29,325,325,22,1,21,4,3
2,334,334,74,12,62,3,2
28,336,336,20,20,0,1,0
4,342,342,3,3,0,1,0
34,345,345,55,44,11,2,1
30,353,353,33,33,0,1,0
20,356,356,9,6,3,2,1
36,357,357,44,28,16,3,2
23,358,358,23,20,3,2,1
8,368,368,64,64,0,1,0
19,371,371,59,59,0,1,0
26,387,387,112,73,39,2,1
31,392,392,45,45,0,1,0
9,434,434,62,36,26,2,1
24,441,441,68,19,49,3,2
7,446,446,28,21,7,2,1
17,472,472,27,5,22,3,2
0,495,495,16,16,0,1,0

16,101,101,6,1,5,2,1
3,103,103,3,3,0,1,0
33,104,104,21,6,15,2,1
7,112,112,15,15,0,1,0
20,124,124,4,4,0,1,0
34,132,132,2,2,0,1,0
9,133,133,4,1,3,2,1
4,172,172,2,2,0,1,0
0,199,199,40,31,9,4,3
10,209,209,9,1,8,2,1
2,209,209,103,59,44,2,1
19,218,218,15,2,13,4,3
22,223,223,68,68,0,1,0
17,230,230,10,10,0,1,0
26,240,240,55,55,0,1,0
15,249,249,22,22,0,1,0
6,257,257,51,42,9,4,3
30,261,261,19,19,0,1,0
13,275,275,48,48,0,1,0
23,315,315,4,4,0,1,0
28,315,315,24,24,0,1,0
32,322,322,76,76,0,1,0
12,326,326,35,35,0,1,0
24,340,340,41,41,0,1,0
11,353,353,17,7,10,2,1
5,353,353,32,32,0,1,0
25,359,359,56,26,30,4,3
14,389,389,8,2,6,3,2
18,402,402,91,69,22,2,1
27,403,403,11,11,0,1,0
8,415,415,86,86,0,1,0
29,448,448,1,1,0,1,0
31,450,450,12,12,0,1,0
1,457,457,12,3,9,2,1
21,480,480,14,14,0,1,0

19,120,120,1,1,0,1,0
3,132,132,19,19,0,1,0
26,134,134,5,2,3,2,1
15,142,142,7,1,6,2,1
5,152,152,28,28,0,1,0
8,164,164,4,4,0,1,0
28,175,175,42,38,4,2,1
39,190,190,3,3,0,1,0
23,195,195,6,6,0,1,0
9,199,199,2,2,0,1,0
31,201,201,13,13,0,1,0
32,224,224,13,13,0,1,0
12,227,227,36,36,0,1,0
24,234,234,40,3,37,3,2
40,239,239,27,27,0,1,0
42,244,244,30,30,0,1,0
13,251,251,1,1,0,1,0
22,251,251,41,41,0,1,0
20,254,254,7,7,0,1,0
29,269,269,13,8,5,2,1
4,279,279,15,15,0,1,0
7,286,286,1,1,0,1,0
10,289,289,1,1,0,1,0
14,290,290,41,15,26,2,1
16,307,307,91,91,0,1,0
34,315,315,63,42,21,2,1
25,317,317,7,7,0,1,0
6,324,324,14,4,10,2,1
0,325,325,3,3,0,1,0
1,326,326,11,6,5,2,1
41,330,330,2,2,0,1,0
21,331,331,7,7,0,1,0
38,349,349,26,26,0,1,0
18,364,364,99,67,32,3,2
33,381,381,53,7,46,2,1
2,381,381,49,49,0,1,0
37,427,427,113,101,12,3,2
11,435,435,2,2,0,1,0
30,453,453,9,9,0,1,0
36,477,477,6,6,0,1,0
17,480,480,41,41,0,1,0
35,490,490,53,5,48,2,1
27,499,499,107,8,99,4,3

23,106,106,3,3,0,1,0
28,118,118,6,6,0,1,0
2,126,126,12,12,0,1,0
19,146,146,7,7,0,1,0
7,159,159,1,1,0,1,0
27,171,171,13,13,0,1,0
16,199,199,8,8,0,1,0
12,209,209,13,13,0,1,0
30,227,227,6,6,0,1,0
0,234,234,31,1,30,2,1
4,234,234,3,3,0,1,0
1,234,234,70,70,0,1,0
33,237,237,22,22,0,1,0
22,240,240,21,21,0,1,0
32,254,254,11,5,6,3,2
9,263,263,33,33,0,1,0
29,277,277,51,7,44,2,1
17,288,288,37,37,0,1,0
14,304,304,40,2,38,4,3
25,309,309,36,36,0,1,0
5,358,358,61,61,0,1,0
31,362,362,21,5,16,3,2
38,369,369,49,6,43,2,1
37,376,376,68,68,0,1,0
3,376,376,13,13,0,1,0
21,378,378,19,5,14,2,1
11,381,381,18,18,0,1,0
8,389,389,9,9,0,1,0
24,395,395,100,100,0,1,0
13,399,399,32,32,0,1,0
15,424,424,43,31,12,3,2
20,435,435,6,1,5,2,1
26,444,444,33,17,16,2,1
6,448,448,13,10,3,2,1
18,450,450,68,14,54,3,2
35,451,451,10,6,4,2,1
10,458,458,83,45,38,4,3
36,460,460,192,188,4,2,1
34,469,469,14,14,0,1,0

25,108,108,4,4,0,1,0
30,130,130,13,13,0,1,0
0,155,155,33,33,0,1,0
11,162,162,3,3,0,1,0
32,170,170,10,10,0,1,0
5,195,195,32,9,23,2,1
8,209,209,23,13,10,3,2
34,227,227,23,1,22,2,1
33,237,237,26,22,4,2,1
20,246,246,33,9,24,3,2
12,249,249,24,19,5,2,1
2,251,251,27,6,21,4,3
1,268,268,103,43,60,3,2
3,287,287,14,14,0,1,0
6,290,290,19,19,0,1,0
31,295,295,5,5,0,1,0
7,304,304,13,3,10,2,1
35,311,311,1,1,0,1,0
22,319,319,13,13,0,1,0
18,340,340,56,6,50,4,3
29,353,353,55,55,0,1,0
27,362,362,120,120,0,1,0
24,363,363,16,16,0,1,0
15,381,381,4,1,3,2,1
23,383,383,1,1,0,1,0
4,386,386,41,17,24,4,3
9,397,397,10,3,7,2,1
10,419,419,42,18,24,2,1
28,423,423,22,2,20,2,1
16,431,431,25,17,8,3,2
26,462,462,26,11,15,2,1
21,469,469,101,31,70,3,2
19,472,472,18,6,12,3,2
14,479,479,30,30,0,1,0
17,481,481,131,99,32,3,2
13,499,499,144,52,92,3,2

9,100,100,2,2,0,1,0
25,124,124,6,6,0,1,0
24,151,151,51,51,0,1,0
2,174,174,39,39,0,1,0
17,177,177,13,13,0,1,0
13,184,184,4,4,0,1,0
5,189,189,54,35,19,2,1
20,196,196,5,1,4,2,1
31,208,208,5,5,0,1,0
6,228,228,45,29,16,2,1
15,231,231,5,5,0,1,0
1,243,243,18,3,15,4,3
8,266,266,22,14,8,2,1
21,273,273,38,1,37,2,1
29,276,276,9,1,8,3,2
18,279,279,15,15,0,1,0
22,281,281,19,19,0,1,0
28,288,288,17,17,0,1,0
27,316,316,5,5,0,1,0
3,322,322,108,19,89,4,3
4,331,331,46,46,0,1,0
26,333,333,2,2,0,1,0
33,335,335,55,11,44,2,1
12,338,338,38,38,0,1,0
0,361,361,4,4,0,1,0
34,371,371,10,10,0,1,0
10,381,381,109,64,45,4,3
16,382,382,1,1,0,1,0
19,402,402,158,136,22,3,2
23,404,404,101,20,81,4,3
32,419,419,13,13,0,1,0
11,424,424,34,34,0,1,0
30,482,482,90,90,0,1,0
14,497,497,2,2,0,1,0
7,500,500,3,3,0,1,0

20,106,106,11,11,0,1,0
8,118,118,6,6,0,1,0
12,142,142,3,3,0,1,0
30,158,158,30,6,24,4,3
2,162,162,22,22,0,1,0
3,175,175,20,8,12,3,2
27,183,183,25,16,9,4,3
21,203,203,50,50,0,1,0
4,218,218,29,1,28,2,1
28,219,219,8,2,6,2,1
9,244,244,40,40,0,1,0
0,268,268,94,62,32,3,2
25,270,270,27,27,0,1,0
7,272,272,12,12,0,1,0
5,278,278,58,58,0,1,0
23,285,285,11,11,0,1,0
14,291,291,48,9,39,2,1
1,358,358,27,13,14,3,2
29,359,359,19,19,0,1,0
26,367,367,10,6,4,2,1
24,368,368,9,9,0,1,0
10,370,370,36,8,28,3,2
18,378,378,19,19,0,1,0
19,411,411,62,30,32,3,2
17,421,421,91,91,0,1,0
6,421,421,20,20,0,1,0
22,434,434,110,110,0,1,0
11,464,464,222,99,123,4,3
15,470,470,33,33,0,1,0
16,471,471,5,1,4,2,1
13,489,489,20,20,0,1,0

2,108,108,8,4,4,2,1
15,115,115,3,3,0,1,0
24,117,117,10,5,5,2,1
36,123,123,13,6,7,2,1
39,123,123,53,49,4,2,1
9,125,125,21,8,13,2,1
35,131,131,12,12,0,1,0
38,133,133,4,4,0,1,0
6,139,139,5,5,0,1,0
22,146,146,13,13,0,1,0
19,152,152,8,8,0,1,0
27,159,159,40,40,0,1,0
3,176,176,16,5,11,2,1
37,200,200,8,5,3,2,1
23,207,207,6,3,3,2,1
13,215,215,20,2,18,4,3
17,219,219,1,1,0,1,0
8,261,261,10,2,8,3,2
28,264,264,2,2,0,1,0
7,282,282,22,22,0,1,0
41,288,288,15,15,0,1,0
0,293,293,50,29,21,2,1
30,299,299,3,3,0,1,0
18,309,309,27,3,24,4,3
10,316,316,15,3,12,4,3
14,334,334,15,15,0,1,0
4,347,347,7,7,0,1,0
20,351,351,27,21,6,2,1
11,363,363,15,15,0,1,0
32,374,374,31,8,23,2,1
16,384,384,28,28,0,1,0
1,386,386,54,54,0,1,0
34,386,386,49,3,46,3,2
25,386,386,87,60,27,4,3
29,387,387,37,2,35,3,2
12,395,395,26,22,4,2,1
26,404,404,58,1,57,4,3
33,440,440,13,13,0,1,0
21,446,446,151,71,80,4,3
42,473,473,18,18,0,1,0
31,480,480,18,4,14,3,2
40,480,480,31,24,7,2,1
5,486,486,9,3,6,2,1

19,108,108,10,7,3,2,1
0,111,111,4,4,0,1,0
34,117,117,6,6,0,1,0
23,120,120,14,14,0,1,0
10,136,136,3,3,0,1,0
9,165,165,3,3,0,1,0
7,186,186,4,4,0,1,0
26,188,188,34,20,14,2,1
17,245,245,22,22,0,1,0
1,251,251,30,30,0,1,0
8,265,265,116,91,25,2,1
13,272,272,49,6,43,2,1
39,277,277,1,1,0,1,0
33,278,278,6,6,0,1,0
14,288,288,4,4,0,1,0
37,295,295,3,3,0,1,0
31,309,309,56,35,21,2,1
20,316,316,31,11,20,4,3
30,322,322,111,97,14,3,2
32,325,325,51,51,0,1,0
27,331,331,8,8,0,1,0
28,349,349,64,29,35,2,1
6,361,361,7,7,0,1,0
5,378,378,11,11,0,1,0
11,383,383,4,4,0,1,0
12,396,396,14,14,0,1,0
3,405,405,62,17,45,4,3
4,408,408,3,3,0,1,0
21,421,421,65,17,48,3,2
16,421,421,30,21,9,4,3
35,428,428,9,9,0,1,0
15,431,431,47,47,0,1,0
38,437,437,49,13,36,4,3
29,451,451,63,23,40,4,3
22,458,458,6,6,0,1,0
18,475,475,2,2,0,1,0
2,477,477,159,127,32,3,2
24,479,479,97,97,0,1,0
25,495,495,1,1,0,1,0
36,497,497,6,6,0,1,0

2,112,112,6,6,0,1,0
17,117,117,13,1,12,2,1
35,124,124,9,1,8,2,1
33,131,131,8,8,0,1,0
9,152,152,23,2,21,4,3
26,174,174,55,55,0,1,0
25,195,195,2,2,0,1,0
19,214,214,19,6,13,2,1
10,225,225,1,1,0,1,0
6,264,264,45,6,39,4,3
13,270,270,1,1,0,1,0
27,271,271,30,30,0,1,0
20,273,273,9,6,3,2,1
31,284,284,61,52,9,4,3
4,285,285,39,39,0,1,0
28,315,315,13,3,10,4,3
15,320,320,7,7,0,1,0
18,348,348,1,1,0,1,0
36,362,362,71,71,0,1,0
7,368,368,130,56,74,4,3
0,372,372,51,48,3,2,1
22,373,373,197,59,138,4,3
23,381,381,6,6,0,1,0
34,391,391,5,5,0,1,0
14,400,400,11,11,0,1,0
1,423,423,105,105,0,1,0
24,427,427,22,11,11,2,1
3,445,445,20,20,0,1,0
11,460,460,65,65,0,1,0
21,462,462,1,1,0,1,0
30,468,468,68,31,37,4,3
16,469,469,31,7,24,2,1
32,471,471,11,7,4,2,1
12,471,471,17,2,15,4,3
5,472,472,68,68,0,1,0
8,492,492,26,12,14,3,2
29,500,500,7,1,6,3,2

38,116,116,3,3,0,1,0
39,120,120,3,3,0,1,0
26,123,123,23,9,14,2,1
16,137,137,20,20,0,1,0
14,143,143,9,9,0,1,0
5,177,177,16,16,0,1,0
31,177,177,16,16,0,1,0
27,183,183,18,2,16,2,1
10,209,209,4,4,0,1,0
36,213,213,7,7,0,1,0
20,215,215,18,11,7,2,1
0,221,221,1,1,0,1,0
24,221,221,4,4,0,1,0
30,234,234,16,8,8,2,1
29,236,236,7,1,6,2,1
2,238,238,34,13,21,4,3
33,250,250,10,4,6,2,1
4,255,255,16,16,0,1,0
11,259,259,38,2,36,3,2
9,271,271,21,11,10,2,1
1,284,284,55,26,29,2,1
19,284,284,45,3,42,3,2
15,305,305,1,1,0,1,0
21,324,324,52,52,0,1,0
18,348,348,2,2,0,1,0
6,351,351,1,1,0,1,0
13,358,358,18,18,0,1,0
17,372,372,1,1,0,1,0
7,374,374,5,2,3,2,1
28,383,383,3,3,0,1,0
22,415,415,67,22,45,4,3
32,419,419,17,1,16,2,1
3,434,434,13,13,0,1,0
34,444,444,5,5,0,1,0
8,445,445,22,10,12,2,1
35,447,447,89,45,44,3,2
12,448,448,250,250,0,1,0
23,450,450,57,57,0,1,0
25,490,490,290,290,0,1,0
37,495,495,16,10,6,3,2

29,113,113,2,2,0,1,0
8,118,118,9,9,0,1,0
35,120,120,4,4,0,1,0
11,120,120,14,14,0,1,0
42,121,121,2,2,0,1,0
36,139,139,6,6,0,1,0
23,146,146,3,3,0,1,0
2,154,154,31,31,0,1,0
13,158,158,1,1,0,1,0
6,163,163,28,28,0,1,0
12,172,172,28,4,24,2,1
20,172,172,8,2,6,2,1
37,184,184,19,9,10,3,2
14,216,216,15,15,0,1,0
34,232,232,29,29,0,1,0
5,237,237,9,9,0,1,0
41,253,253,31,7,24,2,1
4,261,261,3,3,0,1,0
16,266,266,3,3,0,1,0
24,308,308,55,50,5,2,1
25,322,322,1,1,0,1,0
26,329,329,10,2,8,3,2
31,334,334,71,46,25,3,2
39,362,362,18,18,0,1,0
9,376,376,26,9,17,4,3
18,388,388,31,4,27,3,2
0,390,390,10,10,0,1,0
40,399,399,23,4,19,3,2
21,399,399,121,59,62,3,2
1,407,407,31,20,11,2,1
7,414,414,2,2,0,1,0
38,427,427,49,9,40,2,1
15,441,441,9,9,0,1,0
10,449,449,51,51,0,1,0
30,450,450,60,60,0,1,0
22,456,456,1,1,0,1,0
19,459,459,21,6,15,4,3
32,469,469,81,7,74,4,3
3,473,473,48,9,39,2,1
28,490,490,114,48,66,4,3
27,494,494,75,75,0,1,0
17,497,497,65,3,62,4,3
33,497,497,69,39,30,4,3

27,124,124,31,15,16,3,2
21,131,131,1,1,0,1,0
26,135,135,2,2,0,1,0
32,136,136,11,5,6,3,2
35,139,139,18,4,14,3,2
0,147,147,3,3,0,1,0
22,153,153,4,1,3,2,1
14,169,169,3,3,0,1,0
19,183,183,26,6,20,4,3
15,200,200,3,3,0,1,0
41,200,200,11,11,0,1,0
29,203,203,72,32,40,3,2
30,205,205,14,3,11,2,1
9,225,225,3,3,0,1,0
36,227,227,8,3,5,2,1
2,236,236,43,43,0,1,0
33,236,236,13,13,0,1,0
25,236,236,33,33,0,1,0
11,252,252,35,35,0,1,0
38,252,252,42,42,0,1,0
24,257,257,15,6,9,4,3
7,259,259,39,23,16,2,1
5,307,307,1,1,0,1,0
23,321,321,25,25,0,1,0
37,335,335,23,23,0,1,0
39,339,339,40,40,0,1,0
20,341,341,12,12,0,1,0
16,359,359,42,3,39,4,3
1,362,362,4,1,3,2,1
34,371,371,13,13,0,1,0
3,376,376,17,3,14,3,2
40,377,377,40,40,0,1,0
28,388,388,47,47,0,1,0
17,396,396,105,50,55,4,3
6,424,424,48,19,29,2,1
42,442,442,21,21,0,1,0
4,447,447,87,51,36,2,1
18,450,450,7,7,0,1,0
10,457,457,87,27,60,4,3
13,465,465,23,23,0,1,0
12,477,477,22,2,20,3,2
31,480,480,18,18,0,1,0
8,489,489,11,2,9,4,3

19,103,103,6,6,0,1,0
30,129,129,12,1,11,2,1
34,154,154,41,31,10,2,1
4,154,154,20,20,0,1,0
21,159,159,22,17,5,2,1
37,167,167,18,4,14,2,1
23,191,191,37,16,21,4,3
10,192,192,28,24,4,2,1
31,196,196,35,35,0,1,0
13,208,208,6,6,0,1,0
0,236,236,28,28,0,1,0
6,243,243,27,7,20,2,1
7,280,280,13,6,7,2,1
24,285,285,11,2,9,4,3
29,290,290,146,146,0,1,0
39,308,308,1,1,0,1,0
8,322,322,9,9,0,1,0
5,327,327,21,21,0,1,0
33,327,327,2,2,0,1,0
38,330,330,11,11,0,1,0
35,344,344,4,4,0,1,0
17,344,344,1,1,0,1,0
18,346,346,10,5,5,2,1
20,348,348,12,7,5,2,1
25,354,354,1,1,0,1,0
1,368,368,63,63,0,1,0
26,371,371,17,11,6,2,1
22,378,378,3,3,0,1,0
15,388,388,5,5,0,1,0
27,421,421,46,46,0,1,0
28,426,426,5,5,0,1,0
11,431,431,13,5,8,2,1
32,441,441,64,30,34,3,2
14,446,446,142,112,30,3,2
12,449,449,118,118,0,1,0
2,470,470,2,2,0,1,0
16,470,470,70,70,0,1,0
36,474,474,14,14,0,1,0
3,481,481,25,11,14,3,2
9,487,487,50,50,0,1,0

29,108,108,11,11,0,1,0
44,138,138,7,7,0,1,0
38,142,142,2,2,0,1,0
16,143,143,12,12,0,1,0
9,147,147,10,2,8,3,2
18,157,157,32,16,16,2,1
14,177,177,6,6,0,1,0
13,189,189,7,3,4,2,1
4,198,198,1,1,0,1,0
26,207,207,10,10,0,1,0
40,207,207,6,6,0,1,0
30,216,216,49,20,29,4,3
33,227,227,15,15,0,1,0
28,243,243,11,11,0,1,0
25,252,252,21,8,13,2,1
27,260,260,4,4,0,1,0
6,265,265,4,1,3,2,1
19,269,269,27,27,0,1,0
45,270,270,50,11,39,2,1
7,270,270,41,21,20,3,2
39,276,276,82,31,51,4,3
8,287,287,11,11,0,1,0
31,288,288,2,2,0,1,0
34,289,289,32,24,8,2,1
10,295,295,13,13,0,1,0
41,312,312,17,7,10,3,2
21,314,314,5,1,4,2,1
36,322,322,25,25,0,1,0
2,331,331,68,68,0,1,0
35,353,353,74,24,50,3,2
5,355,355,33,33,0,1,0
3,366,366,1,1,0,1,0
24,368,368,7,7,0,1,0
43,369,369,18,6,12,4,3
20,371,371,9,9,0,1,0
23,375,375,23,1,22,2,1
17,383,383,1,1,0,1,0
37,395,395,53,53,0,1,0
32,402,402,81,65,16,2,1
12,404,404,77,14,63,4,3
15,408,408,8,3,5,2,1
42,420,420,24,2,22,2,1
11,424,424,58,58,0,1,0
1,427,427,7,7,0,1,0
0,443,443,42,42,0,1,0
22,462,462,50,34,16,3,2

12,101,101,1,1,0,1,0
2,109,109,28,28,0,1,0
22,121,121,10,1,9,4,3
17,135,135,5,5,0,1,0
28,138,138,28,16,12,3,2
7,140,140,1,1,0,1,0
23,163,163,4,1,3,2,1
36,172,172,4,4,0,1,0
27,172,172,2,2,0,1,0
39,173,173,13,9,4,2,1
13,177,177,7,7,0,1,0
14,180,180,25,16,9,2,1
16,197,197,33,13,20,3,2
26,197,197,2,2,0,1,0
19,234,234,12,2,10,2,1
31,239,239,42,42,0,1,0
15,239,239,59,59,0,1,0
20,253,253,12,12,0,1,0
8,270,270,21,21,0,1,0
37,285,285,11,5,6,3,2
33,293,293,80,26,54,4,3
29,299,299,4,4,0,1,0
4,305,305,70,64,6,3,2
38,307,307,66,66,0,1,0
25,343,343,8,8,0,1,0
21,362,362,45,45,0,1,0
18,365,365,11,11,0,1,0
3,368,368,3,3,0,1,0
11,379,379,46,46,0,1,0
40,398,398,47,47,0,1,0
35,402,402,43,16,27,2,1
10,417,417,12,3,9,2,1
6,422,422,33,33,0,1,0
5,431,431,28,7,21,2,1
32,432,432,55,43,12,2,1
9,434,434,48,1,47,3,2
30,447,447,49,37,12,3,2
34,449,449,121,121,0,1,0
0,493,493,12,12,0,1,0
24,495,495,22,4,18,4,3
1,498,498,1,1,0,1,0

16,129,129,11,11,0,1,0
21,131,131,10,7,3,2,1
19,132,132,5,5,0,1,0
35,133,133,34,12,22,3,2
18,151,151,25,20,5,2,1
7,164,164,14,14,0,1,0
37,180,180,4,1,3,2,1
6,186,186,21,5,16,3,2
34,189,189,36,8,28,2,1
31,192,192,9,9,0,1,0
12,202,202,1,1,0,1,0
17,226,226,6,6,0,1,0
36,229,229,21,21,0,1,0
27,237,237,1,1,0,1,0
2,238,238,31,31,0,1,0
41,241,241,17,17,0,1,0
23,249,249,16,7,9,4,3
32,261,261,8,1,7,2,1
22,274,274,120,5,115,4,3
29,286,286,5,5,0,1,0
39,289,289,8,8,0,1,0
9,315,315,31,23,8,3,2
3,338,338,12,6,6,3,2
30,338,338,19,19,0,1,0
43,346,346,11,11,0,1,0
40,351,351,112,64,48,4,3
25,368,368,4,1,3,2,1
11,392,392,26,26,0,1,0
8,396,396,5,5,0,1,0
20,402,402,4,1,3,2,1
5,404,404,13,13,0,1,0
24,405,405,5,5,0,1,0
26,411,411,135,107,28,3,2
38,418,418,38,38,0,1,0
14,427,427,69,6,63,4,3
4,436,436,16,16,0,1,0
42,447,447,30,30,0,1,0
0,448,448,2,2,0,1,0
13,456,456,40,31,9,4,3
15,465,465,9,9,0,1,0
33,473,473,72,72,0,1,0
1,488,488,28,4,24,4,3
28,489,489,55,43,12,2,1
10,497,497,19,7,12,4,3

23,100,100,13,9,4,2,1
11,111,111,21,21,0,1,0
36,116,116,24,2,22,3,2
3,120,120,11,11,0,1,0
12,126,126,3,3,0,1,0
33,134,134,1,1,0,1,0
4,137,137,4,4,0,1,0
9,149,149,1,1,0,1,0
44,158,158,70,38,32,3,2
7,206,206,6,6,0,1,0
17,218,218,1,1,0,1,0
16,218,218,19,19,0,1,0
1,223,223,53,47,6,2,1
42,226,226,33,15,18,3,2
26,244,244,12,12,0,1,0
19,252,252,22,22,0,1,0
38,257,257,23,15,8,2,1
8,266,266,24,24,0,1,0
30,268,268,50,16,34,3,2
18,272,272,74,62,12,4,3
10,278,278,2,2,0,1,0
39,300,300,3,3,0,1,0
14,300,300,1,1,0,1,0
5,309,309,1,1,0,1,0
34,314,314,18,18,0,1,0
13,334,334,19,16,3,2,1
20,376,376,25,25,0,1,0
43,379,379,32,32,0,1,0
0,391,391,4,4,0,1,0
37,396,396,21,21,0,1,0
28,402,402,11,11,0,1,0
45,405,405,9,9,0,1,0
29,405,405,13,13,0,1,0
15,408,408,1,1,0,1,0
21,414,414,5,5,0,1,0
32,418,418,32,32,0,1,0
25,432,432,15,3,12,3,2
6,436,436,63,63,0,1,0
35,451,451,74,50,24,4,3
41,455,455,67,16,51,4,3
31,457,457,44,11,33,3,2
40,458,458,16,5,11,2,1
2,475,475,57,17,40,2,1
24,482,482,3,3,0,1,0
22,490,490,52,20,32,2,1
27,497,497,23,23,0,1,0

1,113,113,21,21,0,1,0
38,124,124,12,12,0,1,0
21,132,132,13,10,3,2,1
12,192,192,20,20,0,1,0
28,198,198,33,33,0,1,0
26,219,219,55,55,0,1,0
14,227,227,30,30,0,1,0
9,228,228,4,4,0,1,0
31,236,236,8,8,0,1,0
36,242,242,18,18,0,1,0
37,251,251,15,15,0,1,0
33,267,267,18,3,15,4,3
34,268,268,18,18,0,1,0
32,279,279,2,2,0,1,0
35,299,299,11,11,0,1,0
15,313,313,18,10,8,2,1
40,329,329,34,22,12,4,3
2,332,332,6,3,3,2,1
27,332,332,45,45,0,1,0
4,334,334,8,8,0,1,0
11,335,335,51,14,37,2,1
6,337,337,27,18,9,2,1
22,342,342,3,3,0,1,0
24,350,350,147,147,0,1,0
5,352,352,17,17,0,1,0
10,355,355,7,7,0,1,0
0,359,359,102,102,0,1,0
16,368,368,14,1,13,2,1
8,395,395,1,1,0,1,0
30,398,398,15,3,12,4,3
18,399,399,4,4,0,1,0
39,416,416,32,22,10,3,2
25,470,470,104,82,22,3,2
7,472,472,69,69,0,1,0
20,477,477,9,9,0,1,0
23,480,480,25,6,19,3,2
3,482,482,79,36,43,2,1
17,484,484,38,38,0,1,0
29,487,487,11,11,0,1,0
19,500,500,44,44,0,1,0
13,500,500,68,27,41,2,1

16,102,102,14,14,0,1,0
22,134,134,2,2,0,1,0
35,137,137,13,13,0,1,0
1,142,142,7,7,0,1,0
36,162,162,12,2,10,3,2
7,173,173,28,28,0,1,0
32,179,179,11,11,0,1,0
24,209,209,20,20,0,1,0
19,218,218,5,5,0,1,0
15,222,222,1,1,0,1,0
13,229,229,18,18,0,1,0
23,262,262,24,16,8,2,1
25,269,269,50,50,0,1,0
12,273,273,50,18,32,2,1
2,278,278,26,26,0,1,0
9,284,284,55,55,0,1,0
26,296,296,38,11,27,2,1
31,316,316,58,46,12,4,3
5,334,334,11,11,0,1,0
3,337,337,113,14,99,4,3
6,342,342,13,13,0,1,0
30,345,345,8,8,0,1,0
4,347,347,33,33,0,1,0
11,351,351,13,13,0,1,0
10,363,363,20,20,0,1,0
28,370,370,92,92,0,1,0
14,372,372,50,22,28,3,2
20,378,378,81,54,27,4,3
18,380,380,14,14,0,1,0
34,398,398,47,47,0,1,0
8,404,404,22,22,0,1,0
0,408,408,25,25,0,1,0
29,411,411,8,8,0,1,0
17,418,418,50,50,0,1,0
37,426,426,2,2,0,1,0
33,486,486,1,1,0,1,0
21,487,487,143,143,0,1,0
27,499,499,28,28,0,1,0

31,106,106,13,13,0,1,0
15,106,106,2,2,0,1,0
29,129,129,15,15,0,1,0
3,135,135,47,1,46,4,3
37,147,147,6,6,0,1,0
6,166,166,10,10,0,1,0
8,167,167,5,5,0,1,0
12,182,182,1,1,0,1,0
14,210,210,45,45,0,1,0
26,216,216,13,2,11,2,1
27,217,217,6,1,5,2,1
9,222,222,51,51,0,1,0
33,226,226,20,20,0,1,0
17,228,228,11,11,0,1,0
4,232,232,3,3,0,1,0
22,242,242,15,3,12,2,1
19,252,252,12,2,10,3,2
20,260,260,13,3,10,4,3
16,277,277,37,37,0,1,0
25,277,277,4,1,3,2,1
1,278,278,3,3,0,1,0
30,279,279,90,74,16,2,1
32,286,286,17,9,8,2,1
35,293,293,36,20,16,3,2
18,295,295,28,28,0,1,0
23,296,296,49,19,30,3,2
34,302,302,4,4,0,1,0
36,309,309,46,20,26,3,2
0,327,327,19,8,11,2,1
11,348,348,53,53,0,1,0
24,349,349,39,6,33,2,1
13,377,377,7,1,6,3,2
10,401,401,33,12,21,4,3
2,460,460,74,9,65,3,2
7,462,462,59,44,15,4,3
28,466,466,93,93,0,1,0
5,473,473,44,44,0,1,0
21,495,495,78,42,36,2,1

27,103,103,2,2,0,1,0
26,105,105,24,24,0,1,0
19,106,106,22,22,0,1,0
11,125,125,51,27,24,3,2
23,142,142,19,19,0,1,0
20,198,198,22,22,0,1,0
22,207,207,26,26,0,1,0
18,219,219,36,36,0,1,0
9,234,234,35,20,15,2,1
12,259,259,61,16,45,2,1
8,269,269,49,3,46,3,2
1,272,272,19,1,18,2,1
29,295,295,26,26,0,1,0
31,316,316,56,56,0,1,0
13,334,334,38,33,5,2,1
6,336,336,56,56,0,1,0
7,337,337,13,13,0,1,0
10,344,344,48,29,19,2,1
16,347,347,39,39,0,1,0
28,369,369,19,19,0,1,0
0,427,427,9,6,3,2,1
14,432,432,3,3,0,1,0
4,443,443,40,33,7,2,1
21,451,451,73,73,0,1,0
2,454,454,100,100,0,1,0
25,479,479,76,7,69,4,3
24,484,484,17,17,0,1,0
17,494,494,9,9,0,1,0
30,495,495,1,1,0,1,0
5,496,496,33,12,21,2,1
3,499,499,56,56,0,1,0
15,499,499,10,10,0,1,0

30,101,101,2,2,0,1,0
29,128,128,30,2,28,2,1
11,130,130,7,7,0,1,0
32,150,150,30,30,0,1,0
41,157,157,9,5,4,2,1
3,200,200,79,23,56,3,2
18,208,208,1,1,0,1,0
40,210,210,25,8,17,2,1
6,218,218,46,46,0,1,0
26,220,220,8,8,0,1,0
1,228,228,1,1,0,1,0
9,231,231,20,12,8,3,2
24,232,232,24,9,15,4,3
12,242,242,1,1,0,1,0
16,245,245,8,8,0,1,0
7,251,251,8,8,0,1,0
23,255,255,89,51,38,2,1
14,264,264,5,5,0,1,0
38,269,269,24,2,22,3,2
25,271,271,11,11,0,1,0
17,276,276,31,31,0,1,0
4,297,297,8,8,0,1,0
19,302,302,27,27,0,1,0
35,306,306,10,10,0,1,0
5,322,322,29,17,12,2,1
8,323,323,9,9,0,1,0
22,331,331,18,15,3,2,1
33,340,340,26,26,0,1,0
31,371,371,14,14,0,1,0
34,401,401,11,11,0,1,0
27,415,415,38,32,6,3,2
39,422,422,74,44,30,4,3
15,428,428,45,27,18,4,3
28,434,434,51,51,0,1,0
20,437,437,52,28,24,4,3
2,438,438,81,31,50,3,2
37,438,438,23,23,0,1,0
21,449,449,36,20,16,3,2
13,472,472,6,6,0,1,0
36,472,472,38,38,0,1,0
0,477,477,47,47,0,1,0
10,481,481,27,27,0,1,0

20,100,100,22,22,0,1,0
14,103,103,3,3,0,1,0
10,106,106,1,1,0,1,0
2,115,115,12,12,0,1,0
19,128,128,16,10,6,2,1
1,128,128,5,5,0,1,0
32,140,140,1,1,0,1,0
3,143,143,13,1,12,4,3
34,147,147,11,11,0,1,0
8,158,158,1,1,0,1,0
18,160,160,4,4,0,1,0
11,171,171,5,5,0,1,0
37,177,177,9,1,8,3,2
30,177,177,15,15,0,1,0
36,192,192,22,2,20,3,2
7,201,201,7,1,6,2,1
9,213,213,24,24,0,1,0
35,214,214,69,69,0,1,0
29,243,243,7,7,0,1,0
0,246,246,14,14,0,1,0
16,262,262,64,40,24,2,1
25,269,269,1,1,0,1,0
12,271,271,14,10,4,2,1
26,278,278,17,17,0,1,0
21,279,279,82,82,0,1,0
24,297,297,14,14,0,1,0
31,306,306,33,33,0,1,0
17,313,313,24,24,0,1,0
15,318,318,22,16,6,2,1
5,349,349,113,113,0,1,0
23,369,369,107,77,30,3,2
13,375,375,45,45,0,1,0
27,381,381,2,2,0,1,0
22,387,387,5,2,3,2,1
6,387,387,152,50,102,4,3
4,400,400,36,36,0,1,0
28,416,416,13,5,8,2,1
33,425,425,31,3,28,3,2

21,148,148,12,12,0,1,0
35,155,155,2,2,0,1,0
22,157,157,14,8,6,3,2
28,175,175,45,18,27,4,3
12,195,195,27,11,16,2,1
2,202,202,12,2,10,2,1
36,203,203,6,6,0,1,0
31,204,204,17,12,5,2,1
16,205,205,12,12,0,1,0
27,207,207,49,49,0,1,0
17,209,209,4,1,3,2,1
32,216,216,12,2,10,2,1
19,225,225,10,10,0,1,0
30,245,245,1,1,0,1,0
14,260,260,34,4,30,3,2
0,308,308,50,29,21,4,3
29,327,327,50,50,0,1,0
23,330,330,20,5,15,2,1
18,331,331,2,2,0,1,0
24,343,343,32,20,12,4,3
20,355,355,62,62,0,1,0
9,358,358,73,73,0,1,0
37,378,378,66,66,0,1,0
6,379,379,8,1,7,2,1
11,396,396,30,10,20,2,1
15,417,417,110,82,28,3,2
3,419,419,19,19,0,1,0
10,427,427,32,19,13,2,1
8,434,434,21,9,12,2,1
34,461,461,40,40,0,1,0
13,462,462,26,18,8,2,1
7,473,473,72,72,0,1,0
26,479,479,6,6,0,1,0
33,485,485,109,70,39,4,3
1,489,489,24,18,6,2,1
5,490,490,13,13,0,1,0
25,491,491,34,9,25,3,2
4,500,500,154,154,0,1,0

21,110,110,13,2,11,2,1
25,120,120,22,5,17,2,1
3,143,143,10,7,3,2,1
23,163,163,13,13,0,1,0
0,171,171,4,4,0,1,0
9,182,182,10,10,0,1,0
24,213,213,5,5,0,1,0
5,224,224,27,9,18,3,2
11,228,228,7,7,0,1,0
37,234,234,56,28,28,2,1
39,265,265,28,28,0,1,0
32,272,272,28,17,11,2,1
10,277,277,20,20,0,1,0
7,284,284,19,19,0,1,0
26,285,285,66,48,18,2,1
13,293,293,1,1,0,1,0
14,295,295,29,29,0,1,0
38,298,298,5,2,3,2,1
34,299,299,38,38,0,1,0
31,309,309,7,7,0,1,0
12,332,332,24,9,15,2,1
4,333,333,7,7,0,1,0
30,343,343,5,1,4,2,1
2,349,349,101,101,0,1,0
16,354,354,180,180,0,1,0
36,357,357,13,7,6,2,1
33,365,365,81,45,36,4,3
17,372,372,18,6,12,4,3
18,378,378,1,1,0,1,0
35,382,382,33,33,0,1,0
28,390,390,40,40,0,1,0
1,406,406,10,5,5,2,1
15,417,417,20,4,16,2,1
8,418,418,59,59,0,1,0
22,443,443,69,69,0,1,0
19,443,443,7,1,6,3,2
27,444,444,10,10,0,1,0
29,446,446,22,22,0,1,0
20,460,460,54,32,22,3,2
6,493,493,35,35,0,1,0

24,101,101,1,1,0,1,0
9,131,131,3,3,0,1,0
1,133,133,12,4,8,3,2
22,136,136,33,33,0,1,0
8,140,140,1,1,0,1,0
25,151,151,33,33,0,1,0
26,185,185,33,3,30,2,1
6,192,192,31,26,5,2,1
3,200,200,14,14,0,1,0
12,204,204,50,50,0,1,0
13,226,226,70,14,56,3,2
11,242,242,32,20,12,3,2
32,244,244,65,17,48,3,2
17,252,252,29,29,0,1,0
15,257,257,24,17,7,2,1
2,271,271,12,12,0,1,0
14,304,304,18,18,0,1,0
7,307,307,17,12,5,2,1
0,308,308,62,17,45,4,3
30,311,311,30,30,0,1,0
29,327,327,35,7,28,2,1
21,346,346,12,12,0,1,0
5,353,353,26,26,0,1,0
18,372,372,26,26,0,1,0
4,378,378,99,99,0,1,0
23,378,378,17,17,0,1,0
28,388,388,35,23,12,4,3
10,396,396,30,15,15,2,1
34,429,429,81,81,0,1,0
27,431,431,45,35,10,3,2
19,449,449,44,10,34,2,1
31,467,467,1,1,0,1,0
20,475,475,16,16,0,1,0
16,481,481,14,14,0,1,0
33,500,500,2,2,0,1,0

25,110,110,27,3,24,3,2
5,133,133,28,28,0,1,0
13,143,143,29,29,0,1,0
7,146,146,7,7,0,1,0
20,147,147,9,9,0,1,0
29,152,152,4,4,0,1,0
16,157,157,7,7,0,1,0
19,183,183,10,6,4,2,1
11,187,187,51,51,0,1,0
14,193,193,12,6,6,3,2
34,201,201,1,1,0,1,0
31,205,205,13,10,3,2,1
15,212,212,2,2,0,1,0
35,222,222,25,25,0,1,0
17,227,227,9,9,0,1,0
12,230,230,2,2,0,1,0
36,250,250,3,3,0,1,0
21,273,273,10,3,7,2,1
0,278,278,10,5,5,2,1
27,294,294,44,44,0,1,0
24,304,304,23,23,0,1,0
28,305,305,78,78,0,1,0
38,313,313,94,94,0,1,0
18,323,323,97,49,48,3,2
22,327,327,36,30,6,2,1
32,331,331,67,58,9,2,1
4,337,337,34,34,0,1,0
2,344,344,14,6,8,2,1
23,362,362,1,1,0,1,0
26,377,377,23,23,0,1,0
8,391,391,70,55,15,4,3
9,397,397,9,9,0,1,0
10,400,400,50,50,0,1,0
37,408,408,78,48,30,3,2
1,421,421,40,40,0,1,0
3,446,446,6,6,0,1,0
30,454,454,4,4,0,1,0
6,475,475,18,5,13,2,1
33,496,496,9,9,0,1,0

4,106,106,16,6,10,2,1
35,115,115,1,1,0,1,0
25,128,128,2,2,0,1,0
29,133,133,57,7,50,3,2
24,133,133,14,14,0,1,0
34,139,139,1,1,0,1,0
36,148,148,15,15,0,1,0
10,152,152,56,56,0,1,0
12,161,161,10,10,0,1,0
9,177,177,28,28,0,1,0
21,191,191,8,8,0,1,0
23,206,206,9,9,0,1,0
27,210,210,8,2,6,3,2
18,234,234,32,6,26,3,2
11,234,234,2,2,0,1,0
0,253,253,18,3,15,4,3
5,271,271,36,29,7,2,1
7,274,274,6,2,4,2,1
20,280,280,16,2,14,3,2
6,296,296,39,21,18,4,3
3,322,322,1,1,0,1,0
15,323,323,43,43,0,1,0
30,333,333,1,1,0,1,0
8,340,340,18,18,0,1,0
17,355,355,17,12,5,2,1
13,360,360,4,4,0,1,0
2,362,362,3,3,0,1,0
26,363,363,16,13,3,2,1
32,374,374,7,2,5,2,1
28,375,375,15,15,0,1,0
22,398,398,124,124,0,1,0
16,404,404,47,1,46,3,2
31,447,447,129,102,27,4,3
14,449,449,64,21,43,2,1
1,449,449,64,64,0,1,0
37,475,475,80,80,0,1,0
33,488,488,66,57,9,4,3
19,495,495,46,10,36,3,2

10,106,106,9,1,8,2,1
26,115,115,4,4,0,1,0
3,119,119,5,5,0,1,0
30,122,122,1,1,0,1,0
18,132,132,1,1,0,1,0
11,134,134,26,26,0,1,0
7,138,138,4,4,0,1,0
8,184,184,38,38,0,1,0
40,197,197,15,5,10,3,2
41,205,205,24,24,0,1,0
2,223,223,20,4,16,2,1
31,224,224,34,23,11,2,1
37,237,237,41,15,26,4,3
21,242,242,22,4,18,4,3
32,246,246,34,34,0,1,0
33,269,269,4,4,0,1,0
16,272,272,2,2,0,1,0
13,279,279,23,5,18,4,3
27,308,308,4,4,0,1,0
34,309,309,126,5,121,4,3
29,314,314,2,2,0,1,0
22,316,316,24,24,0,1,0
19,333,333,54,42,12,4,3
14,344,344,28,28,0,1,0
15,345,345,15,8,7,2,1
42,355,355,18,18,0,1,0
17,357,357,14,14,0,1,0
1,357,357,82,82,0,1,0
4,362,362,1,1,0,1,0
35,369,369,48,36,12,3,2
23,376,376,39,11,28,2,1
24,383,383,48,48,0,1,0
28,392,392,6,6,0,1,0
25,415,415,51,9,42,3,2
39,416,416,40,37,3,2,1
38,421,421,76,41,35,2,1
5,452,452,13,4,9,2,1
36,455,455,33,33,0,1,0
0,473,473,17,17,0,1,0
20,474,474,71,40,31,2,1
9,480,480,27,27,0,1,0
6,492,492,9,9,0,1,0
12,495,495,19,7,12,4,3

15,102,102,5,2,3,2,1
9,117,117,16,1,15,4,3
0,121,121,26,13,13,2,1
39,122,122,24,24,0,1,0
27,125,125,18,18,0,1,0
24,128,128,16,16,0,1,0
18,137,137,13,13,0,1,0
26,143,143,1,1,0,1,0
17,150,150,5,5,0,1,0
4,156,156,10,10,0,1,0
32,158,158,8,5,3,2,1
28,178,178,22,22,0,1,0
1,206,206,3,3,0,1,0
34,228,228,11,11,0,1,0
3,228,228,21,2,19,2,1
19,230,230,8,3,5,2,1
22,253,253,29,29,0,1,0
33,255,255,7,1,6,3,2
35,264,264,53,10,43,2,1
14,273,273,12,12,0,1,0
36,278,278,40,16,24,3,2
38,302,302,3,3,0,1,0
29,312,312,11,11,0,1,0
21,328,328,51,51,0,1,0
6,330,330,51,1,50,2,1
13,351,351,78,58,20,3,2
31,353,353,28,28,0,1,0
11,383,383,1,1,0,1,0
30,406,406,23,23,0,1,0
16,408,408,38,26,12,2,1
10,438,438,25,25,0,1,0
5,441,441,27,27,0,1,0
23,448,448,77,32,45,4,3
20,468,468,61,21,40,2,1
25,476,476,88,88,0,1,0
7,477,477,15,15,0,1,0
37,484,484,33,33,0,1,0
12,485,485,101,32,69,3,2
2,488,488,68,55,13,2,1
8,497,497,11,3,8,2,1

17,116,116,17,8,9,4,3
18,130,130,8,8,0,1,0
22,136,136,7,7,0,1,0
10,139,139,3,3,0,1,0
28,144,144,9,2,7,2,1
13,161,161,4,4,0,1,0
14,180,180,52,32,20,2,1
2,199,199,4,1,3,2,1
29,219,219,26,7,19,2,1
8,237,237,48,43,5,2,1
21,248,248,91,1,90,3,2
11,259,259,25,13,12,2,1
23,274,274,8,8,0,1,0
20,280,280,17,7,10,2,1
5,281,281,27,27,0,1,0
4,290,290,20,20,0,1,0
19,290,290,10,7,3,2,1
3,294,294,2,2,0,1,0
31,300,300,37,25,12,2,1
12,308,308,66,57,9,4,3
27,310,310,16,16,0,1,0
1,314,314,27,9,18,2,1
32,329,329,20,20,0,1,0
30,331,331,22,10,12,4,3
0,338,338,66,4,62,3,2
15,341,341,21,21,0,1,0
26,343,343,17,17,0,1,0
9,346,346,94,94,0,1,0
33,358,358,28,23,5,2,1
25,366,366,119,42,77,3,2
24,380,380,63,20,43,3,2
7,384,384,83,83,0,1,0
6,397,397,38,7,31,4,3
16,477,477,16,6,10,3,2

36,113,113,2,2,0,1,0
14,127,127,19,9,10,2,1
20,135,135,38,38,0,1,0
32,138,138,1,1,0,1,0
17,151,151,12,12,0,1,0
23,158,158,2,2,0,1,0
37,173,173,19,19,0,1,0
3,177,177,3,3,0,1,0
31,183,183,30,3,27,2,1
21,192,192,2,2,0,1,0
4,204,204,2,2,0,1,0
12,227,227,29,29,0,1,0
33,228,228,16,6,10,3,2
10,233,233,51,51,0,1,0
1,246,246,14,14,0,1,0
34,253,253,38,38,0,1,0
24,259,259,18,18,0,1,0
28,266,266,69,21,48,2,1
15,273,273,35,17,18,4,3
0,276,276,32,32,0,1,0
25,278,278,177,162,15,4,3
13,278,278,21,6,15,2,1
9,279,279,8,8,0,1,0
27,308,308,10,1,9,2,1
16,330,330,55,23,32,3,2
22,352,352,17,5,12,3,2
11,362,362,1,1,0,1,0
26,378,378,13,3,10,3,2
18,387,387,8,2,6,3,2
5,419,419,75,25,50,2,1
19,421,421,3,3,0,1,0
2,430,430,50,50,0,1,0
6,464,464,104,76,28,2,1
29,467,467,7,3,4,2,1
35,469,469,6,6,0,1,0
8,481,481,24,2,22,3,2
7,490,490,66,47,19,2,1
30,497,497,3,3,0,1,0

40,100,100,12,4,8,3,2
32,105,105,5,5,0,1,0
14,106,106,3,3,0,1,0
26,110,110,11,1,10,3,2
20,112,112,2,2,0,1,0
17,113,113,8,8,0,1,0
30,128,128,8,4,4,2,1
43,140,140,57,57,0,1,0
16,170,170,23,23,0,1,0
33,174,174,4,4,0,1,0
23,181,181,2,2,0,1,0
28,182,182,15,15,0,1,0
5,188,188,7,3,4,2,1
6,200,200,9,9,0,1,0
38,206,206,64,64,0,1,0
25,215,215,1,1,0,1,0
18,215,215,23,23,0,1,0
29,224,224,8,8,0,1,0
11,235,235,14,14,0,1,0
41,273,273,33,1,32,3,2
21,297,297,41,10,31,2,1
39,306,306,37,37,0,1,0
12,320,320,19,2,17,2,1
3,336,336,15,15,0,1,0
27,337,337,5,5,0,1,0
15,340,340,30,30,0,1,0
9,349,349,35,35,0,1,0
31,356,356,66,66,0,1,0
1,373,373,27,9,18,3,2
10,382,382,47,47,0,1,0
8,391,391,38,10,28,3,2
19,401,401,26,26,0,1,0
13,409,409,46,46,0,1,0
0,418,418,48,10,38,3,2
24,427,427,26,10,16,3,2
44,428,428,13,13,0,1,0
35,449,449,14,14,0,1,0
36,452,452,57,30,27,4,3
37,462,462,14,14,0,1,0
22,464,464,73,73,0,1,0
42,470,470,18,5,13,2,1
4,482,482,12,12,0,1,0
2,485,485,41,41,0,1,0
34,486,486,33,3,30,3,2
7,490,490,22,14,8,2,1

18,105,105,8,8,0,1,0
19,116,116,9,9,0,1,0
31,122,122,19,19,0,1,0
8,134,134,2,2,0,1,0
22,146,146,11,11,0,1,0
7,175,175,3,3,0,1,0
9,175,175,28,28,0,1,0
2,190,190,1,1,0,1,0
13,198,198,71,71,0,1,0
4,201,201,9,9,0,1,0
30,215,215,24,3,21,2,1
28,237,237,24,5,19,3,2
36,239,239,73,73,0,1,0
10,247,247,13,13,0,1,0
29,263,263,21,21,0,1,0
5,271,271,3,3,0,1,0
3,275,275,20,6,14,2,1
20,284,284,5,5,0,1,0
24,309,309,15,3,12,4,3
25,331,331,13,13,0,1,0
16,338,338,9,9,0,1,0
33,360,360,27,27,0,1,0
15,388,388,12,12,0,1,0
35,388,388,48,48,0,1,0
27,398,398,10,10,0,1,0
1,411,411,17,17,0,1,0
21,429,429,25,25,0,1,0
17,431,431,45,45,0,1,0
23,441,441,3,3,0,1,0
11,443,443,153,127,26,2,1
6,444,444,23,23,0,1,0
12,457,457,54,26,28,3,2
32,472,472,75,58,17,2,1
14,473,473,84,12,72,4,3
26,480,480,181,163,18,4,3
0,487,487,130,103,27,4,3
34,490,490,12,2,10,3,2

9,112,112,18,18,0,1,0
6,118,118,6,6,0,1,0
41,127,127,11,3,8,2,1
7,138,138,3,3,0,1,0
10,141,141,13,4,9,4,3
32,149,149,5,5,0,1,0
22,155,155,8,4,4,2,1
2,175,175,1,1,0,1,0
23,198,198,35,35,0,1,0
33,198,198,25,1,24,4,3
5,215,215,13,13,0,1,0
0,218,218,18,6,12,4,3
18,218,218,21,2,19,2,1
31,228,228,90,90,0,1,0
16,233,233,20,20,0,1,0
42,239,239,24,24,0,1,0
24,245,245,44,20,24,3,2
34,246,246,27,27,0,1,0
26,253,253,5,5,0,1,0
4,255,255,17,17,0,1,0
15,287,287,1,1,0,1,0
12,288,288,31,23,8,3,2
30,295,295,6,6,0,1,0
20,309,309,1,1,0,1,0
28,313,313,2,2,0,1,0
29,315,315,58,27,31,2,1
43,315,315,20,20,0,1,0
27,318,318,23,7,16,3,2
14,351,351,9,2,7,2,1
40,381,381,83,83,0,1,0
11,402,402,20,20,0,1,0
8,406,406,54,54,0,1,0
37,414,414,38,1,37,2,1
39,415,415,9,4,5,2,1
3,420,420,22,14,8,3,2
1,455,455,19,19,0,1,0
21,460,460,45,26,19,2,1
13,461,461,20,10,10,2,1
36,475,475,21,2,19,2,1
35,476,476,85,85,0,1,0
17,480,480,12,6,6,3,2
19,488,488,91,91,0,1,0
25,491,491,6,6,0,1,0
38,494,494,76,42,34,3,2

6,106,106,2,2,0,1,0
4,114,114,4,1,3,2,1
34,128,128,16,16,0,1,0
5,131,131,18,18,0,1,0
19,139,139,13,13,0,1,0
31,150,150,14,11,3,2,1
35,159,159,27,19,8,2,1
15,163,163,3,3,0,1,0
30,169,169,12,12,0,1,0
36,177,177,21,14,7,2,1
28,183,183,1,1,0,1,0
24,188,188,3,3,0,1,0
33,201,201,8,8,0,1,0
12,204,204,10,10,0,1,0
3,232,232,2,2,0,1,0
13,253,253,21,21,0,1,0
2,256,256,8,3,5,2,1
10,273,273,11,11,0,1,0
1,296,296,153,73,80,3,2
25,297,297,25,21,4,2,1
8,330,330,82,73,9,2,1
11,347,347,1,1,0,1,0
17,352,352,1,1,0,1,0
32,353,353,16,13,3,2,1
18,368,368,76,49,27,4,3
7,376,376,7,7,0,1,0
16,403,403,94,94,0,1,0
14,409,409,51,51,0,1,0
22,418,418,4,4,0,1,0
9,437,437,30,6,24,4,3
20,446,446,3,3,0,1,0
21,463,463,11,1,10,3,2
29,468,468,13,13,0,1,0
26,471,471,15,1,14,3,2
27,472,472,125,46,79,4,3
23,475,475,238,175,63,4,3
0,485,485,127,127,0,1,0

10,107,107,1,1,0,1,0
21,109,109,3,3,0,1,0
22,113,113,19,7,12,4,3
1,132,132,21,21,0,1,0
30,139,139,16,16,0,1,0
27,161,161,26,18,8,3,2
17,181,181,22,22,0,1,0
39,187,187,6,1,5,2,1
38,193,193,1,1,0,1,0
37,199,199,14,14,0,1,0
34,203,203,4,4,0,1,0
14,237,237,4,4,0,1,0
6,263,263,5,5,0,1,0
11,272,272,81,30,51,4,3
0,273,273,25,25,0,1,0
36,283,283,22,22,0,1,0
25,312,312,121,32,89,4,3
13,336,336,6,6,0,1,0
7,343,343,62,35,27,4,3
40,351,351,7,7,0,1,0
29,355,355,4,4,0,1,0
19,361,361,17,9,8,2,1
15,362,362,1,1,0,1,0
35,368,368,8,8,0,1,0
3,385,385,53,53,0,1,0
20,390,390,98,94,4,2,1
33,407,407,30,30,0,1,0
8,410,410,56,35,21,4,3
4,417,417,24,24,0,1,0
24,419,419,7,7,0,1,0
16,425,425,6,6,0,1,0
9,429,429,1,1,0,1,0
12,454,454,7,7,0,1,0
23,470,470,128,32,96,3,2
26,472,472,42,28,14,2,1
31,481,481,39,32,7,2,1
28,482,482,6,6,0,1,0
5,489,489,136,136,0,1,0
32,491,491,152,114,38,4,3
2,491,491,3,3,0,1,0
18,494,494,7,7,0,1,0

26,111,111,4,4,0,1,0
3,114,114,3,3,0,1,0
29,139,139,11,11,0,1,0
39,141,141,10,6,4,2,1
34,162,162,4,4,0,1,0
44,166,166,3,3,0,1,0
18,171,171,1,1,0,1,0
10,176,176,1,1,0,1,0
9,180,180,8,8,0,1,0
1,184,184,12,5,7,2,1
11,186,186,35,19,16,4,3
28,191,191,6,6,0,1,0
23,191,191,15,15,0,1,0
19,212,212,11,3,8,3,2
36,213,213,19,6,13,4,3
37,214,214,14,14,0,1,0
17,217,217,6,6,0,1,0
6,246,246,32,32,0,1,0
16,249,249,93,72,21,2,1
30,263,263,74,44,30,4,3
8,274,274,10,10,0,1,0
43,279,279,19,4,15,4,3
4,293,293,2,2,0,1,0
7,308,308,1,1,0,1,0
0,309,309,3,3,0,1,0
27,315,315,27,13,14,2,1
24,345,345,12,12,0,1,0
15,349,349,9,9,0,1,0
33,357,357,71,71,0,1,0
12,364,364,7,1,6,3,2
41,366,366,2,2,0,1,0
31,372,372,13,4,9,4,3
38,372,372,12,7,5,2,1
21,381,381,6,6,0,1,0
35,394,394,164,164,0,1,0
42,415,415,47,36,11,2,1
5,422,422,66,66,0,1,0
25,423,423,14,14,0,1,0
14,430,430,98,6,92,4,3
13,432,432,54,36,18,4,3
40,434,434,93,43,50,2,1
22,441,441,75,75,0,1,0
20,467,467,15,15,0,1,0
2,473,473,3,3,0,1,0
32,478,478,38,4,34,2,1

2,105,105,6,6,0,1,0
20,108,108,1,1,0,1,0
33,109,109,20,11,9,4,3
13,125,125,3,3,0,1,0
39,129,129,4,4,0,1,0
17,133,133,1,1,0,1,0
11,135,135,31,31,0,1,0
6,140,140,20,20,0,1,0
38,154,154,4,4,0,1,0
24,162,162,5,5,0,1,0
22,169,169,10,10,0,1,0
35,192,192,63,45,18,4,3
42,203,203,4,1,3,2,1
32,206,206,8,2,6,3,2
3,211,211,4,4,0,1,0
1,234,234,1,1,0,1,0
5,242,242,1,1,0,1,0
25,243,243,5,2,3,2,1
28,264,264,90,57,33,2,1
23,275,275,16,16,0,1,0
9,281,281,27,27,0,1,0
41,318,318,31,31,0,1,0
10,324,324,17,17,0,1,0
40,339,339,35,35,0,1,0
21,341,341,174,90,84,4,3
0,347,347,25,11,14,3,2
31,364,364,7,7,0,1,0
19,368,368,5,5,0,1,0
27,373,373,31,4,27,2,1
4,375,375,32,4,28,3,2
29,378,378,29,29,0,1,0
34,391,391,132,123,9,4,3
14,396,396,27,17,10,2,1
18,402,402,30,13,17,2,1
26,403,403,2,2,0,1,0
37,406,406,12,12,0,1,0
36,440,440,35,35,0,1,0
12,464,464,4,4,0,1,0
8,478,478,83,33,50,3,2
30,482,482,40,40,0,1,0
7,483,483,31,11,20,3,2
15,493,493,8,8,0,1,0
16,494,494,25,6,19,2,1

21,111,111,2,2,0,1,0
20,139,139,18,6,12,3,2
24,170,170,12,6,6,3,2
13,211,211,18,3,15,4,3
5,217,217,50,50,0,1,0
23,222,222,18,18,0,1,0
15,223,223,78,78,0,1,0
31,253,253,14,6,8,2,1
2,262,262,61,61,0,1,0
14,264,264,12,6,6,3,2
22,276,276,1,1,0,1,0
3,280,280,3,3,0,1,0
16,289,289,20,15,5,2,1
29,293,293,64,42,22,2,1
8,321,321,42,42,0,1,0
19,340,340,74,74,0,1,0
27,351,351,6,6,0,1,0
18,356,356,6,6,0,1,0
9,371,371,57,1,56,3,2
26,373,373,12,12,0,1,0
4,388,388,31,31,0,1,0
17,400,400,84,84,0,1,0
6,421,421,28,28,0,1,0
25,439,439,52,52,0,1,0
10,452,452,34,34,0,1,0
7,456,456,200,74,126,4,3
28,469,469,6,2,4,2,1
0,470,470,6,2,4,2,1
1,474,474,68,68,0,1,0
12,493,493,60,20,40,2,1
11,494,494,101,63,38,2,1
30,494,494,88,88,0,1,0

22,108,108,22,22,0,1,0
0,117,117,17,17,0,1,0
33,122,122,14,7,7,3,2
28,159,159,1,1,0,1,0
3,170,170,4,1,3,2,1
27,170,170,1,1,0,1,0
23,173,173,35,14,21,2,1
21,180,180,7,7,0,1,0
11,189,189,11,11,0,1,0
30,189,189,14,14,0,1,0
16,195,195,22,22,0,1,0
17,198,198,1,1,0,1,0
15,203,203,1,1,0,1,0
12,232,232,92,92,0,1,0
8,237,237,16,16,0,1,0
5,255,255,6,2,4,2,1
26,277,277,55,19,36,4,3
14,287,287,8,5,3,2,1
2,297,297,11,11,0,1,0
20,308,308,46,19,27,2,1
1,309,309,105,39,66,3,2
13,347,347,77,41,36,4,3
10,347,347,127,117,10,3,2
25,353,353,10,10,0,1,0
34,358,358,53,31,22,2,1
4,390,390,1,1,0,1,0
18,399,399,85,85,0,1,0
9,422,422,18,18,0,1,0
29,433,433,15,15,0,1,0
31,440,440,18,18,0,1,0
19,450,450,47,21,26,3,2
6,464,464,32,23,9,2,1
24,473,473,79,35,44,3,2
7,481,481,37,37,0,1,0
32,483,483,39,39,0,1,0

20,102,102,1,1,0,1,0
2,104,104,27,3,24,3,2
25,111,111,27,23,4,2,1
16,113,113,10,6,4,2,1
11,146,146,9,1,8,2,1
41,148,148,1,1,0,1,0
1,178,178,15,8,7,2,1
22,187,187,11,11,0,1,0
33,226,226,12,8,4,2,1
10,235,235,10,10,0,1,0
3,238,238,17,7,10,2,1
28,238,238,1,1,0,1,0
42,239,239,27,12,15,2,1
35,239,239,81,81,0,1,0
17,244,244,25,25,0,1,0
4,254,254,27,22,5,2,1
13,263,263,71,71,0,1,0
9,273,273,1,1,0,1,0
32,274,274,1,1,0,1,0
19,291,291,6,6,0,1,0
18,303,303,11,11,0,1,0
36,320,320,14,6,8,2,1
38,327,327,53,53,0,1,0
7,336,336,11,7,4,2,1
40,358,358,56,15,41,2,1
39,364,364,25,25,0,1,0
24,367,367,64,28,36,2,1
31,391,391,16,16,0,1,0
12,396,396,1,1,0,1,0
0,397,397,20,20,0,1,0
37,430,430,60,24,36,2,1
5,438,438,36,36,0,1,0
6,446,446,67,5,62,3,2
15,448,448,30,30,0,1,0
34,449,449,11,1,10,3,2
8,449,449,60,60,0,1,0
30,451,451,16,16,0,1,0
29,469,469,73,73,0,1,0
21,484,484,56,16,40,2,1
26,488,488,23,5,18,4,3
23,493,493,24,24,0,1,0
14,493,493,1,1,0,1,0
27,500,500,58,8,50,3,2

32,108,108,13,13,0,1,0
7,111,111,1,1,0,1,0
36,120,120,7,7,0,1,0
41,124,124,2,2,0,1,0
37,124,124,16,2,14,3,2
1,136,136,2,2,0,1,0
10,148,148,6,6,0,1,0
43,154,154,9,1,8,2,1
15,173,173,21,3,18,2,1
35,178,178,5,5,0,1,0
19,190,190,19,4,15,2,1
23,195,195,5,1,4,2,1
13,198,198,15,7,8,2,1
5,202,202,3,3,0,1,0
42,207,207,34,8,26,3,2
44,213,213,18,5,13,2,1
33,217,217,23,2,21,4,3
17,239,239,16,8,8,2,1
14,255,255,1,1,0,1,0
30,263,263,39,30,9,4,3
18,268,268,27,27,0,1,0
8,270,270,15,7,8,2,1
24,275,275,41,32,9,2,1
31,277,277,73,48,25,2,1
3,288,288,11,1,10,2,1
11,302,302,20,20,0,1,0
16,312,312,1,1,0,1,0
22,317,317,95,95,0,1,0
38,323,323,9,2,7,2,1
4,352,352,12,2,10,3,2
27,364,364,6,6,0,1,0
39,384,384,76,54,22,2,1
0,388,388,22,12,10,2,1
40,394,394,68,68,0,1,0
25,400,400,23,23,0,1,0
21,411,411,26,5,21,4,3
20,431,431,22,22,0,1,0
12,438,438,51,51,0,1,0
2,446,446,9,4,5,2,1
28,448,448,34,34,0,1,0
29,455,455,81,81,0,1,0
26,457,457,22,22,0,1,0
9,459,459,51,51,0,1,0
6,483,483,99,92,7,2,1
34,495,495,22,8,14,3,2

11,106,106,2,2,0,1,0
40,106,106,3,3,0,1,0
23,109,109,21,21,0,1,0
2,110,110,1,1,0,1,0
25,110,110,8,8,0,1,0
12,121,121,1,1,0,1,0
1,130,130,6,6,0,1,0
7,133,133,5,5,0,1,0
41,152,152,41,41,0,1,0
28,174,174,5,5,0,1,0
44,187,187,13,5,8,2,1
43,188,188,19,19,0,1,0
10,196,196,8,8,0,1,0
17,200,200,9,3,6,3,2
9,206,206,29,4,25,3,2
22,208,208,15,15,0,1,0
19,249,249,16,16,0,1,0
29,254,254,2,2,0,1,0
45,269,269,10,10,0,1,0
34,284,284,5,5,0,1,0
4,286,286,5,5,0,1,0
16,294,294,91,48,43,2,1
42,305,305,81,81,0,1,0
21,306,306,5,2,3,2,1
14,309,309,13,13,0,1,0
33,310,310,4,4,0,1,0
36,317,317,51,35,16,2,1
0,337,337,24,24,0,1,0
20,341,341,53,44,9,4,3
6,386,386,29,29,0,1,0
38,392,392,6,2,4,2,1
18,397,397,1,1,0,1,0
3,408,408,27,6,21,2,1
32,410,410,61,1,60,4,3
8,415,415,41,19,22,2,1
35,428,428,95,79,16,3,2
30,444,444,176,176,0,1,0
37,447,447,5,5,0,1,0
31,458,458,26,5,21,4,3
13,463,463,47,38,9,2,1
15,465,465,40,3,37,2,1
39,466,466,8,8,0,1,0
24,473,473,20,4,16,2,1
5,476,476,19,19,0,1,0
27,477,477,34,34,0,1,0
26,485,485,14,4,10,2,1

5,101,101,4,4,0,1,0
1,120,120,15,6,9,2,1
37,124,124,12,12,0,1,0
39,129,129,2,2,0,1,0
19,130,130,3,3,0,1,0
14,130,130,10,10,0,1,0
24,151,151,2,2,0,1,0
13,157,157,13,13,0,1,0
32,159,159,13,13,0,1,0
3,163,163,5,1,4,2,1
20,165,165,1,1,0,1,0
10,179,179,9,4,5,2,1
31,196,196,38,3,35,2,1
4,221,221,9,3,6,3,2
29,223,223,41,41,0,1,0
21,226,226,17,17,0,1,0
35,229,229,6,6,0,1,0
30,235,235,28,23,5,2,1
0,257,257,25,25,0,1,0
36,268,268,9,9,0,1,0
18,270,270,41,41,0,1,0
16,290,290,10,10,0,1,0
34,313,313,14,14,0,1,0
27,315,315,30,19,11,3,2
11,315,315,40,7,33,4,3
40,347,347,34,34,0,1,0
23,348,348,2,2,0,1,0
33,349,349,49,49,0,1,0
25,360,360,73,50,23,2,1
26,379,379,103,13,90,3,2
28,397,397,7,7,0,1,0
12,399,399,22,2,20,2,1
17,409,409,46,46,0,1,0
2,415,415,1,1,0,1,0
22,417,417,81,9,72,3,2
6,421,421,45,45,0,1,0
9,440,440,9,9,0,1,0
15,441,441,102,102,0,1,0
8,445,445,58,58,0,1,0
38,448,448,44,30,14,2,1
7,460,460,130,66,64,3,2

0,102,102,30,11,19,2,1
15,103,103,12,12,0,1,0
3,112,112,1,1,0,1,0
12,126,126,1,1,0,1,0
6,128,128,8,8,0,1,0
28,129,129,5,5,0,1,0
31,135,135,11,1,10,3,2
25,135,135,6,6,0,1,0
13,141,141,7,7,0,1,0
21,145,145,1,1,0,1,0
1,159,159,6,2,4,2,1
27,165,165,40,10,30,4,3
10,179,179,1,1,0,1,0
18,183,183,16,16,0,1,0
17,189,189,36,24,12,4,3
5,207,207,1,1,0,1,0
33,226,226,22,22,0,1,0
30,238,238,24,2,22,3,2
23,266,266,11,11,0,1,0
22,268,268,2,2,0,1,0
14,288,288,57,57,0,1,0
24,294,294,25,25,0,1,0
11,299,299,2,2,0,1,0
4,305,305,3,3,0,1,0
8,317,317,29,19,10,3,2
19,326,326,109,109,0,1,0
2,354,354,33,7,26,2,1
7,357,357,357,357,0,1,0
16,365,365,9,9,0,1,0
20,369,369,12,12,0,1,0
26,396,396,3,3,0,1,0
32,418,418,2,2,0,1,0
29,440,440,177,163,14,3,2
9,481,481,15,8,7,2,1

27,114,114,2,2,0,1,0
3,115,115,14,14,0,1,0
21,138,138,13,13,0,1,0
15,147,147,6,3,3,2,1
26,147,147,12,2,10,3,2
13,170,170,7,4,3,2,1
8,181,181,16,13,3,2,1
18,198,198,6,1,5,2,1
1,204,204,36,36,0,1,0
10,208,208,48,6,42,4,3
5,224,224,31,15,16,2,1
6,234,234,72,72,0,1,0
14,247,247,12,12,0,1,0
28,257,257,18,14,4,2,1
4,262,262,55,31,24,4,3
22,273,273,5,5,0,1,0
32,292,292,89,89,0,1,0
11,292,292,5,5,0,1,0
17,296,296,9,4,5,2,1
25,316,316,57,11,46,2,1
0,318,318,33,15,18,4,3
9,323,323,48,22,26,2,1
12,340,340,17,8,9,4,3
19,342,342,41,29,12,3,2
30,342,342,1,1,0,1,0
29,343,343,4,4,0,1,0
24,379,379,45,27,18,3,2
20,383,383,7,7,0,1,0
31,401,401,159,48,111,4,3
23,437,437,6,6,0,1,0
2,462,462,103,19,84,4,3
16,474,474,164,146,18,2,1
7,493,493,22,22,0,1,0

36,110,110,12,6,6,2,1
39,110,110,17,7,10,2,1
19,116,116,12,12,0,1,0
37,120,120,11,11,0,1,0
12,138,138,7,1,6,2,1
4,144,144,3,3,0,1,0
40,155,155,19,19,0,1,0
10,168,168,8,8,0,1,0
2,168,168,19,5,14,2,1
18,171,171,2,2,0,1,0
34,179,179,24,4,20,2,1
3,192,192,25,4,21,4,3
11,197,197,31,9,22,4,3
8,224,224,24,20,4,2,1
27,224,224,41,10,31,2,1
32,224,224,20,4,16,3,2
5,232,232,24,24,0,1,0
0,235,235,23,17,6,3,2
7,238,238,3,3,0,1,0
29,251,251,8,8,0,1,0
35,254,254,6,6,0,1,0
28,260,260,71,71,0,1,0
38,280,280,48,48,0,1,0
14,312,312,41,41,0,1,0
1,361,361,13,13,0,1,0
6,389,389,17,4,13,2,1
33,389,389,41,9,32,3,2
22,396,396,60,57,3,2,1
13,406,406,55,55,0,1,0
41,417,417,19,7,12,3,2
20,417,417,52,52,0,1,0
23,419,419,20,20,0,1,0
16,421,421,3,3,0,1,0
25,433,433,42,33,9,4,3
15,434,434,37,27,10,2,1
31,439,439,30,21,9,4,3
9,439,439,18,11,7,2,1
17,450,450,72,60,12,2,1
24,451,451,1,1,0,1,0
21,467,467,14,14,0,1,0
30,471,471,6,6,0,1,0
26,472,472,87,35,52,3,2

18,120,120,19,7,12,3,2
1,130,130,1,1,0,1,0
22,132,132,3,3,0,1,0
12,133,133,34,34,0,1,0
26,138,138,48,8,40,4,3
7,139,139,4,4,0,1,0
40,148,148,1,1,0,1,0
19,153,153,3,3,0,1,0
23,190,190,24,24,0,1,0
10,221,221,4,4,0,1,0
15,244,244,33,12,21,4,3
38,247,247,4,4,0,1,0
31,262,262,11,1,10,2,1
39,263,263,40,40,0,1,0
32,265,265,4,4,0,1,0
5,281,281,29,29,0,1,0
29,285,285,17,17,0,1,0
41,292,292,7,1,6,2,1
33,303,303,17,4,13,2,1
30,303,303,46,46,0,1,0
28,308,308,75,75,0,1,0
16,328,328,51,11,40,3,2
17,330,330,67,4,63,4,3
37,331,331,30,9,21,4,3
24,340,340,9,9,0,1,0
11,340,340,3,3,0,1,0
25,347,347,27,27,0,1,0
3,366,366,67,67,0,1,0
21,370,370,25,1,24,4,3
34,382,382,7,7,0,1,0
2,386,386,15,15,0,1,0
9,387,387,44,5,39,2,1
0,396,396,1,1,0,1,0
8,408,408,11,1,10,3,2
20,422,422,26,19,7,2,1
4,424,424,38,38,0,1,0
6,459,459,22,12,10,3,2
35,474,474,58,58,0,1,0
36,474,474,162,62,100,3,2
14,479,479,45,13,32,2,1
13,485,485,28,15,13,2,1
27,486,486,6,6,0,1,0

19,109,109,1,1,0,1,0
16,109,109,8,8,0,1,0
36,121,121,1,1,0,1,0
35,122,122,11,3,8,2,1
18,126,126,16,16,0,1,0
4,129,129,1,1,0,1,0
12,155,155,29,22,7,2,1
1,161,161,16,4,12,2,1
32,169,169,1,1,0,1,0
24,179,179,41,41,0,1,0
34,180,180,2,2,0,1,0
17,182,182,12,12,0,1,0
38,200,200,40,40,0,1,0
15,220,220,25,25,0,1,0
30,224,224,50,50,0,1,0
22,231,231,34,34,0,1,0
23,244,244,44,22,22,3,2
7,291,291,96,17,79,4,3
20,298,298,32,18,14,3,2
13,298,298,3,3,0,1,0
11,311,311,3,3,0,1,0
25,314,314,33,33,0,1,0
6,330,330,19,3,16,2,1
33,367,367,6,3,3,2,1
31,370,370,57,57,0,1,0
28,377,377,17,11,6,3,2
14,383,383,37,29,8,3,2
27,395,395,16,16,0,1,0
10,397,397,15,15,0,1,0
29,404,404,34,18,16,3,2
21,413,413,72,72,0,1,0
5,419,419,38,26,12,4,3
37,428,428,6,6,0,1,0
26,440,440,42,24,18,4,3
2,448,448,72,72,0,1,0
3,488,488,1,1,0,1,0
9,489,489,92,92,0,1,0
8,494,494,95,68,27,4,3
0,497,497,24,24,0,1,0

15,105,105,17,4,13,4,3
13,108,108,22,4,18,3,2
37,110,110,7,7,0,1,0
8,120,120,2,2,0,1,0
31,122,122,9,3,6,2,1
41,125,125,11,11,0,1,0
30,127,127,10,10,0,1,0
1,158,158,13,13,0,1,0
23,177,177,19,6,13,2,1
40,184,184,11,6,5,2,1
17,193,193,6,2,4,2,1
4,204,204,20,4,16,3,2
44,205,205,22,22,0,1,0
21,233,233,8,8,0,1,0
16,234,234,1,1,0,1,0
35,242,242,55,55,0,1,0
24,244,244,34,10,24,4,3
9,252,252,6,6,0,1,0
11,254,254,1,1,0,1,0
6,282,282,13,5,8,2,1
28,307,307,15,15,0,1,0
26,316,316,10,10,0,1,0
10,341,341,11,11,0,1,0
0,343,343,5,1,4,2,1
34,353,353,49,36,13,2,1
5,355,355,14,7,7,2,1
29,380,380,24,17,7,2,1
22,382,382,66,36,30,3,2
33,389,389,6,6,0,1,0
32,393,393,15,15,0,1,0
25,397,397,29,29,0,1,0
3,404,404,19,12,7,2,1
39,406,406,19,19,0,1,0
27,414,414,108,108,0,1,0
38,420,420,93,61,32,3,2
19,427,427,27,27,0,1,0
42,442,442,150,110,40,2,1
14,465,465,71,23,48,2,1
12,467,467,48,36,12,2,1
43,472,472,9,9,0,1,0
7,477,477,51,51,0,1,0
2,477,477,15,8,7,2,1
36,488,488,9,9,0,1,0
20,488,488,43,43,0,1,0
18,497,497,12,12,0,1,0

3,101,101,3,3,0,1,0
18,125,125,6,6,0,1,0
17,137,137,13,13,0,1,0
22,143,143,4,1,3,2,1
0,143,143,1,1,0,1,0
4,148,148,28,28,0,1,0
8,160,160,5,5,0,1,0
33,161,161,11,5,6,3,2
10,168,168,1,1,0,1,0
20,188,188,3,3,0,1,0
31,198,198,7,1,6,3,2
35,208,208,14,14,0,1,0
1,208,208,2,2,0,1,0
11,211,211,24,24,0,1,0
23,221,221,2,2,0,1,0
34,222,222,100,46,54,4,3
13,231,231,14,11,3,2,1
9,234,234,79,79,0,1,0
36,248,248,87,38,49,2,1
16,274,274,52,52,0,1,0
30,284,284,37,37,0,1,0
29,305,305,9,9,0,1,0
28,345,345,37,2,35,2,1
12,370,370,31,6,25,3,2
7,373,373,68,68,0,1,0
14,375,375,120,120,0,1,0
21,393,393,14,2,12,4,3
32,414,414,37,21,16,3,2
25,417,417,43,43,0,1,0
24,428,428,20,20,0,1,0
5,432,432,47,47,0,1,0
26,446,446,36,36,0,1,0
27,452,452,18,18,0,1,0
15,472,472,16,16,0,1,0
6,479,479,24,12,12,4,3
2,483,483,27,15,12,4,3
19,496,496,101,101,0,1,0

35,113,113,22,22,0,1,0
17,114,114,25,25,0,1,0
23,122,122,8,8,0,1,0
34,145,145,12,4,8,3,2
13,147,147,28,28,0,1,0
27,158,158,16,1,15,2,1
1,172,172,3,3,0,1,0
11,196,196,2,2,0,1,0
18,202,202,45,45,0,1,0
25,241,241,5,2,3,2,1
0,273,273,22,22,0,1,0
21,283,283,29,29,0,1,0
6,298,298,133,96,37,2,1
31,312,312,3,3,0,1,0
4,312,312,39,39,0,1,0
22,315,315,38,14,24,2,1
12,321,321,21,7,14,2,1
14,324,324,52,34,18,3,2
24,331,331,5,5,0,1,0
29,337,337,21,21,0,1,0
5,342,342,4,4,0,1,0
20,348,348,24,10,14,3,2
28,363,363,71,71,0,1,0
3,375,375,12,12,0,1,0
33,402,402,23,14,9,4,3
7,403,403,4,4,0,1,0
32,424,424,106,98,8,2,1
10,427,427,49,27,22,2,1
26,446,446,9,9,0,1,0
16,470,470,145,50,95,4,3
2,477,477,106,94,12,4,3
15,479,479,6,6,0,1,0
19,482,482,4,4,0,1,0
9,487,487,18,18,0,1,0
8,493,493,28,28,0,1,0
30,499,499,56,56,0,1,0

10,101,101,10,4,6,3,2
4,102,102,12,12,0,1,0
8,157,157,4,4,0,1,0
41,158,158,10,10,0,1,0
29,161,161,3,3,0,1,0
17,183,183,1,1,0,1,0
28,183,183,13,7,6,3,2
16,193,193,27,27,0,1,0
25,195,195,19,19,0,1,0
37,201,201,22,22,0,1,0
14,203,203,4,4,0,1,0
40,205,205,36,15,21,4,3
5,227,227,25,25,0,1,0
22,255,255,4,1,3,2,1
21,260,260,96,18,78,4,3
32,261,261,21,21,0,1,0
33,264,264,56,28,28,3,2
1,279,279,11,11,0,1,0
6,283,283,7,7,0,1,0
18,307,307,30,21,9,4,3
26,315,315,4,4,0,1,0
15,343,343,37,37,0,1,0
19,346,346,8,8,0,1,0
11,346,346,10,4,6,3,2
24,351,351,6,6,0,1,0
0,356,356,5,5,0,1,0
2,379,379,40,11,29,2,1
38,383,383,50,29,21,2,1
36,389,389,38,19,19,2,1
12,393,393,20,14,6,2,1
42,405,405,23,23,0,1,0
35,408,408,41,41,0,1,0
27,415,415,39,18,21,2,1
13,418,418,58,38,20,2,1
23,429,429,48,48,0,1,0
39,447,447,24,12,12,4,3
20,447,447,19,1,18,4,3
31,460,460,28,28,0,1,0
34,463,463,148,136,12,2,1
3,473,473,22,22,0,1,0
30,476,476,76,76,0,1,0
7,481,481,20,20,0,1,0
9,491,491,62,8,54,3,2

12,100,100,1,1,0,1,0
23,107,107,12,12,0,1,0
16,108,108,21,5,16,3,2
15,115,115,1,1,0,1,0
30,130,130,9,9,0,1,0
35,132,132,6,6,0,1,0
36,141,141,9,9,0,1,0
5,155,155,16,16,0,1,0
6,158,158,4,1,3,2,1
17,177,177,35,35,0,1,0
31,204,204,20,2,18,3,2
40,210,210,73,73,0,1,0
21,211,211,80,80,0,1,0
25,215,215,72,30,42,3,2
24,256,256,32,8,24,4,3
20,259,259,12,12,0,1,0
10,260,260,20,20,0,1,0
18,308,308,3,3,0,1,0
7,311,311,3,3,0,1,0
8,315,315,17,5,12,2,1
1,331,331,9,9,0,1,0
29,337,337,23,23,0,1,0
3,342,342,18,18,0,1,0
33,345,345,48,6,42,4,3
27,354,354,7,7,0,1,0
28,370,370,11,8,3,2,1
38,373,373,10,10,0,1,0
19,381,381,21,21,0,1,0
0,404,404,64,2,62,3,2
2,404,404,1,1,0,1,0
34,439,439,66,66,0,1,0
37,447,447,6,6,0,1,0
4,451,451,45,45,0,1,0
14,453,453,108,73,35,2,1
11,462,462,15,15,0,1,0
26,471,471,34,10,24,2,1
9,475,475,50,11,39,2,1
39,479,479,83,40,43,2,1
32,492,492,19,14,5,2,1
22,495,495,4,4,0,1,0
13,495,495,7,7,0,1,0

34,104,104,1,1,0,1,0
35,106,106,9,9,0,1,0
8,118,118,14,4,10,2,1
14,142,142,24,4,20,3,2
17,144,144,7,2,5,2,1
24,156,156,26,26,0,1,0
0,162,162,57,7,50,2,1
13,195,195,13,13,0,1,0
16,251,251,11,11,0,1,0
2,260,260,17,2,15,4,3
32,262,262,44,44,0,1,0
21,268,268,37,17,20,3,2
20,270,270,2,2,0,1,0
28,283,283,1,1,0,1,0
4,284,284,14,14,0,1,0
26,285,285,98,98,0,1,0
31,288,288,58,14,44,2,1
22,294,294,2,2,0,1,0
3,307,307,22,22,0,1,0
10,323,323,17,2,15,4,3
6,332,332,23,5,18,4,3
30,336,336,19,19,0,1,0
1,337,337,4,1,3,2,1
7,338,338,25,13,12,2,1
33,341,341,10,6,4,2,1
18,358,358,102,102,0,1,0
11,372,372,36,12,24,3,2
23,380,380,23,3,20,4,3
15,407,407,47,47,0,1,0
25,409,409,2,2,0,1,0
29,428,428,2,2,0,1,0
9,445,445,114,114,0,1,0
19,452,452,36,36,0,1,0
5,457,457,91,91,0,1,0
27,470,470,115,115,0,1,0
12,500,500,45,11,34,2,1

28,101,101,24,24,0,1,0
22,108,108,44,44,0,1,0
43,109,109,18,6,12,2,1
13,123,123,1,1,0,1,0
8,124,124,5,5,0,1,0
11,127,127,3,3,0,1,0
18,128,128,4,4,0,1,0
32,138,138,26,14,12,4,3
14,152,152,1,1,0,1,0
12,153,153,7,7,0,1,0
33,169,169,1,1,0,1,0
24,169,169,10,10,0,1,0
34,182,182,17,17,0,1,0
2,182,182,7,2,5,2,1
42,191,191,4,4,0,1,0
37,202,202,64,64,0,1,0
26,222,222,20,4,16,2,1
27,222,222,5,5,0,1,0
36,237,237,38,38,0,1,0
25,250,250,1,1,0,1,0
31,274,274,44,44,0,1,0
3,283,283,26,8,18,2,1
23,288,288,12,12,0,1,0
0,297,297,8,8,0,1,0
16,297,297,50,20,30,2,1
10,317,317,16,2,14,3,2
19,318,318,13,13,0,1,0
38,326,326,34,28,6,2,1
39,334,334,19,19,0,1,0
40,339,339,6,6,0,1,0
9,346,346,4,4,0,1,0
41,347,347,1,1,0,1,0
20,348,348,19,19,0,1,0
30,349,349,63,63,0,1,0
6,351,351,2,2,0,1,0
4,352,352,79,79,0,1,0
15,358,358,1,1,0,1,0
35,377,377,24,24,0,1,0
17,382,382,100,76,24,2,1
29,429,429,26,26,0,1,0
5,429,429,5,1,4,2,1
1,446,446,77,45,32,3,2
21,459,459,9,2,7,2,1
7,484,484,29,7,22,2,1

23,107,107,8,8,0,1,0
22,109,109,5,5,0,1,0
4,122,122,35,35,0,1,0
9,128,128,19,19,0,1,0
8,132,132,19,19,0,1,0
6,142,142,43,7,36,4,3
17,144,144,10,10,0,1,0
0,150,150,26,17,9,2,1
27,163,163,19,19,0,1,0
20,163,163,20,12,8,3,2
1,184,184,8,5,3,2,1
29,189,189,1,1,0,1,0
18,196,196,7,2,5,2,1
30,202,202,15,15,0,1,0
31,205,205,7,7,0,1,0
16,222,222,53,50,3,2,1
19,236,236,94,57,37,2,1
32,258,258,31,31,0,1,0
3,259,259,1,1,0,1,0
25,273,273,4,4,0,1,0
5,291,291,27,9,18,4,3
11,296,296,33,3,30,2,1
28,311,311,53,53,0,1,0
21,324,324,42,18,24,2,1
14,338,338,15,9,6,3,2
7,338,338,1,1,0,1,0
12,364,364,4,4,0,1,0
13,383,383,102,102,0,1,0
26,391,391,19,4,15,2,1
24,394,394,72,72,0,1,0
2,411,411,69,59,10,2,1
15,478,478,5,5,0,1,0
10,486,486,71,15,56,3,2

13,128,128,8,8,0,1,0
37,136,136,6,3,3,2,1
12,153,153,40,35,5,2,1
31,156,156,41,33,8,3,2
8,159,159,13,13,0,1,0
19,161,161,5,5,0,1,0
21,169,169,46,41,5,2,1
27,172,172,5,5,0,1,0
36,186,186,4,4,0,1,0
2,211,211,1,1,0,1,0
35,214,214,7,7,0,1,0
14,215,215,6,2,4,2,1
15,231,231,35,23,12,2,1
33,271,271,41,29,12,4,3
23,281,281,20,20,0,1,0
0,283,283,30,30,0,1,0
26,287,287,9,9,0,1,0
29,310,310,31,7,24,2,1
20,316,316,20,20,0,1,0
18,319,319,35,35,0,1,0
7,320,320,12,5,7,2,1
32,335,335,11,11,0,1,0
28,337,337,59,47,12,4,3
1,341,341,15,15,0,1,0
11,345,345,31,31,0,1,0
34,355,355,74,74,0,1,0
24,360,360,10,6,4,2,1
5,368,368,61,13,48,2,1
10,375,375,20,20,0,1,0
39,376,376,15,6,9,2,1
4,380,380,14,14,0,1,0
25,388,388,41,41,0,1,0
16,394,394,19,19,0,1,0
38,406,406,33,33,0,1,0
17,411,411,17,17,0,1,0
22,441,441,16,16,0,1,0
3,475,475,117,117,0,1,0
6,479,479,86,86,0,1,0
30,482,482,100,88,12,3,2
9,491,491,29,29,0,1,0

4,103,103,6,1,5,2,1
24,118,118,17,17,0,1,0
2,137,137,9,9,0,1,0
33,146,146,37,37,0,1,0
45,153,153,71,36,35,3,2
13,180,180,16,16,0,1,0
29,213,213,8,8,0,1,0
5,216,216,2,2,0,1,0
38,220,220,14,14,0,1,0
20,227,227,43,43,0,1,0
17,229,229,16,16,0,1,0
40,236,236,11,5,6,2,1
39,241,241,8,4,4,2,1
37,254,254,50,50,0,1,0
42,261,261,35,21,14,2,1
26,264,264,4,4,0,1,0
34,275,275,17,2,15,2,1
30,278,278,25,25,0,1,0
27,283,283,25,5,20,2,1
23,286,286,33,5,28,3,2
7,293,293,15,15,0,1,0
11,294,294,18,2,16,3,2
43,313,313,20,20,0,1,0
14,325,325,57,57,0,1,0
9,341,341,37,3,34,2,1
16,344,344,12,4,8,2,1
22,364,364,5,5,0,1,0
21,365,365,3,3,0,1,0
25,371,371,1,1,0,1,0
0,377,377,22,22,0,1,0
28,381,381,10,1,9,3,2
31,387,387,15,15,0,1,0
18,388,388,8,8,0,1,0
15,395,395,55,11,44,2,1
46,396,396,4,4,0,1,0
19,401,401,30,30,0,1,0
32,405,405,54,14,40,4,3
3,405,405,1,1,0,1,0
8,427,427,1,1,0,1,0
44,428,428,32,32,0,1,0
36,430,430,63,13,50,2,1
12,456,456,9,9,0,1,0
10,468,468,90,90,0,1,0
35,469,469,23,23,0,1,0
1,474,474,39,21,18,2,1
41,493,493,3,3,0,1,0
6,497,497,4,4,0,1,0

2,103,103,11,11,0,1,0
3,104,104,1,1,0,1,0
7,120,120,1,1,0,1,0
13,164,164,11,11,0,1,0
26,164,164,37,17,20,2,1
32,173,173,7,7,0,1,0
10,204,204,30,30,0,1,0
0,243,243,6,6,0,1,0
38,254,254,16,4,12,4,3
4,254,254,3,3,0,1,0
37,271,271,5,5,0,1,0
27,285,285,49,49,0,1,0
29,295,295,1,1,0,1,0
34,312,312,13,5,8,3,2
19,321,321,22,22,0,1,0
11,333,333,95,95,0,1,0
15,337,337,13,3,10,2,1
30,337,337,86,8,78,3,2
9,338,338,83,78,5,2,1
23,347,347,52,52,0,1,0
24,348,348,63,63,0,1,0
8,349,349,49,7,42,3,2
25,349,349,29,29,0,1,0
21,354,354,53,15,38,2,1
16,369,369,54,4,50,3,2
35,373,373,18,18,0,1,0
22,385,385,32,4,28,2,1
5,390,390,6,6,0,1,0
6,395,395,55,3,52,3,2
17,419,419,25,25,0,1,0
31,430,430,23,23,0,1,0
18,441,441,87,1,86,3,2
12,452,452,61,57,4,2,1
14,456,456,18,3,15,2,1
28,459,459,86,53,33,2,1
36,459,459,45,14,31,2,1
33,474,474,3,3,0,1,0
20,474,474,35,4,31,3,2
1,477,477,7,7,0,1,0

23,138,138,8,3,5,2,1
34,138,138,22,13,9,3,2
11,159,159,2,2,0,1,0
26,175,175,2,2,0,1,0
12,178,178,39,39,0,1,0
6,193,193,70,70,0,1,0
15,203,203,6,6,0,1,0
4,212,212,26,2,24,2,1
24,227,227,80,75,5,2,1
5,236,236,48,20,28,4,3
18,250,250,38,2,36,4,3
29,262,262,6,2,4,2,1
33,263,263,2,2,0,1,0
22,266,266,2,2,0,1,0
13,270,270,25,2,23,2,1
30,279,279,12,1,11,2,1
14,289,289,16,10,6,2,1
32,290,290,8,8,0,1,0
28,311,311,26,26,0,1,0
17,340,340,107,107,0,1,0
9,350,350,33,9,24,3,2
27,364,364,16,16,0,1,0
31,376,376,28,11,17,2,1
0,377,377,47,47,0,1,0
19,388,388,12,12,0,1,0
7,401,401,4,4,0,1,0
1,411,411,84,18,66,4,3
2,415,415,27,12,15,4,3
21,426,426,87,87,0,1,0
25,431,431,76,76,0,1,0
10,447,447,22,22,0,1,0
8,455,455,57,57,0,1,0
20,467,467,50,50,0,1,0
3,470,470,61,61,0,1,0
16,498,498,27,27,0,1,0

1,137,137,11,2,9,2,1
15,151,151,9,9,0,1,0
5,158,158,63,3,60,3,2
33,161,161,21,7,14,2,1
31,169,169,10,10,0,1,0
12,175,175,28,28,0,1,0
24,177,177,6,6,0,1,0
4,197,197,17,17,0,1,0
20,209,209,16,16,0,1,0
27,217,217,4,4,0,1,0
11,224,224,30,30,0,1,0
23,238,238,59,23,36,2,1
37,241,241,5,5,0,1,0
3,243,243,18,18,0,1,0
32,252,252,14,14,0,1,0
9,272,272,29,29,0,1,0
18,277,277,41,41,0,1,0
19,285,285,28,1,27,3,2
36,293,293,11,11,0,1,0
30,294,294,63,20,43,2,1
26,304,304,9,3,6,3,2
38,315,315,21,21,0,1,0
22,334,334,104,104,0,1,0
17,343,343,14,8,6,3,2
16,346,346,1,1,0,1,0
35,355,355,22,22,0,1,0
10,356,356,50,50,0,1,0
8,378,378,63,25,38,3,2
6,403,403,12,12,0,1,0
25,409,409,42,6,36,3,2
0,414,414,11,11,0,1,0
7,417,417,26,5,21,4,3
34,426,426,35,35,0,1,0
29,427,427,40,16,24,3,2
13,452,452,3,3,0,1,0
2,453,453,25,25,0,1,0
21,455,455,85,85,0,1,0
14,473,473,11,11,0,1,0
28,492,492,51,51,0,1,0

23,109,109,16,16,0,1,0
26,123,123,5,2,3,2,1
21,124,124,1,1,0,1,0
36,127,127,11,11,0,1,0
7,133,133,25,25,0,1,0
12,137,137,7,7,0,1,0
44,156,156,8,8,0,1,0
27,166,166,3,3,0,1,0
41,170,170,55,21,34,3,2
2,176,176,2,2,0,1,0
6,181,181,18,2,16,3,2
39,186,186,7,7,0,1,0
42,186,186,8,1,7,2,1
38,187,187,40,40,0,1,0
19,206,206,1,1,0,1,0
35,223,223,15,6,9,2,1
5,243,243,24,4,20,2,1
28,262,262,10,2,8,2,1
20,265,265,18,6,12,2,1
30,284,284,49,25,24,3,2
25,287,287,11,1,10,3,2
10,297,297,5,5,0,1,0
17,300,300,23,16,7,2,1
9,301,301,11,6,5,2,1
43,304,304,6,6,0,1,0
16,319,319,36,36,0,1,0
31,326,326,9,5,4,2,1
8,356,356,11,3,8,2,1
0,359,359,50,2,48,3,2
3,361,361,32,20,12,3,2
24,395,395,11,11,0,1,0
29,400,400,72,23,49,2,1
22,408,408,14,2,12,2,1
18,411,411,4,4,0,1,0
34,415,415,47,25,22,3,2
40,418,418,4,4,0,1,0
32,425,425,54,54,0,1,0
33,453,453,117,78,39,4,3
15,457,457,14,6,8,2,1
1,460,460,10,4,6,3,2
11,462,462,15,15,0,1,0
4,470,470,72,36,36,3,2
13,484,484,120,120,0,1,0
14,491,491,63,24,39,4,3
37,500,500,53,53,0,1,0

37,114,114,19,1,18,2,1
10,126,126,3,3,0,1,0
7,132,132,20,7,13,3,2
23,139,139,18,18,0,1,0
13,143,143,21,1,20,3,2
44,161,161,6,1,5,2,1
30,166,166,2,2,0,1,0
34,169,169,9,9,0,1,0
21,188,188,21,5,16,3,2
39,198,198,11,11,0,1,0
27,201,201,6,6,0,1,0
36,206,206,4,4,0,1,0
22,214,214,7,7,0,1,0
5,231,231,43,43,0,1,0
9,235,235,12,12,0,1,0
18,241,241,4,4,0,1,0
8,269,269,24,8,16,3,2
12,281,281,16,5,11,2,1
43,287,287,5,5,0,1,0
3,291,291,2,2,0,1,0
19,299,299,16,8,8,2,1
29,309,309,20,20,0,1,0
15,312,312,36,12,24,4,3
38,317,317,24,24,0,1,0
20,317,317,5,5,0,1,0
28,318,318,18,18,0,1,0
25,326,326,27,27,0,1,0
17,333,333,9,9,0,1,0
32,351,351,32,20,12,4,3
31,356,356,89,7,82,4,3
35,358,358,7,1,6,2,1
41,362,362,3,3,0,1,0
16,373,373,65,7,58,3,2
11,377,377,2,2,0,1,0
14,415,415,19,19,0,1,0
40,430,430,62,52,10,2,1
24,445,445,5,5,0,1,0
33,451,451,49,33,16,3,2
6,454,454,17,9,8,2,1
26,454,454,302,279,23,2,1
4,460,460,56,56,0,1,0
42,479,479,30,30,0,1,0
2,485,485,84,56,28,3,2
1,486,486,6,6,0,1,0
0,492,492,11,2,9,2,1

31,113,113,10,7,3,2,1
19,137,137,26,11,15,4,3
8,154,154,8,8,0,1,0
16,161,161,2,2,0,1,0
14,190,190,9,1,8,3,2
27,202,202,13,5,8,3,2
9,204,204,51,51,0,1,0
6,212,212,33,33,0,1,0
17,216,216,13,1,12,2,1
12,226,226,2,2,0,1,0
1,233,233,8,8,0,1,0
33,238,238,15,10,5,2,1
15,241,241,58,58,0,1,0
28,253,253,22,22,0,1,0
21,253,253,10,10,0,1,0
32,283,283,29,29,0,1,0
11,292,292,71,11,60,3,2
5,322,322,4,4,0,1,0
23,325,325,6,6,0,1,0
36,332,332,25,25,0,1,0
3,356,356,83,83,0,1,0
35,357,357,9,9,0,1,0
0,374,374,27,3,24,4,3
20,392,392,11,11,0,1,0
30,398,398,41,11,30,3,2
2,416,416,19,19,0,1,0
7,432,432,139,16,123,4,3
26,445,445,11,11,0,1,0
29,452,452,48,48,0,1,0
4,453,453,1,1,0,1,0
13,462,462,13,5,8,3,2
24,463,463,29,29,0,1,0
10,478,478,39,39,0,1,0
34,489,489,111,105,6,3,2
18,491,491,51,36,15,4,3
25,492,492,118,7,111,4,3
22,494,494,145,145,0,1,0

13,102,102,1,1,0,1,0
32,113,113,19,1,18,2,1
15,147,147,46,46,0,1,0
4,150,150,30,21,9,4,3
5,151,151,3,3,0,1,0
18,157,157,3,3,0,1,0
24,164,164,44,9,35,2,1
37,164,164,37,7,30,3,2
34,174,174,8,3,5,2,1
28,188,188,5,5,0,1,0
0,191,191,4,4,0,1,0
8,202,202,1,1,0,1,0
27,210,210,27,27,0,1,0
3,224,224,10,10,0,1,0
38,224,224,35,35,0,1,0
1,225,225,25,25,0,1,0
31,279,279,80,42,38,3,2
29,285,285,11,11,0,1,0
33,319,319,10,10,0,1,0
20,343,343,50,50,0,1,0
17,343,343,14,14,0,1,0
16,348,348,15,3,12,3,2
19,357,357,97,39,58,4,3
30,358,358,2,2,0,1,0
10,374,374,18,4,14,2,1
23,379,379,1,1,0,1,0
7,386,386,27,23,4,2,1
9,390,390,41,41,0,1,0
6,394,394,44,4,40,2,1
2,403,403,17,17,0,1,0
21,406,406,3,3,0,1,0
39,409,409,7,7,0,1,0
22,413,413,25,8,17,2,1
26,433,433,19,15,4,2,1
25,443,443,77,35,42,4,3
12,446,446,31,31,0,1,0
11,468,468,51,51,0,1,0
35,476,476,52,35,17,2,1
36,493,493,73,10,63,3,2
14,500,500,50,41,9,4,3

12,105,105,11,11,0,1,0
13,106,106,21,21,0,1,0
0,108,108,5,2,3,2,1
27,112,112,3,3,0,1,0
37,128,128,1,1,0,1,0
30,128,128,2,2,0,1,0
34,136,136,24,2,22,3,2
5,143,143,12,5,7,2,1
10,156,156,26,6,20,3,2
20,159,159,3,3,0,1,0
9,160,160,5,5,0,1,0
4,160,160,11,11,0,1,0
3,175,175,3,3,0,1,0
11,181,181,5,5,0,1,0
40,199,199,1,1,0,1,0
6,211,211,3,3,0,1,0
21,213,213,67,67,0,1,0
26,216,216,22,22,0,1,0
28,220,220,5,5,0,1,0
36,223,223,3,3,0,1,0
8,237,237,9,1,8,2,1
15,274,274,56,14,42,3,2
32,282,282,29,29,0,1,0
14,282,282,6,3,3,2,1
22,288,288,62,22,40,2,1
7,315,315,12,12,0,1,0
39,333,333,76,76,0,1,0
18,344,344,58,29,29,2,1
31,350,350,32,8,24,4,3
1,353,353,64,52,12,4,3
24,371,371,47,10,37,2,1
33,374,374,162,62,100,3,2
35,411,411,32,32,0,1,0
19,412,412,10,10,0,1,0
29,427,427,22,8,14,2,1
2,458,458,22,18,4,2,1
23,473,473,9,9,0,1,0
25,476,476,91,63,28,4,3
16,490,490,9,4,5,2,1
38,496,496,15,1,14,3,2
17,499,499,34,34,0,1,0

39,109,109,22,2,20,2,1
6,116,116,1,1,0,1,0
32,118,118,10,1,9,2,1
41,123,123,25,25,0,1,0
4,125,125,9,9,0,1,0
10,139,139,1,1,0,1,0
26,157,157,3,3,0,1,0
0,160,160,2,2,0,1,0
2,168,168,16,8,8,3,2
34,201,201,1,1,0,1,0
12,203,203,56,33,23,2,1
21,205,205,10,3,7,2,1
31,215,215,72,35,37,2,1
5,219,219,24,16,8,3,2
9,245,245,17,17,0,1,0
35,248,248,11,7,4,2,1
24,250,250,1,1,0,1,0
37,267,267,45,5,40,3,2
23,279,279,4,4,0,1,0
18,280,280,40,40,0,1,0
28,282,282,45,45,0,1,0
7,289,289,37,16,21,4,3
17,296,296,64,64,0,1,0
11,311,311,1,1,0,1,0
29,338,338,44,6,38,2,1
1,365,365,20,14,6,3,2
30,369,369,89,5,84,4,3
20,370,370,18,14,4,2,1
16,378,378,1,1,0,1,0
15,393,393,33,21,12,2,1
36,396,396,8,1,7,2,1
13,405,405,18,13,5,2,1
14,407,407,15,15,0,1,0
22,439,439,3,3,0,1,0
40,448,448,41,13,28,2,1
19,460,460,27,27,0,1,0
33,467,467,38,38,0,1,0
38,476,476,21,8,13,2,1
42,489,489,28,28,0,1,0
27,490,490,18,18,0,1,0
25,491,491,8,8,0,1,0
8,496,496,68,48,20,3,2
3,500,500,112,112,0,1,0

27,101,101,7,7,0,1,0
0,112,112,8,1,7,2,1
35,120,120,7,7,0,1,0
23,120,120,8,8,0,1,0
9,126,126,30,30,0,1,0
11,133,133,8,8,0,1,0
8,154,154,14,2,12,3,2
17,167,167,6,3,3,2,1
25,172,172,1,1,0,1,0
21,172,172,8,8,0,1,0
32,174,174,2,2,0,1,0
26,188,188,2,2,0,1,0
6,192,192,10,10,0,1,0
12,192,192,34,13,21,4,3
10,195,195,21,21,0,1,0
34,213,213,23,23,0,1,0
1,218,218,29,17,12,4,3
30,219,219,28,28,0,1,0
36,226,226,10,10,0,1,0
29,239,239,4,4,0,1,0
19,247,247,26,26,0,1,0
31,248,248,15,3,12,3,2
28,256,256,2,2,0,1,0
37,270,270,35,15,20,3,2
38,305,305,29,29,0,1,0
22,324,324,42,12,30,4,3
5,327,327,35,35,0,1,0
18,338,338,25,18,7,2,1
3,345,345,42,4,38,3,2
16,352,352,24,4,20,3,2
7,354,354,26,26,0,1,0
14,365,365,30,30,0,1,0
13,376,376,32,32,0,1,0
33,394,394,87,57,30,4,3
2,403,403,22,7,15,4,3
15,409,409,20,5,15,2,1
24,418,418,190,96,94,4,3
4,443,443,21,21,0,1,0
20,480,480,32,1,31,4,3
39,497,497,139,139,0,1,0

36,105,105,16,16,0,1,0
6,117,117,2,2,0,1,0
39,125,125,8,8,0,1,0
9,126,126,5,5,0,1,0
18,129,129,5,1,4,2,1
0,159,159,1,1,0,1,0
40,163,163,4,4,0,1,0
20,165,165,1,1,0,1,0
35,165,165,11,1,10,3,2
38,198,198,8,8,0,1,0
14,222,222,4,4,0,1,0
7,228,228,15,8,7,2,1
15,234,234,7,7,0,1,0
8,249,249,11,11,0,1,0
26,255,255,27,3,24,2,1
11,259,259,72,64,8,2,1
33,265,265,13,7,6,3,2
25,267,267,36,36,0,1,0
32,271,271,15,15,0,1,0
22,284,284,24,12,12,2,1
2,286,286,14,14,0,1,0
10,294,294,1,1,0,1,0
23,305,305,10,10,0,1,0
31,307,307,29,29,0,1,0
4,311,311,52,52,0,1,0
1,321,321,37,33,4,2,1
16,340,340,34,24,10,2,1
27,343,343,8,5,3,2,1
21,343,343,1,1,0,1,0
24,359,359,48,41,7,2,1
30,389,389,100,100,0,1,0
19,404,404,114,51,63,4,3
34,411,411,37,6,31,4,3
37,411,411,8,8,0,1,0
5,417,417,55,43,12,4,3
17,428,428,53,8,45,2,1
28,437,437,194,77,117,4,3
3,444,444,74,64,10,2,1
29,445,445,30,30,0,1,0
12,447,447,18,18,0,1,0
13,468,468,82,49,33,4,3

40,100,100,2,2,0,1,0
6,103,103,1,1,0,1,0
12,106,106,28,6,22,3,2
9,112,112,7,4,3,2,1
8,116,116,26,26,0,1,0
31,122,122,21,4,17,2,1
21,131,131,10,10,0,1,0
0,147,147,1,1,0,1,0
14,148,148,4,4,0,1,0
1,175,175,7,7,0,1,0
3,177,177,3,3,0,1,0
24,211,211,8,8,0,1,0
10,218,218,16,4,12,4,3
23,222,222,20,1,19,2,1
22,222,222,1,1,0,1,0
30,227,227,36,36,0,1,0
33,234,234,4,1,3,2,1
38,253,253,19,15,4,2,1
25,256,256,54,54,0,1,0
42,261,261,61,61,0,1,0
37,266,266,49,49,0,1,0
27,279,279,19,19,0,1,0
41,285,285,59,59,0,1,0
5,293,293,76,57,19,2,1
26,299,299,5,5,0,1,0
4,301,301,14,14,0,1,0
19,318,318,5,5,0,1,0
17,322,322,13,13,0,1,0
20,325,325,2,2,0,1,0
28,352,352,3,3,0,1,0
39,365,365,18,18,0,1,0
35,368,368,4,4,0,1,0
2,373,373,27,7,20,2,1
16,426,426,22,22,0,1,0
36,430,430,2,2,0,1,0
18,430,430,20,10,10,3,2
7,446,446,21,21,0,1,0
15,454,454,56,27,29,3,2
11,468,468,137,113,24,3,2
29,475,475,78,44,34,2,1
34,481,481,104,45,59,4,3
13,484,484,3,3,0,1,0
32,487,487,36,8,28,2,1

5,103,103,1,1,0,1,0
31,105,105,10,10,0,1,0
3,118,118,11,3,8,2,1
41,136,136,7,7,0,1,0
30,148,148,2,2,0,1,0
21,150,150,14,8,6,2,1
20,154,154,13,13,0,1,0
22,154,154,22,22,0,1,0
37,158,158,24,24,0,1,0
27,164,164,2,2,0,1,0
35,185,185,4,4,0,1,0
32,196,196,47,47,0,1,0
11,204,204,34,34,0,1,0
25,208,208,2,2,0,1,0
7,210,210,7,7,0,1,0
6,223,223,2,2,0,1,0
23,224,224,3,3,0,1,0
16,263,263,38,28,10,3,2
47,264,264,10,1,9,2,1
33,272,272,26,11,15,4,3
28,291,291,21,21,0,1,0
1,294,294,16,10,6,3,2
46,307,307,47,47,0,1,0
43,314,314,186,65,121,4,3
4,326,326,32,14,18,2,1
15,345,345,7,7,0,1,0
19,346,346,26,8,18,4,3
45,360,360,2,2,0,1,0
18,381,381,48,48,0,1,0
44,387,387,19,19,0,1,0
42,397,397,2,2,0,1,0
36,397,397,27,27,0,1,0
34,398,398,18,10,8,3,2
39,413,413,6,3,3,2,1
9,418,418,48,48,0,1,0
29,428,428,8,8,0,1,0
13,448,448,27,9,18,4,3
26,450,450,13,3,10,2,1
0,457,457,17,3,14,2,1
17,460,460,28,15,13,2,1
12,471,471,44,44,0,1,0
38,473,473,111,66,45,2,1
2,486,486,48,29,19,2,1
8,487,487,51,13,38,3,2
10,488,488,15,15,0,1,0
40,492,492,23,1,22,2,1
24,493,493,1,1,0,1,0
14,500,500,5,5,0,1,0

12,112,112,11,7,4,2,1
23,119,119,18,12,6,3,2
39,126,126,8,8,0,1,0
21,131,131,2,2,0,1,0
33,135,135,10,10,0,1,0
44,141,141,13,5,8,2,1
24,144,144,6,2,4,2,1
28,149,149,8,1,7,2,1
6,154,154,11,11,0,1,0
30,162,162,27,27,0,1,0
10,199,199,7,7,0,1,0
34,214,214,61,61,0,1,0
43,214,214,19,7,12,3,2
13,232,232,29,29,0,1,0
41,233,233,7,7,0,1,0
29,238,238,20,6,14,2,1
0,243,243,1,1,0,1,0
46,248,248,71,28,43,4,3
16,252,252,37,3,34,3,2
37,264,264,10,10,0,1,0
7,270,270,18,18,0,1,0
47,274,274,88,73,15,2,1
42,280,280,17,17,0,1,0
15,281,281,4,4,0,1,0
26,293,293,22,22,0,1,0
45,293,293,39,1,38,2,1
14,309,309,14,14,0,1,0
1,310,310,50,50,0,1,0
8,316,316,20,20,0,1,0
31,319,319,35,17,18,2,1
25,324,324,16,2,14,2,1
27,338,338,34,1,33,2,1
4,340,340,9,9,0,1,0
38,346,346,7,4,3,2,1
35,351,351,15,3,12,3,2
40,355,355,5,5,0,1,0
19,384,384,2,2,0,1,0
20,388,388,1,1,0,1,0
32,394,394,6,6,0,1,0
11,396,396,4,4,0,1,0
17,420,420,26,1,25,2,1
36,433,433,11,2,9,4,3
22,455,455,33,6,27,4,3
18,467,467,42,42,0,1,0
2,478,478,1,1,0,1,0
5,478,478,38,17,21,2,1
3,484,484,11,1,10,3,2
9,484,484,101,65,36,2,1

26,101,101,4,4,0,1,0
20,118,118,8,2,6,2,1
31,124,124,18,18,0,1,0
21,139,139,17,3,14,2,1
24,149,149,40,31,9,2,1
35,168,168,26,16,10,2,1
16,170,170,22,11,11,2,1
32,186,186,17,17,0,1,0
2,194,194,49,3,46,3,2
9,219,219,3,3,0,1,0
7,224,224,7,7,0,1,0
3,230,230,3,3,0,1,0
25,238,238,54,18,36,2,1
14,248,248,57,8,49,2,1
10,258,258,39,18,21,4,3
29,265,265,2,2,0,1,0
15,287,287,4,4,0,1,0
19,292,292,24,17,7,2,1
4,296,296,22,3,19,2,1
17,306,306,4,4,0,1,0
28,316,316,6,6,0,1,0
22,332,332,61,61,0,1,0
13,339,339,140,65,75,4,3
1,350,350,4,4,0,1,0
12,363,363,39,7,32,3,2
6,391,391,64,64,0,1,0
27,411,411,25,25,0,1,0
30,411,411,9,2,7,2,1
0,419,419,3,3,0,1,0
5,431,431,52,52,0,1,0
34,433,433,8,1,7,2,1
8,435,435,4,4,0,1,0
36,444,444,48,15,33,4,3
11,472,472,41,41,0,1,0
23,476,476,35,35,0,1,0
33,478,478,64,64,0,1,0
18,495,495,29,19,10,3,2
37,495,495,56,50,6,2,1

16,100,100,13,2,11,2,1
32,100,100,20,6,14,3,2
29,112,112,27,18,9,4,3
0,113,113,29,29,0,1,0
28,126,126,19,13,6,3,2
31,129,129,10,4,6,2,1
12,136,136,2,2,0,1,0
21,158,158,31,31,0,1,0
33,168,168,15,15,0,1,0
26,172,172,5,2,3,2,1
7,199,199,13,13,0,1,0
6,208,208,15,1,14,3,2
17,208,208,6,3,3,2,1
5,212,212,16,16,0,1,0
9,253,253,15,15,0,1,0
20,277,277,13,13,0,1,0
15,288,288,58,58,0,1,0
23,297,297,24,8,16,3,2
24,299,299,6,6,0,1,0
2,322,322,10,10,0,1,0
25,323,323,1,1,0,1,0
19,323,323,7,1,6,3,2
11,325,325,100,16,84,4,3
8,351,351,37,37,0,1,0
22,356,356,90,90,0,1,0
4,364,364,54,15,39,2,1
13,379,379,34,14,20,2,1
14,388,388,93,51,42,2,1
30,392,392,3,3,0,1,0
10,408,408,71,71,0,1,0
27,451,451,31,5,26,3,2
1,472,472,116,116,0,1,0
18,482,482,53,53,0,1,0
3,496,496,8,5,3,2,1

23,116,116,9,9,0,1,0
21,132,132,5,5,0,1,0
8,151,151,1,1,0,1,0
11,154,154,57,13,44,2,1
31,158,158,22,22,0,1,0
32,167,167,25,25,0,1,0
27,172,172,1,1,0,1,0
13,186,186,13,2,11,2,1
17,189,189,4,4,0,1,0
16,199,199,15,15,0,1,0
26,211,211,7,3,4,2,1
25,214,214,16,7,9,2,1
19,220,220,5,5,0,1,0
2,234,234,92,62,30,3,2
14,268,268,11,1,10,3,2
5,272,272,21,21,0,1,0
10,277,277,14,14,0,1,0
7,278,278,17,17,0,1,0
24,288,288,15,3,12,3,2
33,290,290,75,75,0,1,0
6,297,297,32,5,27,4,3
1,307,307,14,14,0,1,0
0,319,319,10,6,4,2,1
12,333,333,19,14,5,2,1
22,362,362,114,111,3,2,1
29,373,373,85,85,0,1,0
30,389,389,9,4,5,2,1
4,414,414,36,36,0,1,0
3,468,468,132,106,26,2,1
20,476,476,70,62,8,3,2
15,482,482,51,51,0,1,0
18,484,484,17,17,0,1,0
9,496,496,110,77,33,4,3
28,500,500,69,62,7,2,1

2,106,106,11,11,0,1,0
29,108,108,23,23,0,1,0
16,120,120,4,4,0,1,0
1,123,123,7,3,4,2,1
12,140,140,9,3,6,2,1
19,140,140,24,8,16,3,2
4,166,166,6,6,0,1,0
36,167,167,8,8,0,1,0
22,167,167,33,33,0,1,0
3,188,188,8,8,0,1,0
35,210,210,37,37,0,1,0
20,218,218,20,13,7,3,2
6,220,220,39,39,0,1,0
13,253,253,55,7,48,4,3
15,257,257,32,32,0,1,0
10,281,281,3,3,0,1,0
8,281,281,54,54,0,1,0
9,288,288,43,43,0,1,0
5,292,292,43,9,34,3,2
33,302,302,56,14,42,3,2
11,320,320,20,20,0,1,0
30,333,333,86,34,52,3,2
25,344,344,14,2,12,3,2
0,348,348,21,5,16,2,1
14,352,352,76,76,0,1,0
21,358,358,18,5,13,3,2
27,370,370,2,2,0,1,0
31,375,375,15,15,0,1,0
34,380,380,25,25,0,1,0
32,392,392,2,2,0,1,0
24,405,405,11,11,0,1,0
26,406,406,6,6,0,1,0
17,425,425,54,54,0,1,0
18,434,434,139,112,27,2,1
28,440,440,7,7,0,1,0
23,465,465,3,3,0,1,0
7,497,497,40,8,32,2,1

38,108,108,8,8,0,1,0
15,109,109,8,8,0,1,0
34,139,139,26,18,8,2,1
13,139,139,13,5,8,2,1
2,148,148,19,2,17,2,1
10,156,156,36,2,34,4,3
39,164,164,35,35,0,1,0
14,186,186,34,15,19,2,1
35,194,194,34,19,15,2,1
7,201,201,2,2,0,1,0
23,223,223,68,65,3,2,1
32,234,234,18,2,16,2,1
3,239,239,1,1,0,1,0
40,244,244,18,18,0,1,0
22,268,268,21,21,0,1,0
20,280,280,10,10,0,1,0
25,298,298,26,9,17,2,1
31,322,322,39,8,31,2,1
9,328,328,55,55,0,1,0
24,329,329,10,10,0,1,0
11,342,342,49,30,19,2,1
17,354,354,18,3,15,2,1
0,363,363,91,91,0,1,0
5,365,365,5,2,3,2,1
21,378,378,64,64,0,1,0
8,383,383,10,10,0,1,0
37,384,384,10,7,3,2,1
36,384,384,3,3,0,1,0
18,401,401,25,16,9,2,1
6,404,404,19,15,4,2,1
33,406,406,100,82,18,3,2
16,407,407,43,43,0,1,0
1,410,410,2,2,0,1,0
27,433,433,21,21,0,1,0
28,437,437,30,14,16,3,2
30,450,450,6,6,0,1,0
19,462,462,6,3,3,2,1
26,469,469,6,2,4,2,1
4,475,475,1,1,0,1,0
12,475,475,41,41,0,1,0
29,499,499,39,9,30,2,1

12,100,100,4,4,0,1,0
17,103,103,19,19,0,1,0
38,120,120,18,18,0,1,0
27,136,136,12,6,6,3,2
25,138,138,4,4,0,1,0
7,141,141,5,2,3,2,1
32,147,147,12,9,3,2,1
16,151,151,23,23,0,1,0
26,157,157,16,7,9,4,3
33,158,158,4,4,0,1,0
35,159,159,41,41,0,1,0
1,161,161,7,1,6,3,2
3,161,161,4,4,0,1,0
28,209,209,13,1,12,2,1
22,216,216,21,21,0,1,0
39,231,231,1,1,0,1,0
30,241,241,139,90,49,2,1
37,241,241,11,11,0,1,0
0,249,249,34,34,0,1,0
18,266,266,4,1,3,2,1
13,272,272,10,10,0,1,0
4,290,290,8,8,0,1,0
2,305,305,11,11,0,1,0
8,322,322,33,23,10,2,1
24,328,328,11,11,0,1,0
40,334,334,6,1,5,2,1
15,340,340,4,4,0,1,0
5,352,352,123,67,56,3,2
20,365,365,52,13,39,4,3
42,369,369,39,11,28,2,1
14,372,372,1,1,0,1,0
21,378,378,14,11,3,2,1
29,403,403,78,1,77,4,3
31,412,412,37,37,0,1,0
6,418,418,26,26,0,1,0
19,420,420,14,5,9,4,3
34,426,426,6,6,0,1,0
9,455,455,39,7,32,3,2
36,466,466,32,4,28,2,1
11,483,483,1,1,0,1,0
10,486,486,2,2,0,1,0
41,490,490,2,2,0,1,0
23,496,496,118,45,73,4,3

7,101,101,3,3,0,1,0
9,103,103,3,3,0,1,0
26,119,119,18,6,12,3,2
42,123,123,12,12,0,1,0
38,124,124,4,4,0,1,0
32,137,137,7,7,0,1,0
33,142,142,27,20,7,2,1
22,143,143,38,14,24,4,3
18,148,148,1,1,0,1,0
36,158,158,8,8,0,1,0
8,165,165,11,11,0,1,0
39,168,168,15,6,9,2,1
40,171,171,12,1,11,2,1
41,181,181,10,10,0,1,0
16,193,193,19,5,14,2,1
11,224,224,1,1,0,1,0
34,228,228,28,4,24,2,1
37,229,229,15,15,0,1,0
43,239,239,14,14,0,1,0
0,243,243,41,6,35,2,1
6,280,280,6,6,0,1,0
29,282,282,25,5,20,2,1
2,288,288,55,8,47,2,1
30,293,293,81,43,38,3,2
27,307,307,73,52,21,4,3
24,315,315,5,1,4,2,1
1,354,354,70,35,35,2,1
5,370,370,20,11,9,2,1
44,375,375,12,12,0,1,0
20,379,379,12,12,0,1,0
23,380,380,2,2,0,1,0
35,382,382,73,39,34,2,1
31,383,383,27,7,20,3,2
12,383,383,25,11,14,3,2
4,392,392,40,40,0,1,0
13,420,420,15,15,0,1,0
10,428,428,25,25,0,1,0
21,433,433,19,3,16,2,1
19,434,434,80,4,76,4,3
17,441,441,14,14,0,1,0
3,448,448,24,24,0,1,0
28,450,450,8,5,3,2,1
25,472,472,45,45,0,1,0
14,481,481,12,2,10,3,2
15,492,492,9,9,0,1,0

18,111,111,2,2,0,1,0
15,112,112,1,1,0,1,0
19,115,115,8,8,0,1,0
6,127,127,14,14,0,1,0
13,133,133,28,28,0,1,0
20,142,142,1,1,0,1,0
10,148,148,19,19,0,1,0
24,155,155,30,30,0,1,0
3,176,176,12,12,0,1,0
31,177,177,23,13,10,3,2
22,180,180,34,34,0,1,0
34,184,184,4,4,0,1,0
8,194,194,15,7,8,2,1
21,203,203,49,6,43,2,1
25,211,211,65,30,35,2,1
9,213,213,28,28,0,1,0
17,218,218,8,8,0,1,0
0,221,221,3,3,0,1,0
14,229,229,5,5,0,1,0
2,247,247,91,41,50,3,2
29,289,289,61,50,11,2,1
23,296,296,10,1,9,2,1
30,298,298,18,18,0,1,0
4,309,309,4,4,0,1,0
35,316,316,30,12,18,3,2
32,326,326,7,7,0,1,0
33,333,333,13,13,0,1,0
1,365,365,33,14,19,2,1
27,383,383,6,6,0,1,0
36,403,403,57,48,9,2,1
26,422,422,14,5,9,4,3
28,426,426,51,20,31,2,1
16,440,440,21,21,0,1,0
7,452,452,14,11,3,2,1
11,474,474,4,4,0,1,0
5,480,480,146,146,0,1,0
12,487,487,113,77,36,4,3

32,115,115,5,5,0,1,0
5,124,124,37,26,11,2,1
20,125,125,24,19,5,2,1
3,135,135,1,1,0,1,0
38,142,142,29,29,0,1,0
7,158,158,8,8,0,1,0
9,163,163,13,4,9,2,1
26,180,180,21,8,13,2,1
35,183,183,17,17,0,1,0
2,189,189,9,2,7,2,1
10,201,201,6,1,5,2,1
6,212,212,12,4,8,3,2
4,218,218,65,65,0,1,0
37,219,219,16,16,0,1,0
31,221,221,13,13,0,1,0
18,235,235,17,11,6,2,1
13,237,237,2,2,0,1,0
36,264,264,3,3,0,1,0
30,272,272,37,21,16,3,2
33,272,272,11,11,0,1,0
16,273,273,27,27,0,1,0
14,282,282,3,3,0,1,0
28,305,305,31,31,0,1,0
22,315,315,37,22,15,4,3
39,319,319,21,1,20,3,2
40,331,331,51,51,0,1,0
24,355,355,41,41,0,1,0
11,362,362,29,29,0,1,0
8,382,382,9,1,8,3,2
25,393,393,165,129,36,3,2
34,407,407,3,3,0,1,0
1,408,408,25,2,23,2,1
27,409,409,47,47,0,1,0
12,410,410,41,15,26,2,1
41,437,437,8,8,0,1,0
21,441,441,32,2,30,3,2
0,442,442,25,13,12,3,2
23,459,459,53,35,18,4,3
29,469,469,25,25,0,1,0
17,476,476,10,2,8,2,1
15,477,477,44,8,36,2,1
19,494,494,13,13,0,1,0

22,105,105,7,7,0,1,0
11,118,118,10,10,0,1,0
33,131,131,10,10,0,1,0
29,159,159,17,3,14,2,1
9,173,173,1,1,0,1,0
23,176,176,50,23,27,4,3
34,195,195,6,6,0,1,0
20,209,209,13,1,12,4,3
17,236,236,32,16,16,3,2
0,259,259,31,31,0,1,0
7,275,275,51,51,0,1,0
19,309,309,6,6,0,1,0
28,312,312,15,15,0,1,0
15,315,315,61,61,0,1,0
12,317,317,1,1,0,1,0
10,348,348,4,4,0,1,0
21,349,349,98,32,66,4,3
27,370,370,23,23,0,1,0
14,374,374,1,1,0,1,0
13,375,375,103,90,13,2,1
24,383,383,46,13,33,4,3
4,425,425,117,87,30,2,1
26,427,427,16,16,0,1,0
25,428,428,12,5,7,2,1
8,436,436,36,36,0,1,0
1,438,438,67,49,18,4,3
5,439,439,36,36,0,1,0
2,443,443,68,27,41,2,1
3,444,444,61,45,16,2,1
6,444,444,60,24,36,3,2
16,454,454,61,43,18,2,1
32,478,478,22,6,16,3,2
18,481,481,37,7,30,2,1
30,483,483,107,22,85,3,2
31,499,499,46,46,0,1,0

42,103,103,15,15,0,1,0
27,133,133,14,9,5,2,1
5,138,138,18,18,0,1,0
4,144,144,11,1,10,2,1
0,153,153,23,7,16,3,2
13,160,160,22,1,21,4,3
37,172,172,6,6,0,1,0
26,174,174,17,17,0,1,0
23,193,193,10,1,9,2,1
20,198,198,3,3,0,1,0
30,202,202,55,35,20,2,1
24,203,203,6,6,0,1,0
35,226,226,10,10,0,1,0
2,230,230,2,2,0,1,0
21,235,235,55,32,23,2,1
3,241,241,6,2,4,2,1
44,265,265,2,2,0,1,0
1,267,267,21,18,3,2,1
16,275,275,26,26,0,1,0
29,276,276,17,17,0,1,0
22,290,290,23,17,6,2,1
43,296,296,99,78,21,2,1
40,312,312,1,1,0,1,0
36,349,349,6,6,0,1,0
11,372,372,2,2,0,1,0
28,374,374,6,2,4,2,1
45,385,385,7,7,0,1,0
9,395,395,12,9,3,2,1
15,397,397,37,1,36,2,1
34,397,397,3,3,0,1,0
18,401,401,10,1,9,2,1
19,404,404,27,27,0,1,0
12,405,405,26,26,0,1,0
7,406,406,4,4,0,1,0
10,409,409,18,8,10,3,2
25,411,411,31,31,0,1,0
33,435,435,30,30,0,1,0
39,439,439,11,6,5,2,1
6,455,455,48,16,32,3,2
41,458,458,96,96,0,1,0
14,467,467,13,13,0,1,0
38,473,473,88,49,39,4,3
31,476,476,44,44,0,1,0
32,490,490,50,18,32,2,1
17,497,497,6,6,0,1,0
46,499,499,142,142,0,1,0
8,500,500,16,16,0,1,0

42,103,103,13,6,7,2,1
29,159,159,6,6,0,1,0
20,159,159,7,7,0,1,0
13,166,166,12,9,3,2,1
6,182,182,19,19,0,1,0
31,182,182,18,5,13,2,1
5,185,185,14,14,0,1,0
25,186,186,2,2,0,1,0
14,192,192,22,22,0,1,0
15,196,196,15,15,0,1,0
28,200,200,20,10,10,3,2
21,208,208,11,2,9,3,2
16,228,228,17,17,0,1,0
32,244,244,61,61,0,1,0
41,250,250,6,6,0,1,0
37,256,256,48,48,0,1,0
33,260,260,13,13,0,1,0
2,263,263,1,1,0,1,0
19,263,263,26,7,19,3,2
3,264,264,94,49,45,4,3
23,274,274,5,2,3,2,1
43,276,276,15,15,0,1,0
8,284,284,41,41,0,1,0
39,291,291,27,12,15,4,3
35,298,298,1,1,0,1,0
22,311,311,19,19,0,1,0
18,327,327,14,14,0,1,0
10,336,336,38,38,0,1,0
24,341,341,36,6,30,2,1
1,342,342,6,1,5,2,1
4,347,347,5,5,0,1,0
26,349,349,16,9,7,2,1
12,368,368,1,1,0,1,0
11,384,384,51,51,0,1,0
36,390,390,15,15,0,1,0
30,405,405,20,20,0,1,0
38,405,405,31,19,12,3,2
7,406,406,27,18,9,2,1
27,417,417,47,11,36,2,1
34,431,431,12,12,0,1,0
40,457,457,250,250,0,1,0
9,461,461,1,1,0,1,0
17,493,493,36,4,32,3,2
0,497,497,16,16,0,1,0

20,112,112,6,6,0,1,0
8,115,115,1,1,0,1,0
41,121,121,3,3,0,1,0
25,122,122,7,2,5,2,1
33,137,137,15,15,0,1,0
40,148,148,7,7,0,1,0
38,151,151,22,14,8,3,2
24,157,157,19,7,12,2,1
3,159,159,9,5,4,2,1
31,170,170,26,22,4,2,1
23,176,176,5,2,3,2,1
12,182,182,6,3,3,2,1
21,191,191,3,3,0,1,0
35,201,201,8,2,6,3,2
6,211,211,22,22,0,1,0
7,226,226,18,18,0,1,0
9,235,235,19,19,0,1,0
15,242,242,37,10,27,2,1
39,247,247,42,4,38,2,1
0,249,249,4,4,0,1,0
37,254,254,15,15,0,1,0
34,277,277,58,28,30,4,3
17,279,279,2,2,0,1,0
22,291,291,83,62,21,2,1
30,296,296,9,4,5,2,1
29,317,317,83,78,5,2,1
36,347,347,8,8,0,1,0
27,354,354,108,76,32,3,2
5,355,355,16,16,0,1,0
32,359,359,6,1,5,2,1
16,362,362,21,21,0,1,0
19,369,369,2,2,0,1,0
14,383,383,128,98,30,4,3
28,402,402,40,40,0,1,0
18,413,413,38,38,0,1,0
11,425,425,50,22,28,2,1
10,426,426,7,4,3,2,1
2,434,434,58,58,0,1,0
4,449,449,3,3,0,1,0
13,462,462,29,21,8,2,1
26,480,480,21,5,16,2,1
1,489,489,66,21,45,4,3

6,141,141,11,3,8,2,1
21,161,161,3,3,0,1,0
17,182,182,9,3,6,3,2
28,194,194,5,5,0,1,0
7,198,198,11,5,6,2,1
2,211,211,34,34,0,1,0
19,216,216,21,21,0,1,0
15,219,219,5,5,0,1,0
1,239,239,23,23,0,1,0
35,248,248,59,15,44,2,1
29,273,273,88,37,51,4,3
31,281,281,48,48,0,1,0
9,287,287,48,24,24,2,1
16,315,315,31,31,0,1,0
32,320,320,7,7,0,1,0
3,326,326,15,4,11,2,1
5,336,336,11,11,0,1,0
24,341,341,6,6,0,1,0
34,354,354,110,44,66,4,3
14,358,358,98,98,0,1,0
0,377,377,99,84,15,4,3
12,378,378,19,19,0,1,0
18,388,388,4,4,0,1,0
25,403,403,36,4,32,3,2
11,408,408,6,6,0,1,0
8,411,411,17,17,0,1,0
30,413,413,19,19,0,1,0
26,430,430,27,12,15,4,3
27,430,430,9,9,0,1,0
20,446,446,10,10,0,1,0
22,449,449,120,23,97,4,3
13,452,452,127,43,84,3,2
10,456,456,99,77,22,2,1
23,476,476,67,4,63,4,3
4,485,485,1,1,0,1,0
33,495,495,4,1,3,2,1

1,125,125,1,1,0,1,0
22,134,134,1,1,0,1,0
8,150,150,4,4,0,1,0
41,153,153,23,2,21,4,3
14,163,163,6,1,5,2,1
5,170,170,31,17,14,3,2
23,176,176,37,31,6,3,2
15,178,178,10,10,0,1,0
26,182,182,21,21,0,1,0
33,202,202,4,4,0,1,0
32,231,231,4,4,0,1,0
28,239,239,26,17,9,2,1
4,248,248,35,35,0,1,0
25,273,273,43,43,0,1,0
38,280,280,37,37,0,1,0
36,285,285,7,4,3,2,1
13,288,288,18,3,15,4,3
3,296,296,28,10,18,4,3
16,301,301,1,1,0,1,0
24,312,312,4,4,0,1,0
18,316,316,24,10,14,2,1
34,322,322,35,24,11,2,1
21,327,327,34,25,9,2,1
7,330,330,33,33,0,1,0
30,331,331,12,7,5,2,1
12,346,346,18,9,9,2,1
42,355,355,19,7,12,4,3
0,360,360,12,12,0,1,0
20,398,398,88,88,0,1,0
2,400,400,35,35,0,1,0
27,402,402,182,92,90,4,3
37,404,404,5,5,0,1,0
29,417,417,20,11,9,2,1
19,419,419,20,20,0,1,0
10,419,419,55,55,0,1,0
11,428,428,6,6,0,1,0
9,453,453,40,40,0,1,0
39,456,456,65,25,40,3,2
35,465,465,56,56,0,1,0
17,469,469,51,51,0,1,0
31,487,487,89,67,22,2,1
6,490,490,4,4,0,1,0
40,499,499,20,20,0,1,0

19,103,103,11,1,10,2,1
12,103,103,7,4,3,2,1
10,108,108,4,1,3,2,1
18,127,127,39,39,0,1,0
32,141,141,35,9,26,3,2
4,145,145,2,2,0,1,0
27,159,159,5,5,0,1,0
26,160,160,15,2,13,2,1
38,168,168,39,39,0,1,0
1,171,171,19,6,13,2,1
11,190,190,3,3,0,1,0
16,196,196,45,45,0,1,0
33,199,199,9,9,0,1,0
17,241,241,4,4,0,1,0
34,242,242,12,12,0,1,0
29,254,254,9,6,3,2,1
35,256,256,7,7,0,1,0
8,265,265,76,28,48,3,2
15,276,276,9,3,6,2,1
37,278,278,46,46,0,1,0
6,280,280,27,27,0,1,0
9,288,288,9,9,0,1,0
39,292,292,6,6,0,1,0
28,299,299,3,3,0,1,0
2,317,317,10,1,9,4,3
24,322,322,100,3,97,4,3
23,340,340,25,8,17,4,3
0,358,358,63,45,18,2,1
25,361,361,2,2,0,1,0
31,374,374,123,123,0,1,0
21,375,375,31,31,0,1,0
20,385,385,15,10,5,2,1
13,390,390,39,39,0,1,0
14,411,411,30,30,0,1,0
36,418,418,4,4,0,1,0
30,429,429,49,7,42,4,3
5,446,446,43,43,0,1,0
7,460,460,11,11,0,1,0
22,481,481,28,12,16,4,3
3,483,483,4,4,0,1,0

3,119,119,32,32,0,1,0
25,124,124,5,5,0,1,0
10,136,136,5,2,3,2,1
23,144,144,25,25,0,1,0
27,157,157,6,6,0,1,0
1,159,159,13,4,9,4,3
24,162,162,14,14,0,1,0
21,177,177,5,5,0,1,0
22,188,188,2,2,0,1,0
15,194,194,12,12,0,1,0
19,195,195,44,7,37,2,1
26,195,195,54,54,0,1,0
17,198,198,25,25,0,1,0
13,200,200,39,18,21,2,1
29,210,210,41,41,0,1,0
5,224,224,66,38,28,3,2
28,231,231,8,1,7,2,1
16,274,274,5,5,0,1,0
18,293,293,36,26,10,2,1
14,306,306,43,27,16,2,1
6,313,313,73,73,0,1,0
11,342,342,16,10,6,2,1
2,353,353,5,5,0,1,0
20,356,356,38,5,33,2,1
4,363,363,109,109,0,1,0
8,390,390,98,98,0,1,0
9,417,417,108,108,0,1,0
12,448,448,5,5,0,1,0
7,460,460,9,9,0,1,0
0,486,486,71,71,0,1,0

24,102,102,19,1,18,2,1
36,103,103,3,3,0,1,0
34,115,115,14,3,11,2,1
29,140,140,3,3,0,1,0
39,141,141,8,3,5,2,1
33,159,159,19,11,8,3,2
12,175,175,11,11,0,1,0
14,204,204,1,1,0,1,0
16,226,226,1,1,0,1,0
10,233,233,39,39,0,1,0
30,233,233,5,5,0,1,0
5,236,236,62,15,47,2,1
18,238,238,2,2,0,1,0
4,241,241,29,29,0,1,0
13,245,245,12,12,0,1,0
3,255,255,17,17,0,1,0
23,266,266,37,37,0,1,0
31,284,284,4,4,0,1,0
37,294,294,9,9,0,1,0
1,306,306,39,17,22,2,1
8,317,317,63,63,0,1,0
15,334,334,2,2,0,1,0
7,336,336,46,20,26,2,1
25,360,360,7,2,5,2,1
21,360,360,16,7,9,2,1
28,373,373,36,4,32,3,2
17,380,380,15,15,0,1,0
20,384,384,44,7,37,4,3
27,394,394,34,34,0,1,0
11,408,408,23,23,0,1,0
26,408,408,117,75,42,3,2
0,413,413,116,103,13,2,1
9,413,413,16,16,0,1,0
6,413,413,2,2,0,1,0
2,422,422,19,10,9,2,1
32,425,425,48,16,32,2,1
40,450,450,135,55,80,4,3
19,464,464,28,28,0,1,0
35,480,480,27,27,0,1,0
22,482,482,46,22,24,2,1
38,489,489,76,76,0,1,0

17,105,105,4,4,0,1,0
39,107,107,3,3,0,1,0
29,108,108,22,10,12,4,3
38,118,118,2,2,0,1,0
23,131,131,5,5,0,1,0
14,133,133,1,1,0,1,0
5,143,143,37,37,0,1,0
3,150,150,2,2,0,1,0
37,158,158,30,30,0,1,0
21,180,180,27,9,18,4,3
10,186,186,34,34,0,1,0
13,202,202,11,2,9,2,1
9,218,218,17,8,9,2,1
20,234,234,8,1,7,2,1
12,292,292,49,49,0,1,0
24,299,299,49,49,0,1,0
7,307,307,2,2,0,1,0
15,308,308,31,31,0,1,0
16,311,311,7,7,0,1,0
2,324,324,3,3,0,1,0
31,337,337,26,2,24,4,3
34,341,341,38,2,36,2,1
18,360,360,88,88,0,1,0
28,373,373,4,4,0,1,0
19,380,380,7,7,0,1,0
11,388,388,19,12,7,2,1
25,389,389,17,17,0,1,0
33,397,397,37,37,0,1,0
36,402,402,23,5,18,3,2
6,406,406,56,27,29,2,1
0,416,416,44,24,20,4,3
30,436,436,50,50,0,1,0
22,442,442,50,5,45,3,2
8,444,444,63,31,32,3,2
4,455,455,1,1,0,1,0
32,480,480,1,1,0,1,0
27,483,483,67,67,0,1,0
26,485,485,145,145,0,1,0
1,488,488,112,112,0,1,0
35,493,493,44,2,42,2,1

22,101,101,9,9,0,1,0
12,108,108,23,11,12,2,1
24,116,116,7,1,6,3,2
10,157,157,10,10,0,1,0
32,195,195,14,14,0,1,0
21,200,200,1,1,0,1,0
11,201,201,21,6,15,2,1
8,202,202,7,7,0,1,0
27,209,209,41,35,6,3,2
19,220,220,5,5,0,1,0
20,220,220,12,12,0,1,0
2,225,225,3,3,0,1,0
31,245,245,61,61,0,1,0
6,251,251,16,6,10,3,2
28,271,271,36,36,0,1,0
30,315,315,29,10,19,3,2
25,330,330,31,23,8,3,2
16,337,337,3,3,0,1,0
14,339,339,3,3,0,1,0
23,340,340,57,57,0,1,0
26,368,368,35,16,19,2,1
4,374,374,159,69,90,4,3
18,376,376,88,62,26,2,1
3,390,390,34,16,18,4,3
0,395,395,122,122,0,1,0
7,415,415,53,53,0,1,0
29,416,416,26,26,0,1,0
15,444,444,80,62,18,3,2
9,452,452,18,18,0,1,0
1,453,453,38,11,27,2,1
17,474,474,56,56,0,1,0
13,489,489,151,130,21,2,1
5,497,497,13,13,0,1,0

30,102,102,4,1,3,2,1
46,122,122,1,1,0,1,0
1,127,127,1,1,0,1,0
41,156,156,3,3,0,1,0
13,167,167,5,5,0,1,0
7,174,174,9,9,0,1,0
31,175,175,68,62,6,2,1
27,181,181,25,13,12,4,3
32,182,182,6,6,0,1,0
35,184,184,12,12,0,1,0
33,201,201,7,7,0,1,0
3,203,203,39,39,0,1,0
19,206,206,4,4,0,1,0
24,208,208,5,5,0,1,0
10,210,210,14,14,0,1,0
20,216,216,15,3,12,3,2
29,226,226,23,23,0,1,0
25,254,254,47,31,16,3,2
28,260,260,13,4,9,4,3
22,271,271,28,3,25,2,1
4,271,271,2,2,0,1,0
5,278,278,11,11,0,1,0
6,284,284,8,8,0,1,0
34,290,290,52,22,30,3,2
17,290,290,26,5,21,3,2
16,293,293,23,23,0,1,0
15,296,296,1,1,0,1,0
39,300,300,35,1,34,4,3
18,312,312,33,33,0,1,0
45,328,328,13,10,3,2,1
38,329,329,37,5,32,3,2
42,329,329,52,8,44,2,1
2,357,357,3,3,0,1,0
36,359,359,1,1,0,1,0
21,366,366,5,2,3,2,1
44,406,406,10,10,0,1,0
11,408,408,53,5,48,3,2
37,431,431,23,9,14,2,1
0,432,432,80,80,0,1,0
43,449,449,16,16,0,1,0
9,462,462,8,8,0,1,0
12,463,463,3,3,0,1,0
8,472,472,39,19,20,2,1
14,473,473,55,55,0,1,0
26,479,479,38,38,0,1,0
40,480,480,231,131,100,4,3
23,495,495,11,11,0,1,0

29,100,100,18,7,11,2,1
4,102,102,11,11,0,1,0
13,117,117,27,3,24,4,3
32,131,131,20,20,0,1,0
10,160,160,12,1,11,2,1
12,172,172,2,2,0,1,0
27,177,177,39,26,13,2,1
8,182,182,3,3,0,1,0
6,193,193,22,22,0,1,0
28,193,193,12,6,6,2,1
18,205,205,10,10,0,1,0
24,214,214,8,1,7,2,1
26,219,219,11,2,9,2,1
31,229,229,16,16,0,1,0
17,244,244,19,16,3,2,1
1,247,247,7,7,0,1,0
20,249,249,31,3,28,3,2
5,257,257,21,12,9,2,1
21,267,267,28,14,14,2,1
25,280,280,25,6,19,2,1
22,286,286,5,5,0,1,0
7,297,297,6,6,0,1,0
0,310,310,30,15,15,4,3
34,325,325,17,8,9,4,3
3,327,327,58,46,12,4,3
23,333,333,61,37,24,2,1
30,335,335,47,20,27,2,1
14,348,348,4,4,0,1,0
35,364,364,30,30,0,1,0
15,367,367,162,162,0,1,0
37,394,394,47,47,0,1,0
16,425,425,1,1,0,1,0
9,439,439,37,37,0,1,0
36,443,443,23,23,0,1,0
33,444,444,38,38,0,1,0
19,453,453,64,16,48,2,1
2,465,465,4,4,0,1,0
38,481,481,58,37,21,4,3
11,481,481,60,31,29,2,1

27,102,102,4,4,0,1,0
18,109,109,9,9,0,1,0
32,113,113,17,2,15,4,3
4,127,127,22,5,17,2,1
25,135,135,1,1,0,1,0
1,143,143,16,16,0,1,0
8,143,143,30,30,0,1,0
7,145,145,2,2,0,1,0
20,170,170,7,2,5,2,1
6,184,184,1,1,0,1,0
10,187,187,23,11,12,2,1
36,193,193,21,4,17,2,1
29,211,211,5,5,0,1,0
35,220,220,3,3,0,1,0
39,221,221,3,3,0,1,0
0,223,223,6,6,0,1,0
38,245,245,15,15,0,1,0
12,250,250,5,5,0,1,0
16,255,255,3,3,0,1,0
33,284,284,14,14,0,1,0
28,307,307,33,33,0,1,0
11,317,317,17,17,0,1,0
9,319,319,18,6,12,2,1
3,339,339,12,12,0,1,0
17,341,341,46,46,0,1,0
21,346,346,9,9,0,1,0
30,359,359,116,76,40,2,1
37,359,359,70,22,48,2,1
15,377,377,4,4,0,1,0
19,403,403,52,41,11,3,2
22,421,421,2,2,0,1,0
31,423,423,117,29,88,4,3
34,454,454,85,85,0,1,0
26,468,468,39,39,0,1,0
13,479,479,78,78,0,1,0
2,487,487,130,80,50,3,2
14,487,487,85,23,62,3,2
5,487,487,30,12,18,4,3
24,498,498,121,73,48,3,2
23,499,499,19,7,12,3,2

30,102,102,9,9,0,1,0
29,107,107,5,5,0,1,0
20,131,131,4,4,0,1,0
32,139,139,4,1,3,2,1
34,172,172,17,17,0,1,0
5,173,173,3,3,0,1,0
31,182,182,56,30,26,3,2
18,187,187,1,1,0,1,0
13,188,188,20,20,0,1,0
11,202,202,26,26,0,1,0
10,221,221,17,6,11,2,1
3,234,234,19,7,12,3,2
0,244,244,30,30,0,1,0
35,245,245,3,3,0,1,0
6,261,261,59,59,0,1,0
19,279,279,59,25,34,3,2
16,284,284,35,26,9,4,3
39,289,289,58,11,47,3,2
1,304,304,45,45,0,1,0
27,308,308,75,51,24,4,3
8,316,316,36,4,32,2,1
33,317,317,28,28,0,1,0
23,320,320,7,7,0,1,0
9,323,323,1,1,0,1,0
38,326,326,31,19,12,4,3
15,334,334,3,3,0,1,0
37,335,335,36,14,22,3,2
25,362,362,22,22,0,1,0
41,365,365,89,89,0,1,0
17,365,365,26,12,14,3,2
21,369,369,37,37,0,1,0
40,375,375,24,24,0,1,0
24,378,378,7,7,0,1,0
4,401,401,26,20,6,2,1
7,402,402,2,2,0,1,0
36,426,426,24,10,14,4,3
26,427,427,23,23,0,1,0
12,430,430,50,50,0,1,0
14,448,448,3,3,0,1,0
22,454,454,7,7,0,1,0
28,468,468,6,6,0,1,0
2,471,471,36,36,0,1,0
43,486,486,1,1,0,1,0
42,496,496,61,61,0,1,0

16,100,100,1,1,0,1,0
9,116,116,25,12,13,2,1
23,119,119,20,14,6,3,2
39,122,122,6,6,0,1,0
29,128,128,3,3,0,1,0
3,145,145,29,29,0,1,0
22,151,151,8,8,0,1,0
43,158,158,1,1,0,1,0
44,166,166,9,9,0,1,0
35,175,175,43,13,30,3,2
40,191,191,22,22,0,1,0
42,196,196,29,29,0,1,0
18,199,199,6,6,0,1,0
5,210,210,10,4,6,2,1
0,215,215,9,9,0,1,0
4,225,225,1,1,0,1,0
26,234,234,38,18,20,3,2
15,244,244,11,11,0,1,0
20,260,260,7,7,0,1,0
31,275,275,33,33,0,1,0
8,281,281,8,8,0,1,0
27,291,291,11,11,0,1,0
17,291,291,2,2,0,1,0
2,306,306,24,12,12,4,3
25,306,306,40,32,8,2,1
28,321,321,9,9,0,1,0
32,324,324,77,33,44,4,3
19,340,340,15,15,0,1,0
10,349,349,34,20,14,3,2
13,365,365,25,25,0,1,0
33,365,365,18,18,0,1,0
34,366,366,54,54,0,1,0
6,369,369,1,1,0,1,0
14,390,390,20,1,19,2,1
1,394,394,27,16,11,2,1
36,402,402,110,110,0,1,0
41,417,417,11,2,9,4,3
21,421,421,2,2,0,1,0
11,429,429,30,30,0,1,0
7,440,440,9,9,0,1,0
37,445,445,1,1,0,1,0
24,471,471,116,98,18,2,1
38,482,482,19,19,0,1,0
30,486,486,82,4,78,4,3
12,493,493,70,66,4,2,1

14,113,113,5,5,0,1,0
9,121,121,12,12,0,1,0
1,122,122,13,9,4,2,1
8,124,124,1,1,0,1,0
10,125,125,20,10,10,2,1
36,145,145,75,75,0,1,0
26,151,151,1,1,0,1,0
2,162,162,1,1,0,1,0
21,177,177,25,16,9,2,1
40,199,199,3,3,0,1,0
45,211,211,20,20,0,1,0
41,213,213,1,1,0,1,0
23,216,216,10,10,0,1,0
11,217,217,14,2,12,2,1
16,239,239,1,1,0,1,0
44,239,239,34,16,18,3,2
5,253,253,10,10,0,1,0
12,254,254,47,47,0,1,0
13,256,256,43,22,21,2,1
0,268,268,3,3,0,1,0
42,288,288,16,3,13,2,1
47,289,289,7,7,0,1,0
15,296,296,35,35,0,1,0
37,302,302,7,7,0,1,0
4,306,306,7,1,6,2,1
46,309,309,14,9,5,2,1
20,320,320,1,1,0,1,0
33,324,324,10,10,0,1,0
38,327,327,11,11,0,1,0
29,335,335,35,35,0,1,0
25,345,345,6,6,0,1,0
22,347,347,14,6,8,3,2
7,352,352,33,33,0,1,0
34,357,357,83,45,38,2,1
17,362,362,4,4,0,1,0
32,367,367,26,1,25,2,1
6,368,368,52,52,0,1,0
31,377,377,9,9,0,1,0
30,379,379,51,51,0,1,0
39,384,384,50,50,0,1,0
27,395,395,10,10,0,1,0
3,423,423,2,2,0,1,0
28,446,446,68,68,0,1,0
24,450,450,38,20,18,3,2
43,453,453,64,19,45,4,3
18,465,465,9,2,7,2,1
19,483,483,37,37,0,1,0
35,494,494,56,56,0,1,0

30,102,102,2,2,0,1,0
29,111,111,7,7,0,1,0
22,117,117,26,26,0,1,0
9,150,150,38,14,24,2,1
36,162,162,4,4,0,1,0
31,166,166,79,40,39,2,1
21,176,176,35,17,18,2,1
4,179,179,32,32,0,1,0
24,187,187,11,5,6,2,1
2,188,188,45,23,22,3,2
32,197,197,25,25,0,1,0
5,223,223,5,5,0,1,0
11,224,224,13,3,10,3,2
23,231,231,4,1,3,2,1
15,237,237,1,1,0,1,0
33,248,248,28,23,5,2,1
16,258,258,11,3,8,3,2
7,262,262,4,4,0,1,0
19,278,278,64,64,0,1,0
10,281,281,42,42,0,1,0
35,282,282,8,8,0,1,0
14,328,328,40,18,22,3,2
17,330,330,112,112,0,1,0
25,330,330,7,1,6,2,1
20,332,332,16,16,0,1,0
27,340,340,2,2,0,1,0
6,366,366,6,6,0,1,0
12,370,370,31,19,12,2,1
13,371,371,13,5,8,2,1
0,376,376,1,1,0,1,0
26,401,401,12,12,0,1,0
18,406,406,23,14,9,4,3
3,413,413,98,14,84,4,3
1,422,422,14,14,0,1,0
8,425,425,29,29,0,1,0
34,466,466,74,74,0,1,0
28,486,486,18,1,17,4,3

38,100,100,8,8,0,1,0
20,134,134,2,2,0,1,0
41,134,134,1,1,0,1,0
23,145,145,2,2,0,1,0
39,167,167,27,3,24,2,1
25,175,175,9,5,4,2,1
16,185,185,27,27,0,1,0
22,194,194,16,2,14,4,3
8,199,199,15,15,0,1,0
14,199,199,31,31,0,1,0
35,199,199,11,11,0,1,0
17,205,205,34,34,0,1,0
26,229,229,20,12,8,2,1
19,232,232,2,2,0,1,0
37,255,255,53,53,0,1,0
4,264,264,45,39,6,2,1
21,269,269,11,11,0,1,0
36,284,284,11,4,7,2,1
27,289,289,24,2,22,3,2
11,302,302,22,7,15,4,3
13,303,303,1,1,0,1,0
0,304,304,18,3,15,2,1
24,315,315,18,4,14,2,1
32,318,318,21,21,0,1,0
30,318,318,107,8,99,4,3
6,328,328,13,13,0,1,0
34,330,330,31,31,0,1,0
12,338,338,18,18,0,1,0
40,345,345,3,3,0,1,0
5,359,359,12,12,0,1,0
1,365,365,3,3,0,1,0
18,374,374,20,5,15,4,3
3,387,387,21,21,0,1,0
7,406,406,20,20,0,1,0
2,419,419,69,30,39,2,1
29,423,423,56,29,27,4,3
33,436,436,116,71,45,4,3
31,440,440,31,25,6,3,2
28,465,465,59,59,0,1,0
15,484,484,16,16,0,1,0
10,496,496,93,58,35,2,1
9,499,499,114,114,0,1,0

19,117,117,6,6,0,1,0
40,122,122,51,27,24,2,1
2,124,124,17,5,12,3,2
22,132,132,11,11,0,1,0
28,138,138,13,13,0,1,0
15,165,165,8,8,0,1,0
29,169,169,5,2,3,2,1
35,174,174,75,6,69,4,3
16,182,182,4,4,0,1,0
27,182,182,5,5,0,1,0
17,185,185,3,3,0,1,0
20,189,189,4,1,3,2,1
36,205,205,8,5,3,2,1
9,206,206,7,3,4,2,1
30,211,211,8,8,0,1,0
3,215,215,55,55,0,1,0
4,248,248,2,2,0,1,0
23,253,253,26,26,0,1,0
21,260,260,5,1,4,2,1
13,289,289,18,9,9,2,1
39,307,307,43,43,0,1,0
14,309,309,13,6,7,2,1
12,338,338,25,25,0,1,0
10,346,346,56,23,33,4,3
18,358,358,60,42,18,3,2
7,359,359,64,34,30,4,3
32,367,367,50,3,47,3,2
26,377,377,29,29,0,1,0
5,388,388,35,35,0,1,0
31,394,394,14,2,12,2,1
41,394,394,34,30,4,2,1
37,395,395,14,14,0,1,0
8,397,397,19,19,0,1,0
11,397,397,99,60,39,2,1
25,412,412,17,1,16,3,2
34,422,422,23,23,0,1,0
33,433,433,9,9,0,1,0
0,453,453,1,1,0,1,0
6,473,473,48,48,0,1,0
1,475,475,16,13,3,2,1
38,480,480,61,61,0,1,0
24,497,497,5,5,0,1,0

5,122,122,1,1,0,1,0
11,124,124,2,2,0,1,0
38,129,129,13,6,7,2,1
3,131,131,18,3,15,4,3
28,137,137,5,2,3,2,1
13,141,141,1,1,0,1,0
10,144,144,6,6,0,1,0
19,144,144,22,22,0,1,0
0,147,147,4,4,0,1,0
47,174,174,43,43,0,1,0
8,179,179,49,17,32,3,2
4,182,182,5,5,0,1,0
45,184,184,63,63,0,1,0
20,185,185,17,11,6,2,1
41,189,189,4,4,0,1,0
31,193,193,25,1,24,2,1
16,195,195,25,25,0,1,0
37,228,228,7,7,0,1,0
30,233,233,25,3,22,3,2
23,237,237,6,6,0,1,0
7,256,256,4,1,3,2,1
9,267,267,8,8,0,1,0
15,267,267,25,10,15,2,1
6,279,279,15,15,0,1,0
17,283,283,47,35,12,4,3
46,293,293,25,4,21,4,3
24,301,301,29,29,0,1,0
1,312,312,29,1,28,3,2
21,327,327,22,6,16,3,2
27,335,335,5,1,4,2,1
14,337,337,6,1,5,2,1
40,360,360,42,42,0,1,0
18,360,360,9,2,7,2,1
26,365,365,21,21,0,1,0
39,368,368,1,1,0,1,0
44,384,384,3,3,0,1,0
32,393,393,7,7,0,1,0
35,397,397,13,13,0,1,0
25,403,403,17,17,0,1,0
29,417,417,196,146,50,3,2
43,419,419,22,16,6,2,1
2,422,422,8,8,0,1,0
22,452,452,38,22,16,3,2
42,457,457,34,34,0,1,0
36,478,478,30,5,25,2,1
12,479,479,27,5,22,2,1
33,488,488,2,2,0,1,0
34,491,491,15,15,0,1,0

10,103,103,1,1,0,1,0
3,115,115,7,1,6,2,1
28,116,116,17,17,0,1,0
21,116,116,11,3,8,3,2
0,127,127,26,26,0,1,0
13,143,143,38,38,0,1,0
9,148,148,4,4,0,1,0
1,171,171,12,12,0,1,0
4,171,171,48,15,33,2,1
33,177,177,5,5,0,1,0
34,182,182,28,14,14,3,2
18,204,204,2,2,0,1,0
24,217,217,12,12,0,1,0
23,245,245,25,25,0,1,0
16,253,253,20,2,18,4,3
12,257,257,10,10,0,1,0
27,288,288,47,18,29,3,2
17,288,288,52,52,0,1,0
31,317,317,25,10,15,3,2
14,320,320,12,12,0,1,0
5,349,349,39,26,13,2,1
20,353,353,4,4,0,1,0
19,363,363,1,1,0,1,0
22,366,366,8,8,0,1,0
7,369,369,32,9,23,4,3
15,370,370,1,1,0,1,0
2,380,380,81,37,44,3,2
11,386,386,10,10,0,1,0
6,441,441,44,36,8,2,1
29,444,444,130,25,105,4,3
32,459,459,50,22,28,3,2
8,483,483,177,75,102,4,3
25,490,490,41,41,0,1,0
26,495,495,94,74,20,2,1
30,498,498,68,19,49,3,2

36,101,101,30,18,12,4,3
5,128,128,5,2,3,2,1
11,134,134,22,22,0,1,0
21,145,145,5,5,0,1,0
15,149,149,10,10,0,1,0
30,168,168,8,8,0,1,0
42,182,182,6,6,0,1,0
3,201,201,10,10,0,1,0
35,208,208,65,65,0,1,0
6,221,221,26,26,0,1,0
8,243,243,25,17,8,3,2
39,245,245,12,8,4,2,1
37,253,253,19,1,18,3,2
2,260,260,26,8,18,3,2
19,262,262,13,5,8,3,2
26,265,265,10,4,6,3,2
29,288,288,2,2,0,1,0
1,314,314,7,7,0,1,0
33,317,317,11,8,3,2,1
31,328,328,37,37,0,1,0
34,335,335,36,36,0,1,0
4,343,343,7,7,0,1,0
13,352,352,52,5,47,3,2
18,356,356,94,82,12,2,1
25,371,371,37,37,0,1,0
27,371,371,64,64,0,1,0
0,394,394,36,36,0,1,0
14,400,400,44,44,0,1,0
10,402,402,25,12,13,2,1
22,431,431,12,12,0,1,0
9,431,431,92,92,0,1,0
24,448,448,15,15,0,1,0
23,451,451,4,4,0,1,0
32,452,452,4,4,0,1,0
16,453,453,25,20,5,2,1
41,454,454,60,60,0,1,0
17,470,470,14,6,8,3,2
38,470,470,56,56,0,1,0
28,471,471,37,37,0,1,0
20,473,473,37,27,10,3,2
7,482,482,13,13,0,1,0
12,493,493,9,9,0,1,0
40,496,496,88,50,38,3,2

16,112,112,41,31,10,2,1
30,171,171,11,11,0,1,0
11,179,179,1,1,0,1,0
8,184,184,15,3,12,2,1
10,204,204,1,1,0,1,0
22,212,212,37,1,36,4,3
17,222,222,6,6,0,1,0
20,235,235,44,2,42,3,2
9,235,235,43,43,0,1,0
2,239,239,5,1,4,2,1
14,248,248,16,16,0,1,0
27,264,264,25,25,0,1,0
5,295,295,11,11,0,1,0
32,310,310,18,18,0,1,0
3,312,312,9,9,0,1,0
1,315,315,40,40,0,1,0
13,320,320,1,1,0,1,0
21,322,322,91,91,0,1,0
12,332,332,57,57,0,1,0
25,355,355,92,4,88,3,2
35,362,362,18,18,0,1,0
29,371,371,49,43,6,3,2
26,372,372,4,4,0,1,0
31,374,374,4,1,3,2,1
34,374,374,98,4,94,3,2
6,393,393,1,1,0,1,0
24,400,400,18,9,9,2,1
23,405,405,19,11,8,3,2
18,411,411,4,4,0,1,0
4,426,426,42,42,0,1,0
0,438,438,194,137,57,3,2
15,440,440,84,10,74,4,3
33,443,443,5,5,0,1,0
19,472,472,4,4,0,1,0
7,481,481,36,6,30,3,2
28,488,488,95,79,16,2,1

21,102,102,21,21,0,1,0
17,121,121,1,1,0,1,0
5,121,121,2,2,0,1,0
3,129,129,1,1,0,1,0
32,131,131,49,49,0,1,0
14,132,132,22,22,0,1,0
13,140,140,18,7,11,2,1
30,144,144,4,4,0,1,0
12,149,149,7,7,0,1,0
29,160,160,18,15,3,2,1
18,172,172,11,11,0,1,0
23,179,179,7,1,6,2,1
19,194,194,8,2,6,2,1
27,200,200,26,16,10,2,1
0,205,205,36,36,0,1,0
39,206,206,2,2,0,1,0
8,207,207,4,4,0,1,0
4,221,221,15,10,5,2,1
28,242,242,8,8,0,1,0
41,243,243,8,8,0,1,0
22,254,254,2,2,0,1,0
31,275,275,37,29,8,3,2
35,276,276,2,2,0,1,0
10,279,279,9,4,5,2,1
16,331,331,24,24,0,1,0
15,344,344,17,17,0,1,0
2,349,349,3,3,0,1,0
36,369,369,1,1,0,1,0
24,374,374,9,9,0,1,0
33,382,382,55,46,9,2,1
11,408,408,18,3,15,4,3
1,410,410,15,9,6,3,2
6,412,412,139,107,32,3,2
9,434,434,47,4,43,2,1
40,436,436,26,26,0,1,0
20,440,440,111,36,75,4,3
26,443,443,18,15,3,2,1
7,444,444,2,2,0,1,0
25,464,464,117,96,21,4,3
37,466,466,119,93,26,2,1
38,487,487,100,100,0,1,0
34,500,500,26,6,20,3,2

9,108,108,14,7,7,2,1
23,110,110,10,6,4,2,1
16,132,132,34,23,11,2,1
5,133,133,7,4,3,2,1
6,144,144,19,11,8,3,2
7,164,164,5,5,0,1,0
4,171,171,62,26,36,4,3
22,172,172,32,27,5,2,1
17,198,198,40,22,18,2,1
32,200,200,15,11,4,2,1
0,201,201,1,1,0,1,0
31,225,225,43,9,34,2,1
34,250,250,13,3,10,2,1
20,263,263,19,1,18,4,3
3,296,296,54,54,0,1,0
18,298,298,46,46,0,1,0
24,299,299,25,4,21,4,3
30,322,322,35,3,32,2,1
10,360,360,10,10,0,1,0
21,366,366,13,4,9,4,3
28,380,380,18,9,9,4,3
26,382,382,1,1,0,1,0
33,398,398,24,13,11,2,1
12,398,398,2,2,0,1,0
27,406,406,2,2,0,1,0
2,412,412,96,9,87,4,3
11,414,414,11,7,4,2,1
14,426,426,48,48,0,1,0
25,434,434,2,2,0,1,0
19,446,446,39,39,0,1,0
15,464,464,62,16,46,3,2
13,468,468,1,1,0,1,0
1,482,482,47,47,0,1,0
29,483,483,230,193,37,2,1
8,487,487,55,29,26,3,2
35,493,493,2,2,0,1,0

0,107,107,13,13,0,1,0
4,108,108,7,4,3,2,1
32,115,115,29,23,6,2,1
36,142,142,10,2,8,3,2
22,191,191,5,1,4,2,1
30,194,194,16,4,12,2,1
24,194,194,14,14,0,1,0
35,210,210,44,25,19,2,1
23,220,220,40,40,0,1,0
18,229,229,45,45,0,1,0
29,232,232,37,37,0,1,0
37,233,233,22,4,18,4,3
16,243,243,108,18,90,3,2
26,246,246,5,5,0,1,0
20,259,259,13,13,0,1,0
7,282,282,58,8,50,3,2
6,284,284,8,3,5,2,1
9,299,299,8,8,0,1,0
21,310,310,30,30,0,1,0
17,317,317,12,2,10,2,1
15,319,319,26,15,11,2,1
14,329,329,4,4,0,1,0
25,335,335,35,35,0,1,0
33,354,354,115,19,96,3,2
27,376,376,32,26,6,3,2
2,378,378,45,26,19,2,1
34,380,380,1,1,0,1,0
3,395,395,22,22,0,1,0
1,401,401,48,48,0,1,0
5,406,406,53,53,0,1,0
28,417,417,34,34,0,1,0
11,424,424,33,12,21,4,3
10,428,428,11,11,0,1,0
8,440,440,4,4,0,1,0
31,445,445,2,2,0,1,0
12,471,471,39,3,36,2,1
19,478,478,14,14,0,1,0
13,499,499,32,32,0,1,0

26,123,123,14,4,10,2,1
24,124,124,6,6,0,1,0
13,124,124,4,4,0,1,0
2,133,133,34,10,24,3,2
34,171,171,37,9,28,2,1
22,181,181,11,11,0,1,0
7,190,190,10,10,0,1,0
10,212,212,58,58,0,1,0
33,213,213,5,2,3,2,1
20,213,213,4,4,0,1,0
21,222,222,87,87,0,1,0
19,225,225,77,48,29,4,3
5,239,239,48,43,5,2,1
30,250,250,18,18,0,1,0
16,274,274,41,33,8,3,2
3,278,278,25,5,20,2,1
15,287,287,48,11,37,2,1
32,287,287,49,15,34,2,1
27,290,290,3,3,0,1,0
8,295,295,38,6,32,3,2
31,297,297,15,6,9,4,3
25,304,304,11,11,0,1,0
17,321,321,19,13,6,3,2
18,331,331,11,2,9,4,3
12,339,339,27,3,24,3,2
11,374,374,59,13,46,2,1
28,379,379,27,18,9,2,1
29,405,405,4,1,3,2,1
1,416,416,1,1,0,1,0
35,434,434,26,26,0,1,0
6,443,443,5,5,0,1,0
23,465,465,69,27,42,4,3
14,474,474,28,11,17,2,1
9,481,481,50,29,21,2,1
4,484,484,61,61,0,1,0
0,500,500,6,6,0,1,0

3,103,103,6,6,0,1,0
40,112,112,16,3,13,2,1
0,126,126,34,34,0,1,0
27,127,127,11,11,0,1,0
25,128,128,19,1,18,4,3
31,130,130,7,3,4,2,1
38,134,134,70,7,63,4,3
16,140,140,39,36,3,2,1
24,142,142,23,17,6,2,1
8,151,151,6,6,0,1,0
19,161,161,2,2,0,1,0
17,170,170,4,4,0,1,0
35,177,177,2,2,0,1,0
14,203,203,2,2,0,1,0
7,209,209,1,1,0,1,0
6,213,213,52,11,41,4,3
30,220,220,20,2,18,3,2
34,243,243,24,1,23,2,1
2,258,258,6,6,0,1,0
36,261,261,13,5,8,3,2
15,270,270,7,2,5,2,1
39,313,313,11,11,0,1,0
33,329,329,61,61,0,1,0
22,342,342,5,5,0,1,0
10,353,353,22,10,12,3,2
28,356,356,1,1,0,1,0
18,374,374,16,16,0,1,0
9,381,381,3,3,0,1,0
11,383,383,27,12,15,2,1
23,390,390,6,6,0,1,0
37,394,394,50,25,25,2,1
29,406,406,17,17,0,1,0
4,407,407,1,1,0,1,0
5,416,416,31,1,30,3,2
26,428,428,56,5,51,4,3
12,431,431,52,3,49,2,1
21,442,442,44,44,0,1,0
20,450,450,42,42,0,1,0
1,454,454,18,7,11,2,1
13,483,483,144,9,135,4,3
32,489,489,14,14,0,1,0

9,113,113,6,6,0,1,0
1,114,114,1,1,0,1,0
33,119,119,1,1,0,1,0
8,125,125,18,18,0,1,0
6,128,128,12,1,11,2,1
14,133,133,2,2,0,1,0
23,158,158,9,2,7,2,1
25,158,158,5,1,4,2,1
12,158,158,53,4,49,4,3
7,167,167,2,2,0,1,0
17,169,169,1,1,0,1,0
0,172,172,4,4,0,1,0
11,172,172,36,36,0,1,0
5,189,189,53,43,10,3,2
29,195,195,13,13,0,1,0
16,230,230,12,12,0,1,0
27,235,235,8,1,7,2,1
32,264,264,114,48,66,4,3
28,265,265,3,3,0,1,0
38,282,282,16,1,15,4,3
31,291,291,13,2,11,4,3
35,292,292,68,25,43,2,1
3,296,296,12,12,0,1,0
15,322,322,11,11,0,1,0
21,340,340,7,7,0,1,0
37,340,340,20,20,0,1,0
36,359,359,35,35,0,1,0
18,368,368,1,1,0,1,0
22,379,379,34,20,14,2,1
26,395,395,21,21,0,1,0
30,395,395,14,14,0,1,0
4,400,400,27,11,16,3,2
2,430,430,50,5,45,2,1
20,438,438,14,8,6,2,1
13,440,440,5,5,0,1,0
24,441,441,116,62,54,4,3
34,463,463,141,50,91,4,3
19,486,486,55,55,0,1,0
10,487,487,137,47,90,4,3

13,115,115,5,1,4,2,1
29,117,117,8,8,0,1,0
27,119,119,9,6,3,2,1
0,123,123,12,12,0,1,0
20,125,125,2,2,0,1,0
8,140,140,23,1,22,3,2
23,141,141,10,3,7,2,1
1,146,146,51,51,0,1,0
6,152,152,11,6,5,2,1
5,180,180,59,27,32,3,2
34,180,180,2,2,0,1,0
28,190,190,8,8,0,1,0
38,191,191,21,3,18,3,2
36,231,231,4,4,0,1,0
3,241,241,34,34,0,1,0
33,249,249,49,10,39,4,3
15,264,264,3,3,0,1,0
10,274,274,1,1,0,1,0
31,293,293,11,8,3,2,1
14,297,297,25,9,16,3,2
19,313,313,28,28,0,1,0
37,315,315,29,29,0,1,0
22,319,319,54,6,48,2,1
18,325,325,48,36,12,3,2
32,331,331,31,6,25,3,2
17,339,339,6,3,3,2,1
30,381,381,40,40,0,1,0
24,391,391,17,2,15,4,3
2,423,423,14,5,9,2,1
4,427,427,15,1,14,2,1
35,429,429,113,73,40,3,2
26,433,433,60,21,39,4,3
16,440,440,20,20,0,1,0
25,446,446,45,45,0,1,0
12,454,454,11,11,0,1,0
9,457,457,19,19,0,1,0
11,464,464,31,31,0,1,0
21,482,482,65,38,27,4,3
7,485,485,46,46,0,1,0
39,491,491,83,65,18,4,3

33,110,110,19,19,0,1,0
4,114,114,4,4,0,1,0
24,129,129,7,3,4,2,1
12,162,162,24,3,21,4,3
25,170,170,45,27,18,2,1
19,173,173,37,1,36,3,2
15,174,174,1,1,0,1,0
22,176,176,25,5,20,2,1
8,187,187,45,45,0,1,0
23,196,196,13,7,6,2,1
0,201,201,8,8,0,1,0
9,201,201,43,18,25,4,3
31,203,203,2,2,0,1,0
10,212,212,62,62,0,1,0
2,243,243,13,8,5,2,1
13,252,252,17,17,0,1,0
20,269,269,12,5,7,2,1
6,282,282,1,1,0,1,0
11,284,284,79,57,22,3,2
7,333,333,66,66,0,1,0
5,347,347,52,47,5,2,1
30,347,347,29,29,0,1,0
28,391,391,29,29,0,1,0
14,393,393,22,4,18,3,2
27,410,410,19,3,16,3,2
18,413,413,5,5,0,1,0
16,416,416,14,5,9,2,1
17,429,429,58,12,46,2,1
29,429,429,130,130,0,1,0
21,435,435,31,31,0,1,0
3,446,446,38,38,0,1,0
32,452,452,2,2,0,1,0
1,457,457,15,1,14,2,1
26,464,464,62,16,46,3,2
34,491,491,31,31,0,1,0

11,107,107,3,3,0,1,0
9,138,138,1,1,0,1,0
33,141,141,48,48,0,1,0
7,147,147,51,51,0,1,0
1,162,162,20,11,9,4,3
21,169,169,2,2,0,1,0
29,171,171,11,5,6,3,2
8,190,190,15,1,14,3,2
22,191,191,62,62,0,1,0
0,203,203,77,63,14,2,1
10,205,205,12,12,0,1,0
26,205,205,15,6,9,4,3
24,207,207,59,15,44,2,1
5,224,224,3,3,0,1,0
20,247,247,29,8,21,4,3
4,257,257,49,49,0,1,0
30,271,271,26,10,16,2,1
16,272,272,6,6,0,1,0
3,313,313,47,47,0,1,0
25,313,313,3,3,0,1,0
15,334,334,34,1,33,2,1
13,334,334,8,5,3,2,1
14,336,336,29,29,0,1,0
19,353,353,5,5,0,1,0
17,372,372,15,15,0,1,0
32,381,381,14,10,4,2,1
18,390,390,6,6,0,1,0
23,422,422,2,2,0,1,0
31,439,439,18,6,12,3,2
27,442,442,54,54,0,1,0
28,445,445,92,92,0,1,0
12,455,455,92,92,0,1,0
6,476,476,72,72,0,1,0
2,478,478,29,29,0,1,0

15,103,103,13,3,10,3,2
9,107,107,28,28,0,1,0
0,129,129,18,11,7,2,1
27,146,146,42,24,18,4,3
13,162,162,3,3,0,1,0
17,171,171,25,7,18,2,1
26,195,195,1,1,0,1,0
14,206,206,11,4,7,2,1
19,212,212,36,36,0,1,0
22,220,220,29,29,0,1,0
5,224,224,5,5,0,1,0
10,243,243,81,21,60,4,3
23,247,247,6,6,0,1,0
6,247,247,33,33,0,1,0
1,255,255,76,76,0,1,0
8,271,271,26,3,23,2,1
20,284,284,8,8,0,1,0
2,297,297,50,50,0,1,0
21,314,314,7,7,0,1,0
24,327,327,60,30,30,4,3
18,334,334,73,73,0,1,0
12,335,335,11,2,9,2,1
30,362,362,90,42,48,2,1
31,381,381,31,31,0,1,0
11,384,384,16,8,8,3,2
29,406,406,31,31,0,1,0
28,409,409,24,3,21,4,3
4,417,417,9,9,0,1,0
7,449,449,18,2,16,2,1
3,454,454,142,96,46,3,2
25,486,486,17,2,15,2,1
16,489,489,16,16,0,1,0

5,108,108,1,1,0,1,0
15,108,108,4,4,0,1,0
30,126,126,6,3,3,2,1
38,130,130,5,2,3,2,1
1,131,131,11,1,10,2,1
35,139,139,9,9,0,1,0
36,146,146,1,1,0,1,0
11,163,163,8,8,0,1,0
9,165,165,28,16,12,3,2
26,175,175,19,2,17,2,1
29,187,187,13,7,6,2,1
12,188,188,10,10,0,1,0
3,206,206,2,2,0,1,0
23,206,206,1,1,0,1,0
7,216,216,24,4,20,2,1
8,216,216,15,15,0,1,0
4,252,252,4,4,0,1,0
42,262,262,42,42,0,1,0
43,270,270,3,3,0,1,0
31,274,274,99,57,42,4,3
28,281,281,23,23,0,1,0
39,285,285,69,69,0,1,0
0,288,288,65,24,41,2,1
33,291,291,20,20,0,1,0
25,297,297,6,6,0,1,0
18,299,299,13,13,0,1,0
37,326,326,16,16,0,1,0
6,338,338,39,30,9,2,1
40,375,375,6,6,0,1,0
44,377,377,55,50,5,2,1
24,400,400,1,1,0,1,0
21,407,407,18,10,8,2,1
27,408,408,8,8,0,1,0
20,409,409,66,28,38,3,2
41,415,415,37,37,0,1,0
16,417,417,20,7,13,2,1
22,418,418,23,14,9,2,1
2,445,445,136,136,0,1,0
14,458,458,23,8,15,2,1
34,469,469,77,77,0,1,0
10,478,478,28,2,26,3,2
19,484,484,5,5,0,1,0
32,487,487,95,61,34,2,1
13,493,493,19,11,8,2,1
17,496,496,54,8,46,3,2

25,110,110,4,4,0,1,0
14,121,121,23,1,22,2,1
1,123,123,5,1,4,2,1
6,126,126,1,1,0,1,0
24,137,137,22,5,17,2,1
28,156,156,4,1,3,2,1
2,187,187,45,7,38,3,2
29,205,205,36,36,0,1,0
10,206,206,42,42,0,1,0
16,212,212,4,4,0,1,0
31,218,218,17,5,12,2,1
26,231,231,2,2,0,1,0
22,234,234,1,1,0,1,0
17,268,268,41,41,0,1,0
0,273,273,18,2,16,2,1
7,299,299,32,29,3,2,1
4,305,305,24,24,0,1,0
32,328,328,83,24,59,4,3
27,350,350,36,36,0,1,0
30,365,365,24,12,12,4,3
33,374,374,12,12,0,1,0
20,379,379,19,7,12,2,1
21,386,386,26,11,15,4,3
3,437,437,54,30,24,3,2
15,442,442,109,55,54,3,2
23,446,446,168,168,0,1,0
18,457,457,29,29,0,1,0
19,460,460,12,2,10,2,1
8,463,463,112,96,16,3,2
9,466,466,30,9,21,4,3
12,466,466,148,38,110,4,3
13,468,468,21,21,0,1,0
11,469,469,68,68,0,1,0
5,494,494,14,14,0,1,0

28,108,108,1,1,0,1,0
3,109,109,25,25,0,1,0
11,110,110,3,3,0,1,0
0,175,175,30,30,0,1,0
1,176,176,32,18,14,2,1
25,176,176,3,3,0,1,0
12,215,215,1,1,0,1,0
8,218,218,80,14,66,3,2
23,220,220,4,4,0,1,0
31,233,233,3,3,0,1,0
10,241,241,91,73,18,2,1
6,242,242,11,5,6,2,1
14,289,289,14,14,0,1,0
22,292,292,6,6,0,1,0
24,303,303,16,16,0,1,0
7,304,304,14,14,0,1,0
21,309,309,78,52,26,3,2
16,316,316,6,6,0,1,0
19,321,321,52,46,6,3,2
30,332,332,84,84,0,1,0
9,341,341,1,1,0,1,0
20,367,367,74,74,0,1,0
4,367,367,14,14,0,1,0
13,400,400,72,22,50,4,3
29,406,406,5,5,0,1,0
26,410,410,3,3,0,1,0
27,426,426,87,87,0,1,0
2,443,443,50,50,0,1,0
15,448,448,5,5,0,1,0
18,454,454,67,67,0,1,0
17,474,474,115,115,0,1,0
32,490,490,116,53,63,4,3
5,500,500,58,32,26,3,2

21,126,126,18,3,15,4,3
31,139,139,8,8,0,1,0
4,147,147,11,5,6,3,2
22,157,157,24,24,0,1,0
30,178,178,20,20,0,1,0
20,183,183,36,14,22,3,2
11,186,186,31,3,28,3,2
18,194,194,9,9,0,1,0
1,229,229,50,20,30,4,3
9,233,233,11,11,0,1,0
7,241,241,28,28,0,1,0
24,264,264,3,3,0,1,0
6,266,266,16,16,0,1,0
27,300,300,47,27,20,2,1
2,309,309,24,24,0,1,0
29,335,335,1,1,0,1,0
32,346,346,90,90,0,1,0
10,352,352,29,29,0,1,0
13,357,357,94,22,72,4,3
25,360,360,54,54,0,1,0
12,380,380,89,89,0,1,0
3,409,409,79,31,48,3,2
15,411,411,5,5,0,1,0
26,414,414,14,1,13,3,2
16,416,416,7,4,3,2,1
5,418,418,16,10,6,3,2
28,440,440,13,3,10,2,1
17,442,442,89,71,18,4,3
19,455,455,107,42,65,3,2
14,456,456,51,11,40,3,2
8,458,458,75,11,64,3,2
23,468,468,2,2,0,1,0
0,497,497,82,82,0,1,0

26,104,104,27,11,16,3,2
0,125,125,8,5,3,2,1
15,171,171,14,14,0,1,0
14,190,190,10,10,0,1,0
25,199,199,5,5,0,1,0
8,207,207,8,2,6,3,2
24,209,209,29,29,0,1,0
2,221,221,21,3,18,3,2
3,222,222,16,1,15,2,1
23,235,235,40,40,0,1,0
29,237,237,2,2,0,1,0
11,256,256,28,19,9,4,3
20,261,261,31,31,0,1,0
30,262,262,19,13,6,2,1
12,271,271,66,41,25,3,2
7,291,291,146,4,142,4,3
10,297,297,68,38,30,4,3
1,320,320,51,21,30,3,2
6,324,324,19,7,12,3,2
32,328,328,1,1,0,1,0
28,346,346,27,2,25,4,3
4,358,358,71,47,24,4,3
21,379,379,47,47,0,1,0
5,391,391,29,29,0,1,0
18,393,393,68,32,36,3,2
31,409,409,36,18,18,3,2
16,424,424,97,81,16,2,1
19,426,426,10,10,0,1,0
17,437,437,63,63,0,1,0
9,445,445,8,8,0,1,0
13,450,450,18,18,0,1,0
27,465,465,23,13,10,2,1
22,470,470,40,40,0,1,0

6,110,110,1,1,0,1,0
20,122,122,16,16,0,1,0
28,123,123,3,3,0,1,0
30,128,128,1,1,0,1,0
12,133,133,20,10,10,3,2
37,148,148,21,21,0,1,0
4,150,150,30,18,12,2,1
15,158,158,2,2,0,1,0
1,183,183,13,13,0,1,0
2,190,190,14,4,10,2,1
7,211,211,39,12,27,2,1
13,223,223,4,4,0,1,0
5,226,226,13,13,0,1,0
33,239,239,2,2,0,1,0
3,246,246,3,3,0,1,0
11,253,253,46,46,0,1,0
9,254,254,57,57,0,1,0
35,254,254,15,15,0,1,0
29,256,256,57,57,0,1,0
14,257,257,21,15,6,3,2
21,276,276,32,32,0,1,0
23,277,277,44,44,0,1,0
36,281,281,30,30,0,1,0
38,306,306,12,8,4,2,1
31,307,307,33,33,0,1,0
8,317,317,38,23,15,2,1
32,320,320,15,11,4,2,1
19,321,321,4,4,0,1,0
0,358,358,11,11,0,1,0
22,364,364,26,8,18,2,1
40,370,370,39,39,0,1,0
27,384,384,17,11,6,2,1
25,385,385,41,41,0,1,0
34,390,390,91,50,41,2,1
16,393,393,2,2,0,1,0
17,402,402,26,26,0,1,0
10,408,408,42,42,0,1,0
18,431,431,18,6,12,3,2
39,476,476,16,7,9,2,1
26,499,499,74,29,45,4,3
24,499,499,135,93,42,4,3

15,100,100,1,1,0,1,0
12,109,109,5,5,0,1,0
26,113,113,4,1,3,2,1
34,127,127,14,14,0,1,0
4,140,140,15,15,0,1,0
17,142,142,18,1,17,3,2
10,148,148,25,14,11,2,1
3,162,162,11,5,6,2,1
33,184,184,56,56,0,1,0
24,207,207,13,9,4,2,1
32,225,225,4,1,3,2,1
20,234,234,40,3,37,2,1
14,239,239,43,43,0,1,0
18,240,240,18,18,0,1,0
27,285,285,20,20,0,1,0
5,301,301,39,39,0,1,0
29,302,302,3,3,0,1,0
23,317,317,23,9,14,3,2
28,331,331,34,34,0,1,0
13,336,336,1,1,0,1,0
7,350,350,50,4,46,3,2
11,363,363,51,29,22,2,1
22,378,378,14,2,12,3,2
9,398,398,2,2,0,1,0
25,402,402,20,8,12,3,2
16,421,421,80,64,16,2,1
19,429,429,15,15,0,1,0
0,438,438,41,41,0,1,0
30,459,459,146,76,70,4,3
31,465,465,133,133,0,1,0
35,467,467,7,1,6,3,2
1,469,469,107,107,0,1,0
8,481,481,98,76,22,2,1
6,484,484,76,76,0,1,0
21,493,493,21,16,5,2,1
2,493,493,14,6,8,2,1

